"unitid","institution name","year","S2014_IS.Instructional staff category","S2014_IS_RV.Grand total","S2014_IS_RV.Grand total men","S2014_IS_RV.Grand total women","S2014_IS_RV.American Indian or Alaska Native total","S2014_IS_RV.American Indian or Alaska Native men","S2014_IS_RV.American Indian or Alaska Native women","S2014_IS_RV.Asian total","S2014_IS_RV.Asian men","S2014_IS_RV.Asian women","S2014_IS_RV.Black or African American total","S2014_IS_RV.Black or African American men","S2014_IS_RV.Black or African American women","S2014_IS_RV.Hispanic or Latino total","S2014_IS_RV.Hispanic or Latino men","S2014_IS_RV.Hispanic or Latino women","S2014_IS_RV.Native Hawaiian or Other Pacific Islander total","S2014_IS_RV.Native Hawaiian or Other Pacific Islander men","S2014_IS_RV.Native Hawaiian or Other Pacific Islander women","S2014_IS_RV.White total","S2014_IS_RV.White men","S2014_IS_RV.White women","S2014_IS_RV.Two or more races total","S2014_IS_RV.Two or more races men","S2014_IS_RV.Two or more races women","S2014_IS_RV.Race/ethnicity unknown total","S2014_IS_RV.Race/ethnicity unknown men","S2014_IS_RV.Race/ethnicity unknown women","S2014_IS_RV.Nonresident alien total","S2014_IS_RV.Nonresident alien men","S2014_IS_RV.Nonresident alien women","IDX_HR"
"110422","California Polytechnic State University-San Luis Obispo","2014","Tenured total","449","318","131","1","1","0","44","29","15","9","5","4","30","22","8","1","1","0","332","235","97","7","6","1","24","19","5","1","0","1","-2"
"110422","California Polytechnic State University-San Luis Obispo","2014","Tenured, professors","275","211","64","1","1","0","25","21","4","5","3","2","17","12","5","1","1","0","204","153","51","5","4","1","17","16","1","0","0","0","-2"
"110422","California Polytechnic State University-San Luis Obispo","2014","Tenured, associate professors","172","106","66","0","0","0","19","8","11","4","2","2","13","10","3","0","0","0","126","81","45","2","2","0","7","3","4","1","0","1","-2"
"110422","California Polytechnic State University-San Luis Obispo","2014","Tenured, no academic rank","2","1","1","0","0","0","0","0","0","0","0","0","0","0","0","0","0","0","2","1","1","0","0","0","0","0","0","0","0","0","-2"
"110422","California Polytechnic State University-San Luis Obispo","2014","On-Tenure track total","167","97","70","2","1","1","14","9","5","1","1","0","8","6","2","0","0","0","127","68","59","1","0","1","5","4","1","9","8","1","-2"
"110422","California Polytechnic State University-San Luis Obispo","2014","On-tenure track, professors","1","1","0","0","0","0","0","0","0","0","0","0","0","0","0","0","0","0","1","1","0","0","0","0","0","0","0","0","0","0","-2"
"110422","California Polytechnic State University-San Luis Obispo","2014","On-tenure track, associate professors","23","15","8","0","0","0","1","1","0","0","0","0","2","1","1","0","0","0","18","12","6","0","0","0","2","1","1","0","0","0","-2"
"110422","California Polytechnic State University-San Luis Obispo","2014","On-tenure track, assistant professors","142","80","62","2","1","1","13","8","5","1","1","0","6","5","1","0","0","0","107","54","53","1","0","1","3","3","0","9","8","1","-2"
"110422","California Polytechnic State University-San Luis Obispo","2014","On-tenure track, no academic rank","1","1","0","0","0","0","0","0","0","0","0","0","0","0","0","0","0","0","1","1","0","0","0","0","0","0","0","0","0","0","-2"
"110422","California Polytechnic State University-San Luis Obispo","2014","Not on tenure track/No tenure system system total","154","94","60","0","0","0","4","1","3","0","0","0","3","3","0","0","0","0","131","78","53","1","1","0","9","7","2","6","4","2","-2"
"110422","California Polytechnic State University-San Luis Obispo","2014","Not on tenure/no tenure system, lecturers","154","94","60","0","0","0","4","1","3","0","0","0","3","3","0","0","0","0","131","78","53","1","1","0","9","7","2","6","4","2","-2"
"111188","California State University Maritime Academy","2014","Tenured total","24","20","4","0","0","0","1","0","1","1","1","0","2","1","1","0","0","0","20","18","2","0","0","0","0","0","0","0","0","0","-2"
"111188","California State University Maritime Academy","2014","Tenured, professors","19","16","3","0","0","0","1","0","1","0","0","0","1","1","0","0","0","0","17","15","2","0","0","0","0","0","0","0","0","0","-2"
"111188","California State University Maritime Academy","2014","Tenured, associate professors","4","3","1","0","0","0","0","0","0","1","1","0","1","0","1","0","0","0","2","2","0","0","0","0","0","0","0","0","0","0","-2"
"111188","California State University Maritime Academy","2014","Tenured, assistant professors","1","1","0","0","0","0","0","0","0","0","0","0","0","0","0","0","0","0","1","1","0","0","0","0","0","0","0","0","0","0","-2"
"111188","California State University Maritime Academy","2014","On-Tenure track total","26","20","6","0","0","0","5","4","1","0","0","0","1","1","0","0","0","0","19","14","5","0","0","0","1","1","0","0","0","0","-2"
"111188","California State University Maritime Academy","2014","On-tenure track, professors","1","0","1","0","0","0","0","0","0","0","0","0","0","0","0","0","0","0","1","0","1","0","0","0","0","0","0","0","0","0","-2"
"111188","California State University Maritime Academy","2014","On-tenure track, associate professors","5","3","2","0","0","0","1","0","1","0","0","0","0","0","0","0","0","0","4","3","1","0","0","0","0","0","0","0","0","0","-2"
"111188","California State University Maritime Academy","2014","On-tenure track, assistant professors","20","17","3","0","0","0","4","4","0","0","0","0","1","1","0","0","0","0","14","11","3","0","0","0","1","1","0","0","0","0","-2"
"111188","California State University Maritime Academy","2014","Not on tenure track/No tenure system system total","14","11","3","0","0","0","1","0","1","0","0","0","0","0","0","0","0","0","13","11","2","0","0","0","0","0","0","0","0","0","-2"
"111188","California State University Maritime Academy","2014","Not on tenure/no tenure system, lecturers","14","11","3","0","0","0","1","0","1","0","0","0","0","0","0","0","0","0","13","11","2","0","0","0","0","0","0","0","0","0","-2"
"111948","Chapman University","2014","Tenured total","202","135","67","1","1","0","14","8","6","4","3","1","5","3","2","0","0","0","164","111","53","2","1","1","11","8","3","1","0","1","-2"
"111948","Chapman University","2014","Tenured, professors","114","83","31","0","0","0","8","4","4","3","3","0","2","2","0","0","0","0","90","67","23","0","0","0","10","7","3","1","0","1","-2"
"111948","Chapman University","2014","Tenured, associate professors","88","52","36","1","1","0","6","4","2","1","0","1","3","1","2","0","0","0","74","44","30","2","1","1","1","1","0","0","0","0","-2"
"111948","Chapman University","2014","On-Tenure track total","81","41","40","0","0","0","5","1","4","2","1","1","3","1","2","0","0","0","29","17","12","0","0","0","30","14","16","12","7","5","-2"
"111948","Chapman University","2014","On-tenure track, associate professors","7","5","2","0","0","0","0","0","0","1","0","1","0","0","0","0","0","0","2","2","0","0","0","0","4","3","1","0","0","0","-2"
"111948","Chapman University","2014","On-tenure track, assistant professors","74","36","38","0","0","0","5","1","4","1","1","0","3","1","2","0","0","0","27","15","12","0","0","0","26","11","15","12","7","5","-2"
"111948","Chapman University","2014","Not on tenure track/No tenure system system total","135","76","59","0","0","0","7","3","4","3","2","1","7","2","5","0","0","0","82","46","36","0","0","0","33","21","12","3","2","1","-2"
"111948","Chapman University","2014","Not on tenure/no tenure system, professors","10","8","2","0","0","0","0","0","0","0","0","0","0","0","0","0","0","0","8","6","2","0","0","0","1","1","0","1","1","0","-2"
"111948","Chapman University","2014","Not on tenure/no tenure system, associate professors","31","19","12","0","0","0","0","0","0","1","1","0","1","0","1","0","0","0","24","14","10","0","0","0","5","4","1","0","0","0","-2"
"111948","Chapman University","2014","Not on tenure/no tenure system, assistant professors","59","34","25","0","0","0","4","2","2","1","0","1","4","1","3","0","0","0","31","18","13","0","0","0","17","12","5","2","1","1","-2"
"111948","Chapman University","2014","Not on tenure/no tenure system, instructors","35","15","20","0","0","0","3","1","2","1","1","0","2","1","1","0","0","0","19","8","11","0","0","0","10","4","6","0","0","0","-2"
"112260","Claremont McKenna College","2014","Tenured total","99","72","27","0","0","0","9","5","4","2","1","1","4","4","0","0","0","0","80","60","20","0","0","0","1","1","0","3","1","2","-2"
"112260","Claremont McKenna College","2014","Tenured, professors","54","40","14","0","0","0","2","2","0","2","1","1","2","2","0","0","0","0","47","35","12","0","0","0","0","0","0","1","0","1","-2"
"112260","Claremont McKenna College","2014","Tenured, associate professors","44","31","13","0","0","0","7","3","4","0","0","0","2","2","0","0","0","0","32","24","8","0","0","0","1","1","0","2","1","1","-2"
"112260","Claremont McKenna College","2014","Tenured, lecturers","1","1","0","0","0","0","0","0","0","0","0","0","0","0","0","0","0","0","1","1","0","0","0","0","0","0","0","0","0","0","-2"
"112260","Claremont McKenna College","2014","On-Tenure track total","31","17","14","0","0","0","2","2","0","0","0","0","1","0","1","0","0","0","22","11","11","1","0","1","0","0","0","5","4","1","-2"
"112260","Claremont McKenna College","2014","On-tenure track, associate professors","2","1","1","0","0","0","0","0","0","0","0","0","0","0","0","0","0","0","1","0","1","0","0","0","0","0","0","1","1","0","-2"
"112260","Claremont McKenna College","2014","On-tenure track, assistant professors","29","16","13","0","0","0","2","2","0","0","0","0","1","0","1","0","0","0","21","11","10","1","0","1","0","0","0","4","3","1","-2"
"112260","Claremont McKenna College","2014","Not on tenure track/No tenure system system total","37","23","14","0","0","0","4","3","1","0","0","0","4","2","2","0","0","0","27","16","11","0","0","0","1","1","0","1","1","0","-2"
"112260","Claremont McKenna College","2014","Not on tenure/no tenure system, professors","1","1","0","0","0","0","0","0","0","0","0","0","0","0","0","0","0","0","1","1","0","0","0","0","0","0","0","0","0","0","-2"
"112260","Claremont McKenna College","2014","Not on tenure/no tenure system, associate professors","6","3","3","0","0","0","0","0","0","0","0","0","1","0","1","0","0","0","5","3","2","0","0","0","0","0","0","0","0","0","-2"
"112260","Claremont McKenna College","2014","Not on tenure/no tenure system, assistant professors","28","19","9","0","0","0","4","3","1","0","0","0","2","2","0","0","0","0","20","12","8","0","0","0","1","1","0","1","1","0","-2"
"112260","Claremont McKenna College","2014","Not on tenure/no tenure system, instructors","2","0","2","0","0","0","0","0","0","0","0","0","1","0","1","0","0","0","1","0","1","0","0","0","0","0","0","0","0","0","-2"
"115409","Harvey Mudd College","2014","Tenured total","67","43","24","0","0","0","10","4","6","2","1","1","3","2","1","0","0","0","52","36","16","0","0","0","0","0","0","0","0","0","-2"
"115409","Harvey Mudd College","2014","Tenured, professors","48","37","11","0","0","0","5","3","2","1","1","0","3","2","1","0","0","0","39","31","8","0","0","0","0","0","0","0","0","0","-2"
"115409","Harvey Mudd College","2014","Tenured, associate professors","19","6","13","0","0","0","5","1","4","1","0","1","0","0","0","0","0","0","13","5","8","0","0","0","0","0","0","0","0","0","-2"
"115409","Harvey Mudd College","2014","On-Tenure track total","18","8","10","0","0","0","1","1","0","0","0","0","0","0","0","0","0","0","15","6","9","1","0","1","0","0","0","1","1","0","-2"
"115409","Harvey Mudd College","2014","On-tenure track, associate professors","4","3","1","0","0","0","0","0","0","0","0","0","0","0","0","0","0","0","4","3","1","0","0","0","0","0","0","0","0","0","-2"
"115409","Harvey Mudd College","2014","On-tenure track, assistant professors","14","5","9","0","0","0","1","1","0","0","0","0","0","0","0","0","0","0","11","3","8","1","0","1","0","0","0","1","1","0","-2"
"115409","Harvey Mudd College","2014","Not on tenure track/No tenure system system total","9","5","4","0","0","0","4","2","2","0","0","0","0","0","0","1","0","1","4","3","1","0","0","0","0","0","0","0","0","0","-2"
"115409","Harvey Mudd College","2014","Not on tenure/no tenure system, professors","1","1","0","0","0","0","1","1","0","0","0","0","0","0","0","0","0","0","0","0","0","0","0","0","0","0","0","0","0","0","-2"
"115409","Harvey Mudd College","2014","Not on tenure/no tenure system, assistant professors","8","4","4","0","0","0","3","1","2","0","0","0","0","0","0","1","0","1","4","3","1","0","0","0","0","0","0","0","0","0","-2"
"117946","Loyola Marymount University","2014","Tenured total","349","217","132","1","0","1","32","22","10","16","13","3","38","17","21","0","0","0","236","148","88","6","3","3","20","14","6","0","0","0","-2"
"117946","Loyola Marymount University","2014","Tenured, professors","208","144","64","0","0","0","16","12","4","10","7","3","19","7","12","0","0","0","144","105","39","2","1","1","17","12","5","0","0","0","-2"
"117946","Loyola Marymount University","2014","Tenured, associate professors","135","68","67","1","0","1","15","9","6","6","6","0","18","9","9","0","0","0","89","41","48","3","1","2","3","2","1","0","0","0","-2"
"117946","Loyola Marymount University","2014","Tenured, assistant professors","6","5","1","0","0","0","1","1","0","0","0","0","1","1","0","0","0","0","3","2","1","1","1","0","0","0","0","0","0","0","-2"
"117946","Loyola Marymount University","2014","On-Tenure track total","80","35","45","0","0","0","13","1","12","10","4","6","9","4","5","0","0","0","42","22","20","0","0","0","0","0","0","6","4","2","-2"
"117946","Loyola Marymount University","2014","On-tenure track, professors","1","1","0","0","0","0","0","0","0","1","1","0","0","0","0","0","0","0","0","0","0","0","0","0","0","0","0","0","0","0","-2"
"117946","Loyola Marymount University","2014","On-tenure track, associate professors","9","4","5","0","0","0","1","1","0","2","0","2","2","1","1","0","0","0","4","2","2","0","0","0","0","0","0","0","0","0","-2"
"117946","Loyola Marymount University","2014","On-tenure track, assistant professors","70","30","40","0","0","0","12","0","12","7","3","4","7","3","4","0","0","0","38","20","18","0","0","0","0","0","0","6","4","2","-2"
"117946","Loyola Marymount University","2014","Not on tenure track/No tenure system system total","121","56","65","0","0","0","13","5","8","6","3","3","10","5","5","0","0","0","83","40","43","4","2","2","5","1","4","0","0","0","-2"
"117946","Loyola Marymount University","2014","Not on tenure/no tenure system, professors","6","5","1","0","0","0","0","0","0","0","0","0","0","0","0","0","0","0","5","5","0","0","0","0","1","0","1","0","0","0","-2"
"117946","Loyola Marymount University","2014","Not on tenure/no tenure system, associate professors","35","8","27","0","0","0","3","0","3","1","0","1","3","0","3","0","0","0","27","8","19","0","0","0","1","0","1","0","0","0","-2"
"117946","Loyola Marymount University","2014","Not on tenure/no tenure system, assistant professors","72","36","36","0","0","0","10","5","5","5","3","2","5","3","2","0","0","0","47","24","23","3","1","2","2","0","2","0","0","0","-2"
"117946","Loyola Marymount University","2014","Not on tenure/no tenure system, instructors","6","5","1","0","0","0","0","0","0","0","0","0","1","1","0","0","0","0","4","3","1","1","1","0","0","0","0","0","0","0","-2"
"117946","Loyola Marymount University","2014","Not on tenure/no tenure system, no academic rank","2","2","0","0","0","0","0","0","0","0","0","0","1","1","0","0","0","0","0","0","0","0","0","0","1","1","0","0","0","0","-2"
"120698","Palo Alto University","2014","Tenured total","12","7","5","0","0","0","2","0","2","1","1","0","1","1","0","0","0","0","8","5","3","0","0","0","0","0","0","0","0","0","-2"
"120698","Palo Alto University","2014","Tenured, professors","7","6","1","0","0","0","0","0","0","1","1","0","1","1","0","0","0","0","5","4","1","0","0","0","0","0","0","0","0","0","-2"
"120698","Palo Alto University","2014","Tenured, associate professors","5","1","4","0","0","0","2","0","2","0","0","0","0","0","0","0","0","0","3","1","2","0","0","0","0","0","0","0","0","0","-2"
"120698","Palo Alto University","2014","On-Tenure track total","7","1","6","0","0","0","0","0","0","0","0","0","1","0","1","0","0","0","6","1","5","0","0","0","0","0","0","0","0","0","-2"
"120698","Palo Alto University","2014","On-tenure track, assistant professors","7","1","6","0","0","0","0","0","0","0","0","0","1","0","1","0","0","0","6","1","5","0","0","0","0","0","0","0","0","0","-2"
"120698","Palo Alto University","2014","Not on tenure track/No tenure system system total","11","4","7","0","0","0","1","0","1","1","0","1","1","1","0","0","0","0","7","3","4","1","0","1","0","0","0","0","0","0","-2"
"120698","Palo Alto University","2014","Not on tenure/no tenure system, professors","2","1","1","0","0","0","0","0","0","0","0","0","0","0","0","0","0","0","2","1","1","0","0","0","0","0","0","0","0","0","-2"
"120698","Palo Alto University","2014","Not on tenure/no tenure system, associate professors","5","2","3","0","0","0","1","0","1","0","0","0","1","1","0","0","0","0","3","1","2","0","0","0","0","0","0","0","0","0","-2"
"120698","Palo Alto University","2014","Not on tenure/no tenure system, assistant professors","4","1","3","0","0","0","0","0","0","1","0","1","0","0","0","0","0","0","2","1","1","1","0","1","0","0","0","0","0","0","-2"
"121309","Point Loma Nazarene University","2014","Tenured total","75","53","22","0","0","0","4","2","2","2","2","0","4","1","3","0","0","0","65","48","17","0","0","0","0","0","0","0","0","0","-2"
"121309","Point Loma Nazarene University","2014","Tenured, professors","74","53","21","0","0","0","4","2","2","2","2","0","3","1","2","0","0","0","65","48","17","0","0","0","0","0","0","0","0","0","-2"
"121309","Point Loma Nazarene University","2014","Tenured, associate professors","1","0","1","0","0","0","0","0","0","0","0","0","1","0","1","0","0","0","0","0","0","0","0","0","0","0","0","0","0","0","-2"
"121309","Point Loma Nazarene University","2014","On-Tenure track total","61","27","34","0","0","0","7","3","4","2","0","2","3","1","2","0","0","0","49","23","26","0","0","0","0","0","0","0","0","0","-2"
"121309","Point Loma Nazarene University","2014","On-tenure track, professors","10","3","7","0","0","0","1","0","1","1","0","1","1","0","1","0","0","0","7","3","4","0","0","0","0","0","0","0","0","0","-2"
"121309","Point Loma Nazarene University","2014","On-tenure track, associate professors","25","12","13","0","0","0","2","0","2","0","0","0","2","1","1","0","0","0","21","11","10","0","0","0","0","0","0","0","0","0","-2"
"121309","Point Loma Nazarene University","2014","On-tenure track, assistant professors","26","12","14","0","0","0","4","3","1","1","0","1","0","0","0","0","0","0","21","9","12","0","0","0","0","0","0","0","0","0","-2"
"121345","Pomona College","2014","Tenured total","151","89","62","0","0","0","20","8","12","4","3","1","19","12","7","0","0","0","87","50","37","4","4","0","17","12","5","0","0","0","-2"
"121345","Pomona College","2014","Tenured, professors","82","51","31","0","0","0","10","3","7","2","1","1","11","6","5","0","0","0","49","32","17","2","2","0","8","7","1","0","0","0","-2"
"121345","Pomona College","2014","Tenured, associate professors","69","38","31","0","0","0","10","5","5","2","2","0","8","6","2","0","0","0","38","18","20","2","2","0","9","5","4","0","0","0","-2"
"121345","Pomona College","2014","On-Tenure track total","32","18","14","0","0","0","3","1","2","1","0","1","0","0","0","0","0","0","19","13","6","0","0","0","7","3","4","2","1","1","-2"
"121345","Pomona College","2014","On-tenure track, associate professors","1","1","0","0","0","0","0","0","0","0","0","0","0","0","0","0","0","0","1","1","0","0","0","0","0","0","0","0","0","0","-2"
"121345","Pomona College","2014","On-tenure track, assistant professors","31","17","14","0","0","0","3","1","2","1","0","1","0","0","0","0","0","0","18","12","6","0","0","0","7","3","4","2","1","1","-2"
"121345","Pomona College","2014","Not on tenure track/No tenure system system total","3","0","3","0","0","0","1","0","1","0","0","0","2","0","2","0","0","0","0","0","0","0","0","0","0","0","0","0","0","0","-2"
"121345","Pomona College","2014","Not on tenure/no tenure system, professors","3","0","3","0","0","0","1","0","1","0","0","0","2","0","2","0","0","0","0","0","0","0","0","0","0","0","0","0","0","0","-2"
"122296","Samuel Merritt University","2014","Not on tenure track/No tenure system system total","111","23","88","0","0","0","9","2","7","4","0","4","4","0","4","0","0","0","92","21","71","2","0","2","0","0","0","0","0","0","-2"
"122296","Samuel Merritt University","2014","Not on tenure/no tenure system, professors","11","5","6","0","0","0","1","0","1","0","0","0","0","0","0","0","0","0","10","5","5","0","0","0","0","0","0","0","0","0","-2"
"122296","Samuel Merritt University","2014","Not on tenure/no tenure system, associate professors","21","4","17","0","0","0","3","1","2","1","0","1","1","0","1","0","0","0","16","3","13","0","0","0","0","0","0","0","0","0","-2"
"122296","Samuel Merritt University","2014","Not on tenure/no tenure system, assistant professors","58","13","45","0","0","0","5","1","4","0","0","0","2","0","2","0","0","0","49","12","37","2","0","2","0","0","0","0","0","0","-2"
"122296","Samuel Merritt University","2014","Not on tenure/no tenure system, instructors","21","1","20","0","0","0","0","0","0","3","0","3","1","0","1","0","0","0","17","1","16","0","0","0","0","0","0","0","0","0","-2"
"122436","University of San Diego","2014","Tenured total","253","148","105","1","0","1","22","11","11","7","6","1","18","7","11","0","0","0","202","122","80","2","2","0","0","0","0","1","0","1","-2"
"122436","University of San Diego","2014","Tenured, professors","156","100","56","0","0","0","9","5","4","2","2","0","8","4","4","0","0","0","135","88","47","1","1","0","0","0","0","1","0","1","-2"
"122436","University of San Diego","2014","Tenured, associate professors","96","48","48","1","0","1","13","6","7","5","4","1","10","3","7","0","0","0","66","34","32","1","1","0","0","0","0","0","0","0","-2"
"122436","University of San Diego","2014","Tenured, assistant professors","1","0","1","0","0","0","0","0","0","0","0","0","0","0","0","0","0","0","1","0","1","0","0","0","0","0","0","0","0","0","-2"
"122436","University of San Diego","2014","On-Tenure track total","99","42","57","0","0","0","12","3","9","3","2","1","11","7","4","0","0","0","62","24","38","1","0","1","2","1","1","8","5","3","-2"
"122436","University of San Diego","2014","On-tenure track, professors","2","0","2","0","0","0","0","0","0","0","0","0","0","0","0","0","0","0","2","0","2","0","0","0","0","0","0","0","0","0","-2"
"122436","University of San Diego","2014","On-tenure track, associate professors","23","8","15","0","0","0","0","0","0","0","0","0","1","0","1","0","0","0","21","7","14","0","0","0","0","0","0","1","1","0","-2"
"122436","University of San Diego","2014","On-tenure track, assistant professors","74","34","40","0","0","0","12","3","9","3","2","1","10","7","3","0","0","0","39","17","22","1","0","1","2","1","1","7","4","3","-2"
"122436","University of San Diego","2014","Not on tenure track/No tenure system system total","54","25","29","1","1","0","3","1","2","1","1","0","3","1","2","0","0","0","44","19","25","1","1","0","0","0","0","1","1","0","-2"
"122436","University of San Diego","2014","Not on tenure/no tenure system, professors","14","5","9","0","0","0","0","0","0","0","0","0","1","0","1","0","0","0","12","4","8","0","0","0","0","0","0","1","1","0","-2"
"122436","University of San Diego","2014","Not on tenure/no tenure system, associate professors","8","5","3","1","1","0","0","0","0","1","1","0","0","0","0","0","0","0","5","2","3","1","1","0","0","0","0","0","0","0","-2"
"122436","University of San Diego","2014","Not on tenure/no tenure system, assistant professors","20","10","10","0","0","0","2","1","1","0","0","0","0","0","0","0","0","0","18","9","9","0","0","0","0","0","0","0","0","0","-2"
"122436","University of San Diego","2014","Not on tenure/no tenure system, instructors","12","5","7","0","0","0","1","0","1","0","0","0","2","1","1","0","0","0","9","4","5","0","0","0","0","0","0","0","0","0","-2"
"122454","San Francisco Art Institute","2014","Tenured total","19","12","7","0","0","0","1","1","0","1","1","0","1","1","0","0","0","0","16","9","7","0","0","0","0","0","0","0","0","0","-2"
"122454","San Francisco Art Institute","2014","Tenured, professors","4","3","1","0","0","0","1","1","0","0","0","0","1","1","0","0","0","0","2","1","1","0","0","0","0","0","0","0","0","0","-2"
"122454","San Francisco Art Institute","2014","Tenured, associate professors","15","9","6","0","0","0","0","0","0","1","1","0","0","0","0","0","0","0","14","8","6","0","0","0","0","0","0","0","0","0","-2"
"122454","San Francisco Art Institute","2014","On-Tenure track total","4","1","3","0","0","0","1","0","1","0","0","0","1","0","1","0","0","0","1","1","0","0","0","0","1","0","1","0","0","0","-2"
"122454","San Francisco Art Institute","2014","On-tenure track, assistant professors","4","1","3","0","0","0","1","0","1","0","0","0","1","0","1","0","0","0","1","1","0","0","0","0","1","0","1","0","0","0","-2"
"122612","University of San Francisco","2014","Tenured total","250","142","108","0","0","0","29","17","12","11","3","8","21","14","7","1","1","0","152","89","63","7","6","1","28","12","16","1","0","1","-2"
"122612","University of San Francisco","2014","Tenured, professors","130","87","43","0","0","0","11","8","3","4","1","3","8","6","2","1","1","0","86","57","29","6","5","1","14","9","5","0","0","0","-2"
"122612","University of San Francisco","2014","Tenured, associate professors","111","49","62","0","0","0","17","8","9","7","2","5","12","7","5","0","0","0","62","29","33","1","1","0","12","2","10","0","0","0","-2"
"122612","University of San Francisco","2014","Tenured, assistant professors","9","6","3","0","0","0","1","1","0","0","0","0","1","1","0","0","0","0","4","3","1","0","0","0","2","1","1","1","0","1","-2"
"122612","University of San Francisco","2014","On-Tenure track total","108","46","62","2","0","2","15","7","8","9","4","5","14","6","8","0","0","0","50","20","30","1","0","1","8","3","5","9","6","3","-2"
"122612","University of San Francisco","2014","On-tenure track, professors","1","0","1","0","0","0","0","0","0","0","0","0","0","0","0","0","0","0","1","0","1","0","0","0","0","0","0","0","0","0","-2"
"122612","University of San Francisco","2014","On-tenure track, associate professors","14","9","5","0","0","0","3","1","2","0","0","0","4","3","1","0","0","0","5","3","2","0","0","0","1","1","0","1","1","0","-2"
"122612","University of San Francisco","2014","On-tenure track, assistant professors","93","37","56","2","0","2","12","6","6","9","4","5","10","3","7","0","0","0","44","17","27","1","0","1","7","2","5","8","5","3","-2"
"122612","University of San Francisco","2014","Not on tenure track/No tenure system system total","121","53","68","0","0","0","16","6","10","5","1","4","13","4","9","0","0","0","68","33","35","9","4","5","7","3","4","3","2","1","-2"
"122612","University of San Francisco","2014","Not on tenure/no tenure system, professors","10","10","0","0","0","0","0","0","0","0","0","0","0","0","0","0","0","0","7","7","0","1","1","0","1","1","0","1","1","0","-2"
"122612","University of San Francisco","2014","Not on tenure/no tenure system, associate professors","12","2","10","0","0","0","0","0","0","1","0","1","3","1","2","0","0","0","7","1","6","0","0","0","1","0","1","0","0","0","-2"
"122612","University of San Francisco","2014","Not on tenure/no tenure system, assistant professors","78","34","44","0","0","0","14","6","8","3","0","3","9","3","6","0","0","0","40","21","19","6","2","4","4","1","3","2","1","1","-2"
"122612","University of San Francisco","2014","Not on tenure/no tenure system, instructors","21","7","14","0","0","0","2","0","2","1","1","0","1","0","1","0","0","0","14","4","10","2","1","1","1","1","0","0","0","0","-2"
"122931","Santa Clara University","2014","Tenured total","290","180","110","0","0","0","34","20","14","7","3","4","22","14","8","0","0","0","224","141","83","1","1","0","1","1","0","1","0","1","-2"
"122931","Santa Clara University","2014","Tenured, professors","151","100","51","0","0","0","14","12","2","2","2","0","9","8","1","0","0","0","125","77","48","1","1","0","0","0","0","0","0","0","-2"
"122931","Santa Clara University","2014","Tenured, associate professors","138","79","59","0","0","0","20","8","12","5","1","4","13","6","7","0","0","0","98","63","35","0","0","0","1","1","0","1","0","1","-2"
"122931","Santa Clara University","2014","Tenured, assistant professors","1","1","0","0","0","0","0","0","0","0","0","0","0","0","0","0","0","0","1","1","0","0","0","0","0","0","0","0","0","0","-2"
"122931","Santa Clara University","2014","On-Tenure track total","83","51","32","0","0","0","19","11","8","3","3","0","8","4","4","1","1","0","39","23","16","2","1","1","0","0","0","11","8","3","-2"
"122931","Santa Clara University","2014","On-tenure track, associate professors","4","3","1","0","0","0","1","1","0","0","0","0","1","0","1","0","0","0","1","1","0","0","0","0","0","0","0","1","1","0","-2"
"122931","Santa Clara University","2014","On-tenure track, assistant professors","79","48","31","0","0","0","18","10","8","3","3","0","7","4","3","1","1","0","38","22","16","2","1","1","0","0","0","10","7","3","-2"
"122931","Santa Clara University","2014","Not on tenure track/No tenure system system total","142","52","90","0","0","0","15","4","11","6","2","4","10","3","7","0","0","0","106","42","64","1","0","1","4","1","3","0","0","0","-2"
"122931","Santa Clara University","2014","Not on tenure/no tenure system, lecturers","138","50","88","0","0","0","15","4","11","6","2","4","10","3","7","0","0","0","102","40","62","1","0","1","4","1","3","0","0","0","-2"
"122931","Santa Clara University","2014","Not on tenure/no tenure system, no academic rank","4","2","2","0","0","0","0","0","0","0","0","0","0","0","0","0","0","0","4","2","2","0","0","0","0","0","0","0","0","0","-2"
"123299","Shasta College","2014","Tenured total","77","43","34","1","0","1","2","2","0","2","0","2","4","2","2","0","0","0","68","39","29","0","0","0","0","0","0","0","0","0","-2"
"123299","Shasta College","2014","Tenured, instructors","77","43","34","1","0","1","2","2","0","2","0","2","4","2","2","0","0","0","68","39","29","0","0","0","0","0","0","0","0","0","-2"
"123299","Shasta College","2014","On-Tenure track total","41","21","20","0","0","0","0","0","0","0","0","0","4","2","2","1","1","0","32","17","15","0","0","0","4","1","3","0","0","0","-2"
"123299","Shasta College","2014","On-tenure track, instructors","41","21","20","0","0","0","0","0","0","0","0","0","4","2","2","1","1","0","32","17","15","0","0","0","4","1","3","0","0","0","-2"
"123299","Shasta College","2014","Not on tenure track/No tenure system system total","6","2","4","0","0","0","0","0","0","1","1","0","1","1","0","0","0","0","3","0","3","0","0","0","1","0","1","0","0","0","-2"
"123299","Shasta College","2014","Not on tenure/no tenure system, instructors","6","2","4","0","0","0","0","0","0","1","1","0","1","1","0","0","0","0","3","0","3","0","0","0","1","0","1","0","0","0","-2"
"123457","Simpson University","2014","Not on tenure track/No tenure system system total","51","33","18","1","1","0","1","1","0","0","0","0","1","1","0","0","0","0","44","26","18","4","4","0","0","0","0","0","0","0","-2"
"123457","Simpson University","2014","Not on tenure/no tenure system, professors","7","7","0","0","0","0","0","0","0","0","0","0","0","0","0","0","0","0","6","6","0","1","1","0","0","0","0","0","0","0","-2"
"123457","Simpson University","2014","Not on tenure/no tenure system, associate professors","12","8","4","1","1","0","0","0","0","0","0","0","0","0","0","0","0","0","10","6","4","1","1","0","0","0","0","0","0","0","-2"
"123457","Simpson University","2014","Not on tenure/no tenure system, assistant professors","28","16","12","0","0","0","1","1","0","0","0","0","1","1","0","0","0","0","25","13","12","1","1","0","0","0","0","0","0","0","-2"
"123457","Simpson University","2014","Not on tenure/no tenure system, instructors","4","2","2","0","0","0","0","0","0","0","0","0","0","0","0","0","0","0","3","1","2","1","1","0","0","0","0","0","0","0","-2"
"124292","Thomas Aquinas College","2014","Not on tenure track/No tenure system system total","32","28","4","0","0","0","0","0","0","0","0","0","2","2","0","0","0","0","25","23","2","2","2","0","2","1","1","1","0","1","-2"
"124292","Thomas Aquinas College","2014","Not on tenure/no tenure system, professors","15","13","2","0","0","0","0","0","0","0","0","0","1","1","0","0","0","0","13","12","1","0","0","0","0","0","0","1","0","1","-2"
"124292","Thomas Aquinas College","2014","Not on tenure/no tenure system, associate professors","10","10","0","0","0","0","0","0","0","0","0","0","1","1","0","0","0","0","7","7","0","2","2","0","0","0","0","0","0","0","-2"
"124292","Thomas Aquinas College","2014","Not on tenure/no tenure system, assistant professors","7","5","2","0","0","0","0","0","0","0","0","0","0","0","0","0","0","0","5","4","1","0","0","0","2","1","1","0","0","0","-2"
"125727","Westmont College","2014","Tenured total","62","45","17","0","0","0","3","2","1","1","1","0","3","1","2","0","0","0","55","41","14","0","0","0","0","0","0","0","0","0","-2"
"125727","Westmont College","2014","Tenured, professors","45","36","9","0","0","0","2","2","0","0","0","0","2","1","1","0","0","0","41","33","8","0","0","0","0","0","0","0","0","0","-2"
"125727","Westmont College","2014","Tenured, associate professors","16","8","8","0","0","0","1","0","1","1","1","0","1","0","1","0","0","0","13","7","6","0","0","0","0","0","0","0","0","0","-2"
"125727","Westmont College","2014","Tenured, assistant professors","1","1","0","0","0","0","0","0","0","0","0","0","0","0","0","0","0","0","1","1","0","0","0","0","0","0","0","0","0","0","-2"
"125727","Westmont College","2014","On-Tenure track total","14","4","10","1","0","1","3","2","1","0","0","0","0","0","0","0","0","0","9","2","7","1","0","1","0","0","0","0","0","0","-2"
"125727","Westmont College","2014","On-tenure track, associate professors","2","0","2","0","0","0","1","0","1","0","0","0","0","0","0","0","0","0","1","0","1","0","0","0","0","0","0","0","0","0","-2"
"125727","Westmont College","2014","On-tenure track, assistant professors","12","4","8","1","0","1","2","2","0","0","0","0","0","0","0","0","0","0","8","2","6","1","0","1","0","0","0","0","0","0","-2"
"125727","Westmont College","2014","Not on tenure track/No tenure system system total","19","8","11","1","0","1","1","1","0","0","0","0","2","2","0","0","0","0","15","5","10","0","0","0","0","0","0","0","0","0","-2"
"125727","Westmont College","2014","Not on tenure/no tenure system, professors","1","1","0","0","0","0","0","0","0","0","0","0","1","1","0","0","0","0","0","0","0","0","0","0","0","0","0","0","0","0","-2"
"125727","Westmont College","2014","Not on tenure/no tenure system, associate professors","4","2","2","0","0","0","0","0","0","0","0","0","0","0","0","0","0","0","4","2","2","0","0","0","0","0","0","0","0","0","-2"
"125727","Westmont College","2014","Not on tenure/no tenure system, assistant professors","9","4","5","0","0","0","1","1","0","0","0","0","1","1","0","0","0","0","7","2","5","0","0","0","0","0","0","0","0","0","-2"
"125727","Westmont College","2014","Not on tenure/no tenure system, instructors","5","1","4","1","0","1","0","0","0","0","0","0","0","0","0","0","0","0","4","1","3","0","0","0","0","0","0","0","0","0","-2"
"127556","Colorado Mesa University","2014","Tenured total","84","52","32","0","0","0","2","2","0","1","1","0","1","1","0","0","0","0","66","39","27","0","0","0","11","7","4","3","2","1","-2"
"127556","Colorado Mesa University","2014","Tenured, professors","55","31","24","0","0","0","1","1","0","0","0","0","1","1","0","0","0","0","42","22","20","0","0","0","10","7","3","1","0","1","-2"
"127556","Colorado Mesa University","2014","Tenured, associate professors","27","19","8","0","0","0","1","1","0","0","0","0","0","0","0","0","0","0","23","16","7","0","0","0","1","0","1","2","2","0","-2"
"127556","Colorado Mesa University","2014","Tenured, assistant professors","1","1","0","0","0","0","0","0","0","1","1","0","0","0","0","0","0","0","0","0","0","0","0","0","0","0","0","0","0","0","-2"
"127556","Colorado Mesa University","2014","Tenured, instructors","1","1","0","0","0","0","0","0","0","0","0","0","0","0","0","0","0","0","1","1","0","0","0","0","0","0","0","0","0","0","-2"
"127556","Colorado Mesa University","2014","On-Tenure track total","86","46","40","0","0","0","1","1","0","0","0","0","1","0","1","0","0","0","67","34","33","1","0","1","10","9","1","6","2","4","-2"
"127556","Colorado Mesa University","2014","On-tenure track, professors","3","3","0","0","0","0","0","0","0","0","0","0","0","0","0","0","0","0","2","2","0","0","0","0","1","1","0","0","0","0","-2"
"127556","Colorado Mesa University","2014","On-tenure track, associate professors","4","2","2","0","0","0","0","0","0","0","0","0","0","0","0","0","0","0","4","2","2","0","0","0","0","0","0","0","0","0","-2"
"127556","Colorado Mesa University","2014","On-tenure track, assistant professors","77","39","38","0","0","0","1","1","0","0","0","0","1","0","1","0","0","0","60","29","31","1","0","1","9","8","1","5","1","4","-2"
"127556","Colorado Mesa University","2014","On-tenure track, instructors","2","2","0","0","0","0","0","0","0","0","0","0","0","0","0","0","0","0","1","1","0","0","0","0","0","0","0","1","1","0","-2"
"127556","Colorado Mesa University","2014","Not on tenure track/No tenure system system total","92","44","48","0","0","0","0","0","0","0","0","0","2","1","1","0","0","0","74","35","39","0","0","0","12","7","5","4","1","3","-2"
"127556","Colorado Mesa University","2014","Not on tenure/no tenure system, associate professors","1","0","1","0","0","0","0","0","0","0","0","0","0","0","0","0","0","0","1","0","1","0","0","0","0","0","0","0","0","0","-2"
"127556","Colorado Mesa University","2014","Not on tenure/no tenure system, assistant professors","2","1","1","0","0","0","0","0","0","0","0","0","0","0","0","0","0","0","2","1","1","0","0","0","0","0","0","0","0","0","-2"
"127556","Colorado Mesa University","2014","Not on tenure/no tenure system, instructors","80","40","40","0","0","0","0","0","0","0","0","0","2","1","1","0","0","0","65","33","32","0","0","0","9","5","4","4","1","3","-2"
"127556","Colorado Mesa University","2014","Not on tenure/no tenure system, lecturers","6","2","4","0","0","0","0","0","0","0","0","0","0","0","0","0","0","0","4","0","4","0","0","0","2","2","0","0","0","0","-2"
"127556","Colorado Mesa University","2014","Not on tenure/no tenure system, no academic rank","3","1","2","0","0","0","0","0","0","0","0","0","0","0","0","0","0","0","2","1","1","0","0","0","1","0","1","0","0","0","-2"
"127820","Pikes Peak Community College","2014","Not on tenure track/No tenure system system total","169","63","106","0","0","0","4","2","2","6","3","3","4","3","1","0","0","0","132","48","84","0","0","0","23","7","16","0","0","0","-2"
"127820","Pikes Peak Community College","2014","Not on tenure/no tenure system, no academic rank","169","63","106","0","0","0","4","2","2","6","3","3","4","3","1","0","0","0","132","48","84","0","0","0","23","7","16","0","0","0","-2"
"128771","Central Connecticut State University","2014","Tenured total","314","185","129","2","2","0","23","16","7","19","11","8","17","12","5","0","0","0","250","142","108","3","2","1","0","0","0","0","0","0","-2"
"128771","Central Connecticut State University","2014","Tenured, professors","191","121","70","2","2","0","15","9","6","13","8","5","13","10","3","0","0","0","146","91","55","2","1","1","0","0","0","0","0","0","-2"
"128771","Central Connecticut State University","2014","Tenured, associate professors","115","60","55","0","0","0","8","7","1","5","3","2","4","2","2","0","0","0","97","47","50","1","1","0","0","0","0","0","0","0","-2"
"128771","Central Connecticut State University","2014","Tenured, assistant professors","8","4","4","0","0","0","0","0","0","1","0","1","0","0","0","0","0","0","7","4","3","0","0","0","0","0","0","0","0","0","-2"
"128771","Central Connecticut State University","2014","On-Tenure track total","112","65","47","0","0","0","11","7","4","4","1","3","7","1","6","0","0","0","66","37","29","1","1","0","0","0","0","23","18","5","-2"
"128771","Central Connecticut State University","2014","On-tenure track, associate professors","24","18","6","0","0","0","5","4","1","0","0","0","0","0","0","0","0","0","12","9","3","0","0","0","0","0","0","7","5","2","-2"
"128771","Central Connecticut State University","2014","On-tenure track, assistant professors","83","44","39","0","0","0","5","3","2","4","1","3","7","1","6","0","0","0","51","26","25","1","1","0","0","0","0","15","12","3","-2"
"128771","Central Connecticut State University","2014","On-tenure track, instructors","5","3","2","0","0","0","1","0","1","0","0","0","0","0","0","0","0","0","3","2","1","0","0","0","0","0","0","1","1","0","-2"
"128771","Central Connecticut State University","2014","Not on tenure track/No tenure system system total","25","9","16","0","0","0","0","0","0","1","0","1","1","0","1","0","0","0","22","8","14","1","1","0","0","0","0","0","0","0","-2"
"128771","Central Connecticut State University","2014","Not on tenure/no tenure system, associate professors","3","2","1","0","0","0","0","0","0","0","0","0","0","0","0","0","0","0","3","2","1","0","0","0","0","0","0","0","0","0","-2"
"128771","Central Connecticut State University","2014","Not on tenure/no tenure system, assistant professors","14","6","8","0","0","0","0","0","0","1","0","1","1","0","1","0","0","0","11","5","6","1","1","0","0","0","0","0","0","0","-2"
"128771","Central Connecticut State University","2014","Not on tenure/no tenure system, instructors","8","1","7","0","0","0","0","0","0","0","0","0","0","0","0","0","0","0","8","1","7","0","0","0","0","0","0","0","0","0","-2"
"129154","Goodwin University","2014","Not on tenure track/No tenure system system total","90","27","63","0","0","0","2","0","2","11","4","7","5","1","4","0","0","0","72","22","50","0","0","0","0","0","0","0","0","0","-2"
"129154","Goodwin University","2014","Not on tenure/no tenure system, associate professors","21","7","14","0","0","0","1","0","1","0","0","0","0","0","0","0","0","0","20","7","13","0","0","0","0","0","0","0","0","0","-2"
"129154","Goodwin University","2014","Not on tenure/no tenure system, assistant professors","51","17","34","0","0","0","1","0","1","11","4","7","5","1","4","0","0","0","34","12","22","0","0","0","0","0","0","0","0","0","-2"
"129154","Goodwin University","2014","Not on tenure/no tenure system, instructors","18","3","15","0","0","0","0","0","0","0","0","0","0","0","0","0","0","0","18","3","15","0","0","0","0","0","0","0","0","0","-2"
"132693","Eastern Florida State College","2014","Tenured total","180","74","106","0","0","0","9","5","4","11","6","5","4","1","3","0","0","0","151","59","92","4","3","1","1","0","1","0","0","0","-2"
"132693","Eastern Florida State College","2014","Tenured, professors","47","23","24","0","0","0","5","3","2","1","1","0","2","1","1","0","0","0","36","15","21","3","3","0","0","0","0","0","0","0","-2"
"132693","Eastern Florida State College","2014","Tenured, associate professors","45","17","28","0","0","0","2","1","1","5","2","3","1","0","1","0","0","0","37","14","23","0","0","0","0","0","0","0","0","0","-2"
"132693","Eastern Florida State College","2014","Tenured, assistant professors","47","17","30","0","0","0","2","1","1","2","1","1","1","0","1","0","0","0","40","15","25","1","0","1","1","0","1","0","0","0","-2"
"132693","Eastern Florida State College","2014","Tenured, instructors","41","17","24","0","0","0","0","0","0","3","2","1","0","0","0","0","0","0","38","15","23","0","0","0","0","0","0","0","0","0","-2"
"132693","Eastern Florida State College","2014","On-Tenure track total","36","15","21","0","0","0","2","1","1","5","1","4","0","0","0","0","0","0","29","13","16","0","0","0","0","0","0","0","0","0","-2"
"132693","Eastern Florida State College","2014","On-tenure track, assistant professors","2","2","0","0","0","0","0","0","0","0","0","0","0","0","0","0","0","0","2","2","0","0","0","0","0","0","0","0","0","0","-2"
"132693","Eastern Florida State College","2014","On-tenure track, instructors","34","13","21","0","0","0","2","1","1","5","1","4","0","0","0","0","0","0","27","11","16","0","0","0","0","0","0","0","0","0","-2"
"132693","Eastern Florida State College","2014","Not on tenure track/No tenure system system total","5","3","2","0","0","0","0","0","0","0","0","0","1","1","0","0","0","0","4","2","2","0","0","0","0","0","0","0","0","0","-2"
"132693","Eastern Florida State College","2014","Not on tenure/no tenure system, instructors","5","3","2","0","0","0","0","0","0","0","0","0","1","1","0","0","0","0","4","2","2","0","0","0","0","0","0","0","0","0","-2"
"132879","Johnson University Florida","2014","Not on tenure track/No tenure system system total","12","8","4","0","0","0","1","0","1","0","0","0","0","0","0","0","0","0","11","8","3","0","0","0","0","0","0","0","0","0","-2"
"132879","Johnson University Florida","2014","Not on tenure/no tenure system, professors","10","7","3","0","0","0","1","0","1","0","0","0","0","0","0","0","0","0","9","7","2","0","0","0","0","0","0","0","0","0","-2"
"132879","Johnson University Florida","2014","Not on tenure/no tenure system, associate professors","1","1","0","0","0","0","0","0","0","0","0","0","0","0","0","0","0","0","1","1","0","0","0","0","0","0","0","0","0","0","-2"
"132879","Johnson University Florida","2014","Not on tenure/no tenure system, assistant professors","1","0","1","0","0","0","0","0","0","0","0","0","0","0","0","0","0","0","1","0","1","0","0","0","0","0","0","0","0","0","-2"
"133386","Daytona State College","2014","Tenured total","241","125","116","1","0","1","8","6","2","16","8","8","10","7","3","0","0","0","204","102","102","0","0","0","0","0","0","2","2","0","-2"
"133386","Daytona State College","2014","Tenured, professors","104","51","53","0","0","0","5","4","1","7","3","4","5","3","2","0","0","0","86","40","46","0","0","0","0","0","0","1","1","0","-2"
"133386","Daytona State College","2014","Tenured, associate professors","91","48","43","1","0","1","2","2","0","7","4","3","2","2","0","0","0","0","79","40","39","0","0","0","0","0","0","0","0","0","-2"
"133386","Daytona State College","2014","Tenured, assistant professors","44","24","20","0","0","0","1","0","1","2","1","1","3","2","1","0","0","0","37","20","17","0","0","0","0","0","0","1","1","0","-2"
"133386","Daytona State College","2014","Tenured, instructors","2","2","0","0","0","0","0","0","0","0","0","0","0","0","0","0","0","0","2","2","0","0","0","0","0","0","0","0","0","0","-2"
"133386","Daytona State College","2014","On-Tenure track total","44","15","29","0","0","0","1","0","1","7","2","5","2","0","2","0","0","0","33","13","20","0","0","0","0","0","0","1","0","1","-2"
"133386","Daytona State College","2014","On-tenure track, associate professors","13","4","9","0","0","0","1","0","1","3","1","2","0","0","0","0","0","0","8","3","5","0","0","0","0","0","0","1","0","1","-2"
"133386","Daytona State College","2014","On-tenure track, assistant professors","23","6","17","0","0","0","0","0","0","4","1","3","2","0","2","0","0","0","17","5","12","0","0","0","0","0","0","0","0","0","-2"
"133386","Daytona State College","2014","On-tenure track, instructors","8","5","3","0","0","0","0","0","0","0","0","0","0","0","0","0","0","0","8","5","3","0","0","0","0","0","0","0","0","0","-2"
"133386","Daytona State College","2014","Not on tenure track/No tenure system system total","7","2","5","0","0","0","0","0","0","1","0","1","0","0","0","0","0","0","6","2","4","0","0","0","0","0","0","0","0","0","-2"
"133386","Daytona State College","2014","Not on tenure/no tenure system, associate professors","1","0","1","0","0","0","0","0","0","0","0","0","0","0","0","0","0","0","1","0","1","0","0","0","0","0","0","0","0","0","-2"
"133386","Daytona State College","2014","Not on tenure/no tenure system, assistant professors","2","0","2","0","0","0","0","0","0","1","0","1","0","0","0","0","0","0","1","0","1","0","0","0","0","0","0","0","0","0","-2"
"133386","Daytona State College","2014","Not on tenure/no tenure system, instructors","4","2","2","0","0","0","0","0","0","0","0","0","0","0","0","0","0","0","4","2","2","0","0","0","0","0","0","0","0","0","-2"
"134130","University of Florida","2014","Tenured total","1559","1161","398","1","1","0","191","153","38","48","26","22","83","63","20","0","0","0","1220","904","316","15","13","2","1","1","0","0","0","0","-2"
"134130","University of Florida","2014","Tenured, professors","958","763","195","0","0","0","111","96","15","16","11","5","37","32","5","0","0","0","785","617","168","8","6","2","1","1","0","0","0","0","-2"
"134130","University of Florida","2014","Tenured, associate professors","596","393","203","1","1","0","80","57","23","32","15","17","46","31","15","0","0","0","430","282","148","7","7","0","0","0","0","0","0","0","-2"
"134130","University of Florida","2014","Tenured, assistant professors","5","5","0","0","0","0","0","0","0","0","0","0","0","0","0","0","0","0","5","5","0","0","0","0","0","0","0","0","0","0","-2"
"134130","University of Florida","2014","On-Tenure track total","401","246","155","0","0","0","74","45","29","11","4","7","25","18","7","1","1","0","255","157","98","9","6","3","2","1","1","24","14","10","-2"
"134130","University of Florida","2014","On-tenure track, professors","22","18","4","0","0","0","3","3","0","1","1","0","2","2","0","0","0","0","14","10","4","0","0","0","0","0","0","2","2","0","-2"
"134130","University of Florida","2014","On-tenure track, associate professors","52","36","16","0","0","0","9","6","3","1","1","0","1","1","0","0","0","0","37","25","12","1","1","0","0","0","0","3","2","1","-2"
"134130","University of Florida","2014","On-tenure track, assistant professors","327","192","135","0","0","0","62","36","26","9","2","7","22","15","7","1","1","0","204","122","82","8","5","3","2","1","1","19","10","9","-2"
"134130","University of Florida","2014","Not on tenure track/No tenure system system total","512","224","288","2","1","1","43","17","26","24","10","14","25","9","16","0","0","0","389","170","219","3","1","2","5","3","2","21","13","8","-2"
"134130","University of Florida","2014","Not on tenure/no tenure system, professors","21","12","9","0","0","0","4","3","1","1","0","1","1","0","1","0","0","0","12","7","5","0","0","0","2","1","1","1","1","0","-2"
"134130","University of Florida","2014","Not on tenure/no tenure system, associate professors","15","11","4","0","0","0","2","2","0","0","0","0","1","1","0","0","0","0","10","6","4","0","0","0","1","1","0","1","1","0","-2"
"134130","University of Florida","2014","Not on tenure/no tenure system, assistant professors","51","26","25","0","0","0","5","3","2","2","2","0","1","1","0","0","0","0","34","14","20","1","0","1","0","0","0","8","6","2","-2"
"134130","University of Florida","2014","Not on tenure/no tenure system, lecturers","279","113","166","2","1","1","19","2","17","15","4","11","16","5","11","0","0","0","219","95","124","1","1","0","2","1","1","5","4","1","-2"
"134130","University of Florida","2014","Not on tenure/no tenure system, no academic rank","146","62","84","0","0","0","13","7","6","6","4","2","6","2","4","0","0","0","114","48","66","1","0","1","0","0","0","6","1","5","-2"
"135188","Lake-Sumter State College","2014","Tenured total","24","6","18","0","0","0","0","0","0","1","0","1","0","0","0","0","0","0","23","6","17","0","0","0","0","0","0","0","0","0","-2"
"135188","Lake-Sumter State College","2014","Tenured, professors","5","2","3","0","0","0","0","0","0","0","0","0","0","0","0","0","0","0","5","2","3","0","0","0","0","0","0","0","0","0","-2"
"135188","Lake-Sumter State College","2014","Tenured, associate professors","7","2","5","0","0","0","0","0","0","0","0","0","0","0","0","0","0","0","7","2","5","0","0","0","0","0","0","0","0","0","-2"
"135188","Lake-Sumter State College","2014","Tenured, assistant professors","6","2","4","0","0","0","0","0","0","1","0","1","0","0","0","0","0","0","5","2","3","0","0","0","0","0","0","0","0","0","-2"
"135188","Lake-Sumter State College","2014","Tenured, instructors","6","0","6","0","0","0","0","0","0","0","0","0","0","0","0","0","0","0","6","0","6","0","0","0","0","0","0","0","0","0","-2"
"135188","Lake-Sumter State College","2014","On-Tenure track total","42","16","26","1","1","0","0","0","0","3","2","1","1","1","0","0","0","0","37","12","25","0","0","0","0","0","0","0","0","0","-2"
"135188","Lake-Sumter State College","2014","On-tenure track, assistant professors","7","1","6","0","0","0","0","0","0","1","0","1","0","0","0","0","0","0","6","1","5","0","0","0","0","0","0","0","0","0","-2"
"135188","Lake-Sumter State College","2014","On-tenure track, instructors","33","15","18","1","1","0","0","0","0","2","2","0","1","1","0","0","0","0","29","11","18","0","0","0","0","0","0","0","0","0","-2"
"135188","Lake-Sumter State College","2014","On-tenure track, no academic rank","2","0","2","0","0","0","0","0","0","0","0","0","0","0","0","0","0","0","2","0","2","0","0","0","0","0","0","0","0","0","-2"
"135391","State College of Florida-Manatee-Sarasota","2014","Tenured total","106","42","64","0","0","0","3","3","0","6","4","2","6","2","4","0","0","0","89","33","56","0","0","0","2","0","2","0","0","0","-2"
"135391","State College of Florida-Manatee-Sarasota","2014","Tenured, professors","24","10","14","0","0","0","1","1","0","2","1","1","0","0","0","0","0","0","21","8","13","0","0","0","0","0","0","0","0","0","-2"
"135391","State College of Florida-Manatee-Sarasota","2014","Tenured, associate professors","31","12","19","0","0","0","1","1","0","1","1","0","2","0","2","0","0","0","26","10","16","0","0","0","1","0","1","0","0","0","-2"
"135391","State College of Florida-Manatee-Sarasota","2014","Tenured, assistant professors","36","14","22","0","0","0","1","1","0","2","2","0","4","2","2","0","0","0","28","9","19","0","0","0","1","0","1","0","0","0","-2"
"135391","State College of Florida-Manatee-Sarasota","2014","Tenured, instructors","15","6","9","0","0","0","0","0","0","1","0","1","0","0","0","0","0","0","14","6","8","0","0","0","0","0","0","0","0","0","-2"
"135391","State College of Florida-Manatee-Sarasota","2014","On-Tenure track total","17","6","11","0","0","0","0","0","0","0","0","0","1","1","0","0","0","0","16","5","11","0","0","0","0","0","0","0","0","0","-2"
"135391","State College of Florida-Manatee-Sarasota","2014","On-tenure track, associate professors","2","0","2","0","0","0","0","0","0","0","0","0","0","0","0","0","0","0","2","0","2","0","0","0","0","0","0","0","0","0","-2"
"135391","State College of Florida-Manatee-Sarasota","2014","On-tenure track, assistant professors","10","2","8","0","0","0","0","0","0","0","0","0","0","0","0","0","0","0","10","2","8","0","0","0","0","0","0","0","0","0","-2"
"135391","State College of Florida-Manatee-Sarasota","2014","On-tenure track, instructors","5","4","1","0","0","0","0","0","0","0","0","0","1","1","0","0","0","0","4","3","1","0","0","0","0","0","0","0","0","0","-2"
"135391","State College of Florida-Manatee-Sarasota","2014","Not on tenure track/No tenure system system total","7","2","5","0","0","0","0","0","0","0","0","0","0","0","0","0","0","0","7","2","5","0","0","0","0","0","0","0","0","0","-2"
"135391","State College of Florida-Manatee-Sarasota","2014","Not on tenure/no tenure system, lecturers","3","2","1","0","0","0","0","0","0","0","0","0","0","0","0","0","0","0","3","2","1","0","0","0","0","0","0","0","0","0","-2"
"135391","State College of Florida-Manatee-Sarasota","2014","Not on tenure/no tenure system, no academic rank","4","0","4","0","0","0","0","0","0","0","0","0","0","0","0","0","0","0","4","0","4","0","0","0","0","0","0","0","0","0","-2"
"136400","Pasco-Hernando State College","2014","Tenured total","90","26","64","0","0","0","0","0","0","6","3","3","4","3","1","1","0","1","77","19","58","0","0","0","2","1","1","0","0","0","-2"
"136400","Pasco-Hernando State College","2014","Tenured, professors","27","5","22","0","0","0","0","0","0","0","0","0","1","1","0","0","0","0","25","4","21","0","0","0","1","0","1","0","0","0","-2"
"136400","Pasco-Hernando State College","2014","Tenured, associate professors","21","2","19","0","0","0","0","0","0","1","0","1","0","0","0","0","0","0","20","2","18","0","0","0","0","0","0","0","0","0","-2"
"136400","Pasco-Hernando State College","2014","Tenured, assistant professors","32","15","17","0","0","0","0","0","0","5","3","2","3","2","1","1","0","1","22","9","13","0","0","0","1","1","0","0","0","0","-2"
"136400","Pasco-Hernando State College","2014","Tenured, instructors","10","4","6","0","0","0","0","0","0","0","0","0","0","0","0","0","0","0","10","4","6","0","0","0","0","0","0","0","0","0","-2"
"136400","Pasco-Hernando State College","2014","On-Tenure track total","54","18","36","0","0","0","2","0","2","3","0","3","5","2","3","0","0","0","42","15","27","2","1","1","0","0","0","0","0","0","-2"
"136400","Pasco-Hernando State College","2014","On-tenure track, professors","4","2","2","0","0","0","0","0","0","1","0","1","0","0","0","0","0","0","3","2","1","0","0","0","0","0","0","0","0","0","-2"
"136400","Pasco-Hernando State College","2014","On-tenure track, associate professors","1","1","0","0","0","0","0","0","0","0","0","0","0","0","0","0","0","0","1","1","0","0","0","0","0","0","0","0","0","0","-2"
"136400","Pasco-Hernando State College","2014","On-tenure track, assistant professors","3","1","2","0","0","0","0","0","0","0","0","0","0","0","0","0","0","0","3","1","2","0","0","0","0","0","0","0","0","0","-2"
"136400","Pasco-Hernando State College","2014","On-tenure track, instructors","46","14","32","0","0","0","2","0","2","2","0","2","5","2","3","0","0","0","35","11","24","2","1","1","0","0","0","0","0","0","-2"
"136400","Pasco-Hernando State College","2014","Not on tenure track/No tenure system system total","9","5","4","0","0","0","0","0","0","1","1","0","0","0","0","0","0","0","8","4","4","0","0","0","0","0","0","0","0","0","-2"
"136400","Pasco-Hernando State College","2014","Not on tenure/no tenure system, instructors","3","0","3","0","0","0","0","0","0","0","0","0","0","0","0","0","0","0","3","0","3","0","0","0","0","0","0","0","0","0","-2"
"136400","Pasco-Hernando State College","2014","Not on tenure/no tenure system, no academic rank","6","5","1","0","0","0","0","0","0","1","1","0","0","0","0","0","0","0","5","4","1","0","0","0","0","0","0","0","0","0","-2"
"136774","Ringling College of Art and Design","2014","Not on tenure track/No tenure system system total","92","66","26","0","0","0","2","1","1","1","1","0","2","1","1","0","0","0","85","63","22","0","0","0","2","0","2","0","0","0","-2"
"136774","Ringling College of Art and Design","2014","Not on tenure/no tenure system, no academic rank","92","66","26","0","0","0","2","1","1","1","1","0","2","1","1","0","0","0","85","63","22","0","0","0","2","0","2","0","0","0","-2"
"136950","Rollins College","2014","Tenured total","126","77","49","0","0","0","6","3","3","4","4","0","7","4","3","0","0","0","106","64","42","0","0","0","3","2","1","0","0","0","-2"
"136950","Rollins College","2014","Tenured, professors","70","49","21","0","0","0","2","1","1","0","0","0","3","2","1","0","0","0","64","45","19","0","0","0","1","1","0","0","0","0","-2"
"136950","Rollins College","2014","Tenured, associate professors","56","28","28","0","0","0","4","2","2","4","4","0","4","2","2","0","0","0","42","19","23","0","0","0","2","1","1","0","0","0","-2"
"136950","Rollins College","2014","On-Tenure track total","44","19","25","0","0","0","1","0","1","1","1","0","2","1","1","0","0","0","32","13","19","0","0","0","3","1","2","5","3","2","-2"
"136950","Rollins College","2014","On-tenure track, assistant professors","44","19","25","0","0","0","1","0","1","1","1","0","2","1","1","0","0","0","32","13","19","0","0","0","3","1","2","5","3","2","-2"
"136950","Rollins College","2014","Not on tenure track/No tenure system system total","49","27","22","0","0","0","1","1","0","1","1","0","4","1","3","0","0","0","39","20","19","0","0","0","3","3","0","1","1","0","-2"
"136950","Rollins College","2014","Not on tenure/no tenure system, professors","2","2","0","0","0","0","0","0","0","0","0","0","0","0","0","0","0","0","1","1","0","0","0","0","0","0","0","1","1","0","-2"
"136950","Rollins College","2014","Not on tenure/no tenure system, associate professors","2","2","0","0","0","0","0","0","0","0","0","0","0","0","0","0","0","0","2","2","0","0","0","0","0","0","0","0","0","0","-2"
"136950","Rollins College","2014","Not on tenure/no tenure system, assistant professors","16","9","7","0","0","0","1","1","0","0","0","0","1","0","1","0","0","0","12","6","6","0","0","0","2","2","0","0","0","0","-2"
"136950","Rollins College","2014","Not on tenure/no tenure system, lecturers","29","14","15","0","0","0","0","0","0","1","1","0","3","1","2","0","0","0","24","11","13","0","0","0","1","1","0","0","0","0","-2"
"137078","St Petersburg College","2014","Tenured total","251","115","136","0","0","0","7","5","2","20","10","10","14","5","9","0","0","0","201","90","111","9","5","4","0","0","0","0","0","0","-2"
"137078","St Petersburg College","2014","Tenured, no academic rank","251","115","136","0","0","0","7","5","2","20","10","10","14","5","9","0","0","0","201","90","111","9","5","4","0","0","0","0","0","0","-2"
"137078","St Petersburg College","2014","On-Tenure track total","109","44","65","0","0","0","2","2","0","11","4","7","4","1","3","0","0","0","91","37","54","1","0","1","0","0","0","0","0","0","-2"
"137078","St Petersburg College","2014","On-tenure track, no academic rank","109","44","65","0","0","0","2","2","0","11","4","7","4","1","3","0","0","0","91","37","54","1","0","1","0","0","0","0","0","0","-2"
"137078","St Petersburg College","2014","Not on tenure track/No tenure system system total","19","9","10","0","0","0","0","0","0","2","1","1","0","0","0","0","0","0","17","8","9","0","0","0","0","0","0","0","0","0","-2"
"137078","St Petersburg College","2014","Not on tenure/no tenure system, no academic rank","19","9","10","0","0","0","0","0","0","2","1","1","0","0","0","0","0","0","17","8","9","0","0","0","0","0","0","0","0","0","-2"
"137096","Santa Fe College","2014","Tenured total","169","77","92","0","0","0","3","2","1","11","5","6","10","3","7","0","0","0","142","64","78","1","1","0","2","2","0","0","0","0","-2"
"137096","Santa Fe College","2014","Tenured, no academic rank","169","77","92","0","0","0","3","2","1","11","5","6","10","3","7","0","0","0","142","64","78","1","1","0","2","2","0","0","0","0","-2"
"137096","Santa Fe College","2014","On-Tenure track total","71","26","45","0","0","0","2","2","0","5","1","4","4","1","3","0","0","0","58","22","36","1","0","1","1","0","1","0","0","0","-2"
"137096","Santa Fe College","2014","On-tenure track, no academic rank","71","26","45","0","0","0","2","2","0","5","1","4","4","1","3","0","0","0","58","22","36","1","0","1","1","0","1","0","0","0","-2"
"137546","Stetson University","2014","Tenured total","168","102","66","0","0","0","3","1","2","9","3","6","5","3","2","0","0","0","141","88","53","6","4","2","2","1","1","2","2","0","-2"
"137546","Stetson University","2014","Tenured, professors","110","64","46","0","0","0","3","1","2","6","2","4","3","1","2","0","0","0","94","57","37","2","2","0","1","0","1","1","1","0","-2"
"137546","Stetson University","2014","Tenured, associate professors","58","38","20","0","0","0","0","0","0","3","1","2","2","2","0","0","0","0","47","31","16","4","2","2","1","1","0","1","1","0","-2"
"137546","Stetson University","2014","On-Tenure track total","61","29","32","0","0","0","4","1","3","2","0","2","6","2","4","0","0","0","46","24","22","1","0","1","0","0","0","2","2","0","-2"
"137546","Stetson University","2014","On-tenure track, professors","2","1","1","0","0","0","0","0","0","0","0","0","0","0","0","0","0","0","2","1","1","0","0","0","0","0","0","0","0","0","-2"
"137546","Stetson University","2014","On-tenure track, associate professors","12","5","7","0","0","0","2","1","1","1","0","1","1","0","1","0","0","0","8","4","4","0","0","0","0","0","0","0","0","0","-2"
"137546","Stetson University","2014","On-tenure track, assistant professors","47","23","24","0","0","0","2","0","2","1","0","1","5","2","3","0","0","0","36","19","17","1","0","1","0","0","0","2","2","0","-2"
"137546","Stetson University","2014","Not on tenure track/No tenure system system total","36","15","21","0","0","0","1","1","0","2","2","0","5","2","3","0","0","0","26","8","18","0","0","0","0","0","0","2","2","0","-2"
"137546","Stetson University","2014","Not on tenure/no tenure system, no academic rank","36","15","21","0","0","0","1","1","0","2","2","0","5","2","3","0","0","0","26","8","18","0","0","0","0","0","0","2","2","0","-2"
"139700","Georgia Highlands College","2014","Tenured total","58","27","31","0","0","0","1","1","0","1","0","1","1","0","1","0","0","0","55","26","29","0","0","0","0","0","0","0","0","0","-2"
"139700","Georgia Highlands College","2014","Tenured, professors","16","10","6","0","0","0","1","1","0","0","0","0","0","0","0","0","0","0","15","9","6","0","0","0","0","0","0","0","0","0","-2"
"139700","Georgia Highlands College","2014","Tenured, associate professors","34","13","21","0","0","0","0","0","0","1","0","1","1","0","1","0","0","0","32","13","19","0","0","0","0","0","0","0","0","0","-2"
"139700","Georgia Highlands College","2014","Tenured, assistant professors","8","4","4","0","0","0","0","0","0","0","0","0","0","0","0","0","0","0","8","4","4","0","0","0","0","0","0","0","0","0","-2"
"139700","Georgia Highlands College","2014","On-Tenure track total","38","18","20","0","0","0","1","1","0","4","2","2","0","0","0","0","0","0","32","15","17","0","0","0","1","0","1","0","0","0","-2"
"139700","Georgia Highlands College","2014","On-tenure track, professors","1","1","0","0","0","0","0","0","0","0","0","0","0","0","0","0","0","0","1","1","0","0","0","0","0","0","0","0","0","0","-2"
"139700","Georgia Highlands College","2014","On-tenure track, associate professors","1","0","1","0","0","0","0","0","0","1","0","1","0","0","0","0","0","0","0","0","0","0","0","0","0","0","0","0","0","0","-2"
"139700","Georgia Highlands College","2014","On-tenure track, assistant professors","36","17","19","0","0","0","1","1","0","3","2","1","0","0","0","0","0","0","31","14","17","0","0","0","1","0","1","0","0","0","-2"
"139700","Georgia Highlands College","2014","Not on tenure track/No tenure system system total","28","9","19","0","0","0","1","1","0","3","1","2","1","0","1","0","0","0","21","6","15","0","0","0","2","1","1","0","0","0","-2"
"139700","Georgia Highlands College","2014","Not on tenure/no tenure system, instructors","28","9","19","0","0","0","1","1","0","3","1","2","1","0","1","0","0","0","21","6","15","0","0","0","2","1","1","0","0","0","-2"
"141565","University of Hawaii at Hilo","2014","Tenured total","140","83","57","1","1","0","42","24","18","1","1","0","2","2","0","10","3","7","82","51","31","0","0","0","0","0","0","2","1","1","-2"
"141565","University of Hawaii at Hilo","2014","Tenured, professors","57","40","17","1","1","0","15","11","4","1","1","0","1","1","0","2","1","1","37","25","12","0","0","0","0","0","0","0","0","0","-2"
"141565","University of Hawaii at Hilo","2014","Tenured, associate professors","83","43","40","0","0","0","27","13","14","0","0","0","1","1","0","8","2","6","45","26","19","0","0","0","0","0","0","2","1","1","-2"
"141565","University of Hawaii at Hilo","2014","On-Tenure track total","51","25","26","0","0","0","9","4","5","0","0","0","2","2","0","4","1","3","32","16","16","0","0","0","0","0","0","4","2","2","-2"
"141565","University of Hawaii at Hilo","2014","On-tenure track, professors","1","0","1","0","0","0","0","0","0","0","0","0","0","0","0","0","0","0","1","0","1","0","0","0","0","0","0","0","0","0","-2"
"141565","University of Hawaii at Hilo","2014","On-tenure track, associate professors","5","1","4","0","0","0","2","0","2","0","0","0","0","0","0","0","0","0","3","1","2","0","0","0","0","0","0","0","0","0","-2"
"141565","University of Hawaii at Hilo","2014","On-tenure track, assistant professors","45","24","21","0","0","0","7","4","3","0","0","0","2","2","0","4","1","3","28","15","13","0","0","0","0","0","0","4","2","2","-2"
"141565","University of Hawaii at Hilo","2014","Not on tenure track/No tenure system system total","30","9","21","0","0","0","1","0","1","0","0","0","1","0","1","1","0","1","25","8","17","1","1","0","0","0","0","1","0","1","-2"
"141565","University of Hawaii at Hilo","2014","Not on tenure/no tenure system, instructors","30","9","21","0","0","0","1","0","1","0","0","0","1","0","1","1","0","1","25","8","17","1","1","0","0","0","0","1","0","1","-2"
"141839","University of Hawaii Maui College","2014","Tenured total","58","21","37","0","0","0","11","3","8","1","1","0","0","0","0","7","5","2","38","11","27","0","0","0","0","0","0","1","1","0","-2"
"141839","University of Hawaii Maui College","2014","Tenured, professors","16","6","10","0","0","0","3","1","2","1","1","0","0","0","0","0","0","0","12","4","8","0","0","0","0","0","0","0","0","0","-2"
"141839","University of Hawaii Maui College","2014","Tenured, associate professors","12","3","9","0","0","0","3","0","3","0","0","0","0","0","0","2","2","0","7","1","6","0","0","0","0","0","0","0","0","0","-2"
"141839","University of Hawaii Maui College","2014","Tenured, assistant professors","30","12","18","0","0","0","5","2","3","0","0","0","0","0","0","5","3","2","19","6","13","0","0","0","0","0","0","1","1","0","-2"
"141839","University of Hawaii Maui College","2014","On-Tenure track total","31","17","14","0","0","0","5","4","1","0","0","0","1","1","0","5","3","2","16","6","10","1","0","1","0","0","0","3","3","0","-2"
"141839","University of Hawaii Maui College","2014","On-tenure track, assistant professors","5","2","3","0","0","0","2","1","1","0","0","0","0","0","0","1","1","0","2","0","2","0","0","0","0","0","0","0","0","0","-2"
"141839","University of Hawaii Maui College","2014","On-tenure track, instructors","26","15","11","0","0","0","3","3","0","0","0","0","1","1","0","4","2","2","14","6","8","1","0","1","0","0","0","3","3","0","-2"
"141839","University of Hawaii Maui College","2014","Not on tenure track/No tenure system system total","4","1","3","0","0","0","2","0","2","0","0","0","0","0","0","2","1","1","0","0","0","0","0","0","0","0","0","0","0","0","-2"
"141839","University of Hawaii Maui College","2014","Not on tenure/no tenure system, assistant professors","1","1","0","0","0","0","0","0","0","0","0","0","0","0","0","1","1","0","0","0","0","0","0","0","0","0","0","0","0","0","-2"
"141839","University of Hawaii Maui College","2014","Not on tenure/no tenure system, instructors","3","0","3","0","0","0","2","0","2","0","0","0","0","0","0","1","0","1","0","0","0","0","0","0","0","0","0","0","0","0","-2"
"142559","College of Southern Idaho","2014","Not on tenure track/No tenure system system total","155","73","82","1","0","1","1","0","1","0","0","0","4","1","3","0","0","0","148","72","76","1","0","1","0","0","0","0","0","0","-2"
"142559","College of Southern Idaho","2014","Not on tenure/no tenure system, professors","55","26","29","0","0","0","0","0","0","0","0","0","3","1","2","0","0","0","52","25","27","0","0","0","0","0","0","0","0","0","-2"
"142559","College of Southern Idaho","2014","Not on tenure/no tenure system, associate professors","25","12","13","0","0","0","0","0","0","0","0","0","1","0","1","0","0","0","23","12","11","1","0","1","0","0","0","0","0","0","-2"
"142559","College of Southern Idaho","2014","Not on tenure/no tenure system, assistant professors","34","17","17","0","0","0","1","0","1","0","0","0","0","0","0","0","0","0","33","17","16","0","0","0","0","0","0","0","0","0","-2"
"142559","College of Southern Idaho","2014","Not on tenure/no tenure system, instructors","41","18","23","1","0","1","0","0","0","0","0","0","0","0","0","0","0","0","40","18","22","0","0","0","0","0","0","0","0","0","-2"
"144281","Columbia College Chicago","2014","Tenured total","231","129","102","0","0","0","5","3","2","27","12","15","10","7","3","0","0","0","188","106","82","1","1","0","0","0","0","0","0","0","-2"
"144281","Columbia College Chicago","2014","Tenured, professors","47","29","18","0","0","0","1","0","1","5","2","3","0","0","0","0","0","0","41","27","14","0","0","0","0","0","0","0","0","0","-2"
"144281","Columbia College Chicago","2014","Tenured, associate professors","184","100","84","0","0","0","4","3","1","22","10","12","10","7","3","0","0","0","147","79","68","1","1","0","0","0","0","0","0","0","-2"
"144281","Columbia College Chicago","2014","On-Tenure track total","57","24","33","0","0","0","6","1","5","3","0","3","1","0","1","23","0","23","23","23","0","1","0","1","0","0","0","0","0","0","-2"
"144281","Columbia College Chicago","2014","On-tenure track, assistant professors","57","24","33","0","0","0","6","1","5","3","0","3","1","0","1","23","0","23","23","23","0","1","0","1","0","0","0","0","0","0","-2"
"144281","Columbia College Chicago","2014","Not on tenure track/No tenure system system total","85","44","41","0","0","0","2","1","1","7","4","3","2","1","1","0","0","0","74","38","36","0","0","0","0","0","0","0","0","0","-2"
"144281","Columbia College Chicago","2014","Not on tenure/no tenure system, lecturers","85","44","41","0","0","0","2","1","1","7","4","3","2","1","1","0","0","0","74","38","36","0","0","0","0","0","0","0","0","0","-2"
"144740","DePaul University","2014","Tenured total","529","303","226","1","1","0","32","16","16","44","25","19","29","12","17","0","0","0","358","209","149","3","2","1","25","14","11","37","24","13","-2"
"144740","DePaul University","2014","Tenured, professors","187","115","72","0","0","0","11","8","3","11","5","6","10","4","6","0","0","0","135","85","50","2","2","0","11","5","6","7","6","1","-2"
"144740","DePaul University","2014","Tenured, associate professors","340","186","154","1","1","0","21","8","13","33","20","13","19","8","11","0","0","0","222","123","99","1","0","1","13","8","5","30","18","12","-2"
"144740","DePaul University","2014","Tenured, assistant professors","2","2","0","0","0","0","0","0","0","0","0","0","0","0","0","0","0","0","1","1","0","0","0","0","1","1","0","0","0","0","-2"
"144740","DePaul University","2014","On-Tenure track total","190","89","101","1","0","1","12","5","7","12","1","11","16","8","8","0","0","0","95","50","45","3","1","2","29","15","14","22","9","13","-2"
"144740","DePaul University","2014","On-tenure track, professors","1","1","0","0","0","0","0","0","0","0","0","0","0","0","0","0","0","0","1","1","0","0","0","0","0","0","0","0","0","0","-2"
"144740","DePaul University","2014","On-tenure track, associate professors","14","5","9","0","0","0","2","1","1","2","0","2","0","0","0","0","0","0","6","2","4","0","0","0","4","2","2","0","0","0","-2"
"144740","DePaul University","2014","On-tenure track, assistant professors","175","83","92","1","0","1","10","4","6","10","1","9","16","8","8","0","0","0","88","47","41","3","1","2","25","13","12","22","9","13","-2"
"144740","DePaul University","2014","Not on tenure track/No tenure system system total","200","101","99","1","1","0","8","4","4","11","3","8","5","4","1","0","0","0","144","70","74","2","2","0","21","10","11","8","7","1","-2"
"144740","DePaul University","2014","Not on tenure/no tenure system, professors","5","2","3","0","0","0","1","0","1","0","0","0","0","0","0","0","0","0","1","0","1","0","0","0","3","2","1","0","0","0","-2"
"144740","DePaul University","2014","Not on tenure/no tenure system, associate professors","6","5","1","0","0","0","0","0","0","0","0","0","1","1","0","0","0","0","4","3","1","0","0","0","1","1","0","0","0","0","-2"
"144740","DePaul University","2014","Not on tenure/no tenure system, assistant professors","78","41","37","1","1","0","3","0","3","9","2","7","2","2","0","0","0","0","49","25","24","1","1","0","8","5","3","5","5","0","-2"
"144740","DePaul University","2014","Not on tenure/no tenure system, instructors","111","53","58","0","0","0","4","4","0","2","1","1","2","1","1","0","0","0","90","42","48","1","1","0","9","2","7","3","2","1","-2"
"145336","Governors State University","2014","Tenured total","104","49","55","0","0","0","15","10","5","20","6","14","1","0","1","0","0","0","38","21","17","2","0","2","28","12","16","0","0","0","-2"
"145336","Governors State University","2014","Tenured, professors","30","15","15","0","0","0","6","3","3","2","1","1","0","0","0","0","0","0","14","7","7","1","0","1","7","4","3","0","0","0","-2"
"145336","Governors State University","2014","Tenured, associate professors","62","27","35","0","0","0","6","5","1","13","3","10","1","0","1","0","0","0","21","11","10","1","0","1","20","8","12","0","0","0","-2"
"145336","Governors State University","2014","Tenured, assistant professors","11","7","4","0","0","0","3","2","1","5","2","3","0","0","0","0","0","0","3","3","0","0","0","0","0","0","0","0","0","0","-2"
"145336","Governors State University","2014","Tenured, lecturers","1","0","1","0","0","0","0","0","0","0","0","0","0","0","0","0","0","0","0","0","0","0","0","0","1","0","1","0","0","0","-2"
"145336","Governors State University","2014","On-Tenure track total","55","19","36","0","0","0","7","2","5","8","2","6","2","0","2","0","0","0","28","12","16","1","1","0","0","0","0","9","2","7","-2"
"145336","Governors State University","2014","On-tenure track, associate professors","2","1","1","0","0","0","0","0","0","0","0","0","0","0","0","0","0","0","2","1","1","0","0","0","0","0","0","0","0","0","-2"
"145336","Governors State University","2014","On-tenure track, assistant professors","51","18","33","0","0","0","7","2","5","7","2","5","2","0","2","0","0","0","25","11","14","1","1","0","0","0","0","9","2","7","-2"
"145336","Governors State University","2014","On-tenure track, instructors","2","0","2","0","0","0","0","0","0","1","0","1","0","0","0","0","0","0","1","0","1","0","0","0","0","0","0","0","0","0","-2"
"145336","Governors State University","2014","Not on tenure track/No tenure system system total","75","26","49","0","0","0","2","0","2","9","1","8","1","0","1","1","1","0","43","16","27","1","1","0","18","7","11","0","0","0","-2"
"145336","Governors State University","2014","Not on tenure/no tenure system, assistant professors","6","2","4","0","0","0","1","0","1","0","0","0","0","0","0","0","0","0","5","2","3","0","0","0","0","0","0","0","0","0","-2"
"145336","Governors State University","2014","Not on tenure/no tenure system, lecturers","63","22","41","0","0","0","1","0","1","7","1","6","1","0","1","0","0","0","36","13","23","1","1","0","17","7","10","0","0","0","-2"
"145336","Governors State University","2014","Not on tenure/no tenure system, no academic rank","6","2","4","0","0","0","0","0","0","2","0","2","0","0","0","1","1","0","2","1","1","0","0","0","1","0","1","0","0","0","-2"
"145619","Benedictine University","2014","Tenured total","77","44","33","0","0","0","5","3","2","3","1","2","1","1","0","0","0","0","66","38","28","0","0","0","2","1","1","0","0","0","-2"
"145619","Benedictine University","2014","Tenured, professors","40","25","15","0","0","0","2","1","1","2","1","1","0","0","0","0","0","0","35","23","12","0","0","0","1","0","1","0","0","0","-2"
"145619","Benedictine University","2014","Tenured, associate professors","37","19","18","0","0","0","3","2","1","1","0","1","1","1","0","0","0","0","31","15","16","0","0","0","1","1","0","0","0","0","-2"
"145619","Benedictine University","2014","On-Tenure track total","44","15","29","0","0","0","4","1","3","4","1","3","1","1","0","0","0","0","34","12","22","0","0","0","0","0","0","1","0","1","-2"
"145619","Benedictine University","2014","On-tenure track, professors","3","1","2","0","0","0","0","0","0","0","0","0","0","0","0","0","0","0","3","1","2","0","0","0","0","0","0","0","0","0","-2"
"145619","Benedictine University","2014","On-tenure track, associate professors","6","1","5","0","0","0","0","0","0","3","1","2","0","0","0","0","0","0","3","0","3","0","0","0","0","0","0","0","0","0","-2"
"145619","Benedictine University","2014","On-tenure track, assistant professors","35","13","22","0","0","0","4","1","3","1","0","1","1","1","0","0","0","0","28","11","17","0","0","0","0","0","0","1","0","1","-2"
"145619","Benedictine University","2014","Not on tenure track/No tenure system system total","45","19","26","1","0","1","3","3","0","0","0","0","2","1","1","0","0","0","39","15","24","0","0","0","0","0","0","0","0","0","-2"
"145619","Benedictine University","2014","Not on tenure/no tenure system, professors","1","1","0","0","0","0","1","1","0","0","0","0","0","0","0","0","0","0","0","0","0","0","0","0","0","0","0","0","0","0","-2"
"145619","Benedictine University","2014","Not on tenure/no tenure system, associate professors","6","2","4","0","0","0","1","1","0","0","0","0","0","0","0","0","0","0","5","1","4","0","0","0","0","0","0","0","0","0","-2"
"145619","Benedictine University","2014","Not on tenure/no tenure system, assistant professors","22","9","13","1","0","1","1","1","0","0","0","0","1","1","0","0","0","0","19","7","12","0","0","0","0","0","0","0","0","0","-2"
"145619","Benedictine University","2014","Not on tenure/no tenure system, instructors","15","6","9","0","0","0","0","0","0","0","0","0","1","0","1","0","0","0","14","6","8","0","0","0","0","0","0","0","0","0","-2"
"145619","Benedictine University","2014","Not on tenure/no tenure system, no academic rank","1","1","0","0","0","0","0","0","0","0","0","0","0","0","0","0","0","0","1","1","0","0","0","0","0","0","0","0","0","0","-2"
"146612","Lewis University","2014","Tenured total","93","51","42","0","0","0","5","4","1","4","2","2","0","0","0","0","0","0","83","45","38","0","0","0","0","0","0","1","0","1","-2"
"146612","Lewis University","2014","Tenured, professors","61","36","25","0","0","0","4","3","1","3","2","1","0","0","0","0","0","0","54","31","23","0","0","0","0","0","0","0","0","0","-2"
"146612","Lewis University","2014","Tenured, associate professors","29","13","16","0","0","0","0","0","0","1","0","1","0","0","0","0","0","0","27","13","14","0","0","0","0","0","0","1","0","1","-2"
"146612","Lewis University","2014","Tenured, assistant professors","3","2","1","0","0","0","1","1","0","0","0","0","0","0","0","0","0","0","2","1","1","0","0","0","0","0","0","0","0","0","-2"
"146612","Lewis University","2014","On-Tenure track total","32","15","17","0","0","0","4","3","1","2","2","0","1","0","1","0","0","0","24","9","15","0","0","0","0","0","0","1","1","0","-2"
"146612","Lewis University","2014","On-tenure track, associate professors","6","4","2","0","0","0","1","1","0","1","1","0","0","0","0","0","0","0","4","2","2","0","0","0","0","0","0","0","0","0","-2"
"146612","Lewis University","2014","On-tenure track, assistant professors","26","11","15","0","0","0","3","2","1","1","1","0","1","0","1","0","0","0","20","7","13","0","0","0","0","0","0","1","1","0","-2"
"146612","Lewis University","2014","Not on tenure track/No tenure system system total","94","37","57","0","0","0","3","0","3","5","0","5","3","2","1","0","0","0","81","34","47","0","0","0","0","0","0","2","1","1","-2"
"146612","Lewis University","2014","Not on tenure/no tenure system, professors","2","2","0","0","0","0","0","0","0","0","0","0","1","1","0","0","0","0","1","1","0","0","0","0","0","0","0","0","0","0","-2"
"146612","Lewis University","2014","Not on tenure/no tenure system, associate professors","11","5","6","0","0","0","0","0","0","2","0","2","0","0","0","0","0","0","8","4","4","0","0","0","0","0","0","1","1","0","-2"
"146612","Lewis University","2014","Not on tenure/no tenure system, assistant professors","64","26","38","0","0","0","3","0","3","2","0","2","2","1","1","0","0","0","56","25","31","0","0","0","0","0","0","1","0","1","-2"
"146612","Lewis University","2014","Not on tenure/no tenure system, instructors","17","4","13","0","0","0","0","0","0","1","0","1","0","0","0","0","0","0","16","4","12","0","0","0","0","0","0","0","0","0","-2"
"146719","Loyola University Chicago","2014","Tenured total","448","277","171","1","1","0","28","19","9","13","4","9","21","12","9","0","0","0","378","238","140","4","1","3","2","1","1","1","1","0","-2"
"146719","Loyola University Chicago","2014","Tenured, professors","232","162","70","0","0","0","12","10","2","2","1","1","13","10","3","0","0","0","202","140","62","2","0","2","1","1","0","0","0","0","-2"
"146719","Loyola University Chicago","2014","Tenured, associate professors","204","106","98","1","1","0","15","8","7","10","3","7","7","1","6","0","0","0","167","91","76","2","1","1","1","0","1","1","1","0","-2"
"146719","Loyola University Chicago","2014","Tenured, assistant professors","12","9","3","0","0","0","1","1","0","1","0","1","1","1","0","0","0","0","9","7","2","0","0","0","0","0","0","0","0","0","-2"
"146719","Loyola University Chicago","2014","On-Tenure track total","124","60","64","0","0","0","14","6","8","6","3","3","3","1","2","0","0","0","91","44","47","0","0","0","0","0","0","10","6","4","-2"
"146719","Loyola University Chicago","2014","On-tenure track, associate professors","6","3","3","0","0","0","1","1","0","1","0","1","0","0","0","0","0","0","4","2","2","0","0","0","0","0","0","0","0","0","-2"
"146719","Loyola University Chicago","2014","On-tenure track, assistant professors","118","57","61","0","0","0","13","5","8","5","3","2","3","1","2","0","0","0","87","42","45","0","0","0","0","0","0","10","6","4","-2"
"146719","Loyola University Chicago","2014","Not on tenure track/No tenure system system total","269","108","161","0","0","0","12","5","7","15","2","13","8","4","4","0","0","0","229","95","134","1","0","1","0","0","0","4","2","2","-2"
"146719","Loyola University Chicago","2014","Not on tenure/no tenure system, instructors","269","108","161","0","0","0","12","5","7","15","2","13","8","4","4","0","0","0","229","95","134","1","0","1","0","0","0","4","2","2","-2"
"147660","North Central College","2014","Tenured total","76","46","30","0","0","0","4","2","2","2","1","1","0","0","0","0","0","0","70","43","27","0","0","0","0","0","0","0","0","0","-2"
"147660","North Central College","2014","Tenured, professors","43","26","17","0","0","0","2","1","1","1","1","0","0","0","0","0","0","0","40","24","16","0","0","0","0","0","0","0","0","0","-2"
"147660","North Central College","2014","Tenured, associate professors","33","20","13","0","0","0","2","1","1","1","0","1","0","0","0","0","0","0","30","19","11","0","0","0","0","0","0","0","0","0","-2"
"147660","North Central College","2014","On-Tenure track total","32","9","23","0","0","0","1","0","1","1","0","1","2","0","2","0","0","0","20","7","13","1","0","1","0","0","0","7","2","5","-2"
"147660","North Central College","2014","On-tenure track, assistant professors","32","9","23","0","0","0","1","0","1","1","0","1","2","0","2","0","0","0","20","7","13","1","0","1","0","0","0","7","2","5","-2"
"147660","North Central College","2014","Not on tenure track/No tenure system system total","30","8","22","0","0","0","0","0","0","0","0","0","0","0","0","0","0","0","29","8","21","0","0","0","0","0","0","1","0","1","-2"
"147660","North Central College","2014","Not on tenure/no tenure system, professors","3","2","1","0","0","0","0","0","0","0","0","0","0","0","0","0","0","0","3","2","1","0","0","0","0","0","0","0","0","0","-2"
"147660","North Central College","2014","Not on tenure/no tenure system, associate professors","2","0","2","0","0","0","0","0","0","0","0","0","0","0","0","0","0","0","2","0","2","0","0","0","0","0","0","0","0","0","-2"
"147660","North Central College","2014","Not on tenure/no tenure system, assistant professors","21","6","15","0","0","0","0","0","0","0","0","0","0","0","0","0","0","0","20","6","14","0","0","0","0","0","0","1","0","1","-2"
"147660","North Central College","2014","Not on tenure/no tenure system, instructors","4","0","4","0","0","0","0","0","0","0","0","0","0","0","0","0","0","0","4","0","4","0","0","0","0","0","0","0","0","0","-2"
"148405","Rockford University","2014","Tenured total","29","15","14","0","0","0","0","0","0","0","0","0","0","0","0","0","0","0","28","14","14","1","1","0","0","0","0","0","0","0","-2"
"148405","Rockford University","2014","Tenured, professors","17","9","8","0","0","0","0","0","0","0","0","0","0","0","0","0","0","0","16","8","8","1","1","0","0","0","0","0","0","0","-2"
"148405","Rockford University","2014","Tenured, associate professors","9","5","4","0","0","0","0","0","0","0","0","0","0","0","0","0","0","0","9","5","4","0","0","0","0","0","0","0","0","0","-2"
"148405","Rockford University","2014","Tenured, assistant professors","3","1","2","0","0","0","0","0","0","0","0","0","0","0","0","0","0","0","3","1","2","0","0","0","0","0","0","0","0","0","-2"
"148405","Rockford University","2014","On-Tenure track total","38","20","18","0","0","0","0","0","0","1","0","1","0","0","0","0","0","0","37","20","17","0","0","0","0","0","0","0","0","0","-2"
"148405","Rockford University","2014","On-tenure track, associate professors","5","3","2","0","0","0","0","0","0","0","0","0","0","0","0","0","0","0","5","3","2","0","0","0","0","0","0","0","0","0","-2"
"148405","Rockford University","2014","On-tenure track, assistant professors","33","17","16","0","0","0","0","0","0","1","0","1","0","0","0","0","0","0","32","17","15","0","0","0","0","0","0","0","0","0","-2"
"148405","Rockford University","2014","Not on tenure track/No tenure system system total","8","4","4","0","0","0","0","0","0","0","0","0","0","0","0","0","0","0","8","4","4","0","0","0","0","0","0","0","0","0","-2"
"148405","Rockford University","2014","Not on tenure/no tenure system, associate professors","2","1","1","0","0","0","0","0","0","0","0","0","0","0","0","0","0","0","2","1","1","0","0","0","0","0","0","0","0","0","-2"
"148405","Rockford University","2014","Not on tenure/no tenure system, assistant professors","6","3","3","0","0","0","0","0","0","0","0","0","0","0","0","0","0","0","6","3","3","0","0","0","0","0","0","0","0","0","-2"
"148584","University of St Francis","2014","Tenured total","38","17","21","0","0","0","2","0","2","2","1","1","0","0","0","0","0","0","34","16","18","0","0","0","0","0","0","0","0","0","-2"
"148584","University of St Francis","2014","Tenured, professors","19","7","12","0","0","0","1","0","1","1","0","1","0","0","0","0","0","0","17","7","10","0","0","0","0","0","0","0","0","0","-2"
"148584","University of St Francis","2014","Tenured, associate professors","18","10","8","0","0","0","1","0","1","1","1","0","0","0","0","0","0","0","16","9","7","0","0","0","0","0","0","0","0","0","-2"
"148584","University of St Francis","2014","Tenured, assistant professors","1","0","1","0","0","0","0","0","0","0","0","0","0","0","0","0","0","0","1","0","1","0","0","0","0","0","0","0","0","0","-2"
"148584","University of St Francis","2014","On-Tenure track total","29","7","22","0","0","0","1","0","1","5","0","5","1","0","1","0","0","0","21","7","14","0","0","0","1","0","1","0","0","0","-2"
"148584","University of St Francis","2014","On-tenure track, associate professors","2","0","2","0","0","0","0","0","0","2","0","2","0","0","0","0","0","0","0","0","0","0","0","0","0","0","0","0","0","0","-2"
"148584","University of St Francis","2014","On-tenure track, assistant professors","27","7","20","0","0","0","1","0","1","3","0","3","1","0","1","0","0","0","21","7","14","0","0","0","1","0","1","0","0","0","-2"
"148584","University of St Francis","2014","Not on tenure track/No tenure system system total","34","12","22","0","0","0","1","1","0","0","0","0","3","1","2","0","0","0","29","10","19","1","0","1","0","0","0","0","0","0","-2"
"148584","University of St Francis","2014","Not on tenure/no tenure system, professors","9","8","1","0","0","0","0","0","0","0","0","0","1","1","0","0","0","0","8","7","1","0","0","0","0","0","0","0","0","0","-2"
"148584","University of St Francis","2014","Not on tenure/no tenure system, associate professors","1","0","1","0","0","0","0","0","0","0","0","0","0","0","0","0","0","0","1","0","1","0","0","0","0","0","0","0","0","0","-2"
"148584","University of St Francis","2014","Not on tenure/no tenure system, assistant professors","11","0","11","0","0","0","0","0","0","0","0","0","1","0","1","0","0","0","9","0","9","1","0","1","0","0","0","0","0","0","-2"
"148584","University of St Francis","2014","Not on tenure/no tenure system, instructors","13","4","9","0","0","0","1","1","0","0","0","0","1","0","1","0","0","0","11","3","8","0","0","0","0","0","0","0","0","0","-2"
"150668","Goshen College","2014","Tenured total","34","17","17","0","0","0","0","0","0","0","0","0","0","0","0","0","0","0","34","17","17","0","0","0","0","0","0","0","0","0","-2"
"150668","Goshen College","2014","Tenured, professors","30","15","15","0","0","0","0","0","0","0","0","0","0","0","0","0","0","0","30","15","15","0","0","0","0","0","0","0","0","0","-2"
"150668","Goshen College","2014","Tenured, associate professors","4","2","2","0","0","0","0","0","0","0","0","0","0","0","0","0","0","0","4","2","2","0","0","0","0","0","0","0","0","0","-2"
"150668","Goshen College","2014","On-Tenure track total","16","12","4","0","0","0","1","1","0","0","0","0","0","0","0","0","0","0","13","9","4","1","1","0","0","0","0","1","1","0","-2"
"150668","Goshen College","2014","On-tenure track, professors","2","2","0","0","0","0","0","0","0","0","0","0","0","0","0","0","0","0","2","2","0","0","0","0","0","0","0","0","0","0","-2"
"150668","Goshen College","2014","On-tenure track, associate professors","10","7","3","0","0","0","1","1","0","0","0","0","0","0","0","0","0","0","8","5","3","1","1","0","0","0","0","0","0","0","-2"
"150668","Goshen College","2014","On-tenure track, assistant professors","4","3","1","0","0","0","0","0","0","0","0","0","0","0","0","0","0","0","3","2","1","0","0","0","0","0","0","1","1","0","-2"
"150668","Goshen College","2014","Not on tenure track/No tenure system system total","17","5","12","0","0","0","0","0","0","1","0","1","1","0","1","0","0","0","14","5","9","0","0","0","1","0","1","0","0","0","-2"
"150668","Goshen College","2014","Not on tenure/no tenure system, associate professors","12","5","7","0","0","0","0","0","0","0","0","0","0","0","0","0","0","0","11","5","6","0","0","0","1","0","1","0","0","0","-2"
"150668","Goshen College","2014","Not on tenure/no tenure system, assistant professors","5","0","5","0","0","0","0","0","0","1","0","1","1","0","1","0","0","0","3","0","3","0","0","0","0","0","0","0","0","0","-2"
"152992","Briar Cliff University","2014","Tenured total","26","16","10","0","0","0","0","0","0","0","0","0","0","0","0","0","0","0","26","16","10","0","0","0","0","0","0","0","0","0","-2"
"152992","Briar Cliff University","2014","Tenured, professors","14","9","5","0","0","0","0","0","0","0","0","0","0","0","0","0","0","0","14","9","5","0","0","0","0","0","0","0","0","0","-2"
"152992","Briar Cliff University","2014","Tenured, associate professors","9","6","3","0","0","0","0","0","0","0","0","0","0","0","0","0","0","0","9","6","3","0","0","0","0","0","0","0","0","0","-2"
"152992","Briar Cliff University","2014","Tenured, assistant professors","3","1","2","0","0","0","0","0","0","0","0","0","0","0","0","0","0","0","3","1","2","0","0","0","0","0","0","0","0","0","-2"
"152992","Briar Cliff University","2014","On-Tenure track total","38","15","23","0","0","0","1","1","0","0","0","0","1","1","0","0","0","0","36","13","23","0","0","0","0","0","0","0","0","0","-2"
"152992","Briar Cliff University","2014","On-tenure track, professors","2","2","0","0","0","0","0","0","0","0","0","0","0","0","0","0","0","0","2","2","0","0","0","0","0","0","0","0","0","0","-2"
"152992","Briar Cliff University","2014","On-tenure track, associate professors","6","2","4","0","0","0","0","0","0","0","0","0","0","0","0","0","0","0","6","2","4","0","0","0","0","0","0","0","0","0","-2"
"152992","Briar Cliff University","2014","On-tenure track, assistant professors","21","11","10","0","0","0","1","1","0","0","0","0","1","1","0","0","0","0","19","9","10","0","0","0","0","0","0","0","0","0","-2"
"152992","Briar Cliff University","2014","On-tenure track, instructors","9","0","9","0","0","0","0","0","0","0","0","0","0","0","0","0","0","0","9","0","9","0","0","0","0","0","0","0","0","0","-2"
"152992","Briar Cliff University","2014","Not on tenure track/No tenure system system total","2","2","0","0","0","0","0","0","0","0","0","0","0","0","0","0","0","0","2","2","0","0","0","0","0","0","0","0","0","0","-2"
"152992","Briar Cliff University","2014","Not on tenure/no tenure system, instructors","2","2","0","0","0","0","0","0","0","0","0","0","0","0","0","0","0","0","2","2","0","0","0","0","0","0","0","0","0","0","-2"
"154721","Bethany College","2014","Tenured total","16","11","5","0","0","0","0","0","0","0","0","0","0","0","0","0","0","0","16","11","5","0","0","0","0","0","0","0","0","0","-2"
"154721","Bethany College","2014","Tenured, professors","11","6","5","0","0","0","0","0","0","0","0","0","0","0","0","0","0","0","11","6","5","0","0","0","0","0","0","0","0","0","-2"
"154721","Bethany College","2014","Tenured, associate professors","5","5","0","0","0","0","0","0","0","0","0","0","0","0","0","0","0","0","5","5","0","0","0","0","0","0","0","0","0","0","-2"
"154721","Bethany College","2014","On-Tenure track total","18","10","8","0","0","0","1","0","1","0","0","0","0","0","0","0","0","0","17","10","7","0","0","0","0","0","0","0","0","0","-2"
"154721","Bethany College","2014","On-tenure track, associate professors","2","2","0","0","0","0","0","0","0","0","0","0","0","0","0","0","0","0","2","2","0","0","0","0","0","0","0","0","0","0","-2"
"154721","Bethany College","2014","On-tenure track, assistant professors","16","8","8","0","0","0","1","0","1","0","0","0","0","0","0","0","0","0","15","8","7","0","0","0","0","0","0","0","0","0","-2"
"154721","Bethany College","2014","Not on tenure track/No tenure system system total","9","3","6","0","0","0","2","0","2","0","0","0","1","1","0","0","0","0","6","2","4","0","0","0","0","0","0","0","0","0","-2"
"154721","Bethany College","2014","Not on tenure/no tenure system, assistant professors","9","3","6","0","0","0","2","0","2","0","0","0","1","1","0","0","0","0","6","2","4","0","0","0","0","0","0","0","0","0","-2"
"159656","Loyola University New Orleans","2014","Tenured total","135","89","46","0","0","0","0","0","0","9","6","3","12","8","4","0","0","0","109","71","38","3","2","1","1","1","0","1","1","0","-2"
"159656","Loyola University New Orleans","2014","Tenured, professors","85","59","26","0","0","0","0","0","0","7","5","2","7","5","2","0","0","0","69","48","21","2","1","1","0","0","0","0","0","0","-2"
"159656","Loyola University New Orleans","2014","Tenured, associate professors","50","30","20","0","0","0","0","0","0","2","1","1","5","3","2","0","0","0","40","23","17","1","1","0","1","1","0","1","1","0","-2"
"159656","Loyola University New Orleans","2014","On-Tenure track total","73","38","35","0","0","0","5","4","1","6","2","4","4","2","2","0","0","0","51","27","24","1","1","0","3","1","2","3","1","2","-2"
"159656","Loyola University New Orleans","2014","On-tenure track, professors","1","0","1","0","0","0","0","0","0","0","0","0","0","0","0","0","0","0","1","0","1","0","0","0","0","0","0","0","0","0","-2"
"159656","Loyola University New Orleans","2014","On-tenure track, associate professors","16","4","12","0","0","0","1","0","1","1","0","1","1","0","1","0","0","0","12","4","8","0","0","0","0","0","0","1","0","1","-2"
"159656","Loyola University New Orleans","2014","On-tenure track, assistant professors","56","34","22","0","0","0","4","4","0","5","2","3","3","2","1","0","0","0","38","23","15","1","1","0","3","1","2","2","1","1","-2"
"159656","Loyola University New Orleans","2014","Not on tenure track/No tenure system system total","68","26","42","0","0","0","0","0","0","1","0","1","2","1","1","1","1","0","61","24","37","0","0","0","2","0","2","1","0","1","-2"
"159656","Loyola University New Orleans","2014","Not on tenure/no tenure system, instructors","1","0","1","0","0","0","0","0","0","0","0","0","0","0","0","0","0","0","1","0","1","0","0","0","0","0","0","0","0","0","-2"
"159656","Loyola University New Orleans","2014","Not on tenure/no tenure system, lecturers","67","26","41","0","0","0","0","0","0","1","0","1","2","1","1","1","1","0","60","24","36","0","0","0","2","0","2","1","0","1","-2"
"164447","American International College","2014","Tenured total","37","20","17","0","0","0","0","0","0","1","0","1","0","0","0","0","0","0","36","20","16","0","0","0","0","0","0","0","0","0","-2"
"164447","American International College","2014","Tenured, professors","12","5","7","0","0","0","0","0","0","0","0","0","0","0","0","0","0","0","12","5","7","0","0","0","0","0","0","0","0","0","-2"
"164447","American International College","2014","Tenured, associate professors","22","13","9","0","0","0","0","0","0","1","0","1","0","0","0","0","0","0","21","13","8","0","0","0","0","0","0","0","0","0","-2"
"164447","American International College","2014","Tenured, assistant professors","2","2","0","0","0","0","0","0","0","0","0","0","0","0","0","0","0","0","2","2","0","0","0","0","0","0","0","0","0","0","-2"
"164447","American International College","2014","Tenured, no academic rank","1","0","1","0","0","0","0","0","0","0","0","0","0","0","0","0","0","0","1","0","1","0","0","0","0","0","0","0","0","0","-2"
"164447","American International College","2014","On-Tenure track total","27","5","22","0","0","0","2","0","2","1","0","1","3","2","1","0","0","0","20","3","17","1","0","1","0","0","0","0","0","0","-2"
"164447","American International College","2014","On-tenure track, associate professors","3","0","3","0","0","0","0","0","0","0","0","0","0","0","0","0","0","0","3","0","3","0","0","0","0","0","0","0","0","0","-2"
"164447","American International College","2014","On-tenure track, assistant professors","23","4","19","0","0","0","2","0","2","1","0","1","2","1","1","0","0","0","17","3","14","1","0","1","0","0","0","0","0","0","-2"
"164447","American International College","2014","On-tenure track, no academic rank","1","1","0","0","0","0","0","0","0","0","0","0","1","1","0","0","0","0","0","0","0","0","0","0","0","0","0","0","0","0","-2"
"164447","American International College","2014","Not on tenure track/No tenure system system total","12","6","6","0","0","0","1","0","1","1","1","0","0","0","0","0","0","0","9","5","4","0","0","0","1","0","1","0","0","0","-2"
"164447","American International College","2014","Not on tenure/no tenure system, assistant professors","6","2","4","0","0","0","1","0","1","1","1","0","0","0","0","0","0","0","3","1","2","0","0","0","1","0","1","0","0","0","-2"
"164447","American International College","2014","Not on tenure/no tenure system, instructors","2","1","1","0","0","0","0","0","0","0","0","0","0","0","0","0","0","0","2","1","1","0","0","0","0","0","0","0","0","0","-2"
"164447","American International College","2014","Not on tenure/no tenure system, no academic rank","4","3","1","0","0","0","0","0","0","0","0","0","0","0","0","0","0","0","4","3","1","0","0","0","0","0","0","0","0","0","-2"
"164632","Bay Path University","2014","Not on tenure track/No tenure system system total","53","17","36","0","0","0","3","2","1","0","0","0","1","1","0","0","0","0","49","14","35","0","0","0","0","0","0","0","0","0","-2"
"164632","Bay Path University","2014","Not on tenure/no tenure system, professors","9","4","5","0","0","0","0","0","0","0","0","0","0","0","0","0","0","0","9","4","5","0","0","0","0","0","0","0","0","0","-2"
"164632","Bay Path University","2014","Not on tenure/no tenure system, associate professors","16","7","9","0","0","0","2","1","1","0","0","0","0","0","0","0","0","0","14","6","8","0","0","0","0","0","0","0","0","0","-2"
"164632","Bay Path University","2014","Not on tenure/no tenure system, assistant professors","27","6","21","0","0","0","1","1","0","0","0","0","1","1","0","0","0","0","25","4","21","0","0","0","0","0","0","0","0","0","-2"
"164632","Bay Path University","2014","Not on tenure/no tenure system, instructors","1","0","1","0","0","0","0","0","0","0","0","0","0","0","0","0","0","0","1","0","1","0","0","0","0","0","0","0","0","0","-2"
"166638","University of Massachusetts-Boston","2014","Tenured total","302","167","135","0","0","0","44","28","16","22","10","12","14","7","7","0","0","0","205","111","94","0","0","0","14","10","4","3","1","2","-2"
"166638","University of Massachusetts-Boston","2014","Tenured, professors","117","70","47","0","0","0","17","13","4","4","4","0","6","3","3","0","0","0","85","46","39","0","0","0","5","4","1","0","0","0","-2"
"166638","University of Massachusetts-Boston","2014","Tenured, associate professors","184","97","87","0","0","0","27","15","12","18","6","12","8","4","4","0","0","0","119","65","54","0","0","0","9","6","3","3","1","2","-2"
"166638","University of Massachusetts-Boston","2014","Tenured, assistant professors","1","0","1","0","0","0","0","0","0","0","0","0","0","0","0","0","0","0","1","0","1","0","0","0","0","0","0","0","0","0","-2"
"166638","University of Massachusetts-Boston","2014","On-Tenure track total","179","80","99","0","0","0","18","12","6","2","0","2","10","5","5","0","0","0","72","28","44","0","0","0","68","34","34","9","1","8","-2"
"166638","University of Massachusetts-Boston","2014","On-tenure track, professors","1","0","1","0","0","0","0","0","0","0","0","0","0","0","0","0","0","0","1","0","1","0","0","0","0","0","0","0","0","0","-2"
"166638","University of Massachusetts-Boston","2014","On-tenure track, associate professors","13","6","7","0","0","0","2","1","1","0","0","0","1","1","0","0","0","0","6","2","4","0","0","0","4","2","2","0","0","0","-2"
"166638","University of Massachusetts-Boston","2014","On-tenure track, assistant professors","165","74","91","0","0","0","16","11","5","2","0","2","9","4","5","0","0","0","65","26","39","0","0","0","64","32","32","9","1","8","-2"
"166638","University of Massachusetts-Boston","2014","Not on tenure track/No tenure system system total","169","80","89","0","0","0","9","6","3","6","5","1","7","5","2","0","0","0","118","52","66","0","0","0","26","10","16","3","2","1","-2"
"166638","University of Massachusetts-Boston","2014","Not on tenure/no tenure system, lecturers","150","74","76","0","0","0","8","5","3","5","5","0","6","4","2","0","0","0","109","50","59","0","0","0","19","8","11","3","2","1","-2"
"166638","University of Massachusetts-Boston","2014","Not on tenure/no tenure system, no academic rank","19","6","13","0","0","0","1","1","0","1","0","1","1","1","0","0","0","0","9","2","7","0","0","0","7","2","5","0","0","0","-2"
"167729","Salem State University","2014","Tenured total","251","121","130","0","0","0","14","9","5","5","3","2","5","2","3","0","0","0","223","105","118","0","0","0","4","2","2","0","0","0","-2"
"167729","Salem State University","2014","Tenured, professors","131","67","64","0","0","0","5","2","3","0","0","0","2","1","1","0","0","0","123","64","59","0","0","0","1","0","1","0","0","0","-2"
"167729","Salem State University","2014","Tenured, associate professors","104","49","55","0","0","0","8","6","2","5","3","2","3","1","2","0","0","0","86","38","48","0","0","0","2","1","1","0","0","0","-2"
"167729","Salem State University","2014","Tenured, assistant professors","16","5","11","0","0","0","1","1","0","0","0","0","0","0","0","0","0","0","14","3","11","0","0","0","1","1","0","0","0","0","-2"
"167729","Salem State University","2014","On-Tenure track total","78","32","46","0","0","0","13","4","9","8","5","3","6","3","3","0","0","0","47","17","30","0","0","0","3","2","1","1","1","0","-2"
"167729","Salem State University","2014","On-tenure track, professors","1","1","0","0","0","0","0","0","0","1","1","0","0","0","0","0","0","0","0","0","0","0","0","0","0","0","0","0","0","0","-2"
"167729","Salem State University","2014","On-tenure track, associate professors","10","5","5","0","0","0","0","0","0","2","1","1","1","1","0","0","0","0","6","2","4","0","0","0","1","1","0","0","0","0","-2"
"167729","Salem State University","2014","On-tenure track, assistant professors","61","26","35","0","0","0","11","4","7","5","3","2","5","2","3","0","0","0","37","15","22","0","0","0","2","1","1","1","1","0","-2"
"167729","Salem State University","2014","On-tenure track, instructors","6","0","6","0","0","0","2","0","2","0","0","0","0","0","0","0","0","0","4","0","4","0","0","0","0","0","0","0","0","0","-2"
"167729","Salem State University","2014","Not on tenure track/No tenure system system total","20","8","12","0","0","0","1","1","0","0","0","0","0","0","0","0","0","0","15","6","9","0","0","0","4","1","3","0","0","0","-2"
"167729","Salem State University","2014","Not on tenure/no tenure system, assistant professors","11","3","8","0","0","0","1","1","0","0","0","0","0","0","0","0","0","0","6","1","5","0","0","0","4","1","3","0","0","0","-2"
"167729","Salem State University","2014","Not on tenure/no tenure system, instructors","9","5","4","0","0","0","0","0","0","0","0","0","0","0","0","0","0","0","9","5","4","0","0","0","0","0","0","0","0","0","-2"
"168740","Andrews University","2014","Tenured total","69","50","19","0","0","0","7","6","1","7","5","2","3","2","1","0","0","0","52","37","15","0","0","0","0","0","0","0","0","0","-2"
"168740","Andrews University","2014","Tenured, professors","54","41","13","0","0","0","7","6","1","3","2","1","3","2","1","0","0","0","41","31","10","0","0","0","0","0","0","0","0","0","-2"
"168740","Andrews University","2014","Tenured, associate professors","12","7","5","0","0","0","0","0","0","4","3","1","0","0","0","0","0","0","8","4","4","0","0","0","0","0","0","0","0","0","-2"
"168740","Andrews University","2014","Tenured, assistant professors","3","2","1","0","0","0","0","0","0","0","0","0","0","0","0","0","0","0","3","2","1","0","0","0","0","0","0","0","0","0","-2"
"168740","Andrews University","2014","On-Tenure track total","150","82","68","0","0","0","10","5","5","16","4","12","16","10","6","0","0","0","95","54","41","3","3","0","3","1","2","7","5","2","-2"
"168740","Andrews University","2014","On-tenure track, professors","20","18","2","0","0","0","1","1","0","2","1","1","2","2","0","0","0","0","12","12","0","0","0","0","1","0","1","2","2","0","-2"
"168740","Andrews University","2014","On-tenure track, associate professors","57","31","26","0","0","0","5","2","3","7","2","5","6","4","2","0","0","0","35","20","15","2","2","0","0","0","0","2","1","1","-2"
"168740","Andrews University","2014","On-tenure track, assistant professors","73","33","40","0","0","0","4","2","2","7","1","6","8","4","4","0","0","0","48","22","26","1","1","0","2","1","1","3","2","1","-2"
"168740","Andrews University","2014","Not on tenure track/No tenure system system total","18","9","9","0","0","0","1","1","0","2","0","2","5","5","0","0","0","0","9","3","6","0","0","0","0","0","0","1","0","1","-2"
"168740","Andrews University","2014","Not on tenure/no tenure system, associate professors","5","4","1","0","0","0","0","0","0","0","0","0","2","2","0","0","0","0","3","2","1","0","0","0","0","0","0","0","0","0","-2"
"168740","Andrews University","2014","Not on tenure/no tenure system, assistant professors","6","1","5","0","0","0","0","0","0","2","0","2","0","0","0","0","0","0","3","1","2","0","0","0","0","0","0","1","0","1","-2"
"168740","Andrews University","2014","Not on tenure/no tenure system, instructors","7","4","3","0","0","0","1","1","0","0","0","0","3","3","0","0","0","0","3","0","3","0","0","0","0","0","0","0","0","0","-2"
"170532","Kalamazoo College","2014","Tenured total","64","34","30","0","0","0","4","0","4","3","2","1","2","0","2","0","0","0","55","32","23","0","0","0","0","0","0","0","0","0","-2"
"170532","Kalamazoo College","2014","Tenured, professors","35","22","13","0","0","0","2","0","2","0","0","0","1","0","1","0","0","0","32","22","10","0","0","0","0","0","0","0","0","0","-2"
"170532","Kalamazoo College","2014","Tenured, associate professors","29","12","17","0","0","0","2","0","2","3","2","1","1","0","1","0","0","0","23","10","13","0","0","0","0","0","0","0","0","0","-2"
"170532","Kalamazoo College","2014","On-Tenure track total","22","9","13","0","0","0","2","0","2","2","1","1","2","0","2","0","0","0","12","6","6","2","1","1","0","0","0","2","1","1","-2"
"170532","Kalamazoo College","2014","On-tenure track, assistant professors","22","9","13","0","0","0","2","0","2","2","1","1","2","0","2","0","0","0","12","6","6","2","1","1","0","0","0","2","1","1","-2"
"170532","Kalamazoo College","2014","Not on tenure track/No tenure system system total","23","8","15","1","0","1","2","2","0","0","0","0","0","0","0","0","0","0","17","6","11","1","0","1","0","0","0","2","0","2","-2"
"170532","Kalamazoo College","2014","Not on tenure/no tenure system, assistant professors","15","6","9","1","0","1","2","2","0","0","0","0","0","0","0","0","0","0","10","4","6","0","0","0","0","0","0","2","0","2","-2"
"170532","Kalamazoo College","2014","Not on tenure/no tenure system, instructors","8","2","6","0","0","0","0","0","0","0","0","0","0","0","0","0","0","0","7","2","5","1","0","1","0","0","0","0","0","0","-2"
"178721","Park University","2014","Tenured total","51","28","23","0","0","0","2","0","2","1","1","0","0","0","0","0","0","0","47","27","20","1","0","1","0","0","0","0","0","0","-2"
"178721","Park University","2014","Tenured, professors","19","15","4","0","0","0","1","0","1","1","1","0","0","0","0","0","0","0","17","14","3","0","0","0","0","0","0","0","0","0","-2"
"178721","Park University","2014","Tenured, associate professors","31","13","18","0","0","0","1","0","1","0","0","0","0","0","0","0","0","0","30","13","17","0","0","0","0","0","0","0","0","0","-2"
"178721","Park University","2014","Tenured, assistant professors","1","0","1","0","0","0","0","0","0","0","0","0","0","0","0","0","0","0","0","0","0","1","0","1","0","0","0","0","0","0","-2"
"178721","Park University","2014","On-Tenure track total","43","24","19","1","0","1","3","1","2","1","1","0","0","0","0","0","0","0","35","20","15","1","1","0","0","0","0","2","1","1","-2"
"178721","Park University","2014","On-tenure track, associate professors","13","10","3","0","0","0","1","0","1","1","1","0","0","0","0","0","0","0","11","9","2","0","0","0","0","0","0","0","0","0","-2"
"178721","Park University","2014","On-tenure track, assistant professors","29","14","15","0","0","0","2","1","1","0","0","0","0","0","0","0","0","0","24","11","13","1","1","0","0","0","0","2","1","1","-2"
"178721","Park University","2014","On-tenure track, lecturers","1","0","1","1","0","1","0","0","0","0","0","0","0","0","0","0","0","0","0","0","0","0","0","0","0","0","0","0","0","0","-2"
"178721","Park University","2014","Not on tenure track/No tenure system system total","35","16","19","0","0","0","0","0","0","0","0","0","2","2","0","0","0","0","30","13","17","1","0","1","0","0","0","2","1","1","-2"
"178721","Park University","2014","Not on tenure/no tenure system, professors","1","0","1","0","0","0","0","0","0","0","0","0","0","0","0","0","0","0","1","0","1","0","0","0","0","0","0","0","0","0","-2"
"178721","Park University","2014","Not on tenure/no tenure system, associate professors","2","2","0","0","0","0","0","0","0","0","0","0","0","0","0","0","0","0","2","2","0","0","0","0","0","0","0","0","0","0","-2"
"178721","Park University","2014","Not on tenure/no tenure system, assistant professors","18","7","11","0","0","0","0","0","0","0","0","0","1","1","0","0","0","0","15","5","10","1","0","1","0","0","0","1","1","0","-2"
"178721","Park University","2014","Not on tenure/no tenure system, instructors","6","3","3","0","0","0","0","0","0","0","0","0","0","0","0","0","0","0","5","3","2","0","0","0","0","0","0","1","0","1","-2"
"178721","Park University","2014","Not on tenure/no tenure system, lecturers","8","4","4","0","0","0","0","0","0","0","0","0","1","1","0","0","0","0","7","3","4","0","0","0","0","0","0","0","0","0","-2"
"182306","Great Basin College","2014","Tenured total","32","18","14","0","0","0","1","1","0","1","0","1","3","2","1","0","0","0","27","15","12","0","0","0","0","0","0","0","0","0","-2"
"182306","Great Basin College","2014","Tenured, professors","32","18","14","0","0","0","1","1","0","1","0","1","3","2","1","0","0","0","27","15","12","0","0","0","0","0","0","0","0","0","-2"
"182306","Great Basin College","2014","On-Tenure track total","16","9","7","0","0","0","3","1","2","1","1","0","0","0","0","0","0","0","12","7","5","0","0","0","0","0","0","0","0","0","-2"
"182306","Great Basin College","2014","On-tenure track, instructors","16","9","7","0","0","0","3","1","2","1","1","0","0","0","0","0","0","0","12","7","5","0","0","0","0","0","0","0","0","0","-2"
"182306","Great Basin College","2014","Not on tenure track/No tenure system system total","15","12","3","0","0","0","0","0","0","0","0","0","0","0","0","0","0","0","15","12","3","0","0","0","0","0","0","0","0","0","-2"
"182306","Great Basin College","2014","Not on tenure/no tenure system, instructors","15","12","3","0","0","0","0","0","0","0","0","0","0","0","0","0","0","0","15","12","3","0","0","0","0","0","0","0","0","0","-2"
"182564","Western Nevada College","2014","Tenured total","32","19","13","0","0","0","0","0","0","0","0","0","1","1","0","0","0","0","31","18","13","0","0","0","0","0","0","0","0","0","-2"
"182564","Western Nevada College","2014","Tenured, professors","32","19","13","0","0","0","0","0","0","0","0","0","1","1","0","0","0","0","31","18","13","0","0","0","0","0","0","0","0","0","-2"
"182564","Western Nevada College","2014","On-Tenure track total","5","2","3","0","0","0","0","0","0","0","0","0","0","0","0","0","0","0","5","2","3","0","0","0","0","0","0","0","0","0","-2"
"182564","Western Nevada College","2014","On-tenure track, professors","5","2","3","0","0","0","0","0","0","0","0","0","0","0","0","0","0","0","5","2","3","0","0","0","0","0","0","0","0","0","-2"
"182564","Western Nevada College","2014","Not on tenure track/No tenure system system total","6","5","1","0","0","0","0","0","0","0","0","0","0","0","0","0","0","0","6","5","1","0","0","0","0","0","0","0","0","0","-2"
"182564","Western Nevada College","2014","Not on tenure/no tenure system, professors","6","5","1","0","0","0","0","0","0","0","0","0","0","0","0","0","0","0","6","5","1","0","0","0","0","0","0","0","0","0","-2"
"183974","Centenary University","2014","Tenured total","12","8","4","0","0","0","1","0","1","0","0","0","0","0","0","0","0","0","11","8","3","0","0","0","0","0","0","0","0","0","-2"
"183974","Centenary University","2014","Tenured, professors","5","3","2","0","0","0","1","0","1","0","0","0","0","0","0","0","0","0","4","3","1","0","0","0","0","0","0","0","0","0","-2"
"183974","Centenary University","2014","Tenured, associate professors","7","5","2","0","0","0","0","0","0","0","0","0","0","0","0","0","0","0","7","5","2","0","0","0","0","0","0","0","0","0","-2"
"183974","Centenary University","2014","On-Tenure track total","13","8","5","0","0","0","2","2","0","1","1","0","0","0","0","0","0","0","10","5","5","0","0","0","0","0","0","0","0","0","-2"
"183974","Centenary University","2014","On-tenure track, associate professors","1","0","1","0","0","0","0","0","0","0","0","0","0","0","0","0","0","0","1","0","1","0","0","0","0","0","0","0","0","0","-2"
"183974","Centenary University","2014","On-tenure track, assistant professors","12","8","4","0","0","0","2","2","0","1","1","0","0","0","0","0","0","0","9","5","4","0","0","0","0","0","0","0","0","0","-2"
"183974","Centenary University","2014","Not on tenure track/No tenure system system total","54","21","33","0","0","0","2","0","2","2","0","2","0","0","0","0","0","0","50","21","29","0","0","0","0","0","0","0","0","0","-2"
"183974","Centenary University","2014","Not on tenure/no tenure system, professors","3","0","3","0","0","0","0","0","0","0","0","0","0","0","0","0","0","0","3","0","3","0","0","0","0","0","0","0","0","0","-2"
"183974","Centenary University","2014","Not on tenure/no tenure system, associate professors","18","6","12","0","0","0","1","0","1","1","0","1","0","0","0","0","0","0","16","6","10","0","0","0","0","0","0","0","0","0","-2"
"183974","Centenary University","2014","Not on tenure/no tenure system, assistant professors","32","15","17","0","0","0","1","0","1","1","0","1","0","0","0","0","0","0","30","15","15","0","0","0","0","0","0","0","0","0","-2"
"183974","Centenary University","2014","Not on tenure/no tenure system, instructors","1","0","1","0","0","0","0","0","0","0","0","0","0","0","0","0","0","0","1","0","1","0","0","0","0","0","0","0","0","0","-2"
"186201","Ramapo College of New Jersey","2014","Tenured total","166","88","78","0","0","0","18","12","6","10","7","3","14","3","11","1","0","1","119","64","55","4","2","2","0","0","0","0","0","0","-2"
"186201","Ramapo College of New Jersey","2014","Tenured, professors","66","38","28","0","0","0","5","5","0","4","2","2","4","1","3","0","0","0","51","29","22","2","1","1","0","0","0","0","0","0","-2"
"186201","Ramapo College of New Jersey","2014","Tenured, associate professors","81","40","41","0","0","0","13","7","6","2","2","0","8","2","6","0","0","0","57","29","28","1","0","1","0","0","0","0","0","0","-2"
"186201","Ramapo College of New Jersey","2014","Tenured, assistant professors","18","10","8","0","0","0","0","0","0","4","3","1","2","0","2","0","0","0","11","6","5","1","1","0","0","0","0","0","0","0","-2"
"186201","Ramapo College of New Jersey","2014","Tenured, instructors","1","0","1","0","0","0","0","0","0","0","0","0","0","0","0","1","0","1","0","0","0","0","0","0","0","0","0","0","0","0","-2"
"186201","Ramapo College of New Jersey","2014","On-Tenure track total","42","17","25","0","0","0","10","4","6","3","0","3","2","1","1","0","0","0","24","11","13","0","0","0","1","1","0","2","0","2","-2"
"186201","Ramapo College of New Jersey","2014","On-tenure track, associate professors","2","0","2","0","0","0","0","0","0","1","0","1","0","0","0","0","0","0","1","0","1","0","0","0","0","0","0","0","0","0","-2"
"186201","Ramapo College of New Jersey","2014","On-tenure track, assistant professors","39","17","22","0","0","0","10","4","6","2","0","2","2","1","1","0","0","0","22","11","11","0","0","0","1","1","0","2","0","2","-2"
"186201","Ramapo College of New Jersey","2014","On-tenure track, instructors","1","0","1","0","0","0","0","0","0","0","0","0","0","0","0","0","0","0","1","0","1","0","0","0","0","0","0","0","0","0","-2"
"186201","Ramapo College of New Jersey","2014","Not on tenure track/No tenure system system total","9","4","5","0","0","0","0","0","0","0","0","0","0","0","0","0","0","0","8","3","5","0","0","0","1","1","0","0","0","0","-2"
"186201","Ramapo College of New Jersey","2014","Not on tenure/no tenure system, assistant professors","9","4","5","0","0","0","0","0","0","0","0","0","0","0","0","0","0","0","8","3","5","0","0","0","1","1","0","0","0","0","-2"
"186283","Rider University","2014","Tenured total","190","103","87","0","0","0","24","12","12","5","2","3","3","2","1","0","0","0","158","87","71","0","0","0","0","0","0","0","0","0","-2"
"186283","Rider University","2014","Tenured, professors","93","51","42","0","0","0","8","5","3","3","2","1","1","0","1","0","0","0","81","44","37","0","0","0","0","0","0","0","0","0","-2"
"186283","Rider University","2014","Tenured, associate professors","97","52","45","0","0","0","16","7","9","2","0","2","2","2","0","0","0","0","77","43","34","0","0","0","0","0","0","0","0","0","-2"
"186283","Rider University","2014","On-Tenure track total","46","21","25","0","0","0","3","1","2","3","0","3","1","0","1","0","0","0","36","18","18","0","0","0","0","0","0","3","2","1","-2"
"186283","Rider University","2014","On-tenure track, professors","1","1","0","0","0","0","0","0","0","0","0","0","0","0","0","0","0","0","1","1","0","0","0","0","0","0","0","0","0","0","-2"
"186283","Rider University","2014","On-tenure track, assistant professors","45","20","25","0","0","0","3","1","2","3","0","3","1","0","1","0","0","0","35","17","18","0","0","0","0","0","0","3","2","1","-2"
"186283","Rider University","2014","Not on tenure track/No tenure system system total","8","4","4","0","0","0","0","0","0","0","0","0","0","0","0","0","0","0","8","4","4","0","0","0","0","0","0","0","0","0","-2"
"186283","Rider University","2014","Not on tenure/no tenure system, professors","2","2","0","0","0","0","0","0","0","0","0","0","0","0","0","0","0","0","2","2","0","0","0","0","0","0","0","0","0","0","-2"
"186283","Rider University","2014","Not on tenure/no tenure system, assistant professors","5","2","3","0","0","0","0","0","0","0","0","0","0","0","0","0","0","0","5","2","3","0","0","0","0","0","0","0","0","0","-2"
"186283","Rider University","2014","Not on tenure/no tenure system, instructors","1","0","1","0","0","0","0","0","0","0","0","0","0","0","0","0","0","0","1","0","1","0","0","0","0","0","0","0","0","0","-2"
"186371","Rutgers University-Camden","2014","Tenured total","149","100","49","0","0","0","26","24","2","4","2","2","2","1","1","0","0","0","102","66","36","0","0","0","5","2","3","10","5","5","-2"
"186371","Rutgers University-Camden","2014","Tenured, professors","90","64","26","0","0","0","13","13","0","2","0","2","1","0","1","0","0","0","67","46","21","0","0","0","4","2","2","3","3","0","-2"
"186371","Rutgers University-Camden","2014","Tenured, associate professors","59","36","23","0","0","0","13","11","2","2","2","0","1","1","0","0","0","0","35","20","15","0","0","0","1","0","1","7","2","5","-2"
"186371","Rutgers University-Camden","2014","On-Tenure track total","87","41","46","0","0","0","4","3","1","7","1","6","2","2","0","0","0","0","40","17","23","0","0","0","21","10","11","13","8","5","-2"
"186371","Rutgers University-Camden","2014","On-tenure track, associate professors","2","1","1","0","0","0","0","0","0","0","0","0","0","0","0","0","0","0","1","1","0","0","0","0","1","0","1","0","0","0","-2"
"186371","Rutgers University-Camden","2014","On-tenure track, assistant professors","85","40","45","0","0","0","4","3","1","7","1","6","2","2","0","0","0","0","39","16","23","0","0","0","20","10","10","13","8","5","-2"
"186371","Rutgers University-Camden","2014","Not on tenure track/No tenure system system total","61","24","37","0","0","0","2","1","1","0","0","0","1","1","0","0","0","0","45","15","30","2","1","1","10","5","5","1","1","0","-2"
"186371","Rutgers University-Camden","2014","Not on tenure/no tenure system, professors","12","5","7","0","0","0","0","0","0","0","0","0","0","0","0","0","0","0","12","5","7","0","0","0","0","0","0","0","0","0","-2"
"186371","Rutgers University-Camden","2014","Not on tenure/no tenure system, associate professors","8","3","5","0","0","0","0","0","0","0","0","0","0","0","0","0","0","0","7","2","5","0","0","0","1","1","0","0","0","0","-2"
"186371","Rutgers University-Camden","2014","Not on tenure/no tenure system, assistant professors","10","3","7","0","0","0","0","0","0","0","0","0","0","0","0","0","0","0","8","3","5","0","0","0","2","0","2","0","0","0","-2"
"186371","Rutgers University-Camden","2014","Not on tenure/no tenure system, instructors","31","13","18","0","0","0","2","1","1","0","0","0","1","1","0","0","0","0","18","5","13","2","1","1","7","4","3","1","1","0","-2"
"186584","Seton Hall University","2014","Tenured total","244","144","100","0","0","0","23","13","10","9","6","3","9","6","3","0","0","0","199","117","82","0","0","0","3","1","2","1","1","0","-2"
"186584","Seton Hall University","2014","Tenured, professors","111","66","45","0","0","0","8","5","3","5","4","1","5","3","2","0","0","0","93","54","39","0","0","0","0","0","0","0","0","0","-2"
"186584","Seton Hall University","2014","Tenured, associate professors","129","75","54","0","0","0","15","8","7","4","2","2","4","3","1","0","0","0","102","60","42","0","0","0","3","1","2","1","1","0","-2"
"186584","Seton Hall University","2014","Tenured, assistant professors","4","3","1","0","0","0","0","0","0","0","0","0","0","0","0","0","0","0","4","3","1","0","0","0","0","0","0","0","0","0","-2"
"186584","Seton Hall University","2014","On-Tenure track total","59","24","35","0","0","0","3","0","3","5","0","5","1","0","1","0","0","0","42","17","25","0","0","0","6","5","1","2","2","0","-2"
"186584","Seton Hall University","2014","On-tenure track, professors","2","1","1","0","0","0","0","0","0","0","0","0","0","0","0","0","0","0","2","1","1","0","0","0","0","0","0","0","0","0","-2"
"186584","Seton Hall University","2014","On-tenure track, associate professors","12","5","7","0","0","0","0","0","0","1","0","1","0","0","0","0","0","0","9","3","6","0","0","0","2","2","0","0","0","0","-2"
"186584","Seton Hall University","2014","On-tenure track, assistant professors","45","18","27","0","0","0","3","0","3","4","0","4","1","0","1","0","0","0","31","13","18","0","0","0","4","3","1","2","2","0","-2"
"186584","Seton Hall University","2014","Not on tenure track/No tenure system system total","151","60","91","1","1","0","10","3","7","6","1","5","7","1","6","0","0","0","118","50","68","0","0","0","7","3","4","2","1","1","-2"
"186584","Seton Hall University","2014","Not on tenure/no tenure system, professors","6","2","4","0","0","0","0","0","0","0","0","0","0","0","0","0","0","0","5","1","4","0","0","0","1","1","0","0","0","0","-2"
"186584","Seton Hall University","2014","Not on tenure/no tenure system, associate professors","28","13","15","0","0","0","3","2","1","1","0","1","0","0","0","0","0","0","23","10","13","0","0","0","0","0","0","1","1","0","-2"
"186584","Seton Hall University","2014","Not on tenure/no tenure system, assistant professors","48","14","34","0","0","0","2","1","1","2","0","2","2","0","2","0","0","0","37","13","24","0","0","0","4","0","4","1","0","1","-2"
"186584","Seton Hall University","2014","Not on tenure/no tenure system, instructors","31","12","19","0","0","0","3","0","3","2","1","1","2","0","2","0","0","0","23","10","13","0","0","0","1","1","0","0","0","0","-2"
"186584","Seton Hall University","2014","Not on tenure/no tenure system, lecturers","1","0","1","0","0","0","0","0","0","0","0","0","0","0","0","0","0","0","1","0","1","0","0","0","0","0","0","0","0","0","-2"
"186584","Seton Hall University","2014","Not on tenure/no tenure system, no academic rank","37","19","18","1","1","0","2","0","2","1","0","1","3","1","2","0","0","0","29","16","13","0","0","0","1","1","0","0","0","0","-2"
"188429","Adelphi University","2014","Tenured total","202","99","103","0","0","0","23","9","14","13","4","9","7","5","2","0","0","0","159","81","78","0","0","0","0","0","0","0","0","0","-2"
"188429","Adelphi University","2014","Tenured, professors","75","48","27","0","0","0","9","4","5","5","2","3","2","1","1","0","0","0","59","41","18","0","0","0","0","0","0","0","0","0","-2"
"188429","Adelphi University","2014","Tenured, associate professors","124","49","75","0","0","0","13","4","9","8","2","6","5","4","1","0","0","0","98","39","59","0","0","0","0","0","0","0","0","0","-2"
"188429","Adelphi University","2014","Tenured, assistant professors","3","2","1","0","0","0","1","1","0","0","0","0","0","0","0","0","0","0","2","1","1","0","0","0","0","0","0","0","0","0","-2"
"188429","Adelphi University","2014","On-Tenure track total","73","31","42","0","0","0","14","5","9","4","0","4","4","1","3","0","0","0","49","25","24","1","0","1","1","0","1","0","0","0","-2"
"188429","Adelphi University","2014","On-tenure track, associate professors","3","0","3","0","0","0","0","0","0","1","0","1","0","0","0","0","0","0","2","0","2","0","0","0","0","0","0","0","0","0","-2"
"188429","Adelphi University","2014","On-tenure track, assistant professors","70","31","39","0","0","0","14","5","9","3","0","3","4","1","3","0","0","0","47","25","22","1","0","1","1","0","1","0","0","0","-2"
"188429","Adelphi University","2014","Not on tenure track/No tenure system system total","39","10","29","0","0","0","1","1","0","2","1","1","1","0","1","0","0","0","35","8","27","0","0","0","0","0","0","0","0","0","-2"
"188429","Adelphi University","2014","Not on tenure/no tenure system, lecturers","6","2","4","0","0","0","0","0","0","0","0","0","0","0","0","0","0","0","6","2","4","0","0","0","0","0","0","0","0","0","-2"
"188429","Adelphi University","2014","Not on tenure/no tenure system, no academic rank","33","8","25","0","0","0","1","1","0","2","1","1","1","0","1","0","0","0","29","6","23","0","0","0","0","0","0","0","0","0","-2"
"190248","Concordia College","2014","Not on tenure track/No tenure system system total","46","17","29","0","0","0","2","1","1","1","0","1","0","0","0","0","0","0","43","16","27","0","0","0","0","0","0","0","0","0","-2"
"190248","Concordia College","2014","Not on tenure/no tenure system, professors","11","4","7","0","0","0","1","1","0","1","0","1","0","0","0","0","0","0","9","3","6","0","0","0","0","0","0","0","0","0","-2"
"190248","Concordia College","2014","Not on tenure/no tenure system, associate professors","11","6","5","0","0","0","0","0","0","0","0","0","0","0","0","0","0","0","11","6","5","0","0","0","0","0","0","0","0","0","-2"
"190248","Concordia College","2014","Not on tenure/no tenure system, assistant professors","21","6","15","0","0","0","1","0","1","0","0","0","0","0","0","0","0","0","20","6","14","0","0","0","0","0","0","0","0","0","-2"
"190248","Concordia College","2014","Not on tenure/no tenure system, instructors","3","1","2","0","0","0","0","0","0","0","0","0","0","0","0","0","0","0","3","1","2","0","0","0","0","0","0","0","0","0","-2"
"190503","Culinary Institute of America","2014","Not on tenure track/No tenure system system total","155","113","42","1","1","0","4","1","3","3","2","1","4","3","1","1","1","0","133","99","34","4","4","0","5","2","3","0","0","0","-2"
"190503","Culinary Institute of America","2014","Not on tenure/no tenure system, professors","26","19","7","0","0","0","1","0","1","0","0","0","0","0","0","0","0","0","23","18","5","1","1","0","1","0","1","0","0","0","-2"
"190503","Culinary Institute of America","2014","Not on tenure/no tenure system, associate professors","60","40","20","1","1","0","0","0","0","2","1","1","2","2","0","0","0","0","54","36","18","0","0","0","1","0","1","0","0","0","-2"
"190503","Culinary Institute of America","2014","Not on tenure/no tenure system, assistant professors","21","17","4","0","0","0","0","0","0","1","1","0","1","1","0","0","0","0","18","14","4","0","0","0","1","1","0","0","0","0","-2"
"190503","Culinary Institute of America","2014","Not on tenure/no tenure system, instructors","48","37","11","0","0","0","3","1","2","0","0","0","1","0","1","1","1","0","38","31","7","3","3","0","2","1","1","0","0","0","-2"
"190512","CUNY Bernard M Baruch College","2014","Tenured total","352","226","126","0","0","0","48","37","11","21","9","12","15","6","9","0","0","0","257","165","92","0","0","0","0","0","0","11","9","2","-2"
"190512","CUNY Bernard M Baruch College","2014","Tenured, professors","185","125","60","0","0","0","24","18","6","6","3","3","8","3","5","0","0","0","145","99","46","0","0","0","0","0","0","2","2","0","-2"
"190512","CUNY Bernard M Baruch College","2014","Tenured, associate professors","138","84","54","0","0","0","20","16","4","11","5","6","6","2","4","0","0","0","92","54","38","0","0","0","0","0","0","9","7","2","-2"
"190512","CUNY Bernard M Baruch College","2014","Tenured, assistant professors","5","4","1","0","0","0","1","1","0","0","0","0","0","0","0","0","0","0","4","3","1","0","0","0","0","0","0","0","0","0","-2"
"190512","CUNY Bernard M Baruch College","2014","Tenured, lecturers","24","13","11","0","0","0","3","2","1","4","1","3","1","1","0","0","0","0","16","9","7","0","0","0","0","0","0","0","0","0","-2"
"190512","CUNY Bernard M Baruch College","2014","On-Tenure track total","141","74","67","0","0","0","19","9","10","5","2","3","5","1","4","0","0","0","76","41","35","0","0","0","0","0","0","36","21","15","-2"
"190512","CUNY Bernard M Baruch College","2014","On-tenure track, professors","1","1","0","0","0","0","0","0","0","0","0","0","0","0","0","0","0","0","1","1","0","0","0","0","0","0","0","0","0","0","-2"
"190512","CUNY Bernard M Baruch College","2014","On-tenure track, associate professors","4","3","1","0","0","0","1","0","1","0","0","0","0","0","0","0","0","0","1","1","0","0","0","0","0","0","0","2","2","0","-2"
"190512","CUNY Bernard M Baruch College","2014","On-tenure track, assistant professors","122","61","61","0","0","0","16","8","8","4","2","2","2","1","1","0","0","0","66","31","35","0","0","0","0","0","0","34","19","15","-2"
"190512","CUNY Bernard M Baruch College","2014","On-tenure track, lecturers","14","9","5","0","0","0","2","1","1","1","0","1","3","0","3","0","0","0","8","8","0","0","0","0","0","0","0","0","0","0","-2"
"190512","CUNY Bernard M Baruch College","2014","Not on tenure track/No tenure system system total","31","18","13","0","0","0","2","0","2","3","1","2","1","0","1","0","0","0","24","17","7","0","0","0","0","0","0","1","0","1","-2"
"190512","CUNY Bernard M Baruch College","2014","Not on tenure/no tenure system, professors","18","12","6","0","0","0","0","0","0","2","0","2","0","0","0","0","0","0","16","12","4","0","0","0","0","0","0","0","0","0","-2"
"190512","CUNY Bernard M Baruch College","2014","Not on tenure/no tenure system, assistant professors","5","3","2","0","0","0","1","0","1","1","1","0","0","0","0","0","0","0","3","2","1","0","0","0","0","0","0","0","0","0","-2"
"190512","CUNY Bernard M Baruch College","2014","Not on tenure/no tenure system, instructors","2","1","1","0","0","0","0","0","0","0","0","0","0","0","0","0","0","0","2","1","1","0","0","0","0","0","0","0","0","0","-2"
"190512","CUNY Bernard M Baruch College","2014","Not on tenure/no tenure system, lecturers","6","2","4","0","0","0","1","0","1","0","0","0","1","0","1","0","0","0","3","2","1","0","0","0","0","0","0","1","0","1","-2"
"190549","CUNY Brooklyn College","2014","Tenured total","385","227","158","1","0","1","35","25","10","23","15","8","23","10","13","0","0","0","294","170","124","1","1","0","0","0","0","8","6","2","-2"
"190549","CUNY Brooklyn College","2014","Tenured, professors","205","132","73","1","0","1","13","12","1","9","5","4","11","6","5","0","0","0","169","107","62","0","0","0","0","0","0","2","2","0","-2"
"190549","CUNY Brooklyn College","2014","Tenured, associate professors","132","69","63","0","0","0","17","11","6","8","6","2","8","2","6","0","0","0","94","46","48","1","1","0","0","0","0","4","3","1","-2"
"190549","CUNY Brooklyn College","2014","Tenured, assistant professors","29","12","17","0","0","0","5","2","3","3","1","2","2","0","2","0","0","0","17","8","9","0","0","0","0","0","0","2","1","1","-2"
"190549","CUNY Brooklyn College","2014","Tenured, lecturers","19","14","5","0","0","0","0","0","0","3","3","0","2","2","0","0","0","0","14","9","5","0","0","0","0","0","0","0","0","0","-2"
"190549","CUNY Brooklyn College","2014","On-Tenure track total","138","61","77","0","0","0","18","3","15","12","9","3","7","4","3","1","1","0","88","40","48","1","0","1","0","0","0","11","4","7","-2"
"190549","CUNY Brooklyn College","2014","On-tenure track, associate professors","10","7","3","0","0","0","1","0","1","1","1","0","0","0","0","0","0","0","8","6","2","0","0","0","0","0","0","0","0","0","-2"
"190549","CUNY Brooklyn College","2014","On-tenure track, assistant professors","111","47","64","0","0","0","16","3","13","10","7","3","7","4","3","1","1","0","65","28","37","1","0","1","0","0","0","11","4","7","-2"
"190549","CUNY Brooklyn College","2014","On-tenure track, lecturers","17","7","10","0","0","0","1","0","1","1","1","0","0","0","0","0","0","0","15","6","9","0","0","0","0","0","0","0","0","0","-2"
"190549","CUNY Brooklyn College","2014","Not on tenure track/No tenure system system total","44","19","25","0","0","0","2","1","1","2","0","2","6","3","3","0","0","0","30","14","16","1","0","1","0","0","0","3","1","2","-2"
"190549","CUNY Brooklyn College","2014","Not on tenure/no tenure system, professors","5","3","2","0","0","0","0","0","0","0","0","0","1","1","0","0","0","0","4","2","2","0","0","0","0","0","0","0","0","0","-2"
"190549","CUNY Brooklyn College","2014","Not on tenure/no tenure system, associate professors","1","0","1","0","0","0","0","0","0","0","0","0","0","0","0","0","0","0","1","0","1","0","0","0","0","0","0","0","0","0","-2"
"190549","CUNY Brooklyn College","2014","Not on tenure/no tenure system, assistant professors","15","8","7","0","0","0","0","0","0","0","0","0","1","0","1","0","0","0","14","8","6","0","0","0","0","0","0","0","0","0","-2"
"190549","CUNY Brooklyn College","2014","Not on tenure/no tenure system, instructors","13","2","11","0","0","0","1","0","1","1","0","1","3","1","2","0","0","0","6","1","5","0","0","0","0","0","0","2","0","2","-2"
"190549","CUNY Brooklyn College","2014","Not on tenure/no tenure system, lecturers","10","6","4","0","0","0","1","1","0","1","0","1","1","1","0","0","0","0","5","3","2","1","0","1","0","0","0","1","1","0","-2"
"190646","CUNY Medgar Evers College","2014","Tenured total","114","68","46","0","0","0","14","8","6","70","43","27","5","3","2","0","0","0","22","13","9","1","1","0","0","0","0","2","0","2","-2"
"190646","CUNY Medgar Evers College","2014","Tenured, professors","48","32","16","0","0","0","11","8","3","24","15","9","2","2","0","0","0","0","11","7","4","0","0","0","0","0","0","0","0","0","-2"
"190646","CUNY Medgar Evers College","2014","Tenured, associate professors","23","10","13","0","0","0","1","0","1","13","6","7","1","0","1","0","0","0","7","4","3","0","0","0","0","0","0","1","0","1","-2"
"190646","CUNY Medgar Evers College","2014","Tenured, assistant professors","12","6","6","0","0","0","0","0","0","7","3","4","1","1","0","0","0","0","3","1","2","1","1","0","0","0","0","0","0","0","-2"
"190646","CUNY Medgar Evers College","2014","Tenured, lecturers","31","20","11","0","0","0","2","0","2","26","19","7","1","0","1","0","0","0","1","1","0","0","0","0","0","0","0","1","0","1","-2"
"190646","CUNY Medgar Evers College","2014","On-Tenure track total","47","20","27","0","0","0","5","2","3","28","11","17","2","2","0","0","0","0","9","5","4","1","0","1","0","0","0","2","0","2","-2"
"190646","CUNY Medgar Evers College","2014","On-tenure track, professors","1","1","0","0","0","0","0","0","0","1","1","0","0","0","0","0","0","0","0","0","0","0","0","0","0","0","0","0","0","0","-2"
"190646","CUNY Medgar Evers College","2014","On-tenure track, associate professors","12","8","4","0","0","0","3","1","2","6","5","1","0","0","0","0","0","0","3","2","1","0","0","0","0","0","0","0","0","0","-2"
"190646","CUNY Medgar Evers College","2014","On-tenure track, assistant professors","32","10","22","0","0","0","2","1","1","19","4","15","2","2","0","0","0","0","6","3","3","1","0","1","0","0","0","2","0","2","-2"
"190646","CUNY Medgar Evers College","2014","On-tenure track, lecturers","2","1","1","0","0","0","0","0","0","2","1","1","0","0","0","0","0","0","0","0","0","0","0","0","0","0","0","0","0","0","-2"
"190646","CUNY Medgar Evers College","2014","Not on tenure track/No tenure system system total","17","8","9","0","0","0","1","1","0","12","5","7","0","0","0","0","0","0","4","2","2","0","0","0","0","0","0","0","0","0","-2"
"190646","CUNY Medgar Evers College","2014","Not on tenure/no tenure system, professors","4","2","2","0","0","0","0","0","0","2","1","1","0","0","0","0","0","0","2","1","1","0","0","0","0","0","0","0","0","0","-2"
"190646","CUNY Medgar Evers College","2014","Not on tenure/no tenure system, assistant professors","8","3","5","0","0","0","0","0","0","7","3","4","0","0","0","0","0","0","1","0","1","0","0","0","0","0","0","0","0","0","-2"
"190646","CUNY Medgar Evers College","2014","Not on tenure/no tenure system, instructors","3","3","0","0","0","0","1","1","0","1","1","0","0","0","0","0","0","0","1","1","0","0","0","0","0","0","0","0","0","0","-2"
"190646","CUNY Medgar Evers College","2014","Not on tenure/no tenure system, lecturers","2","0","2","0","0","0","0","0","0","2","0","2","0","0","0","0","0","0","0","0","0","0","0","0","0","0","0","0","0","0","-2"
"191126","Fashion Institute of Technology","2014","Tenured total","205","98","107","0","0","0","5","4","1","8","4","4","7","3","4","0","0","0","88","38","50","0","0","0","97","49","48","0","0","0","-2"
"191126","Fashion Institute of Technology","2014","Tenured, professors","50","20","30","0","0","0","1","1","0","1","0","1","0","0","0","0","0","0","21","7","14","0","0","0","27","12","15","0","0","0","-2"
"191126","Fashion Institute of Technology","2014","Tenured, associate professors","67","37","30","0","0","0","4","3","1","1","1","0","3","1","2","0","0","0","30","15","15","0","0","0","29","17","12","0","0","0","-2"
"191126","Fashion Institute of Technology","2014","Tenured, assistant professors","88","41","47","0","0","0","0","0","0","6","3","3","4","2","2","0","0","0","37","16","21","0","0","0","41","20","21","0","0","0","-2"
"191126","Fashion Institute of Technology","2014","On-Tenure track total","27","10","17","0","0","0","3","1","2","1","0","1","0","0","0","0","0","0","15","6","9","0","0","0","8","3","5","0","0","0","-2"
"191126","Fashion Institute of Technology","2014","On-tenure track, associate professors","6","2","4","0","0","0","1","1","0","0","0","0","0","0","0","0","0","0","4","1","3","0","0","0","1","0","1","0","0","0","-2"
"191126","Fashion Institute of Technology","2014","On-tenure track, assistant professors","18","8","10","0","0","0","2","0","2","0","0","0","0","0","0","0","0","0","10","5","5","0","0","0","6","3","3","0","0","0","-2"
"191126","Fashion Institute of Technology","2014","On-tenure track, instructors","3","0","3","0","0","0","0","0","0","1","0","1","0","0","0","0","0","0","1","0","1","0","0","0","1","0","1","0","0","0","-2"
"191931","Iona College","2014","Tenured total","114","74","40","0","0","0","9","4","5","5","2","3","2","0","2","0","0","0","96","67","29","0","0","0","0","0","0","2","1","1","-2"
"191931","Iona College","2014","Tenured, professors","46","34","12","0","0","0","2","1","1","2","0","2","0","0","0","0","0","0","42","33","9","0","0","0","0","0","0","0","0","0","-2"
"191931","Iona College","2014","Tenured, associate professors","65","38","27","0","0","0","7","3","4","3","2","1","2","0","2","0","0","0","51","32","19","0","0","0","0","0","0","2","1","1","-2"
"191931","Iona College","2014","Tenured, assistant professors","3","2","1","0","0","0","0","0","0","0","0","0","0","0","0","0","0","0","3","2","1","0","0","0","0","0","0","0","0","0","-2"
"191931","Iona College","2014","On-Tenure track total","33","12","21","0","0","0","8","3","5","2","0","2","0","0","0","0","0","0","22","8","14","0","0","0","0","0","0","1","1","0","-2"
"191931","Iona College","2014","On-tenure track, assistant professors","33","12","21","0","0","0","8","3","5","2","0","2","0","0","0","0","0","0","22","8","14","0","0","0","0","0","0","1","1","0","-2"
"191931","Iona College","2014","Not on tenure track/No tenure system system total","23","15","8","0","0","0","0","0","0","1","0","1","0","0","0","0","0","0","22","15","7","0","0","0","0","0","0","0","0","0","-2"
"191931","Iona College","2014","Not on tenure/no tenure system, assistant professors","6","4","2","0","0","0","0","0","0","0","0","0","0","0","0","0","0","0","6","4","2","0","0","0","0","0","0","0","0","0","-2"
"191931","Iona College","2014","Not on tenure/no tenure system, instructors","6","5","1","0","0","0","0","0","0","0","0","0","0","0","0","0","0","0","6","5","1","0","0","0","0","0","0","0","0","0","-2"
"191931","Iona College","2014","Not on tenure/no tenure system, lecturers","11","6","5","0","0","0","0","0","0","1","0","1","0","0","0","0","0","0","10","6","4","0","0","0","0","0","0","0","0","0","-2"
"193292","Molloy College","2014","Tenured total","124","30","94","0","0","0","4","1","3","9","0","9","4","1","3","0","0","0","106","28","78","1","0","1","0","0","0","0","0","0","-2"
"193292","Molloy College","2014","Tenured, professors","49","14","35","0","0","0","0","0","0","2","0","2","3","1","2","0","0","0","44","13","31","0","0","0","0","0","0","0","0","0","-2"
"193292","Molloy College","2014","Tenured, associate professors","46","11","35","0","0","0","3","1","2","5","0","5","0","0","0","0","0","0","37","10","27","1","0","1","0","0","0","0","0","0","-2"
"193292","Molloy College","2014","Tenured, assistant professors","29","5","24","0","0","0","1","0","1","2","0","2","1","0","1","0","0","0","25","5","20","0","0","0","0","0","0","0","0","0","-2"
"193292","Molloy College","2014","On-Tenure track total","59","19","40","0","0","0","5","0","5","4","1","3","2","2","0","0","0","0","46","15","31","2","1","1","0","0","0","0","0","0","-2"
"193292","Molloy College","2014","On-tenure track, professors","2","1","1","0","0","0","0","0","0","0","0","0","0","0","0","0","0","0","2","1","1","0","0","0","0","0","0","0","0","0","-2"
"193292","Molloy College","2014","On-tenure track, associate professors","12","4","8","0","0","0","1","0","1","0","0","0","1","1","0","0","0","0","10","3","7","0","0","0","0","0","0","0","0","0","-2"
"193292","Molloy College","2014","On-tenure track, assistant professors","33","11","22","0","0","0","3","0","3","4","1","3","1","1","0","0","0","0","23","8","15","2","1","1","0","0","0","0","0","0","-2"
"193292","Molloy College","2014","On-tenure track, instructors","12","3","9","0","0","0","1","0","1","0","0","0","0","0","0","0","0","0","11","3","8","0","0","0","0","0","0","0","0","0","-2"
"194091","New York Institute of Technology","2014","Tenured total","159","109","50","1","1","0","26","17","9","4","3","1","2","2","0","0","0","0","126","86","40","0","0","0","0","0","0","0","0","0","-2"
"194091","New York Institute of Technology","2014","Tenured, professors","65","56","9","1","1","0","9","8","1","4","3","1","1","1","0","0","0","0","50","43","7","0","0","0","0","0","0","0","0","0","-2"
"194091","New York Institute of Technology","2014","Tenured, associate professors","84","50","34","0","0","0","15","8","7","0","0","0","0","0","0","0","0","0","69","42","27","0","0","0","0","0","0","0","0","0","-2"
"194091","New York Institute of Technology","2014","Tenured, assistant professors","10","3","7","0","0","0","2","1","1","0","0","0","1","1","0","0","0","0","7","1","6","0","0","0","0","0","0","0","0","0","-2"
"194091","New York Institute of Technology","2014","On-Tenure track total","62","28","34","0","0","0","17","8","9","1","0","1","1","1","0","1","1","0","42","18","24","0","0","0","0","0","0","0","0","0","-2"
"194091","New York Institute of Technology","2014","On-tenure track, associate professors","7","4","3","0","0","0","1","0","1","0","0","0","0","0","0","0","0","0","6","4","2","0","0","0","0","0","0","0","0","0","-2"
"194091","New York Institute of Technology","2014","On-tenure track, assistant professors","54","24","30","0","0","0","16","8","8","1","0","1","1","1","0","1","1","0","35","14","21","0","0","0","0","0","0","0","0","0","-2"
"194091","New York Institute of Technology","2014","On-tenure track, instructors","1","0","1","0","0","0","0","0","0","0","0","0","0","0","0","0","0","0","1","0","1","0","0","0","0","0","0","0","0","0","-2"
"194091","New York Institute of Technology","2014","Not on tenure track/No tenure system system total","77","49","28","1","1","0","16","11","5","3","1","2","3","2","1","0","0","0","54","34","20","0","0","0","0","0","0","0","0","0","-2"
"194091","New York Institute of Technology","2014","Not on tenure/no tenure system, professors","8","6","2","0","0","0","1","1","0","0","0","0","0","0","0","0","0","0","7","5","2","0","0","0","0","0","0","0","0","0","-2"
"194091","New York Institute of Technology","2014","Not on tenure/no tenure system, associate professors","15","13","2","0","0","0","2","2","0","1","1","0","0","0","0","0","0","0","12","10","2","0","0","0","0","0","0","0","0","0","-2"
"194091","New York Institute of Technology","2014","Not on tenure/no tenure system, assistant professors","46","26","20","1","1","0","10","6","4","2","0","2","3","2","1","0","0","0","30","17","13","0","0","0","0","0","0","0","0","0","-2"
"194091","New York Institute of Technology","2014","Not on tenure/no tenure system, instructors","8","4","4","0","0","0","3","2","1","0","0","0","0","0","0","0","0","0","5","2","3","0","0","0","0","0","0","0","0","0","-2"
"195243","St. Thomas Aquinas College","2014","Tenured total","31","17","14","0","0","0","1","0","1","1","1","0","1","1","0","0","0","0","28","15","13","0","0","0","0","0","0","0","0","0","-2"
"195243","St. Thomas Aquinas College","2014","Tenured, professors","24","11","13","0","0","0","1","0","1","0","0","0","1","1","0","0","0","0","22","10","12","0","0","0","0","0","0","0","0","0","-2"
"195243","St. Thomas Aquinas College","2014","Tenured, associate professors","6","5","1","0","0","0","0","0","0","0","0","0","0","0","0","0","0","0","6","5","1","0","0","0","0","0","0","0","0","0","-2"
"195243","St. Thomas Aquinas College","2014","Tenured, assistant professors","1","1","0","0","0","0","0","0","0","1","1","0","0","0","0","0","0","0","0","0","0","0","0","0","0","0","0","0","0","0","-2"
"195243","St. Thomas Aquinas College","2014","On-Tenure track total","19","6","13","0","0","0","0","0","0","0","0","0","0","0","0","0","0","0","19","6","13","0","0","0","0","0","0","0","0","0","-2"
"195243","St. Thomas Aquinas College","2014","On-tenure track, assistant professors","19","6","13","0","0","0","0","0","0","0","0","0","0","0","0","0","0","0","19","6","13","0","0","0","0","0","0","0","0","0","-2"
"195243","St. Thomas Aquinas College","2014","Not on tenure track/No tenure system system total","5","2","3","0","0","0","0","0","0","0","0","0","0","0","0","0","0","0","5","2","3","0","0","0","0","0","0","0","0","0","-2"
"195243","St. Thomas Aquinas College","2014","Not on tenure/no tenure system, assistant professors","1","1","0","0","0","0","0","0","0","0","0","0","0","0","0","0","0","0","1","1","0","0","0","0","0","0","0","0","0","0","-2"
"195243","St. Thomas Aquinas College","2014","Not on tenure/no tenure system, instructors","4","1","3","0","0","0","0","0","0","0","0","0","0","0","0","0","0","0","4","1","3","0","0","0","0","0","0","0","0","0","-2"
"196024","SUNY College of Technology at Delhi","2014","Tenured total","62","40","22","0","0","0","2","1","1","2","0","2","1","1","0","0","0","0","57","38","19","0","0","0","0","0","0","0","0","0","-2"
"196024","SUNY College of Technology at Delhi","2014","Tenured, professors","27","18","9","0","0","0","0","0","0","0","0","0","0","0","0","0","0","0","27","18","9","0","0","0","0","0","0","0","0","0","-2"
"196024","SUNY College of Technology at Delhi","2014","Tenured, associate professors","17","9","8","0","0","0","1","0","1","0","0","0","1","1","0","0","0","0","15","8","7","0","0","0","0","0","0","0","0","0","-2"
"196024","SUNY College of Technology at Delhi","2014","Tenured, assistant professors","12","8","4","0","0","0","0","0","0","2","0","2","0","0","0","0","0","0","10","8","2","0","0","0","0","0","0","0","0","0","-2"
"196024","SUNY College of Technology at Delhi","2014","Tenured, instructors","6","5","1","0","0","0","1","1","0","0","0","0","0","0","0","0","0","0","5","4","1","0","0","0","0","0","0","0","0","0","-2"
"196024","SUNY College of Technology at Delhi","2014","On-Tenure track total","66","27","39","0","0","0","2","1","1","3","2","1","0","0","0","0","0","0","61","24","37","0","0","0","0","0","0","0","0","0","-2"
"196024","SUNY College of Technology at Delhi","2014","On-tenure track, associate professors","8","3","5","0","0","0","0","0","0","1","1","0","0","0","0","0","0","0","7","2","5","0","0","0","0","0","0","0","0","0","-2"
"196024","SUNY College of Technology at Delhi","2014","On-tenure track, assistant professors","46","18","28","0","0","0","2","1","1","2","1","1","0","0","0","0","0","0","42","16","26","0","0","0","0","0","0","0","0","0","-2"
"196024","SUNY College of Technology at Delhi","2014","On-tenure track, instructors","12","6","6","0","0","0","0","0","0","0","0","0","0","0","0","0","0","0","12","6","6","0","0","0","0","0","0","0","0","0","-2"
"196024","SUNY College of Technology at Delhi","2014","Not on tenure track/No tenure system system total","10","5","5","0","0","0","0","0","0","0","0","0","0","0","0","0","0","0","10","5","5","0","0","0","0","0","0","0","0","0","-2"
"196024","SUNY College of Technology at Delhi","2014","Not on tenure/no tenure system, instructors","10","5","5","0","0","0","0","0","0","0","0","0","0","0","0","0","0","0","10","5","5","0","0","0","0","0","0","0","0","0","-2"
"196042","Farmingdale State College","2014","Tenured total","99","58","41","0","0","0","6","5","1","2","1","1","5","3","2","0","0","0","86","49","37","0","0","0","0","0","0","0","0","0","-2"
"196042","Farmingdale State College","2014","Tenured, professors","57","35","22","0","0","0","5","4","1","1","1","0","2","1","1","0","0","0","49","29","20","0","0","0","0","0","0","0","0","0","-2"
"196042","Farmingdale State College","2014","Tenured, associate professors","30","15","15","0","0","0","1","1","0","0","0","0","1","0","1","0","0","0","28","14","14","0","0","0","0","0","0","0","0","0","-2"
"196042","Farmingdale State College","2014","Tenured, assistant professors","12","8","4","0","0","0","0","0","0","1","0","1","2","2","0","0","0","0","9","6","3","0","0","0","0","0","0","0","0","0","-2"
"196042","Farmingdale State College","2014","On-Tenure track total","80","38","42","0","0","0","18","11","7","6","1","5","4","3","1","0","0","0","48","19","29","1","1","0","0","0","0","3","3","0","-2"
"196042","Farmingdale State College","2014","On-tenure track, professors","2","1","1","0","0","0","1","0","1","0","0","0","0","0","0","0","0","0","1","1","0","0","0","0","0","0","0","0","0","0","-2"
"196042","Farmingdale State College","2014","On-tenure track, associate professors","14","6","8","0","0","0","2","2","0","1","1","0","0","0","0","0","0","0","10","2","8","0","0","0","0","0","0","1","1","0","-2"
"196042","Farmingdale State College","2014","On-tenure track, assistant professors","64","31","33","0","0","0","15","9","6","5","0","5","4","3","1","0","0","0","37","16","21","1","1","0","0","0","0","2","2","0","-2"
"196042","Farmingdale State College","2014","Not on tenure track/No tenure system system total","29","17","12","0","0","0","1","1","0","3","2","1","0","0","0","0","0","0","23","12","11","0","0","0","0","0","0","2","2","0","-2"
"196042","Farmingdale State College","2014","Not on tenure/no tenure system, associate professors","1","1","0","0","0","0","0","0","0","0","0","0","0","0","0","0","0","0","1","1","0","0","0","0","0","0","0","0","0","0","-2"
"196042","Farmingdale State College","2014","Not on tenure/no tenure system, assistant professors","24","15","9","0","0","0","1","1","0","2","2","0","0","0","0","0","0","0","19","10","9","0","0","0","0","0","0","2","2","0","-2"
"196042","Farmingdale State College","2014","Not on tenure/no tenure system, lecturers","4","1","3","0","0","0","0","0","0","1","0","1","0","0","0","0","0","0","3","1","2","0","0","0","0","0","0","0","0","0","-2"
"196176","State University of New York at New Paltz","2014","Tenured total","185","105","80","0","0","0","19","13","6","9","9","0","7","4","3","0","0","0","150","79","71","0","0","0","0","0","0","0","0","0","-2"
"196176","State University of New York at New Paltz","2014","Tenured, professors","52","33","19","0","0","0","8","6","2","2","2","0","1","1","0","0","0","0","41","24","17","0","0","0","0","0","0","0","0","0","-2"
"196176","State University of New York at New Paltz","2014","Tenured, associate professors","122","67","55","0","0","0","11","7","4","5","5","0","6","3","3","0","0","0","100","52","48","0","0","0","0","0","0","0","0","0","-2"
"196176","State University of New York at New Paltz","2014","Tenured, assistant professors","8","5","3","0","0","0","0","0","0","2","2","0","0","0","0","0","0","0","6","3","3","0","0","0","0","0","0","0","0","0","-2"
"196176","State University of New York at New Paltz","2014","Tenured, instructors","3","0","3","0","0","0","0","0","0","0","0","0","0","0","0","0","0","0","3","0","3","0","0","0","0","0","0","0","0","0","-2"
"196176","State University of New York at New Paltz","2014","On-Tenure track total","113","43","70","1","0","1","8","5","3","3","2","1","8","2","6","0","0","0","79","27","52","2","0","2","0","0","0","12","7","5","-2"
"196176","State University of New York at New Paltz","2014","On-tenure track, associate professors","21","13","8","1","0","1","1","1","0","1","1","0","1","1","0","0","0","0","17","10","7","0","0","0","0","0","0","0","0","0","-2"
"196176","State University of New York at New Paltz","2014","On-tenure track, assistant professors","87","30","57","0","0","0","7","4","3","2","1","1","6","1","5","0","0","0","58","17","41","2","0","2","0","0","0","12","7","5","-2"
"196176","State University of New York at New Paltz","2014","On-tenure track, instructors","5","0","5","0","0","0","0","0","0","0","0","0","1","0","1","0","0","0","4","0","4","0","0","0","0","0","0","0","0","0","-2"
"196176","State University of New York at New Paltz","2014","Not on tenure track/No tenure system system total","59","25","34","0","0","0","4","3","1","0","0","0","5","1","4","0","0","0","48","20","28","0","0","0","0","0","0","2","1","1","-2"
"196176","State University of New York at New Paltz","2014","Not on tenure/no tenure system, professors","1","1","0","0","0","0","0","0","0","0","0","0","0","0","0","0","0","0","1","1","0","0","0","0","0","0","0","0","0","0","-2"
"196176","State University of New York at New Paltz","2014","Not on tenure/no tenure system, assistant professors","4","1","3","0","0","0","1","1","0","0","0","0","1","0","1","0","0","0","2","0","2","0","0","0","0","0","0","0","0","0","-2"
"196176","State University of New York at New Paltz","2014","Not on tenure/no tenure system, lecturers","54","23","31","0","0","0","3","2","1","0","0","0","4","1","3","0","0","0","45","19","26","0","0","0","0","0","0","2","1","1","-2"
"207397","Oklahoma State University-Oklahoma City","2014","Tenured total","46","20","26","1","0","1","0","0","0","1","0","1","2","1","1","0","0","0","42","19","23","0","0","0","0","0","0","0","0","0","-2"
"207397","Oklahoma State University-Oklahoma City","2014","Tenured, professors","8","4","4","0","0","0","0","0","0","0","0","0","1","1","0","0","0","0","7","3","4","0","0","0","0","0","0","0","0","0","-2"
"207397","Oklahoma State University-Oklahoma City","2014","Tenured, associate professors","34","13","21","1","0","1","0","0","0","1","0","1","1","0","1","0","0","0","31","13","18","0","0","0","0","0","0","0","0","0","-2"
"207397","Oklahoma State University-Oklahoma City","2014","Tenured, instructors","4","3","1","0","0","0","0","0","0","0","0","0","0","0","0","0","0","0","4","3","1","0","0","0","0","0","0","0","0","0","-2"
"207397","Oklahoma State University-Oklahoma City","2014","On-Tenure track total","40","12","28","1","0","1","1","0","1","3","2","1","1","1","0","0","0","0","33","8","25","0","0","0","0","0","0","1","1","0","-2"
"207397","Oklahoma State University-Oklahoma City","2014","On-tenure track, associate professors","11","0","11","1","0","1","0","0","0","0","0","0","0","0","0","0","0","0","10","0","10","0","0","0","0","0","0","0","0","0","-2"
"207397","Oklahoma State University-Oklahoma City","2014","On-tenure track, assistant professors","6","6","0","0","0","0","0","0","0","2","2","0","1","1","0","0","0","0","2","2","0","0","0","0","0","0","0","1","1","0","-2"
"207397","Oklahoma State University-Oklahoma City","2014","On-tenure track, instructors","23","6","17","0","0","0","1","0","1","1","0","1","0","0","0","0","0","0","21","6","15","0","0","0","0","0","0","0","0","0","-2"
"209287","Multnomah University","2014","Tenured total","3","3","0","0","0","0","0","0","0","0","0","0","0","0","0","0","0","0","3","3","0","0","0","0","0","0","0","0","0","0","-2"
"209287","Multnomah University","2014","Tenured, professors","3","3","0","0","0","0","0","0","0","0","0","0","0","0","0","0","0","0","3","3","0","0","0","0","0","0","0","0","0","0","-2"
"209287","Multnomah University","2014","Not on tenure track/No tenure system system total","22","16","6","0","0","0","1","0","1","0","0","0","0","0","0","0","0","0","19","15","4","1","1","0","1","0","1","0","0","0","-2"
"209287","Multnomah University","2014","Not on tenure/no tenure system, professors","5","5","0","0","0","0","0","0","0","0","0","0","0","0","0","0","0","0","5","5","0","0","0","0","0","0","0","0","0","0","-2"
"209287","Multnomah University","2014","Not on tenure/no tenure system, associate professors","5","4","1","0","0","0","0","0","0","0","0","0","0","0","0","0","0","0","4","3","1","1","1","0","0","0","0","0","0","0","-2"
"209287","Multnomah University","2014","Not on tenure/no tenure system, assistant professors","12","7","5","0","0","0","1","0","1","0","0","0","0","0","0","0","0","0","10","7","3","0","0","0","1","0","1","0","0","0","-2"
"209612","Pacific University","2014","Tenured total","126","71","55","0","0","0","8","3","5","1","0","1","4","2","2","0","0","0","112","65","47","1","1","0","0","0","0","0","0","0","-2"
"209612","Pacific University","2014","Tenured, professors","65","41","24","0","0","0","1","0","1","1","0","1","1","0","1","0","0","0","62","41","21","0","0","0","0","0","0","0","0","0","-2"
"209612","Pacific University","2014","Tenured, associate professors","61","30","31","0","0","0","7","3","4","0","0","0","3","2","1","0","0","0","50","24","26","1","1","0","0","0","0","0","0","0","-2"
"209612","Pacific University","2014","On-Tenure track total","65","27","38","1","0","1","6","3","3","0","0","0","3","1","2","0","0","0","51","21","30","2","1","1","1","0","1","1","1","0","-2"
"209612","Pacific University","2014","On-tenure track, professors","1","1","0","0","0","0","0","0","0","0","0","0","0","0","0","0","0","0","1","1","0","0","0","0","0","0","0","0","0","0","-2"
"209612","Pacific University","2014","On-tenure track, associate professors","9","6","3","0","0","0","1","1","0","0","0","0","1","1","0","0","0","0","7","4","3","0","0","0","0","0","0","0","0","0","-2"
"209612","Pacific University","2014","On-tenure track, assistant professors","55","20","35","1","0","1","5","2","3","0","0","0","2","0","2","0","0","0","43","16","27","2","1","1","1","0","1","1","1","0","-2"
"209612","Pacific University","2014","Not on tenure track/No tenure system system total","85","35","50","0","0","0","8","3","5","2","1","1","5","2","3","0","0","0","68","27","41","2","2","0","0","0","0","0","0","0","-2"
"209612","Pacific University","2014","Not on tenure/no tenure system, professors","3","2","1","0","0","0","0","0","0","0","0","0","0","0","0","0","0","0","3","2","1","0","0","0","0","0","0","0","0","0","-2"
"209612","Pacific University","2014","Not on tenure/no tenure system, associate professors","13","5","8","0","0","0","1","0","1","0","0","0","0","0","0","0","0","0","12","5","7","0","0","0","0","0","0","0","0","0","-2"
"209612","Pacific University","2014","Not on tenure/no tenure system, assistant professors","53","20","33","0","0","0","6","2","4","2","1","1","2","0","2","0","0","0","41","15","26","2","2","0","0","0","0","0","0","0","-2"
"209612","Pacific University","2014","Not on tenure/no tenure system, instructors","16","8","8","0","0","0","1","1","0","0","0","0","3","2","1","0","0","0","12","5","7","0","0","0","0","0","0","0","0","0","-2"
"209807","Portland State University","2014","Tenured total","407","258","149","9","4","5","40","26","14","8","7","1","21","15","6","0","0","0","324","203","121","5","3","2","0","0","0","0","0","0","-2"
"209807","Portland State University","2014","Tenured, professors","236","164","72","6","3","3","25","19","6","4","4","0","6","3","3","0","0","0","195","135","60","0","0","0","0","0","0","0","0","0","-2"
"209807","Portland State University","2014","Tenured, associate professors","170","93","77","3","1","2","15","7","8","4","3","1","15","12","3","0","0","0","128","67","61","5","3","2","0","0","0","0","0","0","-2"
"209807","Portland State University","2014","Tenured, assistant professors","1","1","0","0","0","0","0","0","0","0","0","0","0","0","0","0","0","0","1","1","0","0","0","0","0","0","0","0","0","0","-2"
"209807","Portland State University","2014","On-Tenure track total","179","92","87","0","0","0","21","12","9","5","4","1","14","4","10","0","0","0","137","71","66","2","1","1","0","0","0","0","0","0","-2"
"209807","Portland State University","2014","On-tenure track, professors","2","0","2","0","0","0","1","0","1","0","0","0","0","0","0","0","0","0","1","0","1","0","0","0","0","0","0","0","0","0","-2"
"209807","Portland State University","2014","On-tenure track, associate professors","13","10","3","0","0","0","2","2","0","1","0","1","0","0","0","0","0","0","10","8","2","0","0","0","0","0","0","0","0","0","-2"
"209807","Portland State University","2014","On-tenure track, assistant professors","164","82","82","0","0","0","18","10","8","4","4","0","14","4","10","0","0","0","126","63","63","2","1","1","0","0","0","0","0","0","-2"
"209807","Portland State University","2014","Not on tenure track/No tenure system system total","257","103","154","1","0","1","10","4","6","10","5","5","9","2","7","0","0","0","223","91","132","4","1","3","0","0","0","0","0","0","-2"
"209807","Portland State University","2014","Not on tenure/no tenure system, professors","7","6","1","0","0","0","1","1","0","0","0","0","0","0","0","0","0","0","6","5","1","0","0","0","0","0","0","0","0","0","-2"
"209807","Portland State University","2014","Not on tenure/no tenure system, associate professors","11","6","5","0","0","0","0","0","0","1","1","0","0","0","0","0","0","0","10","5","5","0","0","0","0","0","0","0","0","0","-2"
"209807","Portland State University","2014","Not on tenure/no tenure system, assistant professors","74","31","43","0","0","0","5","2","3","3","1","2","3","0","3","0","0","0","62","28","34","1","0","1","0","0","0","0","0","0","-2"
"209807","Portland State University","2014","Not on tenure/no tenure system, instructors","163","58","105","1","0","1","4","1","3","6","3","3","6","2","4","0","0","0","143","51","92","3","1","2","0","0","0","0","0","0","-2"
"209807","Portland State University","2014","Not on tenure/no tenure system, lecturers","2","2","0","0","0","0","0","0","0","0","0","0","0","0","0","0","0","0","2","2","0","0","0","0","0","0","0","0","0","0","-2"
"210429","Western Oregon University","2014","Tenured total","127","68","59","0","0","0","4","1","3","4","2","2","3","1","2","0","0","0","111","61","50","0","0","0","2","2","0","3","1","2","-2"
"210429","Western Oregon University","2014","Tenured, professors","87","49","38","0","0","0","3","1","2","1","1","0","3","1","2","0","0","0","78","44","34","0","0","0","2","2","0","0","0","0","-2"
"210429","Western Oregon University","2014","Tenured, associate professors","40","19","21","0","0","0","1","0","1","3","1","2","0","0","0","0","0","0","33","17","16","0","0","0","0","0","0","3","1","2","-2"
"210429","Western Oregon University","2014","On-Tenure track total","31","10","21","0","0","0","0","0","0","1","0","1","3","2","1","0","0","0","23","7","16","0","0","0","1","0","1","3","1","2","-2"
"210429","Western Oregon University","2014","On-tenure track, associate professors","1","0","1","0","0","0","0","0","0","0","0","0","0","0","0","0","0","0","1","0","1","0","0","0","0","0","0","0","0","0","-2"
"210429","Western Oregon University","2014","On-tenure track, assistant professors","30","10","20","0","0","0","0","0","0","1","0","1","3","2","1","0","0","0","22","7","15","0","0","0","1","0","1","3","1","2","-2"
"210429","Western Oregon University","2014","Not on tenure track/No tenure system system total","67","31","36","0","0","0","2","1","1","0","0","0","4","0","4","0","0","0","56","26","30","1","0","1","3","3","0","1","1","0","-2"
"210429","Western Oregon University","2014","Not on tenure/no tenure system, assistant professors","25","10","15","0","0","0","1","0","1","0","0","0","1","0","1","0","0","0","21","8","13","0","0","0","2","2","0","0","0","0","-2"
"210429","Western Oregon University","2014","Not on tenure/no tenure system, instructors","37","19","18","0","0","0","1","1","0","0","0","0","3","0","3","0","0","0","31","17","14","1","0","1","1","1","0","0","0","0","-2"
"210429","Western Oregon University","2014","Not on tenure/no tenure system, lecturers","4","1","3","0","0","0","0","0","0","0","0","0","0","0","0","0","0","0","4","1","3","0","0","0","0","0","0","0","0","0","-2"
"210429","Western Oregon University","2014","Not on tenure/no tenure system, no academic rank","1","1","0","0","0","0","0","0","0","0","0","0","0","0","0","0","0","0","0","0","0","0","0","0","0","0","0","1","1","0","-2"
"212133","Eastern University","2014","Tenured total","66","37","29","0","0","0","3","1","2","9","4","5","4","2","2","0","0","0","50","30","20","0","0","0","0","0","0","0","0","0","-2"
"212133","Eastern University","2014","Tenured, professors","37","20","17","0","0","0","2","0","2","4","1","3","1","0","1","0","0","0","30","19","11","0","0","0","0","0","0","0","0","0","-2"
"212133","Eastern University","2014","Tenured, associate professors","29","17","12","0","0","0","1","1","0","5","3","2","3","2","1","0","0","0","20","11","9","0","0","0","0","0","0","0","0","0","-2"
"212133","Eastern University","2014","On-Tenure track total","34","20","14","0","0","0","3","3","0","3","2","1","0","0","0","0","0","0","28","15","13","0","0","0","0","0","0","0","0","0","-2"
"212133","Eastern University","2014","On-tenure track, professors","4","2","2","0","0","0","1","1","0","0","0","0","0","0","0","0","0","0","3","1","2","0","0","0","0","0","0","0","0","0","-2"
"212133","Eastern University","2014","On-tenure track, associate professors","16","12","4","0","0","0","2","2","0","3","2","1","0","0","0","0","0","0","11","8","3","0","0","0","0","0","0","0","0","0","-2"
"212133","Eastern University","2014","On-tenure track, assistant professors","14","6","8","0","0","0","0","0","0","0","0","0","0","0","0","0","0","0","14","6","8","0","0","0","0","0","0","0","0","0","-2"
"212133","Eastern University","2014","Not on tenure track/No tenure system system total","50","23","27","0","0","0","0","0","0","6","0","6","2","1","1","0","0","0","41","22","19","1","0","1","0","0","0","0","0","0","-2"
"212133","Eastern University","2014","Not on tenure/no tenure system, assistant professors","5","2","3","0","0","0","0","0","0","2","0","2","0","0","0","0","0","0","3","2","1","0","0","0","0","0","0","0","0","0","-2"
"212133","Eastern University","2014","Not on tenure/no tenure system, lecturers","32","12","20","0","0","0","0","0","0","4","0","4","1","0","1","0","0","0","26","12","14","1","0","1","0","0","0","0","0","0","-2"
"212133","Eastern University","2014","Not on tenure/no tenure system, no academic rank","13","9","4","0","0","0","0","0","0","0","0","0","1","1","0","0","0","0","12","8","4","0","0","0","0","0","0","0","0","0","-2"
"213367","La Salle University","2014","Tenured total","132","72","60","0","0","0","6","3","3","2","1","1","4","3","1","0","0","0","114","61","53","1","1","0","0","0","0","5","3","2","-2"
"213367","La Salle University","2014","Tenured, professors","43","30","13","0","0","0","1","1","0","1","1","0","1","1","0","0","0","0","39","26","13","1","1","0","0","0","0","0","0","0","-2"
"213367","La Salle University","2014","Tenured, associate professors","80","36","44","0","0","0","5","2","3","1","0","1","3","2","1","0","0","0","66","29","37","0","0","0","0","0","0","5","3","2","-2"
"213367","La Salle University","2014","Tenured, assistant professors","9","6","3","0","0","0","0","0","0","0","0","0","0","0","0","0","0","0","9","6","3","0","0","0","0","0","0","0","0","0","-2"
"213367","La Salle University","2014","On-Tenure track total","51","20","31","0","0","0","0","0","0","2","0","2","3","1","2","0","0","0","43","17","26","0","0","0","0","0","0","3","2","1","-2"
"213367","La Salle University","2014","On-tenure track, associate professors","5","1","4","0","0","0","0","0","0","0","0","0","1","1","0","0","0","0","4","0","4","0","0","0","0","0","0","0","0","0","-2"
"213367","La Salle University","2014","On-tenure track, assistant professors","46","19","27","0","0","0","0","0","0","2","0","2","2","0","2","0","0","0","39","17","22","0","0","0","0","0","0","3","2","1","-2"
"213367","La Salle University","2014","Not on tenure track/No tenure system system total","51","13","38","0","0","0","0","0","0","2","0","2","0","0","0","0","0","0","49","13","36","0","0","0","0","0","0","0","0","0","-2"
"213367","La Salle University","2014","Not on tenure/no tenure system, professors","1","1","0","0","0","0","0","0","0","0","0","0","0","0","0","0","0","0","1","1","0","0","0","0","0","0","0","0","0","0","-2"
"213367","La Salle University","2014","Not on tenure/no tenure system, associate professors","2","1","1","0","0","0","0","0","0","0","0","0","0","0","0","0","0","0","2","1","1","0","0","0","0","0","0","0","0","0","-2"
"213367","La Salle University","2014","Not on tenure/no tenure system, assistant professors","31","6","25","0","0","0","0","0","0","1","0","1","0","0","0","0","0","0","30","6","24","0","0","0","0","0","0","0","0","0","-2"
"213367","La Salle University","2014","Not on tenure/no tenure system, instructors","17","5","12","0","0","0","0","0","0","1","0","1","0","0","0","0","0","0","16","5","11","0","0","0","0","0","0","0","0","0","-2"
"213774","Manor College","2014","Not on tenure track/No tenure system system total","25","6","19","0","0","0","1","1","0","1","0","1","0","0","0","0","0","0","23","5","18","0","0","0","0","0","0","0","0","0","-2"
"213774","Manor College","2014","Not on tenure/no tenure system, professors","13","3","10","0","0","0","1","1","0","1","0","1","0","0","0","0","0","0","11","2","9","0","0","0","0","0","0","0","0","0","-2"
"213774","Manor College","2014","Not on tenure/no tenure system, associate professors","5","2","3","0","0","0","0","0","0","0","0","0","0","0","0","0","0","0","5","2","3","0","0","0","0","0","0","0","0","0","-2"
"213774","Manor College","2014","Not on tenure/no tenure system, assistant professors","4","1","3","0","0","0","0","0","0","0","0","0","0","0","0","0","0","0","4","1","3","0","0","0","0","0","0","0","0","0","-2"
"213774","Manor College","2014","Not on tenure/no tenure system, instructors","3","0","3","0","0","0","0","0","0","0","0","0","0","0","0","0","0","0","3","0","3","0","0","0","0","0","0","0","0","0","-2"
"216542","University of Valley Forge","2014","Not on tenure track/No tenure system system total","31","21","10","0","0","0","0","0","0","2","1","1","0","0","0","1","0","1","28","20","8","0","0","0","0","0","0","0","0","0","-2"
"216542","University of Valley Forge","2014","Not on tenure/no tenure system, professors","11","10","1","0","0","0","0","0","0","0","0","0","0","0","0","1","0","1","10","10","0","0","0","0","0","0","0","0","0","0","-2"
"216542","University of Valley Forge","2014","Not on tenure/no tenure system, associate professors","6","2","4","0","0","0","0","0","0","2","1","1","0","0","0","0","0","0","4","1","3","0","0","0","0","0","0","0","0","0","-2"
"216542","University of Valley Forge","2014","Not on tenure/no tenure system, assistant professors","13","8","5","0","0","0","0","0","0","0","0","0","0","0","0","0","0","0","13","8","5","0","0","0","0","0","0","0","0","0","-2"
"216542","University of Valley Forge","2014","Not on tenure/no tenure system, lecturers","1","1","0","0","0","0","0","0","0","0","0","0","0","0","0","0","0","0","1","1","0","0","0","0","0","0","0","0","0","0","-2"
"217420","Rhode Island College","2014","Tenured total","244","113","131","1","0","1","18","9","9","6","3","3","5","3","2","0","0","0","212","96","116","2","2","0","0","0","0","0","0","0","-2"
"217420","Rhode Island College","2014","Tenured, professors","122","68","54","0","0","0","8","5","3","4","3","1","3","2","1","0","0","0","107","58","49","0","0","0","0","0","0","0","0","0","-2"
"217420","Rhode Island College","2014","Tenured, associate professors","110","41","69","1","0","1","8","3","5","2","0","2","2","1","1","0","0","0","95","35","60","2","2","0","0","0","0","0","0","0","-2"
"217420","Rhode Island College","2014","Tenured, assistant professors","12","4","8","0","0","0","2","1","1","0","0","0","0","0","0","0","0","0","10","3","7","0","0","0","0","0","0","0","0","0","-2"
"217420","Rhode Island College","2014","On-Tenure track total","53","21","32","0","0","0","7","3","4","1","1","0","3","3","0","0","0","0","40","14","26","2","0","2","0","0","0","0","0","0","-2"
"217420","Rhode Island College","2014","On-tenure track, associate professors","1","0","1","0","0","0","0","0","0","0","0","0","0","0","0","0","0","0","1","0","1","0","0","0","0","0","0","0","0","0","-2"
"217420","Rhode Island College","2014","On-tenure track, assistant professors","52","21","31","0","0","0","7","3","4","1","1","0","3","3","0","0","0","0","39","14","25","2","0","2","0","0","0","0","0","0","-2"
"217420","Rhode Island College","2014","Not on tenure track/No tenure system system total","31","5","26","0","0","0","1","1","0","0","0","0","1","0","1","0","0","0","29","4","25","0","0","0","0","0","0","0","0","0","-2"
"217420","Rhode Island College","2014","Not on tenure/no tenure system, associate professors","2","1","1","0","0","0","0","0","0","0","0","0","0","0","0","0","0","0","2","1","1","0","0","0","0","0","0","0","0","0","-2"
"217420","Rhode Island College","2014","Not on tenure/no tenure system, assistant professors","29","4","25","0","0","0","1","1","0","0","0","0","1","0","1","0","0","0","27","3","24","0","0","0","0","0","0","0","0","0","-2"
"221661","Southern Adventist University","2014","Not on tenure track/No tenure system system total","142","75","67","0","0","0","1","0","1","7","2","5","8","5","3","0","0","0","125","67","58","0","0","0","1","1","0","0","0","0","-2"
"221661","Southern Adventist University","2014","Not on tenure/no tenure system, professors","63","44","19","0","0","0","0","0","0","4","2","2","1","1","0","0","0","0","58","41","17","0","0","0","0","0","0","0","0","0","-2"
"221661","Southern Adventist University","2014","Not on tenure/no tenure system, associate professors","52","22","30","0","0","0","1","0","1","0","0","0","4","2","2","0","0","0","47","20","27","0","0","0","0","0","0","0","0","0","-2"
"221661","Southern Adventist University","2014","Not on tenure/no tenure system, assistant professors","24","7","17","0","0","0","0","0","0","2","0","2","3","2","1","0","0","0","18","4","14","0","0","0","1","1","0","0","0","0","-2"
"221661","Southern Adventist University","2014","Not on tenure/no tenure system, instructors","3","2","1","0","0","0","0","0","0","1","0","1","0","0","0","0","0","0","2","2","0","0","0","0","0","0","0","0","0","0","-2"
"222178","Abilene Christian University","2014","Tenured total","131","99","32","0","0","0","2","1","1","5","4","1","4","2","2","0","0","0","116","89","27","4","3","1","0","0","0","0","0","0","-2"
"222178","Abilene Christian University","2014","Tenured, professors","64","56","8","0","0","0","0","0","0","1","1","0","2","1","1","0","0","0","61","54","7","0","0","0","0","0","0","0","0","0","-2"
"222178","Abilene Christian University","2014","Tenured, associate professors","65","41","24","0","0","0","2","1","1","4","3","1","2","1","1","0","0","0","53","33","20","4","3","1","0","0","0","0","0","0","-2"
"222178","Abilene Christian University","2014","Tenured, assistant professors","2","2","0","0","0","0","0","0","0","0","0","0","0","0","0","0","0","0","2","2","0","0","0","0","0","0","0","0","0","0","-2"
"222178","Abilene Christian University","2014","On-Tenure track total","69","47","22","1","1","0","1","1","0","1","0","1","5","4","1","0","0","0","60","40","20","0","0","0","0","0","0","1","1","0","-2"
"222178","Abilene Christian University","2014","On-tenure track, professors","2","2","0","0","0","0","0","0","0","0","0","0","0","0","0","0","0","0","2","2","0","0","0","0","0","0","0","0","0","0","-2"
"222178","Abilene Christian University","2014","On-tenure track, associate professors","13","11","2","1","1","0","0","0","0","0","0","0","0","0","0","0","0","0","12","10","2","0","0","0","0","0","0","0","0","0","-2"
"222178","Abilene Christian University","2014","On-tenure track, assistant professors","54","34","20","0","0","0","1","1","0","1","0","1","5","4","1","0","0","0","46","28","18","0","0","0","0","0","0","1","1","0","-2"
"222178","Abilene Christian University","2014","Not on tenure track/No tenure system system total","50","18","32","0","0","0","0","0","0","1","1","0","2","0","2","0","0","0","46","17","29","0","0","0","1","0","1","0","0","0","-2"
"222178","Abilene Christian University","2014","Not on tenure/no tenure system, associate professors","2","2","0","0","0","0","0","0","0","1","1","0","0","0","0","0","0","0","1","1","0","0","0","0","0","0","0","0","0","0","-2"
"222178","Abilene Christian University","2014","Not on tenure/no tenure system, assistant professors","8","2","6","0","0","0","0","0","0","0","0","0","0","0","0","0","0","0","8","2","6","0","0","0","0","0","0","0","0","0","-2"
"222178","Abilene Christian University","2014","Not on tenure/no tenure system, instructors","40","14","26","0","0","0","0","0","0","0","0","0","2","0","2","0","0","0","37","14","23","0","0","0","1","0","1","0","0","0","-2"
"223232","Baylor University","2014","Tenured total","477","359","118","1","1","0","17","14","3","8","4","4","15","12","3","1","1","0","413","309","104","10","8","2","1","1","0","11","9","2","-2"
"223232","Baylor University","2014","Tenured, professors","275","226","49","1","1","0","5","4","1","4","3","1","6","5","1","1","1","0","244","200","44","10","8","2","1","1","0","3","3","0","-2"
"223232","Baylor University","2014","Tenured, associate professors","200","133","67","0","0","0","12","10","2","4","1","3","9","7","2","0","0","0","167","109","58","0","0","0","0","0","0","8","6","2","-2"
"223232","Baylor University","2014","Tenured, assistant professors","1","0","1","0","0","0","0","0","0","0","0","0","0","0","0","0","0","0","1","0","1","0","0","0","0","0","0","0","0","0","-2"
"223232","Baylor University","2014","Tenured, instructors","1","0","1","0","0","0","0","0","0","0","0","0","0","0","0","0","0","0","1","0","1","0","0","0","0","0","0","0","0","0","-2"
"223232","Baylor University","2014","On-Tenure track total","164","96","68","0","0","0","13","10","3","8","2","6","6","4","2","0","0","0","128","73","55","3","1","2","0","0","0","6","6","0","-2"
"223232","Baylor University","2014","On-tenure track, professors","1","0","1","0","0","0","0","0","0","0","0","0","0","0","0","0","0","0","1","0","1","0","0","0","0","0","0","0","0","0","-2"
"223232","Baylor University","2014","On-tenure track, associate professors","10","6","4","0","0","0","2","2","0","1","0","1","0","0","0","0","0","0","7","4","3","0","0","0","0","0","0","0","0","0","-2"
"223232","Baylor University","2014","On-tenure track, assistant professors","153","90","63","0","0","0","11","8","3","7","2","5","6","4","2","0","0","0","120","69","51","3","1","2","0","0","0","6","6","0","-2"
"223232","Baylor University","2014","Not on tenure track/No tenure system system total","322","129","193","1","1","0","5","1","4","3","0","3","8","1","7","0","0","0","290","118","172","4","2","2","1","1","0","10","5","5","-2"
"223232","Baylor University","2014","Not on tenure/no tenure system, professors","5","2","3","0","0","0","0","0","0","0","0","0","0","0","0","0","0","0","5","2","3","0","0","0","0","0","0","0","0","0","-2"
"223232","Baylor University","2014","Not on tenure/no tenure system, associate professors","11","3","8","0","0","0","1","0","1","0","0","0","0","0","0","0","0","0","10","3","7","0","0","0","0","0","0","0","0","0","-2"
"223232","Baylor University","2014","Not on tenure/no tenure system, assistant professors","1","1","0","1","1","0","0","0","0","0","0","0","0","0","0","0","0","0","0","0","0","0","0","0","0","0","0","0","0","0","-2"
"223232","Baylor University","2014","Not on tenure/no tenure system, lecturers","305","123","182","0","0","0","4","1","3","3","0","3","8","1","7","0","0","0","275","113","162","4","2","2","1","1","0","10","5","5","-2"
"224226","Dallas Baptist University","2014","Not on tenure track/No tenure system system total","122","73","49","0","0","0","7","6","1","3","1","2","5","4","1","0","0","0","107","62","45","0","0","0","0","0","0","0","0","0","-2"
"224226","Dallas Baptist University","2014","Not on tenure/no tenure system, professors","52","29","23","0","0","0","3","3","0","0","0","0","4","4","0","0","0","0","45","22","23","0","0","0","0","0","0","0","0","0","-2"
"224226","Dallas Baptist University","2014","Not on tenure/no tenure system, associate professors","21","13","8","0","0","0","1","0","1","2","1","1","0","0","0","0","0","0","18","12","6","0","0","0","0","0","0","0","0","0","-2"
"224226","Dallas Baptist University","2014","Not on tenure/no tenure system, assistant professors","49","31","18","0","0","0","3","3","0","1","0","1","1","0","1","0","0","0","44","28","16","0","0","0","0","0","0","0","0","0","-2"
"224323","University of Dallas","2014","Tenured total","79","62","17","0","0","0","1","1","0","0","0","0","4","3","1","0","0","0","69","56","13","1","0","1","2","1","1","2","1","1","-2"
"224323","University of Dallas","2014","Tenured, professors","22","18","4","0","0","0","1","1","0","0","0","0","0","0","0","0","0","0","21","17","4","0","0","0","0","0","0","0","0","0","-2"
"224323","University of Dallas","2014","Tenured, associate professors","50","38","12","0","0","0","0","0","0","0","0","0","4","3","1","0","0","0","43","34","9","0","0","0","2","1","1","1","0","1","-2"
"224323","University of Dallas","2014","Tenured, assistant professors","7","6","1","0","0","0","0","0","0","0","0","0","0","0","0","0","0","0","5","5","0","1","0","1","0","0","0","1","1","0","-2"
"224323","University of Dallas","2014","On-Tenure track total","27","10","17","0","0","0","0","0","0","1","1","0","3","1","2","0","0","0","21","8","13","1","0","1","0","0","0","1","0","1","-2"
"224323","University of Dallas","2014","On-tenure track, associate professors","1","0","1","0","0","0","0","0","0","0","0","0","0","0","0","0","0","0","1","0","1","0","0","0","0","0","0","0","0","0","-2"
"224323","University of Dallas","2014","On-tenure track, assistant professors","26","10","16","0","0","0","0","0","0","1","1","0","3","1","2","0","0","0","20","8","12","1","0","1","0","0","0","1","0","1","-2"
"224323","University of Dallas","2014","Not on tenure track/No tenure system system total","31","14","17","0","0","0","1","0","1","0","0","0","2","1","1","0","0","0","23","12","11","1","0","1","0","0","0","4","1","3","-2"
"224323","University of Dallas","2014","Not on tenure/no tenure system, professors","1","1","0","0","0","0","0","0","0","0","0","0","0","0","0","0","0","0","1","1","0","0","0","0","0","0","0","0","0","0","-2"
"224323","University of Dallas","2014","Not on tenure/no tenure system, assistant professors","15","8","7","0","0","0","0","0","0","0","0","0","1","1","0","0","0","0","13","7","6","1","0","1","0","0","0","0","0","0","-2"
"224323","University of Dallas","2014","Not on tenure/no tenure system, instructors","15","5","10","0","0","0","1","0","1","0","0","0","1","0","1","0","0","0","9","4","5","0","0","0","0","0","0","4","1","3","-2"
"224545","Texas A&M University-Texarkana","2014","Tenured total","26","14","12","0","0","0","1","1","0","1","1","0","1","0","1","0","0","0","23","12","11","0","0","0","0","0","0","0","0","0","-2"
"224545","Texas A&M University-Texarkana","2014","Tenured, professors","17","10","7","0","0","0","1","1","0","1","1","0","0","0","0","0","0","0","15","8","7","0","0","0","0","0","0","0","0","0","-2"
"224545","Texas A&M University-Texarkana","2014","Tenured, associate professors","9","4","5","0","0","0","0","0","0","0","0","0","1","0","1","0","0","0","8","4","4","0","0","0","0","0","0","0","0","0","-2"
"224545","Texas A&M University-Texarkana","2014","On-Tenure track total","9","7","2","0","0","0","1","1","0","0","0","0","0","0","0","0","0","0","8","6","2","0","0","0","0","0","0","0","0","0","-2"
"224545","Texas A&M University-Texarkana","2014","On-tenure track, professors","2","2","0","0","0","0","0","0","0","0","0","0","0","0","0","0","0","0","2","2","0","0","0","0","0","0","0","0","0","0","-2"
"224545","Texas A&M University-Texarkana","2014","On-tenure track, associate professors","7","5","2","0","0","0","1","1","0","0","0","0","0","0","0","0","0","0","6","4","2","0","0","0","0","0","0","0","0","0","-2"
"224545","Texas A&M University-Texarkana","2014","Not on tenure track/No tenure system system total","42","23","19","0","0","0","1","1","0","1","1","0","2","2","0","0","0","0","25","10","15","0","0","0","10","6","4","3","3","0","-2"
"224545","Texas A&M University-Texarkana","2014","Not on tenure/no tenure system, professors","2","1","1","0","0","0","0","0","0","0","0","0","0","0","0","0","0","0","2","1","1","0","0","0","0","0","0","0","0","0","-2"
"224545","Texas A&M University-Texarkana","2014","Not on tenure/no tenure system, associate professors","8","5","3","0","0","0","1","1","0","0","0","0","0","0","0","0","0","0","5","2","3","0","0","0","2","2","0","0","0","0","-2"
"224545","Texas A&M University-Texarkana","2014","Not on tenure/no tenure system, assistant professors","21","14","7","0","0","0","0","0","0","1","1","0","1","1","0","0","0","0","12","6","6","0","0","0","5","4","1","2","2","0","-2"
"224545","Texas A&M University-Texarkana","2014","Not on tenure/no tenure system, instructors","10","2","8","0","0","0","0","0","0","0","0","0","1","1","0","0","0","0","6","1","5","0","0","0","3","0","3","0","0","0","-2"
"224545","Texas A&M University-Texarkana","2014","Not on tenure/no tenure system, lecturers","1","1","0","0","0","0","0","0","0","0","0","0","0","0","0","0","0","0","0","0","0","0","0","0","0","0","0","1","1","0","-2"
"226383","Lubbock Christian University","2014","Tenured total","56","32","24","0","0","0","0","0","0","0","0","0","2","2","0","0","0","0","54","30","24","0","0","0","0","0","0","0","0","0","-2"
"226383","Lubbock Christian University","2014","Tenured, professors","28","17","11","0","0","0","0","0","0","0","0","0","1","1","0","0","0","0","27","16","11","0","0","0","0","0","0","0","0","0","-2"
"226383","Lubbock Christian University","2014","Tenured, associate professors","23","14","9","0","0","0","0","0","0","0","0","0","1","1","0","0","0","0","22","13","9","0","0","0","0","0","0","0","0","0","-2"
"226383","Lubbock Christian University","2014","Tenured, assistant professors","5","1","4","0","0","0","0","0","0","0","0","0","0","0","0","0","0","0","5","1","4","0","0","0","0","0","0","0","0","0","-2"
"226383","Lubbock Christian University","2014","On-Tenure track total","34","20","14","0","0","0","0","0","0","0","0","0","2","2","0","0","0","0","32","18","14","0","0","0","0","0","0","0","0","0","-2"
"226383","Lubbock Christian University","2014","On-tenure track, professors","1","1","0","0","0","0","0","0","0","0","0","0","0","0","0","0","0","0","1","1","0","0","0","0","0","0","0","0","0","0","-2"
"226383","Lubbock Christian University","2014","On-tenure track, associate professors","6","5","1","0","0","0","0","0","0","0","0","0","0","0","0","0","0","0","6","5","1","0","0","0","0","0","0","0","0","0","-2"
"226383","Lubbock Christian University","2014","On-tenure track, assistant professors","27","14","13","0","0","0","0","0","0","0","0","0","2","2","0","0","0","0","25","12","13","0","0","0","0","0","0","0","0","0","-2"
"226383","Lubbock Christian University","2014","Not on tenure track/No tenure system system total","6","2","4","0","0","0","0","0","0","0","0","0","0","0","0","0","0","0","6","2","4","0","0","0","0","0","0","0","0","0","-2"
"226383","Lubbock Christian University","2014","Not on tenure/no tenure system, lecturers","5","1","4","0","0","0","0","0","0","0","0","0","0","0","0","0","0","0","5","1","4","0","0","0","0","0","0","0","0","0","-2"
"226383","Lubbock Christian University","2014","Not on tenure/no tenure system, no academic rank","1","1","0","0","0","0","0","0","0","0","0","0","0","0","0","0","0","0","1","1","0","0","0","0","0","0","0","0","0","0","-2"
"226471","University of Mary Hardin-Baylor","2014","Tenured total","55","28","27","0","0","0","4","2","2","0","0","0","1","1","0","1","1","0","47","23","24","0","0","0","1","1","0","1","0","1","-2"
"226471","University of Mary Hardin-Baylor","2014","Tenured, professors","41","21","20","0","0","0","1","1","0","0","0","0","1","1","0","1","1","0","36","17","19","0","0","0","1","1","0","1","0","1","-2"
"226471","University of Mary Hardin-Baylor","2014","Tenured, associate professors","14","7","7","0","0","0","3","1","2","0","0","0","0","0","0","0","0","0","11","6","5","0","0","0","0","0","0","0","0","0","-2"
"226471","University of Mary Hardin-Baylor","2014","On-Tenure track total","58","26","32","0","0","0","1","1","0","5","2","3","2","0","2","0","0","0","48","22","26","2","1","1","0","0","0","0","0","0","-2"
"226471","University of Mary Hardin-Baylor","2014","On-tenure track, professors","3","1","2","0","0","0","0","0","0","0","0","0","0","0","0","0","0","0","3","1","2","0","0","0","0","0","0","0","0","0","-2"
"226471","University of Mary Hardin-Baylor","2014","On-tenure track, associate professors","15","5","10","0","0","0","0","0","0","2","0","2","0","0","0","0","0","0","12","5","7","1","0","1","0","0","0","0","0","0","-2"
"226471","University of Mary Hardin-Baylor","2014","On-tenure track, assistant professors","40","20","20","0","0","0","1","1","0","3","2","1","2","0","2","0","0","0","33","16","17","1","1","0","0","0","0","0","0","0","-2"
"226471","University of Mary Hardin-Baylor","2014","Not on tenure track/No tenure system system total","44","14","30","0","0","0","2","2","0","1","0","1","3","1","2","0","0","0","38","11","27","0","0","0","0","0","0","0","0","0","-2"
"226471","University of Mary Hardin-Baylor","2014","Not on tenure/no tenure system, professors","1","1","0","0","0","0","0","0","0","0","0","0","0","0","0","0","0","0","1","1","0","0","0","0","0","0","0","0","0","0","-2"
"226471","University of Mary Hardin-Baylor","2014","Not on tenure/no tenure system, associate professors","5","2","3","0","0","0","0","0","0","0","0","0","0","0","0","0","0","0","5","2","3","0","0","0","0","0","0","0","0","0","-2"
"226471","University of Mary Hardin-Baylor","2014","Not on tenure/no tenure system, assistant professors","26","8","18","0","0","0","2","2","0","1","0","1","1","0","1","0","0","0","22","6","16","0","0","0","0","0","0","0","0","0","-2"
"226471","University of Mary Hardin-Baylor","2014","Not on tenure/no tenure system, instructors","12","3","9","0","0","0","0","0","0","0","0","0","2","1","1","0","0","0","10","2","8","0","0","0","0","0","0","0","0","0","-2"
"226833","Midwestern State University","2014","Tenured total","111","70","41","1","0","1","6","5","1","2","0","2","4","2","2","0","0","0","89","59","30","2","1","1","1","0","1","6","3","3","-2"
"226833","Midwestern State University","2014","Tenured, professors","39","29","10","1","0","1","2","2","0","0","0","0","3","2","1","0","0","0","32","24","8","0","0","0","0","0","0","1","1","0","-2"
"226833","Midwestern State University","2014","Tenured, associate professors","57","36","21","0","0","0","3","2","1","1","0","1","1","0","1","0","0","0","46","31","15","1","1","0","1","0","1","4","2","2","-2"
"226833","Midwestern State University","2014","Tenured, assistant professors","15","5","10","0","0","0","1","1","0","1","0","1","0","0","0","0","0","0","11","4","7","1","0","1","0","0","0","1","0","1","-2"
"226833","Midwestern State University","2014","On-Tenure track total","60","27","33","0","0","0","0","0","0","1","0","1","2","2","0","0","0","0","43","18","25","2","0","2","0","0","0","12","7","5","-2"
"226833","Midwestern State University","2014","On-tenure track, professors","1","1","0","0","0","0","0","0","0","0","0","0","0","0","0","0","0","0","1","1","0","0","0","0","0","0","0","0","0","0","-2"
"226833","Midwestern State University","2014","On-tenure track, associate professors","8","6","2","0","0","0","0","0","0","0","0","0","1","1","0","0","0","0","4","2","2","0","0","0","0","0","0","3","3","0","-2"
"226833","Midwestern State University","2014","On-tenure track, assistant professors","50","20","30","0","0","0","0","0","0","1","0","1","1","1","0","0","0","0","37","15","22","2","0","2","0","0","0","9","4","5","-2"
"226833","Midwestern State University","2014","On-tenure track, instructors","1","0","1","0","0","0","0","0","0","0","0","0","0","0","0","0","0","0","1","0","1","0","0","0","0","0","0","0","0","0","-2"
"226833","Midwestern State University","2014","Not on tenure track/No tenure system system total","56","14","42","0","0","0","0","0","0","0","0","0","2","0","2","0","0","0","51","14","37","1","0","1","0","0","0","2","0","2","-2"
"226833","Midwestern State University","2014","Not on tenure/no tenure system, professors","1","1","0","0","0","0","0","0","0","0","0","0","0","0","0","0","0","0","1","1","0","0","0","0","0","0","0","0","0","0","-2"
"226833","Midwestern State University","2014","Not on tenure/no tenure system, assistant professors","32","8","24","0","0","0","0","0","0","0","0","0","1","0","1","0","0","0","29","8","21","1","0","1","0","0","0","1","0","1","-2"
"226833","Midwestern State University","2014","Not on tenure/no tenure system, instructors","22","5","17","0","0","0","0","0","0","0","0","0","1","0","1","0","0","0","20","5","15","0","0","0","0","0","0","1","0","1","-2"
"226833","Midwestern State University","2014","Not on tenure/no tenure system, no academic rank","1","0","1","0","0","0","0","0","0","0","0","0","0","0","0","0","0","0","1","0","1","0","0","0","0","0","0","0","0","0","-2"
"227429","Paul Quinn College","2014","Not on tenure track/No tenure system system total","9","5","4","0","0","0","0","0","0","6","4","2","2","1","1","0","0","0","1","0","1","0","0","0","0","0","0","0","0","0","-2"
"227429","Paul Quinn College","2014","Not on tenure/no tenure system, associate professors","9","5","4","0","0","0","0","0","0","6","4","2","2","1","1","0","0","0","1","0","1","0","0","0","0","0","0","0","0","0","-2"
"227881","Sam Houston State University","2014","Tenured total","332","215","117","1","1","0","9","4","5","5","3","2","13","8","5","0","0","0","272","177","95","0","0","0","0","0","0","32","22","10","-2"
"227881","Sam Houston State University","2014","Tenured, professors","158","112","46","1","1","0","1","1","0","2","2","0","4","3","1","0","0","0","137","96","41","0","0","0","0","0","0","13","9","4","-2"
"227881","Sam Houston State University","2014","Tenured, associate professors","168","100","68","0","0","0","7","2","5","3","1","2","8","4","4","0","0","0","131","80","51","0","0","0","0","0","0","19","13","6","-2"
"227881","Sam Houston State University","2014","Tenured, assistant professors","5","3","2","0","0","0","1","1","0","0","0","0","1","1","0","0","0","0","3","1","2","0","0","0","0","0","0","0","0","0","-2"
"227881","Sam Houston State University","2014","Tenured, instructors","1","0","1","0","0","0","0","0","0","0","0","0","0","0","0","0","0","0","1","0","1","0","0","0","0","0","0","0","0","0","-2"
"227881","Sam Houston State University","2014","On-Tenure track total","178","89","89","2","0","2","3","0","3","10","3","7","11","6","5","0","0","0","120","62","58","1","1","0","0","0","0","31","17","14","-2"
"227881","Sam Houston State University","2014","On-tenure track, associate professors","15","8","7","0","0","0","1","0","1","0","0","0","0","0","0","0","0","0","12","7","5","0","0","0","0","0","0","2","1","1","-2"
"227881","Sam Houston State University","2014","On-tenure track, assistant professors","163","81","82","2","0","2","2","0","2","10","3","7","11","6","5","0","0","0","108","55","53","1","1","0","0","0","0","29","16","13","-2"
"227881","Sam Houston State University","2014","Not on tenure track/No tenure system system total","176","70","106","2","1","1","6","1","5","6","1","5","9","7","2","0","0","0","134","51","83","0","0","0","0","0","0","19","9","10","-2"
"227881","Sam Houston State University","2014","Not on tenure/no tenure system, associate professors","1","1","0","0","0","0","0","0","0","0","0","0","1","1","0","0","0","0","0","0","0","0","0","0","0","0","0","0","0","0","-2"
"227881","Sam Houston State University","2014","Not on tenure/no tenure system, lecturers","175","69","106","2","1","1","6","1","5","6","1","5","8","6","2","0","0","0","134","51","83","0","0","0","0","0","0","19","9","10","-2"
"228343","Southwestern University","2014","Tenured total","87","49","38","1","1","0","3","1","2","1","0","1","6","3","3","0","0","0","75","43","32","0","0","0","1","1","0","0","0","0","-2"
"228343","Southwestern University","2014","Tenured, professors","43","26","17","0","0","0","1","1","0","0","0","0","1","0","1","0","0","0","40","24","16","0","0","0","1","1","0","0","0","0","-2"
"228343","Southwestern University","2014","Tenured, associate professors","44","23","21","1","1","0","2","0","2","1","0","1","5","3","2","0","0","0","35","19","16","0","0","0","0","0","0","0","0","0","-2"
"228343","Southwestern University","2014","On-Tenure track total","21","8","13","1","1","0","2","0","2","2","1","1","2","1","1","0","0","0","13","4","9","0","0","0","0","0","0","1","1","0","-2"
"228343","Southwestern University","2014","On-tenure track, associate professors","1","0","1","0","0","0","0","0","0","0","0","0","0","0","0","0","0","0","1","0","1","0","0","0","0","0","0","0","0","0","-2"
"228343","Southwestern University","2014","On-tenure track, assistant professors","20","8","12","1","1","0","2","0","2","2","1","1","2","1","1","0","0","0","12","4","8","0","0","0","0","0","0","1","1","0","-2"
"228343","Southwestern University","2014","Not on tenure track/No tenure system system total","5","2","3","0","0","0","0","0","0","0","0","0","1","0","1","0","0","0","2","2","0","2","0","2","0","0","0","0","0","0","-2"
"228343","Southwestern University","2014","Not on tenure/no tenure system, no academic rank","5","2","3","0","0","0","0","0","0","0","0","0","1","0","1","0","0","0","2","2","0","2","0","2","0","0","0","0","0","0","-2"
"228529","Tarleton State University","2014","Tenured total","121","86","35","2","2","0","4","3","1","0","0","0","6","5","1","0","0","0","109","76","33","0","0","0","0","0","0","0","0","0","-2"
"228529","Tarleton State University","2014","Tenured, professors","62","49","13","2","2","0","2","2","0","0","0","0","1","1","0","0","0","0","57","44","13","0","0","0","0","0","0","0","0","0","-2"
"228529","Tarleton State University","2014","Tenured, associate professors","59","37","22","0","0","0","2","1","1","0","0","0","5","4","1","0","0","0","52","32","20","0","0","0","0","0","0","0","0","0","-2"
"228529","Tarleton State University","2014","On-Tenure track total","121","61","60","2","1","1","9","3","6","6","3","3","5","3","2","0","0","0","89","43","46","2","2","0","2","1","1","6","5","1","-2"
"228529","Tarleton State University","2014","On-tenure track, associate professors","11","3","8","2","1","1","0","0","0","0","0","0","0","0","0","0","0","0","9","2","7","0","0","0","0","0","0","0","0","0","-2"
"228529","Tarleton State University","2014","On-tenure track, assistant professors","110","58","52","0","0","0","9","3","6","6","3","3","5","3","2","0","0","0","80","41","39","2","2","0","2","1","1","6","5","1","-2"
"228529","Tarleton State University","2014","Not on tenure track/No tenure system system total","141","48","93","1","1","0","4","1","3","2","1","1","7","1","6","1","1","0","117","39","78","5","1","4","2","1","1","2","2","0","-2"
"228529","Tarleton State University","2014","Not on tenure/no tenure system, professors","2","1","1","0","0","0","1","1","0","0","0","0","0","0","0","0","0","0","1","0","1","0","0","0","0","0","0","0","0","0","-2"
"228529","Tarleton State University","2014","Not on tenure/no tenure system, associate professors","2","0","2","0","0","0","0","0","0","1","0","1","0","0","0","0","0","0","1","0","1","0","0","0","0","0","0","0","0","0","-2"
"228529","Tarleton State University","2014","Not on tenure/no tenure system, assistant professors","53","21","32","0","0","0","2","0","2","1","1","0","3","0","3","1","1","0","43","17","26","1","1","0","1","0","1","1","1","0","-2"
"228529","Tarleton State University","2014","Not on tenure/no tenure system, instructors","83","26","57","1","1","0","1","0","1","0","0","0","4","1","3","0","0","0","72","22","50","3","0","3","1","1","0","1","1","0","-2"
"228529","Tarleton State University","2014","Not on tenure/no tenure system, lecturers","1","0","1","0","0","0","0","0","0","0","0","0","0","0","0","0","0","0","0","0","0","1","0","1","0","0","0","0","0","0","-2"
"228653","The University of Texas Medical Branch at Galveston","2014","Tenured total","225","161","64","0","0","0","45","29","16","6","5","1","17","13","4","0","0","0","150","108","42","0","0","0","0","0","0","7","6","1","-2"
"228653","The University of Texas Medical Branch at Galveston","2014","Tenured, professors","187","137","50","0","0","0","37","24","13","5","4","1","13","11","2","0","0","0","129","95","34","0","0","0","0","0","0","3","3","0","-2"
"228653","The University of Texas Medical Branch at Galveston","2014","Tenured, associate professors","38","24","14","0","0","0","8","5","3","1","1","0","4","2","2","0","0","0","21","13","8","0","0","0","0","0","0","4","3","1","-2"
"228653","The University of Texas Medical Branch at Galveston","2014","On-Tenure track total","152","75","77","18","18","0","16","1","15","4","0","4","4","2","2","0","0","0","80","37","43","1","1","0","0","0","0","29","16","13","-2"
"228653","The University of Texas Medical Branch at Galveston","2014","On-tenure track, professors","6","4","2","0","0","0","0","0","0","0","0","0","0","0","0","0","0","0","6","4","2","0","0","0","0","0","0","0","0","0","-2"
"228653","The University of Texas Medical Branch at Galveston","2014","On-tenure track, associate professors","38","19","19","5","5","0","5","1","4","2","0","2","1","1","0","0","0","0","21","9","12","0","0","0","0","0","0","4","3","1","-2"
"228653","The University of Texas Medical Branch at Galveston","2014","On-tenure track, assistant professors","108","52","56","13","13","0","11","0","11","2","0","2","3","1","2","0","0","0","53","24","29","1","1","0","0","0","0","25","13","12","-2"
"228653","The University of Texas Medical Branch at Galveston","2014","Not on tenure track/No tenure system system total","107","46","61","0","0","0","7","5","2","6","0","6","9","5","4","1","1","0","71","28","43","1","0","1","0","0","0","12","7","5","-2"
"228653","The University of Texas Medical Branch at Galveston","2014","Not on tenure/no tenure system, professors","40","28","12","0","0","0","5","4","1","2","0","2","3","3","0","1","1","0","28","19","9","0","0","0","0","0","0","1","1","0","-2"
"228653","The University of Texas Medical Branch at Galveston","2014","Not on tenure/no tenure system, associate professors","11","1","10","0","0","0","0","0","0","1","0","1","0","0","0","0","0","0","10","1","9","0","0","0","0","0","0","0","0","0","-2"
"228653","The University of Texas Medical Branch at Galveston","2014","Not on tenure/no tenure system, assistant professors","54","16","38","0","0","0","2","1","1","3","0","3","6","2","4","0","0","0","33","8","25","1","0","1","0","0","0","9","5","4","-2"
"228653","The University of Texas Medical Branch at Galveston","2014","Not on tenure/no tenure system, instructors","2","1","1","0","0","0","0","0","0","0","0","0","0","0","0","0","0","0","0","0","0","0","0","0","0","0","0","2","1","1","-2"
"232706","Marymount University","2014","Tenured total","90","23","67","0","0","0","5","0","5","1","0","1","1","0","1","0","0","0","77","20","57","2","0","2","4","3","1","0","0","0","-2"
"232706","Marymount University","2014","Tenured, professors","52","13","39","0","0","0","1","0","1","1","0","1","1","0","1","0","0","0","46","11","35","1","0","1","2","2","0","0","0","0","-2"
"232706","Marymount University","2014","Tenured, associate professors","38","10","28","0","0","0","4","0","4","0","0","0","0","0","0","0","0","0","31","9","22","1","0","1","2","1","1","0","0","0","-2"
"232706","Marymount University","2014","On-Tenure track total","45","16","29","0","0","0","4","0","4","1","0","1","0","0","0","0","0","0","33","13","20","0","0","0","7","3","4","0","0","0","-2"
"232706","Marymount University","2014","On-tenure track, associate professors","4","1","3","0","0","0","1","0","1","0","0","0","0","0","0","0","0","0","1","0","1","0","0","0","2","1","1","0","0","0","-2"
"232706","Marymount University","2014","On-tenure track, assistant professors","41","15","26","0","0","0","3","0","3","1","0","1","0","0","0","0","0","0","32","13","19","0","0","0","5","2","3","0","0","0","-2"
"232706","Marymount University","2014","Not on tenure track/No tenure system system total","23","7","16","0","0","0","0","0","0","0","0","0","2","0","2","1","0","1","17","6","11","0","0","0","3","1","2","0","0","0","-2"
"232706","Marymount University","2014","Not on tenure/no tenure system, professors","2","2","0","0","0","0","0","0","0","0","0","0","0","0","0","0","0","0","2","2","0","0","0","0","0","0","0","0","0","0","-2"
"232706","Marymount University","2014","Not on tenure/no tenure system, associate professors","1","1","0","0","0","0","0","0","0","0","0","0","0","0","0","0","0","0","1","1","0","0","0","0","0","0","0","0","0","0","-2"
"232706","Marymount University","2014","Not on tenure/no tenure system, assistant professors","18","3","15","0","0","0","0","0","0","0","0","0","2","0","2","1","0","1","14","3","11","0","0","0","1","0","1","0","0","0","-2"
"232706","Marymount University","2014","Not on tenure/no tenure system, no academic rank","2","1","1","0","0","0","0","0","0","0","0","0","0","0","0","0","0","0","0","0","0","0","0","0","2","1","1","0","0","0","-2"
"234827","Central Washington University","2014","Tenured total","246","157","89","2","1","1","14","10","4","6","3","3","9","6","3","4","4","0","183","122","61","0","0","0","21","8","13","7","3","4","-2"
"234827","Central Washington University","2014","Tenured, professors","138","92","46","2","1","1","8","7","1","2","1","1","3","2","1","2","2","0","113","76","37","0","0","0","6","3","3","2","0","2","-2"
"234827","Central Washington University","2014","Tenured, associate professors","108","65","43","0","0","0","6","3","3","4","2","2","6","4","2","2","2","0","70","46","24","0","0","0","15","5","10","5","3","2","-2"
"234827","Central Washington University","2014","On-Tenure track total","98","46","52","1","1","0","2","0","2","3","2","1","5","0","5","0","0","0","65","28","37","0","0","0","11","8","3","11","7","4","-2"
"234827","Central Washington University","2014","On-tenure track, assistant professors","98","46","52","1","1","0","2","0","2","3","2","1","5","0","5","0","0","0","65","28","37","0","0","0","11","8","3","11","7","4","-2"
"234827","Central Washington University","2014","Not on tenure track/No tenure system system total","98","52","46","0","0","0","4","1","3","2","2","0","2","2","0","0","0","0","75","41","34","0","0","0","15","6","9","0","0","0","-2"
"234827","Central Washington University","2014","Not on tenure/no tenure system, assistant professors","1","0","1","0","0","0","0","0","0","0","0","0","0","0","0","0","0","0","0","0","0","0","0","0","1","0","1","0","0","0","-2"
"234827","Central Washington University","2014","Not on tenure/no tenure system, lecturers","97","52","45","0","0","0","4","1","3","2","2","0","2","2","0","0","0","0","75","41","34","0","0","0","14","6","8","0","0","0","-2"
"235097","Eastern Washington University","2014","Tenured total","236","140","96","3","2","1","16","10","6","4","3","1","8","5","3","1","1","0","203","118","85","0","0","0","0","0","0","1","1","0","-2"
"235097","Eastern Washington University","2014","Tenured, professors","142","92","50","1","1","0","10","7","3","1","1","0","5","4","1","1","1","0","124","78","46","0","0","0","0","0","0","0","0","0","-2"
"235097","Eastern Washington University","2014","Tenured, associate professors","94","48","46","2","1","1","6","3","3","3","2","1","3","1","2","0","0","0","79","40","39","0","0","0","0","0","0","1","1","0","-2"
"235097","Eastern Washington University","2014","On-Tenure track total","92","48","44","2","0","2","5","2","3","1","1","0","5","2","3","0","0","0","69","37","32","0","0","0","0","0","0","10","6","4","-2"
"235097","Eastern Washington University","2014","On-tenure track, assistant professors","92","48","44","2","0","2","5","2","3","1","1","0","5","2","3","0","0","0","69","37","32","0","0","0","0","0","0","10","6","4","-2"
"235097","Eastern Washington University","2014","Not on tenure track/No tenure system system total","149","77","72","2","2","0","9","6","3","6","4","2","5","4","1","0","0","0","123","58","65","1","1","0","0","0","0","3","2","1","-2"
"235097","Eastern Washington University","2014","Not on tenure/no tenure system, no academic rank","149","77","72","2","2","0","9","6","3","6","4","2","5","4","1","0","0","0","123","58","65","1","1","0","0","0","0","3","2","1","-2"
"235237","Pierce College District","2014","Tenured total","56","24","32","2","1","1","2","1","1","0","0","0","2","1","1","0","0","0","46","20","26","4","1","3","0","0","0","0","0","0","-2"
"235237","Pierce College District","2014","Tenured, no academic rank","56","24","32","2","1","1","2","1","1","0","0","0","2","1","1","0","0","0","46","20","26","4","1","3","0","0","0","0","0","0","-2"
"235237","Pierce College District","2014","On-Tenure track total","9","3","6","0","0","0","0","0","0","0","0","0","0","0","0","0","0","0","8","3","5","1","0","1","0","0","0","0","0","0","-2"
"235237","Pierce College District","2014","On-tenure track, no academic rank","9","3","6","0","0","0","0","0","0","0","0","0","0","0","0","0","0","0","8","3","5","1","0","1","0","0","0","0","0","0","-2"
"235237","Pierce College District","2014","Not on tenure track/No tenure system system total","11","2","9","0","0","0","0","0","0","0","0","0","0","0","0","0","0","0","11","2","9","0","0","0","0","0","0","0","0","0","-2"
"235237","Pierce College District","2014","Not on tenure/no tenure system, no academic rank","11","2","9","0","0","0","0","0","0","0","0","0","0","0","0","0","0","0","11","2","9","0","0","0","0","0","0","0","0","0","-2"
"236887","Walla Walla Community College","2014","Tenured total","60","33","27","4","3","1","1","0","1","1","0","1","1","1","0","0","0","0","53","29","24","0","0","0","0","0","0","0","0","0","-2"
"236887","Walla Walla Community College","2014","Tenured, no academic rank","60","33","27","4","3","1","1","0","1","1","0","1","1","1","0","0","0","0","53","29","24","0","0","0","0","0","0","0","0","0","-2"
"236887","Walla Walla Community College","2014","On-Tenure track total","18","6","12","0","0","0","0","0","0","0","0","0","0","0","0","0","0","0","17","6","11","1","0","1","0","0","0","0","0","0","-2"
"236887","Walla Walla Community College","2014","On-tenure track, no academic rank","18","6","12","0","0","0","0","0","0","0","0","0","0","0","0","0","0","0","17","6","11","1","0","1","0","0","0","0","0","0","-2"
"236887","Walla Walla Community College","2014","Not on tenure track/No tenure system system total","38","26","12","0","0","0","0","0","0","0","0","0","2","2","0","0","0","0","36","24","12","0","0","0","0","0","0","0","0","0","-2"
"236887","Walla Walla Community College","2014","Not on tenure/no tenure system, no academic rank","38","26","12","0","0","0","0","0","0","0","0","0","2","2","0","0","0","0","36","24","12","0","0","0","0","0","0","0","0","0","-2"
"238430","Cardinal Stritch University","2014","Tenured total","45","20","25","0","0","0","2","0","2","2","2","0","1","0","1","0","0","0","39","17","22","0","0","0","1","1","0","0","0","0","-2"
"238430","Cardinal Stritch University","2014","Tenured, professors","7","5","2","0","0","0","0","0","0","0","0","0","1","0","1","0","0","0","5","4","1","0","0","0","1","1","0","0","0","0","-2"
"238430","Cardinal Stritch University","2014","Tenured, associate professors","16","4","12","0","0","0","2","0","2","0","0","0","0","0","0","0","0","0","14","4","10","0","0","0","0","0","0","0","0","0","-2"
"238430","Cardinal Stritch University","2014","Tenured, assistant professors","22","11","11","0","0","0","0","0","0","2","2","0","0","0","0","0","0","0","20","9","11","0","0","0","0","0","0","0","0","0","-2"
"238430","Cardinal Stritch University","2014","On-Tenure track total","24","6","18","0","0","0","1","0","1","3","1","2","0","0","0","0","0","0","20","5","15","0","0","0","0","0","0","0","0","0","-2"
"238430","Cardinal Stritch University","2014","On-tenure track, associate professors","2","1","1","0","0","0","1","0","1","0","0","0","0","0","0","0","0","0","1","1","0","0","0","0","0","0","0","0","0","0","-2"
"238430","Cardinal Stritch University","2014","On-tenure track, assistant professors","22","5","17","0","0","0","0","0","0","3","1","2","0","0","0","0","0","0","19","4","15","0","0","0","0","0","0","0","0","0","-2"
"238430","Cardinal Stritch University","2014","Not on tenure track/No tenure system system total","38","14","24","1","1","0","1","1","0","2","1","1","1","1","0","0","0","0","32","9","23","0","0","0","1","1","0","0","0","0","-2"
"238430","Cardinal Stritch University","2014","Not on tenure/no tenure system, associate professors","2","1","1","0","0","0","0","0","0","0","0","0","0","0","0","0","0","0","2","1","1","0","0","0","0","0","0","0","0","0","-2"
"238430","Cardinal Stritch University","2014","Not on tenure/no tenure system, assistant professors","28","12","16","1","1","0","1","1","0","2","1","1","1","1","0","0","0","0","22","7","15","0","0","0","1","1","0","0","0","0","-2"
"238430","Cardinal Stritch University","2014","Not on tenure/no tenure system, instructors","5","0","5","0","0","0","0","0","0","0","0","0","0","0","0","0","0","0","5","0","5","0","0","0","0","0","0","0","0","0","-2"
"238430","Cardinal Stritch University","2014","Not on tenure/no tenure system, no academic rank","3","1","2","0","0","0","0","0","0","0","0","0","0","0","0","0","0","0","3","1","2","0","0","0","0","0","0","0","0","0","-2"
"239309","Milwaukee Institute of Art & Design","2014","Not on tenure track/No tenure system system total","38","23","15","0","0","0","2","1","1","1","1","0","0","0","0","0","0","0","34","20","14","1","1","0","0","0","0","0","0","0","-2"
"239309","Milwaukee Institute of Art & Design","2014","Not on tenure/no tenure system, professors","27","16","11","0","0","0","2","1","1","1","1","0","0","0","0","0","0","0","24","14","10","0","0","0","0","0","0","0","0","0","-2"
"239309","Milwaukee Institute of Art & Design","2014","Not on tenure/no tenure system, associate professors","5","3","2","0","0","0","0","0","0","0","0","0","0","0","0","0","0","0","4","2","2","1","1","0","0","0","0","0","0","0","-2"
"239309","Milwaukee Institute of Art & Design","2014","Not on tenure/no tenure system, assistant professors","3","2","1","0","0","0","0","0","0","0","0","0","0","0","0","0","0","0","3","2","1","0","0","0","0","0","0","0","0","0","-2"
"239309","Milwaukee Institute of Art & Design","2014","Not on tenure/no tenure system, instructors","3","2","1","0","0","0","0","0","0","0","0","0","0","0","0","0","0","0","3","2","1","0","0","0","0","0","0","0","0","0","-2"
"240374","University of Wisconsin-Parkside","2014","Tenured total","70","37","33","0","0","0","18","8","10","2","2","0","6","2","4","0","0","0","44","25","19","0","0","0","0","0","0","0","0","0","-2"
"240374","University of Wisconsin-Parkside","2014","Tenured, professors","28","18","10","0","0","0","8","5","3","1","1","0","0","0","0","0","0","0","19","12","7","0","0","0","0","0","0","0","0","0","-2"
"240374","University of Wisconsin-Parkside","2014","Tenured, associate professors","41","18","23","0","0","0","10","3","7","1","1","0","6","2","4","0","0","0","24","12","12","0","0","0","0","0","0","0","0","0","-2"
"240374","University of Wisconsin-Parkside","2014","Tenured, assistant professors","1","1","0","0","0","0","0","0","0","0","0","0","0","0","0","0","0","0","1","1","0","0","0","0","0","0","0","0","0","0","-2"
"240374","University of Wisconsin-Parkside","2014","On-Tenure track total","36","18","18","0","0","0","1","1","0","1","1","0","1","0","1","0","0","0","24","10","14","0","0","0","6","5","1","3","1","2","-2"
"240374","University of Wisconsin-Parkside","2014","On-tenure track, associate professors","1","1","0","0","0","0","0","0","0","0","0","0","0","0","0","0","0","0","1","1","0","0","0","0","0","0","0","0","0","0","-2"
"240374","University of Wisconsin-Parkside","2014","On-tenure track, assistant professors","35","17","18","0","0","0","1","1","0","1","1","0","1","0","1","0","0","0","23","9","14","0","0","0","6","5","1","3","1","2","-2"
"240374","University of Wisconsin-Parkside","2014","Not on tenure track/No tenure system system total","55","25","30","1","1","0","2","2","0","2","1","1","2","0","2","0","0","0","47","20","27","0","0","0","1","1","0","0","0","0","-2"
"240374","University of Wisconsin-Parkside","2014","Not on tenure/no tenure system, associate professors","1","1","0","0","0","0","0","0","0","0","0","0","0","0","0","0","0","0","1","1","0","0","0","0","0","0","0","0","0","0","-2"
"240374","University of Wisconsin-Parkside","2014","Not on tenure/no tenure system, assistant professors","2","1","1","0","0","0","0","0","0","0","0","0","0","0","0","0","0","0","2","1","1","0","0","0","0","0","0","0","0","0","-2"
"240374","University of Wisconsin-Parkside","2014","Not on tenure/no tenure system, lecturers","52","23","29","1","1","0","2","2","0","2","1","1","2","0","2","0","0","0","44","18","26","0","0","0","1","1","0","0","0","0","-2"
"247834","Collin County Community College District","2014","Not on tenure track/No tenure system system total","402","166","236","5","2","3","21","4","17","19","9","10","27","8","19","0","0","0","326","140","186","4","3","1","0","0","0","0","0","0","-2"
"247834","Collin County Community College District","2014","Not on tenure/no tenure system, no academic rank","402","166","236","5","2","3","21","4","17","19","9","10","27","8","19","0","0","0","326","140","186","4","3","1","0","0","0","0","0","0","-2"
"262129","New College of Florida","2014","Tenured total","53","26","27","0","0","0","1","1","0","1","0","1","3","1","2","0","0","0","47","24","23","0","0","0","0","0","0","1","0","1","-2"
"262129","New College of Florida","2014","Tenured, professors","29","18","11","0","0","0","0","0","0","0","0","0","1","1","0","0","0","0","28","17","11","0","0","0","0","0","0","0","0","0","-2"
"262129","New College of Florida","2014","Tenured, associate professors","24","8","16","0","0","0","1","1","0","1","0","1","2","0","2","0","0","0","19","7","12","0","0","0","0","0","0","1","0","1","-2"
"262129","New College of Florida","2014","On-Tenure track total","15","6","9","0","0","0","2","0","2","2","0","2","0","0","0","0","0","0","9","6","3","0","0","0","0","0","0","2","0","2","-2"
"262129","New College of Florida","2014","On-tenure track, assistant professors","15","6","9","0","0","0","2","0","2","2","0","2","0","0","0","0","0","0","9","6","3","0","0","0","0","0","0","2","0","2","-2"
"262129","New College of Florida","2014","Not on tenure track/No tenure system system total","8","5","3","0","0","0","0","0","0","0","0","0","0","0","0","0","0","0","7","5","2","0","0","0","0","0","0","1","0","1","-2"
"262129","New College of Florida","2014","Not on tenure/no tenure system, assistant professors","5","4","1","0","0","0","0","0","0","0","0","0","0","0","0","0","0","0","5","4","1","0","0","0","0","0","0","0","0","0","-2"
"262129","New College of Florida","2014","Not on tenure/no tenure system, instructors","1","0","1","0","0","0","0","0","0","0","0","0","0","0","0","0","0","0","1","0","1","0","0","0","0","0","0","0","0","0","-2"
"262129","New College of Florida","2014","Not on tenure/no tenure system, no academic rank","2","1","1","0","0","0","0","0","0","0","0","0","0","0","0","0","0","0","1","1","0","0","0","0","0","0","0","1","0","1","-2"
"377564","University of Washington-Tacoma Campus","2014","Tenured total","83","46","37","0","0","0","8","7","1","4","2","2","6","4","2","0","0","0","49","24","25","1","0","1","2","2","0","13","7","6","-2"
"377564","University of Washington-Tacoma Campus","2014","Tenured, professors","29","19","10","0","0","0","6","5","1","1","1","0","1","1","0","0","0","0","17","9","8","0","0","0","1","1","0","3","2","1","-2"
"377564","University of Washington-Tacoma Campus","2014","Tenured, associate professors","54","27","27","0","0","0","2","2","0","3","1","2","5","3","2","0","0","0","32","15","17","1","0","1","1","1","0","10","5","5","-2"
"377564","University of Washington-Tacoma Campus","2014","On-Tenure track total","43","19","24","2","0","2","1","0","1","0","0","0","3","2","1","0","0","0","19","8","11","0","0","0","2","2","0","16","7","9","-2"
"377564","University of Washington-Tacoma Campus","2014","On-tenure track, associate professors","3","1","2","0","0","0","0","0","0","0","0","0","0","0","0","0","0","0","0","0","0","0","0","0","0","0","0","3","1","2","-2"
"377564","University of Washington-Tacoma Campus","2014","On-tenure track, assistant professors","40","18","22","2","0","2","1","0","1","0","0","0","3","2","1","0","0","0","19","8","11","0","0","0","2","2","0","13","6","7","-2"
"377564","University of Washington-Tacoma Campus","2014","Not on tenure track/No tenure system system total","88","34","54","0","0","0","1","0","1","3","0","3","5","0","5","1","0","1","66","30","36","2","1","1","2","0","2","8","3","5","-2"
"377564","University of Washington-Tacoma Campus","2014","Not on tenure/no tenure system, professors","4","3","1","0","0","0","0","0","0","0","0","0","0","0","0","0","0","0","4","3","1","0","0","0","0","0","0","0","0","0","-2"
"377564","University of Washington-Tacoma Campus","2014","Not on tenure/no tenure system, associate professors","3","0","3","0","0","0","0","0","0","1","0","1","0","0","0","0","0","0","2","0","2","0","0","0","0","0","0","0","0","0","-2"
"377564","University of Washington-Tacoma Campus","2014","Not on tenure/no tenure system, assistant professors","4","1","3","0","0","0","0","0","0","0","0","0","1","0","1","0","0","0","1","1","0","1","0","1","0","0","0","1","0","1","-2"
"377564","University of Washington-Tacoma Campus","2014","Not on tenure/no tenure system, lecturers","74","29","45","0","0","0","1","0","1","1","0","1","4","0","4","1","0","1","58","26","32","1","1","0","2","0","2","6","2","4","-2"
"377564","University of Washington-Tacoma Campus","2014","Not on tenure/no tenure system, no academic rank","3","1","2","0","0","0","0","0","0","1","0","1","0","0","0","0","0","0","1","0","1","0","0","0","0","0","0","1","1","0","-2"
"385619","Everglades University","2014","Not on tenure track/No tenure system system total","91","59","32","0","0","0","1","0","1","6","6","0","8","6","2","1","1","0","73","46","27","2","0","2","0","0","0","0","0","0","-2"
"385619","Everglades University","2014","Not on tenure/no tenure system, instructors","91","59","32","0","0","0","1","0","1","6","6","0","8","6","2","1","1","0","73","46","27","2","0","2","0","0","0","0","0","0","-2"
"388520","College of Biblical Studies-Houston","2014","Not on tenure track/No tenure system system total","17","15","2","0","0","0","0","0","0","5","4","1","3","3","0","0","0","0","9","8","1","0","0","0","0","0","0","0","0","0","-2"
"388520","College of Biblical Studies-Houston","2014","Not on tenure/no tenure system, professors","10","9","1","0","0","0","0","0","0","4","3","1","1","1","0","0","0","0","5","5","0","0","0","0","0","0","0","0","0","0","-2"
"388520","College of Biblical Studies-Houston","2014","Not on tenure/no tenure system, associate professors","4","3","1","0","0","0","0","0","0","0","0","0","0","0","0","0","0","0","4","3","1","0","0","0","0","0","0","0","0","0","-2"
"388520","College of Biblical Studies-Houston","2014","Not on tenure/no tenure system, assistant professors","3","3","0","0","0","0","0","0","0","1","1","0","2","2","0","0","0","0","0","0","0","0","0","0","0","0","0","0","0","0","-2"
"420574","Arizona State University-Polytechnic","2014","Tenured total","61","44","17","0","0","0","8","6","2","2","1","1","1","1","0","0","0","0","47","33","14","0","0","0","1","1","0","2","2","0","-2"
"420574","Arizona State University-Polytechnic","2014","Tenured, professors","25","21","4","0","0","0","2","2","0","1","1","0","0","0","0","0","0","0","22","18","4","0","0","0","0","0","0","0","0","0","-2"
"420574","Arizona State University-Polytechnic","2014","Tenured, associate professors","36","23","13","0","0","0","6","4","2","1","0","1","1","1","0","0","0","0","25","15","10","0","0","0","1","1","0","2","2","0","-2"
"420574","Arizona State University-Polytechnic","2014","On-Tenure track total","33","23","10","0","0","0","5","4","1","0","0","0","2","2","0","0","0","0","21","15","6","1","1","0","0","0","0","4","1","3","-2"
"420574","Arizona State University-Polytechnic","2014","On-tenure track, associate professors","2","1","1","0","0","0","0","0","0","0","0","0","0","0","0","0","0","0","2","1","1","0","0","0","0","0","0","0","0","0","-2"
"420574","Arizona State University-Polytechnic","2014","On-tenure track, assistant professors","31","22","9","0","0","0","5","4","1","0","0","0","2","2","0","0","0","0","19","14","5","1","1","0","0","0","0","4","1","3","-2"
"420574","Arizona State University-Polytechnic","2014","Not on tenure track/No tenure system system total","92","42","50","1","1","0","1","0","1","4","2","2","6","2","4","0","0","0","75","33","42","2","1","1","0","0","0","3","3","0","-2"
"420574","Arizona State University-Polytechnic","2014","Not on tenure/no tenure system, professors","2","2","0","1","1","0","0","0","0","0","0","0","0","0","0","0","0","0","1","1","0","0","0","0","0","0","0","0","0","0","-2"
"420574","Arizona State University-Polytechnic","2014","Not on tenure/no tenure system, associate professors","3","1","2","0","0","0","0","0","0","0","0","0","1","0","1","0","0","0","1","0","1","1","1","0","0","0","0","0","0","0","-2"
"420574","Arizona State University-Polytechnic","2014","Not on tenure/no tenure system, assistant professors","7","0","7","0","0","0","0","0","0","1","0","1","2","0","2","0","0","0","4","0","4","0","0","0","0","0","0","0","0","0","-2"
"420574","Arizona State University-Polytechnic","2014","Not on tenure/no tenure system, instructors","32","10","22","0","0","0","0","0","0","2","1","1","1","0","1","0","0","0","28","9","19","1","0","1","0","0","0","0","0","0","-2"
"420574","Arizona State University-Polytechnic","2014","Not on tenure/no tenure system, lecturers","48","29","19","0","0","0","1","0","1","1","1","0","2","2","0","0","0","0","41","23","18","0","0","0","0","0","0","3","3","0","-2"
"433660","Florida Gulf Coast University","2014","Tenured total","8","3","5","0","0","0","0","0","0","0","0","0","1","0","1","0","0","0","7","3","4","0","0","0","0","0","0","0","0","0","-2"
"433660","Florida Gulf Coast University","2014","Tenured, professors","7","3","4","0","0","0","0","0","0","0","0","0","1","0","1","0","0","0","6","3","3","0","0","0","0","0","0","0","0","0","-2"
"433660","Florida Gulf Coast University","2014","Tenured, associate professors","1","0","1","0","0","0","0","0","0","0","0","0","0","0","0","0","0","0","1","0","1","0","0","0","0","0","0","0","0","0","-2"
"433660","Florida Gulf Coast University","2014","Not on tenure track/No tenure system system total","439","243","196","2","2","0","28","19","9","15","8","7","26","11","15","0","0","0","350","190","160","2","2","0","0","0","0","16","11","5","-2"
"433660","Florida Gulf Coast University","2014","Not on tenure/no tenure system, professors","65","44","21","0","0","0","2","2","0","1","0","1","6","4","2","0","0","0","54","36","18","1","1","0","0","0","0","1","1","0","-2"
"433660","Florida Gulf Coast University","2014","Not on tenure/no tenure system, associate professors","112","72","40","0","0","0","12","10","2","6","5","1","2","1","1","0","0","0","91","55","36","0","0","0","0","0","0","1","1","0","-2"
"433660","Florida Gulf Coast University","2014","Not on tenure/no tenure system, assistant professors","153","88","65","2","2","0","12","6","6","5","1","4","11","5","6","0","0","0","112","65","47","1","1","0","0","0","0","10","8","2","-2"
"433660","Florida Gulf Coast University","2014","Not on tenure/no tenure system, instructors","107","39","68","0","0","0","2","1","1","3","2","1","7","1","6","0","0","0","93","34","59","0","0","0","0","0","0","2","1","1","-2"
"433660","Florida Gulf Coast University","2014","Not on tenure/no tenure system, lecturers","2","0","2","0","0","0","0","0","0","0","0","0","0","0","0","0","0","0","0","0","0","0","0","0","0","0","0","2","0","2","-2"
"447689","Georgia Gwinnett College","2014","Not on tenure track/No tenure system system total","393","198","195","2","1","1","39","20","19","43","18","25","15","9","6","0","0","0","254","128","126","0","0","0","21","11","10","19","11","8","-2"
"447689","Georgia Gwinnett College","2014","Not on tenure/no tenure system, professors","32","21","11","0","0","0","5","4","1","3","2","1","0","0","0","0","0","0","24","15","9","0","0","0","0","0","0","0","0","0","-2"
"447689","Georgia Gwinnett College","2014","Not on tenure/no tenure system, associate professors","87","50","37","0","0","0","15","8","7","15","7","8","2","1","1","0","0","0","49","30","19","0","0","0","4","3","1","2","1","1","-2"
"447689","Georgia Gwinnett College","2014","Not on tenure/no tenure system, assistant professors","242","117","125","2","1","1","18","8","10","21","9","12","12","8","4","0","0","0","158","75","83","0","0","0","14","6","8","17","10","7","-2"
"447689","Georgia Gwinnett College","2014","Not on tenure/no tenure system, instructors","32","10","22","0","0","0","1","0","1","4","0","4","1","0","1","0","0","0","23","8","15","0","0","0","3","2","1","0","0","0","-2"
"448840","University of South Florida-St Petersburg","2014","Tenured total","64","39","25","0","0","0","2","0","2","0","0","0","5","3","2","0","0","0","46","29","17","1","1","0","0","0","0","10","6","4","-2"
"448840","University of South Florida-St Petersburg","2014","Tenured, professors","28","22","6","0","0","0","2","0","2","0","0","0","2","2","0","0","0","0","21","18","3","0","0","0","0","0","0","3","2","1","-2"
"448840","University of South Florida-St Petersburg","2014","Tenured, associate professors","36","17","19","0","0","0","0","0","0","0","0","0","3","1","2","0","0","0","25","11","14","1","1","0","0","0","0","7","4","3","-2"
"448840","University of South Florida-St Petersburg","2014","On-Tenure track total","26","11","15","0","0","0","2","1","1","1","1","0","2","0","2","0","0","0","15","5","10","0","0","0","0","0","0","6","4","2","-2"
"448840","University of South Florida-St Petersburg","2014","On-tenure track, associate professors","1","0","1","0","0","0","0","0","0","0","0","0","1","0","1","0","0","0","0","0","0","0","0","0","0","0","0","0","0","0","-2"
"448840","University of South Florida-St Petersburg","2014","On-tenure track, assistant professors","23","10","13","0","0","0","2","1","1","1","1","0","1","0","1","0","0","0","14","5","9","0","0","0","0","0","0","5","3","2","-2"
"448840","University of South Florida-St Petersburg","2014","On-tenure track, instructors","2","1","1","0","0","0","0","0","0","0","0","0","0","0","0","0","0","0","1","0","1","0","0","0","0","0","0","1","1","0","-2"
"448840","University of South Florida-St Petersburg","2014","Not on tenure track/No tenure system system total","38","17","21","0","0","0","2","1","1","1","0","1","1","1","0","0","0","0","31","15","16","0","0","0","0","0","0","3","0","3","-2"
"448840","University of South Florida-St Petersburg","2014","Not on tenure/no tenure system, assistant professors","10","3","7","0","0","0","0","0","0","0","0","0","0","0","0","0","0","0","8","3","5","0","0","0","0","0","0","2","0","2","-2"
"448840","University of South Florida-St Petersburg","2014","Not on tenure/no tenure system, instructors","27","13","14","0","0","0","2","1","1","1","0","1","1","1","0","0","0","0","22","11","11","0","0","0","0","0","0","1","0","1","-2"
"448840","University of South Florida-St Petersburg","2014","Not on tenure/no tenure system, lecturers","1","1","0","0","0","0","0","0","0","0","0","0","0","0","0","0","0","0","1","1","0","0","0","0","0","0","0","0","0","0","-2"
"451671","University of South Florida-Sarasota-Manatee","2014","Tenured total","17","8","9","0","0","0","2","2","0","1","0","1","0","0","0","0","0","0","11","4","7","0","0","0","0","0","0","3","2","1","-2"
"451671","University of South Florida-Sarasota-Manatee","2014","Tenured, professors","3","2","1","0","0","0","1","1","0","0","0","0","0","0","0","0","0","0","2","1","1","0","0","0","0","0","0","0","0","0","-2"
"451671","University of South Florida-Sarasota-Manatee","2014","Tenured, associate professors","14","6","8","0","0","0","1","1","0","1","0","1","0","0","0","0","0","0","9","3","6","0","0","0","0","0","0","3","2","1","-2"
"451671","University of South Florida-Sarasota-Manatee","2014","On-Tenure track total","14","5","9","0","0","0","2","0","2","0","0","0","1","1","0","0","0","0","9","4","5","0","0","0","0","0","0","2","0","2","-2"
"451671","University of South Florida-Sarasota-Manatee","2014","On-tenure track, assistant professors","14","5","9","0","0","0","2","0","2","0","0","0","1","1","0","0","0","0","9","4","5","0","0","0","0","0","0","2","0","2","-2"
"451671","University of South Florida-Sarasota-Manatee","2014","Not on tenure track/No tenure system system total","41","18","23","0","0","0","2","0","2","1","0","1","2","1","1","0","0","0","31","13","18","0","0","0","0","0","0","5","4","1","-2"
"451671","University of South Florida-Sarasota-Manatee","2014","Not on tenure/no tenure system, assistant professors","2","0","2","0","0","0","0","0","0","0","0","0","0","0","0","0","0","0","1","0","1","0","0","0","0","0","0","1","0","1","-2"
"451671","University of South Florida-Sarasota-Manatee","2014","Not on tenure/no tenure system, instructors","39","18","21","0","0","0","2","0","2","1","0","1","2","1","1","0","0","0","30","13","17","0","0","0","0","0","0","4","4","0","-2"
"482936","Florida Polytechnic University","2014","Not on tenure track/No tenure system system total","22","14","8","0","0","0","3","3","0","0","0","0","1","1","0","1","1","0","16","9","7","0","0","0","1","0","1","0","0","0","-2"
"482936","Florida Polytechnic University","2014","Not on tenure/no tenure system, associate professors","3","3","0","0","0","0","0","0","0","0","0","0","1","1","0","0","0","0","2","2","0","0","0","0","0","0","0","0","0","0","-2"
"482936","Florida Polytechnic University","2014","Not on tenure/no tenure system, assistant professors","19","11","8","0","0","0","3","3","0","0","0","0","0","0","0","1","1","0","14","7","7","0","0","0","1","0","1","0","0","0","-2"
"483124","Arizona State University Digital Immersion","2014","Tenured total","67","35","32","0","0","0","5","2","3","2","0","2","8","4","4","0","0","0","50","27","23","0","0","0","0","0","0","2","2","0","-2"
"483124","Arizona State University Digital Immersion","2014","Tenured, professors","29","23","6","0","0","0","2","2","0","0","0","0","3","2","1","0","0","0","22","17","5","0","0","0","0","0","0","2","2","0","-2"
"483124","Arizona State University Digital Immersion","2014","Tenured, associate professors","38","12","26","0","0","0","3","0","3","2","0","2","5","2","3","0","0","0","28","10","18","0","0","0","0","0","0","0","0","0","-2"
"483124","Arizona State University Digital Immersion","2014","On-Tenure track total","17","7","10","0","0","0","2","0","2","0","0","0","2","1","1","0","0","0","11","5","6","0","0","0","0","0","0","2","1","1","-2"
"483124","Arizona State University Digital Immersion","2014","On-tenure track, associate professors","1","0","1","0","0","0","0","0","0","0","0","0","0","0","0","0","0","0","1","0","1","0","0","0","0","0","0","0","0","0","-2"
"483124","Arizona State University Digital Immersion","2014","On-tenure track, assistant professors","16","7","9","0","0","0","2","0","2","0","0","0","2","1","1","0","0","0","10","5","5","0","0","0","0","0","0","2","1","1","-2"
"483124","Arizona State University Digital Immersion","2014","Not on tenure track/No tenure system system total","200","67","133","1","0","1","9","4","5","7","1","6","10","4","6","1","0","1","165","56","109","1","0","1","0","0","0","6","2","4","-2"
"483124","Arizona State University Digital Immersion","2014","Not on tenure/no tenure system, professors","3","3","0","0","0","0","0","0","0","0","0","0","0","0","0","0","0","0","3","3","0","0","0","0","0","0","0","0","0","0","-2"
"483124","Arizona State University Digital Immersion","2014","Not on tenure/no tenure system, associate professors","13","3","10","0","0","0","0","0","0","1","0","1","1","0","1","0","0","0","11","3","8","0","0","0","0","0","0","0","0","0","-2"
"483124","Arizona State University Digital Immersion","2014","Not on tenure/no tenure system, assistant professors","14","2","12","0","0","0","0","0","0","0","0","0","0","0","0","0","0","0","14","2","12","0","0","0","0","0","0","0","0","0","-2"
"483124","Arizona State University Digital Immersion","2014","Not on tenure/no tenure system, instructors","68","19","49","0","0","0","2","0","2","4","0","4","5","2","3","0","0","0","56","17","39","0","0","0","0","0","0","1","0","1","-2"
"483124","Arizona State University Digital Immersion","2014","Not on tenure/no tenure system, lecturers","102","40","62","1","0","1","7","4","3","2","1","1","4","2","2","1","0","1","81","31","50","1","0","1","0","0","0","5","2","3","-2"
"484473","University of Florida-Online","2014","Tenured total","1","1","0","0","0","0","0","0","0","0","0","0","0","0","0","0","0","0","1","1","0","0","0","0","0","0","0","0","0","0","-2"
"484473","University of Florida-Online","2014","Tenured, associate professors","1","1","0","0","0","0","0","0","0","0","0","0","0","0","0","0","0","0","1","1","0","0","0","0","0","0","0","0","0","0","-2"
"484473","University of Florida-Online","2014","Not on tenure track/No tenure system system total","4","1","3","0","0","0","0","0","0","0","0","0","0","0","0","0","0","0","4","1","3","0","0","0","0","0","0","0","0","0","-2"
"484473","University of Florida-Online","2014","Not on tenure/no tenure system, lecturers","3","1","2","0","0","0","0","0","0","0","0","0","0","0","0","0","0","0","3","1","2","0","0","0","0","0","0","0","0","0","-2"
"484473","University of Florida-Online","2014","Not on tenure/no tenure system, no academic rank","1","0","1","0","0","0","0","0","0","0","0","0","0","0","0","0","0","0","1","0","1","0","0","0","0","0","0","0","0","0","-2"
