"unitid","institution name","year","S2010_F.Tenure status and academic rank of full-time instruction/research/public service staff","S2010_F_RV.Grand total","S2010_F_RV.Grand total men","S2010_F_RV.Grand total women","S2010_F_RV.American Indian or Alaska Native total","S2010_F_RV.American Indian or Alaska Native men","S2010_F_RV.American Indian or Alaska Native women","S2010_F_RV.Asian total","S2010_F_RV.Asian men","S2010_F_RV.Asian women","S2010_F_RV.Black or African American total","S2010_F_RV.Black or African American men","S2010_F_RV.Black or African American women","S2010_F_RV.Hispanic or Latino total","S2010_F_RV.Hispanic or Latino men","S2010_F_RV.Hispanic or Latino women","S2010_F_RV.Native Hawaiian or Other Pacific Islander total","S2010_F_RV.Native Hawaiian or Other Pacific Islander men","S2010_F_RV.Native Hawaiian or Other Pacific Islander women","S2010_F_RV.White total","S2010_F_RV.White men","S2010_F_RV.White women","S2010_F_RV.Two or more races total","S2010_F_RV.Two or more races men","S2010_F_RV.Two or more races women","S2010_F_RV.Race/ethnicity unknown total","S2010_F_RV.Race/ethnicity unknown men","S2010_F_RV.Race/ethnicity unknown women","S2010_F_RV.Nonresident alien total","S2010_F_RV.Nonresident alien men","S2010_F_RV.Nonresident alien women","IDX_HR"
"110422","California Polytechnic State University-San Luis Obispo","2010","Total full-time Instruction/research/public service, Tenured, Professors","267","210","57","0","0","0","20","18","2","4","4","0","16","12","4","1","1","0","209","159","50","3","3","0","14","13","1","0","0","0","-2"
"110422","California Polytechnic State University-San Luis Obispo","2010","Total full-time Instruction/research/public service, Tenured, Associate professors","138","101","37","0","0","0","14","10","4","2","1","1","11","7","4","0","0","0","98","73","25","3","2","1","9","7","2","1","1","0","-2"
"110422","California Polytechnic State University-San Luis Obispo","2010","Total full-time Instruction/research/public service, Tenured, No academic rank","4","4","0","0","0","0","0","0","0","0","0","0","0","0","0","0","0","0","3","3","0","0","0","0","1","1","0","0","0","0","-2"
"110422","California Polytechnic State University-San Luis Obispo","2010","Total full-time Instruction/research/public service, Tenured total","409","315","94","0","0","0","34","28","6","6","5","1","27","19","8","1","1","0","310","235","75","6","5","1","24","21","3","1","1","0","-2"
"110422","California Polytechnic State University-San Luis Obispo","2010","Total full-time Instruction/research/public service, Non-tenured on tenure track, Professors","1","0","1","0","0","0","0","0","0","0","0","0","0","0","0","0","0","0","1","0","1","0","0","0","0","0","0","0","0","0","-2"
"110422","California Polytechnic State University-San Luis Obispo","2010","Total full-time Instruction/research/public service, Non-tenured on tenure track, Associate professors","29","21","8","0","0","0","5","3","2","2","1","1","1","1","0","0","0","0","19","14","5","0","0","0","0","0","0","2","2","0","-2"
"110422","California Polytechnic State University-San Luis Obispo","2010","Total full-time Instruction/research/public service, Non-tenured on tenure track, Assistant professors","166","93","73","2","1","1","7","1","6","3","1","2","10","8","2","0","0","0","125","71","54","2","2","0","6","3","3","11","6","5","-2"
"110422","California Polytechnic State University-San Luis Obispo","2010","Total full-time Instruction/research/public service, Non-tenured on tenure track total","196","114","82","2","1","1","12","4","8","5","2","3","11","9","2","0","0","0","145","85","60","2","2","0","6","3","3","13","8","5","-2"
"110422","California Polytechnic State University-San Luis Obispo","2010","Total full-time Instruction/research/public service, Non-tenured not on tenure track, Lecturers","121","69","52","0","0","0","3","2","1","1","1","0","6","5","1","0","0","0","105","59","46","1","1","0","4","1","3","1","0","1","-2"
"110422","California Polytechnic State University-San Luis Obispo","2010","Total full-time Instruction/research/public service, Non-tenured not on tenure track total","121","69","52","0","0","0","3","2","1","1","1","0","6","5","1","0","0","0","105","59","46","1","1","0","4","1","3","1","0","1","-2"
"111188","California State University Maritime Academy","2010","Total full-time Instruction/research/public service, Tenured, Professors","16","11","5","0","0","0","1","0","1","0","0","0","0","0","0","0","0","0","15","11","4","0","0","0","0","0","0","0","0","0","-2"
"111188","California State University Maritime Academy","2010","Total full-time Instruction/research/public service, Tenured, Associate professors","5","5","0","0","0","0","0","0","0","0","0","0","1","1","0","0","0","0","4","4","0","0","0","0","0","0","0","0","0","0","-2"
"111188","California State University Maritime Academy","2010","Total full-time Instruction/research/public service, Tenured, Assistant professors","4","4","0","0","0","0","0","0","0","1","1","0","0","0","0","0","0","0","3","3","0","0","0","0","0","0","0","0","0","0","-2"
"111188","California State University Maritime Academy","2010","Total full-time Instruction/research/public service, Tenured, Instructors","2","2","0","0","0","0","0","0","0","0","0","0","0","0","0","0","0","0","2","2","0","0","0","0","0","0","0","0","0","0","-2"
"111188","California State University Maritime Academy","2010","Total full-time Instruction/research/public service, Tenured, No academic rank","3","3","0","0","0","0","0","0","0","0","0","0","0","0","0","0","0","0","3","3","0","0","0","0","0","0","0","0","0","0","-2"
"111188","California State University Maritime Academy","2010","Total full-time Instruction/research/public service, Tenured total","30","25","5","0","0","0","1","0","1","1","1","0","1","1","0","0","0","0","27","23","4","0","0","0","0","0","0","0","0","0","-2"
"111188","California State University Maritime Academy","2010","Total full-time Instruction/research/public service, Non-tenured on tenure track, Associate professors","1","0","1","0","0","0","1","0","1","0","0","0","0","0","0","0","0","0","0","0","0","0","0","0","0","0","0","0","0","0","-2"
"111188","California State University Maritime Academy","2010","Total full-time Instruction/research/public service, Non-tenured on tenure track, Assistant professors","11","10","1","0","0","0","1","1","0","0","0","0","2","1","1","0","0","0","8","8","0","0","0","0","0","0","0","0","0","0","-2"
"111188","California State University Maritime Academy","2010","Total full-time Instruction/research/public service, Non-tenured on tenure track, Instructors","1","1","0","0","0","0","0","0","0","0","0","0","0","0","0","0","0","0","1","1","0","0","0","0","0","0","0","0","0","0","-2"
"111188","California State University Maritime Academy","2010","Total full-time Instruction/research/public service, Non-tenured on tenure track, Lecturers","3","2","1","0","0","0","1","1","0","0","0","0","0","0","0","0","0","0","2","1","1","0","0","0","0","0","0","0","0","0","-2"
"111188","California State University Maritime Academy","2010","Total full-time Instruction/research/public service, Non-tenured on tenure track total","16","13","3","0","0","0","3","2","1","0","0","0","2","1","1","0","0","0","11","10","1","0","0","0","0","0","0","0","0","0","-2"
"111188","California State University Maritime Academy","2010","Total full-time Instruction/research/public service, Non-tenured not on tenure track, Lecturers","14","12","2","0","0","0","2","2","0","0","0","0","0","0","0","0","0","0","12","10","2","0","0","0","0","0","0","0","0","0","-2"
"111188","California State University Maritime Academy","2010","Total full-time Instruction/research/public service, Non-tenured not on tenure track total","14","12","2","0","0","0","2","2","0","0","0","0","0","0","0","0","0","0","12","10","2","0","0","0","0","0","0","0","0","0","-2"
"111948","Chapman University","2010","Total full-time Instruction/research/public service, Tenured, Professors","107","78","29","0","0","0","7","3","4","3","3","0","2","2","0","0","0","0","94","69","25","0","0","0","0","0","0","1","1","0","-2"
"111948","Chapman University","2010","Total full-time Instruction/research/public service, Tenured, Associate professors","69","44","25","1","1","0","3","3","0","1","0","1","2","0","2","0","0","0","59","37","22","1","1","0","0","0","0","2","2","0","-2"
"111948","Chapman University","2010","Total full-time Instruction/research/public service, Tenured total","176","122","54","1","1","0","10","6","4","4","3","1","4","2","2","0","0","0","153","106","47","1","1","0","0","0","0","3","3","0","-2"
"111948","Chapman University","2010","Total full-time Instruction/research/public service, Non-tenured on tenure track, Associate professors","13","10","3","0","0","0","0","0","0","1","0","1","3","3","0","0","0","0","9","7","2","0","0","0","0","0","0","0","0","0","-2"
"111948","Chapman University","2010","Total full-time Instruction/research/public service, Non-tenured on tenure track, Assistant professors","69","28","41","0","0","0","6","1","5","4","3","1","4","1","3","0","0","0","44","19","25","1","0","1","2","0","2","8","4","4","-2"
"111948","Chapman University","2010","Total full-time Instruction/research/public service, Non-tenured on tenure track, Instructors","2","1","1","0","0","0","0","0","0","0","0","0","1","0","1","0","0","0","0","0","0","0","0","0","1","1","0","0","0","0","-2"
"111948","Chapman University","2010","Total full-time Instruction/research/public service, Non-tenured on tenure track total","84","39","45","0","0","0","6","1","5","5","3","2","8","4","4","0","0","0","53","26","27","1","0","1","3","1","2","8","4","4","-2"
"111948","Chapman University","2010","Total full-time Instruction/research/public service, Non-tenured not on tenure track, Professors","10","10","0","0","0","0","0","0","0","0","0","0","0","0","0","0","0","0","8","8","0","0","0","0","1","1","0","1","1","0","-2"
"111948","Chapman University","2010","Total full-time Instruction/research/public service, Non-tenured not on tenure track, Associate professors","31","21","10","0","0","0","2","2","0","0","0","0","2","1","1","0","0","0","24","15","9","0","0","0","1","1","0","2","2","0","-2"
"111948","Chapman University","2010","Total full-time Instruction/research/public servicey, Non-tenured not on tenure track, Assistant professors","54","27","27","0","0","0","3","1","2","2","1","1","2","0","2","0","0","0","41","21","20","0","0","0","2","1","1","4","3","1","-2"
"111948","Chapman University","2010","Total full-time Instruction/research/public service, Non-tenured not on tenure track, Instructors","15","8","7","0","0","0","3","1","2","0","0","0","2","1","1","0","0","0","9","5","4","0","0","0","0","0","0","1","1","0","-2"
"111948","Chapman University","2010","Total full-time Instruction/research/public service, Non-tenured not on tenure track total","110","66","44","0","0","0","8","4","4","2","1","1","6","2","4","0","0","0","82","49","33","0","0","0","4","3","1","8","7","1","-2"
"112260","Claremont McKenna College","2010","Total full-time Instruction/research/public service, Tenured, Professors","52","41","11","1","1","0","2","2","0","3","1","2","2","2","0","0","0","0","43","35","8","0","0","0","0","0","0","1","0","1","-2"
"112260","Claremont McKenna College","2010","Total full-time Instruction/research/public service, Tenured, Associate professors","33","24","9","0","0","0","4","3","1","0","0","0","2","2","0","0","0","0","27","19","8","0","0","0","0","0","0","0","0","0","-2"
"112260","Claremont McKenna College","2010","Total full-time Instruction/research/public service, Tenured, Lecturers","1","1","0","0","0","0","0","0","0","0","0","0","0","0","0","0","0","0","1","1","0","0","0","0","0","0","0","0","0","0","-2"
"112260","Claremont McKenna College","2010","Total full-time Instruction/research/public service, Tenured total","86","66","20","1","1","0","6","5","1","3","1","2","4","4","0","0","0","0","71","55","16","0","0","0","0","0","0","1","0","1","-2"
"112260","Claremont McKenna College","2010","Total full-time Instruction/research/public service, Non-tenured on tenure track, Associate professors","3","3","0","0","0","0","0","0","0","0","0","0","0","0","0","0","0","0","2","2","0","0","0","0","1","1","0","0","0","0","-2"
"112260","Claremont McKenna College","2010","Total full-time Instruction/research/public service, Non-tenured on tenure track, Assistant professors","28","18","10","0","0","0","4","3","1","1","0","1","0","0","0","0","0","0","19","13","6","0","0","0","1","0","1","3","2","1","-2"
"112260","Claremont McKenna College","2010","Total full-time Instruction/research/public service, Non-tenured on tenure track total","31","21","10","0","0","0","4","3","1","1","0","1","0","0","0","0","0","0","21","15","6","0","0","0","2","1","1","3","2","1","-2"
"112260","Claremont McKenna College","2010","Total full-time Instruction/research/public service, Non-tenured not on tenure track, Professors","1","1","0","0","0","0","0","0","0","0","0","0","0","0","0","0","0","0","1","1","0","0","0","0","0","0","0","0","0","0","-2"
"112260","Claremont McKenna College","2010","Total full-time Instruction/research/public service, Non-tenured not on tenure track, Associate professors","3","1","2","0","0","0","0","0","0","0","0","0","0","0","0","0","0","0","3","1","2","0","0","0","0","0","0","0","0","0","-2"
"112260","Claremont McKenna College","2010","Total full-time Instruction/research/public servicey, Non-tenured not on tenure track, Assistant professors","25","12","13","0","0","0","2","0","2","0","0","0","3","1","2","0","0","0","16","8","8","0","0","0","0","0","0","4","3","1","-2"
"112260","Claremont McKenna College","2010","Total full-time Instruction/research/public service, Non-tenured not on tenure track, Instructors","5","2","3","0","0","0","0","0","0","1","0","1","1","0","1","0","0","0","2","2","0","0","0","0","0","0","0","1","0","1","-2"
"112260","Claremont McKenna College","2010","Total full-time Instruction/research/public service, Non-tenured not on tenure track total","34","16","18","0","0","0","2","0","2","1","0","1","4","1","3","0","0","0","22","12","10","0","0","0","0","0","0","5","3","2","-2"
"117946","Loyola Marymount University","2010","Total full-time Instruction/research/public service, Tenured, Professors","210","153","57","0","0","0","17","14","3","8","6","2","14","6","8","0","0","0","152","114","38","2","1","1","17","12","5","0","0","0","-2"
"117946","Loyola Marymount University","2010","Total full-time Instruction/research/public service, Tenured, Associate professors","110","60","50","1","0","1","12","7","5","7","6","1","16","8","8","0","0","0","71","37","34","1","1","0","2","1","1","0","0","0","-2"
"117946","Loyola Marymount University","2010","Total full-time Instruction/research/public service, Tenured, Assistant professors","5","4","1","0","0","0","1","1","0","0","0","0","1","1","0","0","0","0","3","2","1","0","0","0","0","0","0","0","0","0","-2"
"117946","Loyola Marymount University","2010","Total full-time Instruction/research/public service, Tenured total","325","217","108","1","0","1","30","22","8","15","12","3","31","15","16","0","0","0","226","153","73","3","2","1","19","13","6","0","0","0","-2"
"117946","Loyola Marymount University","2010","Total full-time Instruction/research/public service, Non-tenured on tenure track, Associate professors","11","5","6","0","0","0","2","0","2","1","0","1","1","0","1","0","0","0","5","4","1","0","0","0","2","1","1","0","0","0","-2"
"117946","Loyola Marymount University","2010","Total full-time Instruction/research/public service, Non-tenured on tenure track, Assistant professors","84","31","53","0","0","0","8","2","6","3","1","2","10","3","7","0","0","0","56","24","32","3","0","3","1","0","1","3","1","2","-2"
"117946","Loyola Marymount University","2010","Total full-time Instruction/research/public service, Non-tenured on tenure track total","95","36","59","0","0","0","10","2","8","4","1","3","11","3","8","0","0","0","61","28","33","3","0","3","3","1","2","3","1","2","-2"
"117946","Loyola Marymount University","2010","Total full-time Instruction/research/public service, Non-tenured not on tenure track, Professors","2","1","1","0","0","0","0","0","0","1","1","0","0","0","0","0","0","0","1","0","1","0","0","0","0","0","0","0","0","0","-2"
"117946","Loyola Marymount University","2010","Total full-time Instruction/research/public service, Non-tenured not on tenure track, Associate professors","21","7","14","0","0","0","2","1","1","1","0","1","1","0","1","0","0","0","15","6","9","0","0","0","2","0","2","0","0","0","-2"
"117946","Loyola Marymount University","2010","Total full-time Instruction/research/public servicey, Non-tenured not on tenure track, Assistant professors","37","21","16","0","0","0","3","1","2","2","1","1","3","2","1","0","0","0","27","16","11","0","0","0","1","1","0","1","0","1","-2"
"117946","Loyola Marymount University","2010","Total full-time Instruction/research/public service, Non-tenured not on tenure track, Instructors","40","13","27","0","0","0","5","0","5","5","3","2","6","3","3","0","0","0","24","7","17","0","0","0","0","0","0","0","0","0","-2"
"117946","Loyola Marymount University","2010","Total full-time Instruction/research/public service, Non-tenured not on tenure track, No academic rank","1","1","0","0","0","0","0","0","0","0","0","0","1","1","0","0","0","0","0","0","0","0","0","0","0","0","0","0","0","0","-2"
"117946","Loyola Marymount University","2010","Total full-time Instruction/research/public service, Non-tenured not on tenure track total","101","43","58","0","0","0","10","2","8","9","5","4","11","6","5","0","0","0","67","29","38","0","0","0","3","1","2","1","0","1","-2"
"121345","Pomona College","2010","Total full-time Instruction/research/public service, Tenured, Professors","85","55","30","0","0","0","7","2","5","2","1","1","9","5","4","0","0","0","52","34","18","4","3","1","11","10","1","0","0","0","-2"
"121345","Pomona College","2010","Total full-time Instruction/research/public service, Tenured, Associate professors","43","21","22","0","0","0","8","3","5","1","1","0","5","3","2","0","0","0","22","9","13","1","1","0","6","4","2","0","0","0","-2"
"121345","Pomona College","2010","Total full-time Instruction/research/public service, Tenured total","128","76","52","0","0","0","15","5","10","3","2","1","14","8","6","0","0","0","74","43","31","5","4","1","17","14","3","0","0","0","-2"
"121345","Pomona College","2010","Total full-time Instruction/research/public service, Non-tenured on tenure track, Assistant professors","51","30","21","0","0","0","5","3","2","1","1","0","7","6","1","0","0","0","27","14","13","1","1","0","9","4","5","1","1","0","-2"
"121345","Pomona College","2010","Total full-time Instruction/research/public service, Non-tenured on tenure track total","51","30","21","0","0","0","5","3","2","1","1","0","7","6","1","0","0","0","27","14","13","1","1","0","9","4","5","1","1","0","-2"
"121345","Pomona College","2010","Total full-time Instruction/research/public service, Non-tenured not on tenure track, Professors","3","1","2","0","0","0","1","0","1","0","0","0","1","0","1","0","0","0","0","0","0","0","0","0","1","1","0","0","0","0","-2"
"121345","Pomona College","2010","Total full-time Instruction/research/public service, Non-tenured not on tenure track, Associate professors","1","0","1","0","0","0","0","0","0","0","0","0","1","0","1","0","0","0","0","0","0","0","0","0","0","0","0","0","0","0","-2"
"121345","Pomona College","2010","Total full-time Instruction/research/public service, Non-tenured not on tenure track total","4","1","3","0","0","0","1","0","1","0","0","0","2","0","2","0","0","0","0","0","0","0","0","0","1","1","0","0","0","0","-2"
"122296","Samuel Merritt University","2010","Total full-time Instruction/research/public service, Non-tenured not on tenure track, Professors","10","8","2","0","0","0","0","0","0","0","0","0","1","1","0","0","0","0","9","7","2","0","0","0","0","0","0","0","0","0","-2"
"122296","Samuel Merritt University","2010","Total full-time Instruction/research/public service, Non-tenured not on tenure track, Associate professors","13","3","10","0","0","0","1","1","0","1","0","1","0","0","0","0","0","0","11","2","9","0","0","0","0","0","0","0","0","0","-2"
"122296","Samuel Merritt University","2010","Total full-time Instruction/research/public servicey, Non-tenured not on tenure track, Assistant professors","56","13","43","1","1","0","6","1","5","2","0","2","1","0","1","0","0","0","45","11","34","1","0","1","0","0","0","0","0","0","-2"
"122296","Samuel Merritt University","2010","Total full-time Instruction/research/public service, Non-tenured not on tenure track, Instructors","9","0","9","0","0","0","2","0","2","1","0","1","0","0","0","0","0","0","6","0","6","0","0","0","0","0","0","0","0","0","-2"
"122296","Samuel Merritt University","2010","Total full-time Instruction/research/public service, Non-tenured not on tenure track total","88","24","64","1","1","0","9","2","7","4","0","4","2","1","1","0","0","0","71","20","51","1","0","1","0","0","0","0","0","0","-2"
"122436","University of San Diego","2010","Total full-time Instruction/research/public service, Tenured, Professors","145","93","52","0","0","0","9","5","4","2","2","0","7","5","2","0","0","0","126","81","45","0","0","0","0","0","0","1","0","1","-2"
"122436","University of San Diego","2010","Total full-time Instruction/research/public service, Tenured, Associate professors","93","54","39","0","0","0","11","8","3","3","3","0","11","4","7","0","0","0","67","38","29","1","1","0","0","0","0","0","0","0","-2"
"122436","University of San Diego","2010","Total full-time Instruction/research/public service, Tenured, Assistant professors","1","0","1","0","0","0","0","0","0","0","0","0","0","0","0","0","0","0","1","0","1","0","0","0","0","0","0","0","0","0","-2"
"122436","University of San Diego","2010","Total full-time Instruction/research/public service, Tenured total","239","147","92","0","0","0","20","13","7","5","5","0","18","9","9","0","0","0","194","119","75","1","1","0","0","0","0","1","0","1","-2"
"122436","University of San Diego","2010","Total full-time Instruction/research/public service, Non-tenured on tenure track, Professors","2","0","2","0","0","0","0","0","0","0","0","0","0","0","0","0","0","0","2","0","2","0","0","0","0","0","0","0","0","0","-2"
"122436","University of San Diego","2010","Total full-time Instruction/research/public service, Non-tenured on tenure track, Associate professors","13","4","9","1","0","1","2","1","1","0","0","0","2","0","2","0","0","0","8","3","5","0","0","0","0","0","0","0","0","0","-2"
"122436","University of San Diego","2010","Total full-time Instruction/research/public service, Non-tenured on tenure track, Assistant professors","82","41","41","0","0","0","5","1","4","3","2","1","5","2","3","0","0","0","57","28","29","1","0","1","0","0","0","11","8","3","-2"
"122436","University of San Diego","2010","Total full-time Instruction/research/public service, Non-tenured on tenure track, Instructors","3","1","2","0","0","0","0","0","0","0","0","0","0","0","0","0","0","0","3","1","2","0","0","0","0","0","0","0","0","0","-2"
"122436","University of San Diego","2010","Total full-time Instruction/research/public service, Non-tenured on tenure track total","100","46","54","1","0","1","7","2","5","3","2","1","7","2","5","0","0","0","70","32","38","1","0","1","0","0","0","11","8","3","-2"
"122436","University of San Diego","2010","Total full-time Instruction/research/public service, Non-tenured not on tenure track, Professors","12","6","6","0","0","0","0","0","0","0","0","0","0","0","0","0","0","0","10","4","6","0","0","0","0","0","0","2","2","0","-2"
"122436","University of San Diego","2010","Total full-time Instruction/research/public service, Non-tenured not on tenure track, Associate professors","6","1","5","0","0","0","0","0","0","1","1","0","0","0","0","0","0","0","4","0","4","0","0","0","1","0","1","0","0","0","-2"
"122436","University of San Diego","2010","Total full-time Instruction/research/public servicey, Non-tenured not on tenure track, Assistant professors","13","3","10","1","0","1","3","0","3","0","0","0","0","0","0","0","0","0","9","3","6","0","0","0","0","0","0","0","0","0","-2"
"122436","University of San Diego","2010","Total full-time Instruction/research/public service, Non-tenured not on tenure track, Instructors","23","7","16","0","0","0","2","1","1","0","0","0","2","0","2","0","0","0","18","6","12","0","0","0","0","0","0","1","0","1","-2"
"122436","University of San Diego","2010","Total full-time Instruction/research/public service, Non-tenured not on tenure track total","54","17","37","1","0","1","5","1","4","1","1","0","2","0","2","0","0","0","41","13","28","0","0","0","1","0","1","3","2","1","-2"
"122612","University of San Francisco","2010","Total full-time Instruction/research/public service, Tenured, Professors","129","83","46","0","0","0","8","5","3","5","0","5","7","4","3","1","1","0","103","70","33","3","2","1","0","0","0","2","1","1","-2"
"122612","University of San Francisco","2010","Total full-time Instruction/research/public service, Tenured, Associate professors","104","52","52","1","0","1","11","4","7","6","3","3","10","6","4","0","0","0","70","34","36","4","3","1","0","0","0","2","2","0","-2"
"122612","University of San Francisco","2010","Total full-time Instruction/research/public service, Tenured, Assistant professors","4","2","2","0","0","0","0","0","0","0","0","0","0","0","0","0","0","0","4","2","2","0","0","0","0","0","0","0","0","0","-2"
"122612","University of San Francisco","2010","Total full-time Instruction/research/public service, Tenured total","237","137","100","1","0","1","19","9","10","11","3","8","17","10","7","1","1","0","177","106","71","7","5","2","0","0","0","4","3","1","-2"
"122612","University of San Francisco","2010","Total full-time Instruction/research/public service, Non-tenured on tenure track, Professors","1","1","0","0","0","0","0","0","0","0","0","0","0","0","0","0","0","0","1","1","0","0","0","0","0","0","0","0","0","0","-2"
"122612","University of San Francisco","2010","Total full-time Instruction/research/public service, Non-tenured on tenure track, Associate professors","9","5","4","0","0","0","1","1","0","1","0","1","1","1","0","0","0","0","5","2","3","1","1","0","0","0","0","0","0","0","-2"
"122612","University of San Francisco","2010","Total full-time Instruction/research/public service, Non-tenured on tenure track, Assistant professors","70","20","50","0","0","0","10","3","7","4","1","3","8","4","4","0","0","0","42","9","33","2","1","1","0","0","0","4","2","2","-2"
"122612","University of San Francisco","2010","Total full-time Instruction/research/public service, Non-tenured on tenure track total","80","26","54","0","0","0","11","4","7","5","1","4","9","5","4","0","0","0","48","12","36","3","2","1","0","0","0","4","2","2","-2"
"122612","University of San Francisco","2010","Total full-time Instruction/research/public service, Non-tenured not on tenure track, Professors","1","1","0","0","0","0","0","0","0","0","0","0","0","0","0","0","0","0","1","1","0","0","0","0","0","0","0","0","0","0","-2"
"122612","University of San Francisco","2010","Total full-time Instruction/research/public service, Non-tenured not on tenure track, Associate professors","13","7","6","0","0","0","1","1","0","1","0","1","0","0","0","0","0","0","9","4","5","2","2","0","0","0","0","0","0","0","-2"
"122612","University of San Francisco","2010","Total full-time Instruction/research/public servicey, Non-tenured not on tenure track, Assistant professors","45","25","20","1","1","0","8","3","5","2","0","2","5","4","1","0","0","0","27","16","11","0","0","0","0","0","0","2","1","1","-2"
"122612","University of San Francisco","2010","Total full-time Instruction/research/public service, Non-tenured not on tenure track, Instructors","18","6","12","1","0","1","3","0","3","0","0","0","0","0","0","0","0","0","13","5","8","1","1","0","0","0","0","0","0","0","-2"
"122612","University of San Francisco","2010","Total full-time Instruction/research/public service, Non-tenured not on tenure track total","77","39","38","2","1","1","12","4","8","3","0","3","5","4","1","0","0","0","50","26","24","3","3","0","0","0","0","2","1","1","-2"
"122728","William Jessup University","2010","Total full-time Instruction/research/public service, Tenured, Professors","6","2","4","0","0","0","0","0","0","0","0","0","1","0","1","0","0","0","5","2","3","0","0","0","0","0","0","0","0","0","-2"
"122728","William Jessup University","2010","Total full-time Instruction/research/public service, Tenured total","6","2","4","0","0","0","0","0","0","0","0","0","1","0","1","0","0","0","5","2","3","0","0","0","0","0","0","0","0","0","-2"
"122728","William Jessup University","2010","Total full-time Instruction/research/public service, Non-tenured on tenure track, Professors","4","3","1","0","0","0","0","0","0","0","0","0","0","0","0","0","0","0","4","3","1","0","0","0","0","0","0","0","0","0","-2"
"122728","William Jessup University","2010","Total full-time Instruction/research/public service, Non-tenured on tenure track, Associate professors","6","3","3","0","0","0","1","0","1","0","0","0","0","0","0","0","0","0","5","3","2","0","0","0","0","0","0","0","0","0","-2"
"122728","William Jessup University","2010","Total full-time Instruction/research/public service, Non-tenured on tenure track, Assistant professors","3","3","0","0","0","0","0","0","0","0","0","0","0","0","0","0","0","0","3","3","0","0","0","0","0","0","0","0","0","0","-2"
"122728","William Jessup University","2010","Total full-time Instruction/research/public service, Non-tenured on tenure track total","13","9","4","0","0","0","1","0","1","0","0","0","0","0","0","0","0","0","12","9","3","0","0","0","0","0","0","0","0","0","-2"
"122931","Santa Clara University","2010","Total full-time Instruction/research/public service, Tenured, Professors","142","106","36","0","0","0","10","9","1","0","0","0","9","8","1","0","0","0","122","88","34","1","1","0","0","0","0","0","0","0","122931"
"122931","Santa Clara University","2010","Total full-time Instruction/research/public service, Tenured, Associate professors","139","81","58","0","0","0","16","8","8","6","3","3","15","8","7","0","0","0","101","61","40","0","0","0","1","1","0","0","0","0","122931"
"122931","Santa Clara University","2010","Total full-time Instruction/research/public service, Tenured, Assistant professors","1","1","0","0","0","0","0","0","0","0","0","0","0","0","0","0","0","0","1","1","0","0","0","0","0","0","0","0","0","0","122931"
"122931","Santa Clara University","2010","Total full-time Instruction/research/public service, Tenured total","282","188","94","0","0","0","26","17","9","6","3","3","24","16","8","0","0","0","224","150","74","1","1","0","1","1","0","0","0","0","122931"
"122931","Santa Clara University","2010","Total full-time Instruction/research/public service, Non-tenured on tenure track, Associate professors","6","3","3","0","0","0","1","0","1","0","0","0","0","0","0","0","0","0","5","3","2","0","0","0","0","0","0","0","0","0","122931"
"122931","Santa Clara University","2010","Total full-time Instruction/research/public service, Non-tenured on tenure track, Assistant professors","74","37","37","0","0","0","15","6","9","2","0","2","3","1","2","4","3","1","48","26","22","1","1","0","1","0","1","0","0","0","122931"
"122931","Santa Clara University","2010","Total full-time Instruction/research/public service, Non-tenured on tenure track total","80","40","40","0","0","0","16","6","10","2","0","2","3","1","2","4","3","1","53","29","24","1","1","0","1","0","1","0","0","0","122931"
"122931","Santa Clara University","2010","Total full-time Instruction/research/public service, Non-tenured not on tenure track, Lecturers","61","26","35","0","0","0","6","2","4","1","0","1","5","2","3","0","0","0","47","21","26","2","1","1","0","0","0","0","0","0","122931"
"122931","Santa Clara University","2010","Total full-time Instruction/research/public service, Non-tenured not on tenure track, No academic rank","25","11","14","0","0","0","0","0","0","0","0","0","2","0","2","0","0","0","22","10","12","1","1","0","0","0","0","0","0","0","122931"
"122931","Santa Clara University","2010","Total full-time Instruction/research/public service, Non-tenured not on tenure track total","86","37","49","0","0","0","6","2","4","1","0","1","7","2","5","0","0","0","69","31","38","3","2","1","0","0","0","0","0","0","122931"
"123299","Shasta College","2010","Total full-time Instruction/research/public service, Tenured, Instructors","102","54","48","3","2","1","2","1","1","2","0","2","5","3","2","0","0","0","90","48","42","0","0","0","0","0","0","0","0","0","-2"
"123299","Shasta College","2010","Total full-time Instruction/research/public service, Tenured total","102","54","48","3","2","1","2","1","1","2","0","2","5","3","2","0","0","0","90","48","42","0","0","0","0","0","0","0","0","0","-2"
"123299","Shasta College","2010","Total full-time Instruction/research/public service, Non-tenured on tenure track, Instructors","21","14","7","0","0","0","0","0","0","0","0","0","2","2","0","1","1","0","18","11","7","0","0","0","0","0","0","0","0","0","-2"
"123299","Shasta College","2010","Total full-time Instruction/research/public service, Non-tenured on tenure track total","21","14","7","0","0","0","0","0","0","0","0","0","2","2","0","1","1","0","18","11","7","0","0","0","0","0","0","0","0","0","-2"
"123299","Shasta College","2010","Total full-time Instruction/research/public service, Non-tenured not on tenure track, Instructors","18","7","11","0","0","0","0","0","0","2","2","0","0","0","0","0","0","0","16","5","11","0","0","0","0","0","0","0","0","0","-2"
"123299","Shasta College","2010","Total full-time Instruction/research/public service, Non-tenured not on tenure track total","18","7","11","0","0","0","0","0","0","2","2","0","0","0","0","0","0","0","16","5","11","0","0","0","0","0","0","0","0","0","-2"
"125727","Westmont College","2010","Total full-time Instruction/research/public service, Tenured, Professors","48","38","10","0","0","0","2","2","0","0","0","0","1","1","0","0","0","0","45","35","10","0","0","0","0","0","0","0","0","0","-2"
"125727","Westmont College","2010","Total full-time Instruction/research/public service, Tenured, Associate professors","15","8","7","0","0","0","2","1","1","0","0","0","1","0","1","0","0","0","12","7","5","0","0","0","0","0","0","0","0","0","-2"
"125727","Westmont College","2010","Total full-time Instruction/research/public service, Tenured total","63","46","17","0","0","0","4","3","1","0","0","0","2","1","1","0","0","0","57","42","15","0","0","0","0","0","0","0","0","0","-2"
"125727","Westmont College","2010","Total full-time Instruction/research/public service, Non-tenured on tenure track, Professors","1","0","1","0","0","0","0","0","0","0","0","0","0","0","0","0","0","0","1","0","1","0","0","0","0","0","0","0","0","0","-2"
"125727","Westmont College","2010","Total full-time Instruction/research/public service, Non-tenured on tenure track, Associate professors","2","1","1","0","0","0","0","0","0","0","0","0","1","0","1","0","0","0","1","1","0","0","0","0","0","0","0","0","0","0","-2"
"125727","Westmont College","2010","Total full-time Instruction/research/public service, Non-tenured on tenure track, Assistant professors","16","10","6","1","0","1","2","2","0","1","1","0","0","0","0","0","0","0","12","7","5","0","0","0","0","0","0","0","0","0","-2"
"125727","Westmont College","2010","Total full-time Instruction/research/public service, Non-tenured on tenure track total","19","11","8","1","0","1","2","2","0","1","1","0","1","0","1","0","0","0","14","8","6","0","0","0","0","0","0","0","0","0","-2"
"125727","Westmont College","2010","Total full-time Instruction/research/public service, Non-tenured not on tenure track, Associate professors","4","2","2","0","0","0","0","0","0","0","0","0","0","0","0","0","0","0","4","2","2","0","0","0","0","0","0","0","0","0","-2"
"125727","Westmont College","2010","Total full-time Instruction/research/public servicey, Non-tenured not on tenure track, Assistant professors","6","2","4","0","0","0","0","0","0","0","0","0","0","0","0","0","0","0","6","2","4","0","0","0","0","0","0","0","0","0","-2"
"125727","Westmont College","2010","Total full-time Instruction/research/public service, Non-tenured not on tenure track, Instructors","3","1","2","0","0","0","0","0","0","0","0","0","0","0","0","0","0","0","3","1","2","0","0","0","0","0","0","0","0","0","-2"
"125727","Westmont College","2010","Total full-time Instruction/research/public service, Non-tenured not on tenure track total","13","5","8","0","0","0","0","0","0","0","0","0","0","0","0","0","0","0","13","5","8","0","0","0","0","0","0","0","0","0","-2"
"126580","University of Colorado Colorado Springs","2010","Total full-time Instruction/research/public service, Tenured, Professors","69","56","13","0","0","0","3","3","0","1","0","1","3","2","1","0","0","0","61","50","11","0","0","0","1","1","0","0","0","0","-2"
"126580","University of Colorado Colorado Springs","2010","Total full-time Instruction/research/public service, Tenured, Associate professors","66","31","35","1","0","1","1","1","0","2","0","2","3","1","2","0","0","0","56","29","27","0","0","0","3","0","3","0","0","0","-2"
"126580","University of Colorado Colorado Springs","2010","Total full-time Instruction/research/public service, Tenured total","135","87","48","1","0","1","4","4","0","3","0","3","6","3","3","0","0","0","117","79","38","0","0","0","4","1","3","0","0","0","-2"
"126580","University of Colorado Colorado Springs","2010","Total full-time Instruction/research/public service, Non-tenured on tenure track, Assistant professors","79","35","44","1","0","1","9","3","6","2","1","1","5","4","1","0","0","0","54","23","31","0","0","0","8","4","4","0","0","0","-2"
"126580","University of Colorado Colorado Springs","2010","Total full-time Instruction/research/public service, Non-tenured on tenure track total","79","35","44","1","0","1","9","3","6","2","1","1","5","4","1","0","0","0","54","23","31","0","0","0","8","4","4","0","0","0","-2"
"126580","University of Colorado Colorado Springs","2010","Total full-time Instruction/research/public service, Non-tenured not on tenure track, Instructors","125","41","84","1","0","1","4","2","2","2","1","1","10","2","8","0","0","0","98","33","65","0","0","0","10","3","7","0","0","0","-2"
"126580","University of Colorado Colorado Springs","2010","Total full-time Instruction/research/public service, Non-tenured not on tenure track total","125","41","84","1","0","1","4","2","2","2","1","1","10","2","8","0","0","0","98","33","65","0","0","0","10","3","7","0","0","0","-2"
"127556","Colorado Mesa University","2010","Total full-time Instruction/research/public service, Tenured, Professors","63","41","22","0","0","0","0","0","0","0","0","0","1","1","0","0","0","0","45","28","17","1","1","0","12","8","4","4","3","1","-2"
"127556","Colorado Mesa University","2010","Total full-time Instruction/research/public service, Tenured, Associate professors","22","9","13","0","0","0","1","1","0","0","0","0","0","0","0","0","0","0","17","7","10","0","0","0","2","0","2","2","1","1","-2"
"127556","Colorado Mesa University","2010","Total full-time Instruction/research/public service, Tenured, Assistant professors","1","1","0","0","0","0","0","0","0","1","1","0","0","0","0","0","0","0","0","0","0","0","0","0","0","0","0","0","0","0","-2"
"127556","Colorado Mesa University","2010","Total full-time Instruction/research/public service, Tenured, Instructors","1","1","0","0","0","0","0","0","0","0","0","0","0","0","0","0","0","0","1","1","0","0","0","0","0","0","0","0","0","0","-2"
"127556","Colorado Mesa University","2010","Total full-time Instruction/research/public service, Tenured total","87","52","35","0","0","0","1","1","0","1","1","0","1","1","0","0","0","0","63","36","27","1","1","0","14","8","6","6","4","2","-2"
"127556","Colorado Mesa University","2010","Total full-time Instruction/research/public service, Non-tenured on tenure track, Professors","3","3","0","0","0","0","0","0","0","0","0","0","0","0","0","0","0","0","2","2","0","0","0","0","1","1","0","0","0","0","-2"
"127556","Colorado Mesa University","2010","Total full-time Instruction/research/public service, Non-tenured on tenure track, Associate professors","10","8","2","0","0","0","0","0","0","0","0","0","0","0","0","0","0","0","10","8","2","0","0","0","0","0","0","0","0","0","-2"
"127556","Colorado Mesa University","2010","Total full-time Instruction/research/public service, Non-tenured on tenure track, Assistant professors","43","23","20","0","0","0","0","0","0","0","0","0","1","0","1","0","0","0","37","19","18","0","0","0","5","4","1","0","0","0","-2"
"127556","Colorado Mesa University","2010","Total full-time Instruction/research/public service, Non-tenured on tenure track total","56","34","22","0","0","0","0","0","0","0","0","0","1","0","1","0","0","0","49","29","20","0","0","0","6","5","1","0","0","0","-2"
"127556","Colorado Mesa University","2010","Total full-time Instruction/research/public servicey, Non-tenured not on tenure track, Assistant professors","1","1","0","0","0","0","0","0","0","0","0","0","0","0","0","0","0","0","1","1","0","0","0","0","0","0","0","0","0","0","-2"
"127556","Colorado Mesa University","2010","Total full-time Instruction/research/public service, Non-tenured not on tenure track, Instructors","72","43","29","0","0","0","1","0","1","0","0","0","5","4","1","0","0","0","57","35","22","0","0","0","5","4","1","4","0","4","-2"
"127556","Colorado Mesa University","2010","Total full-time Instruction/research/public service, Non-tenured not on tenure track, Lecturers","1","1","0","0","0","0","0","0","0","0","0","0","0","0","0","0","0","0","1","1","0","0","0","0","0","0","0","0","0","0","-2"
"127556","Colorado Mesa University","2010","Total full-time Instruction/research/public service, Non-tenured not on tenure track, No academic rank","1","0","1","0","0","0","0","0","0","0","0","0","0","0","0","0","0","0","1","0","1","0","0","0","0","0","0","0","0","0","-2"
"127556","Colorado Mesa University","2010","Total full-time Instruction/research/public service, Non-tenured not on tenure track total","75","45","30","0","0","0","1","0","1","0","0","0","5","4","1","0","0","0","60","37","23","0","0","0","5","4","1","4","0","4","-2"
"127820","Pikes Peak Community College","2010","Total full-time Instruction/research/public service, Non-tenured not on tenure track, No academic rank","191","73","118","1","1","0","5","2","3","6","1","5","6","3","3","0","0","0","171","66","105","0","0","0","2","0","2","0","0","0","-2"
"127820","Pikes Peak Community College","2010","Total full-time Instruction/research/public service, Non-tenured not on tenure track total","191","73","118","1","1","0","5","2","3","6","1","5","6","3","3","0","0","0","171","66","105","0","0","0","2","0","2","0","0","0","-2"
"127909","Red Rocks Community College","2010","Total full-time Instruction/research/public service, Non-tenured not on tenure track, Instructors","82","33","49","1","0","1","1","0","1","0","0","0","2","1","1","0","0","0","77","32","45","0","0","0","1","0","1","0","0","0","-2"
"127909","Red Rocks Community College","2010","Total full-time Instruction/research/public service, Non-tenured not on tenure track total","82","33","49","1","0","1","1","0","1","0","0","0","2","1","1","0","0","0","77","32","45","0","0","0","1","0","1","0","0","0","-2"
"128771","Central Connecticut State University","2010","Total full-time Instruction/research/public service, Tenured, Professors","176","109","67","2","2","0","14","8","6","12","8","4","12","8","4","0","0","0","133","82","51","3","1","2","0","0","0","0","0","0","-2"
"128771","Central Connecticut State University","2010","Total full-time Instruction/research/public service, Tenured, Associate professors","105","60","45","0","0","0","6","6","0","5","3","2","5","5","0","0","0","0","88","45","43","0","0","0","0","0","0","1","1","0","-2"
"128771","Central Connecticut State University","2010","Total full-time Instruction/research/public service, Tenured, Assistant professors","15","7","8","0","0","0","0","0","0","1","0","1","0","0","0","0","0","0","14","7","7","0","0","0","0","0","0","0","0","0","-2"
"128771","Central Connecticut State University","2010","Total full-time Instruction/research/public service, Tenured total","296","176","120","2","2","0","20","14","6","18","11","7","17","13","4","0","0","0","235","134","101","3","1","2","0","0","0","1","1","0","-2"
"128771","Central Connecticut State University","2010","Total full-time Instruction/research/public service, Non-tenured on tenure track, Professors","3","2","1","0","0","0","0","0","0","0","0","0","0","0","0","0","0","0","3","2","1","0","0","0","0","0","0","0","0","0","-2"
"128771","Central Connecticut State University","2010","Total full-time Instruction/research/public service, Non-tenured on tenure track, Associate professors","12","6","6","0","0","0","1","1","0","0","0","0","0","0","0","0","0","0","11","5","6","0","0","0","0","0","0","0","0","0","-2"
"128771","Central Connecticut State University","2010","Total full-time Instruction/research/public service, Non-tenured on tenure track, Assistant professors","67","36","31","0","0","0","2","2","0","5","3","2","3","1","2","0","0","0","50","25","25","1","1","0","0","0","0","6","4","2","-2"
"128771","Central Connecticut State University","2010","Total full-time Instruction/research/public service, Non-tenured on tenure track total","82","44","38","0","0","0","3","3","0","5","3","2","3","1","2","0","0","0","64","32","32","1","1","0","0","0","0","6","4","2","-2"
"128771","Central Connecticut State University","2010","Total full-time Instruction/research/public service, Non-tenured not on tenure track, Professors","2","1","1","0","0","0","0","0","0","1","1","0","0","0","0","0","0","0","1","0","1","0","0","0","0","0","0","0","0","0","-2"
"128771","Central Connecticut State University","2010","Total full-time Instruction/research/public service, Non-tenured not on tenure track, Associate professors","3","3","0","0","0","0","0","0","0","0","0","0","0","0","0","0","0","0","3","3","0","0","0","0","0","0","0","0","0","0","-2"
"128771","Central Connecticut State University","2010","Total full-time Instruction/research/public servicey, Non-tenured not on tenure track, Assistant professors","37","23","14","0","0","0","2","2","0","3","2","1","1","0","1","0","0","0","27","16","11","0","0","0","0","0","0","4","3","1","-2"
"128771","Central Connecticut State University","2010","Total full-time Instruction/research/public service, Non-tenured not on tenure track, Instructors","20","11","9","0","0","0","0","0","0","0","0","0","0","0","0","0","0","0","16","9","7","0","0","0","0","0","0","4","2","2","-2"
"128771","Central Connecticut State University","2010","Total full-time Instruction/research/public service, Non-tenured not on tenure track total","62","38","24","0","0","0","2","2","0","4","3","1","1","0","1","0","0","0","47","28","19","0","0","0","0","0","0","8","5","3","-2"
"129154","Goodwin University","2010","Total full-time Instruction/research/public service, Non-tenured not on tenure track, Associate professors","23","7","16","0","0","0","2","0","2","0","0","0","1","0","1","0","0","0","19","7","12","1","0","1","0","0","0","0","0","0","-2"
"129154","Goodwin University","2010","Total full-time Instruction/research/public servicey, Non-tenured not on tenure track, Assistant professors","23","8","15","0","0","0","1","0","1","1","0","1","1","1","0","0","0","0","20","7","13","0","0","0","0","0","0","0","0","0","-2"
"129154","Goodwin University","2010","Total full-time Instruction/research/public service, Non-tenured not on tenure track, Instructors","2","0","2","0","0","0","0","0","0","0","0","0","1","0","1","0","0","0","1","0","1","0","0","0","0","0","0","0","0","0","-2"
"129154","Goodwin University","2010","Total full-time Instruction/research/public service, Non-tenured not on tenure track, No academic rank","4","1","3","0","0","0","0","0","0","0","0","0","0","0","0","0","0","0","4","1","3","0","0","0","0","0","0","0","0","0","-2"
"129154","Goodwin University","2010","Total full-time Instruction/research/public service, Non-tenured not on tenure track total","52","16","36","0","0","0","3","0","3","1","0","1","3","1","2","0","0","0","44","15","29","1","0","1","0","0","0","0","0","0","-2"
"129774","Mitchell College","2010","Total full-time Instruction/research/public service, Tenured, Professors","2","1","1","0","0","0","0","0","0","0","0","0","0","0","0","0","0","0","2","1","1","0","0","0","0","0","0","0","0","0","-2"
"129774","Mitchell College","2010","Total full-time Instruction/research/public service, Tenured, Associate professors","3","1","2","0","0","0","0","0","0","0","0","0","0","0","0","0","0","0","3","1","2","0","0","0","0","0","0","0","0","0","-2"
"129774","Mitchell College","2010","Total full-time Instruction/research/public service, Tenured, Assistant professors","2","1","1","0","0","0","0","0","0","0","0","0","0","0","0","0","0","0","2","1","1","0","0","0","0","0","0","0","0","0","-2"
"129774","Mitchell College","2010","Total full-time Instruction/research/public service, Tenured total","7","3","4","0","0","0","0","0","0","0","0","0","0","0","0","0","0","0","7","3","4","0","0","0","0","0","0","0","0","0","-2"
"129774","Mitchell College","2010","Total full-time Instruction/research/public service, Non-tenured not on tenure track, Professors","2","1","1","0","0","0","0","0","0","0","0","0","0","0","0","0","0","0","2","1","1","0","0","0","0","0","0","0","0","0","-2"
"129774","Mitchell College","2010","Total full-time Instruction/research/public service, Non-tenured not on tenure track, Associate professors","9","5","4","0","0","0","0","0","0","1","0","1","0","0","0","0","0","0","8","5","3","0","0","0","0","0","0","0","0","0","-2"
"129774","Mitchell College","2010","Total full-time Instruction/research/public servicey, Non-tenured not on tenure track, Assistant professors","18","9","9","0","0","0","0","0","0","1","1","0","1","0","1","0","0","0","16","8","8","0","0","0","0","0","0","0","0","0","-2"
"129774","Mitchell College","2010","Total full-time Instruction/research/public service, Non-tenured not on tenure track total","29","15","14","0","0","0","0","0","0","2","1","1","1","0","1","0","0","0","26","14","12","0","0","0","0","0","0","0","0","0","-2"
"132657","Lynn University","2010","Total full-time Instruction/research/public service, Non-tenured not on tenure track, Professors","18","12","6","1","0","1","0","0","0","0","0","0","0","0","0","0","0","0","15","11","4","0","0","0","2","1","1","0","0","0","-2"
"132657","Lynn University","2010","Total full-time Instruction/research/public service, Non-tenured not on tenure track, Associate professors","25","11","14","0","0","0","0","0","0","1","0","1","2","1","1","0","0","0","20","9","11","0","0","0","2","1","1","0","0","0","-2"
"132657","Lynn University","2010","Total full-time Instruction/research/public servicey, Non-tenured not on tenure track, Assistant professors","35","19","16","1","1","0","1","1","0","1","0","1","1","0","1","0","0","0","30","17","13","0","0","0","1","0","1","0","0","0","-2"
"132657","Lynn University","2010","Total full-time Instruction/research/public service, Non-tenured not on tenure track, Instructors","16","12","4","0","0","0","1","0","1","0","0","0","1","1","0","0","0","0","11","9","2","0","0","0","2","2","0","1","0","1","-2"
"132657","Lynn University","2010","Total full-time Instruction/research/public service, Non-tenured not on tenure track total","94","54","40","2","1","1","2","1","1","2","0","2","4","2","2","0","0","0","76","46","30","0","0","0","7","4","3","1","0","1","-2"
"132693","Eastern Florida State College","2010","Total full-time Instruction/research/public service, Tenured, Professors","48","29","19","0","0","0","6","3","3","1","1","0","1","1","0","0","0","0","39","23","16","1","1","0","0","0","0","0","0","0","-2"
"132693","Eastern Florida State College","2010","Total full-time Instruction/research/public service, Tenured, Associate professors","50","20","30","0","0","0","1","1","0","5","2","3","1","0","1","0","0","0","43","17","26","0","0","0","0","0","0","0","0","0","-2"
"132693","Eastern Florida State College","2010","Total full-time Instruction/research/public service, Tenured, Assistant professors","65","22","43","0","0","0","2","1","1","2","0","2","2","0","2","0","0","0","57","21","36","2","0","2","0","0","0","0","0","0","-2"
"132693","Eastern Florida State College","2010","Total full-time Instruction/research/public service, Tenured, Instructors","13","2","11","0","0","0","0","0","0","0","0","0","0","0","0","0","0","0","13","2","11","0","0","0","0","0","0","0","0","0","-2"
"132693","Eastern Florida State College","2010","Total full-time Instruction/research/public service, Tenured total","176","73","103","0","0","0","9","5","4","8","3","5","4","1","3","0","0","0","152","63","89","3","1","2","0","0","0","0","0","0","-2"
"132693","Eastern Florida State College","2010","Total full-time Instruction/research/public service, Non-tenured on tenure track, Professors","2","0","2","0","0","0","0","0","0","1","0","1","0","0","0","0","0","0","1","0","1","0","0","0","0","0","0","0","0","0","-2"
"132693","Eastern Florida State College","2010","Total full-time Instruction/research/public service, Non-tenured on tenure track, Assistant professors","16","5","11","0","0","0","2","0","2","1","1","0","0","0","0","0","0","0","13","4","9","0","0","0","0","0","0","0","0","0","-2"
"132693","Eastern Florida State College","2010","Total full-time Instruction/research/public service, Non-tenured on tenure track, Instructors","36","13","23","0","0","0","0","0","0","3","0","3","1","1","0","0","0","0","32","12","20","0","0","0","0","0","0","0","0","0","-2"
"132693","Eastern Florida State College","2010","Total full-time Instruction/research/public service, Non-tenured on tenure track total","54","18","36","0","0","0","2","0","2","5","1","4","1","1","0","0","0","0","46","16","30","0","0","0","0","0","0","0","0","0","-2"
"132693","Eastern Florida State College","2010","Total full-time Instruction/research/public service, Non-tenured not on tenure track, Professors","1","1","0","0","0","0","0","0","0","0","0","0","0","0","0","0","0","0","1","1","0","0","0","0","0","0","0","0","0","0","-2"
"132693","Eastern Florida State College","2010","Total full-time Instruction/research/public service, Non-tenured not on tenure track, Instructors","12","7","5","0","0","0","0","0","0","2","2","0","1","1","0","0","0","0","9","4","5","0","0","0","0","0","0","0","0","0","-2"
"132693","Eastern Florida State College","2010","Total full-time Instruction/research/public service, Non-tenured not on tenure track total","13","8","5","0","0","0","0","0","0","2","2","0","1","1","0","0","0","0","10","5","5","0","0","0","0","0","0","0","0","0","-2"
"132879","Johnson University Florida","2010","Total full-time Instruction/research/public service, Non-tenured not on tenure track, Professors","3","1","2","0","0","0","1","0","1","0","0","0","0","0","0","0","0","0","2","1","1","0","0","0","0","0","0","0","0","0","-2"
"132879","Johnson University Florida","2010","Total full-time Instruction/research/public service, Non-tenured not on tenure track, Associate professors","9","8","1","0","0","0","0","0","0","0","0","0","0","0","0","0","0","0","9","8","1","0","0","0","0","0","0","0","0","0","-2"
"132879","Johnson University Florida","2010","Total full-time Instruction/research/public service, Non-tenured not on tenure track total","12","9","3","0","0","0","1","0","1","0","0","0","0","0","0","0","0","0","11","9","2","0","0","0","0","0","0","0","0","0","-2"
"133386","Daytona State College","2010","Total full-time Instruction/research/public service, Tenured, Professors","92","45","47","0","0","0","4","3","1","9","2","7","1","0","1","0","0","0","76","39","37","0","0","0","2","1","1","0","0","0","-2"
"133386","Daytona State College","2010","Total full-time Instruction/research/public service, Tenured, Associate professors","82","44","38","1","0","1","3","3","0","5","3","2","0","0","0","0","0","0","70","36","34","0","0","0","3","2","1","0","0","0","-2"
"133386","Daytona State College","2010","Total full-time Instruction/research/public service, Tenured, Assistant professors","27","19","8","0","0","0","0","0","0","2","2","0","0","0","0","0","0","0","22","14","8","0","0","0","3","3","0","0","0","0","-2"
"133386","Daytona State College","2010","Total full-time Instruction/research/public service, Tenured, Instructors","2","2","0","0","0","0","0","0","0","1","1","0","0","0","0","0","0","0","1","1","0","0","0","0","0","0","0","0","0","0","-2"
"133386","Daytona State College","2010","Total full-time Instruction/research/public service, Tenured total","203","110","93","1","0","1","7","6","1","17","8","9","1","0","1","0","0","0","169","90","79","0","0","0","8","6","2","0","0","0","-2"
"133386","Daytona State College","2010","Total full-time Instruction/research/public service, Non-tenured on tenure track, Professors","2","1","1","0","0","0","0","0","0","0","0","0","0","0","0","0","0","0","2","1","1","0","0","0","0","0","0","0","0","0","-2"
"133386","Daytona State College","2010","Total full-time Instruction/research/public service, Non-tenured on tenure track, Associate professors","39","17","22","0","0","0","2","1","1","3","2","1","2","1","1","0","0","0","29","11","18","0","0","0","1","0","1","2","2","0","-2"
"133386","Daytona State College","2010","Total full-time Instruction/research/public service, Non-tenured on tenure track, Assistant professors","39","20","19","0","0","0","1","0","1","1","1","0","2","2","0","0","0","0","28","14","14","0","0","0","5","2","3","2","1","1","-2"
"133386","Daytona State College","2010","Total full-time Instruction/research/public service, Non-tenured on tenure track, Instructors","14","8","6","0","0","0","0","0","0","0","0","0","1","1","0","0","0","0","12","6","6","0","0","0","1","1","0","0","0","0","-2"
"133386","Daytona State College","2010","Total full-time Instruction/research/public service, Non-tenured on tenure track total","94","46","48","0","0","0","3","1","2","4","3","1","5","4","1","0","0","0","71","32","39","0","0","0","7","3","4","4","3","1","-2"
"133386","Daytona State College","2010","Total full-time Instruction/research/public service, Non-tenured not on tenure track, Professors","1","0","1","0","0","0","0","0","0","0","0","0","0","0","0","0","0","0","1","0","1","0","0","0","0","0","0","0","0","0","-2"
"133386","Daytona State College","2010","Total full-time Instruction/research/public service, Non-tenured not on tenure track, Associate professors","1","0","1","0","0","0","0","0","0","0","0","0","0","0","0","0","0","0","0","0","0","0","0","0","0","0","0","1","0","1","-2"
"133386","Daytona State College","2010","Total full-time Instruction/research/public servicey, Non-tenured not on tenure track, Assistant professors","1","1","0","0","0","0","0","0","0","0","0","0","0","0","0","0","0","0","1","1","0","0","0","0","0","0","0","0","0","0","-2"
"133386","Daytona State College","2010","Total full-time Instruction/research/public service, Non-tenured not on tenure track, Instructors","7","1","6","0","0","0","0","0","0","1","0","1","0","0","0","0","0","0","6","1","5","0","0","0","0","0","0","0","0","0","-2"
"133386","Daytona State College","2010","Total full-time Instruction/research/public service, Non-tenured not on tenure track total","10","2","8","0","0","0","0","0","0","1","0","1","0","0","0","0","0","0","8","2","6","0","0","0","0","0","0","1","0","1","-2"
"134130","University of Florida","2010","Total full-time Instruction/research/public service, Tenured, Professors","1005","820","185","0","0","0","89","77","12","18","10","8","32","27","5","0","0","0","858","698","160","5","5","0","3","3","0","0","0","0","-2"
"134130","University of Florida","2010","Total full-time Instruction/research/public service, Tenured, Associate professors","681","461","220","0","0","0","74","60","14","31","12","19","42","31","11","0","0","0","525","351","174","5","4","1","4","3","1","0","0","0","-2"
"134130","University of Florida","2010","Total full-time Instruction/research/public service, Tenured, Assistant professors","10","7","3","0","0","0","1","1","0","1","0","1","0","0","0","0","0","0","8","6","2","0","0","0","0","0","0","0","0","0","-2"
"134130","University of Florida","2010","Total full-time Instruction/research/public service, Tenured, Lecturers","1","1","0","0","0","0","0","0","0","0","0","0","0","0","0","0","0","0","1","1","0","0","0","0","0","0","0","0","0","0","-2"
"134130","University of Florida","2010","Total full-time Instruction/research/public service, Tenured, No academic rank","150","53","97","0","0","0","1","0","1","14","6","8","6","3","3","0","0","0","129","44","85","0","0","0","0","0","0","0","0","0","-2"
"134130","University of Florida","2010","Total full-time Instruction/research/public service, Tenured total","1847","1342","505","0","0","0","165","138","27","64","28","36","80","61","19","0","0","0","1521","1100","421","10","9","1","7","6","1","0","0","0","-2"
"134130","University of Florida","2010","Total full-time Instruction/research/public service, Non-tenured on tenure track, Professors","22","18","4","0","0","0","5","5","0","1","0","1","0","0","0","0","0","0","16","13","3","0","0","0","0","0","0","0","0","0","-2"
"134130","University of Florida","2010","Total full-time Instruction/research/public service, Non-tenured on tenure track, Associate professors","65","42","23","0","0","0","14","9","5","3","2","1","6","4","2","0","0","0","41","27","14","1","0","1","0","0","0","0","0","0","-2"
"134130","University of Florida","2010","Total full-time Instruction/research/public service, Non-tenured on tenure track, Assistant professors","487","323","164","1","1","0","91","61","30","25","16","9","40","24","16","1","1","0","312","205","107","8","7","1","8","7","1","1","1","0","-2"
"134130","University of Florida","2010","Total full-time Instruction/research/public service, Non-tenured on tenure track, Lecturers","1","0","1","0","0","0","0","0","0","0","0","0","0","0","0","0","0","0","1","0","1","0","0","0","0","0","0","0","0","0","-2"
"134130","University of Florida","2010","Total full-time Instruction/research/public service, Non-tenured on tenure track, No academic rank","138","48","90","2","1","1","5","1","4","5","2","3","7","1","6","0","0","0","115","41","74","0","0","0","4","2","2","0","0","0","-2"
"134130","University of Florida","2010","Total full-time Instruction/research/public service, Non-tenured on tenure track total","713","431","282","3","2","1","115","76","39","34","20","14","53","29","24","1","1","0","485","286","199","9","7","2","12","9","3","1","1","0","-2"
"134130","University of Florida","2010","Total full-time Instruction/research/public service, Non-tenured not on tenure track, Professors","89","66","23","0","0","0","7","2","5","1","1","0","4","4","0","0","0","0","74","57","17","1","1","0","1","1","0","1","0","1","-2"
"134130","University of Florida","2010","Total full-time Instruction/research/public service, Non-tenured not on tenure track, Associate professors","217","149","68","1","1","0","30","23","7","3","3","0","20","15","5","0","0","0","158","104","54","1","1","0","3","1","2","1","1","0","-2"
"134130","University of Florida","2010","Total full-time Instruction/research/public servicey, Non-tenured not on tenure track, Assistant professors","842","451","391","2","2","0","207","130","77","31","12","19","66","29","37","1","1","0","516","266","250","9","4","5","9","6","3","1","1","0","-2"
"134130","University of Florida","2010","Total full-time Instruction/research/public service, Non-tenured not on tenure track, Lecturers","257","116","141","1","1","0","21","7","14","11","3","8","18","6","12","0","0","0","205","99","106","0","0","0","0","0","0","1","0","1","-2"
"134130","University of Florida","2010","Total full-time Instruction/research/public service, Non-tenured not on tenure track, No academic rank","250","122","128","1","0","1","26","17","9","13","6","7","15","9","6","0","0","0","181","83","98","2","1","1","7","4","3","5","2","3","-2"
"134130","University of Florida","2010","Total full-time Instruction/research/public service, Non-tenured not on tenure track total","1655","904","751","5","4","1","291","179","112","59","25","34","123","63","60","1","1","0","1134","609","525","13","7","6","20","12","8","9","4","5","-2"
"135188","Lake-Sumter State College","2010","Total full-time Instruction/research/public service, Tenured, Professors","10","5","5","0","0","0","0","0","0","1","0","1","0","0","0","0","0","0","8","5","3","0","0","0","0","0","0","1","0","1","-2"
"135188","Lake-Sumter State College","2010","Total full-time Instruction/research/public service, Tenured, Associate professors","11","4","7","0","0","0","0","0","0","0","0","0","0","0","0","0","0","0","11","4","7","0","0","0","0","0","0","0","0","0","-2"
"135188","Lake-Sumter State College","2010","Total full-time Instruction/research/public service, Tenured, Assistant professors","8","1","7","0","0","0","0","0","0","0","0","0","0","0","0","0","0","0","8","1","7","0","0","0","0","0","0","0","0","0","-2"
"135188","Lake-Sumter State College","2010","Total full-time Instruction/research/public service, Tenured, Instructors","9","0","9","0","0","0","0","0","0","1","0","1","0","0","0","0","0","0","8","0","8","0","0","0","0","0","0","0","0","0","-2"
"135188","Lake-Sumter State College","2010","Total full-time Instruction/research/public service, Tenured total","38","10","28","0","0","0","0","0","0","2","0","2","0","0","0","0","0","0","35","10","25","0","0","0","0","0","0","1","0","1","-2"
"135188","Lake-Sumter State College","2010","Total full-time Instruction/research/public service, Non-tenured on tenure track, Instructors","39","15","24","1","1","0","0","0","0","1","0","1","1","1","0","0","0","0","36","13","23","0","0","0","0","0","0","0","0","0","-2"
"135188","Lake-Sumter State College","2010","Total full-time Instruction/research/public service, Non-tenured on tenure track total","39","15","24","1","1","0","0","0","0","1","0","1","1","1","0","0","0","0","36","13","23","0","0","0","0","0","0","0","0","0","-2"
"135188","Lake-Sumter State College","2010","Total full-time Instruction/research/public service, Non-tenured not on tenure track, Instructors","6","4","2","0","0","0","0","0","0","0","0","0","0","0","0","0","0","0","6","4","2","0","0","0","0","0","0","0","0","0","-2"
"135188","Lake-Sumter State College","2010","Total full-time Instruction/research/public service, Non-tenured not on tenure track, No academic rank","1","0","1","0","0","0","0","0","0","0","0","0","0","0","0","0","0","0","1","0","1","0","0","0","0","0","0","0","0","0","-2"
"135188","Lake-Sumter State College","2010","Total full-time Instruction/research/public service, Non-tenured not on tenure track total","7","4","3","0","0","0","0","0","0","0","0","0","0","0","0","0","0","0","7","4","3","0","0","0","0","0","0","0","0","0","-2"
"135391","State College of Florida-Manatee-Sarasota","2010","Total full-time Instruction/research/public service, Tenured, Professors","31","14","17","0","0","0","1","1","0","3","2","1","0","0","0","0","0","0","27","11","16","0","0","0","0","0","0","0","0","0","-2"
"135391","State College of Florida-Manatee-Sarasota","2010","Total full-time Instruction/research/public service, Tenured, Associate professors","28","6","22","0","0","0","1","1","0","0","0","0","2","0","2","0","0","0","24","5","19","0","0","0","1","0","1","0","0","0","-2"
"135391","State College of Florida-Manatee-Sarasota","2010","Total full-time Instruction/research/public service, Tenured, Assistant professors","25","11","14","0","0","0","0","0","0","2","2","0","2","1","1","0","0","0","21","8","13","0","0","0","0","0","0","0","0","0","-2"
"135391","State College of Florida-Manatee-Sarasota","2010","Total full-time Instruction/research/public service, Tenured, Instructors","7","3","4","0","0","0","0","0","0","1","0","1","0","0","0","0","0","0","6","3","3","0","0","0","0","0","0","0","0","0","-2"
"135391","State College of Florida-Manatee-Sarasota","2010","Total full-time Instruction/research/public service, Tenured total","91","34","57","0","0","0","2","2","0","6","4","2","4","1","3","0","0","0","78","27","51","0","0","0","1","0","1","0","0","0","-2"
"135391","State College of Florida-Manatee-Sarasota","2010","Total full-time Instruction/research/public service, Non-tenured on tenure track, Assistant professors","13","4","9","0","0","0","1","1","0","0","0","0","1","1","0","0","0","0","11","2","9","0","0","0","0","0","0","0","0","0","-2"
"135391","State College of Florida-Manatee-Sarasota","2010","Total full-time Instruction/research/public service, Non-tenured on tenure track, Instructors","19","7","12","0","0","0","0","0","0","0","0","0","1","0","1","0","0","0","17","6","11","0","0","0","0","0","0","1","1","0","-2"
"135391","State College of Florida-Manatee-Sarasota","2010","Total full-time Instruction/research/public service, Non-tenured on tenure track, Lecturers","1","0","1","0","0","0","0","0","0","0","0","0","0","0","0","0","0","0","1","0","1","0","0","0","0","0","0","0","0","0","-2"
"135391","State College of Florida-Manatee-Sarasota","2010","Total full-time Instruction/research/public service, Non-tenured on tenure track total","33","11","22","0","0","0","1","1","0","0","0","0","2","1","1","0","0","0","29","8","21","0","0","0","0","0","0","1","1","0","-2"
"135391","State College of Florida-Manatee-Sarasota","2010","Total full-time Instruction/research/public service, Non-tenured not on tenure track, Instructors","9","4","5","0","0","0","0","0","0","0","0","0","0","0","0","0","0","0","9","4","5","0","0","0","0","0","0","0","0","0","-2"
"135391","State College of Florida-Manatee-Sarasota","2010","Total full-time Instruction/research/public service, Non-tenured not on tenure track total","9","4","5","0","0","0","0","0","0","0","0","0","0","0","0","0","0","0","9","4","5","0","0","0","0","0","0","0","0","0","-2"
"136400","Pasco-Hernando State College","2010","Total full-time Instruction/research/public service, Tenured, Professors","28","8","20","0","0","0","0","0","0","2","1","1","1","1","0","0","0","0","24","6","18","0","0","0","1","0","1","0","0","0","-2"
"136400","Pasco-Hernando State College","2010","Total full-time Instruction/research/public service, Tenured, Associate professors","20","1","19","0","0","0","0","0","0","1","0","1","0","0","0","0","0","0","19","1","18","0","0","0","0","0","0","0","0","0","-2"
"136400","Pasco-Hernando State College","2010","Total full-time Instruction/research/public service, Tenured, Assistant professors","20","8","12","0","0","0","0","0","0","5","2","3","1","0","1","1","0","1","13","6","7","0","0","0","0","0","0","0","0","0","-2"
"136400","Pasco-Hernando State College","2010","Total full-time Instruction/research/public service, Tenured, Instructors","9","3","6","0","0","0","0","0","0","0","0","0","0","0","0","0","0","0","9","3","6","0","0","0","0","0","0","0","0","0","-2"
"136400","Pasco-Hernando State College","2010","Total full-time Instruction/research/public service, Tenured total","77","20","57","0","0","0","0","0","0","8","3","5","2","1","1","1","0","1","65","16","49","0","0","0","1","0","1","0","0","0","-2"
"136400","Pasco-Hernando State College","2010","Total full-time Instruction/research/public service, Non-tenured on tenure track, Professors","1","1","0","0","0","0","0","0","0","0","0","0","0","0","0","0","0","0","1","1","0","0","0","0","0","0","0","0","0","0","-2"
"136400","Pasco-Hernando State College","2010","Total full-time Instruction/research/public service, Non-tenured on tenure track, Assistant professors","4","3","1","0","0","0","0","0","0","0","0","0","1","1","0","0","0","0","3","2","1","0","0","0","0","0","0","0","0","0","-2"
"136400","Pasco-Hernando State College","2010","Total full-time Instruction/research/public service, Non-tenured on tenure track, Instructors","28","8","20","0","0","0","0","0","0","0","0","0","1","0","1","0","0","0","26","7","19","0","0","0","1","1","0","0","0","0","-2"
"136400","Pasco-Hernando State College","2010","Total full-time Instruction/research/public service, Non-tenured on tenure track total","33","12","21","0","0","0","0","0","0","0","0","0","2","1","1","0","0","0","30","10","20","0","0","0","1","1","0","0","0","0","-2"
"136400","Pasco-Hernando State College","2010","Total full-time Instruction/research/public service, Non-tenured not on tenure track, Instructors","2","0","2","0","0","0","0","0","0","0","0","0","0","0","0","0","0","0","2","0","2","0","0","0","0","0","0","0","0","0","-2"
"136400","Pasco-Hernando State College","2010","Total full-time Instruction/research/public service, Non-tenured not on tenure track, No academic rank","6","4","2","0","0","0","0","0","0","0","0","0","0","0","0","0","0","0","6","4","2","0","0","0","0","0","0","0","0","0","-2"
"136400","Pasco-Hernando State College","2010","Total full-time Instruction/research/public service, Non-tenured not on tenure track total","8","4","4","0","0","0","0","0","0","0","0","0","0","0","0","0","0","0","8","4","4","0","0","0","0","0","0","0","0","0","-2"
"136774","Ringling College of Art and Design","2010","Total full-time Instruction/research/public service, Non-tenured not on tenure track, No academic rank","88","61","27","0","0","0","1","1","0","1","1","0","2","1","1","0","0","0","83","58","25","0","0","0","0","0","0","1","0","1","-2"
"136774","Ringling College of Art and Design","2010","Total full-time Instruction/research/public service, Non-tenured not on tenure track total","88","61","27","0","0","0","1","1","0","1","1","0","2","1","1","0","0","0","83","58","25","0","0","0","0","0","0","1","0","1","-2"
"136950","Rollins College","2010","Total full-time Instruction/research/public service, Tenured, Professors","74","53","21","0","0","0","0","0","0","0","0","0","3","2","1","0","0","0","70","50","20","0","0","0","1","1","0","0","0","0","-2"
"136950","Rollins College","2010","Total full-time Instruction/research/public service, Tenured, Associate professors","41","24","17","0","0","0","3","1","2","1","1","0","2","1","1","0","0","0","35","21","14","0","0","0","0","0","0","0","0","0","-2"
"136950","Rollins College","2010","Total full-time Instruction/research/public service, Tenured total","115","77","38","0","0","0","3","1","2","1","1","0","5","3","2","0","0","0","105","71","34","0","0","0","1","1","0","0","0","0","-2"
"136950","Rollins College","2010","Total full-time Instruction/research/public service, Non-tenured on tenure track, Professors","3","3","0","0","0","0","0","0","0","0","0","0","0","0","0","0","0","0","3","3","0","0","0","0","0","0","0","0","0","0","-2"
"136950","Rollins College","2010","Total full-time Instruction/research/public service, Non-tenured on tenure track, Associate professors","7","4","3","0","0","0","0","0","0","2","2","0","0","0","0","0","0","0","4","2","2","0","0","0","1","0","1","0","0","0","-2"
"136950","Rollins College","2010","Total full-time Instruction/research/public service, Non-tenured on tenure track, Assistant professors","31","13","18","0","0","0","2","1","1","1","1","0","2","2","0","0","0","0","21","8","13","0","0","0","3","1","2","2","0","2","-2"
"136950","Rollins College","2010","Total full-time Instruction/research/public service, Non-tenured on tenure track total","41","20","21","0","0","0","2","1","1","3","3","0","2","2","0","0","0","0","28","13","15","0","0","0","4","1","3","2","0","2","-2"
"136950","Rollins College","2010","Total full-time Instruction/research/public service, Non-tenured not on tenure track, Professors","1","0","1","0","0","0","0","0","0","0","0","0","0","0","0","0","0","0","1","0","1","0","0","0","0","0","0","0","0","0","-2"
"136950","Rollins College","2010","Total full-time Instruction/research/public service, Non-tenured not on tenure track, Associate professors","1","1","0","0","0","0","0","0","0","0","0","0","0","0","0","0","0","0","1","1","0","0","0","0","0","0","0","0","0","0","-2"
"136950","Rollins College","2010","Total full-time Instruction/research/public servicey, Non-tenured not on tenure track, Assistant professors","16","7","9","0","0","0","0","0","0","0","0","0","0","0","0","0","0","0","14","6","8","0","0","0","2","1","1","0","0","0","-2"
"136950","Rollins College","2010","Total full-time Instruction/research/public service, Non-tenured not on tenure track, Instructors","2","1","1","0","0","0","0","0","0","0","0","0","0","0","0","0","0","0","0","0","0","0","0","0","0","0","0","2","1","1","-2"
"136950","Rollins College","2010","Total full-time Instruction/research/public service, Non-tenured not on tenure track, Lecturers","24","13","11","0","0","0","1","1","0","0","0","0","3","1","2","0","0","0","20","11","9","0","0","0","0","0","0","0","0","0","-2"
"136950","Rollins College","2010","Total full-time Instruction/research/public service, Non-tenured not on tenure track total","44","22","22","0","0","0","1","1","0","0","0","0","3","1","2","0","0","0","36","18","18","0","0","0","2","1","1","2","1","1","-2"
"137078","St Petersburg College","2010","Total full-time Instruction/research/public service, Tenured, No academic rank","224","102","122","1","1","0","6","4","2","18","10","8","11","3","8","0","0","0","181","79","102","7","5","2","0","0","0","0","0","0","-2"
"137078","St Petersburg College","2010","Total full-time Instruction/research/public service, Tenured total","224","102","122","1","1","0","6","4","2","18","10","8","11","3","8","0","0","0","181","79","102","7","5","2","0","0","0","0","0","0","-2"
"137078","St Petersburg College","2010","Total full-time Instruction/research/public service, Non-tenured on tenure track, No academic rank","100","41","59","0","0","0","1","1","0","10","3","7","4","0","4","0","0","0","82","37","45","2","0","2","1","0","1","0","0","0","-2"
"137078","St Petersburg College","2010","Total full-time Instruction/research/public service, Non-tenured on tenure track total","100","41","59","0","0","0","1","1","0","10","3","7","4","0","4","0","0","0","82","37","45","2","0","2","1","0","1","0","0","0","-2"
"137078","St Petersburg College","2010","Total full-time Instruction/research/public service, Non-tenured not on tenure track, No academic rank","1","0","1","0","0","0","0","0","0","1","0","1","0","0","0","0","0","0","0","0","0","0","0","0","0","0","0","0","0","0","-2"
"137078","St Petersburg College","2010","Total full-time Instruction/research/public service, Non-tenured not on tenure track total","1","0","1","0","0","0","0","0","0","1","0","1","0","0","0","0","0","0","0","0","0","0","0","0","0","0","0","0","0","0","-2"
"137096","Santa Fe College","2010","Total full-time Instruction/research/public service, Tenured, No academic rank","201","92","109","0","0","0","3","2","1","13","5","8","9","2","7","0","0","0","174","81","93","0","0","0","2","2","0","0","0","0","-2"
"137096","Santa Fe College","2010","Total full-time Instruction/research/public service, Tenured total","201","92","109","0","0","0","3","2","1","13","5","8","9","2","7","0","0","0","174","81","93","0","0","0","2","2","0","0","0","0","-2"
"137096","Santa Fe College","2010","Total full-time Instruction/research/public service, Non-tenured on tenure track, No academic rank","29","9","20","1","0","1","2","1","1","2","1","1","3","2","1","0","0","0","21","5","16","0","0","0","0","0","0","0","0","0","-2"
"137096","Santa Fe College","2010","Total full-time Instruction/research/public service, Non-tenured on tenure track total","29","9","20","1","0","1","2","1","1","2","1","1","3","2","1","0","0","0","21","5","16","0","0","0","0","0","0","0","0","0","-2"
"137564","Southeastern University","2010","Total full-time Instruction/research/public service, Tenured, Professors","4","4","0","0","0","0","0","0","0","0","0","0","0","0","0","0","0","0","4","4","0","0","0","0","0","0","0","0","0","0","-2"
"137564","Southeastern University","2010","Total full-time Instruction/research/public service, Tenured, Associate professors","1","1","0","0","0","0","0","0","0","0","0","0","0","0","0","0","0","0","1","1","0","0","0","0","0","0","0","0","0","0","-2"
"137564","Southeastern University","2010","Total full-time Instruction/research/public service, Tenured total","5","5","0","0","0","0","0","0","0","0","0","0","0","0","0","0","0","0","5","5","0","0","0","0","0","0","0","0","0","0","-2"
"137564","Southeastern University","2010","Total full-time Instruction/research/public service, Non-tenured not on tenure track, Professors","14","12","2","0","0","0","0","0","0","0","0","0","0","0","0","0","0","0","14","12","2","0","0","0","0","0","0","0","0","0","-2"
"137564","Southeastern University","2010","Total full-time Instruction/research/public service, Non-tenured not on tenure track, Associate professors","32","22","10","0","0","0","1","0","1","4","3","1","1","0","1","0","0","0","25","18","7","0","0","0","0","0","0","1","1","0","-2"
"137564","Southeastern University","2010","Total full-time Instruction/research/public servicey, Non-tenured not on tenure track, Assistant professors","46","28","18","0","0","0","3","1","2","3","1","2","2","0","2","0","0","0","37","26","11","0","0","0","0","0","0","1","0","1","-2"
"137564","Southeastern University","2010","Total full-time Instruction/research/public service, Non-tenured not on tenure track total","92","62","30","0","0","0","4","1","3","7","4","3","3","0","3","0","0","0","76","56","20","0","0","0","0","0","0","2","1","1","-2"
"137962","Trinity College of Florida","2010","Total full-time Instruction/research/public service, Non-tenured on tenure track, Professors","2","2","0","0","0","0","0","0","0","0","0","0","0","0","0","0","0","0","2","2","0","0","0","0","0","0","0","0","0","0","-2"
"137962","Trinity College of Florida","2010","Total full-time Instruction/research/public service, Non-tenured on tenure track, Associate professors","2","2","0","0","0","0","0","0","0","0","0","0","0","0","0","0","0","0","2","2","0","0","0","0","0","0","0","0","0","0","-2"
"137962","Trinity College of Florida","2010","Total full-time Instruction/research/public service, Non-tenured on tenure track, Assistant professors","3","1","2","0","0","0","0","0","0","0","0","0","0","0","0","0","0","0","3","1","2","0","0","0","0","0","0","0","0","0","-2"
"137962","Trinity College of Florida","2010","Total full-time Instruction/research/public service, Non-tenured on tenure track total","7","5","2","0","0","0","0","0","0","0","0","0","0","0","0","0","0","0","7","5","2","0","0","0","0","0","0","0","0","0","-2"
"139700","Georgia Highlands College","2010","Total full-time Instruction/research/public service, Tenured, Professors","17","11","6","0","0","0","2","1","1","0","0","0","0","0","0","0","0","0","15","10","5","0","0","0","0","0","0","0","0","0","-2"
"139700","Georgia Highlands College","2010","Total full-time Instruction/research/public service, Tenured, Associate professors","19","5","14","0","0","0","0","0","0","0","0","0","1","0","1","0","0","0","18","5","13","0","0","0","0","0","0","0","0","0","-2"
"139700","Georgia Highlands College","2010","Total full-time Instruction/research/public service, Tenured, Assistant professors","11","6","5","0","0","0","0","0","0","1","0","1","0","0","0","0","0","0","10","6","4","0","0","0","0","0","0","0","0","0","-2"
"139700","Georgia Highlands College","2010","Total full-time Instruction/research/public service, Tenured total","47","22","25","0","0","0","2","1","1","1","0","1","1","0","1","0","0","0","43","21","22","0","0","0","0","0","0","0","0","0","-2"
"139700","Georgia Highlands College","2010","Total full-time Instruction/research/public service, Non-tenured on tenure track, Associate professors","3","1","2","0","0","0","0","0","0","1","0","1","0","0","0","0","0","0","2","1","1","0","0","0","0","0","0","0","0","0","-2"
"139700","Georgia Highlands College","2010","Total full-time Instruction/research/public service, Non-tenured on tenure track, Assistant professors","20","7","13","0","0","0","1","0","1","0","0","0","0","0","0","0","0","0","19","7","12","0","0","0","0","0","0","0","0","0","-2"
"139700","Georgia Highlands College","2010","Total full-time Instruction/research/public service, Non-tenured on tenure track, Instructors","45","19","26","0","0","0","1","1","0","3","2","1","0","0","0","0","0","0","41","16","25","0","0","0","0","0","0","0","0","0","-2"
"139700","Georgia Highlands College","2010","Total full-time Instruction/research/public service, Non-tenured on tenure track total","68","27","41","0","0","0","2","1","1","4","2","2","0","0","0","0","0","0","62","24","38","0","0","0","0","0","0","0","0","0","-2"
"139700","Georgia Highlands College","2010","Total full-time Instruction/research/public service, Non-tenured not on tenure track, Lecturers","18","6","12","0","0","0","1","1","0","1","1","0","1","0","1","0","0","0","15","4","11","0","0","0","0","0","0","0","0","0","-2"
"139700","Georgia Highlands College","2010","Total full-time Instruction/research/public service, Non-tenured not on tenure track, No academic rank","8","4","4","0","0","0","0","0","0","0","0","0","0","0","0","0","0","0","8","4","4","0","0","0","0","0","0","0","0","0","-2"
"139700","Georgia Highlands College","2010","Total full-time Instruction/research/public service, Non-tenured not on tenure track total","26","10","16","0","0","0","1","1","0","1","1","0","1","0","1","0","0","0","23","8","15","0","0","0","0","0","0","0","0","0","-2"
"142559","College of Southern Idaho","2010","Total full-time Instruction/research/public service, Non-tenured not on tenure track, Professors","48","30","18","0","0","0","0","0","0","0","0","0","1","0","1","0","0","0","47","30","17","0","0","0","0","0","0","0","0","0","-2"
"142559","College of Southern Idaho","2010","Total full-time Instruction/research/public service, Non-tenured not on tenure track, Associate professors","41","19","22","0","0","0","0","0","0","0","0","0","1","1","0","0","0","0","40","18","22","0","0","0","0","0","0","0","0","0","-2"
"142559","College of Southern Idaho","2010","Total full-time Instruction/research/public servicey, Non-tenured not on tenure track, Assistant professors","36","17","19","0","0","0","1","0","1","0","0","0","1","0","1","0","0","0","33","17","16","1","0","1","0","0","0","0","0","0","-2"
"142559","College of Southern Idaho","2010","Total full-time Instruction/research/public service, Non-tenured not on tenure track, Instructors","45","16","29","1","0","1","0","0","0","0","0","0","0","0","0","0","0","0","44","16","28","0","0","0","0","0","0","0","0","0","-2"
"142559","College of Southern Idaho","2010","Total full-time Instruction/research/public service, Non-tenured not on tenure track total","170","82","88","1","0","1","1","0","1","0","0","0","3","1","2","0","0","0","164","81","83","1","0","1","0","0","0","0","0","0","-2"
"144281","Columbia College Chicago","2010","Total full-time Instruction/research/public service, Tenured, Professors","236","133","103","0","0","0","8","4","4","28","10","18","12","8","4","0","0","0","187","110","77","0","0","0","1","1","0","0","0","0","-2"
"144281","Columbia College Chicago","2010","Total full-time Instruction/research/public service, Tenured total","236","133","103","0","0","0","8","4","4","28","10","18","12","8","4","0","0","0","187","110","77","0","0","0","1","1","0","0","0","0","-2"
"144281","Columbia College Chicago","2010","Total full-time Instruction/research/public service, Non-tenured on tenure track, Professors","68","30","38","0","0","0","1","0","1","6","3","3","3","1","2","0","0","0","56","25","31","0","0","0","2","1","1","0","0","0","-2"
"144281","Columbia College Chicago","2010","Total full-time Instruction/research/public service, Non-tenured on tenure track total","68","30","38","0","0","0","1","0","1","6","3","3","3","1","2","0","0","0","56","25","31","0","0","0","2","1","1","0","0","0","-2"
"144281","Columbia College Chicago","2010","Total full-time Instruction/research/public service, Non-tenured not on tenure track, Lecturers","60","32","28","0","0","0","1","1","0","2","1","1","1","0","1","0","0","0","52","29","23","0","0","0","3","0","3","1","1","0","-2"
"144281","Columbia College Chicago","2010","Total full-time Instruction/research/public service, Non-tenured not on tenure track total","60","32","28","0","0","0","1","1","0","2","1","1","1","0","1","0","0","0","52","29","23","0","0","0","3","0","3","1","1","0","-2"
"144740","DePaul University","2010","Total full-time Instruction/research/public service, Tenured, Professors","203","128","75","0","0","0","10","6","4","8","4","4","10","5","5","0","0","0","164","106","58","1","1","0","8","4","4","2","2","0","-2"
"144740","DePaul University","2010","Total full-time Instruction/research/public service, Tenured, Associate professors","339","194","145","0","0","0","17","9","8","27","15","12","16","7","9","0","0","0","232","134","98","1","1","0","15","7","8","31","21","10","-2"
"144740","DePaul University","2010","Total full-time Instruction/research/public service, Tenured, Assistant professors","5","5","0","0","0","0","0","0","0","1","1","0","0","0","0","0","0","0","3","3","0","0","0","0","1","1","0","0","0","0","-2"
"144740","DePaul University","2010","Total full-time Instruction/research/public service, Tenured total","547","327","220","0","0","0","27","15","12","36","20","16","26","12","14","0","0","0","399","243","156","2","2","0","24","12","12","33","23","10","-2"
"144740","DePaul University","2010","Total full-time Instruction/research/public service, Non-tenured on tenure track, Associate professors","14","6","8","0","0","0","1","1","0","2","1","1","0","0","0","0","0","0","9","3","6","0","0","0","2","1","1","0","0","0","-2"
"144740","DePaul University","2010","Total full-time Instruction/research/public service, Non-tenured on tenure track, Assistant professors","193","94","99","1","0","1","21","6","15","11","5","6","22","14","8","0","0","0","112","57","55","3","0","3","15","10","5","8","2","6","-2"
"144740","DePaul University","2010","Total full-time Instruction/research/public service, Non-tenured on tenure track total","207","100","107","1","0","1","22","7","15","13","6","7","22","14","8","0","0","0","121","60","61","3","0","3","17","11","6","8","2","6","-2"
"144740","DePaul University","2010","Total full-time Instruction/research/public service, Non-tenured not on tenure track, Professors","7","5","2","0","0","0","0","0","0","1","1","0","1","0","1","0","0","0","4","3","1","0","0","0","1","1","0","0","0","0","-2"
"144740","DePaul University","2010","Total full-time Instruction/research/public service, Non-tenured not on tenure track, Associate professors","9","4","5","0","0","0","0","0","0","1","0","1","0","0","0","0","0","0","5","3","2","0","0","0","3","1","2","0","0","0","-2"
"144740","DePaul University","2010","Total full-time Instruction/research/public servicey, Non-tenured not on tenure track, Assistant professors","63","31","32","1","1","0","2","0","2","4","1","3","8","3","5","0","0","0","37","17","20","1","1","0","8","7","1","2","1","1","-2"
"144740","DePaul University","2010","Total full-time Instruction/research/public service, Non-tenured not on tenure track, Instructors","105","53","52","0","0","0","4","4","0","2","1","1","4","2","2","0","0","0","86","43","43","1","0","1","7","2","5","1","1","0","-2"
"144740","DePaul University","2010","Total full-time Instruction/research/public service, Non-tenured not on tenure track total","184","93","91","1","1","0","6","4","2","8","3","5","13","5","8","0","0","0","132","66","66","2","1","1","19","11","8","3","2","1","-2"
"144962","Elmhurst University","2010","Total full-time Instruction/research/public service, Tenured, Professors","46","26","20","0","0","0","3","3","0","1","1","0","1","1","0","0","0","0","41","21","20","0","0","0","0","0","0","0","0","0","-2"
"144962","Elmhurst University","2010","Total full-time Instruction/research/public service, Tenured, Associate professors","25","11","14","0","0","0","1","1","0","0","0","0","1","0","1","0","0","0","23","10","13","0","0","0","0","0","0","0","0","0","-2"
"144962","Elmhurst University","2010","Total full-time Instruction/research/public service, Tenured, Assistant professors","5","3","2","0","0","0","0","0","0","0","0","0","0","0","0","0","0","0","5","3","2","0","0","0","0","0","0","0","0","0","-2"
"144962","Elmhurst University","2010","Total full-time Instruction/research/public service, Tenured total","76","40","36","0","0","0","4","4","0","1","1","0","2","1","1","0","0","0","69","34","35","0","0","0","0","0","0","0","0","0","-2"
"144962","Elmhurst University","2010","Total full-time Instruction/research/public service, Non-tenured on tenure track, Associate professors","1","1","0","0","0","0","0","0","0","0","0","0","0","0","0","0","0","0","1","1","0","0","0","0","0","0","0","0","0","0","-2"
"144962","Elmhurst University","2010","Total full-time Instruction/research/public service, Non-tenured on tenure track, Assistant professors","33","12","21","0","0","0","1","1","0","2","0","2","1","0","1","0","0","0","28","10","18","0","0","0","0","0","0","1","1","0","-2"
"144962","Elmhurst University","2010","Total full-time Instruction/research/public service, Non-tenured on tenure track, Instructors","2","0","2","0","0","0","0","0","0","0","0","0","0","0","0","0","0","0","2","0","2","0","0","0","0","0","0","0","0","0","-2"
"144962","Elmhurst University","2010","Total full-time Instruction/research/public service, Non-tenured on tenure track total","36","13","23","0","0","0","1","1","0","2","0","2","1","0","1","0","0","0","31","11","20","0","0","0","0","0","0","1","1","0","-2"
"144962","Elmhurst University","2010","Total full-time Instruction/research/public service, Non-tenured not on tenure track, Associate professors","5","1","4","0","0","0","0","0","0","0","0","0","0","0","0","0","0","0","5","1","4","0","0","0","0","0","0","0","0","0","-2"
"144962","Elmhurst University","2010","Total full-time Instruction/research/public servicey, Non-tenured not on tenure track, Assistant professors","17","7","10","0","0","0","1","0","1","1","0","1","1","1","0","0","0","0","14","6","8","0","0","0","0","0","0","0","0","0","-2"
"144962","Elmhurst University","2010","Total full-time Instruction/research/public service, Non-tenured not on tenure track, Instructors","1","0","1","0","0","0","0","0","0","0","0","0","1","0","1","0","0","0","0","0","0","0","0","0","0","0","0","0","0","0","-2"
"144962","Elmhurst University","2010","Total full-time Instruction/research/public service, Non-tenured not on tenure track total","23","8","15","0","0","0","1","0","1","1","0","1","2","1","1","0","0","0","19","7","12","0","0","0","0","0","0","0","0","0","-2"
"145336","Governors State University","2010","Total full-time Instruction/research/public service, Tenured, Professors","33","17","16","0","0","0","5","3","2","2","1","1","0","0","0","0","0","0","9","4","5","1","0","1","16","9","7","0","0","0","-2"
"145336","Governors State University","2010","Total full-time Instruction/research/public service, Tenured, Associate professors","53","21","32","0","0","0","4","3","1","4","1","3","1","0","1","0","0","0","13","6","7","1","0","1","30","11","19","0","0","0","-2"
"145336","Governors State University","2010","Total full-time Instruction/research/public service, Tenured, No academic rank","4","2","2","0","0","0","1","0","1","0","0","0","0","0","0","0","0","0","0","0","0","0","0","0","3","2","1","0","0","0","-2"
"145336","Governors State University","2010","Total full-time Instruction/research/public service, Tenured total","90","40","50","0","0","0","10","6","4","6","2","4","1","0","1","0","0","0","22","10","12","2","0","2","49","22","27","0","0","0","-2"
"145336","Governors State University","2010","Total full-time Instruction/research/public service, Non-tenured on tenure track, Assistant professors","53","28","25","0","0","0","4","2","2","5","1","4","0","0","0","0","0","0","9","4","5","0","0","0","35","21","14","0","0","0","-2"
"145336","Governors State University","2010","Total full-time Instruction/research/public service, Non-tenured on tenure track, Instructors","4","1","3","0","0","0","0","0","0","0","0","0","0","0","0","0","0","0","1","0","1","0","0","0","3","1","2","0","0","0","-2"
"145336","Governors State University","2010","Total full-time Instruction/research/public service, Non-tenured on tenure track total","57","29","28","0","0","0","4","2","2","5","1","4","0","0","0","0","0","0","10","4","6","0","0","0","38","22","16","0","0","0","-2"
"145336","Governors State University","2010","Total full-time Instruction/research/public service, Non-tenured not on tenure track, Lecturers","64","26","38","0","0","0","1","0","1","2","1","1","1","0","1","0","0","0","16","6","10","1","1","0","43","18","25","0","0","0","-2"
"145336","Governors State University","2010","Total full-time Instruction/research/public service, Non-tenured not on tenure track, No academic rank","1","1","0","0","0","0","0","0","0","0","0","0","0","0","0","0","0","0","0","0","0","0","0","0","1","1","0","0","0","0","-2"
"145336","Governors State University","2010","Total full-time Instruction/research/public service, Non-tenured not on tenure track total","65","27","38","0","0","0","1","0","1","2","1","1","1","0","1","0","0","0","16","6","10","1","1","0","44","19","25","0","0","0","-2"
"145619","Benedictine University","2010","Total full-time Instruction/research/public service, Tenured, Professors","37","25","12","0","0","0","2","2","0","2","1","1","0","0","0","0","0","0","33","22","11","0","0","0","0","0","0","0","0","0","-2"
"145619","Benedictine University","2010","Total full-time Instruction/research/public service, Tenured, Associate professors","23","11","12","0","0","0","3","1","2","1","0","1","0","0","0","0","0","0","18","10","8","0","0","0","1","0","1","0","0","0","-2"
"145619","Benedictine University","2010","Total full-time Instruction/research/public service, Tenured total","60","36","24","0","0","0","5","3","2","3","1","2","0","0","0","0","0","0","51","32","19","0","0","0","1","0","1","0","0","0","-2"
"145619","Benedictine University","2010","Total full-time Instruction/research/public service, Non-tenured on tenure track, Associate professors","5","2","3","0","0","0","2","2","0","1","0","1","0","0","0","0","0","0","2","0","2","0","0","0","0","0","0","0","0","0","-2"
"145619","Benedictine University","2010","Total full-time Instruction/research/public service, Non-tenured on tenure track, Assistant professors","27","11","16","0","0","0","1","0","1","0","0","0","1","1","0","0","0","0","24","9","15","0","0","0","1","1","0","0","0","0","-2"
"145619","Benedictine University","2010","Total full-time Instruction/research/public service, Non-tenured on tenure track total","32","13","19","0","0","0","3","2","1","1","0","1","1","1","0","0","0","0","26","9","17","0","0","0","1","1","0","0","0","0","-2"
"145619","Benedictine University","2010","Total full-time Instruction/research/public service, Non-tenured not on tenure track, Professors","1","1","0","0","0","0","1","1","0","0","0","0","0","0","0","0","0","0","0","0","0","0","0","0","0","0","0","0","0","0","-2"
"145619","Benedictine University","2010","Total full-time Instruction/research/public service, Non-tenured not on tenure track, Associate professors","1","0","1","0","0","0","0","0","0","0","0","0","0","0","0","0","0","0","1","0","1","0","0","0","0","0","0","0","0","0","-2"
"145619","Benedictine University","2010","Total full-time Instruction/research/public servicey, Non-tenured not on tenure track, Assistant professors","4","3","1","0","0","0","3","2","1","0","0","0","0","0","0","0","0","0","1","1","0","0","0","0","0","0","0","0","0","0","-2"
"145619","Benedictine University","2010","Total full-time Instruction/research/public service, Non-tenured not on tenure track, Instructors","10","5","5","0","0","0","2","1","1","0","0","0","0","0","0","0","0","0","8","4","4","0","0","0","0","0","0","0","0","0","-2"
"145619","Benedictine University","2010","Total full-time Instruction/research/public service, Non-tenured not on tenure track total","16","9","7","0","0","0","6","4","2","0","0","0","0","0","0","0","0","0","10","5","5","0","0","0","0","0","0","0","0","0","-2"
"145725","Illinois Institute of Technology","2010","Total full-time Instruction/research/public service, Tenured, Professors","112","98","14","0","0","0","4","4","0","0","0","0","0","0","0","0","0","0","5","3","2","0","0","0","99","87","12","4","4","0","-2"
"145725","Illinois Institute of Technology","2010","Total full-time Instruction/research/public service, Tenured, Associate professors","74","53","21","0","0","0","3","3","0","0","0","0","2","2","0","0","0","0","6","4","2","0","0","0","54","35","19","9","9","0","-2"
"145725","Illinois Institute of Technology","2010","Total full-time Instruction/research/public service, Tenured total","186","151","35","0","0","0","7","7","0","0","0","0","2","2","0","0","0","0","11","7","4","0","0","0","153","122","31","13","13","0","-2"
"145725","Illinois Institute of Technology","2010","Total full-time Instruction/research/public service, Non-tenured on tenure track, Associate professors","1","1","0","0","0","0","0","0","0","0","0","0","0","0","0","0","0","0","0","0","0","0","0","0","1","1","0","0","0","0","-2"
"145725","Illinois Institute of Technology","2010","Total full-time Instruction/research/public service, Non-tenured on tenure track, Assistant professors","86","63","23","0","0","0","1","1","0","2","0","2","0","0","0","0","0","0","17","9","8","0","0","0","51","41","10","15","12","3","-2"
"145725","Illinois Institute of Technology","2010","Total full-time Instruction/research/public service, Non-tenured on tenure track total","87","64","23","0","0","0","1","1","0","2","0","2","0","0","0","0","0","0","17","9","8","0","0","0","52","42","10","15","12","3","-2"
"145725","Illinois Institute of Technology","2010","Total full-time Instruction/research/public service, Non-tenured not on tenure track, Professors","31","21","10","0","0","0","1","1","0","0","0","0","0","0","0","0","0","0","5","2","3","0","0","0","22","16","6","3","2","1","-2"
"145725","Illinois Institute of Technology","2010","Total full-time Instruction/research/public service, Non-tenured not on tenure track, Associate professors","32","27","5","0","0","0","0","0","0","0","0","0","0","0","0","0","0","0","5","4","1","0","0","0","26","22","4","1","1","0","-2"
"145725","Illinois Institute of Technology","2010","Total full-time Instruction/research/public servicey, Non-tenured not on tenure track, Assistant professors","55","44","11","0","0","0","1","1","0","0","0","0","1","0","1","0","0","0","14","11","3","0","0","0","35","29","6","4","3","1","-2"
"145725","Illinois Institute of Technology","2010","Total full-time Instruction/research/public service, Non-tenured not on tenure track, Instructors","7","5","2","0","0","0","0","0","0","0","0","0","0","0","0","0","0","0","3","2","1","0","0","0","2","1","1","2","2","0","-2"
"145725","Illinois Institute of Technology","2010","Total full-time Instruction/research/public service, Non-tenured not on tenure track, Lecturers","3","2","1","0","0","0","0","0","0","0","0","0","1","0","1","0","0","0","2","2","0","0","0","0","0","0","0","0","0","0","-2"
"145725","Illinois Institute of Technology","2010","Total full-time Instruction/research/public service, Non-tenured not on tenure track, No academic rank","10","9","1","0","0","0","0","0","0","0","0","0","0","0","0","0","0","0","1","1","0","0","0","0","5","4","1","4","4","0","-2"
"145725","Illinois Institute of Technology","2010","Total full-time Instruction/research/public service, Non-tenured not on tenure track total","138","108","30","0","0","0","2","2","0","0","0","0","2","0","2","0","0","0","30","22","8","0","0","0","90","72","18","14","12","2","-2"
"146339","Judson University","2010","Total full-time Instruction/research/public service, Tenured, Professors","22","15","7","0","0","0","4","1","3","0","0","0","0","0","0","0","0","0","18","14","4","0","0","0","0","0","0","0","0","0","-2"
"146339","Judson University","2010","Total full-time Instruction/research/public service, Tenured, Associate professors","15","11","4","0","0","0","1","1","0","1","1","0","0","0","0","0","0","0","13","9","4","0","0","0","0","0","0","0","0","0","-2"
"146339","Judson University","2010","Total full-time Instruction/research/public service, Tenured total","37","26","11","0","0","0","5","2","3","1","1","0","0","0","0","0","0","0","31","23","8","0","0","0","0","0","0","0","0","0","-2"
"146339","Judson University","2010","Total full-time Instruction/research/public service, Non-tenured on tenure track, Professors","1","1","0","0","0","0","0","0","0","0","0","0","0","0","0","0","0","0","1","1","0","0","0","0","0","0","0","0","0","0","-2"
"146339","Judson University","2010","Total full-time Instruction/research/public service, Non-tenured on tenure track, Associate professors","8","5","3","0","0","0","0","0","0","1","0","1","0","0","0","0","0","0","7","5","2","0","0","0","0","0","0","0","0","0","-2"
"146339","Judson University","2010","Total full-time Instruction/research/public service, Non-tenured on tenure track, Assistant professors","14","8","6","0","0","0","1","0","1","0","0","0","0","0","0","0","0","0","13","8","5","0","0","0","0","0","0","0","0","0","-2"
"146339","Judson University","2010","Total full-time Instruction/research/public service, Non-tenured on tenure track, Instructors","1","0","1","0","0","0","0","0","0","0","0","0","0","0","0","0","0","0","1","0","1","0","0","0","0","0","0","0","0","0","-2"
"146339","Judson University","2010","Total full-time Instruction/research/public service, Non-tenured on tenure track total","24","14","10","0","0","0","1","0","1","1","0","1","0","0","0","0","0","0","22","14","8","0","0","0","0","0","0","0","0","0","-2"
"146339","Judson University","2010","Total full-time Instruction/research/public service, Non-tenured not on tenure track, Professors","2","1","1","0","0","0","0","0","0","0","0","0","0","0","0","0","0","0","2","1","1","0","0","0","0","0","0","0","0","0","-2"
"146339","Judson University","2010","Total full-time Instruction/research/public service, Non-tenured not on tenure track, Associate professors","2","1","1","0","0","0","1","0","1","0","0","0","0","0","0","0","0","0","1","1","0","0","0","0","0","0","0","0","0","0","-2"
"146339","Judson University","2010","Total full-time Instruction/research/public servicey, Non-tenured not on tenure track, Assistant professors","4","1","3","0","0","0","0","0","0","0","0","0","0","0","0","0","0","0","4","1","3","0","0","0","0","0","0","0","0","0","-2"
"146339","Judson University","2010","Total full-time Instruction/research/public service, Non-tenured not on tenure track, Instructors","2","1","1","0","0","0","0","0","0","0","0","0","0","0","0","0","0","0","2","1","1","0","0","0","0","0","0","0","0","0","-2"
"146339","Judson University","2010","Total full-time Instruction/research/public service, Non-tenured not on tenure track total","10","4","6","0","0","0","1","0","1","0","0","0","0","0","0","0","0","0","9","4","5","0","0","0","0","0","0","0","0","0","-2"
"146612","Lewis University","2010","Total full-time Instruction/research/public service, Tenured, Professors","61","38","23","0","0","0","2","2","0","5","4","1","0","0","0","0","0","0","54","32","22","0","0","0","0","0","0","0","0","0","-2"
"146612","Lewis University","2010","Total full-time Instruction/research/public service, Tenured, Associate professors","23","8","15","0","0","0","1","0","1","0","0","0","0","0","0","0","0","0","22","8","14","0","0","0","0","0","0","0","0","0","-2"
"146612","Lewis University","2010","Total full-time Instruction/research/public service, Tenured, Assistant professors","2","2","0","0","0","0","1","1","0","0","0","0","0","0","0","0","0","0","1","1","0","0","0","0","0","0","0","0","0","0","-2"
"146612","Lewis University","2010","Total full-time Instruction/research/public service, Tenured total","86","48","38","0","0","0","4","3","1","5","4","1","0","0","0","0","0","0","77","41","36","0","0","0","0","0","0","0","0","0","-2"
"146612","Lewis University","2010","Total full-time Instruction/research/public service, Non-tenured on tenure track, Associate professors","9","4","5","0","0","0","0","0","0","1","0","1","0","0","0","0","0","0","7","3","4","0","0","0","0","0","0","1","1","0","-2"
"146612","Lewis University","2010","Total full-time Instruction/research/public service, Non-tenured on tenure track, Assistant professors","30","16","14","0","0","0","0","0","0","1","0","1","1","1","0","0","0","0","26","14","12","0","0","0","0","0","0","2","1","1","-2"
"146612","Lewis University","2010","Total full-time Instruction/research/public service, Non-tenured on tenure track total","39","20","19","0","0","0","0","0","0","2","0","2","1","1","0","0","0","0","33","17","16","0","0","0","0","0","0","3","2","1","-2"
"146612","Lewis University","2010","Total full-time Instruction/research/public service, Non-tenured not on tenure track, Professors","1","1","0","0","0","0","0","0","0","0","0","0","0","0","0","0","0","0","1","1","0","0","0","0","0","0","0","0","0","0","-2"
"146612","Lewis University","2010","Total full-time Instruction/research/public service, Non-tenured not on tenure track, Associate professors","10","5","5","0","0","0","0","0","0","0","0","0","1","1","0","0","0","0","9","4","5","0","0","0","0","0","0","0","0","0","-2"
"146612","Lewis University","2010","Total full-time Instruction/research/public servicey, Non-tenured not on tenure track, Assistant professors","49","21","28","0","0","0","1","0","1","3","0","3","0","0","0","0","0","0","43","19","24","0","0","0","0","0","0","2","2","0","-2"
"146612","Lewis University","2010","Total full-time Instruction/research/public service, Non-tenured not on tenure track, Instructors","16","5","11","0","0","0","1","0","1","1","0","1","0","0","0","0","0","0","14","5","9","0","0","0","0","0","0","0","0","0","-2"
"146612","Lewis University","2010","Total full-time Instruction/research/public service, Non-tenured not on tenure track total","76","32","44","0","0","0","2","0","2","4","0","4","1","1","0","0","0","0","67","29","38","0","0","0","0","0","0","2","2","0","-2"
"146719","Loyola University Chicago","2010","Total full-time Instruction/research/public service, Tenured, Professors","231","168","63","0","0","0","13","11","2","3","2","1","9","6","3","0","0","0","205","149","56","1","0","1","0","0","0","0","0","0","-2"
"146719","Loyola University Chicago","2010","Total full-time Instruction/research/public service, Tenured, Associate professors","181","98","83","1","1","0","8","5","3","6","2","4","6","1","5","1","0","1","158","89","69","1","0","1","0","0","0","0","0","0","-2"
"146719","Loyola University Chicago","2010","Total full-time Instruction/research/public service, Tenured, Assistant professors","22","15","7","0","0","0","1","1","0","1","0","1","2","1","1","0","0","0","15","10","5","0","0","0","0","0","0","3","3","0","-2"
"146719","Loyola University Chicago","2010","Total full-time Instruction/research/public service, Tenured total","434","281","153","1","1","0","22","17","5","10","4","6","17","8","9","1","0","1","378","248","130","2","0","2","0","0","0","3","3","0","-2"
"146719","Loyola University Chicago","2010","Total full-time Instruction/research/public service, Non-tenured on tenure track, Professors","7","6","1","0","0","0","0","0","0","0","0","0","1","1","0","0","0","0","5","5","0","0","0","0","0","0","0","1","0","1","-2"
"146719","Loyola University Chicago","2010","Total full-time Instruction/research/public service, Non-tenured on tenure track, Associate professors","7","3","4","0","0","0","0","0","0","1","0","1","0","0","0","0","0","0","5","2","3","0","0","0","0","0","0","1","1","0","-2"
"146719","Loyola University Chicago","2010","Total full-time Instruction/research/public service, Non-tenured on tenure track, Assistant professors","105","50","55","0","0","0","12","5","7","6","2","4","4","2","2","0","0","0","72","38","34","1","1","0","1","0","1","9","2","7","-2"
"146719","Loyola University Chicago","2010","Total full-time Instruction/research/public service, Non-tenured on tenure track total","119","59","60","0","0","0","12","5","7","7","2","5","5","3","2","0","0","0","82","45","37","1","1","0","1","0","1","11","3","8","-2"
"146719","Loyola University Chicago","2010","Total full-time Instruction/research/public service, Non-tenured not on tenure track, Instructors","214","94","120","0","0","0","13","7","6","10","3","7","6","3","3","0","0","0","176","76","100","4","2","2","1","0","1","4","3","1","-2"
"146719","Loyola University Chicago","2010","Total full-time Instruction/research/public service, Non-tenured not on tenure track total","214","94","120","0","0","0","13","7","6","10","3","7","6","3","3","0","0","0","176","76","100","4","2","2","1","0","1","4","3","1","-2"
"147660","North Central College","2010","Total full-time Instruction/research/public service, Tenured, Professors","35","22","13","0","0","0","3","1","2","0","0","0","1","1","0","0","0","0","31","20","11","0","0","0","0","0","0","0","0","0","-2"
"147660","North Central College","2010","Total full-time Instruction/research/public service, Tenured, Associate professors","31","17","14","0","0","0","0","0","0","1","1","0","0","0","0","0","0","0","30","16","14","0","0","0","0","0","0","0","0","0","-2"
"147660","North Central College","2010","Total full-time Instruction/research/public service, Tenured total","66","39","27","0","0","0","3","1","2","1","1","0","1","1","0","0","0","0","61","36","25","0","0","0","0","0","0","0","0","0","-2"
"147660","North Central College","2010","Total full-time Instruction/research/public service, Non-tenured on tenure track, Associate professors","4","2","2","0","0","0","2","1","1","0","0","0","0","0","0","0","0","0","2","1","1","0","0","0","0","0","0","0","0","0","-2"
"147660","North Central College","2010","Total full-time Instruction/research/public service, Non-tenured on tenure track, Assistant professors","29","14","15","0","0","0","1","0","1","1","0","1","1","0","1","0","0","0","25","13","12","0","0","0","0","0","0","1","1","0","-2"
"147660","North Central College","2010","Total full-time Instruction/research/public service, Non-tenured on tenure track total","33","16","17","0","0","0","3","1","2","1","0","1","1","0","1","0","0","0","27","14","13","0","0","0","0","0","0","1","1","0","-2"
"147660","North Central College","2010","Total full-time Instruction/research/public service, Non-tenured not on tenure track, Professors","2","1","1","0","0","0","0","0","0","0","0","0","0","0","0","0","0","0","2","1","1","0","0","0","0","0","0","0","0","0","-2"
"147660","North Central College","2010","Total full-time Instruction/research/public service, Non-tenured not on tenure track, Associate professors","4","1","3","0","0","0","0","0","0","0","0","0","0","0","0","0","0","0","4","1","3","0","0","0","0","0","0","0","0","0","-2"
"147660","North Central College","2010","Total full-time Instruction/research/public servicey, Non-tenured not on tenure track, Assistant professors","17","10","7","0","0","0","0","0","0","2","2","0","1","0","1","0","0","0","14","8","6","0","0","0","0","0","0","0","0","0","-2"
"147660","North Central College","2010","Total full-time Instruction/research/public service, Non-tenured not on tenure track, Instructors","4","1","3","0","0","0","0","0","0","0","0","0","0","0","0","0","0","0","4","1","3","0","0","0","0","0","0","0","0","0","-2"
"147660","North Central College","2010","Total full-time Instruction/research/public service, Non-tenured not on tenure track total","27","13","14","0","0","0","0","0","0","2","2","0","1","0","1","0","0","0","24","11","13","0","0","0","0","0","0","0","0","0","-2"
"148405","Rockford University","2010","Total full-time Instruction/research/public service, Tenured, Professors","25","18","7","0","0","0","0","0","0","0","0","0","0","0","0","0","0","0","8","5","3","1","1","0","16","12","4","0","0","0","-2"
"148405","Rockford University","2010","Total full-time Instruction/research/public service, Tenured, Associate professors","13","8","5","0","0","0","0","0","0","0","0","0","0","0","0","0","0","0","7","3","4","1","0","1","5","5","0","0","0","0","-2"
"148405","Rockford University","2010","Total full-time Instruction/research/public service, Tenured, Assistant professors","5","0","5","0","0","0","0","0","0","0","0","0","0","0","0","0","0","0","3","0","3","0","0","0","2","0","2","0","0","0","-2"
"148405","Rockford University","2010","Total full-time Instruction/research/public service, Tenured total","43","26","17","0","0","0","0","0","0","0","0","0","0","0","0","0","0","0","18","8","10","2","1","1","23","17","6","0","0","0","-2"
"148405","Rockford University","2010","Total full-time Instruction/research/public service, Non-tenured on tenure track, Associate professors","3","2","1","0","0","0","0","0","0","0","0","0","0","0","0","0","0","0","3","2","1","0","0","0","0","0","0","0","0","0","-2"
"148405","Rockford University","2010","Total full-time Instruction/research/public service, Non-tenured on tenure track, Assistant professors","14","9","5","0","0","0","0","0","0","1","1","0","1","1","0","0","0","0","10","5","5","0","0","0","2","2","0","0","0","0","-2"
"148405","Rockford University","2010","Total full-time Instruction/research/public service, Non-tenured on tenure track total","17","11","6","0","0","0","0","0","0","1","1","0","1","1","0","0","0","0","13","7","6","0","0","0","2","2","0","0","0","0","-2"
"148405","Rockford University","2010","Total full-time Instruction/research/public service, Non-tenured not on tenure track, Associate professors","1","1","0","0","0","0","0","0","0","0","0","0","0","0","0","0","0","0","1","1","0","0","0","0","0","0","0","0","0","0","-2"
"148405","Rockford University","2010","Total full-time Instruction/research/public servicey, Non-tenured not on tenure track, Assistant professors","8","3","5","0","0","0","0","0","0","1","1","0","0","0","0","0","0","0","6","1","5","0","0","0","1","1","0","0","0","0","-2"
"148405","Rockford University","2010","Total full-time Instruction/research/public service, Non-tenured not on tenure track, Instructors","2","0","2","0","0","0","0","0","0","0","0","0","0","0","0","0","0","0","0","0","0","0","0","0","2","0","2","0","0","0","-2"
"148405","Rockford University","2010","Total full-time Instruction/research/public service, Non-tenured not on tenure track total","11","4","7","0","0","0","0","0","0","1","1","0","0","0","0","0","0","0","7","2","5","0","0","0","3","1","2","0","0","0","-2"
"148584","University of St Francis","2010","Total full-time Instruction/research/public service, Tenured, Professors","25","15","10","0","0","0","1","0","1","1","0","1","0","0","0","0","0","0","23","15","8","0","0","0","0","0","0","0","0","0","-2"
"148584","University of St Francis","2010","Total full-time Instruction/research/public service, Tenured, Associate professors","15","6","9","0","0","0","0","0","0","0","0","0","0","0","0","0","0","0","15","6","9","0","0","0","0","0","0","0","0","0","-2"
"148584","University of St Francis","2010","Total full-time Instruction/research/public service, Tenured, Assistant professors","11","0","11","0","0","0","0","0","0","0","0","0","1","0","1","0","0","0","10","0","10","0","0","0","0","0","0","0","0","0","-2"
"148584","University of St Francis","2010","Total full-time Instruction/research/public service, Tenured total","51","21","30","0","0","0","1","0","1","1","0","1","1","0","1","0","0","0","48","21","27","0","0","0","0","0","0","0","0","0","-2"
"148584","University of St Francis","2010","Total full-time Instruction/research/public service, Non-tenured on tenure track, Associate professors","3","2","1","0","0","0","0","0","0","0","0","0","0","0","0","0","0","0","3","2","1","0","0","0","0","0","0","0","0","0","-2"
"148584","University of St Francis","2010","Total full-time Instruction/research/public service, Non-tenured on tenure track, Assistant professors","24","11","13","1","1","0","2","1","1","2","2","0","0","0","0","0","0","0","19","7","12","0","0","0","0","0","0","0","0","0","-2"
"148584","University of St Francis","2010","Total full-time Instruction/research/public service, Non-tenured on tenure track total","27","13","14","1","1","0","2","1","1","2","2","0","0","0","0","0","0","0","22","9","13","0","0","0","0","0","0","0","0","0","-2"
"148584","University of St Francis","2010","Total full-time Instruction/research/public service, Non-tenured not on tenure track, Associate professors","1","1","0","0","0","0","0","0","0","0","0","0","0","0","0","0","0","0","1","1","0","0","0","0","0","0","0","0","0","0","-2"
"148584","University of St Francis","2010","Total full-time Instruction/research/public servicey, Non-tenured not on tenure track, Assistant professors","6","1","5","0","0","0","1","0","1","0","0","0","0","0","0","0","0","0","5","1","4","0","0","0","0","0","0","0","0","0","-2"
"148584","University of St Francis","2010","Total full-time Instruction/research/public service, Non-tenured not on tenure track, Instructors","10","4","6","0","0","0","2","1","1","0","0","0","3","2","1","0","0","0","4","1","3","1","0","1","0","0","0","0","0","0","-2"
"148584","University of St Francis","2010","Total full-time Instruction/research/public service, Non-tenured not on tenure track total","17","6","11","0","0","0","3","1","2","0","0","0","3","2","1","0","0","0","10","3","7","1","0","1","0","0","0","0","0","0","-2"
"149763","Resurrection University","2010","Total full-time Instruction/research/public service, Non-tenured not on tenure track, Associate professors","1","0","1","0","0","0","0","0","0","0","0","0","0","0","0","0","0","0","1","0","1","0","0","0","0","0","0","0","0","0","-2"
"149763","Resurrection University","2010","Total full-time Instruction/research/public servicey, Non-tenured not on tenure track, Assistant professors","5","0","5","0","0","0","2","0","2","0","0","0","0","0","0","0","0","0","3","0","3","0","0","0","0","0","0","0","0","0","-2"
"149763","Resurrection University","2010","Total full-time Instruction/research/public service, Non-tenured not on tenure track, Instructors","13","0","13","0","0","0","2","0","2","1","0","1","0","0","0","0","0","0","10","0","10","0","0","0","0","0","0","0","0","0","-2"
"149763","Resurrection University","2010","Total full-time Instruction/research/public service, Non-tenured not on tenure track total","19","0","19","0","0","0","4","0","4","1","0","1","0","0","0","0","0","0","14","0","14","0","0","0","0","0","0","0","0","0","-2"
"150668","Goshen College","2010","Total full-time Instruction/research/public service, Tenured, Professors","28","18","10","0","0","0","0","0","0","0","0","0","1","1","0","0","0","0","27","17","10","0","0","0","0","0","0","0","0","0","-2"
"150668","Goshen College","2010","Total full-time Instruction/research/public service, Tenured, Associate professors","4","1","3","0","0","0","0","0","0","0","0","0","0","0","0","0","0","0","4","1","3","0","0","0","0","0","0","0","0","0","-2"
"150668","Goshen College","2010","Total full-time Instruction/research/public service, Tenured total","32","19","13","0","0","0","0","0","0","0","0","0","1","1","0","0","0","0","31","18","13","0","0","0","0","0","0","0","0","0","-2"
"150668","Goshen College","2010","Total full-time Instruction/research/public service, Non-tenured on tenure track, Professors","1","1","0","0","0","0","0","0","0","0","0","0","0","0","0","0","0","0","1","1","0","0","0","0","0","0","0","0","0","0","-2"
"150668","Goshen College","2010","Total full-time Instruction/research/public service, Non-tenured on tenure track, Associate professors","12","5","7","0","0","0","0","0","0","0","0","0","0","0","0","0","0","0","12","5","7","0","0","0","0","0","0","0","0","0","-2"
"150668","Goshen College","2010","Total full-time Instruction/research/public service, Non-tenured on tenure track, Assistant professors","8","6","2","0","0","0","0","0","0","0","0","0","0","0","0","0","0","0","7","5","2","0","0","0","0","0","0","1","1","0","-2"
"150668","Goshen College","2010","Total full-time Instruction/research/public service, Non-tenured on tenure track total","21","12","9","0","0","0","0","0","0","0","0","0","0","0","0","0","0","0","20","11","9","0","0","0","0","0","0","1","1","0","-2"
"150668","Goshen College","2010","Total full-time Instruction/research/public service, Non-tenured not on tenure track, Associate professors","9","4","5","0","0","0","0","0","0","0","0","0","0","0","0","0","0","0","9","4","5","0","0","0","0","0","0","0","0","0","-2"
"150668","Goshen College","2010","Total full-time Instruction/research/public servicey, Non-tenured not on tenure track, Assistant professors","10","2","8","0","0","0","0","0","0","2","0","2","0","0","0","0","0","0","8","2","6","0","0","0","0","0","0","0","0","0","-2"
"150668","Goshen College","2010","Total full-time Instruction/research/public service, Non-tenured not on tenure track total","19","6","13","0","0","0","0","0","0","2","0","2","0","0","0","0","0","0","17","6","11","0","0","0","0","0","0","0","0","0","-2"
"152637","Vincennes University","2010","Total full-time Instruction/research/public service, Tenured, Professors","91","47","44","0","0","0","1","1","0","1","1","0","1","1","0","0","0","0","88","44","44","0","0","0","0","0","0","0","0","0","-2"
"152637","Vincennes University","2010","Total full-time Instruction/research/public service, Tenured, Associate professors","18","14","4","0","0","0","0","0","0","0","0","0","0","0","0","0","0","0","18","14","4","0","0","0","0","0","0","0","0","0","-2"
"152637","Vincennes University","2010","Total full-time Instruction/research/public service, Tenured, Assistant professors","4","4","0","0","0","0","0","0","0","0","0","0","0","0","0","0","0","0","4","4","0","0","0","0","0","0","0","0","0","0","-2"
"152637","Vincennes University","2010","Total full-time Instruction/research/public service, Tenured, Instructors","2","2","0","0","0","0","0","0","0","0","0","0","0","0","0","0","0","0","2","2","0","0","0","0","0","0","0","0","0","0","-2"
"152637","Vincennes University","2010","Total full-time Instruction/research/public service, Tenured total","115","67","48","0","0","0","1","1","0","1","1","0","1","1","0","0","0","0","112","64","48","0","0","0","0","0","0","0","0","0","-2"
"152637","Vincennes University","2010","Total full-time Instruction/research/public service, Non-tenured on tenure track, Professors","2","2","0","0","0","0","0","0","0","0","0","0","0","0","0","0","0","0","2","2","0","0","0","0","0","0","0","0","0","0","-2"
"152637","Vincennes University","2010","Total full-time Instruction/research/public service, Non-tenured on tenure track, Associate professors","4","3","1","0","0","0","0","0","0","1","1","0","0","0","0","0","0","0","3","2","1","0","0","0","0","0","0","0","0","0","-2"
"152637","Vincennes University","2010","Total full-time Instruction/research/public service, Non-tenured on tenure track, Assistant professors","2","2","0","0","0","0","0","0","0","1","1","0","0","0","0","0","0","0","1","1","0","0","0","0","0","0","0","0","0","0","-2"
"152637","Vincennes University","2010","Total full-time Instruction/research/public service, Non-tenured on tenure track total","8","7","1","0","0","0","0","0","0","2","2","0","0","0","0","0","0","0","6","5","1","0","0","0","0","0","0","0","0","0","-2"
"152637","Vincennes University","2010","Total full-time Instruction/research/public service, Non-tenured not on tenure track, Professors","8","3","5","0","0","0","0","0","0","0","0","0","0","0","0","0","0","0","8","3","5","0","0","0","0","0","0","0","0","0","-2"
"152637","Vincennes University","2010","Total full-time Instruction/research/public service, Non-tenured not on tenure track, Associate professors","24","10","14","0","0","0","0","0","0","1","1","0","0","0","0","0","0","0","23","9","14","0","0","0","0","0","0","0","0","0","-2"
"152637","Vincennes University","2010","Total full-time Instruction/research/public servicey, Non-tenured not on tenure track, Assistant professors","67","28","39","0","0","0","0","0","0","1","0","1","0","0","0","0","0","0","64","27","37","0","0","0","0","0","0","2","1","1","-2"
"152637","Vincennes University","2010","Total full-time Instruction/research/public service, Non-tenured not on tenure track, Instructors","24","21","3","0","0","0","0","0","0","0","0","0","0","0","0","0","0","0","24","21","3","0","0","0","0","0","0","0","0","0","-2"
"152637","Vincennes University","2010","Total full-time Instruction/research/public service, Non-tenured not on tenure track, No academic rank","23","5","18","0","0","0","0","0","0","0","0","0","0","0","0","0","0","0","23","5","18","0","0","0","0","0","0","0","0","0","-2"
"152637","Vincennes University","2010","Total full-time Instruction/research/public service, Non-tenured not on tenure track total","146","67","79","0","0","0","0","0","0","2","1","1","0","0","0","0","0","0","142","65","77","0","0","0","0","0","0","2","1","1","-2"
"152992","Briar Cliff University","2010","Total full-time Instruction/research/public service, Tenured, Professors","16","11","5","0","0","0","0","0","0","0","0","0","0","0","0","0","0","0","16","11","5","0","0","0","0","0","0","0","0","0","-2"
"152992","Briar Cliff University","2010","Total full-time Instruction/research/public service, Tenured, Associate professors","11","6","5","0","0","0","0","0","0","0","0","0","0","0","0","0","0","0","11","6","5","0","0","0","0","0","0","0","0","0","-2"
"152992","Briar Cliff University","2010","Total full-time Instruction/research/public service, Tenured, Assistant professors","3","1","2","0","0","0","0","0","0","0","0","0","0","0","0","0","0","0","3","1","2","0","0","0","0","0","0","0","0","0","-2"
"152992","Briar Cliff University","2010","Total full-time Instruction/research/public service, Tenured total","30","18","12","0","0","0","0","0","0","0","0","0","0","0","0","0","0","0","30","18","12","0","0","0","0","0","0","0","0","0","-2"
"152992","Briar Cliff University","2010","Total full-time Instruction/research/public service, Non-tenured on tenure track, Professors","1","0","1","0","0","0","0","0","0","0","0","0","0","0","0","0","0","0","1","0","1","0","0","0","0","0","0","0","0","0","-2"
"152992","Briar Cliff University","2010","Total full-time Instruction/research/public service, Non-tenured on tenure track, Associate professors","6","4","2","0","0","0","0","0","0","0","0","0","0","0","0","0","0","0","6","4","2","0","0","0","0","0","0","0","0","0","-2"
"152992","Briar Cliff University","2010","Total full-time Instruction/research/public service, Non-tenured on tenure track, Assistant professors","19","8","11","0","0","0","0","0","0","1","0","1","0","0","0","0","0","0","18","8","10","0","0","0","0","0","0","0","0","0","-2"
"152992","Briar Cliff University","2010","Total full-time Instruction/research/public service, Non-tenured on tenure track, Instructors","4","0","4","0","0","0","0","0","0","0","0","0","0","0","0","0","0","0","4","0","4","0","0","0","0","0","0","0","0","0","-2"
"152992","Briar Cliff University","2010","Total full-time Instruction/research/public service, Non-tenured on tenure track total","30","12","18","0","0","0","0","0","0","1","0","1","0","0","0","0","0","0","29","12","17","0","0","0","0","0","0","0","0","0","-2"
"152992","Briar Cliff University","2010","Total full-time Instruction/research/public service, Non-tenured not on tenure track, No academic rank","3","1","2","0","0","0","0","0","0","0","0","0","0","0","0","0","0","0","3","1","2","0","0","0","0","0","0","0","0","0","-2"
"152992","Briar Cliff University","2010","Total full-time Instruction/research/public service, Non-tenured not on tenure track total","3","1","2","0","0","0","0","0","0","0","0","0","0","0","0","0","0","0","3","1","2","0","0","0","0","0","0","0","0","0","-2"
"154721","Bethany College","2010","Total full-time Instruction/research/public service, Tenured, Professors","9","5","4","0","0","0","0","0","0","0","0","0","0","0","0","0","0","0","9","5","4","0","0","0","0","0","0","0","0","0","-2"
"154721","Bethany College","2010","Total full-time Instruction/research/public service, Tenured, Associate professors","14","9","5","0","0","0","0","0","0","0","0","0","0","0","0","0","0","0","14","9","5","0","0","0","0","0","0","0","0","0","-2"
"154721","Bethany College","2010","Total full-time Instruction/research/public service, Tenured total","23","14","9","0","0","0","0","0","0","0","0","0","0","0","0","0","0","0","23","14","9","0","0","0","0","0","0","0","0","0","-2"
"154721","Bethany College","2010","Total full-time Instruction/research/public service, Non-tenured on tenure track, Assistant professors","12","7","5","0","0","0","1","0","1","1","1","0","0","0","0","0","0","0","9","5","4","0","0","0","0","0","0","1","1","0","-2"
"154721","Bethany College","2010","Total full-time Instruction/research/public service, Non-tenured on tenure track total","12","7","5","0","0","0","1","0","1","1","1","0","0","0","0","0","0","0","9","5","4","0","0","0","0","0","0","1","1","0","-2"
"154721","Bethany College","2010","Total full-time Instruction/research/public service, Non-tenured not on tenure track, Associate professors","2","2","0","0","0","0","0","0","0","0","0","0","0","0","0","0","0","0","2","2","0","0","0","0","0","0","0","0","0","0","-2"
"154721","Bethany College","2010","Total full-time Instruction/research/public servicey, Non-tenured not on tenure track, Assistant professors","2","1","1","0","0","0","0","0","0","0","0","0","0","0","0","0","0","0","2","1","1","0","0","0","0","0","0","0","0","0","-2"
"154721","Bethany College","2010","Total full-time Instruction/research/public service, Non-tenured not on tenure track total","4","3","1","0","0","0","0","0","0","0","0","0","0","0","0","0","0","0","4","3","1","0","0","0","0","0","0","0","0","0","-2"
"159656","Loyola University New Orleans","2010","Total full-time Instruction/research/public service, Tenured, Professors","86","63","23","0","0","0","1","1","0","6","4","2","5","3","2","0","0","0","72","54","18","2","1","1","0","0","0","0","0","0","-2"
"159656","Loyola University New Orleans","2010","Total full-time Instruction/research/public service, Tenured, Associate professors","56","30","26","0","0","0","0","0","0","1","1","0","2","0","2","0","0","0","50","27","23","2","1","1","1","1","0","0","0","0","-2"
"159656","Loyola University New Orleans","2010","Total full-time Instruction/research/public service, Tenured total","142","93","49","0","0","0","1","1","0","7","5","2","7","3","4","0","0","0","122","81","41","4","2","2","1","1","0","0","0","0","-2"
"159656","Loyola University New Orleans","2010","Total full-time Instruction/research/public service, Non-tenured on tenure track, Professors","1","1","0","0","0","0","0","0","0","0","0","0","0","0","0","0","0","0","1","1","0","0","0","0","0","0","0","0","0","0","-2"
"159656","Loyola University New Orleans","2010","Total full-time Instruction/research/public service, Non-tenured on tenure track, Associate professors","19","13","6","0","0","0","1","1","0","2","1","1","2","1","1","0","0","0","13","9","4","0","0","0","0","0","0","1","1","0","-2"
"159656","Loyola University New Orleans","2010","Total full-time Instruction/research/public service, Non-tenured on tenure track, Assistant professors","55","27","28","0","0","0","0","0","0","3","0","3","3","2","1","0","0","0","44","22","22","0","0","0","3","2","1","2","1","1","-2"
"159656","Loyola University New Orleans","2010","Total full-time Instruction/research/public service, Non-tenured on tenure track, Instructors","1","0","1","0","0","0","0","0","0","0","0","0","0","0","0","0","0","0","0","0","0","0","0","0","1","0","1","0","0","0","-2"
"159656","Loyola University New Orleans","2010","Total full-time Instruction/research/public service, Non-tenured on tenure track total","76","41","35","0","0","0","1","1","0","5","1","4","5","3","2","0","0","0","58","32","26","0","0","0","4","2","2","3","2","1","-2"
"159656","Loyola University New Orleans","2010","Total full-time Instruction/research/public service, Non-tenured not on tenure track, Professors","2","0","2","0","0","0","0","0","0","1","0","1","1","0","1","0","0","0","0","0","0","0","0","0","0","0","0","0","0","0","-2"
"159656","Loyola University New Orleans","2010","Total full-time Instruction/research/public service, Non-tenured not on tenure track, Associate professors","2","0","2","0","0","0","0","0","0","0","0","0","0","0","0","0","0","0","2","0","2","0","0","0","0","0","0","0","0","0","-2"
"159656","Loyola University New Orleans","2010","Total full-time Instruction/research/public servicey, Non-tenured not on tenure track, Assistant professors","5","2","3","0","0","0","0","0","0","0","0","0","1","0","1","0","0","0","3","2","1","0","0","0","1","0","1","0","0","0","-2"
"159656","Loyola University New Orleans","2010","Total full-time Instruction/research/public service, Non-tenured not on tenure track, Lecturers","80","33","47","0","0","0","0","0","0","2","0","2","2","0","2","0","0","0","68","30","38","1","0","1","5","2","3","2","1","1","-2"
"159656","Loyola University New Orleans","2010","Total full-time Instruction/research/public service, Non-tenured not on tenure track total","89","35","54","0","0","0","0","0","0","3","0","3","4","0","4","0","0","0","73","32","41","1","0","1","6","2","4","2","1","1","-2"
"164447","American International College","2010","Total full-time Instruction/research/public service, Tenured, Professors","12","6","6","0","0","0","0","0","0","0","0","0","0","0","0","0","0","0","12","6","6","0","0","0","0","0","0","0","0","0","-2"
"164447","American International College","2010","Total full-time Instruction/research/public service, Tenured, Associate professors","18","9","9","0","0","0","0","0","0","0","0","0","0","0","0","0","0","0","18","9","9","0","0","0","0","0","0","0","0","0","-2"
"164447","American International College","2010","Total full-time Instruction/research/public service, Tenured, Assistant professors","5","3","2","0","0","0","0","0","0","0","0","0","0","0","0","0","0","0","5","3","2","0","0","0","0","0","0","0","0","0","-2"
"164447","American International College","2010","Total full-time Instruction/research/public service, Tenured total","35","18","17","0","0","0","0","0","0","0","0","0","0","0","0","0","0","0","35","18","17","0","0","0","0","0","0","0","0","0","-2"
"164447","American International College","2010","Total full-time Instruction/research/public service, Non-tenured on tenure track, Associate professors","4","0","4","0","0","0","0","0","0","0","0","0","0","0","0","0","0","0","4","0","4","0","0","0","0","0","0","0","0","0","-2"
"164447","American International College","2010","Total full-time Instruction/research/public service, Non-tenured on tenure track, Assistant professors","14","5","9","0","0","0","0","0","0","0","0","0","1","0","1","0","0","0","13","5","8","0","0","0","0","0","0","0","0","0","-2"
"164447","American International College","2010","Total full-time Instruction/research/public service, Non-tenured on tenure track, Instructors","3","1","2","0","0","0","0","0","0","1","1","0","0","0","0","0","0","0","2","0","2","0","0","0","0","0","0","0","0","0","-2"
"164447","American International College","2010","Total full-time Instruction/research/public service, Non-tenured on tenure track total","21","6","15","0","0","0","0","0","0","1","1","0","1","0","1","0","0","0","19","5","14","0","0","0","0","0","0","0","0","0","-2"
"164447","American International College","2010","Total full-time Instruction/research/public service, Non-tenured not on tenure track, Professors","1","1","0","0","0","0","0","0","0","0","0","0","0","0","0","0","0","0","1","1","0","0","0","0","0","0","0","0","0","0","-2"
"164447","American International College","2010","Total full-time Instruction/research/public service, Non-tenured not on tenure track, Associate professors","2","1","1","0","0","0","0","0","0","0","0","0","0","0","0","0","0","0","2","1","1","0","0","0","0","0","0","0","0","0","-2"
"164447","American International College","2010","Total full-time Instruction/research/public servicey, Non-tenured not on tenure track, Assistant professors","2","1","1","0","0","0","0","0","0","0","0","0","0","0","0","0","0","0","2","1","1","0","0","0","0","0","0","0","0","0","-2"
"164447","American International College","2010","Total full-time Instruction/research/public service, Non-tenured not on tenure track, Instructors","7","2","5","0","0","0","0","0","0","1","1","0","0","0","0","0","0","0","6","1","5","0","0","0","0","0","0","0","0","0","-2"
"164447","American International College","2010","Total full-time Instruction/research/public service, Non-tenured not on tenure track total","12","5","7","0","0","0","0","0","0","1","1","0","0","0","0","0","0","0","11","4","7","0","0","0","0","0","0","0","0","0","-2"
"164872","Boston Architectural College","2010","Total full-time Instruction/research/public service, Non-tenured not on tenure track, Instructors","13","9","4","0","0","0","0","0","0","0","0","0","3","2","1","0","0","0","10","7","3","0","0","0","0","0","0","0","0","0","-2"
"164872","Boston Architectural College","2010","Total full-time Instruction/research/public service, Non-tenured not on tenure track total","13","9","4","0","0","0","0","0","0","0","0","0","3","2","1","0","0","0","10","7","3","0","0","0","0","0","0","0","0","0","-2"
"165866","Framingham State University","2010","Total full-time Instruction/research/public service, Tenured, Professors","52","25","27","0","0","0","0","0","0","1","1","0","0","0","0","0","0","0","49","23","26","0","0","0","2","1","1","0","0","0","-2"
"165866","Framingham State University","2010","Total full-time Instruction/research/public service, Tenured, Associate professors","40","14","26","0","0","0","2","2","0","2","1","1","0","0","0","0","0","0","33","9","24","0","0","0","3","2","1","0","0","0","-2"
"165866","Framingham State University","2010","Total full-time Instruction/research/public service, Tenured, Assistant professors","12","6","6","0","0","0","1","1","0","0","0","0","0","0","0","0","0","0","11","5","6","0","0","0","0","0","0","0","0","0","-2"
"165866","Framingham State University","2010","Total full-time Instruction/research/public service, Tenured total","104","45","59","0","0","0","3","3","0","3","2","1","0","0","0","0","0","0","93","37","56","0","0","0","5","3","2","0","0","0","-2"
"165866","Framingham State University","2010","Total full-time Instruction/research/public service, Non-tenured on tenure track, Professors","1","0","1","0","0","0","0","0","0","0","0","0","0","0","0","0","0","0","1","0","1","0","0","0","0","0","0","0","0","0","-2"
"165866","Framingham State University","2010","Total full-time Instruction/research/public service, Non-tenured on tenure track, Associate professors","2","1","1","0","0","0","0","0","0","0","0","0","0","0","0","0","0","0","1","0","1","0","0","0","1","1","0","0","0","0","-2"
"165866","Framingham State University","2010","Total full-time Instruction/research/public service, Non-tenured on tenure track, Assistant professors","41","16","25","0","0","0","2","0","2","0","0","0","0","0","0","0","0","0","29","11","18","0","0","0","10","5","5","0","0","0","-2"
"165866","Framingham State University","2010","Total full-time Instruction/research/public service, Non-tenured on tenure track total","44","17","27","0","0","0","2","0","2","0","0","0","0","0","0","0","0","0","31","11","20","0","0","0","11","6","5","0","0","0","-2"
"165866","Framingham State University","2010","Total full-time Instruction/research/public service, Non-tenured not on tenure track, Professors","1","1","0","0","0","0","0","0","0","0","0","0","0","0","0","0","0","0","0","0","0","0","0","0","1","1","0","0","0","0","-2"
"165866","Framingham State University","2010","Total full-time Instruction/research/public service, Non-tenured not on tenure track, Associate professors","1","0","1","0","0","0","0","0","0","0","0","0","0","0","0","0","0","0","1","0","1","0","0","0","0","0","0","0","0","0","-2"
"165866","Framingham State University","2010","Total full-time Instruction/research/public servicey, Non-tenured not on tenure track, Assistant professors","7","4","3","0","0","0","0","0","0","1","1","0","0","0","0","0","0","0","3","1","2","0","0","0","3","2","1","0","0","0","-2"
"165866","Framingham State University","2010","Total full-time Instruction/research/public service, Non-tenured not on tenure track, Instructors","4","1","3","0","0","0","0","0","0","0","0","0","0","0","0","0","0","0","4","1","3","0","0","0","0","0","0","0","0","0","-2"
"165866","Framingham State University","2010","Total full-time Instruction/research/public service, Non-tenured not on tenure track, No academic rank","2","0","2","0","0","0","0","0","0","0","0","0","0","0","0","0","0","0","2","0","2","0","0","0","0","0","0","0","0","0","-2"
"165866","Framingham State University","2010","Total full-time Instruction/research/public service, Non-tenured not on tenure track total","15","6","9","0","0","0","0","0","0","1","1","0","0","0","0","0","0","0","10","2","8","0","0","0","4","3","1","0","0","0","-2"
"166638","University of Massachusetts-Boston","2010","Total full-time Instruction/research/public service, Tenured, Professors","119","78","41","1","0","1","11","10","1","5","5","0","4","2","2","0","0","0","97","60","37","0","0","0","1","1","0","0","0","0","-2"
"166638","University of Massachusetts-Boston","2010","Total full-time Instruction/research/public service, Tenured, Associate professors","138","73","65","0","0","0","16","9","7","14","5","9","8","4","4","0","0","0","95","51","44","0","0","0","4","4","0","1","0","1","-2"
"166638","University of Massachusetts-Boston","2010","Total full-time Instruction/research/public service, Tenured, Assistant professors","2","1","1","0","0","0","1","1","0","0","0","0","0","0","0","0","0","0","1","0","1","0","0","0","0","0","0","0","0","0","-2"
"166638","University of Massachusetts-Boston","2010","Total full-time Instruction/research/public service, Tenured total","259","152","107","1","0","1","28","20","8","19","10","9","12","6","6","0","0","0","193","111","82","0","0","0","5","5","0","1","0","1","-2"
"166638","University of Massachusetts-Boston","2010","Total full-time Instruction/research/public service, Non-tenured on tenure track, Associate professors","9","5","4","0","0","0","1","1","0","0","0","0","0","0","0","0","0","0","8","4","4","0","0","0","0","0","0","0","0","0","-2"
"166638","University of Massachusetts-Boston","2010","Total full-time Instruction/research/public service, Non-tenured on tenure track, Assistant professors","134","56","78","0","0","0","26","16","10","6","1","5","7","2","5","0","0","0","78","30","48","0","0","0","9","4","5","8","3","5","-2"
"166638","University of Massachusetts-Boston","2010","Total full-time Instruction/research/public service, Non-tenured on tenure track, Lecturers","1","0","1","0","0","0","0","0","0","1","0","1","0","0","0","0","0","0","0","0","0","0","0","0","0","0","0","0","0","0","-2"
"166638","University of Massachusetts-Boston","2010","Total full-time Instruction/research/public service, Non-tenured on tenure track total","144","61","83","0","0","0","27","17","10","7","1","6","7","2","5","0","0","0","86","34","52","0","0","0","9","4","5","8","3","5","-2"
"166638","University of Massachusetts-Boston","2010","Total full-time Instruction/research/public service, Non-tenured not on tenure track, Professors","2","0","2","0","0","0","0","0","0","0","0","0","0","0","0","0","0","0","2","0","2","0","0","0","0","0","0","0","0","0","-2"
"166638","University of Massachusetts-Boston","2010","Total full-time Instruction/research/public service, Non-tenured not on tenure track, Associate professors","1","0","1","0","0","0","0","0","0","0","0","0","0","0","0","0","0","0","1","0","1","0","0","0","0","0","0","0","0","0","-2"
"166638","University of Massachusetts-Boston","2010","Total full-time Instruction/research/public service, Non-tenured not on tenure track, Instructors","1","1","0","0","0","0","0","0","0","0","0","0","0","0","0","0","0","0","1","1","0","0","0","0","0","0","0","0","0","0","-2"
"166638","University of Massachusetts-Boston","2010","Total full-time Instruction/research/public service, Non-tenured not on tenure track, Lecturers","118","50","68","0","0","0","6","3","3","7","5","2","1","1","0","0","0","0","97","37","60","1","1","0","5","2","3","1","1","0","-2"
"166638","University of Massachusetts-Boston","2010","Total full-time Instruction/research/public service, Non-tenured not on tenure track total","122","51","71","0","0","0","6","3","3","7","5","2","1","1","0","0","0","0","101","38","63","1","1","0","5","2","3","1","1","0","-2"
"167455","Pine Manor College","2010","Total full-time Instruction/research/public service, Tenured, Professors","11","3","8","0","0","0","1","1","0","0","0","0","0","0","0","0","0","0","10","2","8","0","0","0","0","0","0","0","0","0","-2"
"167455","Pine Manor College","2010","Total full-time Instruction/research/public service, Tenured, Associate professors","4","1","3","0","0","0","1","0","1","0","0","0","0","0","0","0","0","0","3","1","2","0","0","0","0","0","0","0","0","0","-2"
"167455","Pine Manor College","2010","Total full-time Instruction/research/public service, Tenured total","15","4","11","0","0","0","2","1","1","0","0","0","0","0","0","0","0","0","13","3","10","0","0","0","0","0","0","0","0","0","-2"
"167455","Pine Manor College","2010","Total full-time Instruction/research/public service, Non-tenured on tenure track, Associate professors","2","1","1","0","0","0","0","0","0","0","0","0","0","0","0","0","0","0","2","1","1","0","0","0","0","0","0","0","0","0","-2"
"167455","Pine Manor College","2010","Total full-time Instruction/research/public service, Non-tenured on tenure track, Assistant professors","5","3","2","0","0","0","0","0","0","1","0","1","0","0","0","0","0","0","4","3","1","0","0","0","0","0","0","0","0","0","-2"
"167455","Pine Manor College","2010","Total full-time Instruction/research/public service, Non-tenured on tenure track total","7","4","3","0","0","0","0","0","0","1","0","1","0","0","0","0","0","0","6","4","2","0","0","0","0","0","0","0","0","0","-2"
"167455","Pine Manor College","2010","Total full-time Instruction/research/public servicey, Non-tenured not on tenure track, Assistant professors","6","0","6","0","0","0","0","0","0","0","0","0","0","0","0","0","0","0","6","0","6","0","0","0","0","0","0","0","0","0","-2"
"167455","Pine Manor College","2010","Total full-time Instruction/research/public service, Non-tenured not on tenure track total","6","0","6","0","0","0","0","0","0","0","0","0","0","0","0","0","0","0","6","0","6","0","0","0","0","0","0","0","0","0","-2"
"167729","Salem State University","2010","Total full-time Instruction/research/public service, Tenured, Professors","126","62","64","0","0","0","3","2","1","1","1","0","2","1","1","0","0","0","120","58","62","0","0","0","0","0","0","0","0","0","-2"
"167729","Salem State University","2010","Total full-time Instruction/research/public service, Tenured, Associate professors","90","44","46","0","0","0","6","3","3","2","1","1","0","0","0","0","0","0","77","38","39","0","0","0","4","1","3","1","1","0","-2"
"167729","Salem State University","2010","Total full-time Instruction/research/public service, Tenured, Assistant professors","14","6","8","0","0","0","1","1","0","0","0","0","0","0","0","0","0","0","12","4","8","0","0","0","1","1","0","0","0","0","-2"
"167729","Salem State University","2010","Total full-time Instruction/research/public service, Tenured total","230","112","118","0","0","0","10","6","4","3","2","1","2","1","1","0","0","0","209","100","109","0","0","0","5","2","3","1","1","0","-2"
"167729","Salem State University","2010","Total full-time Instruction/research/public service, Non-tenured on tenure track, Associate professors","3","2","1","0","0","0","0","0","0","0","0","0","0","0","0","0","0","0","3","2","1","0","0","0","0","0","0","0","0","0","-2"
"167729","Salem State University","2010","Total full-time Instruction/research/public service, Non-tenured on tenure track, Assistant professors","86","36","50","0","0","0","7","5","2","5","2","3","5","2","3","0","0","0","61","25","36","0","0","0","4","1","3","4","1","3","-2"
"167729","Salem State University","2010","Total full-time Instruction/research/public service, Non-tenured on tenure track, Instructors","6","1","5","0","0","0","0","0","0","0","0","0","1","0","1","0","0","0","5","1","4","0","0","0","0","0","0","0","0","0","-2"
"167729","Salem State University","2010","Total full-time Instruction/research/public service, Non-tenured on tenure track total","95","39","56","0","0","0","7","5","2","5","2","3","6","2","4","0","0","0","69","28","41","0","0","0","4","1","3","4","1","3","-2"
"167729","Salem State University","2010","Total full-time Instruction/research/public servicey, Non-tenured not on tenure track, Assistant professors","4","2","2","0","0","0","1","0","1","0","0","0","0","0","0","0","0","0","3","2","1","0","0","0","0","0","0","0","0","0","-2"
"167729","Salem State University","2010","Total full-time Instruction/research/public service, Non-tenured not on tenure track, Instructors","4","1","3","0","0","0","0","0","0","0","0","0","0","0","0","0","0","0","4","1","3","0","0","0","0","0","0","0","0","0","-2"
"167729","Salem State University","2010","Total full-time Instruction/research/public service, Non-tenured not on tenure track total","8","3","5","0","0","0","1","0","1","0","0","0","0","0","0","0","0","0","7","3","4","0","0","0","0","0","0","0","0","0","-2"
"168740","Andrews University","2010","Total full-time Instruction/research/public service, Tenured, Professors","60","51","9","0","0","0","3","3","0","6","5","1","3","3","0","0","0","0","48","40","8","0","0","0","0","0","0","0","0","0","-2"
"168740","Andrews University","2010","Total full-time Instruction/research/public service, Tenured, Associate professors","18","10","8","0","0","0","2","2","0","3","2","1","0","0","0","0","0","0","12","5","7","0","0","0","0","0","0","1","1","0","-2"
"168740","Andrews University","2010","Total full-time Instruction/research/public service, Tenured, Assistant professors","2","2","0","0","0","0","0","0","0","0","0","0","0","0","0","0","0","0","2","2","0","0","0","0","0","0","0","0","0","0","-2"
"168740","Andrews University","2010","Total full-time Instruction/research/public service, Tenured total","80","63","17","0","0","0","5","5","0","9","7","2","3","3","0","0","0","0","62","47","15","0","0","0","0","0","0","1","1","0","-2"
"168740","Andrews University","2010","Total full-time Instruction/research/public service, Non-tenured on tenure track, Professors","18","14","4","0","0","0","2","2","0","2","1","1","2","2","0","0","0","0","11","8","3","0","0","0","0","0","0","1","1","0","-2"
"168740","Andrews University","2010","Total full-time Instruction/research/public service, Non-tenured on tenure track, Associate professors","42","28","14","0","0","0","1","0","1","5","3","2","4","4","0","0","0","0","26","17","9","1","1","0","0","0","0","5","3","2","-2"
"168740","Andrews University","2010","Total full-time Instruction/research/public service, Non-tenured on tenure track, Assistant professors","27","10","17","0","0","0","3","2","1","6","1","5","0","0","0","0","0","0","17","6","11","1","1","0","0","0","0","0","0","0","-2"
"168740","Andrews University","2010","Total full-time Instruction/research/public service, Non-tenured on tenure track total","87","52","35","0","0","0","6","4","2","13","5","8","6","6","0","0","0","0","54","31","23","2","2","0","0","0","0","6","4","2","-2"
"168740","Andrews University","2010","Total full-time Instruction/research/public service, Non-tenured not on tenure track, Professors","2","1","1","0","0","0","0","0","0","0","0","0","0","0","0","0","0","0","2","1","1","0","0","0","0","0","0","0","0","0","-2"
"168740","Andrews University","2010","Total full-time Instruction/research/public service, Non-tenured not on tenure track, Associate professors","10","6","4","0","0","0","0","0","0","0","0","0","1","1","0","0","0","0","8","5","3","0","0","0","0","0","0","1","0","1","-2"
"168740","Andrews University","2010","Total full-time Instruction/research/public servicey, Non-tenured not on tenure track, Assistant professors","37","17","20","0","0","0","1","0","1","4","1","3","2","1","1","0","0","0","27","13","14","0","0","0","0","0","0","3","2","1","-2"
"168740","Andrews University","2010","Total full-time Instruction/research/public service, Non-tenured not on tenure track, Instructors","11","6","5","0","0","0","0","0","0","0","0","0","2","2","0","0","0","0","8","3","5","0","0","0","0","0","0","1","1","0","-2"
"168740","Andrews University","2010","Total full-time Instruction/research/public service, Non-tenured not on tenure track total","60","30","30","0","0","0","1","0","1","4","1","3","5","4","1","0","0","0","45","22","23","0","0","0","0","0","0","5","3","2","-2"
"182306","Great Basin College","2010","Total full-time Instruction/research/public service, Tenured, Professors","38","20","18","0","0","0","1","1","0","1","0","1","3","2","1","0","0","0","33","17","16","0","0","0","0","0","0","0","0","0","-2"
"182306","Great Basin College","2010","Total full-time Instruction/research/public service, Tenured total","38","20","18","0","0","0","1","1","0","1","0","1","3","2","1","0","0","0","33","17","16","0","0","0","0","0","0","0","0","0","-2"
"182306","Great Basin College","2010","Total full-time Instruction/research/public service, Non-tenured on tenure track, Instructors","8","3","5","0","0","0","0","0","0","0","0","0","0","0","0","0","0","0","8","3","5","0","0","0","0","0","0","0","0","0","-2"
"182306","Great Basin College","2010","Total full-time Instruction/research/public service, Non-tenured on tenure track total","8","3","5","0","0","0","0","0","0","0","0","0","0","0","0","0","0","0","8","3","5","0","0","0","0","0","0","0","0","0","-2"
"182306","Great Basin College","2010","Total full-time Instruction/research/public service, Non-tenured not on tenure track, Instructors","18","11","7","0","0","0","0","0","0","0","0","0","0","0","0","0","0","0","18","11","7","0","0","0","0","0","0","0","0","0","-2"
"182306","Great Basin College","2010","Total full-time Instruction/research/public service, Non-tenured not on tenure track total","18","11","7","0","0","0","0","0","0","0","0","0","0","0","0","0","0","0","18","11","7","0","0","0","0","0","0","0","0","0","-2"
"182564","Western Nevada College","2010","Total full-time Instruction/research/public service, Tenured, Professors","50","26","24","0","0","0","0","0","0","0","0","0","2","2","0","0","0","0","48","24","24","0","0","0","0","0","0","0","0","0","-2"
"182564","Western Nevada College","2010","Total full-time Instruction/research/public service, Tenured total","50","26","24","0","0","0","0","0","0","0","0","0","2","2","0","0","0","0","48","24","24","0","0","0","0","0","0","0","0","0","-2"
"182564","Western Nevada College","2010","Total full-time Instruction/research/public service, Non-tenured on tenure track, Instructors","6","4","2","0","0","0","0","0","0","0","0","0","2","1","1","0","0","0","4","3","1","0","0","0","0","0","0","0","0","0","-2"
"182564","Western Nevada College","2010","Total full-time Instruction/research/public service, Non-tenured on tenure track total","6","4","2","0","0","0","0","0","0","0","0","0","2","1","1","0","0","0","4","3","1","0","0","0","0","0","0","0","0","0","-2"
"182564","Western Nevada College","2010","Total full-time Instruction/research/public service, Non-tenured not on tenure track, Instructors","5","3","2","0","0","0","0","0","0","0","0","0","0","0","0","0","0","0","5","3","2","0","0","0","0","0","0","0","0","0","-2"
"182564","Western Nevada College","2010","Total full-time Instruction/research/public service, Non-tenured not on tenure track total","5","3","2","0","0","0","0","0","0","0","0","0","0","0","0","0","0","0","5","3","2","0","0","0","0","0","0","0","0","0","-2"
"184694","Fairleigh Dickinson University-Florham Campus","2010","Total full-time Instruction/research/public service, Tenured, Professors","28","23","5","0","0","0","3","3","0","0","0","0","1","0","1","0","0","0","24","20","4","0","0","0","0","0","0","0","0","0","-2"
"184694","Fairleigh Dickinson University-Florham Campus","2010","Total full-time Instruction/research/public service, Tenured, Associate professors","36","23","13","0","0","0","5","2","3","2","1","1","1","1","0","0","0","0","28","19","9","0","0","0","0","0","0","0","0","0","-2"
"184694","Fairleigh Dickinson University-Florham Campus","2010","Total full-time Instruction/research/public service, Tenured, Assistant professors","3","3","0","0","0","0","1","1","0","0","0","0","0","0","0","0","0","0","2","2","0","0","0","0","0","0","0","0","0","0","-2"
"184694","Fairleigh Dickinson University-Florham Campus","2010","Total full-time Instruction/research/public service, Tenured total","67","49","18","0","0","0","9","6","3","2","1","1","2","1","1","0","0","0","54","41","13","0","0","0","0","0","0","0","0","0","-2"
"184694","Fairleigh Dickinson University-Florham Campus","2010","Total full-time Instruction/research/public service, Non-tenured on tenure track, Professors","1","1","0","0","0","0","0","0","0","0","0","0","0","0","0","0","0","0","1","1","0","0","0","0","0","0","0","0","0","0","-2"
"184694","Fairleigh Dickinson University-Florham Campus","2010","Total full-time Instruction/research/public service, Non-tenured on tenure track, Associate professors","5","3","2","0","0","0","1","1","0","0","0","0","0","0","0","0","0","0","4","2","2","0","0","0","0","0","0","0","0","0","-2"
"184694","Fairleigh Dickinson University-Florham Campus","2010","Total full-time Instruction/research/public service, Non-tenured on tenure track, Assistant professors","34","15","19","0","0","0","0","0","0","0","0","0","2","1","1","0","0","0","32","14","18","0","0","0","0","0","0","0","0","0","-2"
"184694","Fairleigh Dickinson University-Florham Campus","2010","Total full-time Instruction/research/public service, Non-tenured on tenure track, Lecturers","1","1","0","0","0","0","0","0","0","0","0","0","0","0","0","0","0","0","0","0","0","0","0","0","1","1","0","0","0","0","-2"
"184694","Fairleigh Dickinson University-Florham Campus","2010","Total full-time Instruction/research/public service, Non-tenured on tenure track total","41","20","21","0","0","0","1","1","0","0","0","0","2","1","1","0","0","0","37","17","20","0","0","0","1","1","0","0","0","0","-2"
"184694","Fairleigh Dickinson University-Florham Campus","2010","Total full-time Instruction/research/public service, Non-tenured not on tenure track, Lecturers","21","9","12","0","0","0","0","0","0","2","1","1","2","0","2","0","0","0","16","7","9","0","0","0","1","1","0","0","0","0","-2"
"184694","Fairleigh Dickinson University-Florham Campus","2010","Total full-time Instruction/research/public service, Non-tenured not on tenure track total","21","9","12","0","0","0","0","0","0","2","1","1","2","0","2","0","0","0","16","7","9","0","0","0","1","1","0","0","0","0","-2"
"185828","New Jersey Institute of Technology","2010","Total full-time Instruction/research/public service, Tenured, Professors","141","126","15","1","1","0","33","33","0","3","3","0","1","1","0","0","0","0","97","83","14","0","0","0","5","4","1","1","1","0","-2"
"185828","New Jersey Institute of Technology","2010","Total full-time Instruction/research/public service, Tenured, Associate professors","93","75","18","0","0","0","18","15","3","8","5","3","3","2","1","0","0","0","53","44","9","0","0","0","10","9","1","1","0","1","-2"
"185828","New Jersey Institute of Technology","2010","Total full-time Instruction/research/public service, Tenured total","234","201","33","1","1","0","51","48","3","11","8","3","4","3","1","0","0","0","150","127","23","0","0","0","15","13","2","2","1","1","-2"
"185828","New Jersey Institute of Technology","2010","Total full-time Instruction/research/public service, Non-tenured on tenure track, Associate professors","5","4","1","0","0","0","0","0","0","0","0","0","0","0","0","0","0","0","4","4","0","0","0","0","0","0","0","1","0","1","-2"
"185828","New Jersey Institute of Technology","2010","Total full-time Instruction/research/public service, Non-tenured on tenure track, Assistant professors","43","35","8","0","0","0","12","8","4","0","0","0","1","1","0","0","0","0","20","17","3","1","1","0","0","0","0","9","8","1","-2"
"185828","New Jersey Institute of Technology","2010","Total full-time Instruction/research/public service, Non-tenured on tenure track total","48","39","9","0","0","0","12","8","4","0","0","0","1","1","0","0","0","0","24","21","3","1","1","0","0","0","0","10","8","2","-2"
"185828","New Jersey Institute of Technology","2010","Total full-time Instruction/research/public service, Non-tenured not on tenure track, Instructors","7","4","3","0","0","0","0","0","0","0","0","0","0","0","0","0","0","0","6","4","2","0","0","0","0","0","0","1","0","1","-2"
"185828","New Jersey Institute of Technology","2010","Total full-time Instruction/research/public service, Non-tenured not on tenure track, Lecturers","85","58","27","0","0","0","8","7","1","4","3","1","3","2","1","0","0","0","57","33","24","0","0","0","10","10","0","3","3","0","-2"
"185828","New Jersey Institute of Technology","2010","Total full-time Instruction/research/public service, Non-tenured not on tenure track, No academic rank","24","20","4","0","0","0","1","1","0","1","1","0","0","0","0","0","0","0","14","12","2","0","0","0","3","3","0","5","3","2","-2"
"185828","New Jersey Institute of Technology","2010","Total full-time Instruction/research/public service, Non-tenured not on tenure track total","116","82","34","0","0","0","9","8","1","5","4","1","3","2","1","0","0","0","77","49","28","0","0","0","13","13","0","9","6","3","-2"
"186371","Rutgers University-Camden","2010","Total full-time Instruction/research/public service, Tenured, Professors","85","65","20","0","0","0","11","11","0","0","0","0","2","1","1","0","0","0","68","49","19","0","0","0","0","0","0","4","4","0","-2"
"186371","Rutgers University-Camden","2010","Total full-time Instruction/research/public service, Tenured, Associate professors","75","42","33","0","0","0","12","11","1","3","1","2","0","0","0","0","0","0","55","30","25","0","0","0","1","0","1","4","0","4","-2"
"186371","Rutgers University-Camden","2010","Total full-time Instruction/research/public service, Tenured total","160","107","53","0","0","0","23","22","1","3","1","2","2","1","1","0","0","0","123","79","44","0","0","0","1","0","1","8","4","4","-2"
"186371","Rutgers University-Camden","2010","Total full-time Instruction/research/public service, Non-tenured on tenure track, Professors","1","1","0","0","0","0","0","0","0","0","0","0","0","0","0","0","0","0","1","1","0","0","0","0","0","0","0","0","0","0","-2"
"186371","Rutgers University-Camden","2010","Total full-time Instruction/research/public service, Non-tenured on tenure track, Associate professors","2","2","0","0","0","0","0","0","0","0","0","0","0","0","0","0","0","0","1","1","0","0","0","0","0","0","0","1","1","0","-2"
"186371","Rutgers University-Camden","2010","Total full-time Instruction/research/public service, Non-tenured on tenure track, Assistant professors","46","28","18","0","0","0","4","4","0","2","2","0","2","2","0","0","0","0","33","17","16","0","0","0","2","1","1","3","2","1","-2"
"186371","Rutgers University-Camden","2010","Total full-time Instruction/research/public service, Non-tenured on tenure track total","49","31","18","0","0","0","4","4","0","2","2","0","2","2","0","0","0","0","35","19","16","0","0","0","2","1","1","4","3","1","-2"
"186371","Rutgers University-Camden","2010","Total full-time Instruction/research/public service, Non-tenured not on tenure track, Professors","7","3","4","0","0","0","0","0","0","0","0","0","0","0","0","0","0","0","7","3","4","0","0","0","0","0","0","0","0","0","-2"
"186371","Rutgers University-Camden","2010","Total full-time Instruction/research/public service, Non-tenured not on tenure track, Associate professors","11","3","8","0","0","0","0","0","0","0","0","0","1","0","1","0","0","0","10","3","7","0","0","0","0","0","0","0","0","0","-2"
"186371","Rutgers University-Camden","2010","Total full-time Instruction/research/public servicey, Non-tenured not on tenure track, Assistant professors","9","5","4","0","0","0","1","0","1","1","0","1","0","0","0","0","0","0","7","5","2","0","0","0","0","0","0","0","0","0","-2"
"186371","Rutgers University-Camden","2010","Total full-time Instruction/research/public service, Non-tenured not on tenure track, Instructors","19","6","13","0","0","0","1","1","0","1","0","1","0","0","0","0","0","0","16","5","11","0","0","0","0","0","0","1","0","1","-2"
"186371","Rutgers University-Camden","2010","Total full-time Instruction/research/public service, Non-tenured not on tenure track, No academic rank","1","1","0","0","0","0","0","0","0","1","1","0","0","0","0","0","0","0","0","0","0","0","0","0","0","0","0","0","0","0","-2"
"186371","Rutgers University-Camden","2010","Total full-time Instruction/research/public service, Non-tenured not on tenure track total","47","18","29","0","0","0","2","1","1","3","1","2","1","0","1","0","0","0","40","16","24","0","0","0","0","0","0","1","0","1","-2"
"188429","Adelphi University","2010","Total full-time Instruction/research/public service, Tenured, Professors","74","56","18","0","0","0","5","2","3","2","1","1","2","1","1","0","0","0","65","52","13","0","0","0","0","0","0","0","0","0","-2"
"188429","Adelphi University","2010","Total full-time Instruction/research/public service, Tenured, Associate professors","91","42","49","0","0","0","7","5","2","7","2","5","2","2","0","0","0","0","75","33","42","0","0","0","0","0","0","0","0","0","-2"
"188429","Adelphi University","2010","Total full-time Instruction/research/public service, Tenured, Assistant professors","3","2","1","0","0","0","0","0","0","0","0","0","0","0","0","0","0","0","3","2","1","0","0","0","0","0","0","0","0","0","-2"
"188429","Adelphi University","2010","Total full-time Instruction/research/public service, Tenured total","168","100","68","0","0","0","12","7","5","9","3","6","4","3","1","0","0","0","143","87","56","0","0","0","0","0","0","0","0","0","-2"
"188429","Adelphi University","2010","Total full-time Instruction/research/public service, Non-tenured on tenure track, Associate professors","12","2","10","0","0","0","1","0","1","1","0","1","0","0","0","0","0","0","10","2","8","0","0","0","0","0","0","0","0","0","-2"
"188429","Adelphi University","2010","Total full-time Instruction/research/public service, Non-tenured on tenure track, Assistant professors","99","36","63","0","0","0","14","5","9","7","1","6","4","0","4","0","0","0","74","30","44","0","0","0","0","0","0","0","0","0","-2"
"188429","Adelphi University","2010","Total full-time Instruction/research/public service, Non-tenured on tenure track, Lecturers","5","4","1","0","0","0","0","0","0","0","0","0","0","0","0","0","0","0","5","4","1","0","0","0","0","0","0","0","0","0","-2"
"188429","Adelphi University","2010","Total full-time Instruction/research/public service, Non-tenured on tenure track total","116","42","74","0","0","0","15","5","10","8","1","7","4","0","4","0","0","0","89","36","53","0","0","0","0","0","0","0","0","0","-2"
"188429","Adelphi University","2010","Total full-time Instruction/research/public service, Non-tenured not on tenure track, No academic rank","27","6","21","0","0","0","0","0","0","3","1","2","1","0","1","0","0","0","23","5","18","0","0","0","0","0","0","0","0","0","-2"
"188429","Adelphi University","2010","Total full-time Instruction/research/public service, Non-tenured not on tenure track total","27","6","21","0","0","0","0","0","0","3","1","2","1","0","1","0","0","0","23","5","18","0","0","0","0","0","0","0","0","0","-2"
"190503","Culinary Institute of America","2010","Total full-time Instruction/research/public service, Non-tenured not on tenure track, Professors","14","12","2","0","0","0","1","0","1","0","0","0","1","0","1","0","0","0","11","11","0","1","1","0","0","0","0","0","0","0","-2"
"190503","Culinary Institute of America","2010","Total full-time Instruction/research/public service, Non-tenured not on tenure track, Associate professors","51","38","13","0","0","0","0","0","0","1","0","1","1","1","0","0","0","0","47","37","10","0","0","0","2","0","2","0","0","0","-2"
"190503","Culinary Institute of America","2010","Total full-time Instruction/research/public servicey, Non-tenured not on tenure track, Assistant professors","41","29","12","0","0","0","0","0","0","0","0","0","3","2","1","0","0","0","35","25","10","1","1","0","2","1","1","0","0","0","-2"
"190503","Culinary Institute of America","2010","Total full-time Instruction/research/public service, Non-tenured not on tenure track, Instructors","43","34","9","0","0","0","2","1","1","2","2","0","0","0","0","1","1","0","28","23","5","0","0","0","10","7","3","0","0","0","-2"
"190503","Culinary Institute of America","2010","Total full-time Instruction/research/public service, Non-tenured not on tenure track total","149","113","36","0","0","0","3","1","2","3","2","1","5","3","2","1","1","0","121","96","25","2","2","0","14","8","6","0","0","0","-2"
"190512","CUNY Bernard M Baruch College","2010","Total full-time Instruction/research/public service, Tenured, Professors","182","134","48","0","0","0","23","20","3","6","4","2","8","3","5","0","0","0","145","107","38","0","0","0","0","0","0","0","0","0","-2"
"190512","CUNY Bernard M Baruch College","2010","Total full-time Instruction/research/public service, Tenured, Associate professors","138","79","59","0","0","0","17","14","3","12","5","7","3","1","2","0","0","0","101","55","46","0","0","0","0","0","0","5","4","1","-2"
"190512","CUNY Bernard M Baruch College","2010","Total full-time Instruction/research/public service, Tenured, Assistant professors","15","8","7","0","0","0","1","1","0","0","0","0","2","0","2","0","0","0","12","7","5","0","0","0","0","0","0","0","0","0","-2"
"190512","CUNY Bernard M Baruch College","2010","Total full-time Instruction/research/public service, Tenured, Lecturers","16","10","6","0","0","0","1","1","0","3","1","2","1","1","0","0","0","0","11","7","4","0","0","0","0","0","0","0","0","0","-2"
"190512","CUNY Bernard M Baruch College","2010","Total full-time Instruction/research/public service, Tenured total","351","231","120","0","0","0","42","36","6","21","10","11","14","5","9","0","0","0","269","176","93","0","0","0","0","0","0","5","4","1","-2"
"190512","CUNY Bernard M Baruch College","2010","Total full-time Instruction/research/public service, Non-tenured on tenure track, Professors","2","1","1","0","0","0","1","0","1","0","0","0","0","0","0","0","0","0","1","1","0","0","0","0","0","0","0","0","0","0","-2"
"190512","CUNY Bernard M Baruch College","2010","Total full-time Instruction/research/public service, Non-tenured on tenure track, Associate professors","10","6","4","0","0","0","0","0","0","1","0","1","0","0","0","0","0","0","6","3","3","0","0","0","0","0","0","3","3","0","-2"
"190512","CUNY Bernard M Baruch College","2010","Total full-time Instruction/research/public service, Non-tenured on tenure track, Assistant professors","89","46","43","0","0","0","18","10","8","2","1","1","3","2","1","0","0","0","42","21","21","0","0","0","0","0","0","24","12","12","-2"
"190512","CUNY Bernard M Baruch College","2010","Total full-time Instruction/research/public service, Non-tenured on tenure track, Lecturers","28","15","13","0","0","0","4","2","2","3","0","3","1","1","0","0","0","0","20","12","8","0","0","0","0","0","0","0","0","0","-2"
"190512","CUNY Bernard M Baruch College","2010","Total full-time Instruction/research/public service, Non-tenured on tenure track total","129","68","61","0","0","0","23","12","11","6","1","5","4","3","1","0","0","0","69","37","32","0","0","0","0","0","0","27","15","12","-2"
"190512","CUNY Bernard M Baruch College","2010","Total full-time Instruction/research/public service, Non-tenured not on tenure track, Professors","15","11","4","0","0","0","0","0","0","3","1","2","0","0","0","0","0","0","12","10","2","0","0","0","0","0","0","0","0","0","-2"
"190512","CUNY Bernard M Baruch College","2010","Total full-time Instruction/research/public service, Non-tenured not on tenure track, Associate professors","1","1","0","0","0","0","0","0","0","0","0","0","0","0","0","0","0","0","0","0","0","0","0","0","0","0","0","1","1","0","-2"
"190512","CUNY Bernard M Baruch College","2010","Total full-time Instruction/research/public servicey, Non-tenured not on tenure track, Assistant professors","7","3","4","0","0","0","0","0","0","1","0","1","0","0","0","0","0","0","5","2","3","0","0","0","0","0","0","1","1","0","-2"
"190512","CUNY Bernard M Baruch College","2010","Total full-time Instruction/research/public service, Non-tenured not on tenure track, Instructors","8","5","3","0","0","0","0","0","0","2","1","1","1","1","0","0","0","0","2","1","1","0","0","0","0","0","0","3","2","1","-2"
"190512","CUNY Bernard M Baruch College","2010","Total full-time Instruction/research/public service, Non-tenured not on tenure track, Lecturers","11","6","5","0","0","0","0","0","0","1","0","1","1","0","1","0","0","0","9","6","3","0","0","0","0","0","0","0","0","0","-2"
"190512","CUNY Bernard M Baruch College","2010","Total full-time Instruction/research/public service, Non-tenured not on tenure track total","42","26","16","0","0","0","0","0","0","7","2","5","2","1","1","0","0","0","28","19","9","0","0","0","0","0","0","5","4","1","-2"
"190549","CUNY Brooklyn College","2010","Total full-time Instruction/research/public service, Tenured, Professors","187","122","65","0","0","0","10","9","1","8","6","2","9","5","4","0","0","0","160","102","58","0","0","0","0","0","0","0","0","0","-2"
"190549","CUNY Brooklyn College","2010","Total full-time Instruction/research/public service, Tenured, Associate professors","127","72","55","2","1","1","13","10","3","7","6","1","6","2","4","0","0","0","98","52","46","0","0","0","0","0","0","1","1","0","-2"
"190549","CUNY Brooklyn College","2010","Total full-time Instruction/research/public service, Tenured, Assistant professors","26","12","14","0","0","0","6","2","4","4","1","3","2","0","2","0","0","0","12","7","5","0","0","0","0","0","0","2","2","0","-2"
"190549","CUNY Brooklyn College","2010","Total full-time Instruction/research/public service, Tenured, Lecturers","8","7","1","0","0","0","1","0","1","3","3","0","2","2","0","0","0","0","2","2","0","0","0","0","0","0","0","0","0","0","-2"
"190549","CUNY Brooklyn College","2010","Total full-time Instruction/research/public service, Tenured total","348","213","135","2","1","1","30","21","9","22","16","6","19","9","10","0","0","0","272","163","109","0","0","0","0","0","0","3","3","0","-2"
"190549","CUNY Brooklyn College","2010","Total full-time Instruction/research/public service, Non-tenured on tenure track, Professors","1","1","0","0","0","0","0","0","0","0","0","0","0","0","0","0","0","0","1","1","0","0","0","0","0","0","0","0","0","0","-2"
"190549","CUNY Brooklyn College","2010","Total full-time Instruction/research/public service, Non-tenured on tenure track, Associate professors","12","9","3","0","0","0","1","1","0","1","1","0","0","0","0","0","0","0","10","7","3","0","0","0","0","0","0","0","0","0","-2"
"190549","CUNY Brooklyn College","2010","Total full-time Instruction/research/public service, Non-tenured on tenure track, Assistant professors","110","45","65","0","0","0","14","6","8","10","4","6","10","4","6","1","1","0","66","25","41","0","0","0","0","0","0","9","5","4","-2"
"190549","CUNY Brooklyn College","2010","Total full-time Instruction/research/public service, Non-tenured on tenure track, Lecturers","26","12","14","0","0","0","1","0","1","0","0","0","2","0","2","0","0","0","23","12","11","0","0","0","0","0","0","0","0","0","-2"
"190549","CUNY Brooklyn College","2010","Total full-time Instruction/research/public service, Non-tenured on tenure track total","149","67","82","0","0","0","16","7","9","11","5","6","12","4","8","1","1","0","100","45","55","0","0","0","0","0","0","9","5","4","-2"
"190549","CUNY Brooklyn College","2010","Total full-time Instruction/research/public service, Non-tenured not on tenure track, Professors","6","6","0","0","0","0","0","0","0","1","1","0","0","0","0","0","0","0","3","3","0","0","0","0","0","0","0","2","2","0","-2"
"190549","CUNY Brooklyn College","2010","Total full-time Instruction/research/public servicey, Non-tenured not on tenure track, Assistant professors","5","2","3","0","0","0","0","0","0","0","0","0","1","0","1","0","0","0","4","2","2","0","0","0","0","0","0","0","0","0","-2"
"190549","CUNY Brooklyn College","2010","Total full-time Instruction/research/public service, Non-tenured not on tenure track, Instructors","9","4","5","0","0","0","0","0","0","1","0","1","1","0","1","0","0","0","6","3","3","0","0","0","0","0","0","1","1","0","-2"
"190549","CUNY Brooklyn College","2010","Total full-time Instruction/research/public service, Non-tenured not on tenure track, Lecturers","2","0","2","0","0","0","0","0","0","1","0","1","0","0","0","0","0","0","1","0","1","0","0","0","0","0","0","0","0","0","-2"
"190549","CUNY Brooklyn College","2010","Total full-time Instruction/research/public service, Non-tenured not on tenure track total","22","12","10","0","0","0","0","0","0","3","1","2","2","0","2","0","0","0","14","8","6","0","0","0","0","0","0","3","3","0","-2"
"190646","CUNY Medgar Evers College","2010","Total full-time Instruction/research/public service, Tenured, Professors","51","34","17","0","0","0","10","8","2","27","18","9","1","1","0","0","0","0","13","7","6","0","0","0","0","0","0","0","0","0","-2"
"190646","CUNY Medgar Evers College","2010","Total full-time Instruction/research/public service, Tenured, Associate professors","21","9","12","0","0","0","3","0","3","12","6","6","2","1","1","0","0","0","4","2","2","0","0","0","0","0","0","0","0","0","-2"
"190646","CUNY Medgar Evers College","2010","Total full-time Instruction/research/public service, Tenured, Assistant professors","18","6","12","0","0","0","0","0","0","12","3","9","0","0","0","0","0","0","6","3","3","0","0","0","0","0","0","0","0","0","-2"
"190646","CUNY Medgar Evers College","2010","Total full-time Instruction/research/public service, Tenured, Lecturers","24","18","6","0","0","0","0","0","0","24","18","6","0","0","0","0","0","0","0","0","0","0","0","0","0","0","0","0","0","0","-2"
"190646","CUNY Medgar Evers College","2010","Total full-time Instruction/research/public service, Tenured total","114","67","47","0","0","0","13","8","5","75","45","30","3","2","1","0","0","0","23","12","11","0","0","0","0","0","0","0","0","0","-2"
"190646","CUNY Medgar Evers College","2010","Total full-time Instruction/research/public service, Non-tenured on tenure track, Professors","1","0","1","0","0","0","0","0","0","1","0","1","0","0","0","0","0","0","0","0","0","0","0","0","0","0","0","0","0","0","-2"
"190646","CUNY Medgar Evers College","2010","Total full-time Instruction/research/public service, Non-tenured on tenure track, Associate professors","5","2","3","0","0","0","1","0","1","3","2","1","1","0","1","0","0","0","0","0","0","0","0","0","0","0","0","0","0","0","-2"
"190646","CUNY Medgar Evers College","2010","Total full-time Instruction/research/public service, Non-tenured on tenure track, Assistant professors","34","14","20","0","0","0","2","1","1","23","7","16","0","0","0","0","0","0","7","6","1","0","0","0","0","0","0","2","0","2","-2"
"190646","CUNY Medgar Evers College","2010","Total full-time Instruction/research/public service, Non-tenured on tenure track, Lecturers","14","8","6","0","0","0","1","0","1","10","7","3","1","0","1","0","0","0","1","1","0","0","0","0","0","0","0","1","0","1","-2"
"190646","CUNY Medgar Evers College","2010","Total full-time Instruction/research/public service, Non-tenured on tenure track total","54","24","30","0","0","0","4","1","3","37","16","21","2","0","2","0","0","0","8","7","1","0","0","0","0","0","0","3","0","3","-2"
"190646","CUNY Medgar Evers College","2010","Total full-time Instruction/research/public service, Non-tenured not on tenure track, Professors","7","4","3","0","0","0","0","0","0","7","4","3","0","0","0","0","0","0","0","0","0","0","0","0","0","0","0","0","0","0","-2"
"190646","CUNY Medgar Evers College","2010","Total full-time Instruction/research/public servicey, Non-tenured not on tenure track, Assistant professors","3","2","1","0","0","0","1","1","0","2","1","1","0","0","0","0","0","0","0","0","0","0","0","0","0","0","0","0","0","0","-2"
"190646","CUNY Medgar Evers College","2010","Total full-time Instruction/research/public service, Non-tenured not on tenure track, Instructors","6","3","3","0","0","0","0","0","0","5","2","3","1","1","0","0","0","0","0","0","0","0","0","0","0","0","0","0","0","0","-2"
"190646","CUNY Medgar Evers College","2010","Total full-time Instruction/research/public service, Non-tenured not on tenure track, Lecturers","2","0","2","0","0","0","0","0","0","2","0","2","0","0","0","0","0","0","0","0","0","0","0","0","0","0","0","0","0","0","-2"
"190646","CUNY Medgar Evers College","2010","Total full-time Instruction/research/public service, Non-tenured not on tenure track total","18","9","9","0","0","0","1","1","0","16","7","9","1","1","0","0","0","0","0","0","0","0","0","0","0","0","0","0","0","0","-2"
"193292","Molloy College","2010","Total full-time Instruction/research/public service, Tenured, Professors","33","8","25","0","0","0","0","0","0","1","0","1","0","0","0","0","0","0","31","7","24","1","1","0","0","0","0","0","0","0","-2"
"193292","Molloy College","2010","Total full-time Instruction/research/public service, Tenured, Associate professors","36","14","22","0","0","0","1","0","1","1","0","1","3","1","2","0","0","0","31","13","18","0","0","0","0","0","0","0","0","0","-2"
"193292","Molloy College","2010","Total full-time Instruction/research/public service, Tenured, Assistant professors","41","7","34","0","0","0","2","1","1","3","0","3","0","0","0","0","0","0","36","6","30","0","0","0","0","0","0","0","0","0","-2"
"193292","Molloy College","2010","Total full-time Instruction/research/public service, Tenured total","110","29","81","0","0","0","3","1","2","5","0","5","3","1","2","0","0","0","98","26","72","1","1","0","0","0","0","0","0","0","-2"
"193292","Molloy College","2010","Total full-time Instruction/research/public service, Non-tenured on tenure track, Professors","2","1","1","0","0","0","0","0","0","0","0","0","0","0","0","0","0","0","2","1","1","0","0","0","0","0","0","0","0","0","-2"
"193292","Molloy College","2010","Total full-time Instruction/research/public service, Non-tenured on tenure track, Associate professors","10","4","6","0","0","0","0","0","0","2","0","2","1","0","1","0","0","0","7","4","3","0","0","0","0","0","0","0","0","0","-2"
"193292","Molloy College","2010","Total full-time Instruction/research/public service, Non-tenured on tenure track, Assistant professors","41","8","33","0","0","0","2","0","2","2","0","2","2","1","1","0","0","0","34","7","27","1","0","1","0","0","0","0","0","0","-2"
"193292","Molloy College","2010","Total full-time Instruction/research/public service, Non-tenured on tenure track, Instructors","10","3","7","0","0","0","0","0","0","1","0","1","0","0","0","0","0","0","9","3","6","0","0","0","0","0","0","0","0","0","-2"
"193292","Molloy College","2010","Total full-time Instruction/research/public service, Non-tenured on tenure track total","63","16","47","0","0","0","2","0","2","5","0","5","3","1","2","0","0","0","52","15","37","1","0","1","0","0","0","0","0","0","-2"
"193353","Mount Saint Mary College","2010","Total full-time Instruction/research/public service, Tenured, Professors","24","14","10","0","0","0","1","0","1","1","1","0","0","0","0","0","0","0","22","13","9","0","0","0","0","0","0","0","0","0","-2"
"193353","Mount Saint Mary College","2010","Total full-time Instruction/research/public service, Tenured, Associate professors","17","6","11","0","0","0","0","0","0","0","0","0","0","0","0","0","0","0","17","6","11","0","0","0","0","0","0","0","0","0","-2"
"193353","Mount Saint Mary College","2010","Total full-time Instruction/research/public service, Tenured total","41","20","21","0","0","0","1","0","1","1","1","0","0","0","0","0","0","0","39","19","20","0","0","0","0","0","0","0","0","0","-2"
"193353","Mount Saint Mary College","2010","Total full-time Instruction/research/public service, Non-tenured on tenure track, Associate professors","6","2","4","0","0","0","0","0","0","0","0","0","0","0","0","0","0","0","6","2","4","0","0","0","0","0","0","0","0","0","-2"
"193353","Mount Saint Mary College","2010","Total full-time Instruction/research/public service, Non-tenured on tenure track, Assistant professors","31","12","19","0","0","0","1","0","1","2","0","2","1","1","0","0","0","0","27","11","16","0","0","0","0","0","0","0","0","0","-2"
"193353","Mount Saint Mary College","2010","Total full-time Instruction/research/public service, Non-tenured on tenure track, Instructors","7","1","6","0","0","0","0","0","0","0","0","0","0","0","0","0","0","0","7","1","6","0","0","0","0","0","0","0","0","0","-2"
"193353","Mount Saint Mary College","2010","Total full-time Instruction/research/public service, Non-tenured on tenure track total","44","15","29","0","0","0","1","0","1","2","0","2","1","1","0","0","0","0","40","14","26","0","0","0","0","0","0","0","0","0","-2"
"195243","St. Thomas Aquinas College","2010","Total full-time Instruction/research/public service, Tenured, Professors","24","12","12","0","0","0","2","0","2","0","0","0","1","1","0","0","0","0","21","11","10","0","0","0","0","0","0","0","0","0","-2"
"195243","St. Thomas Aquinas College","2010","Total full-time Instruction/research/public service, Tenured, Associate professors","16","11","5","0","0","0","1","1","0","0","0","0","0","0","0","0","0","0","15","10","5","0","0","0","0","0","0","0","0","0","-2"
"195243","St. Thomas Aquinas College","2010","Total full-time Instruction/research/public service, Tenured, Assistant professors","4","4","0","0","0","0","0","0","0","1","1","0","1","1","0","0","0","0","2","2","0","0","0","0","0","0","0","0","0","0","-2"
"195243","St. Thomas Aquinas College","2010","Total full-time Instruction/research/public service, Tenured total","44","27","17","0","0","0","3","1","2","1","1","0","2","2","0","0","0","0","38","23","15","0","0","0","0","0","0","0","0","0","-2"
"195243","St. Thomas Aquinas College","2010","Total full-time Instruction/research/public service, Non-tenured on tenure track, Associate professors","3","1","2","0","0","0","0","0","0","0","0","0","0","0","0","0","0","0","3","1","2","0","0","0","0","0","0","0","0","0","-2"
"195243","St. Thomas Aquinas College","2010","Total full-time Instruction/research/public service, Non-tenured on tenure track, Assistant professors","10","6","4","0","0","0","0","0","0","0","0","0","0","0","0","0","0","0","10","6","4","0","0","0","0","0","0","0","0","0","-2"
"195243","St. Thomas Aquinas College","2010","Total full-time Instruction/research/public service, Non-tenured on tenure track total","13","7","6","0","0","0","0","0","0","0","0","0","0","0","0","0","0","0","13","7","6","0","0","0","0","0","0","0","0","0","-2"
"195243","St. Thomas Aquinas College","2010","Total full-time Instruction/research/public service, Non-tenured not on tenure track, Instructors","4","0","4","0","0","0","0","0","0","0","0","0","0","0","0","0","0","0","4","0","4","0","0","0","0","0","0","0","0","0","-2"
"195243","St. Thomas Aquinas College","2010","Total full-time Instruction/research/public service, Non-tenured not on tenure track total","4","0","4","0","0","0","0","0","0","0","0","0","0","0","0","0","0","0","4","0","4","0","0","0","0","0","0","0","0","0","-2"
"196024","SUNY College of Technology at Delhi","2010","Total full-time Instruction/research/public service, Tenured, Professors","28","19","9","0","0","0","0","0","0","0","0","0","0","0","0","0","0","0","28","19","9","0","0","0","0","0","0","0","0","0","-2"
"196024","SUNY College of Technology at Delhi","2010","Total full-time Instruction/research/public service, Tenured, Associate professors","22","13","9","0","0","0","0","0","0","0","0","0","1","1","0","0","0","0","21","12","9","0","0","0","0","0","0","0","0","0","-2"
"196024","SUNY College of Technology at Delhi","2010","Total full-time Instruction/research/public service, Tenured, Assistant professors","14","8","6","0","0","0","1","0","1","2","0","2","0","0","0","0","0","0","11","8","3","0","0","0","0","0","0","0","0","0","-2"
"196024","SUNY College of Technology at Delhi","2010","Total full-time Instruction/research/public service, Tenured, Instructors","6","3","3","0","0","0","0","0","0","0","0","0","0","0","0","0","0","0","6","3","3","0","0","0","0","0","0","0","0","0","-2"
"196024","SUNY College of Technology at Delhi","2010","Total full-time Instruction/research/public service, Tenured total","70","43","27","0","0","0","1","0","1","2","0","2","1","1","0","0","0","0","66","42","24","0","0","0","0","0","0","0","0","0","-2"
"196024","SUNY College of Technology at Delhi","2010","Total full-time Instruction/research/public service, Non-tenured on tenure track, Associate professors","5","4","1","0","0","0","0","0","0","0","0","0","0","0","0","0","0","0","5","4","1","0","0","0","0","0","0","0","0","0","-2"
"196024","SUNY College of Technology at Delhi","2010","Total full-time Instruction/research/public service, Non-tenured on tenure track, Assistant professors","26","14","12","0","0","0","3","2","1","3","2","1","1","1","0","0","0","0","19","9","10","0","0","0","0","0","0","0","0","0","-2"
"196024","SUNY College of Technology at Delhi","2010","Total full-time Instruction/research/public service, Non-tenured on tenure track, Instructors","22","13","9","0","0","0","1","1","0","0","0","0","1","0","1","0","0","0","20","12","8","0","0","0","0","0","0","0","0","0","-2"
"196024","SUNY College of Technology at Delhi","2010","Total full-time Instruction/research/public service, Non-tenured on tenure track total","53","31","22","0","0","0","4","3","1","3","2","1","2","1","1","0","0","0","44","25","19","0","0","0","0","0","0","0","0","0","-2"
"196042","Farmingdale State College","2010","Total full-time Instruction/research/public service, Tenured, Professors","69","42","27","0","0","0","5","4","1","2","2","0","3","1","2","0","0","0","59","35","24","0","0","0","0","0","0","0","0","0","-2"
"196042","Farmingdale State College","2010","Total full-time Instruction/research/public service, Tenured, Associate professors","41","21","20","0","0","0","2","0","2","1","0","1","3","2","1","0","0","0","35","19","16","0","0","0","0","0","0","0","0","0","-2"
"196042","Farmingdale State College","2010","Total full-time Instruction/research/public service, Tenured, Assistant professors","9","6","3","0","0","0","0","0","0","1","0","1","0","0","0","0","0","0","8","6","2","0","0","0","0","0","0","0","0","0","-2"
"196042","Farmingdale State College","2010","Total full-time Instruction/research/public service, Tenured total","119","69","50","0","0","0","7","4","3","4","2","2","6","3","3","0","0","0","102","60","42","0","0","0","0","0","0","0","0","0","-2"
"196042","Farmingdale State College","2010","Total full-time Instruction/research/public service, Non-tenured on tenure track, Professors","1","1","0","0","0","0","0","0","0","0","0","0","0","0","0","0","0","0","1","1","0","0","0","0","0","0","0","0","0","0","-2"
"196042","Farmingdale State College","2010","Total full-time Instruction/research/public service, Non-tenured on tenure track, Associate professors","5","2","3","0","0","0","0","0","0","0","0","0","0","0","0","0","0","0","4","1","3","0","0","0","0","0","0","1","1","0","-2"
"196042","Farmingdale State College","2010","Total full-time Instruction/research/public service, Non-tenured on tenure track, Assistant professors","72","32","40","0","0","0","8","7","1","6","2","4","3","3","0","0","0","0","54","20","34","0","0","0","0","0","0","1","0","1","-2"
"196042","Farmingdale State College","2010","Total full-time Instruction/research/public service, Non-tenured on tenure track, Instructors","1","0","1","0","0","0","0","0","0","0","0","0","0","0","0","0","0","0","1","0","1","0","0","0","0","0","0","0","0","0","-2"
"196042","Farmingdale State College","2010","Total full-time Instruction/research/public service, Non-tenured on tenure track total","79","35","44","0","0","0","8","7","1","6","2","4","3","3","0","0","0","0","60","22","38","0","0","0","0","0","0","2","1","1","-2"
"196042","Farmingdale State College","2010","Total full-time Instruction/research/public service, Non-tenured not on tenure track, Professors","1","1","0","0","0","0","1","1","0","0","0","0","0","0","0","0","0","0","0","0","0","0","0","0","0","0","0","0","0","0","-2"
"196042","Farmingdale State College","2010","Total full-time Instruction/research/public servicey, Non-tenured not on tenure track, Assistant professors","5","2","3","0","0","0","0","0","0","0","0","0","1","0","1","0","0","0","4","2","2","0","0","0","0","0","0","0","0","0","-2"
"196042","Farmingdale State College","2010","Total full-time Instruction/research/public service, Non-tenured not on tenure track, Instructors","1","1","0","0","0","0","1","1","0","0","0","0","0","0","0","0","0","0","0","0","0","0","0","0","0","0","0","0","0","0","-2"
"196042","Farmingdale State College","2010","Total full-time Instruction/research/public service, Non-tenured not on tenure track, Lecturers","2","1","1","0","0","0","0","0","0","0","0","0","0","0","0","0","0","0","2","1","1","0","0","0","0","0","0","0","0","0","-2"
"196042","Farmingdale State College","2010","Total full-time Instruction/research/public service, Non-tenured not on tenure track total","9","5","4","0","0","0","2","2","0","0","0","0","1","0","1","0","0","0","6","3","3","0","0","0","0","0","0","0","0","0","-2"
"196176","State University of New York at New Paltz","2010","Total full-time Instruction/research/public service, Tenured, Professors","52","31","21","0","0","0","7","6","1","1","1","0","3","1","2","0","0","0","41","23","18","0","0","0","0","0","0","0","0","0","-2"
"196176","State University of New York at New Paltz","2010","Total full-time Instruction/research/public service, Tenured, Associate professors","99","52","47","0","0","0","9","6","3","4","4","0","3","1","2","0","0","0","83","41","42","0","0","0","0","0","0","0","0","0","-2"
"196176","State University of New York at New Paltz","2010","Total full-time Instruction/research/public service, Tenured, Assistant professors","10","5","5","0","0","0","0","0","0","2","1","1","0","0","0","0","0","0","8","4","4","0","0","0","0","0","0","0","0","0","-2"
"196176","State University of New York at New Paltz","2010","Total full-time Instruction/research/public service, Tenured, Instructors","1","0","1","0","0","0","0","0","0","0","0","0","0","0","0","0","0","0","1","0","1","0","0","0","0","0","0","0","0","0","-2"
"196176","State University of New York at New Paltz","2010","Total full-time Instruction/research/public service, Tenured total","162","88","74","0","0","0","16","12","4","7","6","1","6","2","4","0","0","0","133","68","65","0","0","0","0","0","0","0","0","0","-2"
"196176","State University of New York at New Paltz","2010","Total full-time Instruction/research/public service, Non-tenured on tenure track, Associate professors","4","4","0","0","0","0","0","0","0","0","0","0","0","0","0","0","0","0","4","4","0","0","0","0","0","0","0","0","0","0","-2"
"196176","State University of New York at New Paltz","2010","Total full-time Instruction/research/public service, Non-tenured on tenure track, Assistant professors","98","44","54","0","0","0","6","3","3","5","3","2","5","3","2","0","0","0","74","33","41","0","0","0","0","0","0","8","2","6","-2"
"196176","State University of New York at New Paltz","2010","Total full-time Instruction/research/public service, Non-tenured on tenure track, Instructors","4","0","4","0","0","0","0","0","0","0","0","0","0","0","0","0","0","0","4","0","4","0","0","0","0","0","0","0","0","0","-2"
"196176","State University of New York at New Paltz","2010","Total full-time Instruction/research/public service, Non-tenured on tenure track total","106","48","58","0","0","0","6","3","3","5","3","2","5","3","2","0","0","0","82","37","45","0","0","0","0","0","0","8","2","6","-2"
"196176","State University of New York at New Paltz","2010","Total full-time Instruction/research/public service, Non-tenured not on tenure track, Associate professors","3","1","2","0","0","0","0","0","0","1","1","0","0","0","0","0","0","0","2","0","2","0","0","0","0","0","0","0","0","0","-2"
"196176","State University of New York at New Paltz","2010","Total full-time Instruction/research/public servicey, Non-tenured not on tenure track, Assistant professors","1","0","1","0","0","0","0","0","0","0","0","0","0","0","0","0","0","0","1","0","1","0","0","0","0","0","0","0","0","0","-2"
"196176","State University of New York at New Paltz","2010","Total full-time Instruction/research/public service, Non-tenured not on tenure track, Lecturers","53","20","33","0","0","0","0","0","0","0","0","0","3","0","3","0","0","0","46","20","26","1","0","1","0","0","0","3","0","3","-2"
"196176","State University of New York at New Paltz","2010","Total full-time Instruction/research/public service, Non-tenured not on tenure track total","57","21","36","0","0","0","0","0","0","1","1","0","3","0","3","0","0","0","49","20","29","1","0","1","0","0","0","3","0","3","-2"
"205027","Pontifical College Josephinum","2010","Total full-time Instruction/research/public service, Non-tenured not on tenure track, Professors","2","1","1","0","0","0","0","0","0","0","0","0","0","0","0","0","0","0","2","1","1","0","0","0","0","0","0","0","0","0","-2"
"205027","Pontifical College Josephinum","2010","Total full-time Instruction/research/public service, Non-tenured not on tenure track, Associate professors","7","7","0","0","0","0","0","0","0","0","0","0","0","0","0","0","0","0","7","7","0","0","0","0","0","0","0","0","0","0","-2"
"205027","Pontifical College Josephinum","2010","Total full-time Instruction/research/public servicey, Non-tenured not on tenure track, Assistant professors","7","5","2","0","0","0","0","0","0","0","0","0","0","0","0","0","0","0","6","5","1","0","0","0","0","0","0","1","0","1","-2"
"205027","Pontifical College Josephinum","2010","Total full-time Instruction/research/public service, Non-tenured not on tenure track, Instructors","2","1","1","0","0","0","0","0","0","1","1","0","0","0","0","0","0","0","1","0","1","0","0","0","0","0","0","0","0","0","-2"
"205027","Pontifical College Josephinum","2010","Total full-time Instruction/research/public service, Non-tenured not on tenure track total","18","14","4","0","0","0","0","0","0","1","1","0","0","0","0","0","0","0","16","13","3","0","0","0","0","0","0","1","0","1","-2"
"206862","Southern Nazarene University","2010","Total full-time Instruction/research/public service, Non-tenured not on tenure track, Professors","27","19","8","1","1","0","1","1","0","0","0","0","0","0","0","0","0","0","25","17","8","0","0","0","0","0","0","0","0","0","-2"
"206862","Southern Nazarene University","2010","Total full-time Instruction/research/public service, Non-tenured not on tenure track, Associate professors","18","11","7","0","0","0","0","0","0","0","0","0","0","0","0","0","0","0","18","11","7","0","0","0","0","0","0","0","0","0","-2"
"206862","Southern Nazarene University","2010","Total full-time Instruction/research/public servicey, Non-tenured not on tenure track, Assistant professors","22","9","13","0","0","0","1","0","1","0","0","0","0","0","0","0","0","0","21","9","12","0","0","0","0","0","0","0","0","0","-2"
"206862","Southern Nazarene University","2010","Total full-time Instruction/research/public service, Non-tenured not on tenure track, No academic rank","2","1","1","0","0","0","0","0","0","0","0","0","0","0","0","0","0","0","2","1","1","0","0","0","0","0","0","0","0","0","-2"
"206862","Southern Nazarene University","2010","Total full-time Instruction/research/public service, Non-tenured not on tenure track total","69","40","29","1","1","0","2","1","1","0","0","0","0","0","0","0","0","0","66","38","28","0","0","0","0","0","0","0","0","0","-2"
"207157","Randall University","2010","Total full-time Instruction/research/public service, Non-tenured not on tenure track, No academic rank","16","8","8","4","1","3","0","0","0","1","0","1","0","0","0","0","0","0","11","7","4","0","0","0","0","0","0","0","0","0","-2"
"207157","Randall University","2010","Total full-time Instruction/research/public service, Non-tenured not on tenure track total","16","8","8","4","1","3","0","0","0","1","0","1","0","0","0","0","0","0","11","7","4","0","0","0","0","0","0","0","0","0","-2"
"209807","Portland State University","2010","Total full-time Instruction/research/public service, Tenured, Professors","223","159","64","3","2","1","15","10","5","5","4","1","0","0","0","0","0","0","158","113","45","0","0","0","39","27","12","3","3","0","-2"
"209807","Portland State University","2010","Total full-time Instruction/research/public service, Tenured, Associate professors","148","81","67","3","1","2","9","7","2","1","0","1","0","0","0","0","0","0","101","52","49","0","0","0","27","18","9","7","3","4","-2"
"209807","Portland State University","2010","Total full-time Instruction/research/public service, Tenured, Assistant professors","1","1","0","0","0","0","0","0","0","0","0","0","0","0","0","0","0","0","1","1","0","0","0","0","0","0","0","0","0","0","-2"
"209807","Portland State University","2010","Total full-time Instruction/research/public service, Tenured total","372","241","131","6","3","3","24","17","7","6","4","2","0","0","0","0","0","0","260","166","94","0","0","0","66","45","21","10","6","4","-2"
"209807","Portland State University","2010","Total full-time Instruction/research/public service, Non-tenured on tenure track, Professors","3","1","2","0","0","0","1","0","1","0","0","0","0","0","0","0","0","0","2","1","1","0","0","0","0","0","0","0","0","0","-2"
"209807","Portland State University","2010","Total full-time Instruction/research/public service, Non-tenured on tenure track, Associate professors","22","14","8","0","0","0","0","0","0","1","1","0","0","0","0","0","0","0","18","11","7","0","0","0","1","0","1","2","2","0","-2"
"209807","Portland State University","2010","Total full-time Instruction/research/public service, Non-tenured on tenure track, Assistant professors","133","60","73","1","0","1","9","3","6","3","1","2","0","0","0","0","0","0","87","39","48","0","0","0","20","10","10","13","7","6","-2"
"209807","Portland State University","2010","Total full-time Instruction/research/public service, Non-tenured on tenure track total","158","75","83","1","0","1","10","3","7","4","2","2","0","0","0","0","0","0","107","51","56","0","0","0","21","10","11","15","9","6","-2"
"209807","Portland State University","2010","Total full-time Instruction/research/public service, Non-tenured not on tenure track, Professors","7","4","3","0","0","0","0","0","0","0","0","0","0","0","0","0","0","0","7","4","3","0","0","0","0","0","0","0","0","0","-2"
"209807","Portland State University","2010","Total full-time Instruction/research/public service, Non-tenured not on tenure track, Associate professors","10","7","3","0","0","0","1","1","0","1","1","0","0","0","0","0","0","0","7","4","3","0","0","0","0","0","0","1","1","0","-2"
"209807","Portland State University","2010","Total full-time Instruction/research/public servicey, Non-tenured not on tenure track, Assistant professors","68","30","38","0","0","0","4","2","2","1","1","0","0","0","0","1","0","1","47","19","28","0","0","0","10","6","4","5","2","3","-2"
"209807","Portland State University","2010","Total full-time Instruction/research/public service, Non-tenured not on tenure track, Instructors","143","41","102","1","0","1","2","0","2","3","0","3","1","0","1","0","0","0","119","36","83","0","0","0","12","3","9","5","2","3","-2"
"209807","Portland State University","2010","Total full-time Instruction/research/public service, Non-tenured not on tenure track, No academic rank","87","47","40","0","0","0","3","2","1","0","0","0","0","0","0","0","0","0","59","27","32","0","0","0","5","3","2","20","15","5","-2"
"209807","Portland State University","2010","Total full-time Instruction/research/public service, Non-tenured not on tenure track total","315","129","186","1","0","1","10","5","5","5","2","3","1","0","1","1","0","1","239","90","149","0","0","0","27","12","15","31","20","11","-2"
"210429","Western Oregon University","2010","Total full-time Instruction/research/public service, Tenured, Professors","77","46","31","0","0","0","3","1","2","1","1","0","3","2","1","1","1","0","66","38","28","0","0","0","2","2","0","1","1","0","-2"
"210429","Western Oregon University","2010","Total full-time Instruction/research/public service, Tenured, Associate professors","53","24","29","0","0","0","0","0","0","2","0","2","2","0","2","0","0","0","46","21","25","0","0","0","2","2","0","1","1","0","-2"
"210429","Western Oregon University","2010","Total full-time Instruction/research/public service, Tenured, Assistant professors","3","1","2","0","0","0","0","0","0","0","0","0","0","0","0","0","0","0","3","1","2","0","0","0","0","0","0","0","0","0","-2"
"210429","Western Oregon University","2010","Total full-time Instruction/research/public service, Tenured total","133","71","62","0","0","0","3","1","2","3","1","2","5","2","3","1","1","0","115","60","55","0","0","0","4","4","0","2","2","0","-2"
"210429","Western Oregon University","2010","Total full-time Instruction/research/public service, Non-tenured on tenure track, Assistant professors","22","10","12","0","0","0","0","0","0","1","1","0","1","1","0","0","0","0","17","7","10","0","0","0","0","0","0","3","1","2","-2"
"210429","Western Oregon University","2010","Total full-time Instruction/research/public service, Non-tenured on tenure track total","22","10","12","0","0","0","0","0","0","1","1","0","1","1","0","0","0","0","17","7","10","0","0","0","0","0","0","3","1","2","-2"
"210429","Western Oregon University","2010","Total full-time Instruction/research/public servicey, Non-tenured not on tenure track, Assistant professors","15","9","6","0","0","0","1","1","0","0","0","0","0","0","0","0","0","0","14","8","6","0","0","0","0","0","0","0","0","0","-2"
"210429","Western Oregon University","2010","Total full-time Instruction/research/public service, Non-tenured not on tenure track, Instructors","24","16","8","0","0","0","1","1","0","1","0","1","1","1","0","1","1","0","20","13","7","0","0","0","0","0","0","0","0","0","-2"
"210429","Western Oregon University","2010","Total full-time Instruction/research/public service, Non-tenured not on tenure track, Lecturers","3","0","3","0","0","0","0","0","0","0","0","0","0","0","0","0","0","0","3","0","3","0","0","0","0","0","0","0","0","0","-2"
"210429","Western Oregon University","2010","Total full-time Instruction/research/public service, Non-tenured not on tenure track, No academic rank","32","11","21","0","0","0","1","0","1","0","0","0","0","0","0","0","0","0","31","11","20","0","0","0","0","0","0","0","0","0","-2"
"210429","Western Oregon University","2010","Total full-time Instruction/research/public service, Non-tenured not on tenure track total","74","36","38","0","0","0","3","2","1","1","0","1","1","1","0","1","1","0","68","32","36","0","0","0","0","0","0","0","0","0","-2"
"212133","Eastern University","2010","Total full-time Instruction/research/public service, Tenured, Professors","35","21","14","0","0","0","1","0","1","2","1","1","0","0","0","0","0","0","32","20","12","0","0","0","0","0","0","0","0","0","-2"
"212133","Eastern University","2010","Total full-time Instruction/research/public service, Tenured, Associate professors","26","13","13","0","0","0","1","0","1","6","2","4","3","1","2","0","0","0","16","10","6","0","0","0","0","0","0","0","0","0","-2"
"212133","Eastern University","2010","Total full-time Instruction/research/public service, Tenured total","61","34","27","0","0","0","2","0","2","8","3","5","3","1","2","0","0","0","48","30","18","0","0","0","0","0","0","0","0","0","-2"
"212133","Eastern University","2010","Total full-time Instruction/research/public service, Non-tenured on tenure track, Professors","3","2","1","0","0","0","1","1","0","0","0","0","0","0","0","0","0","0","2","1","1","0","0","0","0","0","0","0","0","0","-2"
"212133","Eastern University","2010","Total full-time Instruction/research/public service, Non-tenured on tenure track, Associate professors","30","22","8","0","0","0","1","1","0","4","3","1","1","1","0","0","0","0","24","17","7","0","0","0","0","0","0","0","0","0","-2"
"212133","Eastern University","2010","Total full-time Instruction/research/public service, Non-tenured on tenure track, Assistant professors","19","11","8","0","0","0","2","2","0","3","0","3","0","0","0","0","0","0","13","9","4","0","0","0","1","0","1","0","0","0","-2"
"212133","Eastern University","2010","Total full-time Instruction/research/public service, Non-tenured on tenure track, Lecturers","1","1","0","0","0","0","0","0","0","0","0","0","0","0","0","0","0","0","1","1","0","0","0","0","0","0","0","0","0","0","-2"
"212133","Eastern University","2010","Total full-time Instruction/research/public service, Non-tenured on tenure track total","53","36","17","0","0","0","4","4","0","7","3","4","1","1","0","0","0","0","40","28","12","0","0","0","1","0","1","0","0","0","-2"
"212133","Eastern University","2010","Total full-time Instruction/research/public service, Non-tenured not on tenure track, Lecturers","32","11","21","0","0","0","1","0","1","4","0","4","1","0","1","0","0","0","26","11","15","0","0","0","0","0","0","0","0","0","-2"
"212133","Eastern University","2010","Total full-time Instruction/research/public service, Non-tenured not on tenure track total","32","11","21","0","0","0","1","0","1","4","0","4","1","0","1","0","0","0","26","11","15","0","0","0","0","0","0","0","0","0","-2"
"213774","Manor College","2010","Total full-time Instruction/research/public service, Non-tenured not on tenure track, Professors","7","1","6","0","0","0","0","0","0","0","0","0","0","0","0","0","0","0","7","1","6","0","0","0","0","0","0","0","0","0","-2"
"213774","Manor College","2010","Total full-time Instruction/research/public service, Non-tenured not on tenure track, Associate professors","10","4","6","0","0","0","0","0","0","0","0","0","0","0","0","0","0","0","10","4","6","0","0","0","0","0","0","0","0","0","-2"
"213774","Manor College","2010","Total full-time Instruction/research/public servicey, Non-tenured not on tenure track, Assistant professors","4","0","4","0","0","0","0","0","0","0","0","0","0","0","0","0","0","0","4","0","4","0","0","0","0","0","0","0","0","0","-2"
"213774","Manor College","2010","Total full-time Instruction/research/public service, Non-tenured not on tenure track, Instructors","2","0","2","0","0","0","0","0","0","0","0","0","0","0","0","0","0","0","2","0","2","0","0","0","0","0","0","0","0","0","-2"
"213774","Manor College","2010","Total full-time Instruction/research/public service, Non-tenured not on tenure track total","23","5","18","0","0","0","0","0","0","0","0","0","0","0","0","0","0","0","23","5","18","0","0","0","0","0","0","0","0","0","-2"
"217420","Rhode Island College","2010","Total full-time Instruction/research/public service, Tenured, Professors","120","67","53","0","0","0","6","4","2","2","2","0","1","1","0","0","0","0","111","60","51","0","0","0","0","0","0","0","0","0","-2"
"217420","Rhode Island College","2010","Total full-time Instruction/research/public service, Tenured, Associate professors","93","41","52","1","0","1","5","2","3","4","1","3","3","1","2","0","0","0","80","37","43","0","0","0","0","0","0","0","0","0","-2"
"217420","Rhode Island College","2010","Total full-time Instruction/research/public service, Tenured, Assistant professors","16","6","10","0","0","0","0","0","0","0","0","0","0","0","0","0","0","0","16","6","10","0","0","0","0","0","0","0","0","0","-2"
"217420","Rhode Island College","2010","Total full-time Instruction/research/public service, Tenured total","229","114","115","1","0","1","11","6","5","6","3","3","4","2","2","0","0","0","207","103","104","0","0","0","0","0","0","0","0","0","-2"
"217420","Rhode Island College","2010","Total full-time Instruction/research/public service, Non-tenured on tenure track, Professors","1","1","0","0","0","0","0","0","0","0","0","0","0","0","0","0","0","0","1","1","0","0","0","0","0","0","0","0","0","0","-2"
"217420","Rhode Island College","2010","Total full-time Instruction/research/public service, Non-tenured on tenure track, Associate professors","1","0","1","0","0","0","0","0","0","0","0","0","0","0","0","0","0","0","1","0","1","0","0","0","0","0","0","0","0","0","-2"
"217420","Rhode Island College","2010","Total full-time Instruction/research/public service, Non-tenured on tenure track, Assistant professors","77","27","50","0","0","0","8","4","4","1","1","0","4","3","1","0","0","0","64","19","45","0","0","0","0","0","0","0","0","0","-2"
"217420","Rhode Island College","2010","Total full-time Instruction/research/public service, Non-tenured on tenure track, Instructors","4","0","4","0","0","0","0","0","0","0","0","0","0","0","0","0","0","0","4","0","4","0","0","0","0","0","0","0","0","0","-2"
"217420","Rhode Island College","2010","Total full-time Instruction/research/public service, Non-tenured on tenure track total","83","28","55","0","0","0","8","4","4","1","1","0","4","3","1","0","0","0","70","20","50","0","0","0","0","0","0","0","0","0","-2"
"217420","Rhode Island College","2010","Total full-time Instruction/research/public service, Non-tenured not on tenure track, Associate professors","3","1","2","0","0","0","0","0","0","0","0","0","0","0","0","0","0","0","3","1","2","0","0","0","0","0","0","0","0","0","-2"
"217420","Rhode Island College","2010","Total full-time Instruction/research/public servicey, Non-tenured not on tenure track, Assistant professors","27","5","22","0","0","0","2","1","1","0","0","0","1","1","0","0","0","0","24","3","21","0","0","0","0","0","0","0","0","0","-2"
"217420","Rhode Island College","2010","Total full-time Instruction/research/public service, Non-tenured not on tenure track total","30","6","24","0","0","0","2","1","1","0","0","0","1","1","0","0","0","0","27","4","23","0","0","0","0","0","0","0","0","0","-2"
"222983","Austin College","2010","Total full-time Instruction/research/public service, Tenured, Professors","28","23","5","0","0","0","0","0","0","0","0","0","0","0","0","0","0","0","28","23","5","0","0","0","0","0","0","0","0","0","-2"
"222983","Austin College","2010","Total full-time Instruction/research/public service, Tenured, Associate professors","39","28","11","1","1","0","0","0","0","1","0","1","3","1","2","0","0","0","34","26","8","0","0","0","0","0","0","0","0","0","-2"
"222983","Austin College","2010","Total full-time Instruction/research/public service, Tenured total","67","51","16","1","1","0","0","0","0","1","0","1","3","1","2","0","0","0","62","49","13","0","0","0","0","0","0","0","0","0","-2"
"222983","Austin College","2010","Total full-time Instruction/research/public service, Non-tenured on tenure track, Associate professors","1","1","0","0","0","0","0","0","0","0","0","0","0","0","0","0","0","0","0","0","0","0","0","0","0","0","0","1","1","0","-2"
"222983","Austin College","2010","Total full-time Instruction/research/public service, Non-tenured on tenure track, Assistant professors","24","10","14","0","0","0","1","0","1","0","0","0","0","0","0","0","0","0","18","10","8","0","0","0","5","0","5","0","0","0","-2"
"222983","Austin College","2010","Total full-time Instruction/research/public service, Non-tenured on tenure track total","25","11","14","0","0","0","1","0","1","0","0","0","0","0","0","0","0","0","18","10","8","0","0","0","5","0","5","1","1","0","-2"
"222983","Austin College","2010","Total full-time Instruction/research/public servicey, Non-tenured not on tenure track, Assistant professors","1","0","1","0","0","0","0","0","0","0","0","0","0","0","0","0","0","0","1","0","1","0","0","0","0","0","0","0","0","0","-2"
"222983","Austin College","2010","Total full-time Instruction/research/public service, Non-tenured not on tenure track total","1","0","1","0","0","0","0","0","0","0","0","0","0","0","0","0","0","0","1","0","1","0","0","0","0","0","0","0","0","0","-2"
"223232","Baylor University","2010","Total full-time Instruction/research/public service, Tenured, Professors","229","196","33","2","2","0","4","4","0","4","3","1","4","4","0","1","1","0","203","171","32","6","6","0","2","2","0","3","3","0","-2"
"223232","Baylor University","2010","Total full-time Instruction/research/public service, Tenured, Associate professors","185","127","58","0","0","0","11","8","3","3","1","2","8","6","2","0","0","0","157","109","48","4","2","2","0","0","0","2","1","1","-2"
"223232","Baylor University","2010","Total full-time Instruction/research/public service, Tenured, Assistant professors","3","1","2","0","0","0","0","0","0","0","0","0","0","0","0","0","0","0","3","1","2","0","0","0","0","0","0","0","0","0","-2"
"223232","Baylor University","2010","Total full-time Instruction/research/public service, Tenured, Instructors","1","0","1","0","0","0","0","0","0","0","0","0","0","0","0","0","0","0","1","0","1","0","0","0","0","0","0","0","0","0","-2"
"223232","Baylor University","2010","Total full-time Instruction/research/public service, Tenured total","418","324","94","2","2","0","15","12","3","7","4","3","12","10","2","1","1","0","364","281","83","10","8","2","2","2","0","5","4","1","-2"
"223232","Baylor University","2010","Total full-time Instruction/research/public service, Non-tenured on tenure track, Professors","3","2","1","0","0","0","0","0","0","0","0","0","0","0","0","0","0","0","3","2","1","0","0","0","0","0","0","0","0","0","-2"
"223232","Baylor University","2010","Total full-time Instruction/research/public service, Non-tenured on tenure track, Associate professors","28","16","12","0","0","0","3","3","0","2","1","1","1","1","0","0","0","0","22","11","11","0","0","0","0","0","0","0","0","0","-2"
"223232","Baylor University","2010","Total full-time Instruction/research/public service, Non-tenured on tenure track, Assistant professors","153","90","63","0","0","0","9","7","2","4","0","4","6","2","4","0","0","0","115","66","49","1","1","0","5","3","2","13","11","2","-2"
"223232","Baylor University","2010","Total full-time Instruction/research/public service, Non-tenured on tenure track total","184","108","76","0","0","0","12","10","2","6","1","5","7","3","4","0","0","0","140","79","61","1","1","0","5","3","2","13","11","2","-2"
"223232","Baylor University","2010","Total full-time Instruction/research/public service, Non-tenured not on tenure track, Professors","3","2","1","0","0","0","0","0","0","0","0","0","0","0","0","0","0","0","2","2","0","0","0","0","1","0","1","0","0","0","-2"
"223232","Baylor University","2010","Total full-time Instruction/research/public service, Non-tenured not on tenure track, Associate professors","1","1","0","0","0","0","0","0","0","0","0","0","0","0","0","0","0","0","1","1","0","0","0","0","0","0","0","0","0","0","-2"
"223232","Baylor University","2010","Total full-time Instruction/research/public servicey, Non-tenured not on tenure track, Assistant professors","1","0","1","0","0","0","0","0","0","0","0","0","0","0","0","0","0","0","1","0","1","0","0","0","0","0","0","0","0","0","-2"
"223232","Baylor University","2010","Total full-time Instruction/research/public service, Non-tenured not on tenure track, Lecturers","264","109","155","2","1","1","4","1","3","2","0","2","10","5","5","0","0","0","234","96","138","2","1","1","3","1","2","7","4","3","-2"
"223232","Baylor University","2010","Total full-time Instruction/research/public service, Non-tenured not on tenure track total","269","112","157","2","1","1","4","1","3","2","0","2","10","5","5","0","0","0","238","99","139","2","1","1","4","1","3","7","4","3","-2"
"224226","Dallas Baptist University","2010","Total full-time Instruction/research/public service, Tenured, Professors","1","0","1","0","0","0","0","0","0","0","0","0","0","0","0","0","0","0","1","0","1","0","0","0","0","0","0","0","0","0","-2"
"224226","Dallas Baptist University","2010","Total full-time Instruction/research/public service, Tenured total","1","0","1","0","0","0","0","0","0","0","0","0","0","0","0","0","0","0","1","0","1","0","0","0","0","0","0","0","0","0","-2"
"224226","Dallas Baptist University","2010","Total full-time Instruction/research/public service, Non-tenured not on tenure track, Professors","49","28","21","0","0","0","3","3","0","0","0","0","2","2","0","0","0","0","44","23","21","0","0","0","0","0","0","0","0","0","-2"
"224226","Dallas Baptist University","2010","Total full-time Instruction/research/public service, Non-tenured not on tenure track, Associate professors","13","10","3","0","0","0","0","0","0","0","0","0","1","1","0","0","0","0","12","9","3","0","0","0","0","0","0","0","0","0","-2"
"224226","Dallas Baptist University","2010","Total full-time Instruction/research/public servicey, Non-tenured not on tenure track, Assistant professors","52","31","21","0","0","0","5","4","1","3","1","2","2","1","1","0","0","0","42","25","17","0","0","0","0","0","0","0","0","0","-2"
"224226","Dallas Baptist University","2010","Total full-time Instruction/research/public service, Non-tenured not on tenure track total","114","69","45","0","0","0","8","7","1","3","1","2","5","4","1","0","0","0","98","57","41","0","0","0","0","0","0","0","0","0","-2"
"224244","Dallas Christian College","2010","Total full-time Instruction/research/public service, Non-tenured not on tenure track, Professors","5","4","1","0","0","0","0","0","0","0","0","0","0","0","0","0","0","0","5","4","1","0","0","0","0","0","0","0","0","0","-2"
"224244","Dallas Christian College","2010","Total full-time Instruction/research/public service, Non-tenured not on tenure track, Associate professors","6","4","2","0","0","0","0","0","0","0","0","0","0","0","0","0","0","0","6","4","2","0","0","0","0","0","0","0","0","0","-2"
"224244","Dallas Christian College","2010","Total full-time Instruction/research/public service, Non-tenured not on tenure track total","11","8","3","0","0","0","0","0","0","0","0","0","0","0","0","0","0","0","11","8","3","0","0","0","0","0","0","0","0","0","-2"
"224545","Texas A&M University-Texarkana","2010","Total full-time Instruction/research/public service, Tenured, Professors","23","12","11","0","0","0","2","2","0","2","1","1","0","0","0","0","0","0","19","9","10","0","0","0","0","0","0","0","0","0","-2"
"224545","Texas A&M University-Texarkana","2010","Total full-time Instruction/research/public service, Tenured, Associate professors","12","6","6","0","0","0","0","0","0","0","0","0","0","0","0","0","0","0","11","6","5","0","0","0","0","0","0","1","0","1","-2"
"224545","Texas A&M University-Texarkana","2010","Total full-time Instruction/research/public service, Tenured, Assistant professors","1","1","0","0","0","0","0","0","0","0","0","0","0","0","0","0","0","0","1","1","0","0","0","0","0","0","0","0","0","0","-2"
"224545","Texas A&M University-Texarkana","2010","Total full-time Instruction/research/public service, Tenured total","36","19","17","0","0","0","2","2","0","2","1","1","0","0","0","0","0","0","31","16","15","0","0","0","0","0","0","1","0","1","-2"
"224545","Texas A&M University-Texarkana","2010","Total full-time Instruction/research/public service, Non-tenured on tenure track, Professors","1","1","0","0","0","0","0","0","0","0","0","0","0","0","0","0","0","0","1","1","0","0","0","0","0","0","0","0","0","0","-2"
"224545","Texas A&M University-Texarkana","2010","Total full-time Instruction/research/public service, Non-tenured on tenure track, Associate professors","6","5","1","1","1","0","1","1","0","0","0","0","0","0","0","0","0","0","3","2","1","0","0","0","0","0","0","1","1","0","-2"
"224545","Texas A&M University-Texarkana","2010","Total full-time Instruction/research/public service, Non-tenured on tenure track, Assistant professors","6","4","2","0","0","0","0","0","0","0","0","0","0","0","0","0","0","0","4","3","1","0","0","0","0","0","0","2","1","1","-2"
"224545","Texas A&M University-Texarkana","2010","Total full-time Instruction/research/public service, Non-tenured on tenure track total","13","10","3","1","1","0","1","1","0","0","0","0","0","0","0","0","0","0","8","6","2","0","0","0","0","0","0","3","2","1","-2"
"224545","Texas A&M University-Texarkana","2010","Total full-time Instruction/research/public service, Non-tenured not on tenure track, Professors","2","1","1","0","0","0","0","0","0","0","0","0","0","0","0","0","0","0","2","1","1","0","0","0","0","0","0","0","0","0","-2"
"224545","Texas A&M University-Texarkana","2010","Total full-time Instruction/research/public service, Non-tenured not on tenure track, Associate professors","2","2","0","0","0","0","0","0","0","0","0","0","0","0","0","0","0","0","2","2","0","0","0","0","0","0","0","0","0","0","-2"
"224545","Texas A&M University-Texarkana","2010","Total full-time Instruction/research/public servicey, Non-tenured not on tenure track, Assistant professors","4","4","0","0","0","0","0","0","0","0","0","0","1","1","0","0","0","0","3","3","0","0","0","0","0","0","0","0","0","0","-2"
"224545","Texas A&M University-Texarkana","2010","Total full-time Instruction/research/public service, Non-tenured not on tenure track, Instructors","5","0","5","0","0","0","0","0","0","0","0","0","0","0","0","0","0","0","5","0","5","0","0","0","0","0","0","0","0","0","-2"
"224545","Texas A&M University-Texarkana","2010","Total full-time Instruction/research/public service, Non-tenured not on tenure track total","13","7","6","0","0","0","0","0","0","0","0","0","1","1","0","0","0","0","12","6","6","0","0","0","0","0","0","0","0","0","-2"
"224554","Texas A & M University-Commerce","2010","Total full-time Instruction/research/public service, Tenured, Professors","35","30","5","1","1","0","4","3","1","1","1","0","0","0","0","0","0","0","29","25","4","0","0","0","0","0","0","0","0","0","-2"
"224554","Texas A & M University-Commerce","2010","Total full-time Instruction/research/public service, Tenured, Associate professors","23","10","13","0","0","0","0","0","0","2","0","2","1","0","1","0","0","0","19","10","9","1","0","1","0","0","0","0","0","0","-2"
"224554","Texas A & M University-Commerce","2010","Total full-time Instruction/research/public service, Tenured, Assistant professors","12","10","2","0","0","0","1","1","0","0","0","0","0","0","0","0","0","0","11","9","2","0","0","0","0","0","0","0","0","0","-2"
"224554","Texas A & M University-Commerce","2010","Total full-time Instruction/research/public service, Tenured, Instructors","4","2","2","0","0","0","0","0","0","2","2","0","0","0","0","0","0","0","2","0","2","0","0","0","0","0","0","0","0","0","-2"
"224554","Texas A & M University-Commerce","2010","Total full-time Instruction/research/public service, Tenured total","74","52","22","1","1","0","5","4","1","5","3","2","1","0","1","0","0","0","61","44","17","1","0","1","0","0","0","0","0","0","-2"
"224554","Texas A & M University-Commerce","2010","Total full-time Instruction/research/public service, Non-tenured on tenure track, Professors","2","1","1","0","0","0","0","0","0","0","0","0","1","1","0","0","0","0","1","0","1","0","0","0","0","0","0","0","0","0","-2"
"224554","Texas A & M University-Commerce","2010","Total full-time Instruction/research/public service, Non-tenured on tenure track, Associate professors","18","10","8","0","0","0","2","1","1","0","0","0","0","0","0","0","0","0","16","9","7","0","0","0","0","0","0","0","0","0","-2"
"224554","Texas A & M University-Commerce","2010","Total full-time Instruction/research/public service, Non-tenured on tenure track, Assistant professors","63","39","24","0","0","0","4","2","2","3","1","2","4","2","2","0","0","0","52","34","18","0","0","0","0","0","0","0","0","0","-2"
"224554","Texas A & M University-Commerce","2010","Total full-time Instruction/research/public service, Non-tenured on tenure track, Instructors","6","5","1","0","0","0","2","2","0","0","0","0","0","0","0","0","0","0","4","3","1","0","0","0","0","0","0","0","0","0","-2"
"224554","Texas A & M University-Commerce","2010","Total full-time Instruction/research/public service, Non-tenured on tenure track total","89","55","34","0","0","0","8","5","3","3","1","2","5","3","2","0","0","0","73","46","27","0","0","0","0","0","0","0","0","0","-2"
"224554","Texas A & M University-Commerce","2010","Total full-time Instruction/research/public service, Non-tenured not on tenure track, Professors","2","1","1","0","0","0","0","0","0","0","0","0","0","0","0","0","0","0","2","1","1","0","0","0","0","0","0","0","0","0","-2"
"224554","Texas A & M University-Commerce","2010","Total full-time Instruction/research/public service, Non-tenured not on tenure track, Associate professors","1","0","1","0","0","0","0","0","0","0","0","0","0","0","0","0","0","0","1","0","1","0","0","0","0","0","0","0","0","0","-2"
"224554","Texas A & M University-Commerce","2010","Total full-time Instruction/research/public servicey, Non-tenured not on tenure track, Assistant professors","46","29","17","0","0","0","4","2","2","3","1","2","6","5","1","0","0","0","33","21","12","0","0","0","0","0","0","0","0","0","-2"
"224554","Texas A & M University-Commerce","2010","Total full-time Instruction/research/public service, Non-tenured not on tenure track, Instructors","56","29","27","0","0","0","7","6","1","6","4","2","0","0","0","0","0","0","43","19","24","0","0","0","0","0","0","0","0","0","-2"
"224554","Texas A & M University-Commerce","2010","Total full-time Instruction/research/public service, Non-tenured not on tenure track total","105","59","46","0","0","0","11","8","3","9","5","4","6","5","1","0","0","0","79","41","38","0","0","0","0","0","0","0","0","0","-2"
"225247","Hardin-Simmons University","2010","Total full-time Instruction/research/public service, Tenured, Professors","54","40","14","0","0","0","0","0","0","0","0","0","1","1","0","0","0","0","53","39","14","0","0","0","0","0","0","0","0","0","-2"
"225247","Hardin-Simmons University","2010","Total full-time Instruction/research/public service, Tenured, Associate professors","37","22","15","0","0","0","0","0","0","0","0","0","0","0","0","0","0","0","37","22","15","0","0","0","0","0","0","0","0","0","-2"
"225247","Hardin-Simmons University","2010","Total full-time Instruction/research/public service, Tenured, Assistant professors","3","2","1","0","0","0","0","0","0","0","0","0","0","0","0","0","0","0","3","2","1","0","0","0","0","0","0","0","0","0","-2"
"225247","Hardin-Simmons University","2010","Total full-time Instruction/research/public service, Tenured total","94","64","30","0","0","0","0","0","0","0","0","0","1","1","0","0","0","0","93","63","30","0","0","0","0","0","0","0","0","0","-2"
"225247","Hardin-Simmons University","2010","Total full-time Instruction/research/public service, Non-tenured on tenure track, Professors","2","1","1","0","0","0","0","0","0","0","0","0","0","0","0","0","0","0","2","1","1","0","0","0","0","0","0","0","0","0","-2"
"225247","Hardin-Simmons University","2010","Total full-time Instruction/research/public service, Non-tenured on tenure track, Associate professors","4","4","0","0","0","0","0","0","0","0","0","0","0","0","0","0","0","0","4","4","0","0","0","0","0","0","0","0","0","0","-2"
"225247","Hardin-Simmons University","2010","Total full-time Instruction/research/public service, Non-tenured on tenure track, Assistant professors","28","17","11","0","0","0","1","1","0","1","1","0","0","0","0","0","0","0","26","15","11","0","0","0","0","0","0","0","0","0","-2"
"225247","Hardin-Simmons University","2010","Total full-time Instruction/research/public service, Non-tenured on tenure track, Instructors","2","1","1","0","0","0","0","0","0","0","0","0","0","0","0","0","0","0","2","1","1","0","0","0","0","0","0","0","0","0","-2"
"225247","Hardin-Simmons University","2010","Total full-time Instruction/research/public service, Non-tenured on tenure track total","36","23","13","0","0","0","1","1","0","1","1","0","0","0","0","0","0","0","34","21","13","0","0","0","0","0","0","0","0","0","-2"
"225247","Hardin-Simmons University","2010","Total full-time Instruction/research/public service, Non-tenured not on tenure track, Professors","1","1","0","0","0","0","0","0","0","0","0","0","0","0","0","0","0","0","1","1","0","0","0","0","0","0","0","0","0","0","-2"
"225247","Hardin-Simmons University","2010","Total full-time Instruction/research/public service, Non-tenured not on tenure track, Associate professors","1","0","1","0","0","0","0","0","0","0","0","0","0","0","0","0","0","0","1","0","1","0","0","0","0","0","0","0","0","0","-2"
"225247","Hardin-Simmons University","2010","Total full-time Instruction/research/public servicey, Non-tenured not on tenure track, Assistant professors","1","1","0","0","0","0","0","0","0","0","0","0","0","0","0","0","0","0","1","1","0","0","0","0","0","0","0","0","0","0","-2"
"225247","Hardin-Simmons University","2010","Total full-time Instruction/research/public service, Non-tenured not on tenure track, Instructors","1","1","0","0","0","0","0","0","0","0","0","0","0","0","0","0","0","0","1","1","0","0","0","0","0","0","0","0","0","0","-2"
"225247","Hardin-Simmons University","2010","Total full-time Instruction/research/public service, Non-tenured not on tenure track total","4","3","1","0","0","0","0","0","0","0","0","0","0","0","0","0","0","0","4","3","1","0","0","0","0","0","0","0","0","0","-2"
"226383","Lubbock Christian University","2010","Total full-time Instruction/research/public service, Tenured, Professors","16","9","7","0","0","0","0","0","0","0","0","0","0","0","0","0","0","0","16","9","7","0","0","0","0","0","0","0","0","0","-2"
"226383","Lubbock Christian University","2010","Total full-time Instruction/research/public service, Tenured, Associate professors","25","14","11","0","0","0","0","0","0","0","0","0","1","1","0","0","0","0","24","13","11","0","0","0","0","0","0","0","0","0","-2"
"226383","Lubbock Christian University","2010","Total full-time Instruction/research/public service, Tenured, Assistant professors","6","2","4","0","0","0","0","0","0","0","0","0","0","0","0","0","0","0","6","2","4","0","0","0","0","0","0","0","0","0","-2"
"226383","Lubbock Christian University","2010","Total full-time Instruction/research/public service, Tenured total","47","25","22","0","0","0","0","0","0","0","0","0","1","1","0","0","0","0","46","24","22","0","0","0","0","0","0","0","0","0","-2"
"226383","Lubbock Christian University","2010","Total full-time Instruction/research/public service, Non-tenured on tenure track, Professors","2","1","1","0","0","0","0","0","0","0","0","0","1","1","0","0","0","0","1","0","1","0","0","0","0","0","0","0","0","0","-2"
"226383","Lubbock Christian University","2010","Total full-time Instruction/research/public service, Non-tenured on tenure track, Associate professors","4","4","0","0","0","0","0","0","0","0","0","0","0","0","0","0","0","0","4","4","0","0","0","0","0","0","0","0","0","0","-2"
"226383","Lubbock Christian University","2010","Total full-time Instruction/research/public service, Non-tenured on tenure track, Assistant professors","20","12","8","0","0","0","0","0","0","0","0","0","0","0","0","0","0","0","20","12","8","0","0","0","0","0","0","0","0","0","-2"
"226383","Lubbock Christian University","2010","Total full-time Instruction/research/public service, Non-tenured on tenure track, Instructors","3","3","0","0","0","0","0","0","0","0","0","0","0","0","0","0","0","0","3","3","0","0","0","0","0","0","0","0","0","0","-2"
"226383","Lubbock Christian University","2010","Total full-time Instruction/research/public service, Non-tenured on tenure track, Lecturers","2","1","1","0","0","0","0","0","0","0","0","0","0","0","0","0","0","0","2","1","1","0","0","0","0","0","0","0","0","0","-2"
"226383","Lubbock Christian University","2010","Total full-time Instruction/research/public service, Non-tenured on tenure track total","31","21","10","0","0","0","0","0","0","0","0","0","1","1","0","0","0","0","30","20","10","0","0","0","0","0","0","0","0","0","-2"
"226833","Midwestern State University","2010","Total full-time Instruction/research/public service, Tenured, Professors","47","34","13","1","0","1","1","1","0","0","0","0","3","2","1","0","0","0","39","29","10","2","1","1","0","0","0","1","1","0","-2"
"226833","Midwestern State University","2010","Total full-time Instruction/research/public service, Tenured, Associate professors","49","33","16","0","0","0","1","1","0","2","1","1","2","1","1","0","0","0","41","28","13","1","1","0","0","0","0","2","1","1","-2"
"226833","Midwestern State University","2010","Total full-time Instruction/research/public service, Tenured, Assistant professors","14","10","4","0","0","0","0","0","0","0","0","0","0","0","0","0","0","0","12","8","4","0","0","0","0","0","0","2","2","0","-2"
"226833","Midwestern State University","2010","Total full-time Instruction/research/public service, Tenured total","110","77","33","1","0","1","2","2","0","2","1","1","5","3","2","0","0","0","92","65","27","3","2","1","0","0","0","5","4","1","-2"
"226833","Midwestern State University","2010","Total full-time Instruction/research/public service, Non-tenured on tenure track, Professors","1","1","0","0","0","0","1","1","0","0","0","0","0","0","0","0","0","0","0","0","0","0","0","0","0","0","0","0","0","0","-2"
"226833","Midwestern State University","2010","Total full-time Instruction/research/public service, Non-tenured on tenure track, Associate professors","6","4","2","0","0","0","0","0","0","1","1","0","2","2","0","0","0","0","3","1","2","0","0","0","0","0","0","0","0","0","-2"
"226833","Midwestern State University","2010","Total full-time Instruction/research/public service, Non-tenured on tenure track, Assistant professors","50","18","32","0","0","0","2","1","1","1","0","1","3","1","2","0","0","0","36","13","23","2","1","1","0","0","0","6","2","4","-2"
"226833","Midwestern State University","2010","Total full-time Instruction/research/public service, Non-tenured on tenure track total","57","23","34","0","0","0","3","2","1","2","1","1","5","3","2","0","0","0","39","14","25","2","1","1","0","0","0","6","2","4","-2"
"226833","Midwestern State University","2010","Total full-time Instruction/research/public service, Non-tenured not on tenure track, Professors","1","1","0","0","0","0","0","0","0","0","0","0","0","0","0","0","0","0","1","1","0","0","0","0","0","0","0","0","0","0","-2"
"226833","Midwestern State University","2010","Total full-time Instruction/research/public servicey, Non-tenured not on tenure track, Assistant professors","28","7","21","0","0","0","0","0","0","0","0","0","0","0","0","0","0","0","27","7","20","0","0","0","0","0","0","1","0","1","-2"
"226833","Midwestern State University","2010","Total full-time Instruction/research/public service, Non-tenured not on tenure track, Instructors","30","11","19","0","0","0","0","0","0","0","0","0","0","0","0","0","0","0","30","11","19","0","0","0","0","0","0","0","0","0","-2"
"226833","Midwestern State University","2010","Total full-time Instruction/research/public service, Non-tenured not on tenure track total","59","19","40","0","0","0","0","0","0","0","0","0","0","0","0","0","0","0","58","19","39","0","0","0","0","0","0","1","0","1","-2"
"227881","Sam Houston State University","2010","Total full-time Instruction/research/public service, Tenured, Professors","138","106","32","1","1","0","7","6","1","2","1","1","4","1","3","0","0","0","123","96","27","0","0","0","0","0","0","1","1","0","-2"
"227881","Sam Houston State University","2010","Total full-time Instruction/research/public service, Tenured, Associate professors","121","69","52","0","0","0","8","4","4","3","2","1","4","3","1","0","0","0","106","60","46","0","0","0","0","0","0","0","0","0","-2"
"227881","Sam Houston State University","2010","Total full-time Instruction/research/public service, Tenured, Assistant professors","7","4","3","0","0","0","1","1","0","0","0","0","1","1","0","0","0","0","5","2","3","0","0","0","0","0","0","0","0","0","-2"
"227881","Sam Houston State University","2010","Total full-time Instruction/research/public service, Tenured, Instructors","2","0","2","0","0","0","0","0","0","0","0","0","0","0","0","0","0","0","2","0","2","0","0","0","0","0","0","0","0","0","-2"
"227881","Sam Houston State University","2010","Total full-time Instruction/research/public service, Tenured total","268","179","89","1","1","0","16","11","5","5","3","2","9","5","4","0","0","0","236","158","78","0","0","0","0","0","0","1","1","0","-2"
"227881","Sam Houston State University","2010","Total full-time Instruction/research/public service, Non-tenured on tenure track, Professors","1","0","1","0","0","0","0","0","0","1","0","1","0","0","0","0","0","0","0","0","0","0","0","0","0","0","0","0","0","0","-2"
"227881","Sam Houston State University","2010","Total full-time Instruction/research/public service, Non-tenured on tenure track, Associate professors","16","9","7","0","0","0","1","1","0","2","0","2","0","0","0","0","0","0","12","7","5","0","0","0","0","0","0","1","1","0","-2"
"227881","Sam Houston State University","2010","Total full-time Instruction/research/public service, Non-tenured on tenure track, Assistant professors","188","101","87","1","0","1","17","6","11","3","1","2","16","9","7","0","0","0","138","76","62","0","0","0","0","0","0","13","9","4","-2"
"227881","Sam Houston State University","2010","Total full-time Instruction/research/public service, Non-tenured on tenure track total","205","110","95","1","0","1","18","7","11","6","1","5","16","9","7","0","0","0","150","83","67","0","0","0","0","0","0","14","10","4","-2"
"227881","Sam Houston State University","2010","Total full-time Instruction/research/public service, Non-tenured not on tenure track, Professors","2","2","0","0","0","0","0","0","0","0","0","0","0","0","0","0","0","0","2","2","0","0","0","0","0","0","0","0","0","0","-2"
"227881","Sam Houston State University","2010","Total full-time Instruction/research/public service, Non-tenured not on tenure track, Associate professors","1","0","1","0","0","0","0","0","0","1","0","1","0","0","0","0","0","0","0","0","0","0","0","0","0","0","0","0","0","0","-2"
"227881","Sam Houston State University","2010","Total full-time Instruction/research/public service, Non-tenured not on tenure track, Lecturers","141","56","85","2","1","1","4","0","4","5","3","2","12","6","6","0","0","0","113","43","70","0","0","0","0","0","0","5","3","2","-2"
"227881","Sam Houston State University","2010","Total full-time Instruction/research/public service, Non-tenured not on tenure track total","144","58","86","2","1","1","4","0","4","6","3","3","12","6","6","0","0","0","115","45","70","0","0","0","0","0","0","5","3","2","-2"
"228431","Stephen F Austin State University","2010","Total full-time Instruction/research/public service, Tenured, Professors","60","48","12","1","1","0","0","0","0","1","1","0","0","0","0","0","0","0","58","46","12","0","0","0","0","0","0","0","0","0","-2"
"228431","Stephen F Austin State University","2010","Total full-time Instruction/research/public service, Tenured, Associate professors","81","53","28","0","0","0","0","0","0","2","1","1","3","1","2","0","0","0","75","50","25","1","1","0","0","0","0","0","0","0","-2"
"228431","Stephen F Austin State University","2010","Total full-time Instruction/research/public service, Tenured, Assistant professors","58","33","25","0","0","0","0","0","0","0","0","0","2","1","1","0","0","0","54","32","22","2","0","2","0","0","0","0","0","0","-2"
"228431","Stephen F Austin State University","2010","Total full-time Instruction/research/public service, Tenured, Instructors","7","3","4","0","0","0","0","0","0","0","0","0","0","0","0","0","0","0","7","3","4","0","0","0","0","0","0","0","0","0","-2"
"228431","Stephen F Austin State University","2010","Total full-time Instruction/research/public service, Tenured, No academic rank","9","4","5","0","0","0","0","0","0","1","0","1","0","0","0","0","0","0","8","4","4","0","0","0","0","0","0","0","0","0","-2"
"228431","Stephen F Austin State University","2010","Total full-time Instruction/research/public service, Tenured total","215","141","74","1","1","0","0","0","0","4","2","2","5","2","3","0","0","0","202","135","67","3","1","2","0","0","0","0","0","0","-2"
"228431","Stephen F Austin State University","2010","Total full-time Instruction/research/public service, Non-tenured on tenure track, Professors","2","2","0","0","0","0","0","0","0","0","0","0","0","0","0","0","0","0","2","2","0","0","0","0","0","0","0","0","0","0","-2"
"228431","Stephen F Austin State University","2010","Total full-time Instruction/research/public service, Non-tenured on tenure track, Associate professors","5","4","1","0","0","0","0","0","0","0","0","0","1","0","1","0","0","0","4","4","0","0","0","0","0","0","0","0","0","0","-2"
"228431","Stephen F Austin State University","2010","Total full-time Instruction/research/public service, Non-tenured on tenure track, Assistant professors","106","58","48","0","0","0","3","1","2","5","5","0","8","5","3","0","0","0","87","47","40","3","0","3","0","0","0","0","0","0","-2"
"228431","Stephen F Austin State University","2010","Total full-time Instruction/research/public service, Non-tenured on tenure track, Instructors","6","3","3","0","0","0","0","0","0","0","0","0","1","1","0","0","0","0","3","1","2","2","1","1","0","0","0","0","0","0","-2"
"228431","Stephen F Austin State University","2010","Total full-time Instruction/research/public service, Non-tenured on tenure track, No academic rank","25","16","9","0","0","0","1","1","0","1","0","1","0","0","0","0","0","0","23","15","8","0","0","0","0","0","0","0","0","0","-2"
"228431","Stephen F Austin State University","2010","Total full-time Instruction/research/public service, Non-tenured on tenure track total","144","83","61","0","0","0","4","2","2","6","5","1","10","6","4","0","0","0","119","69","50","5","1","4","0","0","0","0","0","0","-2"
"228431","Stephen F Austin State University","2010","Total full-time Instruction/research/public service, Non-tenured not on tenure track, Associate professors","1","1","0","0","0","0","0","0","0","0","0","0","0","0","0","0","0","0","1","1","0","0","0","0","0","0","0","0","0","0","-2"
"228431","Stephen F Austin State University","2010","Total full-time Instruction/research/public servicey, Non-tenured not on tenure track, Assistant professors","6","4","2","0","0","0","0","0","0","0","0","0","0","0","0","0","0","0","6","4","2","0","0","0","0","0","0","0","0","0","-2"
"228431","Stephen F Austin State University","2010","Total full-time Instruction/research/public service, Non-tenured not on tenure track, Instructors","32","5","27","0","0","0","0","0","0","1","0","1","1","1","0","0","0","0","29","4","25","1","0","1","0","0","0","0","0","0","-2"
"228431","Stephen F Austin State University","2010","Total full-time Instruction/research/public service, Non-tenured not on tenure track, Lecturers","24","8","16","0","0","0","0","0","0","0","0","0","0","0","0","0","0","0","21","6","15","3","2","1","0","0","0","0","0","0","-2"
"228431","Stephen F Austin State University","2010","Total full-time Instruction/research/public service, Non-tenured not on tenure track, No academic rank","52","15","37","1","0","1","0","0","0","2","0","2","2","1","1","0","0","0","47","14","33","0","0","0","0","0","0","0","0","0","-2"
"228431","Stephen F Austin State University","2010","Total full-time Instruction/research/public service, Non-tenured not on tenure track total","115","33","82","1","0","1","0","0","0","3","0","3","3","2","1","0","0","0","104","29","75","4","2","2","0","0","0","0","0","0","-2"
"228529","Tarleton State University","2010","Total full-time Instruction/research/public service, Tenured, Professors","63","47","16","2","2","0","2","2","0","0","0","0","0","0","0","0","0","0","59","43","16","0","0","0","0","0","0","0","0","0","-2"
"228529","Tarleton State University","2010","Total full-time Instruction/research/public service, Tenured, Associate professors","56","33","23","1","1","0","3","3","0","0","0","0","3","3","0","0","0","0","49","26","23","0","0","0","0","0","0","0","0","0","-2"
"228529","Tarleton State University","2010","Total full-time Instruction/research/public service, Tenured, Assistant professors","3","3","0","0","0","0","0","0","0","0","0","0","0","0","0","0","0","0","3","3","0","0","0","0","0","0","0","0","0","0","-2"
"228529","Tarleton State University","2010","Total full-time Instruction/research/public service, Tenured total","122","83","39","3","3","0","5","5","0","0","0","0","3","3","0","0","0","0","111","72","39","0","0","0","0","0","0","0","0","0","-2"
"228529","Tarleton State University","2010","Total full-time Instruction/research/public service, Non-tenured on tenure track, Associate professors","6","3","3","0","0","0","0","0","0","0","0","0","1","1","0","0","0","0","5","2","3","0","0","0","0","0","0","0","0","0","-2"
"228529","Tarleton State University","2010","Total full-time Instruction/research/public service, Non-tenured on tenure track, Assistant professors","89","54","35","0","0","0","6","4","2","2","1","1","4","0","4","1","1","0","75","47","28","1","1","0","0","0","0","0","0","0","-2"
"228529","Tarleton State University","2010","Total full-time Instruction/research/public service, Non-tenured on tenure track total","95","57","38","0","0","0","6","4","2","2","1","1","5","1","4","1","1","0","80","49","31","1","1","0","0","0","0","0","0","0","-2"
"228529","Tarleton State University","2010","Total full-time Instruction/research/public service, Non-tenured not on tenure track, Associate professors","3","1","2","0","0","0","0","0","0","1","0","1","0","0","0","0","0","0","2","1","1","0","0","0","0","0","0","0","0","0","-2"
"228529","Tarleton State University","2010","Total full-time Instruction/research/public servicey, Non-tenured not on tenure track, Assistant professors","45","14","31","0","0","0","1","0","1","3","3","0","2","0","2","0","0","0","39","11","28","0","0","0","0","0","0","0","0","0","-2"
"228529","Tarleton State University","2010","Total full-time Instruction/research/public service, Non-tenured not on tenure track, Instructors","60","23","37","0","0","0","2","0","2","0","0","0","4","0","4","0","0","0","53","22","31","1","1","0","0","0","0","0","0","0","-2"
"228529","Tarleton State University","2010","Total full-time Instruction/research/public service, Non-tenured not on tenure track, Lecturers","13","8","5","0","0","0","0","0","0","3","3","0","0","0","0","0","0","0","9","5","4","1","0","1","0","0","0","0","0","0","-2"
"228529","Tarleton State University","2010","Total full-time Instruction/research/public service, Non-tenured not on tenure track, No academic rank","6","3","3","0","0","0","0","0","0","0","0","0","0","0","0","0","0","0","5","3","2","1","0","1","0","0","0","0","0","0","-2"
"228529","Tarleton State University","2010","Total full-time Instruction/research/public service, Non-tenured not on tenure track total","127","49","78","0","0","0","3","0","3","7","6","1","6","0","6","0","0","0","108","42","66","3","1","2","0","0","0","0","0","0","-2"
"228653","The University of Texas Medical Branch at Galveston","2010","Total full-time Instruction/research/public service, Tenured, Professors","171","131","40","1","1","0","30","20","10","5","5","0","10","8","2","0","0","0","125","97","28","0","0","0","0","0","0","0","0","0","-2"
"228653","The University of Texas Medical Branch at Galveston","2010","Total full-time Instruction/research/public service, Tenured, Associate professors","43","24","19","0","0","0","7","4","3","1","1","0","4","3","1","0","0","0","31","16","15","0","0","0","0","0","0","0","0","0","-2"
"228653","The University of Texas Medical Branch at Galveston","2010","Total full-time Instruction/research/public service, Tenured, Assistant professors","7","6","1","0","0","0","2","2","0","0","0","0","0","0","0","0","0","0","1","1","0","0","0","0","0","0","0","4","3","1","-2"
"228653","The University of Texas Medical Branch at Galveston","2010","Total full-time Instruction/research/public service, Tenured total","221","161","60","1","1","0","39","26","13","6","6","0","14","11","3","0","0","0","157","114","43","0","0","0","0","0","0","4","3","1","-2"
"228653","The University of Texas Medical Branch at Galveston","2010","Total full-time Instruction/research/public service, Non-tenured on tenure track, Professors","5","4","1","0","0","0","0","0","0","0","0","0","0","0","0","0","0","0","5","4","1","0","0","0","0","0","0","0","0","0","-2"
"228653","The University of Texas Medical Branch at Galveston","2010","Total full-time Instruction/research/public service, Non-tenured on tenure track, Associate professors","27","16","11","0","0","0","10","5","5","1","0","1","1","1","0","0","0","0","10","6","4","0","0","0","0","0","0","5","4","1","-2"
"228653","The University of Texas Medical Branch at Galveston","2010","Total full-time Instruction/research/public service, Non-tenured on tenure track, Assistant professors","85","43","42","0","0","0","16","9","7","5","2","3","6","2","4","0","0","0","36","16","20","0","0","0","0","0","0","22","14","8","-2"
"228653","The University of Texas Medical Branch at Galveston","2010","Total full-time Instruction/research/public service, Non-tenured on tenure track, Instructors","1","1","0","0","0","0","0","0","0","0","0","0","0","0","0","0","0","0","0","0","0","0","0","0","0","0","0","1","1","0","-2"
"228653","The University of Texas Medical Branch at Galveston","2010","Total full-time Instruction/research/public service, Non-tenured on tenure track total","118","64","54","0","0","0","26","14","12","6","2","4","7","3","4","0","0","0","51","26","25","0","0","0","0","0","0","28","19","9","-2"
"228653","The University of Texas Medical Branch at Galveston","2010","Total full-time Instruction/research/public service, Non-tenured not on tenure track, Professors","41","32","9","0","0","0","7","6","1","1","0","1","1","1","0","1","1","0","30","23","7","0","0","0","0","0","0","1","1","0","-2"
"228653","The University of Texas Medical Branch at Galveston","2010","Total full-time Instruction/research/public service, Non-tenured not on tenure track, Associate professors","93","64","29","0","0","0","18","12","6","6","4","2","6","4","2","0","0","0","57","39","18","0","0","0","0","0","0","6","5","1","-2"
"228653","The University of Texas Medical Branch at Galveston","2010","Total full-time Instruction/research/public servicey, Non-tenured not on tenure track, Assistant professors","235","115","120","1","0","1","47","22","25","15","10","5","19","7","12","1","1","0","114","50","64","0","0","0","1","1","0","37","24","13","-2"
"228653","The University of Texas Medical Branch at Galveston","2010","Total full-time Instruction/research/public service, Non-tenured not on tenure track, Instructors","62","23","39","0","0","0","9","5","4","2","0","2","3","1","2","0","0","0","33","8","25","0","0","0","0","0","0","15","9","6","-2"
"228653","The University of Texas Medical Branch at Galveston","2010","Total full-time Instruction/research/public service, Non-tenured not on tenure track total","431","234","197","1","0","1","81","45","36","24","14","10","29","13","16","2","2","0","234","120","114","0","0","0","1","1","0","59","39","20","-2"
"228802","The University of Texas at Tyler","2010","Total full-time Instruction/research/public service, Tenured, Professors","52","39","13","1","1","0","9","8","1","0","0","0","0","0","0","0","0","0","42","30","12","0","0","0","0","0","0","0","0","0","-2"
"228802","The University of Texas at Tyler","2010","Total full-time Instruction/research/public service, Tenured, Associate professors","51","32","19","1","0","1","3","3","0","2","1","1","0","0","0","0","0","0","45","28","17","0","0","0","0","0","0","0","0","0","-2"
"228802","The University of Texas at Tyler","2010","Total full-time Instruction/research/public service, Tenured, No academic rank","5","1","4","0","0","0","0","0","0","0","0","0","0","0","0","0","0","0","5","1","4","0","0","0","0","0","0","0","0","0","-2"
"228802","The University of Texas at Tyler","2010","Total full-time Instruction/research/public service, Tenured total","108","72","36","2","1","1","12","11","1","2","1","1","0","0","0","0","0","0","92","59","33","0","0","0","0","0","0","0","0","0","-2"
"228802","The University of Texas at Tyler","2010","Total full-time Instruction/research/public service, Non-tenured on tenure track, Associate professors","7","5","2","0","0","0","1","0","1","0","0","0","1","1","0","0","0","0","5","4","1","0","0","0","0","0","0","0","0","0","-2"
"228802","The University of Texas at Tyler","2010","Total full-time Instruction/research/public service, Non-tenured on tenure track, Assistant professors","63","33","30","0","0","0","3","3","0","3","2","1","4","2","2","0","0","0","49","23","26","0","0","0","0","0","0","4","3","1","-2"
"228802","The University of Texas at Tyler","2010","Total full-time Instruction/research/public service, Non-tenured on tenure track total","70","38","32","0","0","0","4","3","1","3","2","1","5","3","2","0","0","0","54","27","27","0","0","0","0","0","0","4","3","1","-2"
"228802","The University of Texas at Tyler","2010","Total full-time Instruction/research/public service, Non-tenured not on tenure track, Professors","1","0","1","0","0","0","0","0","0","0","0","0","0","0","0","0","0","0","1","0","1","0","0","0","0","0","0","0","0","0","-2"
"228802","The University of Texas at Tyler","2010","Total full-time Instruction/research/public service, Non-tenured not on tenure track, Associate professors","4","1","3","0","0","0","0","0","0","0","0","0","0","0","0","0","0","0","4","1","3","0","0","0","0","0","0","0","0","0","-2"
"228802","The University of Texas at Tyler","2010","Total full-time Instruction/research/public servicey, Non-tenured not on tenure track, Assistant professors","5","1","4","0","0","0","0","0","0","1","0","1","0","0","0","0","0","0","3","0","3","0","0","0","0","0","0","1","1","0","-2"
"228802","The University of Texas at Tyler","2010","Total full-time Instruction/research/public service, Non-tenured not on tenure track, Instructors","42","0","42","0","0","0","0","0","0","2","0","2","1","0","1","0","0","0","39","0","39","0","0","0","0","0","0","0","0","0","-2"
"228802","The University of Texas at Tyler","2010","Total full-time Instruction/research/public service, Non-tenured not on tenure track, Lecturers","37","11","26","0","0","0","0","0","0","1","0","1","0","0","0","0","0","0","35","11","24","0","0","0","0","0","0","1","0","1","-2"
"228802","The University of Texas at Tyler","2010","Total full-time Instruction/research/public service, Non-tenured not on tenure track, No academic rank","4","2","2","0","0","0","0","0","0","0","0","0","0","0","0","0","0","0","4","2","2","0","0","0","0","0","0","0","0","0","-2"
"228802","The University of Texas at Tyler","2010","Total full-time Instruction/research/public service, Non-tenured not on tenure track total","93","15","78","0","0","0","0","0","0","4","0","4","1","0","1","0","0","0","86","14","72","0","0","0","0","0","0","2","1","1","-2"
"235237","Pierce College District","2010","Total full-time Instruction/research/public service, Tenured, No academic rank","63","31","32","2","1","1","4","1","3","0","0","0","3","1","2","0","0","0","51","27","24","3","1","2","0","0","0","0","0","0","-2"
"235237","Pierce College District","2010","Total full-time Instruction/research/public service, Tenured total","63","31","32","2","1","1","4","1","3","0","0","0","3","1","2","0","0","0","51","27","24","3","1","2","0","0","0","0","0","0","-2"
"235237","Pierce College District","2010","Total full-time Instruction/research/public service, Non-tenured on tenure track, No academic rank","12","2","10","0","0","0","0","0","0","0","0","0","0","0","0","0","0","0","12","2","10","0","0","0","0","0","0","0","0","0","-2"
"235237","Pierce College District","2010","Total full-time Instruction/research/public service, Non-tenured on tenure track total","12","2","10","0","0","0","0","0","0","0","0","0","0","0","0","0","0","0","12","2","10","0","0","0","0","0","0","0","0","0","-2"
"235237","Pierce College District","2010","Total full-time Instruction/research/public service, Non-tenured not on tenure track, No academic rank","9","5","4","0","0","0","0","0","0","0","0","0","0","0","0","0","0","0","9","5","4","0","0","0","0","0","0","0","0","0","-2"
"235237","Pierce College District","2010","Total full-time Instruction/research/public service, Non-tenured not on tenure track total","9","5","4","0","0","0","0","0","0","0","0","0","0","0","0","0","0","0","9","5","4","0","0","0","0","0","0","0","0","0","-2"
"236452","Saint Martin's University","2010","Total full-time Instruction/research/public service, Tenured, Professors","19","14","5","0","0","0","3","3","0","1","1","0","1","0","1","0","0","0","14","10","4","0","0","0","0","0","0","0","0","0","-2"
"236452","Saint Martin's University","2010","Total full-time Instruction/research/public service, Tenured, Associate professors","32","19","13","0","0","0","2","1","1","1","1","0","1","1","0","0","0","0","28","16","12","0","0","0","0","0","0","0","0","0","-2"
"236452","Saint Martin's University","2010","Total full-time Instruction/research/public service, Tenured total","51","33","18","0","0","0","5","4","1","2","2","0","2","1","1","0","0","0","42","26","16","0","0","0","0","0","0","0","0","0","-2"
"236452","Saint Martin's University","2010","Total full-time Instruction/research/public service, Non-tenured on tenure track, Professors","1","0","1","0","0","0","0","0","0","0","0","0","0","0","0","0","0","0","1","0","1","0","0","0","0","0","0","0","0","0","-2"
"236452","Saint Martin's University","2010","Total full-time Instruction/research/public service, Non-tenured on tenure track, Associate professors","1","1","0","0","0","0","0","0","0","0","0","0","0","0","0","0","0","0","1","1","0","0","0","0","0","0","0","0","0","0","-2"
"236452","Saint Martin's University","2010","Total full-time Instruction/research/public service, Non-tenured on tenure track, Assistant professors","12","9","3","0","0","0","0","0","0","0","0","0","0","0","0","0","0","0","12","9","3","0","0","0","0","0","0","0","0","0","-2"
"236452","Saint Martin's University","2010","Total full-time Instruction/research/public service, Non-tenured on tenure track total","14","10","4","0","0","0","0","0","0","0","0","0","0","0","0","0","0","0","14","10","4","0","0","0","0","0","0","0","0","0","-2"
"236452","Saint Martin's University","2010","Total full-time Instruction/research/public service, Non-tenured not on tenure track, Associate professors","1","1","0","0","0","0","0","0","0","0","0","0","0","0","0","0","0","0","1","1","0","0","0","0","0","0","0","0","0","0","-2"
"236452","Saint Martin's University","2010","Total full-time Instruction/research/public service, Non-tenured not on tenure track, Instructors","4","4","0","0","0","0","0","0","0","0","0","0","0","0","0","0","0","0","4","4","0","0","0","0","0","0","0","0","0","0","-2"
"236452","Saint Martin's University","2010","Total full-time Instruction/research/public service, Non-tenured not on tenure track total","5","5","0","0","0","0","0","0","0","0","0","0","0","0","0","0","0","0","5","5","0","0","0","0","0","0","0","0","0","0","-2"
"236638","Skagit Valley College","2010","Total full-time Instruction/research/public service, Tenured, No academic rank","88","37","51","2","2","0","1","0","1","0","0","0","4","3","1","0","0","0","80","31","49","0","0","0","1","1","0","0","0","0","-2"
"236638","Skagit Valley College","2010","Total full-time Instruction/research/public service, Tenured total","88","37","51","2","2","0","1","0","1","0","0","0","4","3","1","0","0","0","80","31","49","0","0","0","1","1","0","0","0","0","-2"
"236638","Skagit Valley College","2010","Total full-time Instruction/research/public service, Non-tenured on tenure track, No academic rank","15","3","12","0","0","0","0","0","0","0","0","0","1","0","1","0","0","0","7","1","6","0","0","0","7","2","5","0","0","0","-2"
"236638","Skagit Valley College","2010","Total full-time Instruction/research/public service, Non-tenured on tenure track total","15","3","12","0","0","0","0","0","0","0","0","0","1","0","1","0","0","0","7","1","6","0","0","0","7","2","5","0","0","0","-2"
"236638","Skagit Valley College","2010","Total full-time Instruction/research/public service, Non-tenured not on tenure track, No academic rank","11","3","8","1","0","1","0","0","0","0","0","0","0","0","0","0","0","0","9","3","6","0","0","0","1","0","1","0","0","0","-2"
"236638","Skagit Valley College","2010","Total full-time Instruction/research/public service, Non-tenured not on tenure track total","11","3","8","1","0","1","0","0","0","0","0","0","0","0","0","0","0","0","9","3","6","0","0","0","1","0","1","0","0","0","-2"
"236887","Walla Walla Community College","2010","Total full-time Instruction/research/public service, Tenured, No academic rank","75","43","32","3","2","1","3","1","2","2","1","1","1","1","0","0","0","0","66","38","28","0","0","0","0","0","0","0","0","0","-2"
"236887","Walla Walla Community College","2010","Total full-time Instruction/research/public service, Tenured total","75","43","32","3","2","1","3","1","2","2","1","1","1","1","0","0","0","0","66","38","28","0","0","0","0","0","0","0","0","0","-2"
"236887","Walla Walla Community College","2010","Total full-time Instruction/research/public service, Non-tenured on tenure track, No academic rank","16","8","8","0","0","0","0","0","0","0","0","0","0","0","0","0","0","0","16","8","8","0","0","0","0","0","0","0","0","0","-2"
"236887","Walla Walla Community College","2010","Total full-time Instruction/research/public service, Non-tenured on tenure track total","16","8","8","0","0","0","0","0","0","0","0","0","0","0","0","0","0","0","16","8","8","0","0","0","0","0","0","0","0","0","-2"
"236887","Walla Walla Community College","2010","Total full-time Instruction/research/public service, Non-tenured not on tenure track, No academic rank","36","26","10","0","0","0","0","0","0","0","0","0","1","1","0","0","0","0","35","25","10","0","0","0","0","0","0","0","0","0","-2"
"236887","Walla Walla Community College","2010","Total full-time Instruction/research/public service, Non-tenured not on tenure track total","36","26","10","0","0","0","0","0","0","0","0","0","1","1","0","0","0","0","35","25","10","0","0","0","0","0","0","0","0","0","-2"
"240374","University of Wisconsin-Parkside","2010","Total full-time Instruction/research/public service, Tenured, Professors","27","18","9","0","0","0","5","3","2","1","1","0","0","0","0","0","0","0","21","14","7","0","0","0","0","0","0","0","0","0","-2"
"240374","University of Wisconsin-Parkside","2010","Total full-time Instruction/research/public service, Tenured, Associate professors","51","28","23","0","0","0","9","3","6","3","2","1","2","1","1","0","0","0","37","22","15","0","0","0","0","0","0","0","0","0","-2"
"240374","University of Wisconsin-Parkside","2010","Total full-time Instruction/research/public service, Tenured, Assistant professors","1","1","0","0","0","0","1","1","0","0","0","0","0","0","0","0","0","0","0","0","0","0","0","0","0","0","0","0","0","0","-2"
"240374","University of Wisconsin-Parkside","2010","Total full-time Instruction/research/public service, Tenured total","79","47","32","0","0","0","15","7","8","4","3","1","2","1","1","0","0","0","58","36","22","0","0","0","0","0","0","0","0","0","-2"
"240374","University of Wisconsin-Parkside","2010","Total full-time Instruction/research/public service, Non-tenured on tenure track, Associate professors","2","1","1","0","0","0","0","0","0","0","0","0","0","0","0","0","0","0","2","1","1","0","0","0","0","0","0","0","0","0","-2"
"240374","University of Wisconsin-Parkside","2010","Total full-time Instruction/research/public service, Non-tenured on tenure track, Assistant professors","36","17","19","0","0","0","5","3","2","3","2","1","5","1","4","0","0","0","17","8","9","0","0","0","0","0","0","6","3","3","-2"
"240374","University of Wisconsin-Parkside","2010","Total full-time Instruction/research/public service, Non-tenured on tenure track total","38","18","20","0","0","0","5","3","2","3","2","1","5","1","4","0","0","0","19","9","10","0","0","0","0","0","0","6","3","3","-2"
"240374","University of Wisconsin-Parkside","2010","Total full-time Instruction/research/public service, Non-tenured not on tenure track, Professors","1","1","0","0","0","0","0","0","0","0","0","0","0","0","0","0","0","0","1","1","0","0","0","0","0","0","0","0","0","0","-2"
"240374","University of Wisconsin-Parkside","2010","Total full-time Instruction/research/public service, Non-tenured not on tenure track, Associate professors","1","0","1","0","0","0","0","0","0","0","0","0","0","0","0","0","0","0","1","0","1","0","0","0","0","0","0","0","0","0","-2"
"240374","University of Wisconsin-Parkside","2010","Total full-time Instruction/research/public servicey, Non-tenured not on tenure track, Assistant professors","2","1","1","0","0","0","0","0","0","0","0","0","0","0","0","0","0","0","1","0","1","0","0","0","1","1","0","0","0","0","-2"
"240374","University of Wisconsin-Parkside","2010","Total full-time Instruction/research/public service, Non-tenured not on tenure track, Lecturers","55","27","28","0","0","0","3","1","2","2","1","1","3","0","3","0","0","0","45","24","21","0","0","0","1","0","1","1","1","0","-2"
"240374","University of Wisconsin-Parkside","2010","Total full-time Instruction/research/public service, Non-tenured not on tenure track, No academic rank","1","0","1","0","0","0","0","0","0","0","0","0","0","0","0","0","0","0","1","0","1","0","0","0","0","0","0","0","0","0","-2"
"240374","University of Wisconsin-Parkside","2010","Total full-time Instruction/research/public service, Non-tenured not on tenure track total","60","29","31","0","0","0","3","1","2","2","1","1","3","0","3","0","0","0","49","25","24","0","0","0","2","1","1","1","1","0","-2"
"245838","Antioch University-Los Angeles","2010","Total full-time Instruction/research/public service, Non-tenured not on tenure track, Professors","26","13","13","0","0","0","3","2","1","2","0","2","1","1","0","0","0","0","20","10","10","0","0","0","0","0","0","0","0","0","-2"
"245838","Antioch University-Los Angeles","2010","Total full-time Instruction/research/public service, Non-tenured not on tenure track total","26","13","13","0","0","0","3","2","1","2","0","2","1","1","0","0","0","0","20","10","10","0","0","0","0","0","0","0","0","0","-2"
"247834","Collin County Community College District","2010","Total full-time Instruction/research/public service, Non-tenured not on tenure track, No academic rank","347","146","201","3","1","2","10","0","10","23","10","13","13","1","12","0","0","0","298","134","164","0","0","0","0","0","0","0","0","0","-2"
"247834","Collin County Community College District","2010","Total full-time Instruction/research/public service, Non-tenured not on tenure track total","347","146","201","3","1","2","10","0","10","23","10","13","13","1","12","0","0","0","298","134","164","0","0","0","0","0","0","0","0","0","-2"
"262086","Brandman University","2010","Total full-time Instruction/research/public service, Non-tenured not on tenure track, Professors","4","0","4","0","0","0","0","0","0","1","0","1","0","0","0","0","0","0","3","0","3","0","0","0","0","0","0","0","0","0","-2"
"262086","Brandman University","2010","Total full-time Instruction/research/public service, Non-tenured not on tenure track, Associate professors","18","6","12","0","0","0","2","2","0","1","0","1","0","0","0","0","0","0","14","4","10","0","0","0","1","0","1","0","0","0","-2"
"262086","Brandman University","2010","Total full-time Instruction/research/public servicey, Non-tenured not on tenure track, Assistant professors","46","25","21","1","1","0","3","3","0","5","4","1","0","0","0","0","0","0","36","16","20","1","1","0","0","0","0","0","0","0","-2"
"262086","Brandman University","2010","Total full-time Instruction/research/public service, Non-tenured not on tenure track total","68","31","37","1","1","0","5","5","0","7","4","3","0","0","0","0","0","0","53","20","33","1","1","0","1","0","1","0","0","0","-2"
"262129","New College of Florida","2010","Total full-time Instruction/research/public service, Tenured, Professors","24","15","9","0","0","0","0","0","0","1","1","0","1","1","0","0","0","0","22","13","9","0","0","0","0","0","0","0","0","0","-2"
"262129","New College of Florida","2010","Total full-time Instruction/research/public service, Tenured, Associate professors","25","10","15","0","0","0","0","0","0","1","0","1","2","0","2","0","0","0","22","10","12","0","0","0","0","0","0","0","0","0","-2"
"262129","New College of Florida","2010","Total full-time Instruction/research/public service, Tenured total","49","25","24","0","0","0","0","0","0","2","1","1","3","1","2","0","0","0","44","23","21","0","0","0","0","0","0","0","0","0","-2"
"262129","New College of Florida","2010","Total full-time Instruction/research/public service, Non-tenured on tenure track, Assistant professors","18","12","6","0","0","0","2","1","1","0","0","0","0","0","0","0","0","0","15","11","4","0","0","0","0","0","0","1","0","1","-2"
"262129","New College of Florida","2010","Total full-time Instruction/research/public service, Non-tenured on tenure track total","18","12","6","0","0","0","2","1","1","0","0","0","0","0","0","0","0","0","15","11","4","0","0","0","0","0","0","1","0","1","-2"
"262129","New College of Florida","2010","Total full-time Instruction/research/public servicey, Non-tenured not on tenure track, Assistant professors","5","2","3","0","0","0","0","0","0","0","0","0","1","1","0","0","0","0","4","1","3","0","0","0","0","0","0","0","0","0","-2"
"262129","New College of Florida","2010","Total full-time Instruction/research/public service, Non-tenured not on tenure track, Instructors","1","0","1","0","0","0","0","0","0","0","0","0","0","0","0","0","0","0","1","0","1","0","0","0","0","0","0","0","0","0","-2"
"262129","New College of Florida","2010","Total full-time Instruction/research/public service, Non-tenured not on tenure track total","6","2","4","0","0","0","0","0","0","0","0","0","1","1","0","0","0","0","5","1","4","0","0","0","0","0","0","0","0","0","-2"
"426314","Embry-Riddle Aeronautical University-Worldwide","2010","Total full-time Instruction/research/public service, Tenured, Professors","6","6","0","0","0","0","0","0","0","0","0","0","0","0","0","0","0","0","6","6","0","0","0","0","0","0","0","0","0","0","-2"
"426314","Embry-Riddle Aeronautical University-Worldwide","2010","Total full-time Instruction/research/public service, Tenured, Associate professors","1","0","1","0","0","0","0","0","0","0","0","0","0","0","0","0","0","0","1","0","1","0","0","0","0","0","0","0","0","0","-2"
"426314","Embry-Riddle Aeronautical University-Worldwide","2010","Total full-time Instruction/research/public service, Tenured total","7","6","1","0","0","0","0","0","0","0","0","0","0","0","0","0","0","0","7","6","1","0","0","0","0","0","0","0","0","0","-2"
"426314","Embry-Riddle Aeronautical University-Worldwide","2010","Total full-time Instruction/research/public service, Non-tenured on tenure track, Associate professors","1","1","0","0","0","0","0","0","0","0","0","0","0","0","0","0","0","0","1","1","0","0","0","0","0","0","0","0","0","0","-2"
"426314","Embry-Riddle Aeronautical University-Worldwide","2010","Total full-time Instruction/research/public service, Non-tenured on tenure track, Assistant professors","6","5","1","0","0","0","0","0","0","0","0","0","0","0","0","0","0","0","6","5","1","0","0","0","0","0","0","0","0","0","-2"
"426314","Embry-Riddle Aeronautical University-Worldwide","2010","Total full-time Instruction/research/public service, Non-tenured on tenure track, Instructors","1","1","0","0","0","0","0","0","0","0","0","0","0","0","0","0","0","0","1","1","0","0","0","0","0","0","0","0","0","0","-2"
"426314","Embry-Riddle Aeronautical University-Worldwide","2010","Total full-time Instruction/research/public service, Non-tenured on tenure track total","8","7","1","0","0","0","0","0","0","0","0","0","0","0","0","0","0","0","8","7","1","0","0","0","0","0","0","0","0","0","-2"
"426314","Embry-Riddle Aeronautical University-Worldwide","2010","Total full-time Instruction/research/public service, Non-tenured not on tenure track, Professors","1","1","0","0","0","0","0","0","0","0","0","0","0","0","0","0","0","0","1","1","0","0","0","0","0","0","0","0","0","0","-2"
"426314","Embry-Riddle Aeronautical University-Worldwide","2010","Total full-time Instruction/research/public service, Non-tenured not on tenure track, Associate professors","20","19","1","1","1","0","1","1","0","0","0","0","0","0","0","0","0","0","18","17","1","0","0","0","0","0","0","0","0","0","-2"
"426314","Embry-Riddle Aeronautical University-Worldwide","2010","Total full-time Instruction/research/public servicey, Non-tenured not on tenure track, Assistant professors","35","25","10","0","0","0","0","0","0","1","1","0","0","0","0","1","1","0","33","23","10","0","0","0","0","0","0","0","0","0","-2"
"426314","Embry-Riddle Aeronautical University-Worldwide","2010","Total full-time Instruction/research/public service, Non-tenured not on tenure track, Instructors","34","26","8","1","1","0","0","0","0","2","2","0","1","0","1","0","0","0","30","23","7","0","0","0","0","0","0","0","0","0","-2"
"426314","Embry-Riddle Aeronautical University-Worldwide","2010","Total full-time Instruction/research/public service, Non-tenured not on tenure track, No academic rank","1","1","0","0","0","0","0","0","0","0","0","0","0","0","0","0","0","0","1","1","0","0","0","0","0","0","0","0","0","0","-2"
"426314","Embry-Riddle Aeronautical University-Worldwide","2010","Total full-time Instruction/research/public service, Non-tenured not on tenure track total","91","72","19","2","2","0","1","1","0","3","3","0","1","0","1","1","1","0","83","65","18","0","0","0","0","0","0","0","0","0","-2"
"433660","Florida Gulf Coast University","2010","Total full-time Instruction/research/public service, Tenured, Professors","8","4","4","0","0","0","0","0","0","0","0","0","1","0","1","0","0","0","7","4","3","0","0","0","0","0","0","0","0","0","-2"
"433660","Florida Gulf Coast University","2010","Total full-time Instruction/research/public service, Tenured, Associate professors","4","2","2","0","0","0","0","0","0","1","1","0","0","0","0","0","0","0","3","1","2","0","0","0","0","0","0","0","0","0","-2"
"433660","Florida Gulf Coast University","2010","Total full-time Instruction/research/public service, Tenured total","12","6","6","0","0","0","0","0","0","1","1","0","1","0","1","0","0","0","10","5","5","0","0","0","0","0","0","0","0","0","-2"
"433660","Florida Gulf Coast University","2010","Total full-time Instruction/research/public service, Non-tenured not on tenure track, Professors","56","40","16","0","0","0","2","2","0","1","0","1","3","2","1","1","1","0","49","35","14","0","0","0","0","0","0","0","0","0","-2"
"433660","Florida Gulf Coast University","2010","Total full-time Instruction/research/public service, Non-tenured not on tenure track, Associate professors","91","46","45","1","0","1","7","3","4","4","4","0","7","4","3","0","0","0","71","34","37","1","1","0","0","0","0","0","0","0","-2"
"433660","Florida Gulf Coast University","2010","Total full-time Instruction/research/public servicey, Non-tenured not on tenure track, Assistant professors","124","68","56","2","2","0","13","10","3","5","1","4","5","2","3","0","0","0","98","53","45","1","0","1","0","0","0","0","0","0","-2"
"433660","Florida Gulf Coast University","2010","Total full-time Instruction/research/public service, Non-tenured not on tenure track, Instructors","90","37","53","0","0","0","1","1","0","2","1","1","5","2","3","0","0","0","82","33","49","0","0","0","0","0","0","0","0","0","-2"
"433660","Florida Gulf Coast University","2010","Total full-time Instruction/research/public service, Non-tenured not on tenure track total","361","191","170","3","2","1","23","16","7","12","6","6","20","10","10","1","1","0","300","155","145","2","1","1","0","0","0","0","0","0","-2"
"447689","Georgia Gwinnett College","2010","Total full-time Instruction/research/public service, Non-tenured not on tenure track, Professors","11","8","3","0","0","0","4","3","1","1","1","0","0","0","0","0","0","0","6","4","2","0","0","0","0","0","0","0","0","0","-2"
"447689","Georgia Gwinnett College","2010","Total full-time Instruction/research/public service, Non-tenured not on tenure track, Associate professors","30","18","12","0","0","0","3","2","1","5","2","3","0","0","0","0","0","0","16","10","6","0","0","0","2","1","1","4","3","1","-2"
"447689","Georgia Gwinnett College","2010","Total full-time Instruction/research/public servicey, Non-tenured not on tenure track, Assistant professors","148","77","71","1","0","1","12","5","7","18","7","11","4","2","2","0","0","0","89","47","42","1","1","0","2","2","0","21","13","8","-2"
"447689","Georgia Gwinnett College","2010","Total full-time Instruction/research/public service, Non-tenured not on tenure track, Instructors","13","2","11","0","0","0","0","0","0","1","0","1","0","0","0","0","0","0","11","2","9","0","0","0","0","0","0","1","0","1","-2"
"447689","Georgia Gwinnett College","2010","Total full-time Instruction/research/public service, Non-tenured not on tenure track total","202","105","97","1","0","1","19","10","9","25","10","15","4","2","2","0","0","0","122","63","59","1","1","0","4","3","1","26","16","10","-2"
"448840","University of South Florida-St Petersburg","2010","Total full-time Instruction/research/public service, Tenured, Professors","14","13","1","0","0","0","0","0","0","0","0","0","1","1","0","0","0","0","13","12","1","0","0","0","0","0","0","0","0","0","-2"
"448840","University of South Florida-St Petersburg","2010","Total full-time Instruction/research/public service, Tenured, Associate professors","42","24","18","0","0","0","3","1","2","2","1","1","5","3","2","0","0","0","31","18","13","1","1","0","0","0","0","0","0","0","-2"
"448840","University of South Florida-St Petersburg","2010","Total full-time Instruction/research/public service, Tenured total","56","37","19","0","0","0","3","1","2","2","1","1","6","4","2","0","0","0","44","30","14","1","1","0","0","0","0","0","0","0","-2"
"448840","University of South Florida-St Petersburg","2010","Total full-time Instruction/research/public service, Non-tenured on tenure track, Associate professors","1","0","1","0","0","0","0","0","0","0","0","0","0","0","0","0","0","0","1","0","1","0","0","0","0","0","0","0","0","0","-2"
"448840","University of South Florida-St Petersburg","2010","Total full-time Instruction/research/public service, Non-tenured on tenure track, Assistant professors","21","11","10","0","0","0","3","1","2","1","1","0","3","1","2","0","0","0","9","5","4","0","0","0","0","0","0","5","3","2","-2"
"448840","University of South Florida-St Petersburg","2010","Total full-time Instruction/research/public service, Non-tenured on tenure track, Instructors","1","0","1","0","0","0","0","0","0","0","0","0","0","0","0","0","0","0","1","0","1","0","0","0","0","0","0","0","0","0","-2"
"448840","University of South Florida-St Petersburg","2010","Total full-time Instruction/research/public service, Non-tenured on tenure track, Lecturers","1","1","0","0","0","0","0","0","0","0","0","0","0","0","0","0","0","0","1","1","0","0","0","0","0","0","0","0","0","0","-2"
"448840","University of South Florida-St Petersburg","2010","Total full-time Instruction/research/public service, Non-tenured on tenure track total","24","12","12","0","0","0","3","1","2","1","1","0","3","1","2","0","0","0","12","6","6","0","0","0","0","0","0","5","3","2","-2"
"448840","University of South Florida-St Petersburg","2010","Total full-time Instruction/research/public service, Non-tenured not on tenure track, Associate professors","1","0","1","0","0","0","0","0","0","0","0","0","0","0","0","0","0","0","1","0","1","0","0","0","0","0","0","0","0","0","-2"
"448840","University of South Florida-St Petersburg","2010","Total full-time Instruction/research/public servicey, Non-tenured not on tenure track, Assistant professors","6","4","2","0","0","0","0","0","0","0","0","0","0","0","0","0","0","0","4","3","1","0","0","0","0","0","0","2","1","1","-2"
"448840","University of South Florida-St Petersburg","2010","Total full-time Instruction/research/public service, Non-tenured not on tenure track, Instructors","18","9","9","0","0","0","0","0","0","2","0","2","0","0","0","0","0","0","16","9","7","0","0","0","0","0","0","0","0","0","-2"
"448840","University of South Florida-St Petersburg","2010","Total full-time Instruction/research/public service, Non-tenured not on tenure track, Lecturers","2","1","1","0","0","0","0","0","0","1","0","1","0","0","0","0","0","0","1","1","0","0","0","0","0","0","0","0","0","0","-2"
"448840","University of South Florida-St Petersburg","2010","Total full-time Instruction/research/public service, Non-tenured not on tenure track total","27","14","13","0","0","0","0","0","0","3","0","3","0","0","0","0","0","0","22","13","9","0","0","0","0","0","0","2","1","1","-2"
"451671","University of South Florida-Sarasota-Manatee","2010","Total full-time Instruction/research/public service, Tenured, Professors","3","2","1","0","0","0","0","0","0","0","0","0","0","0","0","0","0","0","3","2","1","0","0","0","0","0","0","0","0","0","-2"
"451671","University of South Florida-Sarasota-Manatee","2010","Total full-time Instruction/research/public service, Tenured, Associate professors","9","6","3","0","0","0","1","1","0","0","0","0","0","0","0","0","0","0","8","5","3","0","0","0","0","0","0","0","0","0","-2"
"451671","University of South Florida-Sarasota-Manatee","2010","Total full-time Instruction/research/public service, Tenured, Assistant professors","1","1","0","0","0","0","0","0","0","0","0","0","0","0","0","0","0","0","1","1","0","0","0","0","0","0","0","0","0","0","-2"
"451671","University of South Florida-Sarasota-Manatee","2010","Total full-time Instruction/research/public service, Tenured total","13","9","4","0","0","0","1","1","0","0","0","0","0","0","0","0","0","0","12","8","4","0","0","0","0","0","0","0","0","0","-2"
"451671","University of South Florida-Sarasota-Manatee","2010","Total full-time Instruction/research/public service, Non-tenured on tenure track, Professors","1","1","0","0","0","0","0","0","0","0","0","0","0","0","0","0","0","0","1","1","0","0","0","0","0","0","0","0","0","0","-2"
"451671","University of South Florida-Sarasota-Manatee","2010","Total full-time Instruction/research/public service, Non-tenured on tenure track, Assistant professors","17","7","10","0","0","0","1","1","0","2","1","1","0","0","0","0","0","0","13","5","8","0","0","0","1","0","1","0","0","0","-2"
"451671","University of South Florida-Sarasota-Manatee","2010","Total full-time Instruction/research/public service, Non-tenured on tenure track, Instructors","1","0","1","0","0","0","0","0","0","0","0","0","0","0","0","0","0","0","1","0","1","0","0","0","0","0","0","0","0","0","-2"
"451671","University of South Florida-Sarasota-Manatee","2010","Total full-time Instruction/research/public service, Non-tenured on tenure track total","19","8","11","0","0","0","1","1","0","2","1","1","0","0","0","0","0","0","15","6","9","0","0","0","1","0","1","0","0","0","-2"
"451671","University of South Florida-Sarasota-Manatee","2010","Total full-time Instruction/research/public servicey, Non-tenured not on tenure track, Assistant professors","5","0","5","0","0","0","1","0","1","0","0","0","0","0","0","0","0","0","4","0","4","0","0","0","0","0","0","0","0","0","-2"
"451671","University of South Florida-Sarasota-Manatee","2010","Total full-time Instruction/research/public service, Non-tenured not on tenure track, Instructors","12","8","4","0","0","0","1","0","1","0","0","0","0","0","0","0","0","0","11","8","3","0","0","0","0","0","0","0","0","0","-2"
"451671","University of South Florida-Sarasota-Manatee","2010","Total full-time Instruction/research/public service, Non-tenured not on tenure track total","17","8","9","0","0","0","2","0","2","0","0","0","0","0","0","0","0","0","15","8","7","0","0","0","0","0","0","0","0","0","-2"
