"unitid","institution name","year","S2012_IS.Instructional staff category","S2012_IS_RV.Grand total","S2012_IS_RV.Grand total men","S2012_IS_RV.Grand total women","S2012_IS_RV.American Indian or Alaska Native total","S2012_IS_RV.American Indian or Alaska Native men","S2012_IS_RV.American Indian or Alaska Native women","S2012_IS_RV.Asian total","S2012_IS_RV.Asian men","S2012_IS_RV.Asian women","S2012_IS_RV.Black or African American total","S2012_IS_RV.Black or African American men","S2012_IS_RV.Black or African American women","S2012_IS_RV.Hispanic or Latino total","S2012_IS_RV.Hispanic or Latino men","S2012_IS_RV.Hispanic or Latino women","S2012_IS_RV.Native Hawaiian or Other Pacific Islander total","S2012_IS_RV.Native Hawaiian or Other Pacific Islander men","S2012_IS_RV.Native Hawaiian or Other Pacific Islander women","S2012_IS_RV.White total","S2012_IS_RV.White men","S2012_IS_RV.White women","S2012_IS_RV.Two or more races total","S2012_IS_RV.Two or more races men","S2012_IS_RV.Two or more races women","S2012_IS_RV.Race/ethnicity unknown total","S2012_IS_RV.Race/ethnicity unknown men","S2012_IS_RV.Race/ethnicity unknown women","S2012_IS_RV.Nonresident alien total","S2012_IS_RV.Nonresident alien men","S2012_IS_RV.Nonresident alien women","IDX_HR"
"110422","California Polytechnic State University-San Luis Obispo","2012","Tenured total","440","318","122","1","1","0","40","29","11","10","6","4","29","19","10","1","1","0","330","238","92","6","5","1","23","19","4","0","0","0","-2"
"110422","California Polytechnic State University-San Luis Obispo","2012","Tenured, professors","278","207","71","0","0","0","25","21","4","6","4","2","18","12","6","1","1","0","207","149","58","4","4","0","17","16","1","0","0","0","-2"
"110422","California Polytechnic State University-San Luis Obispo","2012","Tenured, associate professors","160","109","51","1","1","0","15","8","7","4","2","2","11","7","4","0","0","0","121","87","34","2","1","1","6","3","3","0","0","0","-2"
"110422","California Polytechnic State University-San Luis Obispo","2012","Tenured, no academic rank","2","2","0","0","0","0","0","0","0","0","0","0","0","0","0","0","0","0","2","2","0","0","0","0","0","0","0","0","0","0","-2"
"110422","California Polytechnic State University-San Luis Obispo","2012","On-Tenure track total","168","97","71","2","1","1","13","7","6","1","1","0","10","9","1","0","0","0","125","69","56","2","1","1","5","3","2","10","6","4","-2"
"110422","California Polytechnic State University-San Luis Obispo","2012","On-tenure track, professors","1","1","0","0","0","0","0","0","0","0","0","0","0","0","0","0","0","0","1","1","0","0","0","0","0","0","0","0","0","0","-2"
"110422","California Polytechnic State University-San Luis Obispo","2012","On-tenure track, associate professors","22","18","4","0","0","0","3","2","1","0","0","0","1","1","0","0","0","0","17","14","3","0","0","0","0","0","0","1","1","0","-2"
"110422","California Polytechnic State University-San Luis Obispo","2012","On-tenure track, assistant professors","145","78","67","2","1","1","10","5","5","1","1","0","9","8","1","0","0","0","107","54","53","2","1","1","5","3","2","9","5","4","-2"
"110422","California Polytechnic State University-San Luis Obispo","2012","Not on tenure track/No tenure system system total","126","70","56","0","0","0","3","1","2","0","0","0","3","3","0","0","0","0","112","61","51","1","1","0","5","3","2","2","1","1","-2"
"110422","California Polytechnic State University-San Luis Obispo","2012","Not on tenure/no tenure system, lecturers","126","70","56","0","0","0","3","1","2","0","0","0","3","3","0","0","0","0","112","61","51","1","1","0","5","3","2","2","1","1","-2"
"111188","California State University Maritime Academy","2012","Tenured total","28","23","5","0","0","0","2","1","1","1","1","0","1","1","0","0","0","0","24","20","4","0","0","0","0","0","0","0","0","0","-2"
"111188","California State University Maritime Academy","2012","Tenured, professors","18","13","5","0","0","0","2","1","1","0","0","0","1","1","0","0","0","0","15","11","4","0","0","0","0","0","0","0","0","0","-2"
"111188","California State University Maritime Academy","2012","Tenured, associate professors","2","2","0","0","0","0","0","0","0","0","0","0","0","0","0","0","0","0","2","2","0","0","0","0","0","0","0","0","0","0","-2"
"111188","California State University Maritime Academy","2012","Tenured, assistant professors","3","3","0","0","0","0","0","0","0","1","1","0","0","0","0","0","0","0","2","2","0","0","0","0","0","0","0","0","0","0","-2"
"111188","California State University Maritime Academy","2012","Tenured, instructors","1","1","0","0","0","0","0","0","0","0","0","0","0","0","0","0","0","0","1","1","0","0","0","0","0","0","0","0","0","0","-2"
"111188","California State University Maritime Academy","2012","Tenured, no academic rank","4","4","0","0","0","0","0","0","0","0","0","0","0","0","0","0","0","0","4","4","0","0","0","0","0","0","0","0","0","0","-2"
"111188","California State University Maritime Academy","2012","On-Tenure track total","17","13","4","0","0","0","2","1","1","0","0","0","3","2","1","0","0","0","12","10","2","0","0","0","0","0","0","0","0","0","-2"
"111188","California State University Maritime Academy","2012","On-tenure track, associate professors","2","0","2","0","0","0","1","0","1","0","0","0","0","0","0","0","0","0","1","0","1","0","0","0","0","0","0","0","0","0","-2"
"111188","California State University Maritime Academy","2012","On-tenure track, assistant professors","13","11","2","0","0","0","1","1","0","0","0","0","3","2","1","0","0","0","9","8","1","0","0","0","0","0","0","0","0","0","-2"
"111188","California State University Maritime Academy","2012","On-tenure track, instructors","2","2","0","0","0","0","0","0","0","0","0","0","0","0","0","0","0","0","2","2","0","0","0","0","0","0","0","0","0","0","-2"
"111188","California State University Maritime Academy","2012","Not on tenure track/No tenure system system total","11","10","1","0","0","0","0","0","0","0","0","0","0","0","0","0","0","0","11","10","1","0","0","0","0","0","0","0","0","0","-2"
"111188","California State University Maritime Academy","2012","Not on tenure/no tenure system, lecturers","11","10","1","0","0","0","0","0","0","0","0","0","0","0","0","0","0","0","11","10","1","0","0","0","0","0","0","0","0","0","-2"
"111948","Chapman University","2012","Tenured total","180","119","61","1","1","0","14","8","6","5","3","2","5","3","2","0","0","0","150","102","48","1","0","1","3","1","2","1","1","0","-2"
"111948","Chapman University","2012","Tenured, professors","106","77","29","0","0","0","8","4","4","3","3","0","2","2","0","0","0","0","90","67","23","0","0","0","3","1","2","0","0","0","-2"
"111948","Chapman University","2012","Tenured, associate professors","74","42","32","1","1","0","6","4","2","2","0","2","3","1","2","0","0","0","60","35","25","1","0","1","0","0","0","1","1","0","-2"
"111948","Chapman University","2012","On-Tenure track total","80","41","39","0","0","0","3","0","3","2","1","1","5","2","3","0","0","0","45","27","18","0","0","0","17","7","10","8","4","4","-2"
"111948","Chapman University","2012","On-tenure track, professors","2","2","0","0","0","0","0","0","0","0","0","0","0","0","0","0","0","0","1","1","0","0","0","0","1","1","0","0","0","0","-2"
"111948","Chapman University","2012","On-tenure track, associate professors","13","9","4","0","0","0","0","0","0","1","0","1","0","0","0","0","0","0","6","6","0","0","0","0","5","3","2","1","0","1","-2"
"111948","Chapman University","2012","On-tenure track, assistant professors","61","29","32","0","0","0","3","0","3","1","1","0","5","2","3","0","0","0","37","19","18","0","0","0","9","3","6","6","4","2","-2"
"111948","Chapman University","2012","On-tenure track, instructors","4","1","3","0","0","0","0","0","0","0","0","0","0","0","0","0","0","0","1","1","0","0","0","0","2","0","2","1","0","1","-2"
"111948","Chapman University","2012","Not on tenure track/No tenure system system total","120","64","56","0","0","0","7","3","4","3","2","1","5","1","4","0","0","0","87","50","37","1","1","0","12","6","6","5","1","4","-2"
"111948","Chapman University","2012","Not on tenure/no tenure system, professors","13","10","3","0","0","0","0","0","0","0","0","0","0","0","0","0","0","0","10","8","2","0","0","0","3","2","1","0","0","0","-2"
"111948","Chapman University","2012","Not on tenure/no tenure system, associate professors","28","13","15","0","0","0","0","0","0","0","0","0","1","0","1","0","0","0","24","12","12","0","0","0","2","1","1","1","0","1","-2"
"111948","Chapman University","2012","Not on tenure/no tenure system, assistant professors","44","26","18","0","0","0","3","1","2","3","2","1","1","0","1","0","0","0","34","22","12","0","0","0","1","0","1","2","1","1","-2"
"111948","Chapman University","2012","Not on tenure/no tenure system, instructors","29","14","15","0","0","0","4","2","2","0","0","0","2","1","1","0","0","0","16","7","9","1","1","0","4","3","1","2","0","2","-2"
"111948","Chapman University","2012","Not on tenure/no tenure system, lecturers","6","1","5","0","0","0","0","0","0","0","0","0","1","0","1","0","0","0","3","1","2","0","0","0","2","0","2","0","0","0","-2"
"112260","Claremont McKenna College","2012","Tenured total","94","69","25","1","1","0","6","3","3","3","1","2","4","4","0","0","0","0","76","59","17","0","0","0","2","1","1","2","0","2","-2"
"112260","Claremont McKenna College","2012","Tenured, professors","57","42","15","1","1","0","1","1","0","3","1","2","2","2","0","0","0","0","49","37","12","0","0","0","0","0","0","1","0","1","-2"
"112260","Claremont McKenna College","2012","Tenured, associate professors","36","26","10","0","0","0","5","2","3","0","0","0","2","2","0","0","0","0","26","21","5","0","0","0","2","1","1","1","0","1","-2"
"112260","Claremont McKenna College","2012","Tenured, lecturers","1","1","0","0","0","0","0","0","0","0","0","0","0","0","0","0","0","0","1","1","0","0","0","0","0","0","0","0","0","0","-2"
"112260","Claremont McKenna College","2012","On-Tenure track total","35","21","14","0","0","0","3","2","1","0","0","0","0","0","0","0","0","0","26","16","10","1","0","1","0","0","0","5","3","2","-2"
"112260","Claremont McKenna College","2012","On-tenure track, associate professors","1","1","0","0","0","0","0","0","0","0","0","0","0","0","0","0","0","0","1","1","0","0","0","0","0","0","0","0","0","0","-2"
"112260","Claremont McKenna College","2012","On-tenure track, assistant professors","34","20","14","0","0","0","3","2","1","0","0","0","0","0","0","0","0","0","25","15","10","1","0","1","0","0","0","5","3","2","-2"
"112260","Claremont McKenna College","2012","Not on tenure track/No tenure system system total","34","16","18","0","0","0","1","0","1","0","0","0","4","1","3","0","0","0","27","14","13","0","0","0","0","0","0","2","1","1","-2"
"112260","Claremont McKenna College","2012","Not on tenure/no tenure system, professors","2","2","0","0","0","0","0","0","0","0","0","0","0","0","0","0","0","0","2","2","0","0","0","0","0","0","0","0","0","0","-2"
"112260","Claremont McKenna College","2012","Not on tenure/no tenure system, associate professors","6","3","3","0","0","0","0","0","0","0","0","0","1","0","1","0","0","0","5","3","2","0","0","0","0","0","0","0","0","0","-2"
"112260","Claremont McKenna College","2012","Not on tenure/no tenure system, assistant professors","23","10","13","0","0","0","1","0","1","0","0","0","2","1","1","0","0","0","18","8","10","0","0","0","0","0","0","2","1","1","-2"
"112260","Claremont McKenna College","2012","Not on tenure/no tenure system, instructors","3","1","2","0","0","0","0","0","0","0","0","0","1","0","1","0","0","0","2","1","1","0","0","0","0","0","0","0","0","0","-2"
"117946","Loyola Marymount University","2012","Tenured total","343","217","126","1","0","1","34","23","11","15","12","3","35","17","18","0","0","0","235","150","85","4","2","2","19","13","6","0","0","0","-2"
"117946","Loyola Marymount University","2012","Tenured, professors","207","147","60","0","0","0","18","14","4","7","5","2","18","8","10","0","0","0","146","108","38","2","1","1","16","11","5","0","0","0","-2"
"117946","Loyola Marymount University","2012","Tenured, associate professors","128","65","63","1","0","1","15","8","7","8","7","1","16","8","8","0","0","0","83","39","44","2","1","1","3","2","1","0","0","0","-2"
"117946","Loyola Marymount University","2012","Tenured, assistant professors","8","5","3","0","0","0","1","1","0","0","0","0","1","1","0","0","0","0","6","3","3","0","0","0","0","0","0","0","0","0","-2"
"117946","Loyola Marymount University","2012","On-Tenure track total","89","38","51","0","0","0","10","3","7","8","2","6","13","5","8","0","0","0","47","23","24","2","0","2","0","0","0","9","5","4","-2"
"117946","Loyola Marymount University","2012","On-tenure track, associate professors","14","7","7","0","0","0","1","1","0","2","0","2","3","1","2","0","0","0","7","5","2","0","0","0","0","0","0","1","0","1","-2"
"117946","Loyola Marymount University","2012","On-tenure track, assistant professors","75","31","44","0","0","0","9","2","7","6","2","4","10","4","6","0","0","0","40","18","22","2","0","2","0","0","0","8","5","3","-2"
"117946","Loyola Marymount University","2012","Not on tenure track/No tenure system system total","112","50","62","0","0","0","7","2","5","8","5","3","12","6","6","0","0","0","79","34","45","1","1","0","5","2","3","0","0","0","-2"
"117946","Loyola Marymount University","2012","Not on tenure/no tenure system, professors","11","5","6","0","0","0","0","0","0","2","1","1","0","0","0","0","0","0","7","3","4","0","0","0","2","1","1","0","0","0","-2"
"117946","Loyola Marymount University","2012","Not on tenure/no tenure system, associate professors","35","9","26","0","0","0","4","1","3","1","0","1","4","2","2","0","0","0","26","6","20","0","0","0","0","0","0","0","0","0","-2"
"117946","Loyola Marymount University","2012","Not on tenure/no tenure system, assistant professors","57","31","26","0","0","0","3","1","2","4","3","1","6","3","3","0","0","0","42","23","19","0","0","0","2","1","1","0","0","0","-2"
"117946","Loyola Marymount University","2012","Not on tenure/no tenure system, instructors","7","3","4","0","0","0","0","0","0","1","1","0","1","0","1","0","0","0","3","1","2","1","1","0","1","0","1","0","0","0","-2"
"117946","Loyola Marymount University","2012","Not on tenure/no tenure system, lecturers","1","1","0","0","0","0","0","0","0","0","0","0","0","0","0","0","0","0","1","1","0","0","0","0","0","0","0","0","0","0","-2"
"117946","Loyola Marymount University","2012","Not on tenure/no tenure system, no academic rank","1","1","0","0","0","0","0","0","0","0","0","0","1","1","0","0","0","0","0","0","0","0","0","0","0","0","0","0","0","0","-2"
"121309","Point Loma Nazarene University","2012","Tenured total","68","48","20","0","0","0","4","2","2","2","2","0","4","1","3","0","0","0","58","43","15","0","0","0","0","0","0","0","0","0","-2"
"121309","Point Loma Nazarene University","2012","Tenured, professors","68","48","20","0","0","0","4","2","2","2","2","0","4","1","3","0","0","0","58","43","15","0","0","0","0","0","0","0","0","0","-2"
"121309","Point Loma Nazarene University","2012","On-Tenure track total","74","35","39","0","0","0","6","4","2","2","0","2","2","0","2","0","0","0","64","31","33","0","0","0","0","0","0","0","0","0","-2"
"121309","Point Loma Nazarene University","2012","On-tenure track, professors","16","7","9","0","0","0","0","0","0","1","0","1","0","0","0","0","0","0","15","7","8","0","0","0","0","0","0","0","0","0","-2"
"121309","Point Loma Nazarene University","2012","On-tenure track, associate professors","33","16","17","0","0","0","1","0","1","0","0","0","2","0","2","0","0","0","30","16","14","0","0","0","0","0","0","0","0","0","-2"
"121309","Point Loma Nazarene University","2012","On-tenure track, assistant professors","25","12","13","0","0","0","5","4","1","1","0","1","0","0","0","0","0","0","19","8","11","0","0","0","0","0","0","0","0","0","-2"
"121345","Pomona College","2012","Tenured total","145","88","57","0","0","0","18","7","11","3","2","1","19","13","6","0","0","0","81","48","33","5","4","1","19","14","5","0","0","0","-2"
"121345","Pomona College","2012","Tenured, professors","87","56","31","0","0","0","8","2","6","2","1","1","12","7","5","0","0","0","51","34","17","4","3","1","10","9","1","0","0","0","-2"
"121345","Pomona College","2012","Tenured, associate professors","58","32","26","0","0","0","10","5","5","1","1","0","7","6","1","0","0","0","30","14","16","1","1","0","9","5","4","0","0","0","-2"
"121345","Pomona College","2012","On-Tenure track total","36","18","18","0","0","0","4","1","3","1","1","0","1","0","1","0","0","0","22","12","10","1","1","0","7","3","4","0","0","0","-2"
"121345","Pomona College","2012","On-tenure track, assistant professors","35","18","17","0","0","0","4","1","3","1","1","0","1","0","1","0","0","0","21","12","9","1","1","0","7","3","4","0","0","0","-2"
"121345","Pomona College","2012","On-tenure track, instructors","1","0","1","0","0","0","0","0","0","0","0","0","0","0","0","0","0","0","1","0","1","0","0","0","0","0","0","0","0","0","-2"
"121345","Pomona College","2012","Not on tenure track/No tenure system system total","4","1","3","0","0","0","1","0","1","0","0","0","2","0","2","0","0","0","0","0","0","0","0","0","1","1","0","0","0","0","-2"
"121345","Pomona College","2012","Not on tenure/no tenure system, professors","3","1","2","0","0","0","1","0","1","0","0","0","1","0","1","0","0","0","0","0","0","0","0","0","1","1","0","0","0","0","-2"
"121345","Pomona College","2012","Not on tenure/no tenure system, associate professors","1","0","1","0","0","0","0","0","0","0","0","0","1","0","1","0","0","0","0","0","0","0","0","0","0","0","0","0","0","0","-2"
"122296","Samuel Merritt University","2012","Not on tenure track/No tenure system system total","103","24","79","0","0","0","7","1","6","4","0","4","1","0","1","0","0","0","89","23","66","2","0","2","0","0","0","0","0","0","-2"
"122296","Samuel Merritt University","2012","Not on tenure/no tenure system, professors","11","8","3","0","0","0","0","0","0","0","0","0","0","0","0","0","0","0","11","8","3","0","0","0","0","0","0","0","0","0","-2"
"122296","Samuel Merritt University","2012","Not on tenure/no tenure system, associate professors","11","2","9","0","0","0","1","0","1","1","0","1","0","0","0","0","0","0","9","2","7","0","0","0","0","0","0","0","0","0","-2"
"122296","Samuel Merritt University","2012","Not on tenure/no tenure system, assistant professors","63","11","52","0","0","0","5","1","4","1","0","1","1","0","1","0","0","0","55","10","45","1","0","1","0","0","0","0","0","0","-2"
"122296","Samuel Merritt University","2012","Not on tenure/no tenure system, instructors","18","3","15","0","0","0","1","0","1","2","0","2","0","0","0","0","0","0","14","3","11","1","0","1","0","0","0","0","0","0","-2"
"122436","University of San Diego","2012","Tenured total","248","151","97","1","0","1","20","12","8","5","5","0","19","9","10","0","0","0","200","123","77","1","1","0","0","0","0","2","1","1","-2"
"122436","University of San Diego","2012","Tenured, professors","160","99","61","0","0","0","9","5","4","2","2","0","10","5","5","0","0","0","138","87","51","0","0","0","0","0","0","1","0","1","-2"
"122436","University of San Diego","2012","Tenured, associate professors","87","52","35","1","0","1","11","7","4","3","3","0","9","4","5","0","0","0","61","36","25","1","1","0","0","0","0","1","1","0","-2"
"122436","University of San Diego","2012","Tenured, assistant professors","1","0","1","0","0","0","0","0","0","0","0","0","0","0","0","0","0","0","1","0","1","0","0","0","0","0","0","0","0","0","-2"
"122436","University of San Diego","2012","On-Tenure track total","94","36","58","0","0","0","9","2","7","3","2","1","6","1","5","0","0","0","68","27","41","1","0","1","0","0","0","7","4","3","-2"
"122436","University of San Diego","2012","On-tenure track, professors","3","1","2","0","0","0","0","0","0","0","0","0","0","0","0","0","0","0","3","1","2","0","0","0","0","0","0","0","0","0","-2"
"122436","University of San Diego","2012","On-tenure track, associate professors","16","5","11","0","0","0","0","0","0","2","1","1","1","0","1","0","0","0","13","4","9","0","0","0","0","0","0","0","0","0","-2"
"122436","University of San Diego","2012","On-tenure track, assistant professors","74","30","44","0","0","0","9","2","7","1","1","0","5","1","4","0","0","0","52","22","30","1","0","1","0","0","0","6","4","2","-2"
"122436","University of San Diego","2012","On-tenure track, instructors","1","0","1","0","0","0","0","0","0","0","0","0","0","0","0","0","0","0","0","0","0","0","0","0","0","0","0","1","0","1","-2"
"122436","University of San Diego","2012","Not on tenure track/No tenure system system total","58","27","31","1","1","0","3","2","1","1","1","0","3","0","3","0","0","0","48","22","26","0","0","0","0","0","0","2","1","1","-2"
"122436","University of San Diego","2012","Not on tenure/no tenure system, professors","19","10","9","0","0","0","2","2","0","0","0","0","1","0","1","0","0","0","15","7","8","0","0","0","0","0","0","1","1","0","-2"
"122436","University of San Diego","2012","Not on tenure/no tenure system, associate professors","9","4","5","1","1","0","0","0","0","1","1","0","1","0","1","0","0","0","6","2","4","0","0","0","0","0","0","0","0","0","-2"
"122436","University of San Diego","2012","Not on tenure/no tenure system, assistant professors","17","9","8","0","0","0","1","0","1","0","0","0","0","0","0","0","0","0","16","9","7","0","0","0","0","0","0","0","0","0","-2"
"122436","University of San Diego","2012","Not on tenure/no tenure system, instructors","13","4","9","0","0","0","0","0","0","0","0","0","1","0","1","0","0","0","11","4","7","0","0","0","0","0","0","1","0","1","-2"
"122454","San Francisco Art Institute","2012","Tenured total","21","15","6","0","0","0","2","2","0","1","1","0","2","2","0","0","0","0","16","10","6","0","0","0","0","0","0","0","0","0","-2"
"122454","San Francisco Art Institute","2012","Tenured, professors","5","4","1","0","0","0","2","2","0","0","0","0","0","0","0","0","0","0","3","2","1","0","0","0","0","0","0","0","0","0","-2"
"122454","San Francisco Art Institute","2012","Tenured, associate professors","16","11","5","0","0","0","0","0","0","1","1","0","2","2","0","0","0","0","13","8","5","0","0","0","0","0","0","0","0","0","-2"
"122454","San Francisco Art Institute","2012","On-Tenure track total","1","0","1","0","0","0","0","0","0","0","0","0","0","0","0","0","0","0","1","0","1","0","0","0","0","0","0","0","0","0","-2"
"122454","San Francisco Art Institute","2012","On-tenure track, assistant professors","1","0","1","0","0","0","0","0","0","0","0","0","0","0","0","0","0","0","1","0","1","0","0","0","0","0","0","0","0","0","-2"
"122454","San Francisco Art Institute","2012","Not on tenure track/No tenure system system total","3","1","2","0","0","0","0","0","0","0","0","0","0","0","0","0","0","0","2","1","1","0","0","0","0","0","0","1","0","1","-2"
"122454","San Francisco Art Institute","2012","Not on tenure/no tenure system, no academic rank","3","1","2","0","0","0","0","0","0","0","0","0","0","0","0","0","0","0","2","1","1","0","0","0","0","0","0","1","0","1","-2"
"122612","University of San Francisco","2012","Tenured total","235","136","99","0","0","0","22","13","9","11","3","8","18","12","6","1","1","0","152","90","62","6","5","1","25","12","13","0","0","0","-2"
"122612","University of San Francisco","2012","Tenured, professors","125","85","40","0","0","0","9","7","2","2","0","2","8","6","2","1","1","0","90","61","29","4","4","0","11","6","5","0","0","0","-2"
"122612","University of San Francisco","2012","Tenured, associate professors","106","49","57","0","0","0","13","6","7","9","3","6","10","6","4","0","0","0","59","28","31","2","1","1","13","5","8","0","0","0","-2"
"122612","University of San Francisco","2012","Tenured, assistant professors","4","2","2","0","0","0","0","0","0","0","0","0","0","0","0","0","0","0","3","1","2","0","0","0","1","1","0","0","0","0","-2"
"122612","University of San Francisco","2012","On-Tenure track total","85","34","51","0","0","0","13","6","7","7","2","5","7","4","3","0","0","0","43","16","27","1","1","0","9","3","6","5","2","3","-2"
"122612","University of San Francisco","2012","On-tenure track, professors","1","0","1","0","0","0","0","0","0","0","0","0","0","0","0","0","0","0","1","0","1","0","0","0","0","0","0","0","0","0","-2"
"122612","University of San Francisco","2012","On-tenure track, associate professors","8","4","4","0","0","0","2","1","1","1","0","1","2","1","1","0","0","0","3","2","1","0","0","0","0","0","0","0","0","0","-2"
"122612","University of San Francisco","2012","On-tenure track, assistant professors","76","30","46","0","0","0","11","5","6","6","2","4","5","3","2","0","0","0","39","14","25","1","1","0","9","3","6","5","2","3","-2"
"122612","University of San Francisco","2012","Not on tenure track/No tenure system system total","110","53","57","1","0","1","11","4","7","4","1","3","6","4","2","0","0","0","66","33","33","8","4","4","11","5","6","3","2","1","-2"
"122612","University of San Francisco","2012","Not on tenure/no tenure system, professors","13","8","5","0","0","0","1","1","0","1","1","0","0","0","0","0","0","0","7","3","4","1","1","0","2","1","1","1","1","0","-2"
"122612","University of San Francisco","2012","Not on tenure/no tenure system, associate professors","12","5","7","0","0","0","0","0","0","1","0","1","0","0","0","0","0","0","11","5","6","0","0","0","0","0","0","0","0","0","-2"
"122612","University of San Francisco","2012","Not on tenure/no tenure system, assistant professors","63","32","31","1","0","1","9","3","6","2","0","2","6","4","2","0","0","0","34","19","15","4","2","2","5","3","2","2","1","1","-2"
"122612","University of San Francisco","2012","Not on tenure/no tenure system, instructors","22","8","14","0","0","0","1","0","1","0","0","0","0","0","0","0","0","0","14","6","8","3","1","2","4","1","3","0","0","0","-2"
"122931","Santa Clara University","2012","Tenured total","284","183","101","0","0","0","27","17","10","6","3","3","23","15","8","0","0","0","226","146","80","1","1","0","1","1","0","0","0","0","-2"
"122931","Santa Clara University","2012","Tenured, professors","149","102","47","0","0","0","11","10","1","0","0","0","10","9","1","0","0","0","127","82","45","1","1","0","0","0","0","0","0","0","-2"
"122931","Santa Clara University","2012","Tenured, associate professors","134","80","54","0","0","0","16","7","9","6","3","3","13","6","7","0","0","0","98","63","35","0","0","0","1","1","0","0","0","0","-2"
"122931","Santa Clara University","2012","Tenured, assistant professors","1","1","0","0","0","0","0","0","0","0","0","0","0","0","0","0","0","0","1","1","0","0","0","0","0","0","0","0","0","0","-2"
"122931","Santa Clara University","2012","On-Tenure track total","90","53","37","0","0","0","26","14","12","4","3","1","5","2","3","5","4","1","47","29","18","2","1","1","1","0","1","0","0","0","-2"
"122931","Santa Clara University","2012","On-tenure track, associate professors","5","3","2","0","0","0","3","2","1","0","0","0","1","0","1","0","0","0","1","1","0","0","0","0","0","0","0","0","0","0","-2"
"122931","Santa Clara University","2012","On-tenure track, assistant professors","85","50","35","0","0","0","23","12","11","4","3","1","4","2","2","5","4","1","46","28","18","2","1","1","1","0","1","0","0","0","-2"
"122931","Santa Clara University","2012","Not on tenure track/No tenure system system total","129","54","75","0","0","0","14","6","8","3","0","3","10","5","5","0","0","0","97","42","55","4","1","3","1","0","1","0","0","0","-2"
"122931","Santa Clara University","2012","Not on tenure/no tenure system, lecturers","101","42","59","0","0","0","12","5","7","2","0","2","8","4","4","0","0","0","75","33","42","3","0","3","1","0","1","0","0","0","-2"
"122931","Santa Clara University","2012","Not on tenure/no tenure system, no academic rank","28","12","16","0","0","0","2","1","1","1","0","1","2","1","1","0","0","0","22","9","13","1","1","0","0","0","0","0","0","0","-2"
"123299","Shasta College","2012","Tenured total","92","49","43","2","1","1","2","1","1","2","0","2","4","2","2","0","0","0","82","45","37","0","0","0","0","0","0","0","0","0","-2"
"123299","Shasta College","2012","Tenured, instructors","92","49","43","2","1","1","2","1","1","2","0","2","4","2","2","0","0","0","82","45","37","0","0","0","0","0","0","0","0","0","-2"
"123299","Shasta College","2012","On-Tenure track total","27","14","13","0","0","0","0","0","0","0","0","0","2","2","0","1","1","0","22","10","12","0","0","0","2","1","1","0","0","0","-2"
"123299","Shasta College","2012","On-tenure track, instructors","27","14","13","0","0","0","0","0","0","0","0","0","2","2","0","1","1","0","22","10","12","0","0","0","2","1","1","0","0","0","-2"
"123299","Shasta College","2012","Not on tenure track/No tenure system system total","2","1","1","0","0","0","0","0","0","1","1","0","1","0","1","0","0","0","0","0","0","0","0","0","0","0","0","0","0","0","-2"
"123299","Shasta College","2012","Not on tenure/no tenure system, instructors","2","1","1","0","0","0","0","0","0","1","1","0","1","0","1","0","0","0","0","0","0","0","0","0","0","0","0","0","0","0","-2"
"123457","Simpson University","2012","Not on tenure track/No tenure system system total","47","30","17","2","2","0","0","0","0","0","0","0","2","2","0","0","0","0","41","24","17","2","2","0","0","0","0","0","0","0","-2"
"123457","Simpson University","2012","Not on tenure/no tenure system, professors","9","8","1","0","0","0","0","0","0","0","0","0","0","0","0","0","0","0","8","7","1","1","1","0","0","0","0","0","0","0","-2"
"123457","Simpson University","2012","Not on tenure/no tenure system, associate professors","10","6","4","0","0","0","0","0","0","0","0","0","0","0","0","0","0","0","10","6","4","0","0","0","0","0","0","0","0","0","-2"
"123457","Simpson University","2012","Not on tenure/no tenure system, assistant professors","27","16","11","2","2","0","0","0","0","0","0","0","2","2","0","0","0","0","22","11","11","1","1","0","0","0","0","0","0","0","-2"
"123457","Simpson University","2012","Not on tenure/no tenure system, instructors","1","0","1","0","0","0","0","0","0","0","0","0","0","0","0","0","0","0","1","0","1","0","0","0","0","0","0","0","0","0","-2"
"125727","Westmont College","2012","Tenured total","66","49","17","0","0","0","3","2","1","1","1","0","2","1","1","0","0","0","60","45","15","0","0","0","0","0","0","0","0","0","-2"
"125727","Westmont College","2012","Tenured, professors","51","40","11","0","0","0","1","1","0","0","0","0","1","1","0","0","0","0","49","38","11","0","0","0","0","0","0","0","0","0","-2"
"125727","Westmont College","2012","Tenured, associate professors","15","9","6","0","0","0","2","1","1","1","1","0","1","0","1","0","0","0","11","7","4","0","0","0","0","0","0","0","0","0","-2"
"125727","Westmont College","2012","On-Tenure track total","17","7","10","1","0","1","1","1","0","0","0","0","1","0","1","0","0","0","14","6","8","0","0","0","0","0","0","0","0","0","-2"
"125727","Westmont College","2012","On-tenure track, professors","3","1","2","0","0","0","0","0","0","0","0","0","1","0","1","0","0","0","2","1","1","0","0","0","0","0","0","0","0","0","-2"
"125727","Westmont College","2012","On-tenure track, associate professors","3","2","1","0","0","0","0","0","0","0","0","0","0","0","0","0","0","0","3","2","1","0","0","0","0","0","0","0","0","0","-2"
"125727","Westmont College","2012","On-tenure track, assistant professors","11","4","7","1","0","1","1","1","0","0","0","0","0","0","0","0","0","0","9","3","6","0","0","0","0","0","0","0","0","0","-2"
"125727","Westmont College","2012","Not on tenure track/No tenure system system total","13","5","8","0","0","0","0","0","0","0","0","0","1","1","0","0","0","0","12","4","8","0","0","0","0","0","0","0","0","0","-2"
"125727","Westmont College","2012","Not on tenure/no tenure system, professors","1","1","0","0","0","0","0","0","0","0","0","0","1","1","0","0","0","0","0","0","0","0","0","0","0","0","0","0","0","0","-2"
"125727","Westmont College","2012","Not on tenure/no tenure system, associate professors","3","2","1","0","0","0","0","0","0","0","0","0","0","0","0","0","0","0","3","2","1","0","0","0","0","0","0","0","0","0","-2"
"125727","Westmont College","2012","Not on tenure/no tenure system, assistant professors","7","2","5","0","0","0","0","0","0","0","0","0","0","0","0","0","0","0","7","2","5","0","0","0","0","0","0","0","0","0","-2"
"125727","Westmont College","2012","Not on tenure/no tenure system, instructors","2","0","2","0","0","0","0","0","0","0","0","0","0","0","0","0","0","0","2","0","2","0","0","0","0","0","0","0","0","0","-2"
"126580","University of Colorado Colorado Springs","2012","Tenured total","154","99","55","2","0","2","7","6","1","3","0","3","6","4","2","0","0","0","132","87","45","0","0","0","4","2","2","0","0","0","-2"
"126580","University of Colorado Colorado Springs","2012","Tenured, professors","80","63","17","0","0","0","4","4","0","1","0","1","3","2","1","0","0","0","71","56","15","0","0","0","1","1","0","0","0","0","-2"
"126580","University of Colorado Colorado Springs","2012","Tenured, associate professors","74","36","38","2","0","2","3","2","1","2","0","2","3","2","1","0","0","0","61","31","30","0","0","0","3","1","2","0","0","0","-2"
"126580","University of Colorado Colorado Springs","2012","On-Tenure track total","82","35","47","0","0","0","10","5","5","2","1","1","5","3","2","0","0","0","57","23","34","0","0","0","8","3","5","0","0","0","-2"
"126580","University of Colorado Colorado Springs","2012","On-tenure track, assistant professors","82","35","47","0","0","0","10","5","5","2","1","1","5","3","2","0","0","0","57","23","34","0","0","0","8","3","5","0","0","0","-2"
"126580","University of Colorado Colorado Springs","2012","Not on tenure track/No tenure system system total","163","57","106","3","2","1","3","1","2","2","0","2","9","2","7","0","0","0","140","50","90","0","0","0","6","2","4","0","0","0","-2"
"126580","University of Colorado Colorado Springs","2012","Not on tenure/no tenure system, instructors","163","57","106","3","2","1","3","1","2","2","0","2","9","2","7","0","0","0","140","50","90","0","0","0","6","2","4","0","0","0","-2"
"127556","Colorado Mesa University","2012","Tenured total","92","55","37","0","0","0","2","2","0","1","1","0","1","1","0","0","0","0","69","39","30","1","1","0","13","8","5","5","3","2","-2"
"127556","Colorado Mesa University","2012","Tenured, professors","60","37","23","0","0","0","1","1","0","0","0","0","1","1","0","0","0","0","43","25","18","1","1","0","10","7","3","4","2","2","-2"
"127556","Colorado Mesa University","2012","Tenured, associate professors","30","16","14","0","0","0","1","1","0","0","0","0","0","0","0","0","0","0","25","13","12","0","0","0","3","1","2","1","1","0","-2"
"127556","Colorado Mesa University","2012","Tenured, assistant professors","1","1","0","0","0","0","0","0","0","1","1","0","0","0","0","0","0","0","0","0","0","0","0","0","0","0","0","0","0","0","-2"
"127556","Colorado Mesa University","2012","Tenured, instructors","1","1","0","0","0","0","0","0","0","0","0","0","0","0","0","0","0","0","1","1","0","0","0","0","0","0","0","0","0","0","-2"
"127556","Colorado Mesa University","2012","On-Tenure track total","72","39","33","0","0","0","0","0","0","0","0","0","1","0","1","0","0","0","61","31","30","1","0","1","6","6","0","3","2","1","-2"
"127556","Colorado Mesa University","2012","On-tenure track, professors","2","2","0","0","0","0","0","0","0","0","0","0","0","0","0","0","0","0","1","1","0","0","0","0","1","1","0","0","0","0","-2"
"127556","Colorado Mesa University","2012","On-tenure track, associate professors","7","5","2","0","0","0","0","0","0","0","0","0","0","0","0","0","0","0","7","5","2","0","0","0","0","0","0","0","0","0","-2"
"127556","Colorado Mesa University","2012","On-tenure track, assistant professors","62","31","31","0","0","0","0","0","0","0","0","0","1","0","1","0","0","0","53","25","28","1","0","1","5","5","0","2","1","1","-2"
"127556","Colorado Mesa University","2012","On-tenure track, instructors","1","1","0","0","0","0","0","0","0","0","0","0","0","0","0","0","0","0","0","0","0","0","0","0","0","0","0","1","1","0","-2"
"127556","Colorado Mesa University","2012","Not on tenure track/No tenure system system total","72","40","32","0","0","0","0","0","0","0","0","0","4","3","1","0","0","0","58","32","26","0","0","0","7","5","2","3","0","3","-2"
"127556","Colorado Mesa University","2012","Not on tenure/no tenure system, professors","1","0","1","0","0","0","0","0","0","0","0","0","0","0","0","0","0","0","1","0","1","0","0","0","0","0","0","0","0","0","-2"
"127556","Colorado Mesa University","2012","Not on tenure/no tenure system, instructors","68","39","29","0","0","0","0","0","0","0","0","0","4","3","1","0","0","0","55","32","23","0","0","0","6","4","2","3","0","3","-2"
"127556","Colorado Mesa University","2012","Not on tenure/no tenure system, lecturers","3","1","2","0","0","0","0","0","0","0","0","0","0","0","0","0","0","0","2","0","2","0","0","0","1","1","0","0","0","0","-2"
"127820","Pikes Peak Community College","2012","Not on tenure track/No tenure system system total","170","63","107","0","0","0","4","2","2","2","0","2","3","2","1","0","0","0","138","52","86","0","0","0","23","7","16","0","0","0","-2"
"127820","Pikes Peak Community College","2012","Not on tenure/no tenure system, no academic rank","170","63","107","0","0","0","4","2","2","2","0","2","3","2","1","0","0","0","138","52","86","0","0","0","23","7","16","0","0","0","-2"
"127909","Red Rocks Community College","2012","Not on tenure track/No tenure system system total","94","37","57","1","0","1","0","0","0","0","0","0","2","1","1","0","0","0","84","34","50","2","0","2","5","2","3","0","0","0","-2"
"127909","Red Rocks Community College","2012","Not on tenure/no tenure system, instructors","94","37","57","1","0","1","0","0","0","0","0","0","2","1","1","0","0","0","84","34","50","2","0","2","5","2","3","0","0","0","-2"
"128391","Western Colorado University","2012","Tenured total","59","37","22","0","0","0","1","0","1","0","0","0","1","1","0","0","0","0","54","35","19","0","0","0","1","0","1","2","1","1","-2"
"128391","Western Colorado University","2012","Tenured, professors","46","30","16","0","0","0","0","0","0","0","0","0","1","1","0","0","0","0","45","29","16","0","0","0","0","0","0","0","0","0","-2"
"128391","Western Colorado University","2012","Tenured, associate professors","13","7","6","0","0","0","1","0","1","0","0","0","0","0","0","0","0","0","9","6","3","0","0","0","1","0","1","2","1","1","-2"
"128391","Western Colorado University","2012","On-Tenure track total","20","13","7","0","0","0","0","0","0","0","0","0","0","0","0","0","0","0","18","11","7","0","0","0","2","2","0","0","0","0","-2"
"128391","Western Colorado University","2012","On-tenure track, professors","1","1","0","0","0","0","0","0","0","0","0","0","0","0","0","0","0","0","1","1","0","0","0","0","0","0","0","0","0","0","-2"
"128391","Western Colorado University","2012","On-tenure track, assistant professors","19","12","7","0","0","0","0","0","0","0","0","0","0","0","0","0","0","0","17","10","7","0","0","0","2","2","0","0","0","0","-2"
"128391","Western Colorado University","2012","Not on tenure track/No tenure system system total","32","11","21","0","0","0","1","0","1","1","0","1","0","0","0","0","0","0","29","11","18","0","0","0","1","0","1","0","0","0","-2"
"128391","Western Colorado University","2012","Not on tenure/no tenure system, lecturers","32","11","21","0","0","0","1","0","1","1","0","1","0","0","0","0","0","0","29","11","18","0","0","0","1","0","1","0","0","0","-2"
"128771","Central Connecticut State University","2012","Tenured total","307","181","126","2","2","0","21","15","6","18","10","8","15","11","4","0","0","0","248","142","106","3","1","2","0","0","0","0","0","0","-2"
"128771","Central Connecticut State University","2012","Tenured, professors","187","115","72","2","2","0","13","7","6","11","7","4","12","8","4","0","0","0","146","90","56","3","1","2","0","0","0","0","0","0","-2"
"128771","Central Connecticut State University","2012","Tenured, associate professors","108","61","47","0","0","0","8","8","0","5","3","2","3","3","0","0","0","0","92","47","45","0","0","0","0","0","0","0","0","0","-2"
"128771","Central Connecticut State University","2012","Tenured, assistant professors","12","5","7","0","0","0","0","0","0","2","0","2","0","0","0","0","0","0","10","5","5","0","0","0","0","0","0","0","0","0","-2"
"128771","Central Connecticut State University","2012","On-Tenure track total","92","51","41","0","0","0","9","7","2","4","3","1","5","1","4","0","0","0","62","34","28","1","1","0","0","0","0","11","5","6","-2"
"128771","Central Connecticut State University","2012","On-tenure track, professors","2","1","1","0","0","0","0","0","0","0","0","0","0","0","0","0","0","0","2","1","1","0","0","0","0","0","0","0","0","0","-2"
"128771","Central Connecticut State University","2012","On-tenure track, associate professors","18","12","6","0","0","0","5","4","1","0","0","0","1","1","0","0","0","0","9","6","3","0","0","0","0","0","0","3","1","2","-2"
"128771","Central Connecticut State University","2012","On-tenure track, assistant professors","70","37","33","0","0","0","4","3","1","4","3","1","4","0","4","0","0","0","49","26","23","1","1","0","0","0","0","8","4","4","-2"
"128771","Central Connecticut State University","2012","On-tenure track, instructors","2","1","1","0","0","0","0","0","0","0","0","0","0","0","0","0","0","0","2","1","1","0","0","0","0","0","0","0","0","0","-2"
"128771","Central Connecticut State University","2012","Not on tenure track/No tenure system system total","42","20","22","0","0","0","0","0","0","6","3","3","3","1","2","0","0","0","33","16","17","0","0","0","0","0","0","0","0","0","-2"
"128771","Central Connecticut State University","2012","Not on tenure/no tenure system, professors","2","2","0","0","0","0","0","0","0","2","2","0","0","0","0","0","0","0","0","0","0","0","0","0","0","0","0","0","0","0","-2"
"128771","Central Connecticut State University","2012","Not on tenure/no tenure system, associate professors","2","2","0","0","0","0","0","0","0","0","0","0","0","0","0","0","0","0","2","2","0","0","0","0","0","0","0","0","0","0","-2"
"128771","Central Connecticut State University","2012","Not on tenure/no tenure system, assistant professors","26","10","16","0","0","0","0","0","0","4","1","3","1","0","1","0","0","0","21","9","12","0","0","0","0","0","0","0","0","0","-2"
"128771","Central Connecticut State University","2012","Not on tenure/no tenure system, instructors","12","6","6","0","0","0","0","0","0","0","0","0","2","1","1","0","0","0","10","5","5","0","0","0","0","0","0","0","0","0","-2"
"129154","Goodwin University","2012","Not on tenure track/No tenure system system total","65","19","46","0","0","0","3","0","3","6","1","5","3","1","2","1","0","1","50","16","34","2","1","1","0","0","0","0","0","0","-2"
"129154","Goodwin University","2012","Not on tenure/no tenure system, associate professors","24","6","18","0","0","0","3","0","3","0","0","0","1","0","1","1","0","1","19","6","13","0","0","0","0","0","0","0","0","0","-2"
"129154","Goodwin University","2012","Not on tenure/no tenure system, assistant professors","32","11","21","0","0","0","0","0","0","6","1","5","1","1","0","0","0","0","24","9","15","1","0","1","0","0","0","0","0","0","-2"
"129154","Goodwin University","2012","Not on tenure/no tenure system, instructors","5","1","4","0","0","0","0","0","0","0","0","0","1","0","1","0","0","0","3","0","3","1","1","0","0","0","0","0","0","0","-2"
"129154","Goodwin University","2012","Not on tenure/no tenure system, no academic rank","4","1","3","0","0","0","0","0","0","0","0","0","0","0","0","0","0","0","4","1","3","0","0","0","0","0","0","0","0","0","-2"
"132693","Eastern Florida State College","2012","Tenured total","183","72","111","0","0","0","10","5","5","10","4","6","4","1","3","0","0","0","153","59","94","5","3","2","1","0","1","0","0","0","-2"
"132693","Eastern Florida State College","2012","Tenured, professors","57","29","28","0","0","0","6","3","3","1","1","0","1","1","0","0","0","0","47","22","25","2","2","0","0","0","0","0","0","0","-2"
"132693","Eastern Florida State College","2012","Tenured, associate professors","51","20","31","0","0","0","2","1","1","5","2","3","1","0","1","0","0","0","42","16","26","1","1","0","0","0","0","0","0","0","-2"
"132693","Eastern Florida State College","2012","Tenured, assistant professors","60","20","40","0","0","0","2","1","1","3","1","2","2","0","2","0","0","0","50","18","32","2","0","2","1","0","1","0","0","0","-2"
"132693","Eastern Florida State College","2012","Tenured, instructors","15","3","12","0","0","0","0","0","0","1","0","1","0","0","0","0","0","0","14","3","11","0","0","0","0","0","0","0","0","0","-2"
"132693","Eastern Florida State College","2012","On-Tenure track total","48","27","21","0","0","0","1","1","0","5","3","2","0","0","0","0","0","0","40","22","18","0","0","0","0","0","0","2","1","1","-2"
"132693","Eastern Florida State College","2012","On-tenure track, assistant professors","1","1","0","0","0","0","0","0","0","0","0","0","0","0","0","0","0","0","1","1","0","0","0","0","0","0","0","0","0","0","-2"
"132693","Eastern Florida State College","2012","On-tenure track, instructors","47","26","21","0","0","0","1","1","0","5","3","2","0","0","0","0","0","0","39","21","18","0","0","0","0","0","0","2","1","1","-2"
"132693","Eastern Florida State College","2012","Not on tenure track/No tenure system system total","8","0","8","0","0","0","0","0","0","2","0","2","1","0","1","0","0","0","4","0","4","1","0","1","0","0","0","0","0","0","-2"
"132693","Eastern Florida State College","2012","Not on tenure/no tenure system, instructors","8","0","8","0","0","0","0","0","0","2","0","2","1","0","1","0","0","0","4","0","4","1","0","1","0","0","0","0","0","0","-2"
"133386","Daytona State College","2012","Tenured total","233","124","109","1","0","1","8","6","2","17","9","8","8","6","2","0","0","0","193","99","94","0","0","0","4","2","2","2","2","0","-2"
"133386","Daytona State College","2012","Tenured, professors","104","52","52","0","0","0","4","3","1","8","2","6","5","3","2","0","0","0","87","44","43","0","0","0","0","0","0","0","0","0","-2"
"133386","Daytona State College","2012","Tenured, associate professors","90","48","42","1","0","1","3","3","0","7","5","2","1","1","0","0","0","0","76","38","38","0","0","0","1","0","1","1","1","0","-2"
"133386","Daytona State College","2012","Tenured, assistant professors","38","23","15","0","0","0","1","0","1","2","2","0","2","2","0","0","0","0","29","16","13","0","0","0","3","2","1","1","1","0","-2"
"133386","Daytona State College","2012","Tenured, instructors","1","1","0","0","0","0","0","0","0","0","0","0","0","0","0","0","0","0","1","1","0","0","0","0","0","0","0","0","0","0","-2"
"133386","Daytona State College","2012","On-Tenure track total","67","28","39","0","0","0","1","0","1","8","2","6","3","2","1","0","0","0","53","23","30","0","0","0","2","1","1","0","0","0","-2"
"133386","Daytona State College","2012","On-tenure track, professors","1","0","1","0","0","0","0","0","0","0","0","0","0","0","0","0","0","0","1","0","1","0","0","0","0","0","0","0","0","0","-2"
"133386","Daytona State College","2012","On-tenure track, associate professors","19","8","11","0","0","0","1","0","1","3","1","2","0","0","0","0","0","0","15","7","8","0","0","0","0","0","0","0","0","0","-2"
"133386","Daytona State College","2012","On-tenure track, assistant professors","36","14","22","0","0","0","0","0","0","4","1","3","2","1","1","0","0","0","28","11","17","0","0","0","2","1","1","0","0","0","-2"
"133386","Daytona State College","2012","On-tenure track, instructors","11","6","5","0","0","0","0","0","0","1","0","1","1","1","0","0","0","0","9","5","4","0","0","0","0","0","0","0","0","0","-2"
"133386","Daytona State College","2012","Not on tenure track/No tenure system system total","1","0","1","0","0","0","0","0","0","0","0","0","0","0","0","0","0","0","1","0","1","0","0","0","0","0","0","0","0","0","-2"
"133386","Daytona State College","2012","Not on tenure/no tenure system, instructors","1","0","1","0","0","0","0","0","0","0","0","0","0","0","0","0","0","0","1","0","1","0","0","0","0","0","0","0","0","0","-2"
"134130","University of Florida","2012","Tenured total","1605","1207","398","1","1","0","177","144","33","46","23","23","76","59","17","0","0","0","1291","969","322","12","9","3","1","1","0","1","1","0","-2"
"134130","University of Florida","2012","Tenured, professors","957","771","186","0","0","0","95","81","14","16","9","7","30","26","4","0","0","0","808","649","159","7","5","2","0","0","0","1","1","0","-2"
"134130","University of Florida","2012","Tenured, associate professors","642","431","211","1","1","0","82","63","19","30","14","16","46","33","13","0","0","0","477","315","162","5","4","1","1","1","0","0","0","0","-2"
"134130","University of Florida","2012","Tenured, assistant professors","6","5","1","0","0","0","0","0","0","0","0","0","0","0","0","0","0","0","6","5","1","0","0","0","0","0","0","0","0","0","-2"
"134130","University of Florida","2012","On-Tenure track total","459","294","165","0","0","0","85","53","32","16","9","7","32","17","15","1","1","0","294","190","104","8","7","1","1","0","1","22","17","5","-2"
"134130","University of Florida","2012","On-tenure track, professors","29","23","6","0","0","0","4","4","0","1","0","1","2","2","0","0","0","0","20","15","5","0","0","0","0","0","0","2","2","0","-2"
"134130","University of Florida","2012","On-tenure track, associate professors","63","40","23","0","0","0","15","8","7","3","2","1","5","3","2","0","0","0","38","25","13","0","0","0","0","0","0","2","2","0","-2"
"134130","University of Florida","2012","On-tenure track, assistant professors","367","231","136","0","0","0","66","41","25","12","7","5","25","12","13","1","1","0","236","150","86","8","7","1","1","0","1","18","13","5","-2"
"134130","University of Florida","2012","Not on tenure track/No tenure system system total","497","236","261","2","1","1","39","12","27","27","12","15","33","14","19","0","0","0","372","180","192","5","4","1","1","1","0","18","12","6","-2"
"134130","University of Florida","2012","Not on tenure/no tenure system, professors","10","9","1","0","0","0","0","0","0","0","0","0","3","3","0","0","0","0","4","3","1","2","2","0","0","0","0","1","1","0","-2"
"134130","University of Florida","2012","Not on tenure/no tenure system, associate professors","11","9","2","0","0","0","2","1","1","0","0","0","0","0","0","0","0","0","8","7","1","0","0","0","1","1","0","0","0","0","-2"
"134130","University of Florida","2012","Not on tenure/no tenure system, assistant professors","57","30","27","0","0","0","8","5","3","4","1","3","5","4","1","0","0","0","38","18","20","0","0","0","0","0","0","2","2","0","-2"
"134130","University of Florida","2012","Not on tenure/no tenure system, lecturers","239","106","133","2","1","1","16","2","14","14","6","8","17","5","12","0","0","0","184","89","95","1","1","0","0","0","0","5","2","3","-2"
"134130","University of Florida","2012","Not on tenure/no tenure system, no academic rank","180","82","98","0","0","0","13","4","9","9","5","4","8","2","6","0","0","0","138","63","75","2","1","1","0","0","0","10","7","3","-2"
"135188","Lake-Sumter State College","2012","Tenured total","34","7","27","0","0","0","0","0","0","2","0","2","0","0","0","0","0","0","32","7","25","0","0","0","0","0","0","0","0","0","-2"
"135188","Lake-Sumter State College","2012","Tenured, professors","9","3","6","0","0","0","0","0","0","1","0","1","0","0","0","0","0","0","8","3","5","0","0","0","0","0","0","0","0","0","-2"
"135188","Lake-Sumter State College","2012","Tenured, associate professors","10","3","7","0","0","0","0","0","0","0","0","0","0","0","0","0","0","0","10","3","7","0","0","0","0","0","0","0","0","0","-2"
"135188","Lake-Sumter State College","2012","Tenured, assistant professors","7","1","6","0","0","0","0","0","0","1","0","1","0","0","0","0","0","0","6","1","5","0","0","0","0","0","0","0","0","0","-2"
"135188","Lake-Sumter State College","2012","Tenured, instructors","8","0","8","0","0","0","0","0","0","0","0","0","0","0","0","0","0","0","8","0","8","0","0","0","0","0","0","0","0","0","-2"
"135188","Lake-Sumter State College","2012","On-Tenure track total","42","17","25","1","1","0","0","0","0","2","1","1","1","1","0","0","0","0","38","14","24","0","0","0","0","0","0","0","0","0","-2"
"135188","Lake-Sumter State College","2012","On-tenure track, associate professors","1","1","0","0","0","0","0","0","0","0","0","0","0","0","0","0","0","0","1","1","0","0","0","0","0","0","0","0","0","0","-2"
"135188","Lake-Sumter State College","2012","On-tenure track, assistant professors","5","0","5","0","0","0","0","0","0","1","0","1","0","0","0","0","0","0","4","0","4","0","0","0","0","0","0","0","0","0","-2"
"135188","Lake-Sumter State College","2012","On-tenure track, instructors","31","15","16","1","1","0","0","0","0","0","0","0","1","1","0","0","0","0","29","13","16","0","0","0","0","0","0","0","0","0","-2"
"135188","Lake-Sumter State College","2012","On-tenure track, no academic rank","5","1","4","0","0","0","0","0","0","1","1","0","0","0","0","0","0","0","4","0","4","0","0","0","0","0","0","0","0","0","-2"
"135188","Lake-Sumter State College","2012","Not on tenure track/No tenure system system total","4","3","1","0","0","0","0","0","0","0","0","0","0","0","0","0","0","0","4","3","1","0","0","0","0","0","0","0","0","0","-2"
"135188","Lake-Sumter State College","2012","Not on tenure/no tenure system, instructors","2","1","1","0","0","0","0","0","0","0","0","0","0","0","0","0","0","0","2","1","1","0","0","0","0","0","0","0","0","0","-2"
"135188","Lake-Sumter State College","2012","Not on tenure/no tenure system, no academic rank","2","2","0","0","0","0","0","0","0","0","0","0","0","0","0","0","0","0","2","2","0","0","0","0","0","0","0","0","0","0","-2"
"135391","State College of Florida-Manatee-Sarasota","2012","Tenured total","103","37","66","0","0","0","3","3","0","5","3","2","5","1","4","0","0","0","89","30","59","0","0","0","1","0","1","0","0","0","-2"
"135391","State College of Florida-Manatee-Sarasota","2012","Tenured, professors","27","11","16","0","0","0","1","1","0","2","1","1","0","0","0","0","0","0","24","9","15","0","0","0","0","0","0","0","0","0","-2"
"135391","State College of Florida-Manatee-Sarasota","2012","Tenured, associate professors","27","8","19","0","0","0","1","1","0","0","0","0","2","0","2","0","0","0","23","7","16","0","0","0","1","0","1","0","0","0","-2"
"135391","State College of Florida-Manatee-Sarasota","2012","Tenured, assistant professors","34","12","22","0","0","0","1","1","0","2","2","0","3","1","2","0","0","0","28","8","20","0","0","0","0","0","0","0","0","0","-2"
"135391","State College of Florida-Manatee-Sarasota","2012","Tenured, instructors","15","6","9","0","0","0","0","0","0","1","0","1","0","0","0","0","0","0","14","6","8","0","0","0","0","0","0","0","0","0","-2"
"135391","State College of Florida-Manatee-Sarasota","2012","On-Tenure track total","24","8","16","0","0","0","0","0","0","1","1","0","1","1","0","0","0","0","21","5","16","0","0","0","0","0","0","1","1","0","-2"
"135391","State College of Florida-Manatee-Sarasota","2012","On-tenure track, associate professors","2","1","1","0","0","0","0","0","0","1","1","0","0","0","0","0","0","0","1","0","1","0","0","0","0","0","0","0","0","0","-2"
"135391","State College of Florida-Manatee-Sarasota","2012","On-tenure track, assistant professors","10","3","7","0","0","0","0","0","0","0","0","0","1","1","0","0","0","0","9","2","7","0","0","0","0","0","0","0","0","0","-2"
"135391","State College of Florida-Manatee-Sarasota","2012","On-tenure track, instructors","12","4","8","0","0","0","0","0","0","0","0","0","0","0","0","0","0","0","11","3","8","0","0","0","0","0","0","1","1","0","-2"
"135391","State College of Florida-Manatee-Sarasota","2012","Not on tenure track/No tenure system system total","3","0","3","0","0","0","0","0","0","0","0","0","0","0","0","0","0","0","3","0","3","0","0","0","0","0","0","0","0","0","-2"
"135391","State College of Florida-Manatee-Sarasota","2012","Not on tenure/no tenure system, assistant professors","1","0","1","0","0","0","0","0","0","0","0","0","0","0","0","0","0","0","1","0","1","0","0","0","0","0","0","0","0","0","-2"
"135391","State College of Florida-Manatee-Sarasota","2012","Not on tenure/no tenure system, instructors","2","0","2","0","0","0","0","0","0","0","0","0","0","0","0","0","0","0","2","0","2","0","0","0","0","0","0","0","0","0","-2"
"136400","Pasco-Hernando State College","2012","Tenured total","78","20","58","0","0","0","0","0","0","6","2","4","2","2","0","1","0","1","67","15","52","0","0","0","2","1","1","0","0","0","-2"
"136400","Pasco-Hernando State College","2012","Tenured, professors","26","5","21","0","0","0","0","0","0","1","0","1","1","1","0","0","0","0","23","4","19","0","0","0","1","0","1","0","0","0","-2"
"136400","Pasco-Hernando State College","2012","Tenured, associate professors","17","2","15","0","0","0","0","0","0","1","0","1","0","0","0","0","0","0","16","2","14","0","0","0","0","0","0","0","0","0","-2"
"136400","Pasco-Hernando State College","2012","Tenured, assistant professors","23","8","15","0","0","0","0","0","0","4","2","2","1","1","0","1","0","1","17","5","12","0","0","0","0","0","0","0","0","0","-2"
"136400","Pasco-Hernando State College","2012","Tenured, instructors","12","5","7","0","0","0","0","0","0","0","0","0","0","0","0","0","0","0","11","4","7","0","0","0","1","1","0","0","0","0","-2"
"136400","Pasco-Hernando State College","2012","On-Tenure track total","40","14","26","0","0","0","1","1","0","1","1","0","4","2","2","0","0","0","34","10","24","0","0","0","0","0","0","0","0","0","-2"
"136400","Pasco-Hernando State College","2012","On-tenure track, assistant professors","4","2","2","0","0","0","0","0","0","0","0","0","0","0","0","0","0","0","4","2","2","0","0","0","0","0","0","0","0","0","-2"
"136400","Pasco-Hernando State College","2012","On-tenure track, instructors","36","12","24","0","0","0","1","1","0","1","1","0","4","2","2","0","0","0","30","8","22","0","0","0","0","0","0","0","0","0","-2"
"136400","Pasco-Hernando State College","2012","Not on tenure track/No tenure system system total","7","4","3","0","0","0","0","0","0","0","0","0","0","0","0","0","0","0","7","4","3","0","0","0","0","0","0","0","0","0","-2"
"136400","Pasco-Hernando State College","2012","Not on tenure/no tenure system, instructors","1","0","1","0","0","0","0","0","0","0","0","0","0","0","0","0","0","0","1","0","1","0","0","0","0","0","0","0","0","0","-2"
"136400","Pasco-Hernando State College","2012","Not on tenure/no tenure system, no academic rank","6","4","2","0","0","0","0","0","0","0","0","0","0","0","0","0","0","0","6","4","2","0","0","0","0","0","0","0","0","0","-2"
"136774","Ringling College of Art and Design","2012","Not on tenure track/No tenure system system total","92","64","28","0","0","0","1","1","0","1","1","0","2","1","1","0","0","0","83","59","24","0","0","0","4","2","2","1","0","1","-2"
"136774","Ringling College of Art and Design","2012","Not on tenure/no tenure system, no academic rank","92","64","28","0","0","0","1","1","0","1","1","0","2","1","1","0","0","0","83","59","24","0","0","0","4","2","2","1","0","1","-2"
"136950","Rollins College","2012","Tenured total","126","80","46","0","0","0","5","2","3","4","4","0","6","4","2","0","0","0","109","69","40","0","0","0","2","1","1","0","0","0","-2"
"136950","Rollins College","2012","Tenured, professors","79","54","25","0","0","0","2","1","1","0","0","0","3","2","1","0","0","0","73","50","23","0","0","0","1","1","0","0","0","0","-2"
"136950","Rollins College","2012","Tenured, associate professors","47","26","21","0","0","0","3","1","2","4","4","0","3","2","1","0","0","0","36","19","17","0","0","0","1","0","1","0","0","0","-2"
"136950","Rollins College","2012","On-Tenure track total","39","16","23","0","0","0","1","1","0","0","0","0","3","1","2","0","0","0","28","12","16","0","0","0","4","1","3","3","1","2","-2"
"136950","Rollins College","2012","On-tenure track, assistant professors","39","16","23","0","0","0","1","1","0","0","0","0","3","1","2","0","0","0","28","12","16","0","0","0","4","1","3","3","1","2","-2"
"136950","Rollins College","2012","Not on tenure track/No tenure system system total","51","27","24","0","0","0","1","1","0","0","0","0","5","2","3","0","0","0","40","22","18","0","0","0","3","1","2","2","1","1","-2"
"136950","Rollins College","2012","Not on tenure/no tenure system, professors","2","2","0","0","0","0","0","0","0","0","0","0","0","0","0","0","0","0","2","2","0","0","0","0","0","0","0","0","0","0","-2"
"136950","Rollins College","2012","Not on tenure/no tenure system, associate professors","3","3","0","0","0","0","0","0","0","0","0","0","1","1","0","0","0","0","2","2","0","0","0","0","0","0","0","0","0","0","-2"
"136950","Rollins College","2012","Not on tenure/no tenure system, assistant professors","14","7","7","0","0","0","0","0","0","0","0","0","1","0","1","0","0","0","12","7","5","0","0","0","1","0","1","0","0","0","-2"
"136950","Rollins College","2012","Not on tenure/no tenure system, instructors","3","2","1","0","0","0","0","0","0","0","0","0","0","0","0","0","0","0","1","1","0","0","0","0","0","0","0","2","1","1","-2"
"136950","Rollins College","2012","Not on tenure/no tenure system, lecturers","28","12","16","0","0","0","1","1","0","0","0","0","3","1","2","0","0","0","22","9","13","0","0","0","2","1","1","0","0","0","-2"
"136950","Rollins College","2012","Not on tenure/no tenure system, no academic rank","1","1","0","0","0","0","0","0","0","0","0","0","0","0","0","0","0","0","1","1","0","0","0","0","0","0","0","0","0","0","-2"
"137078","St Petersburg College","2012","Tenured total","224","106","118","0","0","0","7","5","2","18","10","8","9","3","6","0","0","0","183","83","100","7","5","2","0","0","0","0","0","0","-2"
"137078","St Petersburg College","2012","Tenured, no academic rank","224","106","118","0","0","0","7","5","2","18","10","8","9","3","6","0","0","0","183","83","100","7","5","2","0","0","0","0","0","0","-2"
"137078","St Petersburg College","2012","On-Tenure track total","136","56","80","0","0","0","2","2","0","15","5","10","8","1","7","0","0","0","107","46","61","3","1","2","1","1","0","0","0","0","-2"
"137078","St Petersburg College","2012","On-tenure track, no academic rank","136","56","80","0","0","0","2","2","0","15","5","10","8","1","7","0","0","0","107","46","61","3","1","2","1","1","0","0","0","0","-2"
"137078","St Petersburg College","2012","Not on tenure track/No tenure system system total","17","7","10","0","0","0","1","1","0","1","1","0","0","0","0","0","0","0","15","5","10","0","0","0","0","0","0","0","0","0","-2"
"137078","St Petersburg College","2012","Not on tenure/no tenure system, no academic rank","17","7","10","0","0","0","1","1","0","1","1","0","0","0","0","0","0","0","15","5","10","0","0","0","0","0","0","0","0","0","-2"
"137096","Santa Fe College","2012","Tenured total","195","84","111","0","0","0","3","1","2","10","3","7","10","3","7","0","0","0","164","72","92","4","2","2","4","3","1","0","0","0","-2"
"137096","Santa Fe College","2012","Tenured, no academic rank","195","84","111","0","0","0","3","1","2","10","3","7","10","3","7","0","0","0","164","72","92","4","2","2","4","3","1","0","0","0","-2"
"137096","Santa Fe College","2012","On-Tenure track total","39","17","22","0","0","0","2","2","0","3","1","2","4","2","2","0","0","0","30","12","18","0","0","0","0","0","0","0","0","0","-2"
"137096","Santa Fe College","2012","On-tenure track, no academic rank","39","17","22","0","0","0","2","2","0","3","1","2","4","2","2","0","0","0","30","12","18","0","0","0","0","0","0","0","0","0","-2"
"137546","Stetson University","2012","Tenured total","170","102","68","0","0","0","2","0","2","10","4","6","5","3","2","0","0","0","142","86","56","5","4","1","4","3","1","2","2","0","-2"
"137546","Stetson University","2012","Tenured, professors","107","63","44","0","0","0","1","0","1","6","2","4","3","1","2","0","0","0","93","56","37","2","2","0","1","1","0","1","1","0","-2"
"137546","Stetson University","2012","Tenured, associate professors","63","39","24","0","0","0","1","0","1","4","2","2","2","2","0","0","0","0","49","30","19","3","2","1","3","2","1","1","1","0","-2"
"137546","Stetson University","2012","On-Tenure track total","35","20","15","0","0","0","1","1","0","2","0","2","3","1","2","0","0","0","25","16","9","1","0","1","0","0","0","3","2","1","-2"
"137546","Stetson University","2012","On-tenure track, professors","2","2","0","0","0","0","0","0","0","0","0","0","0","0","0","0","0","0","2","2","0","0","0","0","0","0","0","0","0","0","-2"
"137546","Stetson University","2012","On-tenure track, associate professors","2","2","0","0","0","0","0","0","0","0","0","0","0","0","0","0","0","0","2","2","0","0","0","0","0","0","0","0","0","0","-2"
"137546","Stetson University","2012","On-tenure track, assistant professors","31","16","15","0","0","0","1","1","0","2","0","2","3","1","2","0","0","0","21","12","9","1","0","1","0","0","0","3","2","1","-2"
"137546","Stetson University","2012","Not on tenure track/No tenure system system total","41","24","17","0","0","0","1","1","0","0","0","0","2","1","1","0","0","0","36","21","15","0","0","0","2","1","1","0","0","0","-2"
"137546","Stetson University","2012","Not on tenure/no tenure system, no academic rank","41","24","17","0","0","0","1","1","0","0","0","0","2","1","1","0","0","0","36","21","15","0","0","0","2","1","1","0","0","0","-2"
"137564","Southeastern University","2012","Not on tenure track/No tenure system system total","93","61","32","0","0","0","4","1","3","8","6","2","2","0","2","1","0","1","77","53","24","1","1","0","0","0","0","0","0","0","-2"
"137564","Southeastern University","2012","Not on tenure/no tenure system, professors","24","19","5","0","0","0","0","0","0","1","0","1","1","0","1","0","0","0","22","19","3","0","0","0","0","0","0","0","0","0","-2"
"137564","Southeastern University","2012","Not on tenure/no tenure system, associate professors","30","21","9","0","0","0","2","0","2","3","3","0","0","0","0","0","0","0","24","17","7","1","1","0","0","0","0","0","0","0","-2"
"137564","Southeastern University","2012","Not on tenure/no tenure system, assistant professors","38","20","18","0","0","0","2","1","1","3","2","1","1","0","1","1","0","1","31","17","14","0","0","0","0","0","0","0","0","0","-2"
"137564","Southeastern University","2012","Not on tenure/no tenure system, instructors","1","1","0","0","0","0","0","0","0","1","1","0","0","0","0","0","0","0","0","0","0","0","0","0","0","0","0","0","0","0","-2"
"139700","Georgia Highlands College","2012","Tenured total","53","24","29","0","0","0","1","1","0","1","0","1","1","0","1","0","0","0","50","23","27","0","0","0","0","0","0","0","0","0","-2"
"139700","Georgia Highlands College","2012","Tenured, professors","14","10","4","0","0","0","1","1","0","0","0","0","0","0","0","0","0","0","13","9","4","0","0","0","0","0","0","0","0","0","-2"
"139700","Georgia Highlands College","2012","Tenured, associate professors","32","11","21","0","0","0","0","0","0","1","0","1","1","0","1","0","0","0","30","11","19","0","0","0","0","0","0","0","0","0","-2"
"139700","Georgia Highlands College","2012","Tenured, assistant professors","7","3","4","0","0","0","0","0","0","0","0","0","0","0","0","0","0","0","7","3","4","0","0","0","0","0","0","0","0","0","-2"
"139700","Georgia Highlands College","2012","On-Tenure track total","60","25","35","0","0","0","1","1","0","4","2","2","0","0","0","0","0","0","55","22","33","0","0","0","0","0","0","0","0","0","-2"
"139700","Georgia Highlands College","2012","On-tenure track, professors","1","1","0","0","0","0","0","0","0","0","0","0","0","0","0","0","0","0","1","1","0","0","0","0","0","0","0","0","0","0","-2"
"139700","Georgia Highlands College","2012","On-tenure track, associate professors","2","1","1","0","0","0","0","0","0","1","0","1","0","0","0","0","0","0","1","1","0","0","0","0","0","0","0","0","0","0","-2"
"139700","Georgia Highlands College","2012","On-tenure track, assistant professors","35","16","19","0","0","0","0","0","0","2","2","0","0","0","0","0","0","0","33","14","19","0","0","0","0","0","0","0","0","0","-2"
"139700","Georgia Highlands College","2012","On-tenure track, instructors","22","7","15","0","0","0","1","1","0","1","0","1","0","0","0","0","0","0","20","6","14","0","0","0","0","0","0","0","0","0","-2"
"139700","Georgia Highlands College","2012","Not on tenure track/No tenure system system total","21","5","16","0","0","0","1","1","0","2","1","1","1","0","1","0","0","0","17","3","14","0","0","0","0","0","0","0","0","0","-2"
"139700","Georgia Highlands College","2012","Not on tenure/no tenure system, lecturers","21","5","16","0","0","0","1","1","0","2","1","1","1","0","1","0","0","0","17","3","14","0","0","0","0","0","0","0","0","0","-2"
"141565","University of Hawaii at Hilo","2012","Tenured total","116","73","43","1","1","0","29","18","11","1","1","0","2","2","0","8","3","5","74","47","27","0","0","0","0","0","0","1","1","0","-2"
"141565","University of Hawaii at Hilo","2012","Tenured, professors","52","37","15","1","1","0","16","10","6","1","1","0","1","1","0","2","1","1","31","23","8","0","0","0","0","0","0","0","0","0","-2"
"141565","University of Hawaii at Hilo","2012","Tenured, associate professors","62","34","28","0","0","0","13","8","5","0","0","0","1","1","0","5","1","4","43","24","19","0","0","0","0","0","0","0","0","0","-2"
"141565","University of Hawaii at Hilo","2012","Tenured, assistant professors","2","2","0","0","0","0","0","0","0","0","0","0","0","0","0","1","1","0","0","0","0","0","0","0","0","0","0","1","1","0","-2"
"141565","University of Hawaii at Hilo","2012","On-Tenure track total","69","35","34","0","0","0","20","7","13","0","0","0","2","2","0","5","1","4","36","21","15","0","0","0","0","0","0","6","4","2","-2"
"141565","University of Hawaii at Hilo","2012","On-tenure track, associate professors","6","2","4","0","0","0","2","0","2","0","0","0","0","0","0","0","0","0","4","2","2","0","0","0","0","0","0","0","0","0","-2"
"141565","University of Hawaii at Hilo","2012","On-tenure track, assistant professors","63","33","30","0","0","0","18","7","11","0","0","0","2","2","0","5","1","4","32","19","13","0","0","0","0","0","0","6","4","2","-2"
"141565","University of Hawaii at Hilo","2012","Not on tenure track/No tenure system system total","33","15","18","0","0","0","1","1","0","0","0","0","0","0","0","3","1","2","26","11","15","2","1","1","0","0","0","1","1","0","-2"
"141565","University of Hawaii at Hilo","2012","Not on tenure/no tenure system, assistant professors","6","3","3","0","0","0","1","1","0","0","0","0","0","0","0","1","0","1","3","1","2","0","0","0","0","0","0","1","1","0","-2"
"141565","University of Hawaii at Hilo","2012","Not on tenure/no tenure system, instructors","27","12","15","0","0","0","0","0","0","0","0","0","0","0","0","2","1","1","23","10","13","2","1","1","0","0","0","0","0","0","-2"
"141839","University of Hawaii Maui College","2012","Tenured total","55","20","35","0","0","0","11","2","9","1","1","0","0","0","0","7","5","2","36","12","24","0","0","0","0","0","0","0","0","0","-2"
"141839","University of Hawaii Maui College","2012","Tenured, professors","12","4","8","0","0","0","3","1","2","0","0","0","0","0","0","0","0","0","9","3","6","0","0","0","0","0","0","0","0","0","-2"
"141839","University of Hawaii Maui College","2012","Tenured, associate professors","13","5","8","0","0","0","1","0","1","1","1","0","0","0","0","2","2","0","9","2","7","0","0","0","0","0","0","0","0","0","-2"
"141839","University of Hawaii Maui College","2012","Tenured, assistant professors","29","11","18","0","0","0","7","1","6","0","0","0","0","0","0","5","3","2","17","7","10","0","0","0","0","0","0","0","0","0","-2"
"141839","University of Hawaii Maui College","2012","Tenured, instructors","1","0","1","0","0","0","0","0","0","0","0","0","0","0","0","0","0","0","1","0","1","0","0","0","0","0","0","0","0","0","-2"
"141839","University of Hawaii Maui College","2012","On-Tenure track total","31","18","13","0","0","0","6","4","2","1","0","1","1","1","0","5","4","1","15","7","8","1","0","1","0","0","0","2","2","0","-2"
"141839","University of Hawaii Maui College","2012","On-tenure track, assistant professors","4","3","1","0","0","0","3","2","1","0","0","0","0","0","0","1","1","0","0","0","0","0","0","0","0","0","0","0","0","0","-2"
"141839","University of Hawaii Maui College","2012","On-tenure track, instructors","27","15","12","0","0","0","3","2","1","1","0","1","1","1","0","4","3","1","15","7","8","1","0","1","0","0","0","2","2","0","-2"
"141839","University of Hawaii Maui College","2012","Not on tenure track/No tenure system system total","9","1","8","0","0","0","0","0","0","0","0","0","2","0","2","2","1","1","5","0","5","0","0","0","0","0","0","0","0","0","-2"
"141839","University of Hawaii Maui College","2012","Not on tenure/no tenure system, instructors","9","1","8","0","0","0","0","0","0","0","0","0","2","0","2","2","1","1","5","0","5","0","0","0","0","0","0","0","0","0","-2"
"142559","College of Southern Idaho","2012","Not on tenure track/No tenure system system total","162","76","86","1","0","1","1","0","1","0","0","0","4","1","3","0","0","0","155","75","80","1","0","1","0","0","0","0","0","0","-2"
"142559","College of Southern Idaho","2012","Not on tenure/no tenure system, professors","50","30","20","0","0","0","0","0","0","0","0","0","3","1","2","0","0","0","47","29","18","0","0","0","0","0","0","0","0","0","-2"
"142559","College of Southern Idaho","2012","Not on tenure/no tenure system, associate professors","33","13","20","0","0","0","0","0","0","0","0","0","0","0","0","0","0","0","32","13","19","1","0","1","0","0","0","0","0","0","-2"
"142559","College of Southern Idaho","2012","Not on tenure/no tenure system, assistant professors","40","16","24","0","0","0","1","0","1","0","0","0","1","0","1","0","0","0","38","16","22","0","0","0","0","0","0","0","0","0","-2"
"142559","College of Southern Idaho","2012","Not on tenure/no tenure system, instructors","39","17","22","1","0","1","0","0","0","0","0","0","0","0","0","0","0","0","38","17","21","0","0","0","0","0","0","0","0","0","-2"
"144281","Columbia College Chicago","2012","Tenured total","229","129","100","1","1","0","6","4","2","26","10","16","10","7","3","0","0","0","185","106","79","0","0","0","1","1","0","0","0","0","-2"
"144281","Columbia College Chicago","2012","Tenured, professors","50","32","18","0","0","0","1","0","1","5","2","3","0","0","0","0","0","0","43","29","14","0","0","0","1","1","0","0","0","0","-2"
"144281","Columbia College Chicago","2012","Tenured, associate professors","166","91","75","1","1","0","3","2","1","20","7","13","9","7","2","0","0","0","133","74","59","0","0","0","0","0","0","0","0","0","-2"
"144281","Columbia College Chicago","2012","Tenured, assistant professors","13","6","7","0","0","0","2","2","0","1","1","0","1","0","1","0","0","0","9","3","6","0","0","0","0","0","0","0","0","0","-2"
"144281","Columbia College Chicago","2012","On-Tenure track total","72","36","36","0","0","0","7","1","6","4","2","2","1","0","1","0","0","0","56","31","25","0","0","0","4","2","2","0","0","0","-2"
"144281","Columbia College Chicago","2012","On-tenure track, assistant professors","72","36","36","0","0","0","7","1","6","4","2","2","1","0","1","0","0","0","56","31","25","0","0","0","4","2","2","0","0","0","-2"
"144281","Columbia College Chicago","2012","Not on tenure track/No tenure system system total","76","38","38","0","0","0","3","1","2","4","2","2","1","0","1","0","0","0","66","35","31","0","0","0","2","0","2","0","0","0","-2"
"144281","Columbia College Chicago","2012","Not on tenure/no tenure system, assistant professors","1","1","0","0","0","0","0","0","0","0","0","0","0","0","0","0","0","0","1","1","0","0","0","0","0","0","0","0","0","0","-2"
"144281","Columbia College Chicago","2012","Not on tenure/no tenure system, lecturers","75","37","38","0","0","0","3","1","2","4","2","2","1","0","1","0","0","0","65","34","31","0","0","0","2","0","2","0","0","0","-2"
"144740","DePaul University","2012","Tenured total","582","339","243","0","0","0","31","17","14","44","24","20","29","14","15","0","0","0","410","243","167","3","2","1","30","15","15","35","24","11","-2"
"144740","DePaul University","2012","Tenured, professors","212","130","82","0","0","0","12","8","4","10","4","6","10","5","5","0","0","0","166","104","62","2","2","0","10","5","5","2","2","0","-2"
"144740","DePaul University","2012","Tenured, associate professors","365","204","161","0","0","0","19","9","10","33","19","14","19","9","10","0","0","0","241","136","105","1","0","1","19","9","10","33","22","11","-2"
"144740","DePaul University","2012","Tenured, assistant professors","5","5","0","0","0","0","0","0","0","1","1","0","0","0","0","0","0","0","3","3","0","0","0","0","1","1","0","0","0","0","-2"
"144740","DePaul University","2012","On-Tenure track total","212","111","101","1","0","1","15","4","11","10","3","7","22","13","9","0","0","0","109","58","51","3","1","2","33","20","13","19","12","7","-2"
"144740","DePaul University","2012","On-tenure track, associate professors","11","5","6","0","0","0","1","1","0","2","0","2","0","0","0","0","0","0","4","2","2","0","0","0","4","2","2","0","0","0","-2"
"144740","DePaul University","2012","On-tenure track, assistant professors","201","106","95","1","0","1","14","3","11","8","3","5","22","13","9","0","0","0","105","56","49","3","1","2","29","18","11","19","12","7","-2"
"144740","DePaul University","2012","Not on tenure track/No tenure system system total","183","104","79","1","1","0","5","3","2","5","1","4","8","5","3","0","0","0","121","68","53","2","2","0","29","15","14","12","9","3","-2"
"144740","DePaul University","2012","Not on tenure/no tenure system, professors","6","4","2","0","0","0","0","0","0","0","0","0","0","0","0","0","0","0","2","2","0","0","0","0","4","2","2","0","0","0","-2"
"144740","DePaul University","2012","Not on tenure/no tenure system, associate professors","9","7","2","0","0","0","0","0","0","0","0","0","1","1","0","0","0","0","5","4","1","0","0","0","3","2","1","0","0","0","-2"
"144740","DePaul University","2012","Not on tenure/no tenure system, assistant professors","69","39","30","1","1","0","2","0","2","4","0","4","6","3","3","0","0","0","33","19","14","1","1","0","14","9","5","8","6","2","-2"
"144740","DePaul University","2012","Not on tenure/no tenure system, instructors","99","54","45","0","0","0","3","3","0","1","1","0","1","1","0","0","0","0","81","43","38","1","1","0","8","2","6","4","3","1","-2"
"144883","East-West University","2012","Not on tenure track/No tenure system system total","15","10","5","0","0","0","5","2","3","1","1","0","0","0","0","0","0","0","8","6","2","0","0","0","1","1","0","0","0","0","-2"
"144883","East-West University","2012","Not on tenure/no tenure system, associate professors","6","2","4","0","0","0","2","0","2","1","1","0","0","0","0","0","0","0","3","1","2","0","0","0","0","0","0","0","0","0","-2"
"144883","East-West University","2012","Not on tenure/no tenure system, assistant professors","9","8","1","0","0","0","3","2","1","0","0","0","0","0","0","0","0","0","5","5","0","0","0","0","1","1","0","0","0","0","-2"
"144962","Elmhurst University","2012","Tenured total","84","39","45","0","0","0","5","4","1","1","1","0","3","1","2","0","0","0","75","33","42","0","0","0","0","0","0","0","0","0","-2"
"144962","Elmhurst University","2012","Tenured, professors","43","23","20","0","0","0","3","3","0","1","1","0","1","1","0","0","0","0","38","18","20","0","0","0","0","0","0","0","0","0","-2"
"144962","Elmhurst University","2012","Tenured, associate professors","37","13","24","0","0","0","2","1","1","0","0","0","2","0","2","0","0","0","33","12","21","0","0","0","0","0","0","0","0","0","-2"
"144962","Elmhurst University","2012","Tenured, assistant professors","4","3","1","0","0","0","0","0","0","0","0","0","0","0","0","0","0","0","4","3","1","0","0","0","0","0","0","0","0","0","-2"
"144962","Elmhurst University","2012","On-Tenure track total","35","13","22","0","0","0","2","1","1","3","0","3","1","0","1","0","0","0","28","11","17","0","0","0","0","0","0","1","1","0","-2"
"144962","Elmhurst University","2012","On-tenure track, associate professors","2","1","1","0","0","0","0","0","0","0","0","0","0","0","0","0","0","0","2","1","1","0","0","0","0","0","0","0","0","0","-2"
"144962","Elmhurst University","2012","On-tenure track, assistant professors","32","12","20","0","0","0","2","1","1","3","0","3","1","0","1","0","0","0","25","10","15","0","0","0","0","0","0","1","1","0","-2"
"144962","Elmhurst University","2012","On-tenure track, instructors","1","0","1","0","0","0","0","0","0","0","0","0","0","0","0","0","0","0","1","0","1","0","0","0","0","0","0","0","0","0","-2"
"144962","Elmhurst University","2012","Not on tenure track/No tenure system system total","28","9","19","0","0","0","0","0","0","2","0","2","1","0","1","0","0","0","25","9","16","0","0","0","0","0","0","0","0","0","-2"
"144962","Elmhurst University","2012","Not on tenure/no tenure system, associate professors","8","1","7","0","0","0","0","0","0","2","0","2","0","0","0","0","0","0","6","1","5","0","0","0","0","0","0","0","0","0","-2"
"144962","Elmhurst University","2012","Not on tenure/no tenure system, assistant professors","16","6","10","0","0","0","0","0","0","0","0","0","0","0","0","0","0","0","16","6","10","0","0","0","0","0","0","0","0","0","-2"
"144962","Elmhurst University","2012","Not on tenure/no tenure system, lecturers","4","2","2","0","0","0","0","0","0","0","0","0","1","0","1","0","0","0","3","2","1","0","0","0","0","0","0","0","0","0","-2"
"145619","Benedictine University","2012","Tenured total","79","47","32","0","0","0","5","3","2","3","1","2","1","1","0","0","0","0","68","41","27","0","0","0","2","1","1","0","0","0","-2"
"145619","Benedictine University","2012","Tenured, professors","38","26","12","0","0","0","2","2","0","2","1","1","0","0","0","0","0","0","34","23","11","0","0","0","0","0","0","0","0","0","-2"
"145619","Benedictine University","2012","Tenured, associate professors","38","18","20","0","0","0","3","1","2","1","0","1","1","1","0","0","0","0","31","15","16","0","0","0","2","1","1","0","0","0","-2"
"145619","Benedictine University","2012","Tenured, assistant professors","3","3","0","0","0","0","0","0","0","0","0","0","0","0","0","0","0","0","3","3","0","0","0","0","0","0","0","0","0","0","-2"
"145619","Benedictine University","2012","On-Tenure track total","43","15","28","0","0","0","4","2","2","2","0","2","1","1","0","0","0","0","36","12","24","0","0","0","0","0","0","0","0","0","-2"
"145619","Benedictine University","2012","On-tenure track, professors","1","0","1","0","0","0","0","0","0","0","0","0","0","0","0","0","0","0","1","0","1","0","0","0","0","0","0","0","0","0","-2"
"145619","Benedictine University","2012","On-tenure track, associate professors","9","2","7","0","0","0","2","2","0","2","0","2","0","0","0","0","0","0","5","0","5","0","0","0","0","0","0","0","0","0","-2"
"145619","Benedictine University","2012","On-tenure track, assistant professors","33","13","20","0","0","0","2","0","2","0","0","0","1","1","0","0","0","0","30","12","18","0","0","0","0","0","0","0","0","0","-2"
"145619","Benedictine University","2012","Not on tenure track/No tenure system system total","24","10","14","1","0","1","2","2","0","0","0","0","0","0","0","0","0","0","21","8","13","0","0","0","0","0","0","0","0","0","-2"
"145619","Benedictine University","2012","Not on tenure/no tenure system, professors","2","2","0","0","0","0","1","1","0","0","0","0","0","0","0","0","0","0","1","1","0","0","0","0","0","0","0","0","0","0","-2"
"145619","Benedictine University","2012","Not on tenure/no tenure system, assistant professors","9","2","7","1","0","1","1","1","0","0","0","0","0","0","0","0","0","0","7","1","6","0","0","0","0","0","0","0","0","0","-2"
"145619","Benedictine University","2012","Not on tenure/no tenure system, instructors","13","6","7","0","0","0","0","0","0","0","0","0","0","0","0","0","0","0","13","6","7","0","0","0","0","0","0","0","0","0","-2"
"145725","Illinois Institute of Technology","2012","Tenured total","194","159","35","0","0","0","22","18","4","3","2","1","2","2","0","0","0","0","74","60","14","0","0","0","78","62","16","15","15","0","-2"
"145725","Illinois Institute of Technology","2012","Tenured, professors","119","105","14","0","0","0","14","14","0","2","2","0","0","0","0","0","0","0","42","36","6","0","0","0","54","46","8","7","7","0","-2"
"145725","Illinois Institute of Technology","2012","Tenured, associate professors","74","53","21","0","0","0","8","4","4","1","0","1","2","2","0","0","0","0","31","23","8","0","0","0","24","16","8","8","8","0","-2"
"145725","Illinois Institute of Technology","2012","Tenured, assistant professors","1","1","0","0","0","0","0","0","0","0","0","0","0","0","0","0","0","0","1","1","0","0","0","0","0","0","0","0","0","0","-2"
"145725","Illinois Institute of Technology","2012","On-Tenure track total","76","52","24","0","0","0","9","6","3","5","2","3","0","0","0","1","1","0","28","18","10","0","0","0","25","22","3","8","3","5","-2"
"145725","Illinois Institute of Technology","2012","On-tenure track, associate professors","2","2","0","0","0","0","1","1","0","0","0","0","0","0","0","0","0","0","1","1","0","0","0","0","0","0","0","0","0","0","-2"
"145725","Illinois Institute of Technology","2012","On-tenure track, assistant professors","74","50","24","0","0","0","8","5","3","5","2","3","0","0","0","1","1","0","27","17","10","0","0","0","25","22","3","8","3","5","-2"
"145725","Illinois Institute of Technology","2012","Not on tenure track/No tenure system system total","140","96","44","0","0","0","5","5","0","2","1","1","2","0","2","0","0","0","81","56","25","0","0","0","39","27","12","11","7","4","-2"
"145725","Illinois Institute of Technology","2012","Not on tenure/no tenure system, professors","24","15","9","0","0","0","2","2","0","0","0","0","0","0","0","0","0","0","17","10","7","0","0","0","5","3","2","0","0","0","-2"
"145725","Illinois Institute of Technology","2012","Not on tenure/no tenure system, associate professors","28","24","4","0","0","0","1","1","0","0","0","0","0","0","0","0","0","0","18","15","3","0","0","0","8","7","1","1","1","0","-2"
"145725","Illinois Institute of Technology","2012","Not on tenure/no tenure system, assistant professors","66","43","23","0","0","0","2","2","0","0","0","0","1","0","1","0","0","0","37","25","12","0","0","0","19","12","7","7","4","3","-2"
"145725","Illinois Institute of Technology","2012","Not on tenure/no tenure system, instructors","8","4","4","0","0","0","0","0","0","0","0","0","0","0","0","0","0","0","4","2","2","0","0","0","3","1","2","1","1","0","-2"
"145725","Illinois Institute of Technology","2012","Not on tenure/no tenure system, lecturers","6","4","2","0","0","0","0","0","0","2","1","1","0","0","0","0","0","0","2","2","0","0","0","0","1","1","0","1","0","1","-2"
"145725","Illinois Institute of Technology","2012","Not on tenure/no tenure system, no academic rank","8","6","2","0","0","0","0","0","0","0","0","0","1","0","1","0","0","0","3","2","1","0","0","0","3","3","0","1","1","0","-2"
"146339","Judson University","2012","Tenured total","40","28","12","0","0","0","3","1","2","2","2","0","0","0","0","0","0","0","35","25","10","0","0","0","0","0","0","0","0","0","-2"
"146339","Judson University","2012","Tenured, professors","29","21","8","0","0","0","3","1","2","2","2","0","0","0","0","0","0","0","24","18","6","0","0","0","0","0","0","0","0","0","-2"
"146339","Judson University","2012","Tenured, associate professors","11","7","4","0","0","0","0","0","0","0","0","0","0","0","0","0","0","0","11","7","4","0","0","0","0","0","0","0","0","0","-2"
"146339","Judson University","2012","On-Tenure track total","26","13","13","0","0","0","2","0","2","1","0","1","0","0","0","0","0","0","23","13","10","0","0","0","0","0","0","0","0","0","-2"
"146339","Judson University","2012","On-tenure track, professors","3","1","2","0","0","0","0","0","0","1","0","1","0","0","0","0","0","0","2","1","1","0","0","0","0","0","0","0","0","0","-2"
"146339","Judson University","2012","On-tenure track, associate professors","12","6","6","0","0","0","1","0","1","0","0","0","0","0","0","0","0","0","11","6","5","0","0","0","0","0","0","0","0","0","-2"
"146339","Judson University","2012","On-tenure track, assistant professors","11","6","5","0","0","0","1","0","1","0","0","0","0","0","0","0","0","0","10","6","4","0","0","0","0","0","0","0","0","0","-2"
"146339","Judson University","2012","Not on tenure track/No tenure system system total","3","1","2","0","0","0","0","0","0","0","0","0","0","0","0","0","0","0","3","1","2","0","0","0","0","0","0","0","0","0","-2"
"146339","Judson University","2012","Not on tenure/no tenure system, professors","1","1","0","0","0","0","0","0","0","0","0","0","0","0","0","0","0","0","1","1","0","0","0","0","0","0","0","0","0","0","-2"
"146339","Judson University","2012","Not on tenure/no tenure system, associate professors","2","0","2","0","0","0","0","0","0","0","0","0","0","0","0","0","0","0","2","0","2","0","0","0","0","0","0","0","0","0","-2"
"146612","Lewis University","2012","Tenured total","92","53","39","0","0","0","5","4","1","5","4","1","0","0","0","0","0","0","81","45","36","0","0","0","0","0","0","1","0","1","-2"
"146612","Lewis University","2012","Tenured, professors","57","38","19","0","0","0","2","2","0","5","4","1","0","0","0","0","0","0","50","32","18","0","0","0","0","0","0","0","0","0","-2"
"146612","Lewis University","2012","Tenured, associate professors","32","12","20","0","0","0","2","1","1","0","0","0","0","0","0","0","0","0","29","11","18","0","0","0","0","0","0","1","0","1","-2"
"146612","Lewis University","2012","Tenured, assistant professors","3","3","0","0","0","0","1","1","0","0","0","0","0","0","0","0","0","0","2","2","0","0","0","0","0","0","0","0","0","0","-2"
"146612","Lewis University","2012","On-Tenure track total","33","18","15","0","0","0","2","2","0","1","0","1","2","1","1","0","0","0","28","15","13","0","0","0","0","0","0","0","0","0","-2"
"146612","Lewis University","2012","On-tenure track, associate professors","7","5","2","0","0","0","0","0","0","0","0","0","0","0","0","0","0","0","7","5","2","0","0","0","0","0","0","0","0","0","-2"
"146612","Lewis University","2012","On-tenure track, assistant professors","26","13","13","0","0","0","2","2","0","1","0","1","2","1","1","0","0","0","21","10","11","0","0","0","0","0","0","0","0","0","-2"
"146612","Lewis University","2012","Not on tenure track/No tenure system system total","85","33","52","0","0","0","5","1","4","5","1","4","1","1","0","0","0","0","72","29","43","0","0","0","0","0","0","2","1","1","-2"
"146612","Lewis University","2012","Not on tenure/no tenure system, professors","2","2","0","0","0","0","0","0","0","0","0","0","1","1","0","0","0","0","1","1","0","0","0","0","0","0","0","0","0","0","-2"
"146612","Lewis University","2012","Not on tenure/no tenure system, associate professors","8","3","5","0","0","0","0","0","0","2","1","1","0","0","0","0","0","0","6","2","4","0","0","0","0","0","0","0","0","0","-2"
"146612","Lewis University","2012","Not on tenure/no tenure system, assistant professors","54","22","32","0","0","0","4","1","3","2","0","2","0","0","0","0","0","0","46","20","26","0","0","0","0","0","0","2","1","1","-2"
"146612","Lewis University","2012","Not on tenure/no tenure system, instructors","21","6","15","0","0","0","1","0","1","1","0","1","0","0","0","0","0","0","19","6","13","0","0","0","0","0","0","0","0","0","-2"
"146719","Loyola University Chicago","2012","Tenured total","436","283","153","1","1","0","25","20","5","14","5","9","19","9","10","0","0","0","370","244","126","3","1","2","2","1","1","2","2","0","-2"
"146719","Loyola University Chicago","2012","Tenured, professors","232","165","67","0","0","0","14","12","2","3","2","1","11","7","4","0","0","0","201","143","58","2","0","2","1","1","0","0","0","0","-2"
"146719","Loyola University Chicago","2012","Tenured, associate professors","187","106","81","1","1","0","9","6","3","10","3","7","6","1","5","0","0","0","158","93","65","1","1","0","1","0","1","1","1","0","-2"
"146719","Loyola University Chicago","2012","Tenured, assistant professors","17","12","5","0","0","0","2","2","0","1","0","1","2","1","1","0","0","0","11","8","3","0","0","0","0","0","0","1","1","0","-2"
"146719","Loyola University Chicago","2012","On-Tenure track total","136","70","66","0","0","0","17","8","9","7","3","4","6","3","3","0","0","0","96","50","46","0","0","0","0","0","0","10","6","4","-2"
"146719","Loyola University Chicago","2012","On-tenure track, professors","9","7","2","0","0","0","0","0","0","0","0","0","2","2","0","0","0","0","6","5","1","0","0","0","0","0","0","1","0","1","-2"
"146719","Loyola University Chicago","2012","On-tenure track, associate professors","8","6","2","0","0","0","1","1","0","1","0","1","0","0","0","0","0","0","5","4","1","0","0","0","0","0","0","1","1","0","-2"
"146719","Loyola University Chicago","2012","On-tenure track, assistant professors","119","57","62","0","0","0","16","7","9","6","3","3","4","1","3","0","0","0","85","41","44","0","0","0","0","0","0","8","5","3","-2"
"146719","Loyola University Chicago","2012","Not on tenure track/No tenure system system total","241","99","142","0","0","0","9","3","6","13","5","8","10","6","4","1","1","0","197","77","120","3","1","2","0","0","0","8","6","2","-2"
"146719","Loyola University Chicago","2012","Not on tenure/no tenure system, instructors","241","99","142","0","0","0","9","3","6","13","5","8","10","6","4","1","1","0","197","77","120","3","1","2","0","0","0","8","6","2","-2"
"147660","North Central College","2012","Tenured total","73","45","28","0","0","0","2","1","1","2","1","1","1","1","0","0","0","0","68","42","26","0","0","0","0","0","0","0","0","0","-2"
"147660","North Central College","2012","Tenured, professors","42","25","17","0","0","0","2","1","1","0","0","0","1","1","0","0","0","0","39","23","16","0","0","0","0","0","0","0","0","0","-2"
"147660","North Central College","2012","Tenured, associate professors","31","20","11","0","0","0","0","0","0","2","1","1","0","0","0","0","0","0","29","19","10","0","0","0","0","0","0","0","0","0","-2"
"147660","North Central College","2012","On-Tenure track total","31","12","19","0","0","0","3","1","2","0","0","0","1","0","1","0","0","0","23","10","13","0","0","0","0","0","0","4","1","3","-2"
"147660","North Central College","2012","On-tenure track, associate professors","3","1","2","0","0","0","2","1","1","0","0","0","0","0","0","0","0","0","1","0","1","0","0","0","0","0","0","0","0","0","-2"
"147660","North Central College","2012","On-tenure track, assistant professors","28","11","17","0","0","0","1","0","1","0","0","0","1","0","1","0","0","0","22","10","12","0","0","0","0","0","0","4","1","3","-2"
"147660","North Central College","2012","Not on tenure track/No tenure system system total","26","12","14","0","0","0","2","1","1","0","0","0","0","0","0","0","0","0","24","11","13","0","0","0","0","0","0","0","0","0","-2"
"147660","North Central College","2012","Not on tenure/no tenure system, professors","3","2","1","0","0","0","0","0","0","0","0","0","0","0","0","0","0","0","3","2","1","0","0","0","0","0","0","0","0","0","-2"
"147660","North Central College","2012","Not on tenure/no tenure system, associate professors","3","0","3","0","0","0","0","0","0","0","0","0","0","0","0","0","0","0","3","0","3","0","0","0","0","0","0","0","0","0","-2"
"147660","North Central College","2012","Not on tenure/no tenure system, assistant professors","16","9","7","0","0","0","2","1","1","0","0","0","0","0","0","0","0","0","14","8","6","0","0","0","0","0","0","0","0","0","-2"
"147660","North Central College","2012","Not on tenure/no tenure system, instructors","4","1","3","0","0","0","0","0","0","0","0","0","0","0","0","0","0","0","4","1","3","0","0","0","0","0","0","0","0","0","-2"
"148584","University of St Francis","2012","Tenured total","30","14","16","0","0","0","1","0","1","1","0","1","0","0","0","0","0","0","28","14","14","0","0","0","0","0","0","0","0","0","-2"
"148584","University of St Francis","2012","Tenured, professors","14","7","7","0","0","0","1","0","1","1","0","1","0","0","0","0","0","0","12","7","5","0","0","0","0","0","0","0","0","0","-2"
"148584","University of St Francis","2012","Tenured, associate professors","15","7","8","0","0","0","0","0","0","0","0","0","0","0","0","0","0","0","15","7","8","0","0","0","0","0","0","0","0","0","-2"
"148584","University of St Francis","2012","Tenured, assistant professors","1","0","1","0","0","0","0","0","0","0","0","0","0","0","0","0","0","0","1","0","1","0","0","0","0","0","0","0","0","0","-2"
"148584","University of St Francis","2012","On-Tenure track total","29","11","18","0","0","0","2","0","2","3","1","2","0","0","0","0","0","0","22","9","13","0","0","0","0","0","0","2","1","1","-2"
"148584","University of St Francis","2012","On-tenure track, associate professors","3","1","2","0","0","0","0","0","0","1","0","1","0","0","0","0","0","0","2","1","1","0","0","0","0","0","0","0","0","0","-2"
"148584","University of St Francis","2012","On-tenure track, assistant professors","26","10","16","0","0","0","2","0","2","2","1","1","0","0","0","0","0","0","20","8","12","0","0","0","0","0","0","2","1","1","-2"
"148584","University of St Francis","2012","Not on tenure track/No tenure system system total","39","16","23","0","0","0","2","1","1","0","0","0","4","2","2","0","0","0","32","13","19","1","0","1","0","0","0","0","0","0","-2"
"148584","University of St Francis","2012","Not on tenure/no tenure system, professors","11","10","1","0","0","0","0","0","0","0","0","0","1","1","0","0","0","0","10","9","1","0","0","0","0","0","0","0","0","0","-2"
"148584","University of St Francis","2012","Not on tenure/no tenure system, associate professors","3","1","2","0","0","0","0","0","0","0","0","0","0","0","0","0","0","0","3","1","2","0","0","0","0","0","0","0","0","0","-2"
"148584","University of St Francis","2012","Not on tenure/no tenure system, assistant professors","15","3","12","0","0","0","0","0","0","0","0","0","1","0","1","0","0","0","14","3","11","0","0","0","0","0","0","0","0","0","-2"
"148584","University of St Francis","2012","Not on tenure/no tenure system, instructors","10","2","8","0","0","0","2","1","1","0","0","0","2","1","1","0","0","0","5","0","5","1","0","1","0","0","0","0","0","0","-2"
"152637","Vincennes University","2012","Tenured total","89","49","40","0","0","0","1","1","0","0","0","0","0","0","0","0","0","0","88","48","40","0","0","0","0","0","0","0","0","0","-2"
"152637","Vincennes University","2012","Tenured, professors","71","34","37","0","0","0","1","1","0","0","0","0","0","0","0","0","0","0","70","33","37","0","0","0","0","0","0","0","0","0","-2"
"152637","Vincennes University","2012","Tenured, associate professors","15","12","3","0","0","0","0","0","0","0","0","0","0","0","0","0","0","0","15","12","3","0","0","0","0","0","0","0","0","0","-2"
"152637","Vincennes University","2012","Tenured, assistant professors","2","2","0","0","0","0","0","0","0","0","0","0","0","0","0","0","0","0","2","2","0","0","0","0","0","0","0","0","0","0","-2"
"152637","Vincennes University","2012","Tenured, instructors","1","1","0","0","0","0","0","0","0","0","0","0","0","0","0","0","0","0","1","1","0","0","0","0","0","0","0","0","0","0","-2"
"152637","Vincennes University","2012","On-Tenure track total","8","7","1","0","0","0","0","0","0","2","2","0","0","0","0","0","0","0","6","5","1","0","0","0","0","0","0","0","0","0","-2"
"152637","Vincennes University","2012","On-tenure track, professors","2","2","0","0","0","0","0","0","0","0","0","0","0","0","0","0","0","0","2","2","0","0","0","0","0","0","0","0","0","0","-2"
"152637","Vincennes University","2012","On-tenure track, associate professors","4","3","1","0","0","0","0","0","0","1","1","0","0","0","0","0","0","0","3","2","1","0","0","0","0","0","0","0","0","0","-2"
"152637","Vincennes University","2012","On-tenure track, assistant professors","2","2","0","0","0","0","0","0","0","1","1","0","0","0","0","0","0","0","1","1","0","0","0","0","0","0","0","0","0","0","-2"
"152637","Vincennes University","2012","Not on tenure track/No tenure system system total","143","72","71","1","0","1","1","1","0","3","1","2","1","0","1","0","0","0","135","69","66","0","0","0","0","0","0","2","1","1","-2"
"152637","Vincennes University","2012","Not on tenure/no tenure system, professors","8","2","6","0","0","0","0","0","0","0","0","0","0","0","0","0","0","0","8","2","6","0","0","0","0","0","0","0","0","0","-2"
"152637","Vincennes University","2012","Not on tenure/no tenure system, associate professors","29","12","17","0","0","0","0","0","0","1","1","0","0","0","0","0","0","0","28","11","17","0","0","0","0","0","0","0","0","0","-2"
"152637","Vincennes University","2012","Not on tenure/no tenure system, assistant professors","81","36","45","1","0","1","1","1","0","1","0","1","1","0","1","0","0","0","75","34","41","0","0","0","0","0","0","2","1","1","-2"
"152637","Vincennes University","2012","Not on tenure/no tenure system, instructors","25","22","3","0","0","0","0","0","0","1","0","1","0","0","0","0","0","0","24","22","2","0","0","0","0","0","0","0","0","0","-2"
"152992","Briar Cliff University","2012","Tenured total","30","20","10","0","0","0","0","0","0","0","0","0","0","0","0","0","0","0","30","20","10","0","0","0","0","0","0","0","0","0","-2"
"152992","Briar Cliff University","2012","Tenured, professors","15","10","5","0","0","0","0","0","0","0","0","0","0","0","0","0","0","0","15","10","5","0","0","0","0","0","0","0","0","0","-2"
"152992","Briar Cliff University","2012","Tenured, associate professors","12","9","3","0","0","0","0","0","0","0","0","0","0","0","0","0","0","0","12","9","3","0","0","0","0","0","0","0","0","0","-2"
"152992","Briar Cliff University","2012","Tenured, assistant professors","3","1","2","0","0","0","0","0","0","0","0","0","0","0","0","0","0","0","3","1","2","0","0","0","0","0","0","0","0","0","-2"
"152992","Briar Cliff University","2012","On-Tenure track total","29","13","16","0","0","0","1","1","0","0","0","0","1","1","0","0","0","0","27","11","16","0","0","0","0","0","0","0","0","0","-2"
"152992","Briar Cliff University","2012","On-tenure track, associate professors","6","3","3","0","0","0","0","0","0","0","0","0","0","0","0","0","0","0","6","3","3","0","0","0","0","0","0","0","0","0","-2"
"152992","Briar Cliff University","2012","On-tenure track, assistant professors","17","8","9","0","0","0","0","0","0","0","0","0","1","1","0","0","0","0","16","7","9","0","0","0","0","0","0","0","0","0","-2"
"152992","Briar Cliff University","2012","On-tenure track, instructors","6","2","4","0","0","0","1","1","0","0","0","0","0","0","0","0","0","0","5","1","4","0","0","0","0","0","0","0","0","0","-2"
"152992","Briar Cliff University","2012","Not on tenure track/No tenure system system total","2","1","1","0","0","0","0","0","0","0","0","0","0","0","0","0","0","0","2","1","1","0","0","0","0","0","0","0","0","0","-2"
"152992","Briar Cliff University","2012","Not on tenure/no tenure system, assistant professors","1","0","1","0","0","0","0","0","0","0","0","0","0","0","0","0","0","0","1","0","1","0","0","0","0","0","0","0","0","0","-2"
"152992","Briar Cliff University","2012","Not on tenure/no tenure system, no academic rank","1","1","0","0","0","0","0","0","0","0","0","0","0","0","0","0","0","0","1","1","0","0","0","0","0","0","0","0","0","0","-2"
"154721","Bethany College","2012","Tenured total","19","13","6","0","0","0","0","0","0","0","0","0","0","0","0","0","0","0","19","13","6","0","0","0","0","0","0","0","0","0","-2"
"154721","Bethany College","2012","Tenured, professors","9","5","4","0","0","0","0","0","0","0","0","0","0","0","0","0","0","0","9","5","4","0","0","0","0","0","0","0","0","0","-2"
"154721","Bethany College","2012","Tenured, associate professors","10","8","2","0","0","0","0","0","0","0","0","0","0","0","0","0","0","0","10","8","2","0","0","0","0","0","0","0","0","0","-2"
"154721","Bethany College","2012","On-Tenure track total","9","4","5","0","0","0","1","0","1","1","1","0","0","0","0","0","0","0","7","3","4","0","0","0","0","0","0","0","0","0","-2"
"154721","Bethany College","2012","On-tenure track, associate professors","2","1","1","0","0","0","0","0","0","0","0","0","0","0","0","0","0","0","2","1","1","0","0","0","0","0","0","0","0","0","-2"
"154721","Bethany College","2012","On-tenure track, assistant professors","7","3","4","0","0","0","1","0","1","1","1","0","0","0","0","0","0","0","5","2","3","0","0","0","0","0","0","0","0","0","-2"
"154721","Bethany College","2012","Not on tenure track/No tenure system system total","7","2","5","0","0","0","0","0","0","0","0","0","0","0","0","0","0","0","7","2","5","0","0","0","0","0","0","0","0","0","-2"
"154721","Bethany College","2012","Not on tenure/no tenure system, assistant professors","4","1","3","0","0","0","0","0","0","0","0","0","0","0","0","0","0","0","4","1","3","0","0","0","0","0","0","0","0","0","-2"
"154721","Bethany College","2012","Not on tenure/no tenure system, instructors","3","1","2","0","0","0","0","0","0","0","0","0","0","0","0","0","0","0","3","1","2","0","0","0","0","0","0","0","0","0","-2"
"159656","Loyola University New Orleans","2012","Tenured total","168","111","57","0","0","0","3","2","1","10","7","3","10","6","4","0","0","0","139","92","47","4","2","2","0","0","0","2","2","0","-2"
"159656","Loyola University New Orleans","2012","Tenured, professors","98","71","27","0","0","0","1","1","0","7","5","2","6","4","2","0","0","0","82","60","22","2","1","1","0","0","0","0","0","0","-2"
"159656","Loyola University New Orleans","2012","Tenured, associate professors","54","29","25","0","0","0","0","0","0","2","1","1","3","1","2","0","0","0","46","25","21","2","1","1","0","0","0","1","1","0","-2"
"159656","Loyola University New Orleans","2012","Tenured, assistant professors","16","11","5","0","0","0","2","1","1","1","1","0","1","1","0","0","0","0","11","7","4","0","0","0","0","0","0","1","1","0","-2"
"159656","Loyola University New Orleans","2012","On-Tenure track total","62","30","32","0","0","0","2","2","0","5","1","4","5","3","2","0","0","0","45","22","23","0","0","0","3","1","2","2","1","1","-2"
"159656","Loyola University New Orleans","2012","On-tenure track, associate professors","14","5","9","0","0","0","1","1","0","0","0","0","2","1","1","0","0","0","11","3","8","0","0","0","0","0","0","0","0","0","-2"
"159656","Loyola University New Orleans","2012","On-tenure track, assistant professors","48","25","23","0","0","0","1","1","0","5","1","4","3","2","1","0","0","0","34","19","15","0","0","0","3","1","2","2","1","1","-2"
"159656","Loyola University New Orleans","2012","Not on tenure track/No tenure system system total","89","39","50","0","0","0","1","1","0","3","0","3","3","1","2","0","0","0","77","35","42","0","0","0","5","2","3","0","0","0","-2"
"159656","Loyola University New Orleans","2012","Not on tenure/no tenure system, lecturers","89","39","50","0","0","0","1","1","0","3","0","3","3","1","2","0","0","0","77","35","42","0","0","0","5","2","3","0","0","0","-2"
"164447","American International College","2012","Tenured total","34","18","16","0","0","0","0","0","0","0","0","0","0","0","0","0","0","0","34","18","16","0","0","0","0","0","0","0","0","0","-2"
"164447","American International College","2012","Tenured, professors","15","5","10","0","0","0","0","0","0","0","0","0","0","0","0","0","0","0","15","5","10","0","0","0","0","0","0","0","0","0","-2"
"164447","American International College","2012","Tenured, associate professors","17","11","6","0","0","0","0","0","0","0","0","0","0","0","0","0","0","0","17","11","6","0","0","0","0","0","0","0","0","0","-2"
"164447","American International College","2012","Tenured, assistant professors","2","2","0","0","0","0","0","0","0","0","0","0","0","0","0","0","0","0","2","2","0","0","0","0","0","0","0","0","0","0","-2"
"164447","American International College","2012","On-Tenure track total","27","4","23","0","0","0","2","0","2","2","0","2","0","0","0","0","0","0","21","3","18","1","1","0","1","0","1","0","0","0","-2"
"164447","American International College","2012","On-tenure track, associate professors","5","1","4","0","0","0","0","0","0","0","0","0","0","0","0","0","0","0","5","1","4","0","0","0","0","0","0","0","0","0","-2"
"164447","American International College","2012","On-tenure track, assistant professors","21","3","18","0","0","0","2","0","2","2","0","2","0","0","0","0","0","0","15","2","13","1","1","0","1","0","1","0","0","0","-2"
"164447","American International College","2012","On-tenure track, no academic rank","1","0","1","0","0","0","0","0","0","0","0","0","0","0","0","0","0","0","1","0","1","0","0","0","0","0","0","0","0","0","-2"
"164447","American International College","2012","Not on tenure track/No tenure system system total","8","3","5","0","0","0","0","0","0","1","1","0","0","0","0","0","0","0","7","2","5","0","0","0","0","0","0","0","0","0","-2"
"164447","American International College","2012","Not on tenure/no tenure system, associate professors","1","0","1","0","0","0","0","0","0","0","0","0","0","0","0","0","0","0","1","0","1","0","0","0","0","0","0","0","0","0","-2"
"164447","American International College","2012","Not on tenure/no tenure system, assistant professors","3","1","2","0","0","0","0","0","0","1","1","0","0","0","0","0","0","0","2","0","2","0","0","0","0","0","0","0","0","0","-2"
"164447","American International College","2012","Not on tenure/no tenure system, instructors","3","1","2","0","0","0","0","0","0","0","0","0","0","0","0","0","0","0","3","1","2","0","0","0","0","0","0","0","0","0","-2"
"164447","American International College","2012","Not on tenure/no tenure system, no academic rank","1","1","0","0","0","0","0","0","0","0","0","0","0","0","0","0","0","0","1","1","0","0","0","0","0","0","0","0","0","0","-2"
"164632","Bay Path University","2012","Not on tenure track/No tenure system system total","52","19","33","0","0","0","2","1","1","0","0","0","1","1","0","0","0","0","48","17","31","0","0","0","1","0","1","0","0","0","-2"
"164632","Bay Path University","2012","Not on tenure/no tenure system, professors","11","4","7","0","0","0","0","0","0","0","0","0","0","0","0","0","0","0","11","4","7","0","0","0","0","0","0","0","0","0","-2"
"164632","Bay Path University","2012","Not on tenure/no tenure system, associate professors","17","7","10","0","0","0","2","1","1","0","0","0","0","0","0","0","0","0","15","6","9","0","0","0","0","0","0","0","0","0","-2"
"164632","Bay Path University","2012","Not on tenure/no tenure system, assistant professors","21","7","14","0","0","0","0","0","0","0","0","0","1","1","0","0","0","0","19","6","13","0","0","0","1","0","1","0","0","0","-2"
"164632","Bay Path University","2012","Not on tenure/no tenure system, instructors","3","1","2","0","0","0","0","0","0","0","0","0","0","0","0","0","0","0","3","1","2","0","0","0","0","0","0","0","0","0","-2"
"167729","Salem State University","2012","Tenured total","217","108","109","0","0","0","10","6","4","5","4","1","2","1","1","0","0","0","196","95","101","0","0","0","4","2","2","0","0","0","-2"
"167729","Salem State University","2012","Tenured, professors","127","62","65","0","0","0","4","2","2","1","1","0","2","1","1","0","0","0","119","58","61","0","0","0","1","0","1","0","0","0","-2"
"167729","Salem State University","2012","Tenured, associate professors","78","42","36","0","0","0","5","3","2","4","3","1","0","0","0","0","0","0","67","35","32","0","0","0","2","1","1","0","0","0","-2"
"167729","Salem State University","2012","Tenured, assistant professors","12","4","8","0","0","0","1","1","0","0","0","0","0","0","0","0","0","0","10","2","8","0","0","0","1","1","0","0","0","0","-2"
"167729","Salem State University","2012","On-Tenure track total","107","43","64","0","0","0","12","6","6","5","3","2","6","2","4","0","0","0","80","31","49","0","0","0","4","1","3","0","0","0","-2"
"167729","Salem State University","2012","On-tenure track, associate professors","25","11","14","0","0","0","2","2","0","1","1","0","2","1","1","0","0","0","19","7","12","0","0","0","1","0","1","0","0","0","-2"
"167729","Salem State University","2012","On-tenure track, assistant professors","81","32","49","0","0","0","10","4","6","4","2","2","3","1","2","0","0","0","61","24","37","0","0","0","3","1","2","0","0","0","-2"
"167729","Salem State University","2012","On-tenure track, instructors","1","0","1","0","0","0","0","0","0","0","0","0","1","0","1","0","0","0","0","0","0","0","0","0","0","0","0","0","0","0","-2"
"167729","Salem State University","2012","Not on tenure track/No tenure system system total","16","7","9","0","0","0","1","0","1","3","1","2","0","0","0","0","0","0","11","6","5","0","0","0","0","0","0","1","0","1","-2"
"167729","Salem State University","2012","Not on tenure/no tenure system, assistant professors","9","4","5","0","0","0","1","0","1","3","1","2","0","0","0","0","0","0","5","3","2","0","0","0","0","0","0","0","0","0","-2"
"167729","Salem State University","2012","Not on tenure/no tenure system, instructors","7","3","4","0","0","0","0","0","0","0","0","0","0","0","0","0","0","0","6","3","3","0","0","0","0","0","0","1","0","1","-2"
"168740","Andrews University","2012","Tenured total","78","57","21","0","0","0","7","5","2","7","6","1","4","3","1","0","0","0","59","42","17","0","0","0","0","0","0","1","1","0","-2"
"168740","Andrews University","2012","Tenured, professors","61","48","13","0","0","0","6","5","1","4","4","0","4","3","1","0","0","0","47","36","11","0","0","0","0","0","0","0","0","0","-2"
"168740","Andrews University","2012","Tenured, associate professors","14","7","7","0","0","0","1","0","1","3","2","1","0","0","0","0","0","0","9","4","5","0","0","0","0","0","0","1","1","0","-2"
"168740","Andrews University","2012","Tenured, assistant professors","3","2","1","0","0","0","0","0","0","0","0","0","0","0","0","0","0","0","3","2","1","0","0","0","0","0","0","0","0","0","-2"
"168740","Andrews University","2012","On-Tenure track total","138","71","67","0","0","0","8","3","5","9","3","6","11","7","4","0","0","0","94","48","46","2","2","0","0","0","0","14","8","6","-2"
"168740","Andrews University","2012","On-tenure track, professors","18","14","4","0","0","0","2","1","1","1","1","0","2","2","0","0","0","0","12","9","3","0","0","0","0","0","0","1","1","0","-2"
"168740","Andrews University","2012","On-tenure track, associate professors","53","29","24","0","0","0","3","1","2","2","2","0","4","3","1","0","0","0","35","19","16","1","1","0","0","0","0","8","3","5","-2"
"168740","Andrews University","2012","On-tenure track, assistant professors","67","28","39","0","0","0","3","1","2","6","0","6","5","2","3","0","0","0","47","20","27","1","1","0","0","0","0","5","4","1","-2"
"168740","Andrews University","2012","Not on tenure track/No tenure system system total","13","8","5","0","0","0","0","0","0","0","0","0","2","2","0","0","0","0","9","5","4","1","0","1","0","0","0","1","1","0","-2"
"168740","Andrews University","2012","Not on tenure/no tenure system, professors","1","0","1","0","0","0","0","0","0","0","0","0","0","0","0","0","0","0","0","0","0","1","0","1","0","0","0","0","0","0","-2"
"168740","Andrews University","2012","Not on tenure/no tenure system, associate professors","4","3","1","0","0","0","0","0","0","0","0","0","1","1","0","0","0","0","3","2","1","0","0","0","0","0","0","0","0","0","-2"
"168740","Andrews University","2012","Not on tenure/no tenure system, assistant professors","1","1","0","0","0","0","0","0","0","0","0","0","0","0","0","0","0","0","1","1","0","0","0","0","0","0","0","0","0","0","-2"
"168740","Andrews University","2012","Not on tenure/no tenure system, instructors","7","4","3","0","0","0","0","0","0","0","0","0","1","1","0","0","0","0","5","2","3","0","0","0","0","0","0","1","1","0","-2"
"177083","Conception Seminary College","2012","Not on tenure track/No tenure system system total","6","2","4","0","0","0","0","0","0","0","0","0","1","0","1","0","0","0","5","2","3","0","0","0","0","0","0","0","0","0","-2"
"177083","Conception Seminary College","2012","Not on tenure/no tenure system, professors","3","2","1","0","0","0","0","0","0","0","0","0","0","0","0","0","0","0","3","2","1","0","0","0","0","0","0","0","0","0","-2"
"177083","Conception Seminary College","2012","Not on tenure/no tenure system, assistant professors","1","0","1","0","0","0","0","0","0","0","0","0","0","0","0","0","0","0","1","0","1","0","0","0","0","0","0","0","0","0","-2"
"177083","Conception Seminary College","2012","Not on tenure/no tenure system, instructors","2","0","2","0","0","0","0","0","0","0","0","0","1","0","1","0","0","0","1","0","1","0","0","0","0","0","0","0","0","0","-2"
"178721","Park University","2012","Tenured total","48","28","20","0","0","0","2","0","2","1","1","0","0","0","0","0","0","0","45","27","18","0","0","0","0","0","0","0","0","0","-2"
"178721","Park University","2012","Tenured, professors","18","13","5","0","0","0","1","0","1","1","1","0","0","0","0","0","0","0","16","12","4","0","0","0","0","0","0","0","0","0","-2"
"178721","Park University","2012","Tenured, associate professors","30","15","15","0","0","0","1","0","1","0","0","0","0","0","0","0","0","0","29","15","14","0","0","0","0","0","0","0","0","0","-2"
"178721","Park University","2012","On-Tenure track total","36","17","19","0","0","0","2","1","1","0","0","0","0","0","0","0","0","0","32","15","17","1","0","1","0","0","0","1","1","0","-2"
"178721","Park University","2012","On-tenure track, associate professors","11","4","7","0","0","0","0","0","0","0","0","0","0","0","0","0","0","0","11","4","7","0","0","0","0","0","0","0","0","0","-2"
"178721","Park University","2012","On-tenure track, assistant professors","25","13","12","0","0","0","2","1","1","0","0","0","0","0","0","0","0","0","21","11","10","1","0","1","0","0","0","1","1","0","-2"
"178721","Park University","2012","Not on tenure track/No tenure system system total","41","20","21","1","0","1","1","0","1","2","1","1","3","2","1","1","0","1","31","16","15","1","0","1","0","0","0","1","1","0","-2"
"178721","Park University","2012","Not on tenure/no tenure system, professors","1","0","1","0","0","0","0","0","0","0","0","0","0","0","0","0","0","0","1","0","1","0","0","0","0","0","0","0","0","0","-2"
"178721","Park University","2012","Not on tenure/no tenure system, associate professors","3","3","0","0","0","0","0","0","0","0","0","0","0","0","0","0","0","0","3","3","0","0","0","0","0","0","0","0","0","0","-2"
"178721","Park University","2012","Not on tenure/no tenure system, assistant professors","23","10","13","0","0","0","0","0","0","0","0","0","2","1","1","1","0","1","18","8","10","1","0","1","0","0","0","1","1","0","-2"
"178721","Park University","2012","Not on tenure/no tenure system, instructors","7","5","2","0","0","0","0","0","0","1","0","1","0","0","0","0","0","0","6","5","1","0","0","0","0","0","0","0","0","0","-2"
"178721","Park University","2012","Not on tenure/no tenure system, lecturers","7","2","5","1","0","1","1","0","1","1","1","0","1","1","0","0","0","0","3","0","3","0","0","0","0","0","0","0","0","0","-2"
"182564","Western Nevada College","2012","Tenured total","39","23","16","0","0","0","0","0","0","0","0","0","2","2","0","0","0","0","37","21","16","0","0","0","0","0","0","0","0","0","-2"
"182564","Western Nevada College","2012","Tenured, professors","39","23","16","0","0","0","0","0","0","0","0","0","2","2","0","0","0","0","37","21","16","0","0","0","0","0","0","0","0","0","-2"
"182564","Western Nevada College","2012","On-Tenure track total","5","5","0","0","0","0","0","0","0","0","0","0","1","1","0","0","0","0","4","4","0","0","0","0","0","0","0","0","0","0","-2"
"182564","Western Nevada College","2012","On-tenure track, instructors","5","5","0","0","0","0","0","0","0","0","0","0","1","1","0","0","0","0","4","4","0","0","0","0","0","0","0","0","0","0","-2"
"182564","Western Nevada College","2012","Not on tenure track/No tenure system system total","4","3","1","0","0","0","0","0","0","0","0","0","0","0","0","0","0","0","3","2","1","1","1","0","0","0","0","0","0","0","-2"
"182564","Western Nevada College","2012","Not on tenure/no tenure system, instructors","4","3","1","0","0","0","0","0","0","0","0","0","0","0","0","0","0","0","3","2","1","1","1","0","0","0","0","0","0","0","-2"
"183974","Centenary University","2012","Tenured total","9","6","3","0","0","0","1","0","1","0","0","0","0","0","0","0","0","0","8","6","2","0","0","0","0","0","0","0","0","0","-2"
"183974","Centenary University","2012","Tenured, professors","5","3","2","0","0","0","1","0","1","0","0","0","0","0","0","0","0","0","4","3","1","0","0","0","0","0","0","0","0","0","-2"
"183974","Centenary University","2012","Tenured, associate professors","2","1","1","0","0","0","0","0","0","0","0","0","0","0","0","0","0","0","2","1","1","0","0","0","0","0","0","0","0","0","-2"
"183974","Centenary University","2012","Tenured, assistant professors","2","2","0","0","0","0","0","0","0","0","0","0","0","0","0","0","0","0","2","2","0","0","0","0","0","0","0","0","0","0","-2"
"183974","Centenary University","2012","On-Tenure track total","10","6","4","0","0","0","1","1","0","0","0","0","0","0","0","0","0","0","9","5","4","0","0","0","0","0","0","0","0","0","-2"
"183974","Centenary University","2012","On-tenure track, associate professors","2","0","2","0","0","0","0","0","0","0","0","0","0","0","0","0","0","0","2","0","2","0","0","0","0","0","0","0","0","0","-2"
"183974","Centenary University","2012","On-tenure track, assistant professors","8","6","2","0","0","0","1","1","0","0","0","0","0","0","0","0","0","0","7","5","2","0","0","0","0","0","0","0","0","0","-2"
"183974","Centenary University","2012","Not on tenure track/No tenure system system total","54","22","32","0","0","0","1","0","1","3","1","2","0","0","0","0","0","0","50","21","29","0","0","0","0","0","0","0","0","0","-2"
"183974","Centenary University","2012","Not on tenure/no tenure system, professors","2","0","2","0","0","0","0","0","0","0","0","0","0","0","0","0","0","0","2","0","2","0","0","0","0","0","0","0","0","0","-2"
"183974","Centenary University","2012","Not on tenure/no tenure system, associate professors","13","5","8","0","0","0","0","0","0","1","0","1","0","0","0","0","0","0","12","5","7","0","0","0","0","0","0","0","0","0","-2"
"183974","Centenary University","2012","Not on tenure/no tenure system, assistant professors","36","16","20","0","0","0","1","0","1","2","1","1","0","0","0","0","0","0","33","15","18","0","0","0","0","0","0","0","0","0","-2"
"183974","Centenary University","2012","Not on tenure/no tenure system, instructors","3","1","2","0","0","0","0","0","0","0","0","0","0","0","0","0","0","0","3","1","2","0","0","0","0","0","0","0","0","0","-2"
"185828","New Jersey Institute of Technology","2012","Tenured total","234","201","33","1","1","0","58","52","6","11","8","3","5","4","1","0","0","0","158","136","22","0","0","0","0","0","0","1","0","1","-2"
"185828","New Jersey Institute of Technology","2012","Tenured, professors","138","124","14","1","1","0","37","36","1","5","4","1","1","1","0","0","0","0","94","82","12","0","0","0","0","0","0","0","0","0","-2"
"185828","New Jersey Institute of Technology","2012","Tenured, associate professors","96","77","19","0","0","0","21","16","5","6","4","2","4","3","1","0","0","0","64","54","10","0","0","0","0","0","0","1","0","1","-2"
"185828","New Jersey Institute of Technology","2012","On-Tenure track total","43","33","10","0","0","0","11","6","5","0","0","0","1","1","0","0","0","0","20","17","3","1","1","0","0","0","0","10","8","2","-2"
"185828","New Jersey Institute of Technology","2012","On-tenure track, associate professors","3","3","0","0","0","0","0","0","0","0","0","0","0","0","0","0","0","0","3","3","0","0","0","0","0","0","0","0","0","0","-2"
"185828","New Jersey Institute of Technology","2012","On-tenure track, assistant professors","40","30","10","0","0","0","11","6","5","0","0","0","1","1","0","0","0","0","17","14","3","1","1","0","0","0","0","10","8","2","-2"
"185828","New Jersey Institute of Technology","2012","Not on tenure track/No tenure system system total","126","94","32","0","0","0","15","12","3","5","4","1","4","4","0","0","0","0","94","66","28","0","0","0","0","0","0","8","8","0","-2"
"185828","New Jersey Institute of Technology","2012","Not on tenure/no tenure system, lecturers","99","70","29","0","0","0","8","7","1","4","3","1","4","4","0","0","0","0","81","54","27","0","0","0","0","0","0","2","2","0","-2"
"185828","New Jersey Institute of Technology","2012","Not on tenure/no tenure system, no academic rank","27","24","3","0","0","0","7","5","2","1","1","0","0","0","0","0","0","0","13","12","1","0","0","0","0","0","0","6","6","0","-2"
"186201","Ramapo College of New Jersey","2012","Tenured total","146","78","68","0","0","0","10","7","3","12","9","3","9","1","8","0","0","0","115","61","54","0","0","0","0","0","0","0","0","0","-2"
"186201","Ramapo College of New Jersey","2012","Tenured, professors","69","39","30","0","0","0","4","4","0","4","2","2","3","0","3","0","0","0","58","33","25","0","0","0","0","0","0","0","0","0","-2"
"186201","Ramapo College of New Jersey","2012","Tenured, associate professors","61","30","31","0","0","0","6","3","3","5","4","1","5","1","4","0","0","0","45","22","23","0","0","0","0","0","0","0","0","0","-2"
"186201","Ramapo College of New Jersey","2012","Tenured, assistant professors","14","9","5","0","0","0","0","0","0","3","3","0","0","0","0","0","0","0","11","6","5","0","0","0","0","0","0","0","0","0","-2"
"186201","Ramapo College of New Jersey","2012","Tenured, instructors","2","0","2","0","0","0","0","0","0","0","0","0","1","0","1","0","0","0","1","0","1","0","0","0","0","0","0","0","0","0","-2"
"186201","Ramapo College of New Jersey","2012","On-Tenure track total","62","28","34","0","0","0","14","6","8","5","1","4","3","1","2","0","0","0","40","20","20","0","0","0","0","0","0","0","0","0","-2"
"186201","Ramapo College of New Jersey","2012","On-tenure track, associate professors","8","5","3","0","0","0","2","1","1","1","0","1","1","0","1","0","0","0","4","4","0","0","0","0","0","0","0","0","0","0","-2"
"186201","Ramapo College of New Jersey","2012","On-tenure track, assistant professors","54","23","31","0","0","0","12","5","7","4","1","3","2","1","1","0","0","0","36","16","20","0","0","0","0","0","0","0","0","0","-2"
"186201","Ramapo College of New Jersey","2012","Not on tenure track/No tenure system system total","10","5","5","0","0","0","0","0","0","0","0","0","1","0","1","0","0","0","9","5","4","0","0","0","0","0","0","0","0","0","-2"
"186201","Ramapo College of New Jersey","2012","Not on tenure/no tenure system, assistant professors","9","5","4","0","0","0","0","0","0","0","0","0","1","0","1","0","0","0","8","5","3","0","0","0","0","0","0","0","0","0","-2"
"186201","Ramapo College of New Jersey","2012","Not on tenure/no tenure system, instructors","1","0","1","0","0","0","0","0","0","0","0","0","0","0","0","0","0","0","1","0","1","0","0","0","0","0","0","0","0","0","-2"
"186283","Rider University","2012","Tenured total","192","107","85","0","0","0","21","12","9","5","2","3","3","2","1","0","0","0","163","91","72","0","0","0","0","0","0","0","0","0","-2"
"186283","Rider University","2012","Tenured, professors","95","54","41","0","0","0","6","4","2","3","2","1","1","0","1","0","0","0","85","48","37","0","0","0","0","0","0","0","0","0","-2"
"186283","Rider University","2012","Tenured, associate professors","97","53","44","0","0","0","15","8","7","2","0","2","2","2","0","0","0","0","78","43","35","0","0","0","0","0","0","0","0","0","-2"
"186283","Rider University","2012","On-Tenure track total","56","30","26","0","0","0","3","1","2","2","0","2","1","0","1","0","0","0","46","27","19","0","0","0","0","0","0","4","2","2","-2"
"186283","Rider University","2012","On-tenure track, professors","1","1","0","0","0","0","0","0","0","0","0","0","0","0","0","0","0","0","1","1","0","0","0","0","0","0","0","0","0","0","-2"
"186283","Rider University","2012","On-tenure track, associate professors","2","2","0","0","0","0","0","0","0","0","0","0","0","0","0","0","0","0","2","2","0","0","0","0","0","0","0","0","0","0","-2"
"186283","Rider University","2012","On-tenure track, assistant professors","53","27","26","0","0","0","3","1","2","2","0","2","1","0","1","0","0","0","43","24","19","0","0","0","0","0","0","4","2","2","-2"
"186283","Rider University","2012","Not on tenure track/No tenure system system total","5","4","1","0","0","0","0","0","0","1","0","1","0","0","0","0","0","0","4","4","0","0","0","0","0","0","0","0","0","0","-2"
"186283","Rider University","2012","Not on tenure/no tenure system, professors","3","3","0","0","0","0","0","0","0","0","0","0","0","0","0","0","0","0","3","3","0","0","0","0","0","0","0","0","0","0","-2"
"186283","Rider University","2012","Not on tenure/no tenure system, assistant professors","2","1","1","0","0","0","0","0","0","1","0","1","0","0","0","0","0","0","1","1","0","0","0","0","0","0","0","0","0","0","-2"
"186371","Rutgers University-Camden","2012","Tenured total","154","103","51","0","0","0","24","23","1","3","1","2","2","1","1","0","0","0","111","71","40","1","1","0","3","1","2","10","5","5","-2"
"186371","Rutgers University-Camden","2012","Tenured, professors","90","69","21","0","0","0","12","12","0","0","0","0","2","1","1","0","0","0","70","51","19","0","0","0","2","1","1","4","4","0","-2"
"186371","Rutgers University-Camden","2012","Tenured, associate professors","64","34","30","0","0","0","12","11","1","3","1","2","0","0","0","0","0","0","41","20","21","1","1","0","1","0","1","6","1","5","-2"
"186371","Rutgers University-Camden","2012","On-Tenure track total","65","35","30","1","0","1","2","2","0","4","2","2","2","2","0","0","0","0","21","11","10","0","0","0","31","15","16","4","3","1","-2"
"186371","Rutgers University-Camden","2012","On-tenure track, professors","2","1","1","0","0","0","0","0","0","0","0","0","0","0","0","0","0","0","0","0","0","0","0","0","2","1","1","0","0","0","-2"
"186371","Rutgers University-Camden","2012","On-tenure track, associate professors","4","3","1","0","0","0","1","1","0","0","0","0","0","0","0","0","0","0","0","0","0","0","0","0","2","1","1","1","1","0","-2"
"186371","Rutgers University-Camden","2012","On-tenure track, assistant professors","59","31","28","1","0","1","1","1","0","4","2","2","2","2","0","0","0","0","21","11","10","0","0","0","27","13","14","3","2","1","-2"
"186371","Rutgers University-Camden","2012","Not on tenure track/No tenure system system total","54","23","31","0","0","0","3","2","1","0","0","0","2","1","1","0","0","0","37","13","24","0","0","0","11","6","5","1","1","0","-2"
"186371","Rutgers University-Camden","2012","Not on tenure/no tenure system, professors","12","5","7","0","0","0","0","0","0","0","0","0","0","0","0","0","0","0","12","5","7","0","0","0","0","0","0","0","0","0","-2"
"186371","Rutgers University-Camden","2012","Not on tenure/no tenure system, associate professors","8","1","7","0","0","0","0","0","0","0","0","0","1","0","1","0","0","0","7","1","6","0","0","0","0","0","0","0","0","0","-2"
"186371","Rutgers University-Camden","2012","Not on tenure/no tenure system, assistant professors","12","6","6","0","0","0","0","0","0","0","0","0","0","0","0","0","0","0","6","3","3","0","0","0","6","3","3","0","0","0","-2"
"186371","Rutgers University-Camden","2012","Not on tenure/no tenure system, instructors","20","9","11","0","0","0","2","1","1","0","0","0","1","1","0","0","0","0","12","4","8","0","0","0","4","2","2","1","1","0","-2"
"186371","Rutgers University-Camden","2012","Not on tenure/no tenure system, lecturers","2","2","0","0","0","0","1","1","0","0","0","0","0","0","0","0","0","0","0","0","0","0","0","0","1","1","0","0","0","0","-2"
"188429","Adelphi University","2012","Tenured total","198","110","88","0","0","0","16","7","9","11","4","7","5","3","2","0","0","0","166","96","70","0","0","0","0","0","0","0","0","0","-2"
"188429","Adelphi University","2012","Tenured, professors","80","59","21","0","0","0","6","3","3","4","2","2","2","1","1","0","0","0","68","53","15","0","0","0","0","0","0","0","0","0","-2"
"188429","Adelphi University","2012","Tenured, associate professors","115","49","66","0","0","0","10","4","6","7","2","5","3","2","1","0","0","0","95","41","54","0","0","0","0","0","0","0","0","0","-2"
"188429","Adelphi University","2012","Tenured, assistant professors","3","2","1","0","0","0","0","0","0","0","0","0","0","0","0","0","0","0","3","2","1","0","0","0","0","0","0","0","0","0","-2"
"188429","Adelphi University","2012","On-Tenure track total","91","32","59","0","0","0","13","3","10","6","0","6","5","2","3","0","0","0","67","27","40","0","0","0","0","0","0","0","0","0","-2"
"188429","Adelphi University","2012","On-tenure track, associate professors","8","2","6","0","0","0","0","0","0","1","0","1","2","2","0","0","0","0","5","0","5","0","0","0","0","0","0","0","0","0","-2"
"188429","Adelphi University","2012","On-tenure track, assistant professors","83","30","53","0","0","0","13","3","10","5","0","5","3","0","3","0","0","0","62","27","35","0","0","0","0","0","0","0","0","0","-2"
"188429","Adelphi University","2012","Not on tenure track/No tenure system system total","33","11","22","0","0","0","1","1","0","2","1","1","1","0","1","0","0","0","29","9","20","0","0","0","0","0","0","0","0","0","-2"
"188429","Adelphi University","2012","Not on tenure/no tenure system, lecturers","4","3","1","0","0","0","0","0","0","0","0","0","0","0","0","0","0","0","4","3","1","0","0","0","0","0","0","0","0","0","-2"
"188429","Adelphi University","2012","Not on tenure/no tenure system, no academic rank","29","8","21","0","0","0","1","1","0","2","1","1","1","0","1","0","0","0","25","6","19","0","0","0","0","0","0","0","0","0","-2"
"190503","Culinary Institute of America","2012","Not on tenure track/No tenure system system total","151","114","37","0","0","0","5","2","3","3","2","1","5","3","2","1","1","0","128","100","28","1","1","0","8","5","3","0","0","0","-2"
"190503","Culinary Institute of America","2012","Not on tenure/no tenure system, professors","27","21","6","0","0","0","1","0","1","0","0","0","1","0","1","0","0","0","24","20","4","1","1","0","0","0","0","0","0","0","-2"
"190503","Culinary Institute of America","2012","Not on tenure/no tenure system, associate professors","53","38","15","0","0","0","0","0","0","1","0","1","2","2","0","0","0","0","48","36","12","0","0","0","2","0","2","0","0","0","-2"
"190503","Culinary Institute of America","2012","Not on tenure/no tenure system, assistant professors","33","23","10","0","0","0","0","0","0","1","1","0","2","1","1","0","0","0","25","17","8","0","0","0","5","4","1","0","0","0","-2"
"190503","Culinary Institute of America","2012","Not on tenure/no tenure system, instructors","28","24","4","0","0","0","3","2","1","0","0","0","0","0","0","1","1","0","24","21","3","0","0","0","0","0","0","0","0","0","-2"
"190503","Culinary Institute of America","2012","Not on tenure/no tenure system, lecturers","10","8","2","0","0","0","1","0","1","1","1","0","0","0","0","0","0","0","7","6","1","0","0","0","1","1","0","0","0","0","-2"
"190512","CUNY Bernard M Baruch College","2012","Tenured total","342","222","120","0","0","0","45","35","10","21","9","12","16","7","9","0","0","0","253","166","87","0","0","0","0","0","0","7","5","2","-2"
"190512","CUNY Bernard M Baruch College","2012","Tenured, professors","184","127","57","0","0","0","24","18","6","5","3","2","10","4","6","0","0","0","144","101","43","0","0","0","0","0","0","1","1","0","-2"
"190512","CUNY Bernard M Baruch College","2012","Tenured, associate professors","134","81","53","0","0","0","19","16","3","12","5","7","5","2","3","0","0","0","92","54","38","0","0","0","0","0","0","6","4","2","-2"
"190512","CUNY Bernard M Baruch College","2012","Tenured, assistant professors","4","3","1","0","0","0","0","0","0","0","0","0","0","0","0","0","0","0","4","3","1","0","0","0","0","0","0","0","0","0","-2"
"190512","CUNY Bernard M Baruch College","2012","Tenured, lecturers","20","11","9","0","0","0","2","1","1","4","1","3","1","1","0","0","0","0","13","8","5","0","0","0","0","0","0","0","0","0","-2"
"190512","CUNY Bernard M Baruch College","2012","On-Tenure track total","100","53","47","0","0","0","15","7","8","2","0","2","5","1","4","0","0","0","52","29","23","0","0","0","0","0","0","26","16","10","-2"
"190512","CUNY Bernard M Baruch College","2012","On-tenure track, professors","1","1","0","0","0","0","0","0","0","0","0","0","0","0","0","0","0","0","1","1","0","0","0","0","0","0","0","0","0","0","-2"
"190512","CUNY Bernard M Baruch College","2012","On-tenure track, associate professors","4","3","1","0","0","0","1","0","1","0","0","0","0","0","0","0","0","0","0","0","0","0","0","0","0","0","0","3","3","0","-2"
"190512","CUNY Bernard M Baruch College","2012","On-tenure track, assistant professors","74","39","35","0","0","0","10","5","5","1","0","1","2","1","1","0","0","0","38","20","18","0","0","0","0","0","0","23","13","10","-2"
"190512","CUNY Bernard M Baruch College","2012","On-tenure track, lecturers","21","10","11","0","0","0","4","2","2","1","0","1","3","0","3","0","0","0","13","8","5","0","0","0","0","0","0","0","0","0","-2"
"190512","CUNY Bernard M Baruch College","2012","Not on tenure track/No tenure system system total","30","18","12","0","0","0","0","0","0","4","1","3","1","0","1","0","0","0","23","16","7","0","0","0","0","0","0","2","1","1","-2"
"190512","CUNY Bernard M Baruch College","2012","Not on tenure/no tenure system, professors","10","6","4","0","0","0","0","0","0","2","0","2","0","0","0","0","0","0","8","6","2","0","0","0","0","0","0","0","0","0","-2"
"190512","CUNY Bernard M Baruch College","2012","Not on tenure/no tenure system, associate professors","3","1","2","0","0","0","0","0","0","1","0","1","0","0","0","0","0","0","2","1","1","0","0","0","0","0","0","0","0","0","-2"
"190512","CUNY Bernard M Baruch College","2012","Not on tenure/no tenure system, assistant professors","6","6","0","0","0","0","0","0","0","0","0","0","0","0","0","0","0","0","5","5","0","0","0","0","0","0","0","1","1","0","-2"
"190512","CUNY Bernard M Baruch College","2012","Not on tenure/no tenure system, instructors","3","1","2","0","0","0","0","0","0","0","0","0","0","0","0","0","0","0","3","1","2","0","0","0","0","0","0","0","0","0","-2"
"190512","CUNY Bernard M Baruch College","2012","Not on tenure/no tenure system, lecturers","8","4","4","0","0","0","0","0","0","1","1","0","1","0","1","0","0","0","5","3","2","0","0","0","0","0","0","1","0","1","-2"
"190549","CUNY Brooklyn College","2012","Tenured total","371","225","146","1","0","1","31","22","9","22","15","7","23","10","13","0","0","0","286","171","115","1","1","0","0","0","0","7","6","1","-2"
"190549","CUNY Brooklyn College","2012","Tenured, professors","200","133","67","0","0","0","12","11","1","9","6","3","9","5","4","0","0","0","168","109","59","1","1","0","0","0","0","1","1","0","-2"
"190549","CUNY Brooklyn College","2012","Tenured, associate professors","133","71","62","1","0","1","14","9","5","8","6","2","10","3","7","0","0","0","95","49","46","0","0","0","0","0","0","5","4","1","-2"
"190549","CUNY Brooklyn College","2012","Tenured, assistant professors","26","11","15","0","0","0","5","2","3","3","1","2","2","0","2","0","0","0","15","7","8","0","0","0","0","0","0","1","1","0","-2"
"190549","CUNY Brooklyn College","2012","Tenured, lecturers","12","10","2","0","0","0","0","0","0","2","2","0","2","2","0","0","0","0","8","6","2","0","0","0","0","0","0","0","0","0","-2"
"190549","CUNY Brooklyn College","2012","On-Tenure track total","136","58","78","0","0","0","17","6","11","13","8","5","6","2","4","1","1","0","89","38","51","0","0","0","0","0","0","10","3","7","-2"
"190549","CUNY Brooklyn College","2012","On-tenure track, associate professors","11","10","1","0","0","0","1","1","0","1","1","0","0","0","0","0","0","0","9","8","1","0","0","0","0","0","0","0","0","0","-2"
"190549","CUNY Brooklyn College","2012","On-tenure track, assistant professors","105","39","66","0","0","0","15","5","10","12","7","5","6","2","4","1","1","0","61","21","40","0","0","0","0","0","0","10","3","7","-2"
"190549","CUNY Brooklyn College","2012","On-tenure track, lecturers","20","9","11","0","0","0","1","0","1","0","0","0","0","0","0","0","0","0","19","9","10","0","0","0","0","0","0","0","0","0","-2"
"190549","CUNY Brooklyn College","2012","Not on tenure track/No tenure system system total","36","15","21","0","0","0","2","0","2","2","1","1","5","2","3","0","0","0","26","11","15","0","0","0","0","0","0","1","1","0","-2"
"190549","CUNY Brooklyn College","2012","Not on tenure/no tenure system, professors","6","3","3","0","0","0","0","0","0","0","0","0","1","0","1","0","0","0","5","3","2","0","0","0","0","0","0","0","0","0","-2"
"190549","CUNY Brooklyn College","2012","Not on tenure/no tenure system, associate professors","1","1","0","0","0","0","0","0","0","0","0","0","0","0","0","0","0","0","1","1","0","0","0","0","0","0","0","0","0","0","-2"
"190549","CUNY Brooklyn College","2012","Not on tenure/no tenure system, assistant professors","14","7","7","0","0","0","0","0","0","1","1","0","2","1","1","0","0","0","10","4","6","0","0","0","0","0","0","1","1","0","-2"
"190549","CUNY Brooklyn College","2012","Not on tenure/no tenure system, instructors","9","2","7","0","0","0","1","0","1","1","0","1","1","1","0","0","0","0","6","1","5","0","0","0","0","0","0","0","0","0","-2"
"190549","CUNY Brooklyn College","2012","Not on tenure/no tenure system, lecturers","6","2","4","0","0","0","1","0","1","0","0","0","1","0","1","0","0","0","4","2","2","0","0","0","0","0","0","0","0","0","-2"
"190646","CUNY Medgar Evers College","2012","Tenured total","101","58","43","0","0","0","13","8","5","64","36","28","3","2","1","0","0","0","21","12","9","0","0","0","0","0","0","0","0","0","-2"
"190646","CUNY Medgar Evers College","2012","Tenured, professors","49","32","17","0","0","0","11","8","3","25","16","9","1","1","0","0","0","0","12","7","5","0","0","0","0","0","0","0","0","0","-2"
"190646","CUNY Medgar Evers College","2012","Tenured, associate professors","17","8","9","0","0","0","2","0","2","9","5","4","2","1","1","0","0","0","4","2","2","0","0","0","0","0","0","0","0","0","-2"
"190646","CUNY Medgar Evers College","2012","Tenured, assistant professors","16","5","11","0","0","0","0","0","0","11","2","9","0","0","0","0","0","0","5","3","2","0","0","0","0","0","0","0","0","0","-2"
"190646","CUNY Medgar Evers College","2012","Tenured, lecturers","19","13","6","0","0","0","0","0","0","19","13","6","0","0","0","0","0","0","0","0","0","0","0","0","0","0","0","0","0","0","-2"
"190646","CUNY Medgar Evers College","2012","On-Tenure track total","55","25","30","1","0","1","4","1","3","33","16","17","3","1","2","0","0","0","10","7","3","0","0","0","0","0","0","4","0","4","-2"
"190646","CUNY Medgar Evers College","2012","On-tenure track, professors","1","1","0","0","0","0","0","0","0","1","1","0","0","0","0","0","0","0","0","0","0","0","0","0","0","0","0","0","0","0","-2"
"190646","CUNY Medgar Evers College","2012","On-tenure track, associate professors","6","3","3","0","0","0","1","0","1","3","3","0","1","0","1","0","0","0","1","0","1","0","0","0","0","0","0","0","0","0","-2"
"190646","CUNY Medgar Evers College","2012","On-tenure track, assistant professors","37","15","22","1","0","1","1","1","0","23","7","16","1","1","0","0","0","0","8","6","2","0","0","0","0","0","0","3","0","3","-2"
"190646","CUNY Medgar Evers College","2012","On-tenure track, lecturers","11","6","5","0","0","0","2","0","2","6","5","1","1","0","1","0","0","0","1","1","0","0","0","0","0","0","0","1","0","1","-2"
"190646","CUNY Medgar Evers College","2012","Not on tenure track/No tenure system system total","12","8","4","0","0","0","1","1","0","9","6","3","1","1","0","0","0","0","1","0","1","0","0","0","0","0","0","0","0","0","-2"
"190646","CUNY Medgar Evers College","2012","Not on tenure/no tenure system, professors","5","3","2","0","0","0","1","1","0","3","2","1","0","0","0","0","0","0","1","0","1","0","0","0","0","0","0","0","0","0","-2"
"190646","CUNY Medgar Evers College","2012","Not on tenure/no tenure system, assistant professors","2","2","0","0","0","0","0","0","0","1","1","0","1","1","0","0","0","0","0","0","0","0","0","0","0","0","0","0","0","0","-2"
"190646","CUNY Medgar Evers College","2012","Not on tenure/no tenure system, instructors","4","2","2","0","0","0","0","0","0","4","2","2","0","0","0","0","0","0","0","0","0","0","0","0","0","0","0","0","0","0","-2"
"190646","CUNY Medgar Evers College","2012","Not on tenure/no tenure system, lecturers","1","1","0","0","0","0","0","0","0","1","1","0","0","0","0","0","0","0","0","0","0","0","0","0","0","0","0","0","0","0","-2"
"191126","Fashion Institute of Technology","2012","Tenured total","217","103","114","0","0","0","11","9","2","14","8","6","11","4","7","0","0","0","170","76","94","0","0","0","11","6","5","0","0","0","-2"
"191126","Fashion Institute of Technology","2012","Tenured, professors","43","19","24","0","0","0","1","1","0","1","0","1","1","1","0","0","0","0","35","15","20","0","0","0","5","2","3","0","0","0","-2"
"191126","Fashion Institute of Technology","2012","Tenured, associate professors","52","23","29","0","0","0","4","2","2","2","1","1","3","1","2","0","0","0","43","19","24","0","0","0","0","0","0","0","0","0","-2"
"191126","Fashion Institute of Technology","2012","Tenured, assistant professors","119","59","60","0","0","0","6","6","0","11","7","4","7","2","5","0","0","0","89","40","49","0","0","0","6","4","2","0","0","0","-2"
"191126","Fashion Institute of Technology","2012","Tenured, instructors","3","2","1","0","0","0","0","0","0","0","0","0","0","0","0","0","0","0","3","2","1","0","0","0","0","0","0","0","0","0","-2"
"191126","Fashion Institute of Technology","2012","On-Tenure track total","19","5","14","0","0","0","2","1","1","0","0","0","1","0","1","0","0","0","13","3","10","0","0","0","3","1","2","0","0","0","-2"
"191126","Fashion Institute of Technology","2012","On-tenure track, associate professors","3","2","1","0","0","0","1","1","0","0","0","0","0","0","0","0","0","0","2","1","1","0","0","0","0","0","0","0","0","0","-2"
"191126","Fashion Institute of Technology","2012","On-tenure track, assistant professors","11","3","8","0","0","0","1","0","1","0","0","0","0","0","0","0","0","0","8","2","6","0","0","0","2","1","1","0","0","0","-2"
"191126","Fashion Institute of Technology","2012","On-tenure track, instructors","5","0","5","0","0","0","0","0","0","0","0","0","1","0","1","0","0","0","3","0","3","0","0","0","1","0","1","0","0","0","-2"
"191241","Fordham University","2012","Tenured total","416","271","145","0","0","0","35","23","12","12","8","4","21","15","6","0","0","0","346","224","122","0","0","0","0","0","0","2","1","1","-2"
"191241","Fordham University","2012","Tenured, professors","210","147","63","0","0","0","14","11","3","5","4","1","8","4","4","0","0","0","182","127","55","0","0","0","0","0","0","1","1","0","-2"
"191241","Fordham University","2012","Tenured, associate professors","187","106","81","0","0","0","18","9","9","7","4","3","12","10","2","0","0","0","149","83","66","0","0","0","0","0","0","1","0","1","-2"
"191241","Fordham University","2012","Tenured, assistant professors","19","18","1","0","0","0","3","3","0","0","0","0","1","1","0","0","0","0","15","14","1","0","0","0","0","0","0","0","0","0","-2"
"191241","Fordham University","2012","On-Tenure track total","166","80","86","0","0","0","28","11","17","10","7","3","9","3","6","0","0","0","111","55","56","0","0","0","1","0","1","7","4","3","-2"
"191241","Fordham University","2012","On-tenure track, associate professors","23","16","7","0","0","0","4","4","0","3","3","0","2","1","1","0","0","0","13","8","5","0","0","0","1","0","1","0","0","0","-2"
"191241","Fordham University","2012","On-tenure track, assistant professors","141","62","79","0","0","0","23","6","17","7","4","3","7","2","5","0","0","0","97","46","51","0","0","0","0","0","0","7","4","3","-2"
"191241","Fordham University","2012","On-tenure track, instructors","2","2","0","0","0","0","1","1","0","0","0","0","0","0","0","0","0","0","1","1","0","0","0","0","0","0","0","0","0","0","-2"
"191931","Iona College","2012","Tenured total","113","77","36","0","0","0","7","4","3","4","1","3","2","0","2","0","0","0","99","71","28","0","0","0","0","0","0","1","1","0","-2"
"191931","Iona College","2012","Tenured, professors","50","37","13","0","0","0","1","1","0","2","0","2","0","0","0","0","0","0","47","36","11","0","0","0","0","0","0","0","0","0","-2"
"191931","Iona College","2012","Tenured, associate professors","59","37","22","0","0","0","6","3","3","2","1","1","2","0","2","0","0","0","48","32","16","0","0","0","0","0","0","1","1","0","-2"
"191931","Iona College","2012","Tenured, assistant professors","4","3","1","0","0","0","0","0","0","0","0","0","0","0","0","0","0","0","4","3","1","0","0","0","0","0","0","0","0","0","-2"
"191931","Iona College","2012","On-Tenure track total","43","19","24","0","0","0","6","3","3","3","1","2","0","0","0","0","0","0","31","14","17","0","0","0","0","0","0","3","1","2","-2"
"191931","Iona College","2012","On-tenure track, associate professors","6","3","3","0","0","0","1","0","1","1","1","0","0","0","0","0","0","0","3","2","1","0","0","0","0","0","0","1","0","1","-2"
"191931","Iona College","2012","On-tenure track, assistant professors","37","16","21","0","0","0","5","3","2","2","0","2","0","0","0","0","0","0","28","12","16","0","0","0","0","0","0","2","1","1","-2"
"191931","Iona College","2012","Not on tenure track/No tenure system system total","23","13","10","0","0","0","1","0","1","0","0","0","1","1","0","0","0","0","20","12","8","0","0","0","1","0","1","0","0","0","-2"
"191931","Iona College","2012","Not on tenure/no tenure system, instructors","2","1","1","0","0","0","0","0","0","0","0","0","0","0","0","0","0","0","2","1","1","0","0","0","0","0","0","0","0","0","-2"
"191931","Iona College","2012","Not on tenure/no tenure system, lecturers","9","6","3","0","0","0","0","0","0","0","0","0","0","0","0","0","0","0","9","6","3","0","0","0","0","0","0","0","0","0","-2"
"191931","Iona College","2012","Not on tenure/no tenure system, no academic rank","12","6","6","0","0","0","1","0","1","0","0","0","1","1","0","0","0","0","9","5","4","0","0","0","1","0","1","0","0","0","-2"
"192864","Marymount Manhattan College","2012","Tenured total","57","25","32","0","0","0","4","2","2","1","0","1","1","1","0","0","0","0","50","22","28","0","0","0","1","0","1","0","0","0","-2"
"192864","Marymount Manhattan College","2012","Tenured, professors","18","10","8","0","0","0","1","0","1","0","0","0","0","0","0","0","0","0","17","10","7","0","0","0","0","0","0","0","0","0","-2"
"192864","Marymount Manhattan College","2012","Tenured, associate professors","39","15","24","0","0","0","3","2","1","1","0","1","1","1","0","0","0","0","33","12","21","0","0","0","1","0","1","0","0","0","-2"
"192864","Marymount Manhattan College","2012","On-Tenure track total","31","8","23","0","0","0","1","0","1","2","2","0","1","0","1","0","0","0","11","5","6","0","0","0","16","1","15","0","0","0","-2"
"192864","Marymount Manhattan College","2012","On-tenure track, assistant professors","31","8","23","0","0","0","1","0","1","2","2","0","1","0","1","0","0","0","11","5","6","0","0","0","16","1","15","0","0","0","-2"
"192864","Marymount Manhattan College","2012","Not on tenure track/No tenure system system total","10","5","5","0","0","0","1","1","0","0","0","0","0","0","0","0","0","0","4","2","2","0","0","0","5","2","3","0","0","0","-2"
"192864","Marymount Manhattan College","2012","Not on tenure/no tenure system, assistant professors","6","4","2","0","0","0","1","1","0","0","0","0","0","0","0","0","0","0","1","1","0","0","0","0","4","2","2","0","0","0","-2"
"192864","Marymount Manhattan College","2012","Not on tenure/no tenure system, instructors","4","1","3","0","0","0","0","0","0","0","0","0","0","0","0","0","0","0","3","1","2","0","0","0","1","0","1","0","0","0","-2"
"193292","Molloy College","2012","Tenured total","121","32","89","0","0","0","4","1","3","7","0","7","3","1","2","0","0","0","106","30","76","1","0","1","0","0","0","0","0","0","-2"
"193292","Molloy College","2012","Tenured, professors","37","9","28","0","0","0","0","0","0","1","0","1","2","1","1","0","0","0","34","8","26","0","0","0","0","0","0","0","0","0","-2"
"193292","Molloy College","2012","Tenured, associate professors","42","16","26","0","0","0","1","0","1","3","0","3","1","0","1","0","0","0","37","16","21","0","0","0","0","0","0","0","0","0","-2"
"193292","Molloy College","2012","Tenured, assistant professors","42","7","35","0","0","0","3","1","2","3","0","3","0","0","0","0","0","0","35","6","29","1","0","1","0","0","0","0","0","0","-2"
"193292","Molloy College","2012","On-Tenure track total","57","11","46","0","0","0","4","0","4","5","0","5","3","1","2","0","0","0","44","9","35","1","1","0","0","0","0","0","0","0","-2"
"193292","Molloy College","2012","On-tenure track, professors","3","1","2","0","0","0","0","0","0","0","0","0","0","0","0","0","0","0","3","1","2","0","0","0","0","0","0","0","0","0","-2"
"193292","Molloy College","2012","On-tenure track, associate professors","9","1","8","0","0","0","0","0","0","1","0","1","1","0","1","0","0","0","7","1","6","0","0","0","0","0","0","0","0","0","-2"
"193292","Molloy College","2012","On-tenure track, assistant professors","33","6","27","0","0","0","4","0","4","3","0","3","2","1","1","0","0","0","23","4","19","1","1","0","0","0","0","0","0","0","-2"
"193292","Molloy College","2012","On-tenure track, instructors","12","3","9","0","0","0","0","0","0","1","0","1","0","0","0","0","0","0","11","3","8","0","0","0","0","0","0","0","0","0","-2"
"193292","Molloy College","2012","Not on tenure track/No tenure system system total","1","0","1","0","0","0","0","0","0","0","0","0","0","0","0","0","0","0","1","0","1","0","0","0","0","0","0","0","0","0","-2"
"193292","Molloy College","2012","Not on tenure/no tenure system, no academic rank","1","0","1","0","0","0","0","0","0","0","0","0","0","0","0","0","0","0","1","0","1","0","0","0","0","0","0","0","0","0","-2"
"196024","SUNY College of Technology at Delhi","2012","Tenured total","60","40","20","0","0","0","1","0","1","2","0","2","1","1","0","0","0","0","56","39","17","0","0","0","0","0","0","0","0","0","-2"
"196024","SUNY College of Technology at Delhi","2012","Tenured, professors","26","17","9","0","0","0","0","0","0","0","0","0","0","0","0","0","0","0","26","17","9","0","0","0","0","0","0","0","0","0","-2"
"196024","SUNY College of Technology at Delhi","2012","Tenured, associate professors","17","12","5","0","0","0","0","0","0","0","0","0","1","1","0","0","0","0","16","11","5","0","0","0","0","0","0","0","0","0","-2"
"196024","SUNY College of Technology at Delhi","2012","Tenured, assistant professors","12","7","5","0","0","0","1","0","1","2","0","2","0","0","0","0","0","0","9","7","2","0","0","0","0","0","0","0","0","0","-2"
"196024","SUNY College of Technology at Delhi","2012","Tenured, instructors","5","4","1","0","0","0","0","0","0","0","0","0","0","0","0","0","0","0","5","4","1","0","0","0","0","0","0","0","0","0","-2"
"196024","SUNY College of Technology at Delhi","2012","On-Tenure track total","63","32","31","0","0","0","4","3","1","2","1","1","0","0","0","0","0","0","57","28","29","0","0","0","0","0","0","0","0","0","-2"
"196024","SUNY College of Technology at Delhi","2012","On-tenure track, associate professors","6","3","3","0","0","0","1","1","0","1","1","0","0","0","0","0","0","0","4","1","3","0","0","0","0","0","0","0","0","0","-2"
"196024","SUNY College of Technology at Delhi","2012","On-tenure track, assistant professors","38","19","19","0","0","0","3","2","1","1","0","1","0","0","0","0","0","0","34","17","17","0","0","0","0","0","0","0","0","0","-2"
"196024","SUNY College of Technology at Delhi","2012","On-tenure track, instructors","19","10","9","0","0","0","0","0","0","0","0","0","0","0","0","0","0","0","19","10","9","0","0","0","0","0","0","0","0","0","-2"
"196024","SUNY College of Technology at Delhi","2012","Not on tenure track/No tenure system system total","5","3","2","0","0","0","1","1","0","0","0","0","0","0","0","0","0","0","4","2","2","0","0","0","0","0","0","0","0","0","-2"
"196024","SUNY College of Technology at Delhi","2012","Not on tenure/no tenure system, instructors","5","3","2","0","0","0","1","1","0","0","0","0","0","0","0","0","0","0","4","2","2","0","0","0","0","0","0","0","0","0","-2"
"196042","Farmingdale State College","2012","Tenured total","102","60","42","0","0","0","5","3","2","1","1","0","4","1","3","0","0","0","92","55","37","0","0","0","0","0","0","0","0","0","-2"
"196042","Farmingdale State College","2012","Tenured, professors","67","42","25","0","0","0","4","3","1","1","1","0","3","1","2","0","0","0","59","37","22","0","0","0","0","0","0","0","0","0","-2"
"196042","Farmingdale State College","2012","Tenured, associate professors","28","13","15","0","0","0","1","0","1","0","0","0","1","0","1","0","0","0","26","13","13","0","0","0","0","0","0","0","0","0","-2"
"196042","Farmingdale State College","2012","Tenured, assistant professors","7","5","2","0","0","0","0","0","0","0","0","0","0","0","0","0","0","0","7","5","2","0","0","0","0","0","0","0","0","0","-2"
"196042","Farmingdale State College","2012","On-Tenure track total","71","36","35","0","0","0","10","9","1","7","2","5","4","4","0","0","0","0","47","19","28","0","0","0","0","0","0","3","2","1","-2"
"196042","Farmingdale State College","2012","On-tenure track, professors","1","1","0","0","0","0","0","0","0","0","0","0","0","0","0","0","0","0","1","1","0","0","0","0","0","0","0","0","0","0","-2"
"196042","Farmingdale State College","2012","On-tenure track, associate professors","12","4","8","0","0","0","1","1","0","0","0","0","0","0","0","0","0","0","10","2","8","0","0","0","0","0","0","1","1","0","-2"
"196042","Farmingdale State College","2012","On-tenure track, assistant professors","58","31","27","0","0","0","9","8","1","7","2","5","4","4","0","0","0","0","36","16","20","0","0","0","0","0","0","2","1","1","-2"
"196042","Farmingdale State College","2012","Not on tenure track/No tenure system system total","28","17","11","0","0","0","2","2","0","3","2","1","0","0","0","0","0","0","23","13","10","0","0","0","0","0","0","0","0","0","-2"
"196042","Farmingdale State College","2012","Not on tenure/no tenure system, associate professors","2","2","0","0","0","0","0","0","0","0","0","0","0","0","0","0","0","0","2","2","0","0","0","0","0","0","0","0","0","0","-2"
"196042","Farmingdale State College","2012","Not on tenure/no tenure system, assistant professors","19","11","8","0","0","0","1","1","0","1","1","0","0","0","0","0","0","0","17","9","8","0","0","0","0","0","0","0","0","0","-2"
"196042","Farmingdale State College","2012","Not on tenure/no tenure system, lecturers","7","4","3","0","0","0","1","1","0","2","1","1","0","0","0","0","0","0","4","2","2","0","0","0","0","0","0","0","0","0","-2"
"196176","State University of New York at New Paltz","2012","Tenured total","165","89","76","0","0","0","17","11","6","8","7","1","6","2","4","0","0","0","134","69","65","0","0","0","0","0","0","0","0","0","-2"
"196176","State University of New York at New Paltz","2012","Tenured, professors","54","31","23","0","0","0","7","5","2","3","2","1","2","1","1","0","0","0","42","23","19","0","0","0","0","0","0","0","0","0","-2"
"196176","State University of New York at New Paltz","2012","Tenured, associate professors","101","53","48","0","0","0","10","6","4","4","4","0","4","1","3","0","0","0","83","42","41","0","0","0","0","0","0","0","0","0","-2"
"196176","State University of New York at New Paltz","2012","Tenured, assistant professors","8","5","3","0","0","0","0","0","0","1","1","0","0","0","0","0","0","0","7","4","3","0","0","0","0","0","0","0","0","0","-2"
"196176","State University of New York at New Paltz","2012","Tenured, instructors","2","0","2","0","0","0","0","0","0","0","0","0","0","0","0","0","0","0","2","0","2","0","0","0","0","0","0","0","0","0","-2"
"196176","State University of New York at New Paltz","2012","On-Tenure track total","111","48","63","0","0","0","5","5","0","4","3","1","7","4","3","0","0","0","83","32","51","2","0","2","0","0","0","10","4","6","-2"
"196176","State University of New York at New Paltz","2012","On-tenure track, associate professors","15","8","7","0","0","0","1","1","0","0","0","0","2","2","0","0","0","0","12","5","7","0","0","0","0","0","0","0","0","0","-2"
"196176","State University of New York at New Paltz","2012","On-tenure track, assistant professors","92","40","52","0","0","0","4","4","0","4","3","1","4","2","2","0","0","0","68","27","41","2","0","2","0","0","0","10","4","6","-2"
"196176","State University of New York at New Paltz","2012","On-tenure track, instructors","4","0","4","0","0","0","0","0","0","0","0","0","1","0","1","0","0","0","3","0","3","0","0","0","0","0","0","0","0","0","-2"
"196176","State University of New York at New Paltz","2012","Not on tenure track/No tenure system system total","61","29","32","0","0","0","3","1","2","0","0","0","2","0","2","0","0","0","52","26","26","0","0","0","0","0","0","4","2","2","-2"
"196176","State University of New York at New Paltz","2012","Not on tenure/no tenure system, assistant professors","2","1","1","0","0","0","0","0","0","0","0","0","0","0","0","0","0","0","2","1","1","0","0","0","0","0","0","0","0","0","-2"
"196176","State University of New York at New Paltz","2012","Not on tenure/no tenure system, lecturers","59","28","31","0","0","0","3","1","2","0","0","0","2","0","2","0","0","0","50","25","25","0","0","0","0","0","0","4","2","2","-2"
"197230","Wells College","2012","Tenured total","29","14","15","1","1","0","0","0","0","1","1","0","2","1","1","2","1","1","23","10","13","0","0","0","0","0","0","0","0","0","-2"
"197230","Wells College","2012","Tenured, professors","16","10","6","1","1","0","0","0","0","1","1","0","2","1","1","1","1","0","11","6","5","0","0","0","0","0","0","0","0","0","-2"
"197230","Wells College","2012","Tenured, associate professors","13","4","9","0","0","0","0","0","0","0","0","0","0","0","0","1","0","1","12","4","8","0","0","0","0","0","0","0","0","0","-2"
"197230","Wells College","2012","On-Tenure track total","7","2","5","0","0","0","1","0","1","0","0","0","1","1","0","0","0","0","5","1","4","0","0","0","0","0","0","0","0","0","-2"
"197230","Wells College","2012","On-tenure track, assistant professors","7","2","5","0","0","0","1","0","1","0","0","0","1","1","0","0","0","0","5","1","4","0","0","0","0","0","0","0","0","0","-2"
"197230","Wells College","2012","Not on tenure track/No tenure system system total","3","2","1","0","0","0","0","0","0","0","0","0","0","0","0","0","0","0","3","2","1","0","0","0","0","0","0","0","0","0","-2"
"197230","Wells College","2012","Not on tenure/no tenure system, assistant professors","2","1","1","0","0","0","0","0","0","0","0","0","0","0","0","0","0","0","2","1","1","0","0","0","0","0","0","0","0","0","-2"
"197230","Wells College","2012","Not on tenure/no tenure system, lecturers","1","1","0","0","0","0","0","0","0","0","0","0","0","0","0","0","0","0","1","1","0","0","0","0","0","0","0","0","0","0","-2"
"199607","Salem College","2012","Tenured total","20","6","14","0","0","0","1","1","0","0","0","0","0","0","0","0","0","0","19","5","14","0","0","0","0","0","0","0","0","0","-2"
"199607","Salem College","2012","Tenured, professors","3","1","2","0","0","0","0","0","0","0","0","0","0","0","0","0","0","0","3","1","2","0","0","0","0","0","0","0","0","0","-2"
"199607","Salem College","2012","Tenured, associate professors","16","4","12","0","0","0","1","1","0","0","0","0","0","0","0","0","0","0","15","3","12","0","0","0","0","0","0","0","0","0","-2"
"199607","Salem College","2012","Tenured, assistant professors","1","1","0","0","0","0","0","0","0","0","0","0","0","0","0","0","0","0","1","1","0","0","0","0","0","0","0","0","0","0","-2"
"199607","Salem College","2012","On-Tenure track total","12","3","9","0","0","0","0","0","0","3","0","3","3","0","3","0","0","0","6","3","3","0","0","0","0","0","0","0","0","0","-2"
"199607","Salem College","2012","On-tenure track, associate professors","1","0","1","0","0","0","0","0","0","0","0","0","0","0","0","0","0","0","1","0","1","0","0","0","0","0","0","0","0","0","-2"
"199607","Salem College","2012","On-tenure track, assistant professors","11","3","8","0","0","0","0","0","0","3","0","3","3","0","3","0","0","0","5","3","2","0","0","0","0","0","0","0","0","0","-2"
"199607","Salem College","2012","Not on tenure track/No tenure system system total","27","9","18","0","0","0","1","0","1","2","0","2","0","0","0","0","0","0","24","9","15","0","0","0","0","0","0","0","0","0","-2"
"199607","Salem College","2012","Not on tenure/no tenure system, professors","1","1","0","0","0","0","0","0","0","0","0","0","0","0","0","0","0","0","1","1","0","0","0","0","0","0","0","0","0","0","-2"
"199607","Salem College","2012","Not on tenure/no tenure system, associate professors","3","1","2","0","0","0","0","0","0","0","0","0","0","0","0","0","0","0","3","1","2","0","0","0","0","0","0","0","0","0","-2"
"199607","Salem College","2012","Not on tenure/no tenure system, assistant professors","17","5","12","0","0","0","1","0","1","0","0","0","0","0","0","0","0","0","16","5","11","0","0","0","0","0","0","0","0","0","-2"
"199607","Salem College","2012","Not on tenure/no tenure system, instructors","4","0","4","0","0","0","0","0","0","2","0","2","0","0","0","0","0","0","2","0","2","0","0","0","0","0","0","0","0","0","-2"
"199607","Salem College","2012","Not on tenure/no tenure system, no academic rank","2","2","0","0","0","0","0","0","0","0","0","0","0","0","0","0","0","0","2","2","0","0","0","0","0","0","0","0","0","0","-2"
"207397","Oklahoma State University-Oklahoma City","2012","Tenured total","45","20","25","1","0","1","0","0","0","1","0","1","1","1","0","0","0","0","42","19","23","0","0","0","0","0","0","0","0","0","-2"
"207397","Oklahoma State University-Oklahoma City","2012","Tenured, professors","6","3","3","0","0","0","0","0","0","0","0","0","1","1","0","0","0","0","5","2","3","0","0","0","0","0","0","0","0","0","-2"
"207397","Oklahoma State University-Oklahoma City","2012","Tenured, associate professors","38","16","22","1","0","1","0","0","0","1","0","1","0","0","0","0","0","0","36","16","20","0","0","0","0","0","0","0","0","0","-2"
"207397","Oklahoma State University-Oklahoma City","2012","Tenured, instructors","1","1","0","0","0","0","0","0","0","0","0","0","0","0","0","0","0","0","1","1","0","0","0","0","0","0","0","0","0","0","-2"
"207397","Oklahoma State University-Oklahoma City","2012","On-Tenure track total","40","17","23","1","0","1","1","0","1","2","2","0","2","1","1","0","0","0","33","13","20","0","0","0","0","0","0","1","1","0","-2"
"207397","Oklahoma State University-Oklahoma City","2012","On-tenure track, associate professors","1","0","1","0","0","0","0","0","0","0","0","0","0","0","0","0","0","0","1","0","1","0","0","0","0","0","0","0","0","0","-2"
"207397","Oklahoma State University-Oklahoma City","2012","On-tenure track, assistant professors","18","10","8","1","0","1","0","0","0","1","1","0","2","1","1","0","0","0","13","7","6","0","0","0","0","0","0","1","1","0","-2"
"207397","Oklahoma State University-Oklahoma City","2012","On-tenure track, instructors","21","7","14","0","0","0","1","0","1","1","1","0","0","0","0","0","0","0","19","6","13","0","0","0","0","0","0","0","0","0","-2"
"209287","Multnomah University","2012","Tenured total","4","4","0","0","0","0","1","1","0","0","0","0","0","0","0","0","0","0","3","3","0","0","0","0","0","0","0","0","0","0","-2"
"209287","Multnomah University","2012","Tenured, professors","4","4","0","0","0","0","1","1","0","0","0","0","0","0","0","0","0","0","3","3","0","0","0","0","0","0","0","0","0","0","-2"
"209287","Multnomah University","2012","Not on tenure track/No tenure system system total","27","20","7","0","0","0","2","1","1","0","0","0","0","0","0","0","0","0","24","18","6","1","1","0","0","0","0","0","0","0","-2"
"209287","Multnomah University","2012","Not on tenure/no tenure system, professors","5","5","0","0","0","0","0","0","0","0","0","0","0","0","0","0","0","0","5","5","0","0","0","0","0","0","0","0","0","0","-2"
"209287","Multnomah University","2012","Not on tenure/no tenure system, associate professors","4","3","1","0","0","0","1","1","0","0","0","0","0","0","0","0","0","0","3","2","1","0","0","0","0","0","0","0","0","0","-2"
"209287","Multnomah University","2012","Not on tenure/no tenure system, assistant professors","17","11","6","0","0","0","1","0","1","0","0","0","0","0","0","0","0","0","15","10","5","1","1","0","0","0","0","0","0","0","-2"
"209287","Multnomah University","2012","Not on tenure/no tenure system, instructors","1","1","0","0","0","0","0","0","0","0","0","0","0","0","0","0","0","0","1","1","0","0","0","0","0","0","0","0","0","0","-2"
"209612","Pacific University","2012","Tenured total","118","62","56","0","0","0","8","4","4","1","0","1","3","1","2","0","0","0","106","57","49","0","0","0","0","0","0","0","0","0","-2"
"209612","Pacific University","2012","Tenured, professors","59","35","24","0","0","0","1","0","1","1","0","1","0","0","0","0","0","0","57","35","22","0","0","0","0","0","0","0","0","0","-2"
"209612","Pacific University","2012","Tenured, associate professors","58","27","31","0","0","0","7","4","3","0","0","0","3","1","2","0","0","0","48","22","26","0","0","0","0","0","0","0","0","0","-2"
"209612","Pacific University","2012","Tenured, assistant professors","1","0","1","0","0","0","0","0","0","0","0","0","0","0","0","0","0","0","1","0","1","0","0","0","0","0","0","0","0","0","-2"
"209612","Pacific University","2012","On-Tenure track total","56","29","27","0","0","0","6","2","4","0","0","0","2","1","1","0","0","0","45","23","22","2","2","0","0","0","0","1","1","0","-2"
"209612","Pacific University","2012","On-tenure track, associate professors","4","4","0","0","0","0","0","0","0","0","0","0","0","0","0","0","0","0","4","4","0","0","0","0","0","0","0","0","0","0","-2"
"209612","Pacific University","2012","On-tenure track, assistant professors","52","25","27","0","0","0","6","2","4","0","0","0","2","1","1","0","0","0","41","19","22","2","2","0","0","0","0","1","1","0","-2"
"209612","Pacific University","2012","Not on tenure track/No tenure system system total","66","32","34","0","0","0","6","1","5","2","1","1","2","1","1","0","0","0","53","27","26","3","2","1","0","0","0","0","0","0","-2"
"209612","Pacific University","2012","Not on tenure/no tenure system, professors","2","2","0","0","0","0","0","0","0","0","0","0","0","0","0","0","0","0","2","2","0","0","0","0","0","0","0","0","0","0","-2"
"209612","Pacific University","2012","Not on tenure/no tenure system, associate professors","6","1","5","0","0","0","1","0","1","0","0","0","0","0","0","0","0","0","5","1","4","0","0","0","0","0","0","0","0","0","-2"
"209612","Pacific University","2012","Not on tenure/no tenure system, assistant professors","49","26","23","0","0","0","4","1","3","2","1","1","1","0","1","0","0","0","39","22","17","3","2","1","0","0","0","0","0","0","-2"
"209612","Pacific University","2012","Not on tenure/no tenure system, instructors","9","3","6","0","0","0","1","0","1","0","0","0","1","1","0","0","0","0","7","2","5","0","0","0","0","0","0","0","0","0","-2"
"209807","Portland State University","2012","Tenured total","387","255","132","10","4","6","30","21","9","8","7","1","13","11","2","0","0","0","282","183","99","4","2","2","30","19","11","10","8","2","-2"
"209807","Portland State University","2012","Tenured, professors","224","160","64","5","3","2","18","12","6","5","4","1","4","3","1","0","0","0","167","119","48","0","0","0","21","15","6","4","4","0","-2"
"209807","Portland State University","2012","Tenured, associate professors","162","94","68","5","1","4","12","9","3","3","3","0","9","8","1","0","0","0","114","63","51","4","2","2","9","4","5","6","4","2","-2"
"209807","Portland State University","2012","Tenured, assistant professors","1","1","0","0","0","0","0","0","0","0","0","0","0","0","0","0","0","0","1","1","0","0","0","0","0","0","0","0","0","0","-2"
"209807","Portland State University","2012","On-Tenure track total","173","80","93","0","0","0","9","5","4","3","0","3","10","3","7","0","0","0","116","51","65","4","2","2","12","8","4","19","11","8","-2"
"209807","Portland State University","2012","On-tenure track, professors","4","2","2","0","0","0","1","0","1","0","0","0","0","0","0","0","0","0","3","2","1","0","0","0","0","0","0","0","0","0","-2"
"209807","Portland State University","2012","On-tenure track, associate professors","18","10","8","0","0","0","1","1","0","1","0","1","0","0","0","0","0","0","14","7","7","0","0","0","1","1","0","1","1","0","-2"
"209807","Portland State University","2012","On-tenure track, assistant professors","151","68","83","0","0","0","7","4","3","2","0","2","10","3","7","0","0","0","99","42","57","4","2","2","11","7","4","18","10","8","-2"
"209807","Portland State University","2012","Not on tenure track/No tenure system system total","199","73","126","0","0","0","5","1","4","6","1","5","12","6","6","0","0","0","151","53","98","5","0","5","11","8","3","9","4","5","-2"
"209807","Portland State University","2012","Not on tenure/no tenure system, professors","3","2","1","0","0","0","0","0","0","0","0","0","0","0","0","0","0","0","3","2","1","0","0","0","0","0","0","0","0","0","-2"
"209807","Portland State University","2012","Not on tenure/no tenure system, associate professors","6","4","2","0","0","0","0","0","0","1","1","0","0","0","0","0","0","0","5","3","2","0","0","0","0","0","0","0","0","0","-2"
"209807","Portland State University","2012","Not on tenure/no tenure system, assistant professors","47","19","28","0","0","0","2","1","1","1","0","1","4","1","3","0","0","0","31","12","19","2","0","2","4","4","0","3","1","2","-2"
"209807","Portland State University","2012","Not on tenure/no tenure system, instructors","143","48","95","0","0","0","3","0","3","4","0","4","8","5","3","0","0","0","112","36","76","3","0","3","7","4","3","6","3","3","-2"
"210429","Western Oregon University","2012","Tenured total","114","62","52","0","0","0","3","1","2","3","1","2","4","2","2","0","0","0","99","54","45","0","0","0","2","2","0","3","2","1","-2"
"210429","Western Oregon University","2012","Tenured, professors","71","44","27","0","0","0","3","1","2","1","1","0","4","2","2","0","0","0","61","38","23","0","0","0","2","2","0","0","0","0","-2"
"210429","Western Oregon University","2012","Tenured, associate professors","42","18","24","0","0","0","0","0","0","2","0","2","0","0","0","0","0","0","38","16","22","0","0","0","0","0","0","2","2","0","-2"
"210429","Western Oregon University","2012","Tenured, assistant professors","1","0","1","0","0","0","0","0","0","0","0","0","0","0","0","0","0","0","0","0","0","0","0","0","0","0","0","1","0","1","-2"
"210429","Western Oregon University","2012","On-Tenure track total","30","12","18","0","0","0","0","0","0","1","0","1","2","1","1","0","0","0","23","10","13","0","0","0","1","1","0","3","0","3","-2"
"210429","Western Oregon University","2012","On-tenure track, associate professors","2","2","0","0","0","0","0","0","0","0","0","0","0","0","0","0","0","0","1","1","0","0","0","0","1","1","0","0","0","0","-2"
"210429","Western Oregon University","2012","On-tenure track, assistant professors","27","9","18","0","0","0","0","0","0","1","0","1","2","1","1","0","0","0","21","8","13","0","0","0","0","0","0","3","0","3","-2"
"210429","Western Oregon University","2012","On-tenure track, instructors","1","1","0","0","0","0","0","0","0","0","0","0","0","0","0","0","0","0","1","1","0","0","0","0","0","0","0","0","0","0","-2"
"210429","Western Oregon University","2012","Not on tenure track/No tenure system system total","65","35","30","0","0","0","2","1","1","0","0","0","3","2","1","0","0","0","57","32","25","2","0","2","1","0","1","0","0","0","-2"
"210429","Western Oregon University","2012","Not on tenure/no tenure system, assistant professors","26","13","13","0","0","0","1","0","1","0","0","0","1","1","0","0","0","0","24","12","12","0","0","0","0","0","0","0","0","0","-2"
"210429","Western Oregon University","2012","Not on tenure/no tenure system, instructors","33","21","12","0","0","0","1","1","0","0","0","0","2","1","1","0","0","0","28","19","9","1","0","1","1","0","1","0","0","0","-2"
"210429","Western Oregon University","2012","Not on tenure/no tenure system, lecturers","4","0","4","0","0","0","0","0","0","0","0","0","0","0","0","0","0","0","3","0","3","1","0","1","0","0","0","0","0","0","-2"
"210429","Western Oregon University","2012","Not on tenure/no tenure system, no academic rank","2","1","1","0","0","0","0","0","0","0","0","0","0","0","0","0","0","0","2","1","1","0","0","0","0","0","0","0","0","0","-2"
"212133","Eastern University","2012","Tenured total","62","34","28","0","0","0","3","1","2","10","4","6","4","2","2","0","0","0","45","27","18","0","0","0","0","0","0","0","0","0","-2"
"212133","Eastern University","2012","Tenured, professors","32","17","15","0","0","0","1","0","1","3","1","2","1","0","1","0","0","0","27","16","11","0","0","0","0","0","0","0","0","0","-2"
"212133","Eastern University","2012","Tenured, associate professors","30","17","13","0","0","0","2","1","1","7","3","4","3","2","1","0","0","0","18","11","7","0","0","0","0","0","0","0","0","0","-2"
"212133","Eastern University","2012","On-Tenure track total","36","22","14","0","0","0","3","3","0","4","2","2","0","0","0","0","0","0","28","17","11","0","0","0","1","0","1","0","0","0","-2"
"212133","Eastern University","2012","On-tenure track, professors","4","3","1","0","0","0","1","1","0","0","0","0","0","0","0","0","0","0","3","2","1","0","0","0","0","0","0","0","0","0","-2"
"212133","Eastern University","2012","On-tenure track, associate professors","16","11","5","0","0","0","1","1","0","3","1","2","0","0","0","0","0","0","12","9","3","0","0","0","0","0","0","0","0","0","-2"
"212133","Eastern University","2012","On-tenure track, assistant professors","16","8","8","0","0","0","1","1","0","1","1","0","0","0","0","0","0","0","13","6","7","0","0","0","1","0","1","0","0","0","-2"
"212133","Eastern University","2012","Not on tenure track/No tenure system system total","67","32","35","0","0","0","1","1","0","6","0","6","3","1","2","0","0","0","57","30","27","0","0","0","0","0","0","0","0","0","-2"
"212133","Eastern University","2012","Not on tenure/no tenure system, assistant professors","3","2","1","0","0","0","1","1","0","0","0","0","0","0","0","0","0","0","2","1","1","0","0","0","0","0","0","0","0","0","-2"
"212133","Eastern University","2012","Not on tenure/no tenure system, lecturers","38","13","25","0","0","0","0","0","0","5","0","5","2","0","2","0","0","0","31","13","18","0","0","0","0","0","0","0","0","0","-2"
"212133","Eastern University","2012","Not on tenure/no tenure system, no academic rank","26","17","9","0","0","0","0","0","0","1","0","1","1","1","0","0","0","0","24","16","8","0","0","0","0","0","0","0","0","0","-2"
"213367","La Salle University","2012","Tenured total","136","78","58","0","0","0","5","3","2","2","1","1","4","3","1","0","0","0","122","69","53","1","1","0","0","0","0","2","1","1","-2"
"213367","La Salle University","2012","Tenured, professors","50","36","14","0","0","0","1","1","0","1","1","0","1","1","0","0","0","0","46","32","14","1","1","0","0","0","0","0","0","0","-2"
"213367","La Salle University","2012","Tenured, associate professors","74","35","39","0","0","0","3","1","2","1","0","1","3","2","1","0","0","0","65","31","34","0","0","0","0","0","0","2","1","1","-2"
"213367","La Salle University","2012","Tenured, assistant professors","12","7","5","0","0","0","1","1","0","0","0","0","0","0","0","0","0","0","11","6","5","0","0","0","0","0","0","0","0","0","-2"
"213367","La Salle University","2012","On-Tenure track total","57","20","37","1","0","1","1","0","1","1","0","1","1","0","1","0","0","0","49","17","32","0","0","0","0","0","0","4","3","1","-2"
"213367","La Salle University","2012","On-tenure track, associate professors","1","0","1","0","0","0","0","0","0","0","0","0","0","0","0","0","0","0","1","0","1","0","0","0","0","0","0","0","0","0","-2"
"213367","La Salle University","2012","On-tenure track, assistant professors","56","20","36","1","0","1","1","0","1","1","0","1","1","0","1","0","0","0","48","17","31","0","0","0","0","0","0","4","3","1","-2"
"213367","La Salle University","2012","Not on tenure track/No tenure system system total","50","14","36","0","0","0","0","0","0","2","0","2","0","0","0","0","0","0","47","13","34","1","1","0","0","0","0","0","0","0","-2"
"213367","La Salle University","2012","Not on tenure/no tenure system, professors","1","1","0","0","0","0","0","0","0","0","0","0","0","0","0","0","0","0","1","1","0","0","0","0","0","0","0","0","0","0","-2"
"213367","La Salle University","2012","Not on tenure/no tenure system, associate professors","1","1","0","0","0","0","0","0","0","0","0","0","0","0","0","0","0","0","1","1","0","0","0","0","0","0","0","0","0","0","-2"
"213367","La Salle University","2012","Not on tenure/no tenure system, assistant professors","34","8","26","0","0","0","0","0","0","1","0","1","0","0","0","0","0","0","32","7","25","1","1","0","0","0","0","0","0","0","-2"
"213367","La Salle University","2012","Not on tenure/no tenure system, instructors","14","4","10","0","0","0","0","0","0","1","0","1","0","0","0","0","0","0","13","4","9","0","0","0","0","0","0","0","0","0","-2"
"216542","University of Valley Forge","2012","Not on tenure track/No tenure system system total","33","21","12","0","0","0","0","0","0","2","1","1","0","0","0","1","0","1","30","20","10","0","0","0","0","0","0","0","0","0","-2"
"216542","University of Valley Forge","2012","Not on tenure/no tenure system, professors","11","10","1","0","0","0","0","0","0","0","0","0","0","0","0","1","0","1","10","10","0","0","0","0","0","0","0","0","0","0","-2"
"216542","University of Valley Forge","2012","Not on tenure/no tenure system, associate professors","5","3","2","0","0","0","0","0","0","0","0","0","0","0","0","0","0","0","5","3","2","0","0","0","0","0","0","0","0","0","-2"
"216542","University of Valley Forge","2012","Not on tenure/no tenure system, assistant professors","17","8","9","0","0","0","0","0","0","2","1","1","0","0","0","0","0","0","15","7","8","0","0","0","0","0","0","0","0","0","-2"
"217420","Rhode Island College","2012","Tenured total","250","117","133","1","0","1","14","8","6","6","3","3","6","4","2","0","0","0","222","101","121","1","1","0","0","0","0","0","0","0","-2"
"217420","Rhode Island College","2012","Tenured, professors","119","69","50","0","0","0","6","4","2","3","2","1","1","1","0","0","0","0","109","62","47","0","0","0","0","0","0","0","0","0","-2"
"217420","Rhode Island College","2012","Tenured, associate professors","111","43","68","1","0","1","8","4","4","3","1","2","5","3","2","0","0","0","93","34","59","1","1","0","0","0","0","0","0","0","-2"
"217420","Rhode Island College","2012","Tenured, assistant professors","20","5","15","0","0","0","0","0","0","0","0","0","0","0","0","0","0","0","20","5","15","0","0","0","0","0","0","0","0","0","-2"
"217420","Rhode Island College","2012","On-Tenure track total","75","26","49","0","0","0","10","5","5","1","1","0","4","4","0","0","0","0","57","14","43","3","2","1","0","0","0","0","0","0","-2"
"217420","Rhode Island College","2012","On-tenure track, professors","1","1","0","0","0","0","0","0","0","0","0","0","0","0","0","0","0","0","1","1","0","0","0","0","0","0","0","0","0","0","-2"
"217420","Rhode Island College","2012","On-tenure track, associate professors","2","0","2","0","0","0","0","0","0","0","0","0","0","0","0","0","0","0","2","0","2","0","0","0","0","0","0","0","0","0","-2"
"217420","Rhode Island College","2012","On-tenure track, assistant professors","70","25","45","0","0","0","10","5","5","1","1","0","4","4","0","0","0","0","52","13","39","3","2","1","0","0","0","0","0","0","-2"
"217420","Rhode Island College","2012","On-tenure track, instructors","2","0","2","0","0","0","0","0","0","0","0","0","0","0","0","0","0","0","2","0","2","0","0","0","0","0","0","0","0","0","-2"
"217420","Rhode Island College","2012","Not on tenure track/No tenure system system total","27","5","22","0","0","0","0","0","0","0","0","0","0","0","0","0","0","0","27","5","22","0","0","0","0","0","0","0","0","0","-2"
"217420","Rhode Island College","2012","Not on tenure/no tenure system, associate professors","2","1","1","0","0","0","0","0","0","0","0","0","0","0","0","0","0","0","2","1","1","0","0","0","0","0","0","0","0","0","-2"
"217420","Rhode Island College","2012","Not on tenure/no tenure system, assistant professors","25","4","21","0","0","0","0","0","0","0","0","0","0","0","0","0","0","0","25","4","21","0","0","0","0","0","0","0","0","0","-2"
"222178","Abilene Christian University","2012","Tenured total","120","93","27","0","0","0","1","0","1","3","3","0","4","2","2","0","0","0","108","85","23","3","2","1","0","0","0","1","1","0","-2"
"222178","Abilene Christian University","2012","Tenured, professors","64","57","7","0","0","0","0","0","0","1","1","0","2","1","1","0","0","0","60","54","6","0","0","0","0","0","0","1","1","0","-2"
"222178","Abilene Christian University","2012","Tenured, associate professors","53","33","20","0","0","0","1","0","1","2","2","0","2","1","1","0","0","0","45","28","17","3","2","1","0","0","0","0","0","0","-2"
"222178","Abilene Christian University","2012","Tenured, assistant professors","3","3","0","0","0","0","0","0","0","0","0","0","0","0","0","0","0","0","3","3","0","0","0","0","0","0","0","0","0","0","-2"
"222178","Abilene Christian University","2012","On-Tenure track total","76","48","28","1","1","0","2","2","0","3","1","2","2","1","1","0","0","0","65","41","24","2","1","1","0","0","0","1","1","0","-2"
"222178","Abilene Christian University","2012","On-tenure track, professors","2","2","0","0","0","0","0","0","0","0","0","0","0","0","0","0","0","0","2","2","0","0","0","0","0","0","0","0","0","0","-2"
"222178","Abilene Christian University","2012","On-tenure track, associate professors","8","8","0","1","1","0","0","0","0","0","0","0","0","0","0","0","0","0","7","7","0","0","0","0","0","0","0","0","0","0","-2"
"222178","Abilene Christian University","2012","On-tenure track, assistant professors","66","38","28","0","0","0","2","2","0","3","1","2","2","1","1","0","0","0","56","32","24","2","1","1","0","0","0","1","1","0","-2"
"222178","Abilene Christian University","2012","Not on tenure track/No tenure system system total","37","17","20","0","0","0","0","0","0","1","1","0","1","1","0","0","0","0","34","15","19","0","0","0","1","0","1","0","0","0","-2"
"222178","Abilene Christian University","2012","Not on tenure/no tenure system, associate professors","2","2","0","0","0","0","0","0","0","1","1","0","0","0","0","0","0","0","1","1","0","0","0","0","0","0","0","0","0","0","-2"
"222178","Abilene Christian University","2012","Not on tenure/no tenure system, assistant professors","4","2","2","0","0","0","0","0","0","0","0","0","0","0","0","0","0","0","4","2","2","0","0","0","0","0","0","0","0","0","-2"
"222178","Abilene Christian University","2012","Not on tenure/no tenure system, instructors","31","13","18","0","0","0","0","0","0","0","0","0","1","1","0","0","0","0","29","12","17","0","0","0","1","0","1","0","0","0","-2"
"222983","Austin College","2012","Tenured total","72","53","19","1","1","0","0","0","0","1","0","1","4","1","3","0","0","0","65","50","15","0","0","0","0","0","0","1","1","0","-2"
"222983","Austin College","2012","Tenured, professors","28","23","5","1","1","0","0","0","0","0","0","0","0","0","0","0","0","0","27","22","5","0","0","0","0","0","0","0","0","0","-2"
"222983","Austin College","2012","Tenured, associate professors","44","30","14","0","0","0","0","0","0","1","0","1","4","1","3","0","0","0","38","28","10","0","0","0","0","0","0","1","1","0","-2"
"222983","Austin College","2012","On-Tenure track total","21","11","10","0","0","0","3","2","1","0","0","0","0","0","0","0","0","0","18","9","9","0","0","0","0","0","0","0","0","0","-2"
"222983","Austin College","2012","On-tenure track, assistant professors","21","11","10","0","0","0","3","2","1","0","0","0","0","0","0","0","0","0","18","9","9","0","0","0","0","0","0","0","0","0","-2"
"222983","Austin College","2012","Not on tenure track/No tenure system system total","1","1","0","0","0","0","0","0","0","0","0","0","0","0","0","0","0","0","1","1","0","0","0","0","0","0","0","0","0","0","-2"
"222983","Austin College","2012","Not on tenure/no tenure system, professors","1","1","0","0","0","0","0","0","0","0","0","0","0","0","0","0","0","0","1","1","0","0","0","0","0","0","0","0","0","0","-2"
"223232","Baylor University","2012","Tenured total","419","324","95","1","1","0","16","13","3","7","4","3","13","11","2","1","1","0","361","277","84","10","8","2","4","4","0","6","5","1","-2"
"223232","Baylor University","2012","Tenured, professors","242","207","35","1","1","0","4","4","0","4","3","1","5","5","0","1","1","0","213","180","33","8","7","1","3","3","0","3","3","0","-2"
"223232","Baylor University","2012","Tenured, associate professors","175","117","58","0","0","0","12","9","3","3","1","2","8","6","2","0","0","0","146","97","49","2","1","1","1","1","0","3","2","1","-2"
"223232","Baylor University","2012","Tenured, assistant professors","1","0","1","0","0","0","0","0","0","0","0","0","0","0","0","0","0","0","1","0","1","0","0","0","0","0","0","0","0","0","-2"
"223232","Baylor University","2012","Tenured, instructors","1","0","1","0","0","0","0","0","0","0","0","0","0","0","0","0","0","0","1","0","1","0","0","0","0","0","0","0","0","0","-2"
"223232","Baylor University","2012","On-Tenure track total","182","108","74","0","0","0","13","10","3","6","1","5","6","3","3","0","0","0","141","83","58","3","1","2","2","1","1","11","9","2","-2"
"223232","Baylor University","2012","On-tenure track, professors","4","2","2","0","0","0","0","0","0","0","0","0","0","0","0","0","0","0","4","2","2","0","0","0","0","0","0","0","0","0","-2"
"223232","Baylor University","2012","On-tenure track, associate professors","16","9","7","0","0","0","2","2","0","2","0","2","1","0","1","0","0","0","11","7","4","0","0","0","0","0","0","0","0","0","-2"
"223232","Baylor University","2012","On-tenure track, assistant professors","162","97","65","0","0","0","11","8","3","4","1","3","5","3","2","0","0","0","126","74","52","3","1","2","2","1","1","11","9","2","-2"
"223232","Baylor University","2012","Not on tenure track/No tenure system system total","291","124","167","1","0","1","5","2","3","5","0","5","11","5","6","0","0","0","257","109","148","2","1","1","2","2","0","8","5","3","-2"
"223232","Baylor University","2012","Not on tenure/no tenure system, professors","2","2","0","0","0","0","0","0","0","0","0","0","0","0","0","0","0","0","2","2","0","0","0","0","0","0","0","0","0","0","-2"
"223232","Baylor University","2012","Not on tenure/no tenure system, associate professors","1","1","0","0","0","0","0","0","0","0","0","0","0","0","0","0","0","0","1","1","0","0","0","0","0","0","0","0","0","0","-2"
"223232","Baylor University","2012","Not on tenure/no tenure system, assistant professors","4","2","2","0","0","0","1","1","0","0","0","0","0","0","0","0","0","0","3","1","2","0","0","0","0","0","0","0","0","0","-2"
"223232","Baylor University","2012","Not on tenure/no tenure system, lecturers","284","119","165","1","0","1","4","1","3","5","0","5","11","5","6","0","0","0","251","105","146","2","1","1","2","2","0","8","5","3","-2"
"224226","Dallas Baptist University","2012","Tenured total","1","0","1","0","0","0","0","0","0","0","0","0","0","0","0","0","0","0","1","0","1","0","0","0","0","0","0","0","0","0","-2"
"224226","Dallas Baptist University","2012","Tenured, professors","1","0","1","0","0","0","0","0","0","0","0","0","0","0","0","0","0","0","1","0","1","0","0","0","0","0","0","0","0","0","-2"
"224226","Dallas Baptist University","2012","Not on tenure track/No tenure system system total","119","72","47","0","0","0","7","6","1","3","1","2","5","4","1","0","0","0","104","61","43","0","0","0","0","0","0","0","0","0","-2"
"224226","Dallas Baptist University","2012","Not on tenure/no tenure system, professors","55","35","20","0","0","0","3","3","0","0","0","0","3","3","0","0","0","0","49","29","20","0","0","0","0","0","0","0","0","0","-2"
"224226","Dallas Baptist University","2012","Not on tenure/no tenure system, associate professors","17","10","7","0","0","0","1","0","1","0","0","0","1","1","0","0","0","0","15","9","6","0","0","0","0","0","0","0","0","0","-2"
"224226","Dallas Baptist University","2012","Not on tenure/no tenure system, assistant professors","47","27","20","0","0","0","3","3","0","3","1","2","1","0","1","0","0","0","40","23","17","0","0","0","0","0","0","0","0","0","-2"
"224545","Texas A&M University-Texarkana","2012","Tenured total","34","18","16","0","0","0","3","3","0","2","1","1","1","0","1","0","0","0","27","14","13","0","0","0","1","0","1","0","0","0","-2"
"224545","Texas A&M University-Texarkana","2012","Tenured, professors","23","12","11","0","0","0","2","2","0","2","1","1","0","0","0","0","0","0","18","9","9","0","0","0","1","0","1","0","0","0","-2"
"224545","Texas A&M University-Texarkana","2012","Tenured, associate professors","11","6","5","0","0","0","1","1","0","0","0","0","1","0","1","0","0","0","9","5","4","0","0","0","0","0","0","0","0","0","-2"
"224545","Texas A&M University-Texarkana","2012","On-Tenure track total","12","10","2","1","1","0","1","1","0","0","0","0","0","0","0","0","0","0","9","7","2","0","0","0","0","0","0","1","1","0","-2"
"224545","Texas A&M University-Texarkana","2012","On-tenure track, associate professors","8","7","1","1","1","0","1","1","0","0","0","0","0","0","0","0","0","0","6","5","1","0","0","0","0","0","0","0","0","0","-2"
"224545","Texas A&M University-Texarkana","2012","On-tenure track, assistant professors","4","3","1","0","0","0","0","0","0","0","0","0","0","0","0","0","0","0","3","2","1","0","0","0","0","0","0","1","1","0","-2"
"224545","Texas A&M University-Texarkana","2012","Not on tenure track/No tenure system system total","26","12","14","0","0","0","0","0","0","1","0","1","2","2","0","0","0","0","23","10","13","0","0","0","0","0","0","0","0","0","-2"
"224545","Texas A&M University-Texarkana","2012","Not on tenure/no tenure system, professors","1","1","0","0","0","0","0","0","0","0","0","0","0","0","0","0","0","0","1","1","0","0","0","0","0","0","0","0","0","0","-2"
"224545","Texas A&M University-Texarkana","2012","Not on tenure/no tenure system, associate professors","3","2","1","0","0","0","0","0","0","1","0","1","0","0","0","0","0","0","2","2","0","0","0","0","0","0","0","0","0","0","-2"
"224545","Texas A&M University-Texarkana","2012","Not on tenure/no tenure system, assistant professors","13","6","7","0","0","0","0","0","0","0","0","0","1","1","0","0","0","0","12","5","7","0","0","0","0","0","0","0","0","0","-2"
"224545","Texas A&M University-Texarkana","2012","Not on tenure/no tenure system, instructors","8","3","5","0","0","0","0","0","0","0","0","0","1","1","0","0","0","0","7","2","5","0","0","0","0","0","0","0","0","0","-2"
"224545","Texas A&M University-Texarkana","2012","Not on tenure/no tenure system, no academic rank","1","0","1","0","0","0","0","0","0","0","0","0","0","0","0","0","0","0","1","0","1","0","0","0","0","0","0","0","0","0","-2"
"224554","Texas A & M University-Commerce","2012","Tenured total","86","60","26","1","1","0","8","7","1","8","5","3","1","0","1","0","0","0","67","47","20","1","0","1","0","0","0","0","0","0","-2"
"224554","Texas A & M University-Commerce","2012","Tenured, professors","49","37","12","1","1","0","7","6","1","4","3","1","1","0","1","0","0","0","36","27","9","0","0","0","0","0","0","0","0","0","-2"
"224554","Texas A & M University-Commerce","2012","Tenured, associate professors","22","11","11","0","0","0","0","0","0","2","0","2","0","0","0","0","0","0","19","11","8","1","0","1","0","0","0","0","0","0","-2"
"224554","Texas A & M University-Commerce","2012","Tenured, assistant professors","8","7","1","0","0","0","1","1","0","0","0","0","0","0","0","0","0","0","7","6","1","0","0","0","0","0","0","0","0","0","-2"
"224554","Texas A & M University-Commerce","2012","Tenured, instructors","7","5","2","0","0","0","0","0","0","2","2","0","0","0","0","0","0","0","5","3","2","0","0","0","0","0","0","0","0","0","-2"
"224554","Texas A & M University-Commerce","2012","On-Tenure track total","95","58","37","0","0","0","8","4","4","2","1","1","8","5","3","0","0","0","75","46","29","0","0","0","1","1","0","1","1","0","-2"
"224554","Texas A & M University-Commerce","2012","On-tenure track, professors","8","6","2","0","0","0","0","0","0","0","0","0","1","1","0","0","0","0","7","5","2","0","0","0","0","0","0","0","0","0","-2"
"224554","Texas A & M University-Commerce","2012","On-tenure track, associate professors","26","14","12","0","0","0","0","0","0","1","0","1","2","0","2","0","0","0","23","14","9","0","0","0","0","0","0","0","0","0","-2"
"224554","Texas A & M University-Commerce","2012","On-tenure track, assistant professors","51","31","20","0","0","0","6","3","3","0","0","0","5","4","1","0","0","0","39","23","16","0","0","0","0","0","0","1","1","0","-2"
"224554","Texas A & M University-Commerce","2012","On-tenure track, instructors","10","7","3","0","0","0","2","1","1","1","1","0","0","0","0","0","0","0","6","4","2","0","0","0","1","1","0","0","0","0","-2"
"224554","Texas A & M University-Commerce","2012","Not on tenure track/No tenure system system total","149","68","81","0","0","0","10","6","4","17","6","11","6","1","5","0","0","0","110","49","61","0","0","0","1","1","0","5","5","0","-2"
"224554","Texas A & M University-Commerce","2012","Not on tenure/no tenure system, professors","4","3","1","0","0","0","1","1","0","0","0","0","0","0","0","0","0","0","2","1","1","0","0","0","0","0","0","1","1","0","-2"
"224554","Texas A & M University-Commerce","2012","Not on tenure/no tenure system, associate professors","3","1","2","0","0","0","1","1","0","0","0","0","0","0","0","0","0","0","2","0","2","0","0","0","0","0","0","0","0","0","-2"
"224554","Texas A & M University-Commerce","2012","Not on tenure/no tenure system, assistant professors","68","33","35","0","0","0","5","4","1","13","3","10","3","1","2","0","0","0","44","22","22","0","0","0","0","0","0","3","3","0","-2"
"224554","Texas A & M University-Commerce","2012","Not on tenure/no tenure system, instructors","74","31","43","0","0","0","3","0","3","4","3","1","3","0","3","0","0","0","62","26","36","0","0","0","1","1","0","1","1","0","-2"
"225247","Hardin-Simmons University","2012","Tenured total","104","68","36","0","0","0","0","0","0","0","0","0","1","1","0","0","0","0","103","67","36","0","0","0","0","0","0","0","0","0","-2"
"225247","Hardin-Simmons University","2012","Tenured, professors","62","46","16","0","0","0","0","0","0","0","0","0","1","1","0","0","0","0","61","45","16","0","0","0","0","0","0","0","0","0","-2"
"225247","Hardin-Simmons University","2012","Tenured, associate professors","36","19","17","0","0","0","0","0","0","0","0","0","0","0","0","0","0","0","36","19","17","0","0","0","0","0","0","0","0","0","-2"
"225247","Hardin-Simmons University","2012","Tenured, assistant professors","6","3","3","0","0","0","0","0","0","0","0","0","0","0","0","0","0","0","6","3","3","0","0","0","0","0","0","0","0","0","-2"
"225247","Hardin-Simmons University","2012","On-Tenure track total","26","19","7","0","0","0","1","1","0","2","1","1","0","0","0","0","0","0","23","17","6","0","0","0","0","0","0","0","0","0","-2"
"225247","Hardin-Simmons University","2012","On-tenure track, associate professors","5","5","0","0","0","0","0","0","0","0","0","0","0","0","0","0","0","0","5","5","0","0","0","0","0","0","0","0","0","0","-2"
"225247","Hardin-Simmons University","2012","On-tenure track, assistant professors","19","12","7","0","0","0","1","1","0","2","1","1","0","0","0","0","0","0","16","10","6","0","0","0","0","0","0","0","0","0","-2"
"225247","Hardin-Simmons University","2012","On-tenure track, instructors","2","2","0","0","0","0","0","0","0","0","0","0","0","0","0","0","0","0","2","2","0","0","0","0","0","0","0","0","0","0","-2"
"225247","Hardin-Simmons University","2012","Not on tenure track/No tenure system system total","7","4","3","0","0","0","1","0","1","0","0","0","0","0","0","0","0","0","6","4","2","0","0","0","0","0","0","0","0","0","-2"
"225247","Hardin-Simmons University","2012","Not on tenure/no tenure system, professors","1","1","0","0","0","0","0","0","0","0","0","0","0","0","0","0","0","0","1","1","0","0","0","0","0","0","0","0","0","0","-2"
"225247","Hardin-Simmons University","2012","Not on tenure/no tenure system, assistant professors","4","3","1","0","0","0","1","0","1","0","0","0","0","0","0","0","0","0","3","3","0","0","0","0","0","0","0","0","0","0","-2"
"225247","Hardin-Simmons University","2012","Not on tenure/no tenure system, instructors","2","0","2","0","0","0","0","0","0","0","0","0","0","0","0","0","0","0","2","0","2","0","0","0","0","0","0","0","0","0","-2"
"226383","Lubbock Christian University","2012","Tenured total","56","32","24","0","0","0","0","0","0","0","0","0","2","2","0","0","0","0","54","30","24","0","0","0","0","0","0","0","0","0","-2"
"226383","Lubbock Christian University","2012","Tenured, professors","29","18","11","0","0","0","0","0","0","0","0","0","1","1","0","0","0","0","28","17","11","0","0","0","0","0","0","0","0","0","-2"
"226383","Lubbock Christian University","2012","Tenured, associate professors","21","12","9","0","0","0","0","0","0","0","0","0","1","1","0","0","0","0","20","11","9","0","0","0","0","0","0","0","0","0","-2"
"226383","Lubbock Christian University","2012","Tenured, assistant professors","6","2","4","0","0","0","0","0","0","0","0","0","0","0","0","0","0","0","6","2","4","0","0","0","0","0","0","0","0","0","-2"
"226383","Lubbock Christian University","2012","On-Tenure track total","32","21","11","0","0","0","0","0","0","0","0","0","2","1","1","0","0","0","29","19","10","0","0","0","0","0","0","1","1","0","-2"
"226383","Lubbock Christian University","2012","On-tenure track, professors","3","2","1","0","0","0","0","0","0","0","0","0","0","0","0","0","0","0","3","2","1","0","0","0","0","0","0","0","0","0","-2"
"226383","Lubbock Christian University","2012","On-tenure track, associate professors","3","3","0","0","0","0","0","0","0","0","0","0","0","0","0","0","0","0","3","3","0","0","0","0","0","0","0","0","0","0","-2"
"226383","Lubbock Christian University","2012","On-tenure track, assistant professors","24","14","10","0","0","0","0","0","0","0","0","0","2","1","1","0","0","0","22","13","9","0","0","0","0","0","0","0","0","0","-2"
"226383","Lubbock Christian University","2012","On-tenure track, instructors","2","2","0","0","0","0","0","0","0","0","0","0","0","0","0","0","0","0","1","1","0","0","0","0","0","0","0","1","1","0","-2"
"226383","Lubbock Christian University","2012","Not on tenure track/No tenure system system total","6","2","4","0","0","0","0","0","0","0","0","0","0","0","0","0","0","0","6","2","4","0","0","0","0","0","0","0","0","0","-2"
"226383","Lubbock Christian University","2012","Not on tenure/no tenure system, lecturers","6","2","4","0","0","0","0","0","0","0","0","0","0","0","0","0","0","0","6","2","4","0","0","0","0","0","0","0","0","0","-2"
"226471","University of Mary Hardin-Baylor","2012","Tenured total","55","29","26","0","0","0","2","2","0","0","0","0","1","1","0","0","0","0","50","25","25","1","1","0","0","0","0","1","0","1","-2"
"226471","University of Mary Hardin-Baylor","2012","Tenured, professors","41","21","20","0","0","0","1","1","0","0","0","0","1","1","0","0","0","0","37","18","19","1","1","0","0","0","0","1","0","1","-2"
"226471","University of Mary Hardin-Baylor","2012","Tenured, associate professors","14","8","6","0","0","0","1","1","0","0","0","0","0","0","0","0","0","0","13","7","6","0","0","0","0","0","0","0","0","0","-2"
"226471","University of Mary Hardin-Baylor","2012","On-Tenure track total","51","25","26","0","0","0","3","1","2","5","2","3","1","0","1","0","0","0","40","22","18","1","0","1","0","0","0","1","0","1","-2"
"226471","University of Mary Hardin-Baylor","2012","On-tenure track, professors","3","2","1","0","0","0","0","0","0","0","0","0","0","0","0","0","0","0","3","2","1","0","0","0","0","0","0","0","0","0","-2"
"226471","University of Mary Hardin-Baylor","2012","On-tenure track, associate professors","8","4","4","0","0","0","0","0","0","1","0","1","0","0","0","0","0","0","6","4","2","1","0","1","0","0","0","0","0","0","-2"
"226471","University of Mary Hardin-Baylor","2012","On-tenure track, assistant professors","40","19","21","0","0","0","3","1","2","4","2","2","1","0","1","0","0","0","31","16","15","0","0","0","0","0","0","1","0","1","-2"
"226471","University of Mary Hardin-Baylor","2012","Not on tenure track/No tenure system system total","41","9","32","0","0","0","0","0","0","3","0","3","0","0","0","0","0","0","38","9","29","0","0","0","0","0","0","0","0","0","-2"
"226471","University of Mary Hardin-Baylor","2012","Not on tenure/no tenure system, associate professors","6","2","4","0","0","0","0","0","0","0","0","0","0","0","0","0","0","0","6","2","4","0","0","0","0","0","0","0","0","0","-2"
"226471","University of Mary Hardin-Baylor","2012","Not on tenure/no tenure system, assistant professors","28","6","22","0","0","0","0","0","0","2","0","2","0","0","0","0","0","0","26","6","20","0","0","0","0","0","0","0","0","0","-2"
"226471","University of Mary Hardin-Baylor","2012","Not on tenure/no tenure system, instructors","7","1","6","0","0","0","0","0","0","1","0","1","0","0","0","0","0","0","6","1","5","0","0","0","0","0","0","0","0","0","-2"
"226833","Midwestern State University","2012","Tenured total","110","75","35","1","0","1","4","4","0","1","0","1","4","2","2","0","0","0","91","65","26","2","0","2","1","0","1","6","4","2","-2"
"226833","Midwestern State University","2012","Tenured, professors","45","33","12","1","0","1","2","2","0","0","0","0","3","2","1","0","0","0","37","28","9","1","0","1","0","0","0","1","1","0","-2"
"226833","Midwestern State University","2012","Tenured, associate professors","52","35","17","0","0","0","2","2","0","1","0","1","0","0","0","0","0","0","44","30","14","0","0","0","0","0","0","5","3","2","-2"
"226833","Midwestern State University","2012","Tenured, assistant professors","13","7","6","0","0","0","0","0","0","0","0","0","1","0","1","0","0","0","10","7","3","1","0","1","1","0","1","0","0","0","-2"
"226833","Midwestern State University","2012","On-Tenure track total","34","11","23","0","0","0","1","1","0","1","0","1","2","2","0","0","0","0","27","7","20","1","1","0","0","0","0","2","0","2","-2"
"226833","Midwestern State University","2012","On-tenure track, associate professors","2","1","1","0","0","0","0","0","0","0","0","0","1","1","0","0","0","0","1","0","1","0","0","0","0","0","0","0","0","0","-2"
"226833","Midwestern State University","2012","On-tenure track, assistant professors","32","10","22","0","0","0","1","1","0","1","0","1","1","1","0","0","0","0","26","7","19","1","1","0","0","0","0","2","0","2","-2"
"226833","Midwestern State University","2012","Not on tenure track/No tenure system system total","48","13","35","0","0","0","0","0","0","0","0","0","0","0","0","0","0","0","47","13","34","0","0","0","0","0","0","1","0","1","-2"
"226833","Midwestern State University","2012","Not on tenure/no tenure system, professors","1","1","0","0","0","0","0","0","0","0","0","0","0","0","0","0","0","0","1","1","0","0","0","0","0","0","0","0","0","0","-2"
"226833","Midwestern State University","2012","Not on tenure/no tenure system, assistant professors","27","5","22","0","0","0","0","0","0","0","0","0","0","0","0","0","0","0","26","5","21","0","0","0","0","0","0","1","0","1","-2"
"226833","Midwestern State University","2012","Not on tenure/no tenure system, instructors","19","6","13","0","0","0","0","0","0","0","0","0","0","0","0","0","0","0","19","6","13","0","0","0","0","0","0","0","0","0","-2"
"226833","Midwestern State University","2012","Not on tenure/no tenure system, no academic rank","1","1","0","0","0","0","0","0","0","0","0","0","0","0","0","0","0","0","1","1","0","0","0","0","0","0","0","0","0","0","-2"
"227429","Paul Quinn College","2012","Not on tenure track/No tenure system system total","10","7","3","0","0","0","0","0","0","9","6","3","0","0","0","0","0","0","0","0","0","0","0","0","1","1","0","0","0","0","-2"
"227429","Paul Quinn College","2012","Not on tenure/no tenure system, professors","10","7","3","0","0","0","0","0","0","9","6","3","0","0","0","0","0","0","0","0","0","0","0","0","1","1","0","0","0","0","-2"
"227881","Sam Houston State University","2012","Tenured total","309","196","113","1","1","0","18","11","7","5","4","1","13","8","5","0","0","0","265","168","97","0","0","0","0","0","0","7","4","3","-2"
"227881","Sam Houston State University","2012","Tenured, professors","146","106","40","1","1","0","7","6","1","1","1","0","4","2","2","0","0","0","133","96","37","0","0","0","0","0","0","0","0","0","-2"
"227881","Sam Houston State University","2012","Tenured, associate professors","157","87","70","0","0","0","10","4","6","4","3","1","8","5","3","0","0","0","128","71","57","0","0","0","0","0","0","7","4","3","-2"
"227881","Sam Houston State University","2012","Tenured, assistant professors","5","3","2","0","0","0","1","1","0","0","0","0","1","1","0","0","0","0","3","1","2","0","0","0","0","0","0","0","0","0","-2"
"227881","Sam Houston State University","2012","Tenured, instructors","1","0","1","0","0","0","0","0","0","0","0","0","0","0","0","0","0","0","1","0","1","0","0","0","0","0","0","0","0","0","-2"
"227881","Sam Houston State University","2012","On-Tenure track total","168","87","81","2","0","2","4","1","3","4","0","4","8","5","3","0","0","0","125","67","58","0","0","0","0","0","0","25","14","11","-2"
"227881","Sam Houston State University","2012","On-tenure track, associate professors","5","3","2","0","0","0","0","0","0","0","0","0","0","0","0","0","0","0","4","2","2","0","0","0","0","0","0","1","1","0","-2"
"227881","Sam Houston State University","2012","On-tenure track, assistant professors","163","84","79","2","0","2","4","1","3","4","0","4","8","5","3","0","0","0","121","65","56","0","0","0","0","0","0","24","13","11","-2"
"227881","Sam Houston State University","2012","Not on tenure track/No tenure system system total","155","65","90","2","1","1","4","1","3","8","4","4","11","9","2","0","0","0","123","48","75","0","0","0","0","0","0","7","2","5","-2"
"227881","Sam Houston State University","2012","Not on tenure/no tenure system, professors","2","1","1","0","0","0","0","0","0","0","0","0","0","0","0","0","0","0","2","1","1","0","0","0","0","0","0","0","0","0","-2"
"227881","Sam Houston State University","2012","Not on tenure/no tenure system, associate professors","1","1","0","0","0","0","0","0","0","0","0","0","0","0","0","0","0","0","1","1","0","0","0","0","0","0","0","0","0","0","-2"
"227881","Sam Houston State University","2012","Not on tenure/no tenure system, assistant professors","22","9","13","1","1","0","0","0","0","3","1","2","0","0","0","0","0","0","18","7","11","0","0","0","0","0","0","0","0","0","-2"
"227881","Sam Houston State University","2012","Not on tenure/no tenure system, lecturers","130","54","76","1","0","1","4","1","3","5","3","2","11","9","2","0","0","0","102","39","63","0","0","0","0","0","0","7","2","5","-2"
"228529","Tarleton State University","2012","Tenured total","138","96","42","2","2","0","3","3","0","1","0","1","4","3","1","0","0","0","123","83","40","1","1","0","0","0","0","4","4","0","-2"
"228529","Tarleton State University","2012","Tenured, professors","60","46","14","2","2","0","1","1","0","0","0","0","1","1","0","0","0","0","55","41","14","0","0","0","0","0","0","1","1","0","-2"
"228529","Tarleton State University","2012","Tenured, associate professors","71","46","25","0","0","0","2","2","0","0","0","0","1","1","0","0","0","0","64","39","25","1","1","0","0","0","0","3","3","0","-2"
"228529","Tarleton State University","2012","Tenured, assistant professors","7","4","3","0","0","0","0","0","0","1","0","1","2","1","1","0","0","0","4","3","1","0","0","0","0","0","0","0","0","0","-2"
"228529","Tarleton State University","2012","On-Tenure track total","170","86","84","1","0","1","6","2","4","8","5","3","8","3","5","1","1","0","138","69","69","2","2","0","0","0","0","6","4","2","-2"
"228529","Tarleton State University","2012","On-tenure track, associate professors","18","10","8","1","0","1","0","0","0","1","0","1","1","1","0","0","0","0","14","8","6","0","0","0","0","0","0","1","1","0","-2"
"228529","Tarleton State University","2012","On-tenure track, assistant professors","152","76","76","0","0","0","6","2","4","7","5","2","7","2","5","1","1","0","124","61","63","2","2","0","0","0","0","5","3","2","-2"
"228529","Tarleton State University","2012","Not on tenure track/No tenure system system total","121","52","69","0","0","0","0","0","0","3","2","1","5","2","3","0","0","0","107","47","60","1","0","1","1","0","1","4","1","3","-2"
"228529","Tarleton State University","2012","Not on tenure/no tenure system, instructors","105","41","64","0","0","0","0","0","0","2","1","1","4","1","3","0","0","0","93","38","55","1","0","1","1","0","1","4","1","3","-2"
"228529","Tarleton State University","2012","Not on tenure/no tenure system, lecturers","16","11","5","0","0","0","0","0","0","1","1","0","1","1","0","0","0","0","14","9","5","0","0","0","0","0","0","0","0","0","-2"
"228787","The University of Texas at Dallas","2012","Tenured total","348","287","61","1","1","0","81","72","9","7","5","2","7","7","0","0","0","0","233","188","45","4","4","0","1","1","0","14","9","5","-2"
"228787","The University of Texas at Dallas","2012","Tenured, professors","232","200","32","1","1","0","55","49","6","2","2","0","6","6","0","0","0","0","160","135","25","3","3","0","0","0","0","5","4","1","-2"
"228787","The University of Texas at Dallas","2012","Tenured, associate professors","116","87","29","0","0","0","26","23","3","5","3","2","1","1","0","0","0","0","73","53","20","1","1","0","1","1","0","9","5","4","-2"
"228787","The University of Texas at Dallas","2012","On-Tenure track total","141","88","53","0","0","0","28","14","14","4","3","1","7","5","2","0","0","0","78","49","29","1","1","0","0","0","0","23","16","7","-2"
"228787","The University of Texas at Dallas","2012","On-tenure track, professors","1","1","0","0","0","0","0","0","0","0","0","0","0","0","0","0","0","0","1","1","0","0","0","0","0","0","0","0","0","0","-2"
"228787","The University of Texas at Dallas","2012","On-tenure track, associate professors","13","8","5","0","0","0","2","1","1","0","0","0","1","1","0","0","0","0","9","6","3","0","0","0","0","0","0","1","0","1","-2"
"228787","The University of Texas at Dallas","2012","On-tenure track, assistant professors","127","79","48","0","0","0","26","13","13","4","3","1","6","4","2","0","0","0","68","42","26","1","1","0","0","0","0","22","16","6","-2"
"228787","The University of Texas at Dallas","2012","Not on tenure track/No tenure system system total","166","95","71","0","0","0","26","15","11","2","1","1","9","5","4","0","0","0","116","65","51","4","2","2","0","0","0","9","7","2","-2"
"228787","The University of Texas at Dallas","2012","Not on tenure/no tenure system, lecturers","166","95","71","0","0","0","26","15","11","2","1","1","9","5","4","0","0","0","116","65","51","4","2","2","0","0","0","9","7","2","-2"
"235097","Eastern Washington University","2012","Tenured total","212","134","78","3","2","1","12","8","4","3","2","1","5","4","1","2","2","0","187","116","71","0","0","0","0","0","0","0","0","0","-2"
"235097","Eastern Washington University","2012","Tenured, professors","131","90","41","1","1","0","9","7","2","1","1","0","4","4","0","1","1","0","115","76","39","0","0","0","0","0","0","0","0","0","-2"
"235097","Eastern Washington University","2012","Tenured, associate professors","81","44","37","2","1","1","3","1","2","2","1","1","1","0","1","1","1","0","72","40","32","0","0","0","0","0","0","0","0","0","-2"
"235097","Eastern Washington University","2012","On-Tenure track total","67","31","36","0","0","0","8","3","5","2","1","1","6","3","3","0","0","0","47","22","25","0","0","0","0","0","0","4","2","2","-2"
"235097","Eastern Washington University","2012","On-tenure track, assistant professors","67","31","36","0","0","0","8","3","5","2","1","1","6","3","3","0","0","0","47","22","25","0","0","0","0","0","0","4","2","2","-2"
"235097","Eastern Washington University","2012","Not on tenure track/No tenure system system total","129","61","68","1","0","1","6","4","2","5","3","2","2","1","1","0","0","0","115","53","62","0","0","0","0","0","0","0","0","0","-2"
"235097","Eastern Washington University","2012","Not on tenure/no tenure system, no academic rank","129","61","68","1","0","1","6","4","2","5","3","2","2","1","1","0","0","0","115","53","62","0","0","0","0","0","0","0","0","0","-2"
"235237","Pierce College District","2012","Tenured total","60","30","30","2","1","1","3","1","2","0","0","0","2","1","1","0","0","0","50","26","24","3","1","2","0","0","0","0","0","0","-2"
"235237","Pierce College District","2012","Tenured, no academic rank","60","30","30","2","1","1","3","1","2","0","0","0","2","1","1","0","0","0","50","26","24","3","1","2","0","0","0","0","0","0","-2"
"235237","Pierce College District","2012","On-Tenure track total","7","1","6","0","0","0","0","0","0","0","0","0","0","0","0","0","0","0","6","1","5","1","0","1","0","0","0","0","0","0","-2"
"235237","Pierce College District","2012","On-tenure track, no academic rank","7","1","6","0","0","0","0","0","0","0","0","0","0","0","0","0","0","0","6","1","5","1","0","1","0","0","0","0","0","0","-2"
"235237","Pierce College District","2012","Not on tenure track/No tenure system system total","8","3","5","0","0","0","0","0","0","0","0","0","0","0","0","0","0","0","8","3","5","0","0","0","0","0","0","0","0","0","-2"
"235237","Pierce College District","2012","Not on tenure/no tenure system, no academic rank","8","3","5","0","0","0","0","0","0","0","0","0","0","0","0","0","0","0","8","3","5","0","0","0","0","0","0","0","0","0","-2"
"236452","Saint Martin's University","2012","Tenured total","54","34","20","1","0","1","5","4","1","2","2","0","1","0","1","0","0","0","44","28","16","0","0","0","1","0","1","0","0","0","-2"
"236452","Saint Martin's University","2012","Tenured, professors","19","12","7","1","0","1","4","3","1","1","1","0","1","0","1","0","0","0","11","8","3","0","0","0","1","0","1","0","0","0","-2"
"236452","Saint Martin's University","2012","Tenured, associate professors","34","21","13","0","0","0","1","1","0","1","1","0","0","0","0","0","0","0","32","19","13","0","0","0","0","0","0","0","0","0","-2"
"236452","Saint Martin's University","2012","Tenured, assistant professors","1","1","0","0","0","0","0","0","0","0","0","0","0","0","0","0","0","0","1","1","0","0","0","0","0","0","0","0","0","0","-2"
"236452","Saint Martin's University","2012","On-Tenure track total","17","10","7","0","0","0","1","0","1","0","0","0","0","0","0","0","0","0","16","10","6","0","0","0","0","0","0","0","0","0","-2"
"236452","Saint Martin's University","2012","On-tenure track, associate professors","2","0","2","0","0","0","0","0","0","0","0","0","0","0","0","0","0","0","2","0","2","0","0","0","0","0","0","0","0","0","-2"
"236452","Saint Martin's University","2012","On-tenure track, assistant professors","15","10","5","0","0","0","1","0","1","0","0","0","0","0","0","0","0","0","14","10","4","0","0","0","0","0","0","0","0","0","-2"
"236452","Saint Martin's University","2012","Not on tenure track/No tenure system system total","6","6","0","0","0","0","0","0","0","0","0","0","0","0","0","0","0","0","6","6","0","0","0","0","0","0","0","0","0","0","-2"
"236452","Saint Martin's University","2012","Not on tenure/no tenure system, associate professors","1","1","0","0","0","0","0","0","0","0","0","0","0","0","0","0","0","0","1","1","0","0","0","0","0","0","0","0","0","0","-2"
"236452","Saint Martin's University","2012","Not on tenure/no tenure system, assistant professors","1","1","0","0","0","0","0","0","0","0","0","0","0","0","0","0","0","0","1","1","0","0","0","0","0","0","0","0","0","0","-2"
"236452","Saint Martin's University","2012","Not on tenure/no tenure system, instructors","4","4","0","0","0","0","0","0","0","0","0","0","0","0","0","0","0","0","4","4","0","0","0","0","0","0","0","0","0","0","-2"
"236638","Skagit Valley College","2012","Tenured total","84","36","48","2","2","0","1","0","1","0","0","0","4","2","2","0","0","0","75","30","45","0","0","0","2","2","0","0","0","0","-2"
"236638","Skagit Valley College","2012","Tenured, no academic rank","84","36","48","2","2","0","1","0","1","0","0","0","4","2","2","0","0","0","75","30","45","0","0","0","2","2","0","0","0","0","-2"
"236638","Skagit Valley College","2012","On-Tenure track total","11","3","8","0","0","0","0","0","0","0","0","0","0","0","0","0","0","0","10","2","8","0","0","0","1","1","0","0","0","0","-2"
"236638","Skagit Valley College","2012","On-tenure track, no academic rank","11","3","8","0","0","0","0","0","0","0","0","0","0","0","0","0","0","0","10","2","8","0","0","0","1","1","0","0","0","0","-2"
"236638","Skagit Valley College","2012","Not on tenure track/No tenure system system total","8","4","4","0","0","0","0","0","0","0","0","0","0","0","0","0","0","0","7","3","4","0","0","0","1","1","0","0","0","0","-2"
"236638","Skagit Valley College","2012","Not on tenure/no tenure system, no academic rank","8","4","4","0","0","0","0","0","0","0","0","0","0","0","0","0","0","0","7","3","4","0","0","0","1","1","0","0","0","0","-2"
"236887","Walla Walla Community College","2012","Tenured total","66","40","26","3","2","1","2","1","1","0","0","0","1","1","0","0","0","0","60","36","24","0","0","0","0","0","0","0","0","0","-2"
"236887","Walla Walla Community College","2012","Tenured, no academic rank","66","40","26","3","2","1","2","1","1","0","0","0","1","1","0","0","0","0","60","36","24","0","0","0","0","0","0","0","0","0","-2"
"236887","Walla Walla Community College","2012","On-Tenure track total","12","2","10","0","0","0","0","0","0","1","0","1","0","0","0","0","0","0","11","2","9","0","0","0","0","0","0","0","0","0","-2"
"236887","Walla Walla Community College","2012","On-tenure track, no academic rank","12","2","10","0","0","0","0","0","0","1","0","1","0","0","0","0","0","0","11","2","9","0","0","0","0","0","0","0","0","0","-2"
"236887","Walla Walla Community College","2012","Not on tenure track/No tenure system system total","37","24","13","0","0","0","0","0","0","0","0","0","1","1","0","0","0","0","36","23","13","0","0","0","0","0","0","0","0","0","-2"
"236887","Walla Walla Community College","2012","Not on tenure/no tenure system, no academic rank","37","24","13","0","0","0","0","0","0","0","0","0","1","1","0","0","0","0","36","23","13","0","0","0","0","0","0","0","0","0","-2"
"236896","Walla Walla University","2012","Tenured total","91","58","33","0","0","0","2","2","0","2","2","0","4","2","2","0","0","0","80","51","29","0","0","0","3","1","2","0","0","0","-2"
"236896","Walla Walla University","2012","Tenured, professors","60","40","20","0","0","0","1","1","0","2","2","0","4","2","2","0","0","0","52","34","18","0","0","0","1","1","0","0","0","0","-2"
"236896","Walla Walla University","2012","Tenured, associate professors","21","13","8","0","0","0","1","1","0","0","0","0","0","0","0","0","0","0","19","12","7","0","0","0","1","0","1","0","0","0","-2"
"236896","Walla Walla University","2012","Tenured, assistant professors","10","5","5","0","0","0","0","0","0","0","0","0","0","0","0","0","0","0","9","5","4","0","0","0","1","0","1","0","0","0","-2"
"236896","Walla Walla University","2012","On-Tenure track total","19","9","10","0","0","0","0","0","0","0","0","0","0","0","0","0","0","0","19","9","10","0","0","0","0","0","0","0","0","0","-2"
"236896","Walla Walla University","2012","On-tenure track, professors","1","1","0","0","0","0","0","0","0","0","0","0","0","0","0","0","0","0","1","1","0","0","0","0","0","0","0","0","0","0","-2"
"236896","Walla Walla University","2012","On-tenure track, associate professors","4","2","2","0","0","0","0","0","0","0","0","0","0","0","0","0","0","0","4","2","2","0","0","0","0","0","0","0","0","0","-2"
"236896","Walla Walla University","2012","On-tenure track, assistant professors","11","4","7","0","0","0","0","0","0","0","0","0","0","0","0","0","0","0","11","4","7","0","0","0","0","0","0","0","0","0","-2"
"236896","Walla Walla University","2012","On-tenure track, instructors","3","2","1","0","0","0","0","0","0","0","0","0","0","0","0","0","0","0","3","2","1","0","0","0","0","0","0","0","0","0","-2"
"236896","Walla Walla University","2012","Not on tenure track/No tenure system system total","12","6","6","0","0","0","1","1","0","0","0","0","1","0","1","0","0","0","7","4","3","0","0","0","3","1","2","0","0","0","-2"
"236896","Walla Walla University","2012","Not on tenure/no tenure system, professors","4","4","0","0","0","0","1","1","0","0","0","0","0","0","0","0","0","0","2","2","0","0","0","0","1","1","0","0","0","0","-2"
"236896","Walla Walla University","2012","Not on tenure/no tenure system, associate professors","3","1","2","0","0","0","0","0","0","0","0","0","1","0","1","0","0","0","2","1","1","0","0","0","0","0","0","0","0","0","-2"
"236896","Walla Walla University","2012","Not on tenure/no tenure system, assistant professors","3","0","3","0","0","0","0","0","0","0","0","0","0","0","0","0","0","0","1","0","1","0","0","0","2","0","2","0","0","0","-2"
"236896","Walla Walla University","2012","Not on tenure/no tenure system, instructors","2","1","1","0","0","0","0","0","0","0","0","0","0","0","0","0","0","0","2","1","1","0","0","0","0","0","0","0","0","0","-2"
"238430","Cardinal Stritch University","2012","Tenured total","53","20","33","0","0","0","4","1","3","1","1","0","1","1","0","0","0","0","46","16","30","0","0","0","1","1","0","0","0","0","-2"
"238430","Cardinal Stritch University","2012","Tenured, professors","9","6","3","0","0","0","1","1","0","0","0","0","0","0","0","0","0","0","7","4","3","0","0","0","1","1","0","0","0","0","-2"
"238430","Cardinal Stritch University","2012","Tenured, associate professors","20","5","15","0","0","0","3","0","3","0","0","0","0","0","0","0","0","0","17","5","12","0","0","0","0","0","0","0","0","0","-2"
"238430","Cardinal Stritch University","2012","Tenured, assistant professors","24","9","15","0","0","0","0","0","0","1","1","0","1","1","0","0","0","0","22","7","15","0","0","0","0","0","0","0","0","0","-2"
"238430","Cardinal Stritch University","2012","On-Tenure track total","31","13","18","0","0","0","1","0","1","2","1","1","1","1","0","0","0","0","27","11","16","0","0","0","0","0","0","0","0","0","-2"
"238430","Cardinal Stritch University","2012","On-tenure track, associate professors","4","3","1","0","0","0","1","0","1","0","0","0","0","0","0","0","0","0","3","3","0","0","0","0","0","0","0","0","0","0","-2"
"238430","Cardinal Stritch University","2012","On-tenure track, assistant professors","25","9","16","0","0","0","0","0","0","1","1","0","1","1","0","0","0","0","23","7","16","0","0","0","0","0","0","0","0","0","-2"
"238430","Cardinal Stritch University","2012","On-tenure track, instructors","2","1","1","0","0","0","0","0","0","1","0","1","0","0","0","0","0","0","1","1","0","0","0","0","0","0","0","0","0","0","-2"
"238430","Cardinal Stritch University","2012","Not on tenure track/No tenure system system total","27","10","17","0","0","0","1","1","0","1","0","1","1","1","0","0","0","0","24","8","16","0","0","0","0","0","0","0","0","0","-2"
"238430","Cardinal Stritch University","2012","Not on tenure/no tenure system, associate professors","3","1","2","0","0","0","0","0","0","0","0","0","0","0","0","0","0","0","3","1","2","0","0","0","0","0","0","0","0","0","-2"
"238430","Cardinal Stritch University","2012","Not on tenure/no tenure system, assistant professors","13","6","7","0","0","0","1","1","0","0","0","0","0","0","0","0","0","0","12","5","7","0","0","0","0","0","0","0","0","0","-2"
"238430","Cardinal Stritch University","2012","Not on tenure/no tenure system, instructors","9","3","6","0","0","0","0","0","0","0","0","0","1","1","0","0","0","0","8","2","6","0","0","0","0","0","0","0","0","0","-2"
"238430","Cardinal Stritch University","2012","Not on tenure/no tenure system, no academic rank","2","0","2","0","0","0","0","0","0","1","0","1","0","0","0","0","0","0","1","0","1","0","0","0","0","0","0","0","0","0","-2"
"240374","University of Wisconsin-Parkside","2012","Tenured total","75","47","28","0","0","0","14","7","7","4","3","1","4","2","2","0","0","0","53","35","18","0","0","0","0","0","0","0","0","0","-2"
"240374","University of Wisconsin-Parkside","2012","Tenured, professors","26","17","9","0","0","0","6","4","2","1","1","0","0","0","0","0","0","0","19","12","7","0","0","0","0","0","0","0","0","0","-2"
"240374","University of Wisconsin-Parkside","2012","Tenured, associate professors","48","29","19","0","0","0","8","3","5","3","2","1","4","2","2","0","0","0","33","22","11","0","0","0","0","0","0","0","0","0","-2"
"240374","University of Wisconsin-Parkside","2012","Tenured, assistant professors","1","1","0","0","0","0","0","0","0","0","0","0","0","0","0","0","0","0","1","1","0","0","0","0","0","0","0","0","0","0","-2"
"240374","University of Wisconsin-Parkside","2012","On-Tenure track total","49","25","24","0","0","0","4","2","2","2","1","1","4","0","4","0","0","0","31","15","16","0","0","0","3","3","0","5","4","1","-2"
"240374","University of Wisconsin-Parkside","2012","On-tenure track, associate professors","7","4","3","0","0","0","1","0","1","0","0","0","0","0","0","0","0","0","6","4","2","0","0","0","0","0","0","0","0","0","-2"
"240374","University of Wisconsin-Parkside","2012","On-tenure track, assistant professors","42","21","21","0","0","0","3","2","1","2","1","1","4","0","4","0","0","0","25","11","14","0","0","0","3","3","0","5","4","1","-2"
"240374","University of Wisconsin-Parkside","2012","Not on tenure track/No tenure system system total","56","24","32","1","1","0","3","2","1","3","2","1","4","1","3","0","0","0","43","18","25","0","0","0","1","0","1","1","0","1","-2"
"240374","University of Wisconsin-Parkside","2012","Not on tenure/no tenure system, assistant professors","2","1","1","0","0","0","0","0","0","0","0","0","0","0","0","0","0","0","2","1","1","0","0","0","0","0","0","0","0","0","-2"
"240374","University of Wisconsin-Parkside","2012","Not on tenure/no tenure system, lecturers","54","23","31","1","1","0","3","2","1","3","2","1","4","1","3","0","0","0","41","17","24","0","0","0","1","0","1","1","0","1","-2"
"247834","Collin County Community College District","2012","Not on tenure track/No tenure system system total","368","155","213","5","2","3","14","1","13","20","9","11","18","5","13","0","0","0","308","135","173","3","3","0","0","0","0","0","0","0","-2"
"247834","Collin County Community College District","2012","Not on tenure/no tenure system, no academic rank","368","155","213","5","2","3","14","1","13","20","9","11","18","5","13","0","0","0","308","135","173","3","3","0","0","0","0","0","0","0","-2"
"262129","New College of Florida","2012","Tenured total","49","25","24","0","0","0","1","1","0","2","1","1","3","1","2","0","0","0","43","22","21","0","0","0","0","0","0","0","0","0","-2"
"262129","New College of Florida","2012","Tenured, professors","29","19","10","0","0","0","0","0","0","1","1","0","1","1","0","0","0","0","27","17","10","0","0","0","0","0","0","0","0","0","-2"
"262129","New College of Florida","2012","Tenured, associate professors","20","6","14","0","0","0","1","1","0","1","0","1","2","0","2","0","0","0","16","5","11","0","0","0","0","0","0","0","0","0","-2"
"262129","New College of Florida","2012","On-Tenure track total","12","6","6","0","0","0","1","0","1","0","0","0","0","0","0","0","0","0","10","6","4","0","0","0","0","0","0","1","0","1","-2"
"262129","New College of Florida","2012","On-tenure track, assistant professors","12","6","6","0","0","0","1","0","1","0","0","0","0","0","0","0","0","0","10","6","4","0","0","0","0","0","0","1","0","1","-2"
"262129","New College of Florida","2012","Not on tenure track/No tenure system system total","11","5","6","0","0","0","0","0","0","1","0","1","0","0","0","0","0","0","9","5","4","0","0","0","0","0","0","1","0","1","-2"
"262129","New College of Florida","2012","Not on tenure/no tenure system, assistant professors","7","4","3","0","0","0","0","0","0","0","0","0","0","0","0","0","0","0","7","4","3","0","0","0","0","0","0","0","0","0","-2"
"262129","New College of Florida","2012","Not on tenure/no tenure system, instructors","1","0","1","0","0","0","0","0","0","0","0","0","0","0","0","0","0","0","1","0","1","0","0","0","0","0","0","0","0","0","-2"
"262129","New College of Florida","2012","Not on tenure/no tenure system, no academic rank","3","1","2","0","0","0","0","0","0","1","0","1","0","0","0","0","0","0","1","1","0","0","0","0","0","0","0","1","0","1","-2"
"385619","Everglades University","2012","Not on tenure track/No tenure system system total","84","52","32","1","0","1","3","1","2","5","5","0","7","5","2","1","1","0","65","40","25","2","0","2","0","0","0","0","0","0","-2"
"385619","Everglades University","2012","Not on tenure/no tenure system, instructors","84","52","32","1","0","1","3","1","2","5","5","0","7","5","2","1","1","0","65","40","25","2","0","2","0","0","0","0","0","0","-2"
"426314","Embry-Riddle Aeronautical University-Worldwide","2012","Tenured total","3","3","0","0","0","0","0","0","0","0","0","0","0","0","0","0","0","0","3","3","0","0","0","0","0","0","0","0","0","0","-2"
"426314","Embry-Riddle Aeronautical University-Worldwide","2012","Tenured, professors","3","3","0","0","0","0","0","0","0","0","0","0","0","0","0","0","0","0","3","3","0","0","0","0","0","0","0","0","0","0","-2"
"426314","Embry-Riddle Aeronautical University-Worldwide","2012","On-Tenure track total","19","16","3","0","0","0","0","0","0","1","1","0","0","0","0","0","0","0","15","12","3","0","0","0","2","2","0","1","1","0","-2"
"426314","Embry-Riddle Aeronautical University-Worldwide","2012","On-tenure track, associate professors","3","2","1","0","0","0","0","0","0","0","0","0","0","0","0","0","0","0","3","2","1","0","0","0","0","0","0","0","0","0","-2"
"426314","Embry-Riddle Aeronautical University-Worldwide","2012","On-tenure track, assistant professors","16","14","2","0","0","0","0","0","0","1","1","0","0","0","0","0","0","0","12","10","2","0","0","0","2","2","0","1","1","0","-2"
"426314","Embry-Riddle Aeronautical University-Worldwide","2012","Not on tenure track/No tenure system system total","95","67","28","1","1","0","1","1","0","3","3","0","2","0","2","1","1","0","86","61","25","1","0","1","0","0","0","0","0","0","-2"
"426314","Embry-Riddle Aeronautical University-Worldwide","2012","Not on tenure/no tenure system, professors","2","2","0","0","0","0","0","0","0","0","0","0","0","0","0","0","0","0","2","2","0","0","0","0","0","0","0","0","0","0","-2"
"426314","Embry-Riddle Aeronautical University-Worldwide","2012","Not on tenure/no tenure system, associate professors","20","17","3","1","1","0","1","1","0","0","0","0","0","0","0","0","0","0","18","15","3","0","0","0","0","0","0","0","0","0","-2"
"426314","Embry-Riddle Aeronautical University-Worldwide","2012","Not on tenure/no tenure system, assistant professors","44","28","16","0","0","0","0","0","0","1","1","0","1","0","1","1","1","0","40","26","14","1","0","1","0","0","0","0","0","0","-2"
"426314","Embry-Riddle Aeronautical University-Worldwide","2012","Not on tenure/no tenure system, instructors","29","20","9","0","0","0","0","0","0","2","2","0","1","0","1","0","0","0","26","18","8","0","0","0","0","0","0","0","0","0","-2"
"447689","Georgia Gwinnett College","2012","Not on tenure track/No tenure system system total","342","174","168","2","1","1","38","20","18","42","18","24","13","8","5","0","0","0","212","109","103","0","0","0","17","7","10","18","11","7","-2"
"447689","Georgia Gwinnett College","2012","Not on tenure/no tenure system, professors","17","12","5","0","0","0","4","3","1","1","1","0","0","0","0","0","0","0","12","8","4","0","0","0","0","0","0","0","0","0","-2"
"447689","Georgia Gwinnett College","2012","Not on tenure/no tenure system, associate professors","61","36","25","0","0","0","10","7","3","11","5","6","0","0","0","0","0","0","38","23","15","0","0","0","2","1","1","0","0","0","-2"
"447689","Georgia Gwinnett College","2012","Not on tenure/no tenure system, assistant professors","242","121","121","2","1","1","23","10","13","27","12","15","13","8","5","0","0","0","145","73","72","0","0","0","14","6","8","18","11","7","-2"
"447689","Georgia Gwinnett College","2012","Not on tenure/no tenure system, instructors","22","5","17","0","0","0","1","0","1","3","0","3","0","0","0","0","0","0","17","5","12","0","0","0","1","0","1","0","0","0","-2"
"448840","University of South Florida-St Petersburg","2012","Tenured total","58","36","22","0","0","0","3","1","2","1","0","1","7","4","3","0","0","0","44","28","16","1","1","0","2","2","0","0","0","0","-2"
"448840","University of South Florida-St Petersburg","2012","Tenured, professors","18","14","4","0","0","0","1","0","1","0","0","0","2","1","1","0","0","0","13","11","2","0","0","0","2","2","0","0","0","0","-2"
"448840","University of South Florida-St Petersburg","2012","Tenured, associate professors","40","22","18","0","0","0","2","1","1","1","0","1","5","3","2","0","0","0","31","17","14","1","1","0","0","0","0","0","0","0","-2"
"448840","University of South Florida-St Petersburg","2012","On-Tenure track total","25","12","13","0","0","0","3","1","2","1","1","0","3","1","2","0","0","0","11","6","5","0","0","0","0","0","0","7","3","4","-2"
"448840","University of South Florida-St Petersburg","2012","On-tenure track, associate professors","5","2","3","0","0","0","0","0","0","0","0","0","1","0","1","0","0","0","3","1","2","0","0","0","0","0","0","1","1","0","-2"
"448840","University of South Florida-St Petersburg","2012","On-tenure track, assistant professors","19","9","10","0","0","0","3","1","2","1","1","0","2","1","1","0","0","0","7","4","3","0","0","0","0","0","0","6","2","4","-2"
"448840","University of South Florida-St Petersburg","2012","On-tenure track, lecturers","1","1","0","0","0","0","0","0","0","0","0","0","0","0","0","0","0","0","1","1","0","0","0","0","0","0","0","0","0","0","-2"
"448840","University of South Florida-St Petersburg","2012","Not on tenure track/No tenure system system total","30","11","19","0","0","0","2","0","2","2","0","2","1","1","0","0","0","0","23","8","15","0","0","0","1","1","0","1","1","0","-2"
"448840","University of South Florida-St Petersburg","2012","Not on tenure/no tenure system, associate professors","1","0","1","0","0","0","0","0","0","0","0","0","0","0","0","0","0","0","1","0","1","0","0","0","0","0","0","0","0","0","-2"
"448840","University of South Florida-St Petersburg","2012","Not on tenure/no tenure system, assistant professors","11","5","6","0","0","0","1","0","1","0","0","0","0","0","0","0","0","0","9","4","5","0","0","0","0","0","0","1","1","0","-2"
"448840","University of South Florida-St Petersburg","2012","Not on tenure/no tenure system, instructors","16","5","11","0","0","0","1","0","1","1","0","1","1","1","0","0","0","0","12","3","9","0","0","0","1","1","0","0","0","0","-2"
"448840","University of South Florida-St Petersburg","2012","Not on tenure/no tenure system, lecturers","2","1","1","0","0","0","0","0","0","1","0","1","0","0","0","0","0","0","1","1","0","0","0","0","0","0","0","0","0","0","-2"
"451671","University of South Florida-Sarasota-Manatee","2012","Tenured total","14","6","8","0","0","0","1","1","0","0","0","0","0","0","0","0","0","0","13","5","8","0","0","0","0","0","0","0","0","0","-2"
"451671","University of South Florida-Sarasota-Manatee","2012","Tenured, professors","3","2","1","0","0","0","0","0","0","0","0","0","0","0","0","0","0","0","3","2","1","0","0","0","0","0","0","0","0","0","-2"
"451671","University of South Florida-Sarasota-Manatee","2012","Tenured, associate professors","11","4","7","0","0","0","1","1","0","0","0","0","0","0","0","0","0","0","10","3","7","0","0","0","0","0","0","0","0","0","-2"
"451671","University of South Florida-Sarasota-Manatee","2012","On-Tenure track total","21","9","12","0","0","0","2","1","1","2","1","1","0","0","0","0","0","0","16","7","9","0","0","0","1","0","1","0","0","0","-2"
"451671","University of South Florida-Sarasota-Manatee","2012","On-tenure track, professors","2","2","0","0","0","0","0","0","0","0","0","0","0","0","0","0","0","0","2","2","0","0","0","0","0","0","0","0","0","0","-2"
"451671","University of South Florida-Sarasota-Manatee","2012","On-tenure track, associate professors","1","0","1","0","0","0","0","0","0","0","0","0","0","0","0","0","0","0","1","0","1","0","0","0","0","0","0","0","0","0","-2"
"451671","University of South Florida-Sarasota-Manatee","2012","On-tenure track, assistant professors","16","7","9","0","0","0","2","1","1","2","1","1","0","0","0","0","0","0","11","5","6","0","0","0","1","0","1","0","0","0","-2"
"451671","University of South Florida-Sarasota-Manatee","2012","On-tenure track, instructors","2","0","2","0","0","0","0","0","0","0","0","0","0","0","0","0","0","0","2","0","2","0","0","0","0","0","0","0","0","0","-2"
"451671","University of South Florida-Sarasota-Manatee","2012","Not on tenure track/No tenure system system total","22","9","13","0","0","0","1","0","1","1","0","1","1","0","1","0","0","0","18","8","10","0","0","0","1","1","0","0","0","0","-2"
"451671","University of South Florida-Sarasota-Manatee","2012","Not on tenure/no tenure system, instructors","22","9","13","0","0","0","1","0","1","1","0","1","1","0","1","0","0","0","18","8","10","0","0","0","1","1","0","0","0","0","-2"
"459824","Touro University Nevada","2012","Not on tenure track/No tenure system system total","58","30","28","0","0","0","7","4","3","1","0","1","0","0","0","0","0","0","44","25","19","0","0","0","6","1","5","0","0","0","-2"
"459824","Touro University Nevada","2012","Not on tenure/no tenure system, professors","3","3","0","0","0","0","1","1","0","0","0","0","0","0","0","0","0","0","1","1","0","0","0","0","1","1","0","0","0","0","-2"
"459824","Touro University Nevada","2012","Not on tenure/no tenure system, associate professors","17","10","7","0","0","0","5","3","2","0","0","0","0","0","0","0","0","0","11","7","4","0","0","0","1","0","1","0","0","0","-2"
"459824","Touro University Nevada","2012","Not on tenure/no tenure system, assistant professors","38","17","21","0","0","0","1","0","1","1","0","1","0","0","0","0","0","0","32","17","15","0","0","0","4","0","4","0","0","0","-2"
"461795","North American University","2012","Not on tenure track/No tenure system system total","15","8","7","0","0","0","0","0","0","2","0","2","0","0","0","0","0","0","8","6","2","0","0","0","0","0","0","5","2","3","-2"
"461795","North American University","2012","Not on tenure/no tenure system, professors","1","1","0","0","0","0","0","0","0","0","0","0","0","0","0","0","0","0","1","1","0","0","0","0","0","0","0","0","0","0","-2"
"461795","North American University","2012","Not on tenure/no tenure system, associate professors","1","1","0","0","0","0","0","0","0","0","0","0","0","0","0","0","0","0","1","1","0","0","0","0","0","0","0","0","0","0","-2"
"461795","North American University","2012","Not on tenure/no tenure system, assistant professors","10","6","4","0","0","0","0","0","0","0","0","0","0","0","0","0","0","0","6","4","2","0","0","0","0","0","0","4","2","2","-2"
"461795","North American University","2012","Not on tenure/no tenure system, instructors","3","0","3","0","0","0","0","0","0","2","0","2","0","0","0","0","0","0","0","0","0","0","0","0","0","0","0","1","0","1","-2"
