"unitid","institution name","year","S2020_IS.Instructional staff category","S2020_IS.Grand total","S2020_IS.Grand total men","S2020_IS.Grand total women","S2020_IS.American Indian or Alaska Native total","S2020_IS.American Indian or Alaska Native men","S2020_IS.American Indian or Alaska Native women","S2020_IS.Asian total","S2020_IS.Asian men","S2020_IS.Asian women","S2020_IS.Black or African American total","S2020_IS.Black or African American men","S2020_IS.Black or African American women","S2020_IS.Hispanic or Latino total","S2020_IS.Hispanic or Latino men","S2020_IS.Hispanic or Latino women","S2020_IS.Native Hawaiian or Other Pacific Islander total","S2020_IS.Native Hawaiian or Other Pacific Islander men","S2020_IS.Native Hawaiian or Other Pacific Islander women","S2020_IS.White total","S2020_IS.White men","S2020_IS.White women","S2020_IS.Two or more races total","S2020_IS.Two or more races men","S2020_IS.Two or more races women","S2020_IS.Race/ethnicity unknown total","S2020_IS.Race/ethnicity unknown men","S2020_IS.Race/ethnicity unknown women","S2020_IS.Nonresident alien total","S2020_IS.Nonresident alien men","S2020_IS.Nonresident alien women","IDX_HR"
"110097","Biola University","2020","Tenured total","53","45","8","0","0","0","5","3","2","2","1","1","2","1","1","1","1","0","43","39","4","0","0","0","0","0","0","0","0","0","-2"
"110097","Biola University","2020","Tenured, professors","43","37","6","0","0","0","4","2","2","0","0","0","2","1","1","1","1","0","36","33","3","0","0","0","0","0","0","0","0","0","-2"
"110097","Biola University","2020","Tenured, associate professors","10","8","2","0","0","0","1","1","0","2","1","1","0","0","0","0","0","0","7","6","1","0","0","0","0","0","0","0","0","0","-2"
"110097","Biola University","2020","On-Tenure track total","159","81","78","2","0","2","27","12","15","6","4","2","8","4","4","0","0","0","96","51","45","0","0","0","19","10","9","1","0","1","-2"
"110097","Biola University","2020","On-tenure track, professors","12","11","1","0","0","0","4","3","1","0","0","0","1","1","0","0","0","0","5","5","0","0","0","0","2","2","0","0","0","0","-2"
"110097","Biola University","2020","On-tenure track, associate professors","94","45","49","2","0","2","13","4","9","4","3","1","6","2","4","0","0","0","59","31","28","0","0","0","10","5","5","0","0","0","-2"
"110097","Biola University","2020","On-tenure track, assistant professors","42","20","22","0","0","0","8","3","5","2","1","1","1","1","0","0","0","0","23","12","11","0","0","0","7","3","4","1","0","1","-2"
"110097","Biola University","2020","On-tenure track, instructors","11","5","6","0","0","0","2","2","0","0","0","0","0","0","0","0","0","0","9","3","6","0","0","0","0","0","0","0","0","0","-2"
"110422","California Polytechnic State University-San Luis Obispo","2020","Tenured total","466","315","151","3","2","1","55","36","19","6","5","1","27","18","9","0","0","0","350","235","115","4","3","1","19","14","5","2","2","0","-2"
"110422","California Polytechnic State University-San Luis Obispo","2020","Tenured, professors","320","228","92","1","1","0","38","24","14","4","4","0","17","12","5","0","0","0","244","174","70","3","3","0","13","10","3","0","0","0","-2"
"110422","California Polytechnic State University-San Luis Obispo","2020","Tenured, associate professors","144","85","59","2","1","1","17","12","5","2","1","1","10","6","4","0","0","0","104","59","45","1","0","1","6","4","2","2","2","0","-2"
"110422","California Polytechnic State University-San Luis Obispo","2020","Tenured, no academic rank","2","2","0","0","0","0","0","0","0","0","0","0","0","0","0","0","0","0","2","2","0","0","0","0","0","0","0","0","0","0","-2"
"110422","California Polytechnic State University-San Luis Obispo","2020","On-Tenure track total","206","109","97","1","1","0","21","10","11","10","5","5","6","3","3","0","0","0","130","70","60","3","1","2","16","8","8","19","11","8","-2"
"110422","California Polytechnic State University-San Luis Obispo","2020","On-tenure track, professors","3","2","1","0","0","0","0","0","0","0","0","0","0","0","0","0","0","0","3","2","1","0","0","0","0","0","0","0","0","0","-2"
"110422","California Polytechnic State University-San Luis Obispo","2020","On-tenure track, associate professors","21","13","8","0","0","0","3","3","0","1","1","0","2","0","2","0","0","0","14","9","5","0","0","0","1","0","1","0","0","0","-2"
"110422","California Polytechnic State University-San Luis Obispo","2020","On-tenure track, assistant professors","182","94","88","1","1","0","18","7","11","9","4","5","4","3","1","0","0","0","113","59","54","3","1","2","15","8","7","19","11","8","-2"
"110422","California Polytechnic State University-San Luis Obispo","2020","Not on tenure track/No tenure system system total","209","128","81","0","0","0","6","2","4","4","4","0","5","3","2","0","0","0","169","100","69","2","2","0","12","9","3","11","8","3","-2"
"110422","California Polytechnic State University-San Luis Obispo","2020","Not on tenure/no tenure system, lecturers","209","128","81","0","0","0","6","2","4","4","4","0","5","3","2","0","0","0","169","100","69","2","2","0","12","9","3","11","8","3","-2"
"111948","Chapman University","2020","Tenured total","246","157","89","0","0","0","20","9","11","8","6","2","10","6","4","0","0","0","177","119","58","4","2","2","26","15","11","1","0","1","-2"
"111948","Chapman University","2020","Tenured, professors","135","99","36","0","0","0","11","5","6","4","3","1","4","3","1","0","0","0","99","77","22","2","1","1","15","10","5","0","0","0","-2"
"111948","Chapman University","2020","Tenured, associate professors","111","58","53","0","0","0","9","4","5","4","3","1","6","3","3","0","0","0","78","42","36","2","1","1","11","5","6","1","0","1","-2"
"111948","Chapman University","2020","On-Tenure track total","99","49","50","0","0","0","10","2","8","1","0","1","5","2","3","0","0","0","40","20","20","0","0","0","26","16","10","17","9","8","-2"
"111948","Chapman University","2020","On-tenure track, associate professors","6","3","3","0","0","0","0","0","0","0","0","0","0","0","0","0","0","0","4","2","2","0","0","0","2","1","1","0","0","0","-2"
"111948","Chapman University","2020","On-tenure track, assistant professors","93","46","47","0","0","0","10","2","8","1","0","1","5","2","3","0","0","0","36","18","18","0","0","0","24","15","9","17","9","8","-2"
"111948","Chapman University","2020","Not on tenure track/No tenure system system total","199","100","99","0","0","0","23","11","12","4","3","1","8","4","4","1","0","1","109","54","55","3","1","2","48","26","22","3","1","2","-2"
"111948","Chapman University","2020","Not on tenure/no tenure system, professors","25","13","12","0","0","0","1","0","1","0","0","0","0","0","0","0","0","0","23","12","11","0","0","0","1","1","0","0","0","0","-2"
"111948","Chapman University","2020","Not on tenure/no tenure system, associate professors","40","22","18","0","0","0","5","2","3","1","1","0","1","0","1","0","0","0","25","14","11","1","1","0","6","4","2","1","0","1","-2"
"111948","Chapman University","2020","Not on tenure/no tenure system, assistant professors","104","47","57","0","0","0","16","9","7","2","1","1","5","3","2","1","0","1","47","19","28","2","0","2","30","14","16","1","1","0","-2"
"111948","Chapman University","2020","Not on tenure/no tenure system, instructors","26","14","12","0","0","0","1","0","1","0","0","0","2","1","1","0","0","0","12","7","5","0","0","0","10","6","4","1","0","1","-2"
"111948","Chapman University","2020","Not on tenure/no tenure system, no academic rank","4","4","0","0","0","0","0","0","0","1","1","0","0","0","0","0","0","0","2","2","0","0","0","0","1","1","0","0","0","0","-2"
"112260","Claremont McKenna College","2020","Tenured total","112","79","33","0","0","0","14","7","7","3","2","1","6","6","0","0","0","0","83","60","23","1","0","1","4","3","1","1","1","0","-2"
"112260","Claremont McKenna College","2020","Tenured, professors","62","46","16","0","0","0","6","3","3","2","1","1","2","2","0","0","0","0","50","38","12","0","0","0","2","2","0","0","0","0","-2"
"112260","Claremont McKenna College","2020","Tenured, associate professors","50","33","17","0","0","0","8","4","4","1","1","0","4","4","0","0","0","0","33","22","11","1","0","1","2","1","1","1","1","0","-2"
"112260","Claremont McKenna College","2020","On-Tenure track total","24","10","14","0","0","0","2","0","2","1","1","0","1","0","1","0","0","0","15","6","9","2","2","0","1","0","1","2","1","1","-2"
"112260","Claremont McKenna College","2020","On-tenure track, assistant professors","24","10","14","0","0","0","2","0","2","1","1","0","1","0","1","0","0","0","15","6","9","2","2","0","1","0","1","2","1","1","-2"
"112260","Claremont McKenna College","2020","Not on tenure track/No tenure system system total","34","19","15","0","0","0","0","0","0","1","0","1","4","2","2","0","0","0","27","16","11","0","0","0","1","1","0","1","0","1","-2"
"112260","Claremont McKenna College","2020","Not on tenure/no tenure system, professors","1","1","0","0","0","0","0","0","0","0","0","0","0","0","0","0","0","0","1","1","0","0","0","0","0","0","0","0","0","0","-2"
"112260","Claremont McKenna College","2020","Not on tenure/no tenure system, associate professors","2","2","0","0","0","0","0","0","0","0","0","0","0","0","0","0","0","0","2","2","0","0","0","0","0","0","0","0","0","0","-2"
"112260","Claremont McKenna College","2020","Not on tenure/no tenure system, assistant professors","31","16","15","0","0","0","0","0","0","1","0","1","4","2","2","0","0","0","24","13","11","0","0","0","1","1","0","1","0","1","-2"
"115409","Harvey Mudd College","2020","Tenured total","72","46","26","0","0","0","11","7","4","3","2","1","3","2","1","0","0","0","52","34","18","1","0","1","2","1","1","0","0","0","-2"
"115409","Harvey Mudd College","2020","Tenured, professors","53","38","15","0","0","0","9","5","4","1","1","0","3","2","1","0","0","0","40","30","10","0","0","0","0","0","0","0","0","0","-2"
"115409","Harvey Mudd College","2020","Tenured, associate professors","19","8","11","0","0","0","2","2","0","2","1","1","0","0","0","0","0","0","12","4","8","1","0","1","2","1","1","0","0","0","-2"
"115409","Harvey Mudd College","2020","On-Tenure track total","24","14","10","0","0","0","4","1","3","1","0","1","3","3","0","0","0","0","14","8","6","1","1","0","1","1","0","0","0","0","-2"
"115409","Harvey Mudd College","2020","On-tenure track, associate professors","2","1","1","0","0","0","0","0","0","0","0","0","0","0","0","0","0","0","2","1","1","0","0","0","0","0","0","0","0","0","-2"
"115409","Harvey Mudd College","2020","On-tenure track, assistant professors","22","13","9","0","0","0","4","1","3","1","0","1","3","3","0","0","0","0","12","7","5","1","1","0","1","1","0","0","0","0","-2"
"115409","Harvey Mudd College","2020","Not on tenure track/No tenure system system total","3","0","3","0","0","0","1","0","1","0","0","0","0","0","0","0","0","0","2","0","2","0","0","0","0","0","0","0","0","0","-2"
"115409","Harvey Mudd College","2020","Not on tenure/no tenure system, instructors","3","0","3","0","0","0","1","0","1","0","0","0","0","0","0","0","0","0","2","0","2","0","0","0","0","0","0","0","0","0","-2"
"117946","Loyola Marymount University","2020","Tenured total","329","185","144","1","0","1","42","22","20","18","12","6","36","14","22","0","0","0","210","124","86","5","2","3","17","11","6","0","0","0","-2"
"117946","Loyola Marymount University","2020","Tenured, professors","213","136","77","1","0","1","25","17","8","11","8","3","22","10","12","0","0","0","138","90","48","2","1","1","14","10","4","0","0","0","-2"
"117946","Loyola Marymount University","2020","Tenured, associate professors","113","47","66","0","0","0","16","4","12","7","4","3","14","4","10","0","0","0","71","34","37","2","0","2","3","1","2","0","0","0","-2"
"117946","Loyola Marymount University","2020","Tenured, assistant professors","3","2","1","0","0","0","1","1","0","0","0","0","0","0","0","0","0","0","1","0","1","1","1","0","0","0","0","0","0","0","-2"
"117946","Loyola Marymount University","2020","On-Tenure track total","109","47","62","1","0","1","18","5","13","10","2","8","11","3","8","1","1","0","50","26","24","5","2","3","1","1","0","12","7","5","-2"
"117946","Loyola Marymount University","2020","On-tenure track, associate professors","4","1","3","0","0","0","0","0","0","0","0","0","0","0","0","0","0","0","2","1","1","1","0","1","0","0","0","1","0","1","-2"
"117946","Loyola Marymount University","2020","On-tenure track, assistant professors","105","46","59","1","0","1","18","5","13","10","2","8","11","3","8","1","1","0","48","25","23","4","2","2","1","1","0","11","7","4","-2"
"117946","Loyola Marymount University","2020","Not on tenure track/No tenure system system total","177","83","94","0","0","0","17","6","11","8","3","5","14","9","5","0","0","0","117","55","62","5","2","3","15","8","7","1","0","1","-2"
"117946","Loyola Marymount University","2020","Not on tenure/no tenure system, professors","14","8","6","0","0","0","2","0","2","0","0","0","0","0","0","0","0","0","12","8","4","0","0","0","0","0","0","0","0","0","-2"
"117946","Loyola Marymount University","2020","Not on tenure/no tenure system, associate professors","32","9","23","0","0","0","0","0","0","1","0","1","3","2","1","0","0","0","26","6","20","0","0","0","2","1","1","0","0","0","-2"
"117946","Loyola Marymount University","2020","Not on tenure/no tenure system, assistant professors","88","50","38","0","0","0","10","5","5","6","2","4","8","6","2","0","0","0","51","29","22","3","2","1","9","6","3","1","0","1","-2"
"117946","Loyola Marymount University","2020","Not on tenure/no tenure system, instructors","32","11","21","0","0","0","3","0","3","1","1","0","3","1","2","0","0","0","20","8","12","2","0","2","3","1","2","0","0","0","-2"
"117946","Loyola Marymount University","2020","Not on tenure/no tenure system, no academic rank","11","5","6","0","0","0","2","1","1","0","0","0","0","0","0","0","0","0","8","4","4","0","0","0","1","0","1","0","0","0","-2"
"120883","University of the Pacific","2020","Tenured total","226","138","88","0","0","0","40","19","21","3","1","2","9","6","3","0","0","0","165","108","57","0","0","0","0","0","0","9","4","5","-2"
"120883","University of the Pacific","2020","Tenured, professors","124","81","43","0","0","0","24","17","7","2","1","1","6","5","1","0","0","0","87","56","31","0","0","0","0","0","0","5","2","3","-2"
"120883","University of the Pacific","2020","Tenured, associate professors","98","54","44","0","0","0","16","2","14","1","0","1","3","1","2","0","0","0","74","49","25","0","0","0","0","0","0","4","2","2","-2"
"120883","University of the Pacific","2020","Tenured, assistant professors","4","3","1","0","0","0","0","0","0","0","0","0","0","0","0","0","0","0","4","3","1","0","0","0","0","0","0","0","0","0","-2"
"120883","University of the Pacific","2020","On-Tenure track total","54","27","27","1","0","1","14","6","8","0","0","0","6","2","4","0","0","0","29","18","11","2","1","1","0","0","0","2","0","2","-2"
"120883","University of the Pacific","2020","On-tenure track, associate professors","4","3","1","0","0","0","2","1","1","0","0","0","0","0","0","0","0","0","2","2","0","0","0","0","0","0","0","0","0","0","-2"
"120883","University of the Pacific","2020","On-tenure track, assistant professors","49","23","26","1","0","1","12","5","7","0","0","0","6","2","4","0","0","0","26","15","11","2","1","1","0","0","0","2","0","2","-2"
"120883","University of the Pacific","2020","On-tenure track, instructors","1","1","0","0","0","0","0","0","0","0","0","0","0","0","0","0","0","0","1","1","0","0","0","0","0","0","0","0","0","0","-2"
"120883","University of the Pacific","2020","Not on tenure track/No tenure system system total","129","61","68","1","0","1","23","9","14","7","2","5","10","5","5","0","0","0","85","45","40","1","0","1","0","0","0","2","0","2","-2"
"120883","University of the Pacific","2020","Not on tenure/no tenure system, professors","19","8","11","0","0","0","4","2","2","0","0","0","2","0","2","0","0","0","13","6","7","0","0","0","0","0","0","0","0","0","-2"
"120883","University of the Pacific","2020","Not on tenure/no tenure system, associate professors","21","11","10","0","0","0","5","1","4","0","0","0","0","0","0","0","0","0","15","10","5","0","0","0","0","0","0","1","0","1","-2"
"120883","University of the Pacific","2020","Not on tenure/no tenure system, assistant professors","64","25","39","1","0","1","12","5","7","7","2","5","7","4","3","0","0","0","36","14","22","0","0","0","0","0","0","1","0","1","-2"
"120883","University of the Pacific","2020","Not on tenure/no tenure system, instructors","9","6","3","0","0","0","2","1","1","0","0","0","1","1","0","0","0","0","6","4","2","0","0","0","0","0","0","0","0","0","-2"
"120883","University of the Pacific","2020","Not on tenure/no tenure system, lecturers","16","11","5","0","0","0","0","0","0","0","0","0","0","0","0","0","0","0","15","11","4","1","0","1","0","0","0","0","0","0","-2"
"121309","Point Loma Nazarene University","2020","Tenured total","76","47","29","0","0","0","6","3","3","3","1","2","4","1","3","0","0","0","63","42","21","0","0","0","0","0","0","0","0","0","-2"
"121309","Point Loma Nazarene University","2020","Tenured, professors","73","46","27","0","0","0","6","3","3","3","1","2","4","1","3","0","0","0","60","41","19","0","0","0","0","0","0","0","0","0","-2"
"121309","Point Loma Nazarene University","2020","Tenured, associate professors","3","1","2","0","0","0","0","0","0","0","0","0","0","0","0","0","0","0","3","1","2","0","0","0","0","0","0","0","0","0","-2"
"121309","Point Loma Nazarene University","2020","On-Tenure track total","58","20","38","1","0","1","4","1","3","1","0","1","6","2","4","0","0","0","39","12","27","3","3","0","4","2","2","0","0","0","-2"
"121309","Point Loma Nazarene University","2020","On-tenure track, professors","9","6","3","0","0","0","1","0","1","0","0","0","0","0","0","0","0","0","6","4","2","1","1","0","1","1","0","0","0","0","-2"
"121309","Point Loma Nazarene University","2020","On-tenure track, associate professors","29","8","21","0","0","0","2","0","2","1","0","1","3","1","2","0","0","0","21","6","15","1","1","0","1","0","1","0","0","0","-2"
"121309","Point Loma Nazarene University","2020","On-tenure track, assistant professors","20","6","14","1","0","1","1","1","0","0","0","0","3","1","2","0","0","0","12","2","10","1","1","0","2","1","1","0","0","0","-2"
"121309","Point Loma Nazarene University","2020","Not on tenure track/No tenure system system total","15","6","9","0","0","0","0","0","0","0","0","0","1","0","1","1","1","0","13","5","8","0","0","0","0","0","0","0","0","0","-2"
"121309","Point Loma Nazarene University","2020","Not on tenure/no tenure system, professors","1","1","0","0","0","0","0","0","0","0","0","0","0","0","0","0","0","0","1","1","0","0","0","0","0","0","0","0","0","0","-2"
"121309","Point Loma Nazarene University","2020","Not on tenure/no tenure system, associate professors","9","3","6","0","0","0","0","0","0","0","0","0","1","0","1","1","1","0","7","2","5","0","0","0","0","0","0","0","0","0","-2"
"121309","Point Loma Nazarene University","2020","Not on tenure/no tenure system, assistant professors","5","2","3","0","0","0","0","0","0","0","0","0","0","0","0","0","0","0","5","2","3","0","0","0","0","0","0","0","0","0","-2"
"121345","Pomona College","2020","Tenured total","140","78","62","0","0","0","21","6","15","5","3","2","16","11","5","0","0","0","75","43","32","3","3","0","20","12","8","0","0","0","-2"
"121345","Pomona College","2020","Tenured, professors","89","50","39","0","0","0","14","5","9","3","2","1","13","9","4","0","0","0","49","27","22","1","1","0","9","6","3","0","0","0","-2"
"121345","Pomona College","2020","Tenured, associate professors","51","28","23","0","0","0","7","1","6","2","1","1","3","2","1","0","0","0","26","16","10","2","2","0","11","6","5","0","0","0","-2"
"121345","Pomona College","2020","On-Tenure track total","33","18","15","0","0","0","4","2","2","6","3","3","5","3","2","0","0","0","12","6","6","0","0","0","4","2","2","2","2","0","-2"
"121345","Pomona College","2020","On-tenure track, assistant professors","33","18","15","0","0","0","4","2","2","6","3","3","5","3","2","0","0","0","12","6","6","0","0","0","4","2","2","2","2","0","-2"
"121345","Pomona College","2020","Not on tenure track/No tenure system system total","2","0","2","0","0","0","0","0","0","0","0","0","2","0","2","0","0","0","0","0","0","0","0","0","0","0","0","0","0","0","-2"
"121345","Pomona College","2020","Not on tenure/no tenure system, professors","2","0","2","0","0","0","0","0","0","0","0","0","2","0","2","0","0","0","0","0","0","0","0","0","0","0","0","0","0","0","-2"
"122436","University of San Diego","2020","Tenured total","290","161","129","0","0","0","34","16","18","9","6","3","26","13","13","0","0","0","214","123","91","5","2","3","2","1","1","0","0","0","-2"
"122436","University of San Diego","2020","Tenured, professors","164","101","63","0","0","0","17","8","9","4","3","1","10","6","4","0","0","0","131","82","49","2","2","0","0","0","0","0","0","0","-2"
"122436","University of San Diego","2020","Tenured, associate professors","126","60","66","0","0","0","17","8","9","5","3","2","16","7","9","0","0","0","83","41","42","3","0","3","2","1","1","0","0","0","-2"
"122436","University of San Diego","2020","On-Tenure track total","87","40","47","1","1","0","8","4","4","9","6","3","11","4","7","0","0","0","46","19","27","2","1","1","2","1","1","8","4","4","-2"
"122436","University of San Diego","2020","On-tenure track, professors","1","0","1","0","0","0","0","0","0","0","0","0","0","0","0","0","0","0","1","0","1","0","0","0","0","0","0","0","0","0","-2"
"122436","University of San Diego","2020","On-tenure track, associate professors","6","1","5","1","1","0","1","0","1","0","0","0","1","0","1","0","0","0","3","0","3","0","0","0","0","0","0","0","0","0","-2"
"122436","University of San Diego","2020","On-tenure track, assistant professors","79","38","41","0","0","0","7","4","3","9","6","3","10","4","6","0","0","0","41","18","23","2","1","1","2","1","1","8","4","4","-2"
"122436","University of San Diego","2020","On-tenure track, instructors","1","1","0","0","0","0","0","0","0","0","0","0","0","0","0","0","0","0","1","1","0","0","0","0","0","0","0","0","0","0","-2"
"122436","University of San Diego","2020","Not on tenure track/No tenure system system total","109","48","61","1","0","1","6","2","4","1","1","0","14","9","5","0","0","0","82","34","48","0","0","0","3","0","3","2","2","0","-2"
"122436","University of San Diego","2020","Not on tenure/no tenure system, professors","41","23","18","0","0","0","2","2","0","1","1","0","8","6","2","0","0","0","30","14","16","0","0","0","0","0","0","0","0","0","-2"
"122436","University of San Diego","2020","Not on tenure/no tenure system, associate professors","15","5","10","0","0","0","0","0","0","0","0","0","2","1","1","0","0","0","12","3","9","0","0","0","0","0","0","1","1","0","-2"
"122436","University of San Diego","2020","Not on tenure/no tenure system, assistant professors","34","11","23","1","0","1","3","0","3","0","0","0","2","2","0","0","0","0","26","9","17","0","0","0","2","0","2","0","0","0","-2"
"122436","University of San Diego","2020","Not on tenure/no tenure system, instructors","15","8","7","0","0","0","1","0","1","0","0","0","1","0","1","0","0","0","13","8","5","0","0","0","0","0","0","0","0","0","-2"
"122436","University of San Diego","2020","Not on tenure/no tenure system, no academic rank","4","1","3","0","0","0","0","0","0","0","0","0","1","0","1","0","0","0","1","0","1","0","0","0","1","0","1","1","1","0","-2"
"122612","University of San Francisco","2020","Tenured total","263","129","134","1","0","1","37","18","19","13","4","9","30","17","13","1","1","0","152","75","77","8","6","2","20","8","12","1","0","1","-2"
"122612","University of San Francisco","2020","Tenured, professors","134","75","59","0","0","0","15","7","8","4","2","2","14","10","4","1","1","0","86","47","39","5","4","1","9","4","5","0","0","0","-2"
"122612","University of San Francisco","2020","Tenured, associate professors","128","53","75","1","0","1","21","10","11","9","2","7","16","7","9","0","0","0","66","28","38","3","2","1","11","4","7","1","0","1","-2"
"122612","University of San Francisco","2020","Tenured, assistant professors","1","1","0","0","0","0","1","1","0","0","0","0","0","0","0","0","0","0","0","0","0","0","0","0","0","0","0","0","0","0","-2"
"122612","University of San Francisco","2020","On-Tenure track total","77","31","46","0","0","0","13","3","10","2","0","2","6","0","6","0","0","0","36","19","17","3","2","1","10","4","6","7","3","4","-2"
"122612","University of San Francisco","2020","On-tenure track, associate professors","6","3","3","0","0","0","0","0","0","0","0","0","1","0","1","0","0","0","4","2","2","0","0","0","1","1","0","0","0","0","-2"
"122612","University of San Francisco","2020","On-tenure track, assistant professors","71","28","43","0","0","0","13","3","10","2","0","2","5","0","5","0","0","0","32","17","15","3","2","1","9","3","6","7","3","4","-2"
"122612","University of San Francisco","2020","Not on tenure track/No tenure system system total","113","45","68","0","0","0","20","4","16","3","1","2","10","4","6","0","0","0","62","26","36","6","4","2","12","6","6","0","0","0","-2"
"122612","University of San Francisco","2020","Not on tenure/no tenure system, professors","14","9","5","0","0","0","3","2","1","0","0","0","1","1","0","0","0","0","9","5","4","1","1","0","0","0","0","0","0","0","-2"
"122612","University of San Francisco","2020","Not on tenure/no tenure system, associate professors","22","9","13","0","0","0","4","1","3","2","0","2","2","0","2","0","0","0","9","5","4","1","0","1","4","3","1","0","0","0","-2"
"122612","University of San Francisco","2020","Not on tenure/no tenure system, assistant professors","65","19","46","0","0","0","13","1","12","0","0","0","6","2","4","0","0","0","37","13","24","3","2","1","6","1","5","0","0","0","-2"
"122612","University of San Francisco","2020","Not on tenure/no tenure system, instructors","12","8","4","0","0","0","0","0","0","1","1","0","1","1","0","0","0","0","7","3","4","1","1","0","2","2","0","0","0","0","-2"
"122931","Santa Clara University","2020","Tenured total","293","176","117","1","1","0","58","35","23","9","5","4","23","14","9","1","1","0","195","118","77","1","1","0","5","1","4","0","0","0","-2"
"122931","Santa Clara University","2020","Tenured, professors","146","89","57","0","0","0","20","15","5","3","3","0","11","8","3","0","0","0","110","62","48","1","1","0","1","0","1","0","0","0","-2"
"122931","Santa Clara University","2020","Tenured, associate professors","147","87","60","1","1","0","38","20","18","6","2","4","12","6","6","1","1","0","85","56","29","0","0","0","4","1","3","0","0","0","-2"
"122931","Santa Clara University","2020","On-Tenure track total","107","51","56","0","0","0","17","7","10","2","1","1","9","5","4","0","0","0","46","24","22","1","0","1","16","7","9","16","7","9","-2"
"122931","Santa Clara University","2020","On-tenure track, associate professors","4","3","1","0","0","0","1","1","0","0","0","0","1","1","0","0","0","0","0","0","0","0","0","0","2","1","1","0","0","0","-2"
"122931","Santa Clara University","2020","On-tenure track, assistant professors","103","48","55","0","0","0","16","6","10","2","1","1","8","4","4","0","0","0","46","24","22","1","0","1","14","6","8","16","7","9","-2"
"122931","Santa Clara University","2020","Not on tenure track/No tenure system system total","185","83","102","0","0","0","18","8","10","6","4","2","13","5","8","0","0","0","133","61","72","2","1","1","9","1","8","4","3","1","-2"
"122931","Santa Clara University","2020","Not on tenure/no tenure system, lecturers","185","83","102","0","0","0","18","8","10","6","4","2","13","5","8","0","0","0","133","61","72","2","1","1","9","1","8","4","3","1","-2"
"123299","Shasta College","2020","Tenured total","51","32","19","0","0","0","2","2","0","1","0","1","2","2","0","0","0","0","46","28","18","0","0","0","0","0","0","0","0","0","-2"
"123299","Shasta College","2020","Tenured, instructors","51","32","19","0","0","0","2","2","0","1","0","1","2","2","0","0","0","0","46","28","18","0","0","0","0","0","0","0","0","0","-2"
"123299","Shasta College","2020","On-Tenure track total","30","19","11","0","0","0","0","0","0","0","0","0","3","2","1","0","0","0","27","17","10","0","0","0","0","0","0","0","0","0","-2"
"123299","Shasta College","2020","On-tenure track, instructors","30","19","11","0","0","0","0","0","0","0","0","0","3","2","1","0","0","0","27","17","10","0","0","0","0","0","0","0","0","0","-2"
"123299","Shasta College","2020","Not on tenure track/No tenure system system total","78","34","44","0","0","0","7","4","3","2","1","1","10","4","6","0","0","0","58","25","33","0","0","0","0","0","0","1","0","1","-2"
"123299","Shasta College","2020","Not on tenure/no tenure system, instructors","78","34","44","0","0","0","7","4","3","2","1","1","10","4","6","0","0","0","58","25","33","0","0","0","0","0","0","1","0","1","-2"
"125727","Westmont College","2020","Tenured total","61","39","22","0","0","0","5","3","2","0","0","0","2","0","2","0","0","0","54","36","18","0","0","0","0","0","0","0","0","0","-2"
"125727","Westmont College","2020","Tenured, professors","46","33","13","0","0","0","3","1","2","0","0","0","1","0","1","0","0","0","42","32","10","0","0","0","0","0","0","0","0","0","-2"
"125727","Westmont College","2020","Tenured, associate professors","15","6","9","0","0","0","2","2","0","0","0","0","1","0","1","0","0","0","12","4","8","0","0","0","0","0","0","0","0","0","-2"
"125727","Westmont College","2020","On-Tenure track total","23","7","16","1","0","1","3","3","0","3","0","3","0","0","0","0","0","0","15","4","11","0","0","0","1","0","1","0","0","0","-2"
"125727","Westmont College","2020","On-tenure track, professors","2","1","1","0","0","0","0","0","0","0","0","0","0","0","0","0","0","0","2","1","1","0","0","0","0","0","0","0","0","0","-2"
"125727","Westmont College","2020","On-tenure track, associate professors","4","1","3","1","0","1","0","0","0","0","0","0","0","0","0","0","0","0","3","1","2","0","0","0","0","0","0","0","0","0","-2"
"125727","Westmont College","2020","On-tenure track, assistant professors","17","5","12","0","0","0","3","3","0","3","0","3","0","0","0","0","0","0","10","2","8","0","0","0","1","0","1","0","0","0","-2"
"125727","Westmont College","2020","Not on tenure track/No tenure system system total","12","9","3","0","0","0","1","1","0","1","1","0","0","0","0","0","0","0","10","7","3","0","0","0","0","0","0","0","0","0","-2"
"125727","Westmont College","2020","Not on tenure/no tenure system, professors","2","2","0","0","0","0","0","0","0","1","1","0","0","0","0","0","0","0","1","1","0","0","0","0","0","0","0","0","0","0","-2"
"125727","Westmont College","2020","Not on tenure/no tenure system, associate professors","4","3","1","0","0","0","1","1","0","0","0","0","0","0","0","0","0","0","3","2","1","0","0","0","0","0","0","0","0","0","-2"
"125727","Westmont College","2020","Not on tenure/no tenure system, assistant professors","4","3","1","0","0","0","0","0","0","0","0","0","0","0","0","0","0","0","4","3","1","0","0","0","0","0","0","0","0","0","-2"
"125727","Westmont College","2020","Not on tenure/no tenure system, instructors","2","1","1","0","0","0","0","0","0","0","0","0","0","0","0","0","0","0","2","1","1","0","0","0","0","0","0","0","0","0","-2"
"126580","University of Colorado Colorado Springs","2020","Tenured total","160","99","61","0","0","0","19","10","9","2","1","1","10","7","3","0","0","0","121","77","44","0","0","0","8","4","4","0","0","0","-2"
"126580","University of Colorado Colorado Springs","2020","Tenured, professors","79","54","25","0","0","0","6","5","1","0","0","0","7","4","3","0","0","0","62","43","19","0","0","0","4","2","2","0","0","0","-2"
"126580","University of Colorado Colorado Springs","2020","Tenured, associate professors","81","45","36","0","0","0","13","5","8","2","1","1","3","3","0","0","0","0","59","34","25","0","0","0","4","2","2","0","0","0","-2"
"126580","University of Colorado Colorado Springs","2020","On-Tenure track total","110","53","57","1","0","1","10","8","2","4","1","3","6","3","3","1","0","1","68","32","36","2","0","2","14","6","8","4","3","1","-2"
"126580","University of Colorado Colorado Springs","2020","On-tenure track, assistant professors","110","53","57","1","0","1","10","8","2","4","1","3","6","3","3","1","0","1","68","32","36","2","0","2","14","6","8","4","3","1","-2"
"126580","University of Colorado Colorado Springs","2020","Not on tenure track/No tenure system system total","187","75","112","1","0","1","7","0","7","3","1","2","13","7","6","0","0","0","141","57","84","5","3","2","16","6","10","1","1","0","-2"
"126580","University of Colorado Colorado Springs","2020","Not on tenure/no tenure system, assistant professors","2","2","0","0","0","0","0","0","0","0","0","0","0","0","0","0","0","0","0","0","0","1","1","0","1","1","0","0","0","0","-2"
"126580","University of Colorado Colorado Springs","2020","Not on tenure/no tenure system, instructors","185","73","112","1","0","1","7","0","7","3","1","2","13","7","6","0","0","0","141","57","84","4","2","2","15","5","10","1","1","0","-2"
"127556","Colorado Mesa University","2020","Tenured total","109","66","43","0","0","0","3","2","1","0","0","0","1","1","0","0","0","0","88","51","37","0","0","0","14","11","3","3","1","2","-2"
"127556","Colorado Mesa University","2020","Tenured, professors","56","35","21","0","0","0","0","0","0","0","0","0","1","1","0","0","0","0","46","29","17","0","0","0","8","5","3","1","0","1","-2"
"127556","Colorado Mesa University","2020","Tenured, associate professors","52","30","22","0","0","0","3","2","1","0","0","0","0","0","0","0","0","0","41","21","20","0","0","0","6","6","0","2","1","1","-2"
"127556","Colorado Mesa University","2020","Tenured, assistant professors","1","1","0","0","0","0","0","0","0","0","0","0","0","0","0","0","0","0","1","1","0","0","0","0","0","0","0","0","0","0","-2"
"127556","Colorado Mesa University","2020","On-Tenure track total","84","38","46","0","0","0","1","0","1","3","1","2","3","2","1","0","0","0","62","24","38","0","0","0","6","4","2","9","7","2","-2"
"127556","Colorado Mesa University","2020","On-tenure track, associate professors","4","3","1","0","0","0","0","0","0","0","0","0","0","0","0","0","0","0","1","1","0","0","0","0","2","1","1","1","1","0","-2"
"127556","Colorado Mesa University","2020","On-tenure track, assistant professors","78","34","44","0","0","0","1","0","1","3","1","2","3","2","1","0","0","0","60","23","37","0","0","0","4","3","1","7","5","2","-2"
"127556","Colorado Mesa University","2020","On-tenure track, instructors","1","0","1","0","0","0","0","0","0","0","0","0","0","0","0","0","0","0","1","0","1","0","0","0","0","0","0","0","0","0","-2"
"127556","Colorado Mesa University","2020","On-tenure track, no academic rank","1","1","0","0","0","0","0","0","0","0","0","0","0","0","0","0","0","0","0","0","0","0","0","0","0","0","0","1","1","0","-2"
"127556","Colorado Mesa University","2020","Not on tenure track/No tenure system system total","120","58","62","0","0","0","0","0","0","0","0","0","5","2","3","0","0","0","100","50","50","1","0","1","11","4","7","3","2","1","-2"
"127556","Colorado Mesa University","2020","Not on tenure/no tenure system, professors","1","0","1","0","0","0","0","0","0","0","0","0","0","0","0","0","0","0","1","0","1","0","0","0","0","0","0","0","0","0","-2"
"127556","Colorado Mesa University","2020","Not on tenure/no tenure system, instructors","115","56","59","0","0","0","0","0","0","0","0","0","5","2","3","0","0","0","96","49","47","1","0","1","11","4","7","2","1","1","-2"
"127556","Colorado Mesa University","2020","Not on tenure/no tenure system, lecturers","3","1","2","0","0","0","0","0","0","0","0","0","0","0","0","0","0","0","3","1","2","0","0","0","0","0","0","0","0","0","-2"
"127556","Colorado Mesa University","2020","Not on tenure/no tenure system, no academic rank","1","1","0","0","0","0","0","0","0","0","0","0","0","0","0","0","0","0","0","0","0","0","0","0","0","0","0","1","1","0","-2"
"127918","Regis University","2020","Tenured total","78","43","35","0","0","0","3","2","1","4","4","0","6","2","4","0","0","0","65","35","30","0","0","0","0","0","0","0","0","0","-2"
"127918","Regis University","2020","Tenured, professors","33","18","15","0","0","0","1","1","0","1","1","0","4","2","2","0","0","0","27","14","13","0","0","0","0","0","0","0","0","0","-2"
"127918","Regis University","2020","Tenured, associate professors","45","25","20","0","0","0","2","1","1","3","3","0","2","0","2","0","0","0","38","21","17","0","0","0","0","0","0","0","0","0","-2"
"127918","Regis University","2020","On-Tenure track total","30","11","19","0","0","0","4","1","3","1","1","0","2","1","1","0","0","0","23","8","15","0","0","0","0","0","0","0","0","0","-2"
"127918","Regis University","2020","On-tenure track, professors","1","0","1","0","0","0","0","0","0","0","0","0","0","0","0","0","0","0","1","0","1","0","0","0","0","0","0","0","0","0","-2"
"127918","Regis University","2020","On-tenure track, associate professors","3","2","1","0","0","0","0","0","0","0","0","0","0","0","0","0","0","0","3","2","1","0","0","0","0","0","0","0","0","0","-2"
"127918","Regis University","2020","On-tenure track, assistant professors","26","9","17","0","0","0","4","1","3","1","1","0","2","1","1","0","0","0","19","6","13","0","0","0","0","0","0","0","0","0","-2"
"127918","Regis University","2020","Not on tenure track/No tenure system system total","200","75","125","0","0","0","5","1","4","5","2","3","12","7","5","0","0","0","176","64","112","0","0","0","2","1","1","0","0","0","-2"
"127918","Regis University","2020","Not on tenure/no tenure system, professors","43","19","24","0","0","0","2","1","1","3","1","2","2","2","0","0","0","0","36","15","21","0","0","0","0","0","0","0","0","0","-2"
"127918","Regis University","2020","Not on tenure/no tenure system, associate professors","54","18","36","0","0","0","2","0","2","1","0","1","2","1","1","0","0","0","49","17","32","0","0","0","0","0","0","0","0","0","-2"
"127918","Regis University","2020","Not on tenure/no tenure system, assistant professors","48","12","36","0","0","0","0","0","0","0","0","0","2","1","1","0","0","0","45","10","35","0","0","0","1","1","0","0","0","0","-2"
"127918","Regis University","2020","Not on tenure/no tenure system, instructors","37","16","21","0","0","0","1","0","1","1","1","0","5","2","3","0","0","0","29","13","16","0","0","0","1","0","1","0","0","0","-2"
"127918","Regis University","2020","Not on tenure/no tenure system, lecturers","17","10","7","0","0","0","0","0","0","0","0","0","1","1","0","0","0","0","16","9","7","0","0","0","0","0","0","0","0","0","-2"
"127918","Regis University","2020","Not on tenure/no tenure system, no academic rank","1","0","1","0","0","0","0","0","0","0","0","0","0","0","0","0","0","0","1","0","1","0","0","0","0","0","0","0","0","0","-2"
"128391","Western Colorado University","2020","Tenured total","60","38","22","0","0","0","0","0","0","0","0","0","2","0","2","1","0","1","53","35","18","4","3","1","0","0","0","0","0","0","-2"
"128391","Western Colorado University","2020","Tenured, professors","46","31","15","0","0","0","0","0","0","0","0","0","1","0","1","1","0","1","41","29","12","3","2","1","0","0","0","0","0","0","-2"
"128391","Western Colorado University","2020","Tenured, associate professors","14","7","7","0","0","0","0","0","0","0","0","0","1","0","1","0","0","0","12","6","6","1","1","0","0","0","0","0","0","0","-2"
"128391","Western Colorado University","2020","On-Tenure track total","25","16","9","0","0","0","0","0","0","1","1","0","0","0","0","0","0","0","22","14","8","2","1","1","0","0","0","0","0","0","-2"
"128391","Western Colorado University","2020","On-tenure track, professors","1","1","0","0","0","0","0","0","0","0","0","0","0","0","0","0","0","0","1","1","0","0","0","0","0","0","0","0","0","0","-2"
"128391","Western Colorado University","2020","On-tenure track, associate professors","2","1","1","0","0","0","0","0","0","0","0","0","0","0","0","0","0","0","1","1","0","1","0","1","0","0","0","0","0","0","-2"
"128391","Western Colorado University","2020","On-tenure track, assistant professors","22","14","8","0","0","0","0","0","0","1","1","0","0","0","0","0","0","0","20","12","8","1","1","0","0","0","0","0","0","0","-2"
"128391","Western Colorado University","2020","Not on tenure track/No tenure system system total","51","25","26","0","0","0","3","1","2","0","0","0","1","1","0","0","0","0","45","22","23","1","0","1","0","0","0","1","1","0","-2"
"128391","Western Colorado University","2020","Not on tenure/no tenure system, lecturers","51","25","26","0","0","0","3","1","2","0","0","0","1","1","0","0","0","0","45","22","23","1","0","1","0","0","0","1","1","0","-2"
"128498","Albertus Magnus College","2020","Tenured total","5","2","3","0","0","0","0","0","0","0","0","0","0","0","0","0","0","0","5","2","3","0","0","0","0","0","0","0","0","0","-2"
"128498","Albertus Magnus College","2020","Tenured, professors","5","2","3","0","0","0","0","0","0","0","0","0","0","0","0","0","0","0","5","2","3","0","0","0","0","0","0","0","0","0","-2"
"128498","Albertus Magnus College","2020","Not on tenure track/No tenure system system total","44","22","22","0","0","0","3","1","2","3","1","2","0","0","0","0","0","0","38","20","18","0","0","0","0","0","0","0","0","0","-2"
"128498","Albertus Magnus College","2020","Not on tenure/no tenure system, professors","15","12","3","0","0","0","1","1","0","0","0","0","0","0","0","0","0","0","14","11","3","0","0","0","0","0","0","0","0","0","-2"
"128498","Albertus Magnus College","2020","Not on tenure/no tenure system, associate professors","12","3","9","0","0","0","0","0","0","0","0","0","0","0","0","0","0","0","12","3","9","0","0","0","0","0","0","0","0","0","-2"
"128498","Albertus Magnus College","2020","Not on tenure/no tenure system, assistant professors","16","7","9","0","0","0","2","0","2","3","1","2","0","0","0","0","0","0","11","6","5","0","0","0","0","0","0","0","0","0","-2"
"128498","Albertus Magnus College","2020","Not on tenure/no tenure system, instructors","1","0","1","0","0","0","0","0","0","0","0","0","0","0","0","0","0","0","1","0","1","0","0","0","0","0","0","0","0","0","-2"
"128771","Central Connecticut State University","2020","Tenured total","320","188","132","1","1","0","38","26","12","16","8","8","20","12","8","0","0","0","239","137","102","4","3","1","0","0","0","2","1","1","-2"
"128771","Central Connecticut State University","2020","Tenured, professors","200","127","73","1","1","0","22","15","7","13","7","6","13","10","3","0","0","0","150","94","56","1","0","1","0","0","0","0","0","0","-2"
"128771","Central Connecticut State University","2020","Tenured, associate professors","112","58","54","0","0","0","16","11","5","3","1","2","7","2","5","0","0","0","81","40","41","3","3","0","0","0","0","2","1","1","-2"
"128771","Central Connecticut State University","2020","Tenured, assistant professors","8","3","5","0","0","0","0","0","0","0","0","0","0","0","0","0","0","0","8","3","5","0","0","0","0","0","0","0","0","0","-2"
"128771","Central Connecticut State University","2020","On-Tenure track total","97","47","50","0","0","0","7","4","3","7","4","3","6","3","3","0","0","0","54","20","34","0","0","0","3","2","1","20","14","6","-2"
"128771","Central Connecticut State University","2020","On-tenure track, associate professors","21","12","9","0","0","0","2","2","0","1","1","0","1","1","0","0","0","0","10","3","7","0","0","0","2","1","1","5","4","1","-2"
"128771","Central Connecticut State University","2020","On-tenure track, assistant professors","76","35","41","0","0","0","5","2","3","6","3","3","5","2","3","0","0","0","44","17","27","0","0","0","1","1","0","15","10","5","-2"
"128771","Central Connecticut State University","2020","Not on tenure track/No tenure system system total","11","6","5","0","0","0","1","1","0","1","1","0","0","0","0","0","0","0","9","4","5","0","0","0","0","0","0","0","0","0","-2"
"128771","Central Connecticut State University","2020","Not on tenure/no tenure system, associate professors","3","1","2","0","0","0","0","0","0","0","0","0","0","0","0","0","0","0","3","1","2","0","0","0","0","0","0","0","0","0","-2"
"128771","Central Connecticut State University","2020","Not on tenure/no tenure system, assistant professors","6","4","2","0","0","0","1","1","0","1","1","0","0","0","0","0","0","0","4","2","2","0","0","0","0","0","0","0","0","0","-2"
"128771","Central Connecticut State University","2020","Not on tenure/no tenure system, instructors","2","1","1","0","0","0","0","0","0","0","0","0","0","0","0","0","0","0","2","1","1","0","0","0","0","0","0","0","0","0","-2"
"134130","University of Florida","2020","Tenured total","1500","1068","432","1","0","1","203","155","48","51","27","24","87","64","23","0","0","0","1131","801","330","18","13","5","4","4","0","5","4","1","-2"
"134130","University of Florida","2020","Tenured, professors","999","755","244","0","0","0","129","102","27","25","16","9","55","41","14","0","0","0","774","583","191","8","6","2","3","3","0","5","4","1","-2"
"134130","University of Florida","2020","Tenured, associate professors","499","311","188","1","0","1","74","53","21","26","11","15","32","23","9","0","0","0","355","216","139","10","7","3","1","1","0","0","0","0","-2"
"134130","University of Florida","2020","Tenured, assistant professors","2","2","0","0","0","0","0","0","0","0","0","0","0","0","0","0","0","0","2","2","0","0","0","0","0","0","0","0","0","0","-2"
"134130","University of Florida","2020","On-Tenure track total","697","410","287","2","1","1","103","54","49","30","11","19","58","39","19","0","0","0","373","212","161","13","9","4","21","17","4","97","67","30","-2"
"134130","University of Florida","2020","On-tenure track, professors","29","22","7","0","0","0","5","4","1","1","1","0","2","2","0","0","0","0","19","13","6","1","1","0","0","0","0","1","1","0","-2"
"134130","University of Florida","2020","On-tenure track, associate professors","67","47","20","0","0","0","19","13","6","2","1","1","8","7","1","0","0","0","38","26","12","0","0","0","0","0","0","0","0","0","-2"
"134130","University of Florida","2020","On-tenure track, assistant professors","599","341","258","2","1","1","78","37","41","27","9","18","48","30","18","0","0","0","315","173","142","12","8","4","21","17","4","96","66","30","-2"
"134130","University of Florida","2020","On-tenure track, lecturers","2","0","2","0","0","0","1","0","1","0","0","0","0","0","0","0","0","0","1","0","1","0","0","0","0","0","0","0","0","0","-2"
"134130","University of Florida","2020","Not on tenure track/No tenure system system total","705","282","423","2","0","2","38","10","28","43","12","31","61","23","38","1","1","0","512","215","297","10","6","4","4","1","3","34","14","20","-2"
"134130","University of Florida","2020","Not on tenure/no tenure system, professors","33","19","14","0","0","0","0","0","0","1","1","0","2","2","0","0","0","0","28","16","12","1","0","1","1","0","1","0","0","0","-2"
"134130","University of Florida","2020","Not on tenure/no tenure system, associate professors","20","8","12","0","0","0","1","0","1","0","0","0","2","1","1","0","0","0","17","7","10","0","0","0","0","0","0","0","0","0","-2"
"134130","University of Florida","2020","Not on tenure/no tenure system, assistant professors","110","31","79","0","0","0","6","1","5","9","2","7","8","2","6","0","0","0","75","20","55","2","1","1","1","0","1","9","5","4","-2"
"134130","University of Florida","2020","Not on tenure/no tenure system, lecturers","451","186","265","2","0","2","24","5","19","29","6","23","43","17","26","1","1","0","319","143","176","6","4","2","2","1","1","25","9","16","-2"
"134130","University of Florida","2020","Not on tenure/no tenure system, no academic rank","91","38","53","0","0","0","7","4","3","4","3","1","6","1","5","0","0","0","73","29","44","1","1","0","0","0","0","0","0","0","-2"
"136330","Palm Beach Atlantic University","2020","Not on tenure track/No tenure system system total","164","91","73","0","0","0","4","1","3","11","2","9","15","10","5","0","0","0","120","71","49","4","3","1","2","1","1","8","3","5","-2"
"136330","Palm Beach Atlantic University","2020","Not on tenure/no tenure system, professors","44","32","12","0","0","0","1","1","0","3","2","1","1","1","0","0","0","0","38","27","11","0","0","0","0","0","0","1","1","0","-2"
"136330","Palm Beach Atlantic University","2020","Not on tenure/no tenure system, associate professors","61","33","28","0","0","0","3","0","3","5","0","5","2","2","0","0","0","0","43","28","15","1","0","1","2","1","1","5","2","3","-2"
"136330","Palm Beach Atlantic University","2020","Not on tenure/no tenure system, assistant professors","52","23","29","0","0","0","0","0","0","3","0","3","10","7","3","0","0","0","37","16","21","0","0","0","0","0","0","2","0","2","-2"
"136330","Palm Beach Atlantic University","2020","Not on tenure/no tenure system, instructors","7","3","4","0","0","0","0","0","0","0","0","0","2","0","2","0","0","0","2","0","2","3","3","0","0","0","0","0","0","0","-2"
"136950","Rollins College","2020","Tenured total","131","71","60","0","0","0","7","2","5","7","6","1","7","4","3","0","0","0","105","55","50","1","1","0","3","2","1","1","1","0","-2"
"136950","Rollins College","2020","Tenured, professors","72","39","33","0","0","0","5","2","3","0","0","0","6","4","2","0","0","0","60","32","28","1","1","0","0","0","0","0","0","0","-2"
"136950","Rollins College","2020","Tenured, associate professors","59","32","27","0","0","0","2","0","2","7","6","1","1","0","1","0","0","0","45","23","22","0","0","0","3","2","1","1","1","0","-2"
"136950","Rollins College","2020","On-Tenure track total","45","17","28","0","0","0","1","0","1","6","2","4","1","0","1","0","0","0","30","11","19","0","0","0","2","2","0","5","2","3","-2"
"136950","Rollins College","2020","On-tenure track, assistant professors","45","17","28","0","0","0","1","0","1","6","2","4","1","0","1","0","0","0","30","11","19","0","0","0","2","2","0","5","2","3","-2"
"136950","Rollins College","2020","Not on tenure track/No tenure system system total","30","13","17","0","0","0","1","1","0","0","0","0","3","1","2","0","0","0","23","10","13","0","0","0","1","1","0","2","0","2","-2"
"136950","Rollins College","2020","Not on tenure/no tenure system, professors","1","1","0","0","0","0","0","0","0","0","0","0","0","0","0","0","0","0","1","1","0","0","0","0","0","0","0","0","0","0","-2"
"136950","Rollins College","2020","Not on tenure/no tenure system, assistant professors","5","1","4","0","0","0","0","0","0","0","0","0","0","0","0","0","0","0","4","1","3","0","0","0","0","0","0","1","0","1","-2"
"136950","Rollins College","2020","Not on tenure/no tenure system, lecturers","24","11","13","0","0","0","1","1","0","0","0","0","3","1","2","0","0","0","18","8","10","0","0","0","1","1","0","1","0","1","-2"
"137546","Stetson University","2020","Tenured total","166","89","77","0","0","0","6","2","4","8","3","5","8","4","4","0","0","0","136","75","61","3","1","2","2","1","1","3","3","0","-2"
"137546","Stetson University","2020","Tenured, professors","101","54","47","0","0","0","4","2","2","5","2","3","5","2","3","0","0","0","84","46","38","1","1","0","1","0","1","1","1","0","-2"
"137546","Stetson University","2020","Tenured, associate professors","65","35","30","0","0","0","2","0","2","3","1","2","3","2","1","0","0","0","52","29","23","2","0","2","1","1","0","2","2","0","-2"
"137546","Stetson University","2020","On-Tenure track total","54","24","30","0","0","0","3","0","3","4","1","3","3","1","2","0","0","0","37","17","20","1","0","1","1","1","0","5","4","1","-2"
"137546","Stetson University","2020","On-tenure track, associate professors","2","0","2","0","0","0","0","0","0","0","0","0","1","0","1","0","0","0","1","0","1","0","0","0","0","0","0","0","0","0","-2"
"137546","Stetson University","2020","On-tenure track, assistant professors","52","24","28","0","0","0","3","0","3","4","1","3","2","1","1","0","0","0","36","17","19","1","0","1","1","1","0","5","4","1","-2"
"137546","Stetson University","2020","Not on tenure track/No tenure system system total","58","23","35","0","0","0","2","2","0","0","0","0","4","1","3","0","0","0","50","18","32","0","0","0","1","1","0","1","1","0","-2"
"137546","Stetson University","2020","Not on tenure/no tenure system, professors","2","2","0","0","0","0","0","0","0","0","0","0","0","0","0","0","0","0","2","2","0","0","0","0","0","0","0","0","0","0","-2"
"137546","Stetson University","2020","Not on tenure/no tenure system, assistant professors","8","3","5","0","0","0","0","0","0","0","0","0","1","0","1","0","0","0","5","1","4","0","0","0","1","1","0","1","1","0","-2"
"137546","Stetson University","2020","Not on tenure/no tenure system, no academic rank","48","18","30","0","0","0","2","2","0","0","0","0","3","1","2","0","0","0","43","15","28","0","0","0","0","0","0","0","0","0","-2"
"141565","University of Hawaii at Hilo","2020","Tenured total","131","77","54","1","1","0","40","23","17","1","1","0","3","3","0","11","4","7","71","41","30","1","1","0","0","0","0","3","3","0","-2"
"141565","University of Hawaii at Hilo","2020","Tenured, professors","73","38","35","1","1","0","24","12","12","1","1","0","1","1","0","1","1","0","44","21","23","0","0","0","0","0","0","1","1","0","-2"
"141565","University of Hawaii at Hilo","2020","Tenured, associate professors","56","37","19","0","0","0","15","10","5","0","0","0","2","2","0","10","3","7","27","20","7","1","1","0","0","0","0","1","1","0","-2"
"141565","University of Hawaii at Hilo","2020","Tenured, assistant professors","2","2","0","0","0","0","1","1","0","0","0","0","0","0","0","0","0","0","0","0","0","0","0","0","0","0","0","1","1","0","-2"
"141565","University of Hawaii at Hilo","2020","On-Tenure track total","35","21","14","0","0","0","10","7","3","0","0","0","0","0","0","3","0","3","16","11","5","5","2","3","0","0","0","1","1","0","-2"
"141565","University of Hawaii at Hilo","2020","On-tenure track, associate professors","1","0","1","0","0","0","0","0","0","0","0","0","0","0","0","0","0","0","1","0","1","0","0","0","0","0","0","0","0","0","-2"
"141565","University of Hawaii at Hilo","2020","On-tenure track, assistant professors","34","21","13","0","0","0","10","7","3","0","0","0","0","0","0","3","0","3","15","11","4","5","2","3","0","0","0","1","1","0","-2"
"141565","University of Hawaii at Hilo","2020","Not on tenure track/No tenure system system total","25","8","17","0","0","0","4","1","3","0","0","0","1","0","1","1","0","1","16","5","11","1","1","0","0","0","0","2","1","1","-2"
"141565","University of Hawaii at Hilo","2020","Not on tenure/no tenure system, assistant professors","1","0","1","0","0","0","0","0","0","0","0","0","0","0","0","1","0","1","0","0","0","0","0","0","0","0","0","0","0","0","-2"
"141565","University of Hawaii at Hilo","2020","Not on tenure/no tenure system, instructors","24","8","16","0","0","0","4","1","3","0","0","0","1","0","1","0","0","0","16","5","11","1","1","0","0","0","0","2","1","1","-2"
"142559","College of Southern Idaho","2020","Not on tenure track/No tenure system system total","138","68","70","1","0","1","2","0","2","1","1","0","5","1","4","0","0","0","125","64","61","2","1","1","1","1","0","1","0","1","-2"
"142559","College of Southern Idaho","2020","Not on tenure/no tenure system, professors","54","24","30","1","0","1","0","0","0","0","0","0","4","1","3","0","0","0","49","23","26","0","0","0","0","0","0","0","0","0","-2"
"142559","College of Southern Idaho","2020","Not on tenure/no tenure system, associate professors","23","12","11","0","0","0","0","0","0","0","0","0","0","0","0","0","0","0","23","12","11","0","0","0","0","0","0","0","0","0","-2"
"142559","College of Southern Idaho","2020","Not on tenure/no tenure system, assistant professors","18","12","6","0","0","0","1","0","1","0","0","0","0","0","0","0","0","0","16","11","5","1","1","0","0","0","0","0","0","0","-2"
"142559","College of Southern Idaho","2020","Not on tenure/no tenure system, instructors","43","20","23","0","0","0","1","0","1","1","1","0","1","0","1","0","0","0","37","18","19","1","0","1","1","1","0","1","0","1","-2"
"144281","Columbia College Chicago","2020","Tenured total","174","97","77","0","0","0","5","1","4","11","4","7","9","6","3","0","0","0","145","85","60","1","0","1","3","1","2","0","0","0","-2"
"144281","Columbia College Chicago","2020","Tenured, professors","38","22","16","0","0","0","1","0","1","2","1","1","3","2","1","0","0","0","31","19","12","0","0","0","1","0","1","0","0","0","-2"
"144281","Columbia College Chicago","2020","Tenured, associate professors","136","75","61","0","0","0","4","1","3","9","3","6","6","4","2","0","0","0","114","66","48","1","0","1","2","1","1","0","0","0","-2"
"144281","Columbia College Chicago","2020","On-Tenure track total","33","18","15","0","0","0","1","0","1","5","4","1","4","3","1","0","0","0","19","10","9","0","0","0","4","1","3","0","0","0","-2"
"144281","Columbia College Chicago","2020","On-tenure track, assistant professors","33","18","15","0","0","0","1","0","1","5","4","1","4","3","1","0","0","0","19","10","9","0","0","0","4","1","3","0","0","0","-2"
"144281","Columbia College Chicago","2020","Not on tenure track/No tenure system system total","53","27","26","0","0","0","1","0","1","5","0","5","2","2","0","0","0","0","43","23","20","0","0","0","2","2","0","0","0","0","-2"
"144281","Columbia College Chicago","2020","Not on tenure/no tenure system, lecturers","53","27","26","0","0","0","1","0","1","5","0","5","2","2","0","0","0","0","43","23","20","0","0","0","2","2","0","0","0","0","-2"
"144740","DePaul University","2020","Tenured total","531","297","234","2","1","1","36","21","15","37","20","17","34","16","18","0","0","0","325","184","141","6","3","3","42","23","19","49","29","20","-2"
"144740","DePaul University","2020","Tenured, professors","196","122","74","0","0","0","12","9","3","8","4","4","11","5","6","0","0","0","138","88","50","2","1","1","13","5","8","12","10","2","-2"
"144740","DePaul University","2020","Tenured, associate professors","334","174","160","2","1","1","24","12","12","29","16","13","23","11","12","0","0","0","187","96","91","4","2","2","28","17","11","37","19","18","-2"
"144740","DePaul University","2020","Tenured, assistant professors","1","1","0","0","0","0","0","0","0","0","0","0","0","0","0","0","0","0","0","0","0","0","0","0","1","1","0","0","0","0","-2"
"144740","DePaul University","2020","On-Tenure track total","126","59","67","0","0","0","6","2","4","8","3","5","6","4","2","0","0","0","47","20","27","1","1","0","37","13","24","21","16","5","-2"
"144740","DePaul University","2020","On-tenure track, associate professors","4","0","4","0","0","0","1","0","1","0","0","0","0","0","0","0","0","0","0","0","0","0","0","0","3","0","3","0","0","0","-2"
"144740","DePaul University","2020","On-tenure track, assistant professors","122","59","63","0","0","0","5","2","3","8","3","5","6","4","2","0","0","0","47","20","27","1","1","0","34","13","21","21","16","5","-2"
"144740","DePaul University","2020","Not on tenure track/No tenure system system total","217","109","108","1","1","0","9","7","2","10","5","5","13","7","6","0","0","0","147","71","76","2","2","0","27","13","14","8","3","5","-2"
"144740","DePaul University","2020","Not on tenure/no tenure system, associate professors","1","0","1","0","0","0","0","0","0","0","0","0","0","0","0","0","0","0","0","0","0","0","0","0","1","0","1","0","0","0","-2"
"144740","DePaul University","2020","Not on tenure/no tenure system, assistant professors","2","1","1","0","0","0","0","0","0","0","0","0","0","0","0","0","0","0","2","1","1","0","0","0","0","0","0","0","0","0","-2"
"144740","DePaul University","2020","Not on tenure/no tenure system, instructors","214","108","106","1","1","0","9","7","2","10","5","5","13","7","6","0","0","0","145","70","75","2","2","0","26","13","13","8","3","5","-2"
"144962","Elmhurst University","2020","Tenured total","86","36","50","0","0","0","5","4","1","3","1","2","4","2","2","0","0","0","73","28","45","0","0","0","1","1","0","0","0","0","-2"
"144962","Elmhurst University","2020","Tenured, professors","56","24","32","0","0","0","4","3","1","2","1","1","2","1","1","0","0","0","48","19","29","0","0","0","0","0","0","0","0","0","-2"
"144962","Elmhurst University","2020","Tenured, associate professors","28","11","17","0","0","0","1","1","0","1","0","1","2","1","1","0","0","0","23","8","15","0","0","0","1","1","0","0","0","0","-2"
"144962","Elmhurst University","2020","Tenured, assistant professors","2","1","1","0","0","0","0","0","0","0","0","0","0","0","0","0","0","0","2","1","1","0","0","0","0","0","0","0","0","0","-2"
"144962","Elmhurst University","2020","On-Tenure track total","31","13","18","0","0","0","3","1","2","1","1","0","0","0","0","0","0","0","27","11","16","0","0","0","0","0","0","0","0","0","-2"
"144962","Elmhurst University","2020","On-tenure track, assistant professors","27","11","16","0","0","0","2","0","2","0","0","0","0","0","0","0","0","0","25","11","14","0","0","0","0","0","0","0","0","0","-2"
"144962","Elmhurst University","2020","On-tenure track, instructors","1","0","1","0","0","0","0","0","0","0","0","0","0","0","0","0","0","0","1","0","1","0","0","0","0","0","0","0","0","0","-2"
"144962","Elmhurst University","2020","On-tenure track, lecturers","1","1","0","0","0","0","0","0","0","1","1","0","0","0","0","0","0","0","0","0","0","0","0","0","0","0","0","0","0","0","-2"
"144962","Elmhurst University","2020","On-tenure track, no academic rank","2","1","1","0","0","0","1","1","0","0","0","0","0","0","0","0","0","0","1","0","1","0","0","0","0","0","0","0","0","0","-2"
"144962","Elmhurst University","2020","Not on tenure track/No tenure system system total","41","13","28","0","0","0","3","0","3","3","1","2","3","2","1","0","0","0","32","10","22","0","0","0","0","0","0","0","0","0","-2"
"144962","Elmhurst University","2020","Not on tenure/no tenure system, associate professors","5","2","3","0","0","0","0","0","0","1","0","1","0","0","0","0","0","0","4","2","2","0","0","0","0","0","0","0","0","0","-2"
"144962","Elmhurst University","2020","Not on tenure/no tenure system, assistant professors","18","5","13","0","0","0","1","0","1","0","0","0","1","1","0","0","0","0","16","4","12","0","0","0","0","0","0","0","0","0","-2"
"144962","Elmhurst University","2020","Not on tenure/no tenure system, lecturers","15","5","10","0","0","0","1","0","1","2","1","1","2","1","1","0","0","0","10","3","7","0","0","0","0","0","0","0","0","0","-2"
"144962","Elmhurst University","2020","Not on tenure/no tenure system, no academic rank","3","1","2","0","0","0","1","0","1","0","0","0","0","0","0","0","0","0","2","1","1","0","0","0","0","0","0","0","0","0","-2"
"145336","Governors State University","2020","Tenured total","80","42","38","0","0","0","15","10","5","13","6","7","0","0","0","0","0","0","39","21","18","2","0","2","11","5","6","0","0","0","-2"
"145336","Governors State University","2020","Tenured, professors","32","18","14","0","0","0","6","5","1","4","1","3","0","0","0","0","0","0","16","9","7","1","0","1","5","3","2","0","0","0","-2"
"145336","Governors State University","2020","Tenured, associate professors","48","24","24","0","0","0","9","5","4","9","5","4","0","0","0","0","0","0","23","12","11","1","0","1","6","2","4","0","0","0","-2"
"145336","Governors State University","2020","On-Tenure track total","93","30","63","2","0","2","10","5","5","18","5","13","4","0","4","0","0","0","51","16","35","1","0","1","5","3","2","2","1","1","-2"
"145336","Governors State University","2020","On-tenure track, associate professors","24","8","16","0","0","0","4","2","2","2","1","1","1","0","1","0","0","0","16","5","11","1","0","1","0","0","0","0","0","0","-2"
"145336","Governors State University","2020","On-tenure track, assistant professors","68","22","46","2","0","2","6","3","3","16","4","12","3","0","3","0","0","0","35","11","24","0","0","0","4","3","1","2","1","1","-2"
"145336","Governors State University","2020","On-tenure track, instructors","1","0","1","0","0","0","0","0","0","0","0","0","0","0","0","0","0","0","0","0","0","0","0","0","1","0","1","0","0","0","-2"
"145336","Governors State University","2020","Not on tenure track/No tenure system system total","68","29","39","0","0","0","6","3","3","11","4","7","2","1","1","0","0","0","40","17","23","2","1","1","7","3","4","0","0","0","-2"
"145336","Governors State University","2020","Not on tenure/no tenure system, lecturers","58","23","35","0","0","0","3","1","2","11","4","7","1","1","0","0","0","0","34","13","21","2","1","1","7","3","4","0","0","0","-2"
"145336","Governors State University","2020","Not on tenure/no tenure system, no academic rank","10","6","4","0","0","0","3","2","1","0","0","0","1","0","1","0","0","0","6","4","2","0","0","0","0","0","0","0","0","0","-2"
"145619","Benedictine University","2020","Tenured total","71","37","34","0","0","0","8","3","5","2","1","1","1","1","0","0","0","0","58","31","27","0","0","0","2","1","1","0","0","0","-2"
"145619","Benedictine University","2020","Tenured, professors","47","27","20","0","0","0","5","3","2","2","1","1","1","1","0","0","0","0","38","22","16","0","0","0","1","0","1","0","0","0","-2"
"145619","Benedictine University","2020","Tenured, associate professors","24","10","14","0","0","0","3","0","3","0","0","0","0","0","0","0","0","0","20","9","11","0","0","0","1","1","0","0","0","0","-2"
"145619","Benedictine University","2020","On-Tenure track total","38","15","23","0","0","0","7","3","4","2","1","1","1","0","1","0","0","0","28","11","17","0","0","0","0","0","0","0","0","0","-2"
"145619","Benedictine University","2020","On-tenure track, associate professors","8","3","5","0","0","0","0","0","0","0","0","0","0","0","0","0","0","0","8","3","5","0","0","0","0","0","0","0","0","0","-2"
"145619","Benedictine University","2020","On-tenure track, assistant professors","30","12","18","0","0","0","7","3","4","2","1","1","1","0","1","0","0","0","20","8","12","0","0","0","0","0","0","0","0","0","-2"
"145619","Benedictine University","2020","Not on tenure track/No tenure system system total","32","16","16","0","0","0","2","1","1","0","0","0","1","1","0","0","0","0","28","13","15","0","0","0","1","1","0","0","0","0","-2"
"145619","Benedictine University","2020","Not on tenure/no tenure system, professors","1","0","1","0","0","0","0","0","0","0","0","0","0","0","0","0","0","0","1","0","1","0","0","0","0","0","0","0","0","0","-2"
"145619","Benedictine University","2020","Not on tenure/no tenure system, associate professors","3","2","1","0","0","0","0","0","0","0","0","0","1","1","0","0","0","0","2","1","1","0","0","0","0","0","0","0","0","0","-2"
"145619","Benedictine University","2020","Not on tenure/no tenure system, assistant professors","17","8","9","0","0","0","2","1","1","0","0","0","0","0","0","0","0","0","15","7","8","0","0","0","0","0","0","0","0","0","-2"
"145619","Benedictine University","2020","Not on tenure/no tenure system, instructors","11","6","5","0","0","0","0","0","0","0","0","0","0","0","0","0","0","0","10","5","5","0","0","0","1","1","0","0","0","0","-2"
"145725","Illinois Institute of Technology","2020","Tenured total","210","162","48","1","1","0","51","39","12","5","2","3","7","6","1","1","0","1","122","94","28","1","1","0","4","4","0","18","15","3","-2"
"145725","Illinois Institute of Technology","2020","Tenured, professors","125","103","22","1","1","0","35","29","6","3","2","1","2","2","0","0","0","0","74","60","14","1","1","0","3","3","0","6","5","1","-2"
"145725","Illinois Institute of Technology","2020","Tenured, associate professors","85","59","26","0","0","0","16","10","6","2","0","2","5","4","1","1","0","1","48","34","14","0","0","0","1","1","0","12","10","2","-2"
"145725","Illinois Institute of Technology","2020","On-Tenure track total","43","32","11","2","0","2","8","5","3","2","2","0","1","1","0","0","0","0","12","10","2","0","0","0","6","4","2","12","10","2","-2"
"145725","Illinois Institute of Technology","2020","On-tenure track, associate professors","1","0","1","0","0","0","0","0","0","0","0","0","0","0","0","0","0","0","1","0","1","0","0","0","0","0","0","0","0","0","-2"
"145725","Illinois Institute of Technology","2020","On-tenure track, assistant professors","42","32","10","2","0","2","8","5","3","2","2","0","1","1","0","0","0","0","11","10","1","0","0","0","6","4","2","12","10","2","-2"
"145725","Illinois Institute of Technology","2020","Not on tenure track/No tenure system system total","134","81","53","3","3","0","13","9","4","2","0","2","2","1","1","0","0","0","88","55","33","0","0","0","8","4","4","18","9","9","-2"
"145725","Illinois Institute of Technology","2020","Not on tenure/no tenure system, professors","26","18","8","2","2","0","4","1","3","0","0","0","0","0","0","0","0","0","20","15","5","0","0","0","0","0","0","0","0","0","-2"
"145725","Illinois Institute of Technology","2020","Not on tenure/no tenure system, associate professors","14","11","3","0","0","0","0","0","0","0","0","0","0","0","0","0","0","0","13","10","3","0","0","0","0","0","0","1","1","0","-2"
"145725","Illinois Institute of Technology","2020","Not on tenure/no tenure system, assistant professors","25","12","13","1","1","0","2","2","0","1","0","1","1","0","1","0","0","0","10","5","5","0","0","0","5","2","3","5","2","3","-2"
"145725","Illinois Institute of Technology","2020","Not on tenure/no tenure system, instructors","11","6","5","0","0","0","1","1","0","0","0","0","0","0","0","0","0","0","9","4","5","0","0","0","1","1","0","0","0","0","-2"
"145725","Illinois Institute of Technology","2020","Not on tenure/no tenure system, lecturers","51","31","20","0","0","0","6","5","1","1","0","1","0","0","0","0","0","0","36","21","15","0","0","0","1","1","0","7","4","3","-2"
"145725","Illinois Institute of Technology","2020","Not on tenure/no tenure system, no academic rank","7","3","4","0","0","0","0","0","0","0","0","0","1","1","0","0","0","0","0","0","0","0","0","0","1","0","1","5","2","3","-2"
"146339","Judson University","2020","Tenured total","19","11","8","0","0","0","2","0","2","0","0","0","0","0","0","0","0","0","17","11","6","0","0","0","0","0","0","0","0","0","-2"
"146339","Judson University","2020","Tenured, professors","18","11","7","0","0","0","2","0","2","0","0","0","0","0","0","0","0","0","16","11","5","0","0","0","0","0","0","0","0","0","-2"
"146339","Judson University","2020","Tenured, associate professors","1","0","1","0","0","0","0","0","0","0","0","0","0","0","0","0","0","0","1","0","1","0","0","0","0","0","0","0","0","0","-2"
"146339","Judson University","2020","On-Tenure track total","12","7","5","0","0","0","1","1","0","3","1","2","0","0","0","0","0","0","7","5","2","0","0","0","0","0","0","1","0","1","-2"
"146339","Judson University","2020","On-tenure track, associate professors","4","3","1","0","0","0","0","0","0","0","0","0","0","0","0","0","0","0","4","3","1","0","0","0","0","0","0","0","0","0","-2"
"146339","Judson University","2020","On-tenure track, assistant professors","8","4","4","0","0","0","1","1","0","3","1","2","0","0","0","0","0","0","3","2","1","0","0","0","0","0","0","1","0","1","-2"
"146339","Judson University","2020","Not on tenure track/No tenure system system total","18","10","8","0","0","0","0","0","0","4","2","2","0","0","0","0","0","0","14","8","6","0","0","0","0","0","0","0","0","0","-2"
"146339","Judson University","2020","Not on tenure/no tenure system, professors","3","1","2","0","0","0","0","0","0","1","0","1","0","0","0","0","0","0","2","1","1","0","0","0","0","0","0","0","0","0","-2"
"146339","Judson University","2020","Not on tenure/no tenure system, associate professors","4","3","1","0","0","0","0","0","0","1","1","0","0","0","0","0","0","0","3","2","1","0","0","0","0","0","0","0","0","0","-2"
"146339","Judson University","2020","Not on tenure/no tenure system, assistant professors","11","6","5","0","0","0","0","0","0","2","1","1","0","0","0","0","0","0","9","5","4","0","0","0","0","0","0","0","0","0","-2"
"146612","Lewis University","2020","Tenured total","83","42","41","0","0","0","6","5","1","3","1","2","3","0","3","0","0","0","70","35","35","0","0","0","1","1","0","0","0","0","-2"
"146612","Lewis University","2020","Tenured, professors","47","25","22","0","0","0","4","3","1","3","1","2","1","0","1","0","0","0","39","21","18","0","0","0","0","0","0","0","0","0","-2"
"146612","Lewis University","2020","Tenured, associate professors","36","17","19","0","0","0","2","2","0","0","0","0","2","0","2","0","0","0","31","14","17","0","0","0","1","1","0","0","0","0","-2"
"146612","Lewis University","2020","On-Tenure track total","57","21","36","0","0","0","7","4","3","4","2","2","3","0","3","0","0","0","39","14","25","0","0","0","2","0","2","2","1","1","-2"
"146612","Lewis University","2020","On-tenure track, professors","1","1","0","0","0","0","0","0","0","0","0","0","0","0","0","0","0","0","1","1","0","0","0","0","0","0","0","0","0","0","-2"
"146612","Lewis University","2020","On-tenure track, associate professors","20","6","14","0","0","0","2","1","1","2","1","1","0","0","0","0","0","0","15","4","11","0","0","0","0","0","0","1","0","1","-2"
"146612","Lewis University","2020","On-tenure track, assistant professors","36","14","22","0","0","0","5","3","2","2","1","1","3","0","3","0","0","0","23","9","14","0","0","0","2","0","2","1","1","0","-2"
"146612","Lewis University","2020","Not on tenure track/No tenure system system total","84","38","46","0","0","0","3","0","3","7","4","3","3","0","3","0","0","0","71","34","37","0","0","0","0","0","0","0","0","0","-2"
"146612","Lewis University","2020","Not on tenure/no tenure system, professors","1","1","0","0","0","0","0","0","0","0","0","0","0","0","0","0","0","0","1","1","0","0","0","0","0","0","0","0","0","0","-2"
"146612","Lewis University","2020","Not on tenure/no tenure system, associate professors","13","7","6","0","0","0","0","0","0","2","1","1","0","0","0","0","0","0","11","6","5","0","0","0","0","0","0","0","0","0","-2"
"146612","Lewis University","2020","Not on tenure/no tenure system, assistant professors","53","23","30","0","0","0","2","0","2","5","3","2","2","0","2","0","0","0","44","20","24","0","0","0","0","0","0","0","0","0","-2"
"146612","Lewis University","2020","Not on tenure/no tenure system, instructors","17","7","10","0","0","0","1","0","1","0","0","0","1","0","1","0","0","0","15","7","8","0","0","0","0","0","0","0","0","0","-2"
"146719","Loyola University Chicago","2020","Tenured total","380","220","160","0","0","0","38","24","14","13","8","5","17","8","9","0","0","0","305","177","128","1","0","1","4","2","2","2","1","1","-2"
"146719","Loyola University Chicago","2020","Tenured, professors","188","119","69","0","0","0","20","16","4","2","1","1","11","7","4","0","0","0","152","94","58","1","0","1","1","1","0","1","0","1","-2"
"146719","Loyola University Chicago","2020","Tenured, associate professors","191","101","90","0","0","0","18","8","10","11","7","4","6","1","5","0","0","0","152","83","69","0","0","0","3","1","2","1","1","0","-2"
"146719","Loyola University Chicago","2020","Tenured, assistant professors","1","0","1","0","0","0","0","0","0","0","0","0","0","0","0","0","0","0","1","0","1","0","0","0","0","0","0","0","0","0","-2"
"146719","Loyola University Chicago","2020","On-Tenure track total","155","79","76","0","0","0","16","7","9","12","6","6","5","3","2","0","0","0","103","58","45","2","0","2","2","0","2","15","5","10","-2"
"146719","Loyola University Chicago","2020","On-tenure track, professors","1","0","1","0","0","0","1","0","1","0","0","0","0","0","0","0","0","0","0","0","0","0","0","0","0","0","0","0","0","0","-2"
"146719","Loyola University Chicago","2020","On-tenure track, associate professors","12","8","4","0","0","0","1","0","1","1","1","0","0","0","0","0","0","0","10","7","3","0","0","0","0","0","0","0","0","0","-2"
"146719","Loyola University Chicago","2020","On-tenure track, assistant professors","142","71","71","0","0","0","14","7","7","11","5","6","5","3","2","0","0","0","93","51","42","2","0","2","2","0","2","15","5","10","-2"
"146719","Loyola University Chicago","2020","Not on tenure track/No tenure system system total","382","164","218","0","0","0","24","10","14","22","7","15","18","11","7","3","0","3","303","129","174","4","2","2","2","1","1","6","4","2","-2"
"146719","Loyola University Chicago","2020","Not on tenure/no tenure system, instructors","382","164","218","0","0","0","24","10","14","22","7","15","18","11","7","3","0","3","303","129","174","4","2","2","2","1","1","6","4","2","-2"
"147660","North Central College","2020","Tenured total","77","41","36","0","0","0","7","2","5","1","0","1","2","1","1","0","0","0","65","37","28","1","0","1","0","0","0","1","1","0","-2"
"147660","North Central College","2020","Tenured, professors","40","27","13","0","0","0","2","1","1","0","0","0","0","0","0","0","0","0","38","26","12","0","0","0","0","0","0","0","0","0","-2"
"147660","North Central College","2020","Tenured, associate professors","34","13","21","0","0","0","5","1","4","1","0","1","2","1","1","0","0","0","25","11","14","1","0","1","0","0","0","0","0","0","-2"
"147660","North Central College","2020","Tenured, assistant professors","3","1","2","0","0","0","0","0","0","0","0","0","0","0","0","0","0","0","2","0","2","0","0","0","0","0","0","1","1","0","-2"
"147660","North Central College","2020","On-Tenure track total","44","18","26","0","0","0","3","1","2","1","1","0","3","2","1","0","0","0","26","11","15","1","0","1","3","0","3","7","3","4","-2"
"147660","North Central College","2020","On-tenure track, professors","2","1","1","0","0","0","0","0","0","0","0","0","0","0","0","0","0","0","2","1","1","0","0","0","0","0","0","0","0","0","-2"
"147660","North Central College","2020","On-tenure track, associate professors","8","4","4","0","0","0","0","0","0","0","0","0","1","1","0","0","0","0","5","3","2","0","0","0","2","0","2","0","0","0","-2"
"147660","North Central College","2020","On-tenure track, assistant professors","34","13","21","0","0","0","3","1","2","1","1","0","2","1","1","0","0","0","19","7","12","1","0","1","1","0","1","7","3","4","-2"
"147660","North Central College","2020","Not on tenure track/No tenure system system total","39","11","28","0","0","0","3","0","3","2","0","2","1","0","1","0","0","0","33","11","22","0","0","0","0","0","0","0","0","0","-2"
"147660","North Central College","2020","Not on tenure/no tenure system, professors","6","3","3","0","0","0","0","0","0","0","0","0","0","0","0","0","0","0","6","3","3","0","0","0","0","0","0","0","0","0","-2"
"147660","North Central College","2020","Not on tenure/no tenure system, associate professors","9","2","7","0","0","0","0","0","0","0","0","0","0","0","0","0","0","0","9","2","7","0","0","0","0","0","0","0","0","0","-2"
"147660","North Central College","2020","Not on tenure/no tenure system, assistant professors","20","4","16","0","0","0","2","0","2","2","0","2","1","0","1","0","0","0","15","4","11","0","0","0","0","0","0","0","0","0","-2"
"147660","North Central College","2020","Not on tenure/no tenure system, instructors","1","1","0","0","0","0","0","0","0","0","0","0","0","0","0","0","0","0","1","1","0","0","0","0","0","0","0","0","0","0","-2"
"147660","North Central College","2020","Not on tenure/no tenure system, lecturers","3","1","2","0","0","0","1","0","1","0","0","0","0","0","0","0","0","0","2","1","1","0","0","0","0","0","0","0","0","0","-2"
"148405","Rockford University","2020","Tenured total","33","20","13","0","0","0","1","0","1","0","0","0","2","2","0","0","0","0","29","17","12","1","1","0","0","0","0","0","0","0","-2"
"148405","Rockford University","2020","Tenured, professors","12","7","5","0","0","0","0","0","0","0","0","0","0","0","0","0","0","0","11","6","5","1","1","0","0","0","0","0","0","0","-2"
"148405","Rockford University","2020","Tenured, associate professors","16","13","3","0","0","0","1","0","1","0","0","0","2","2","0","0","0","0","13","11","2","0","0","0","0","0","0","0","0","0","-2"
"148405","Rockford University","2020","Tenured, assistant professors","5","0","5","0","0","0","0","0","0","0","0","0","0","0","0","0","0","0","5","0","5","0","0","0","0","0","0","0","0","0","-2"
"148405","Rockford University","2020","On-Tenure track total","31","8","23","0","0","0","1","1","0","0","0","0","2","1","1","0","0","0","27","5","22","1","1","0","0","0","0","0","0","0","-2"
"148405","Rockford University","2020","On-tenure track, associate professors","6","3","3","0","0","0","0","0","0","0","0","0","0","0","0","0","0","0","6","3","3","0","0","0","0","0","0","0","0","0","-2"
"148405","Rockford University","2020","On-tenure track, assistant professors","25","5","20","0","0","0","1","1","0","0","0","0","2","1","1","0","0","0","21","2","19","1","1","0","0","0","0","0","0","0","-2"
"148405","Rockford University","2020","Not on tenure track/No tenure system system total","5","0","5","0","0","0","1","0","1","0","0","0","0","0","0","0","0","0","4","0","4","0","0","0","0","0","0","0","0","0","-2"
"148405","Rockford University","2020","Not on tenure/no tenure system, associate professors","2","0","2","0","0","0","0","0","0","0","0","0","0","0","0","0","0","0","2","0","2","0","0","0","0","0","0","0","0","0","-2"
"148405","Rockford University","2020","Not on tenure/no tenure system, assistant professors","1","0","1","0","0","0","0","0","0","0","0","0","0","0","0","0","0","0","1","0","1","0","0","0","0","0","0","0","0","0","-2"
"148405","Rockford University","2020","Not on tenure/no tenure system, lecturers","2","0","2","0","0","0","1","0","1","0","0","0","0","0","0","0","0","0","1","0","1","0","0","0","0","0","0","0","0","0","-2"
"150668","Goshen College","2020","Tenured total","28","16","12","0","0","0","0","0","0","1","0","1","0","0","0","0","0","0","26","16","10","0","0","0","1","0","1","0","0","0","-2"
"150668","Goshen College","2020","Tenured, professors","24","14","10","0","0","0","0","0","0","1","0","1","0","0","0","0","0","0","22","14","8","0","0","0","1","0","1","0","0","0","-2"
"150668","Goshen College","2020","Tenured, associate professors","4","2","2","0","0","0","0","0","0","0","0","0","0","0","0","0","0","0","4","2","2","0","0","0","0","0","0","0","0","0","-2"
"150668","Goshen College","2020","On-Tenure track total","6","5","1","0","0","0","0","0","0","0","0","0","0","0","0","0","0","0","6","5","1","0","0","0","0","0","0","0","0","0","-2"
"150668","Goshen College","2020","On-tenure track, professors","2","2","0","0","0","0","0","0","0","0","0","0","0","0","0","0","0","0","2","2","0","0","0","0","0","0","0","0","0","0","-2"
"150668","Goshen College","2020","On-tenure track, associate professors","1","1","0","0","0","0","0","0","0","0","0","0","0","0","0","0","0","0","1","1","0","0","0","0","0","0","0","0","0","0","-2"
"150668","Goshen College","2020","On-tenure track, assistant professors","3","2","1","0","0","0","0","0","0","0","0","0","0","0","0","0","0","0","3","2","1","0","0","0","0","0","0","0","0","0","-2"
"150668","Goshen College","2020","Not on tenure track/No tenure system system total","27","8","19","0","0","0","0","0","0","0","0","0","0","0","0","0","0","0","25","6","19","0","0","0","1","1","0","1","1","0","-2"
"150668","Goshen College","2020","Not on tenure/no tenure system, professors","5","2","3","0","0","0","0","0","0","0","0","0","0","0","0","0","0","0","5","2","3","0","0","0","0","0","0","0","0","0","-2"
"150668","Goshen College","2020","Not on tenure/no tenure system, associate professors","13","3","10","0","0","0","0","0","0","0","0","0","0","0","0","0","0","0","12","2","10","0","0","0","1","1","0","0","0","0","-2"
"150668","Goshen College","2020","Not on tenure/no tenure system, assistant professors","9","3","6","0","0","0","0","0","0","0","0","0","0","0","0","0","0","0","8","2","6","0","0","0","0","0","0","1","1","0","-2"
"152637","Vincennes University","2020","Tenured total","42","15","27","1","0","1","1","1","0","1","1","0","0","0","0","0","0","0","38","13","25","0","0","0","0","0","0","1","0","1","-2"
"152637","Vincennes University","2020","Tenured, professors","21","5","16","1","0","1","1","1","0","0","0","0","0","0","0","0","0","0","19","4","15","0","0","0","0","0","0","0","0","0","-2"
"152637","Vincennes University","2020","Tenured, associate professors","20","9","11","0","0","0","0","0","0","1","1","0","0","0","0","0","0","0","18","8","10","0","0","0","0","0","0","1","0","1","-2"
"152637","Vincennes University","2020","Tenured, instructors","1","1","0","0","0","0","0","0","0","0","0","0","0","0","0","0","0","0","1","1","0","0","0","0","0","0","0","0","0","0","-2"
"152637","Vincennes University","2020","On-Tenure track total","16","6","10","0","0","0","0","0","0","0","0","0","0","0","0","0","0","0","16","6","10","0","0","0","0","0","0","0","0","0","-2"
"152637","Vincennes University","2020","On-tenure track, professors","1","0","1","0","0","0","0","0","0","0","0","0","0","0","0","0","0","0","1","0","1","0","0","0","0","0","0","0","0","0","-2"
"152637","Vincennes University","2020","On-tenure track, associate professors","8","5","3","0","0","0","0","0","0","0","0","0","0","0","0","0","0","0","8","5","3","0","0","0","0","0","0","0","0","0","-2"
"152637","Vincennes University","2020","On-tenure track, assistant professors","7","1","6","0","0","0","0","0","0","0","0","0","0","0","0","0","0","0","7","1","6","0","0","0","0","0","0","0","0","0","-2"
"152637","Vincennes University","2020","Not on tenure track/No tenure system system total","122","67","55","1","0","1","1","0","1","2","2","0","2","1","1","0","0","0","108","57","51","1","1","0","1","1","0","6","5","1","-2"
"152637","Vincennes University","2020","Not on tenure/no tenure system, professors","5","1","4","1","0","1","0","0","0","0","0","0","0","0","0","0","0","0","3","0","3","0","0","0","0","0","0","1","1","0","-2"
"152637","Vincennes University","2020","Not on tenure/no tenure system, associate professors","18","8","10","0","0","0","0","0","0","2","2","0","0","0","0","0","0","0","16","6","10","0","0","0","0","0","0","0","0","0","-2"
"152637","Vincennes University","2020","Not on tenure/no tenure system, assistant professors","66","29","37","0","0","0","0","0","0","0","0","0","0","0","0","0","0","0","60","24","36","0","0","0","1","1","0","5","4","1","-2"
"152637","Vincennes University","2020","Not on tenure/no tenure system, instructors","33","29","4","0","0","0","1","0","1","0","0","0","2","1","1","0","0","0","29","27","2","1","1","0","0","0","0","0","0","0","-2"
"152992","Briar Cliff University","2020","Tenured total","31","22","9","1","1","0","1","1","0","0","0","0","0","0","0","0","0","0","29","20","9","0","0","0","0","0","0","0","0","0","-2"
"152992","Briar Cliff University","2020","Tenured, professors","13","10","3","0","0","0","0","0","0","0","0","0","0","0","0","0","0","0","13","10","3","0","0","0","0","0","0","0","0","0","-2"
"152992","Briar Cliff University","2020","Tenured, associate professors","17","11","6","0","0","0","1","1","0","0","0","0","0","0","0","0","0","0","16","10","6","0","0","0","0","0","0","0","0","0","-2"
"152992","Briar Cliff University","2020","Tenured, assistant professors","1","1","0","1","1","0","0","0","0","0","0","0","0","0","0","0","0","0","0","0","0","0","0","0","0","0","0","0","0","0","-2"
"152992","Briar Cliff University","2020","On-Tenure track total","30","11","19","0","0","0","0","0","0","0","0","0","2","1","1","0","0","0","28","10","18","0","0","0","0","0","0","0","0","0","-2"
"152992","Briar Cliff University","2020","On-tenure track, associate professors","4","2","2","0","0","0","0","0","0","0","0","0","0","0","0","0","0","0","4","2","2","0","0","0","0","0","0","0","0","0","-2"
"152992","Briar Cliff University","2020","On-tenure track, assistant professors","26","9","17","0","0","0","0","0","0","0","0","0","2","1","1","0","0","0","24","8","16","0","0","0","0","0","0","0","0","0","-2"
"152992","Briar Cliff University","2020","Not on tenure track/No tenure system system total","8","1","7","0","0","0","0","0","0","0","0","0","0","0","0","0","0","0","7","0","7","1","1","0","0","0","0","0","0","0","-2"
"152992","Briar Cliff University","2020","Not on tenure/no tenure system, instructors","8","1","7","0","0","0","0","0","0","0","0","0","0","0","0","0","0","0","7","0","7","1","1","0","0","0","0","0","0","0","-2"
"154721","Bethany College","2020","Tenured total","17","13","4","0","0","0","0","0","0","0","0","0","0","0","0","0","0","0","15","11","4","0","0","0","2","2","0","0","0","0","-2"
"154721","Bethany College","2020","Tenured, professors","5","4","1","0","0","0","0","0","0","0","0","0","0","0","0","0","0","0","5","4","1","0","0","0","0","0","0","0","0","0","-2"
"154721","Bethany College","2020","Tenured, associate professors","9","6","3","0","0","0","0","0","0","0","0","0","0","0","0","0","0","0","8","5","3","0","0","0","1","1","0","0","0","0","-2"
"154721","Bethany College","2020","Tenured, assistant professors","3","3","0","0","0","0","0","0","0","0","0","0","0","0","0","0","0","0","2","2","0","0","0","0","1","1","0","0","0","0","-2"
"154721","Bethany College","2020","On-Tenure track total","25","13","12","0","0","0","1","1","0","0","0","0","0","0","0","0","0","0","24","12","12","0","0","0","0","0","0","0","0","0","-2"
"154721","Bethany College","2020","On-tenure track, professors","6","3","3","0","0","0","0","0","0","0","0","0","0","0","0","0","0","0","6","3","3","0","0","0","0","0","0","0","0","0","-2"
"154721","Bethany College","2020","On-tenure track, associate professors","3","2","1","0","0","0","0","0","0","0","0","0","0","0","0","0","0","0","3","2","1","0","0","0","0","0","0","0","0","0","-2"
"154721","Bethany College","2020","On-tenure track, assistant professors","16","8","8","0","0","0","1","1","0","0","0","0","0","0","0","0","0","0","15","7","8","0","0","0","0","0","0","0","0","0","-2"
"155414","Kansas Wesleyan University","2020","Tenured total","19","12","7","0","0","0","0","0","0","1","1","0","0","0","0","0","0","0","18","11","7","0","0","0","0","0","0","0","0","0","-2"
"155414","Kansas Wesleyan University","2020","Tenured, professors","7","5","2","0","0","0","0","0","0","0","0","0","0","0","0","0","0","0","7","5","2","0","0","0","0","0","0","0","0","0","-2"
"155414","Kansas Wesleyan University","2020","Tenured, associate professors","12","7","5","0","0","0","0","0","0","1","1","0","0","0","0","0","0","0","11","6","5","0","0","0","0","0","0","0","0","0","-2"
"155414","Kansas Wesleyan University","2020","On-Tenure track total","21","6","15","0","0","0","1","1","0","0","0","0","0","0","0","0","0","0","18","4","14","1","1","0","1","0","1","0","0","0","-2"
"155414","Kansas Wesleyan University","2020","On-tenure track, assistant professors","21","6","15","0","0","0","1","1","0","0","0","0","0","0","0","0","0","0","18","4","14","1","1","0","1","0","1","0","0","0","-2"
"155414","Kansas Wesleyan University","2020","Not on tenure track/No tenure system system total","7","2","5","0","0","0","0","0","0","0","0","0","0","0","0","0","0","0","6","2","4","1","0","1","0","0","0","0","0","0","-2"
"155414","Kansas Wesleyan University","2020","Not on tenure/no tenure system, associate professors","1","1","0","0","0","0","0","0","0","0","0","0","0","0","0","0","0","0","1","1","0","0","0","0","0","0","0","0","0","0","-2"
"155414","Kansas Wesleyan University","2020","Not on tenure/no tenure system, assistant professors","4","0","4","0","0","0","0","0","0","0","0","0","0","0","0","0","0","0","3","0","3","1","0","1","0","0","0","0","0","0","-2"
"155414","Kansas Wesleyan University","2020","Not on tenure/no tenure system, instructors","2","1","1","0","0","0","0","0","0","0","0","0","0","0","0","0","0","0","2","1","1","0","0","0","0","0","0","0","0","0","-2"
"155511","McPherson College","2020","Tenured total","27","18","9","0","0","0","2","1","1","0","0","0","1","0","1","0","0","0","24","17","7","0","0","0","0","0","0","0","0","0","-2"
"155511","McPherson College","2020","Tenured, professors","14","10","4","0","0","0","1","1","0","0","0","0","0","0","0","0","0","0","13","9","4","0","0","0","0","0","0","0","0","0","-2"
"155511","McPherson College","2020","Tenured, associate professors","13","8","5","0","0","0","1","0","1","0","0","0","1","0","1","0","0","0","11","8","3","0","0","0","0","0","0","0","0","0","-2"
"155511","McPherson College","2020","On-Tenure track total","15","8","7","0","0","0","0","0","0","0","0","0","1","1","0","0","0","0","14","7","7","0","0","0","0","0","0","0","0","0","-2"
"155511","McPherson College","2020","On-tenure track, associate professors","4","3","1","0","0","0","0","0","0","0","0","0","0","0","0","0","0","0","4","3","1","0","0","0","0","0","0","0","0","0","-2"
"155511","McPherson College","2020","On-tenure track, assistant professors","11","5","6","0","0","0","0","0","0","0","0","0","1","1","0","0","0","0","10","4","6","0","0","0","0","0","0","0","0","0","-2"
"155511","McPherson College","2020","Not on tenure track/No tenure system system total","3","2","1","0","0","0","0","0","0","0","0","0","0","0","0","0","0","0","3","2","1","0","0","0","0","0","0","0","0","0","-2"
"155511","McPherson College","2020","Not on tenure/no tenure system, assistant professors","3","2","1","0","0","0","0","0","0","0","0","0","0","0","0","0","0","0","3","2","1","0","0","0","0","0","0","0","0","0","-2"
"159656","Loyola University New Orleans","2020","Tenured total","125","80","45","0","0","0","5","3","2","9","5","4","10","7","3","0","0","0","97","62","35","3","2","1","1","1","0","0","0","0","-2"
"159656","Loyola University New Orleans","2020","Tenured, professors","74","47","27","0","0","0","1","0","1","5","3","2","7","5","2","0","0","0","60","39","21","1","0","1","0","0","0","0","0","0","-2"
"159656","Loyola University New Orleans","2020","Tenured, associate professors","49","33","16","0","0","0","4","3","1","4","2","2","3","2","1","0","0","0","35","23","12","2","2","0","1","1","0","0","0","0","-2"
"159656","Loyola University New Orleans","2020","Tenured, assistant professors","2","0","2","0","0","0","0","0","0","0","0","0","0","0","0","0","0","0","2","0","2","0","0","0","0","0","0","0","0","0","-2"
"159656","Loyola University New Orleans","2020","On-Tenure track total","29","12","17","0","0","0","2","1","1","1","0","1","0","0","0","0","0","0","25","10","15","0","0","0","0","0","0","1","1","0","-2"
"159656","Loyola University New Orleans","2020","On-tenure track, associate professors","2","2","0","0","0","0","0","0","0","0","0","0","0","0","0","0","0","0","2","2","0","0","0","0","0","0","0","0","0","0","-2"
"159656","Loyola University New Orleans","2020","On-tenure track, assistant professors","27","10","17","0","0","0","2","1","1","1","0","1","0","0","0","0","0","0","23","8","15","0","0","0","0","0","0","1","1","0","-2"
"159656","Loyola University New Orleans","2020","Not on tenure track/No tenure system system total","79","37","42","0","0","0","2","1","1","8","2","6","4","4","0","0","0","0","56","27","29","0","0","0","6","2","4","3","1","2","-2"
"159656","Loyola University New Orleans","2020","Not on tenure/no tenure system, lecturers","79","37","42","0","0","0","2","1","1","8","2","6","4","4","0","0","0","0","56","27","29","0","0","0","6","2","4","3","1","2","-2"
"162210","Washington Adventist University","2020","Not on tenure track/No tenure system system total","32","18","14","0","0","0","5","1","4","12","5","7","2","2","0","0","0","0","13","10","3","0","0","0","0","0","0","0","0","0","-2"
"162210","Washington Adventist University","2020","Not on tenure/no tenure system, professors","11","6","5","0","0","0","1","0","1","6","3","3","0","0","0","0","0","0","4","3","1","0","0","0","0","0","0","0","0","0","-2"
"162210","Washington Adventist University","2020","Not on tenure/no tenure system, associate professors","12","6","6","0","0","0","4","1","3","2","0","2","1","1","0","0","0","0","5","4","1","0","0","0","0","0","0","0","0","0","-2"
"162210","Washington Adventist University","2020","Not on tenure/no tenure system, assistant professors","9","6","3","0","0","0","0","0","0","4","2","2","1","1","0","0","0","0","4","3","1","0","0","0","0","0","0","0","0","0","-2"
"164447","American International College","2020","Tenured total","37","17","20","0","0","0","2","0","2","2","0","2","0","0","0","0","0","0","32","16","16","1","1","0","0","0","0","0","0","0","-2"
"164447","American International College","2020","Tenured, professors","13","4","9","0","0","0","0","0","0","0","0","0","0","0","0","0","0","0","13","4","9","0","0","0","0","0","0","0","0","0","-2"
"164447","American International College","2020","Tenured, associate professors","24","13","11","0","0","0","2","0","2","2","0","2","0","0","0","0","0","0","19","12","7","1","1","0","0","0","0","0","0","0","-2"
"164447","American International College","2020","On-Tenure track total","9","2","7","0","0","0","1","0","1","0","0","0","0","0","0","0","0","0","8","2","6","0","0","0","0","0","0","0","0","0","-2"
"164447","American International College","2020","On-tenure track, associate professors","3","0","3","0","0","0","0","0","0","0","0","0","0","0","0","0","0","0","3","0","3","0","0","0","0","0","0","0","0","0","-2"
"164447","American International College","2020","On-tenure track, assistant professors","6","2","4","0","0","0","1","0","1","0","0","0","0","0","0","0","0","0","5","2","3","0","0","0","0","0","0","0","0","0","-2"
"164447","American International College","2020","Not on tenure track/No tenure system system total","11","2","9","0","0","0","0","0","0","1","0","1","0","0","0","0","0","0","9","2","7","1","0","1","0","0","0","0","0","0","-2"
"164447","American International College","2020","Not on tenure/no tenure system, assistant professors","8","1","7","0","0","0","0","0","0","1","0","1","0","0","0","0","0","0","6","1","5","1","0","1","0","0","0","0","0","0","-2"
"164447","American International College","2020","Not on tenure/no tenure system, instructors","3","1","2","0","0","0","0","0","0","0","0","0","0","0","0","0","0","0","3","1","2","0","0","0","0","0","0","0","0","0","-2"
"165644","Eastern Nazarene College","2020","Tenured total","8","8","0","0","0","0","0","0","0","0","0","0","0","0","0","0","0","0","6","6","0","1","1","0","0","0","0","1","1","0","-2"
"165644","Eastern Nazarene College","2020","Tenured, professors","6","6","0","0","0","0","0","0","0","0","0","0","0","0","0","0","0","0","4","4","0","1","1","0","0","0","0","1","1","0","-2"
"165644","Eastern Nazarene College","2020","Tenured, associate professors","2","2","0","0","0","0","0","0","0","0","0","0","0","0","0","0","0","0","2","2","0","0","0","0","0","0","0","0","0","0","-2"
"165644","Eastern Nazarene College","2020","On-Tenure track total","11","7","4","0","0","0","0","0","0","0","0","0","1","0","1","0","0","0","9","6","3","0","0","0","1","1","0","0","0","0","-2"
"165644","Eastern Nazarene College","2020","On-tenure track, associate professors","1","0","1","0","0","0","0","0","0","0","0","0","1","0","1","0","0","0","0","0","0","0","0","0","0","0","0","0","0","0","-2"
"165644","Eastern Nazarene College","2020","On-tenure track, assistant professors","10","7","3","0","0","0","0","0","0","0","0","0","0","0","0","0","0","0","9","6","3","0","0","0","1","1","0","0","0","0","-2"
"165644","Eastern Nazarene College","2020","Not on tenure track/No tenure system system total","14","8","6","0","0","0","1","0","1","2","1","1","0","0","0","0","0","0","11","7","4","0","0","0","0","0","0","0","0","0","-2"
"165644","Eastern Nazarene College","2020","Not on tenure/no tenure system, associate professors","2","1","1","0","0","0","0","0","0","0","0","0","0","0","0","0","0","0","2","1","1","0","0","0","0","0","0","0","0","0","-2"
"165644","Eastern Nazarene College","2020","Not on tenure/no tenure system, assistant professors","8","5","3","0","0","0","0","0","0","2","1","1","0","0","0","0","0","0","6","4","2","0","0","0","0","0","0","0","0","0","-2"
"165644","Eastern Nazarene College","2020","Not on tenure/no tenure system, instructors","4","2","2","0","0","0","1","0","1","0","0","0","0","0","0","0","0","0","3","2","1","0","0","0","0","0","0","0","0","0","-2"
"165866","Framingham State University","2020","Tenured total","127","59","68","0","0","0","9","4","5","3","2","1","4","3","1","0","0","0","106","48","58","3","1","2","0","0","0","2","1","1","-2"
"165866","Framingham State University","2020","Tenured, professors","64","26","38","0","0","0","4","3","1","1","1","0","1","0","1","0","0","0","56","21","35","2","1","1","0","0","0","0","0","0","-2"
"165866","Framingham State University","2020","Tenured, associate professors","61","32","29","0","0","0","5","1","4","2","1","1","3","3","0","0","0","0","48","26","22","1","0","1","0","0","0","2","1","1","-2"
"165866","Framingham State University","2020","Tenured, assistant professors","2","1","1","0","0","0","0","0","0","0","0","0","0","0","0","0","0","0","2","1","1","0","0","0","0","0","0","0","0","0","-2"
"165866","Framingham State University","2020","On-Tenure track total","43","14","29","0","0","0","1","0","1","3","1","2","5","0","5","0","0","0","30","11","19","0","0","0","0","0","0","4","2","2","-2"
"165866","Framingham State University","2020","On-tenure track, associate professors","5","0","5","0","0","0","1","0","1","1","0","1","2","0","2","0","0","0","1","0","1","0","0","0","0","0","0","0","0","0","-2"
"165866","Framingham State University","2020","On-tenure track, assistant professors","38","14","24","0","0","0","0","0","0","2","1","1","3","0","3","0","0","0","29","11","18","0","0","0","0","0","0","4","2","2","-2"
"165866","Framingham State University","2020","Not on tenure track/No tenure system system total","19","4","15","0","0","0","5","0","5","2","0","2","0","0","0","0","0","0","12","4","8","0","0","0","0","0","0","0","0","0","-2"
"165866","Framingham State University","2020","Not on tenure/no tenure system, assistant professors","17","3","14","0","0","0","5","0","5","2","0","2","0","0","0","0","0","0","10","3","7","0","0","0","0","0","0","0","0","0","-2"
"165866","Framingham State University","2020","Not on tenure/no tenure system, instructors","2","1","1","0","0","0","0","0","0","0","0","0","0","0","0","0","0","0","2","1","1","0","0","0","0","0","0","0","0","0","-2"
"166638","University of Massachusetts-Boston","2020","Tenured total","353","186","167","0","0","0","68","44","24","25","10","15","23","12","11","0","0","0","235","119","116","1","1","0","0","0","0","1","0","1","-2"
"166638","University of Massachusetts-Boston","2020","Tenured, professors","121","70","51","0","0","0","21","13","8","8","5","3","5","3","2","0","0","0","87","49","38","0","0","0","0","0","0","0","0","0","-2"
"166638","University of Massachusetts-Boston","2020","Tenured, associate professors","231","116","115","0","0","0","47","31","16","17","5","12","17","9","8","0","0","0","148","70","78","1","1","0","0","0","0","1","0","1","-2"
"166638","University of Massachusetts-Boston","2020","Tenured, assistant professors","1","0","1","0","0","0","0","0","0","0","0","0","1","0","1","0","0","0","0","0","0","0","0","0","0","0","0","0","0","0","-2"
"166638","University of Massachusetts-Boston","2020","On-Tenure track total","122","56","66","2","0","2","24","7","17","12","4","8","8","5","3","0","0","0","54","27","27","3","2","1","0","0","0","19","11","8","-2"
"166638","University of Massachusetts-Boston","2020","On-tenure track, associate professors","2","1","1","0","0","0","1","0","1","0","0","0","0","0","0","0","0","0","0","0","0","0","0","0","0","0","0","1","1","0","-2"
"166638","University of Massachusetts-Boston","2020","On-tenure track, assistant professors","120","55","65","2","0","2","23","7","16","12","4","8","8","5","3","0","0","0","54","27","27","3","2","1","0","0","0","18","10","8","-2"
"166638","University of Massachusetts-Boston","2020","Not on tenure track/No tenure system system total","209","94","115","0","0","0","19","8","11","14","10","4","10","5","5","0","0","0","159","67","92","1","1","0","2","0","2","4","3","1","-2"
"166638","University of Massachusetts-Boston","2020","Not on tenure/no tenure system, lecturers","193","87","106","0","0","0","19","8","11","12","9","3","9","5","4","0","0","0","147","62","85","1","1","0","2","0","2","3","2","1","-2"
"166638","University of Massachusetts-Boston","2020","Not on tenure/no tenure system, no academic rank","16","7","9","0","0","0","0","0","0","2","1","1","1","0","1","0","0","0","12","5","7","0","0","0","0","0","0","1","1","0","-2"
"167729","Salem State University","2020","Tenured total","225","110","115","0","0","0","25","11","14","10","7","3","10","5","5","0","0","0","178","86","92","0","0","0","2","1","1","0","0","0","-2"
"167729","Salem State University","2020","Tenured, professors","143","70","73","0","0","0","9","5","4","3","2","1","7","4","3","0","0","0","124","59","65","0","0","0","0","0","0","0","0","0","-2"
"167729","Salem State University","2020","Tenured, associate professors","81","39","42","0","0","0","15","5","10","7","5","2","3","1","2","0","0","0","54","27","27","0","0","0","2","1","1","0","0","0","-2"
"167729","Salem State University","2020","Tenured, assistant professors","1","1","0","0","0","0","1","1","0","0","0","0","0","0","0","0","0","0","0","0","0","0","0","0","0","0","0","0","0","0","-2"
"167729","Salem State University","2020","On-Tenure track total","53","23","30","0","0","0","9","1","8","6","4","2","3","2","1","0","0","0","30","14","16","0","0","0","1","0","1","4","2","2","-2"
"167729","Salem State University","2020","On-tenure track, associate professors","4","1","3","0","0","0","0","0","0","0","0","0","0","0","0","0","0","0","3","1","2","0","0","0","1","0","1","0","0","0","-2"
"167729","Salem State University","2020","On-tenure track, assistant professors","48","22","26","0","0","0","9","1","8","6","4","2","3","2","1","0","0","0","26","13","13","0","0","0","0","0","0","4","2","2","-2"
"167729","Salem State University","2020","On-tenure track, instructors","1","0","1","0","0","0","0","0","0","0","0","0","0","0","0","0","0","0","1","0","1","0","0","0","0","0","0","0","0","0","-2"
"167729","Salem State University","2020","Not on tenure track/No tenure system system total","15","4","11","0","0","0","0","0","0","0","0","0","0","0","0","0","0","0","14","3","11","0","0","0","1","1","0","0","0","0","-2"
"167729","Salem State University","2020","Not on tenure/no tenure system, professors","2","2","0","0","0","0","0","0","0","0","0","0","0","0","0","0","0","0","1","1","0","0","0","0","1","1","0","0","0","0","-2"
"167729","Salem State University","2020","Not on tenure/no tenure system, assistant professors","6","1","5","0","0","0","0","0","0","0","0","0","0","0","0","0","0","0","6","1","5","0","0","0","0","0","0","0","0","0","-2"
"167729","Salem State University","2020","Not on tenure/no tenure system, instructors","7","1","6","0","0","0","0","0","0","0","0","0","0","0","0","0","0","0","7","1","6","0","0","0","0","0","0","0","0","0","-2"
"168740","Andrews University","2020","Tenured total","63","38","25","0","0","0","8","5","3","7","6","1","7","3","4","0","0","0","38","22","16","2","2","0","0","0","0","1","0","1","-2"
"168740","Andrews University","2020","Tenured, professors","49","31","18","0","0","0","8","5","3","3","2","1","5","2","3","0","0","0","30","20","10","2","2","0","0","0","0","1","0","1","-2"
"168740","Andrews University","2020","Tenured, associate professors","13","7","6","0","0","0","0","0","0","4","4","0","2","1","1","0","0","0","7","2","5","0","0","0","0","0","0","0","0","0","-2"
"168740","Andrews University","2020","Tenured, assistant professors","1","0","1","0","0","0","0","0","0","0","0","0","0","0","0","0","0","0","1","0","1","0","0","0","0","0","0","0","0","0","-2"
"168740","Andrews University","2020","On-Tenure track total","118","67","51","0","0","0","4","0","4","20","10","10","13","9","4","0","0","0","70","44","26","2","1","1","6","2","4","3","1","2","-2"
"168740","Andrews University","2020","On-tenure track, professors","18","15","3","0","0","0","2","0","2","1","0","1","1","1","0","0","0","0","12","12","0","1","1","0","1","1","0","0","0","0","-2"
"168740","Andrews University","2020","On-tenure track, associate professors","43","20","23","0","0","0","1","0","1","9","4","5","5","5","0","0","0","0","25","11","14","0","0","0","2","0","2","1","0","1","-2"
"168740","Andrews University","2020","On-tenure track, assistant professors","56","32","24","0","0","0","1","0","1","10","6","4","7","3","4","0","0","0","32","21","11","1","0","1","3","1","2","2","1","1","-2"
"168740","Andrews University","2020","On-tenure track, instructors","1","0","1","0","0","0","0","0","0","0","0","0","0","0","0","0","0","0","1","0","1","0","0","0","0","0","0","0","0","0","-2"
"168740","Andrews University","2020","Not on tenure track/No tenure system system total","18","9","9","0","0","0","1","1","0","3","2","1","1","1","0","0","0","0","11","5","6","0","0","0","2","0","2","0","0","0","-2"
"168740","Andrews University","2020","Not on tenure/no tenure system, professors","3","1","2","0","0","0","0","0","0","1","1","0","0","0","0","0","0","0","1","0","1","0","0","0","1","0","1","0","0","0","-2"
"168740","Andrews University","2020","Not on tenure/no tenure system, associate professors","5","3","2","0","0","0","0","0","0","1","0","1","1","1","0","0","0","0","3","2","1","0","0","0","0","0","0","0","0","0","-2"
"168740","Andrews University","2020","Not on tenure/no tenure system, assistant professors","8","3","5","0","0","0","0","0","0","0","0","0","0","0","0","0","0","0","7","3","4","0","0","0","1","0","1","0","0","0","-2"
"168740","Andrews University","2020","Not on tenure/no tenure system, instructors","2","2","0","0","0","0","1","1","0","1","1","0","0","0","0","0","0","0","0","0","0","0","0","0","0","0","0","0","0","0","-2"
"170532","Kalamazoo College","2020","Tenured total","67","33","34","0","0","0","4","0","4","4","2","2","4","0","4","0","0","0","51","29","22","2","1","1","2","1","1","0","0","0","-2"
"170532","Kalamazoo College","2020","Tenured, professors","38","20","18","0","0","0","1","0","1","1","1","0","2","0","2","0","0","0","34","19","15","0","0","0","0","0","0","0","0","0","-2"
"170532","Kalamazoo College","2020","Tenured, associate professors","29","13","16","0","0","0","3","0","3","3","1","2","2","0","2","0","0","0","17","10","7","2","1","1","2","1","1","0","0","0","-2"
"170532","Kalamazoo College","2020","On-Tenure track total","22","10","12","0","0","0","1","0","1","1","1","0","7","2","5","0","0","0","9","3","6","0","0","0","1","1","0","3","3","0","-2"
"170532","Kalamazoo College","2020","On-tenure track, assistant professors","22","10","12","0","0","0","1","0","1","1","1","0","7","2","5","0","0","0","9","3","6","0","0","0","1","1","0","3","3","0","-2"
"170532","Kalamazoo College","2020","Not on tenure track/No tenure system system total","25","10","15","0","0","0","0","0","0","0","0","0","5","4","1","0","0","0","13","6","7","0","0","0","6","0","6","1","0","1","-2"
"170532","Kalamazoo College","2020","Not on tenure/no tenure system, assistant professors","4","2","2","0","0","0","0","0","0","0","0","0","2","1","1","0","0","0","2","1","1","0","0","0","0","0","0","0","0","0","-2"
"170532","Kalamazoo College","2020","Not on tenure/no tenure system, instructors","21","8","13","0","0","0","0","0","0","0","0","0","3","3","0","0","0","0","11","5","6","0","0","0","6","0","6","1","0","1","-2"
"178721","Park University","2020","Tenured total","48","30","18","0","0","0","4","1","3","1","1","0","1","0","1","0","0","0","42","28","14","0","0","0","0","0","0","0","0","0","-2"
"178721","Park University","2020","Tenured, professors","20","12","8","0","0","0","2","0","2","0","0","0","1","0","1","0","0","0","17","12","5","0","0","0","0","0","0","0","0","0","-2"
"178721","Park University","2020","Tenured, associate professors","28","18","10","0","0","0","2","1","1","1","1","0","0","0","0","0","0","0","25","16","9","0","0","0","0","0","0","0","0","0","-2"
"178721","Park University","2020","On-Tenure track total","33","13","20","1","0","1","4","3","1","2","0","2","0","0","0","0","0","0","25","9","16","1","1","0","0","0","0","0","0","0","-2"
"178721","Park University","2020","On-tenure track, associate professors","5","2","3","1","0","1","0","0","0","0","0","0","0","0","0","0","0","0","4","2","2","0","0","0","0","0","0","0","0","0","-2"
"178721","Park University","2020","On-tenure track, assistant professors","28","11","17","0","0","0","4","3","1","2","0","2","0","0","0","0","0","0","21","7","14","1","1","0","0","0","0","0","0","0","-2"
"178721","Park University","2020","Not on tenure track/No tenure system system total","31","9","22","1","0","1","0","0","0","2","1","1","1","0","1","0","0","0","25","7","18","2","1","1","0","0","0","0","0","0","-2"
"178721","Park University","2020","Not on tenure/no tenure system, associate professors","3","1","2","0","0","0","0","0","0","0","0","0","0","0","0","0","0","0","3","1","2","0","0","0","0","0","0","0","0","0","-2"
"178721","Park University","2020","Not on tenure/no tenure system, assistant professors","11","2","9","0","0","0","0","0","0","1","0","1","1","0","1","0","0","0","7","1","6","2","1","1","0","0","0","0","0","0","-2"
"178721","Park University","2020","Not on tenure/no tenure system, instructors","2","0","2","0","0","0","0","0","0","0","0","0","0","0","0","0","0","0","2","0","2","0","0","0","0","0","0","0","0","0","-2"
"178721","Park University","2020","Not on tenure/no tenure system, lecturers","15","6","9","1","0","1","0","0","0","1","1","0","0","0","0","0","0","0","13","5","8","0","0","0","0","0","0","0","0","0","-2"
"181738","Union College","2020","Tenured total","10","5","5","0","0","0","0","0","0","1","0","1","0","0","0","0","0","0","9","5","4","0","0","0","0","0","0","0","0","0","-2"
"181738","Union College","2020","Tenured, professors","10","5","5","0","0","0","0","0","0","1","0","1","0","0","0","0","0","0","9","5","4","0","0","0","0","0","0","0","0","0","-2"
"181738","Union College","2020","On-Tenure track total","46","21","25","0","0","0","0","0","0","4","2","2","2","2","0","0","0","0","40","17","23","0","0","0","0","0","0","0","0","0","-2"
"181738","Union College","2020","On-tenure track, professors","6","4","2","0","0","0","0","0","0","1","1","0","0","0","0","0","0","0","5","3","2","0","0","0","0","0","0","0","0","0","-2"
"181738","Union College","2020","On-tenure track, associate professors","17","4","13","0","0","0","0","0","0","1","0","1","2","2","0","0","0","0","14","2","12","0","0","0","0","0","0","0","0","0","-2"
"181738","Union College","2020","On-tenure track, assistant professors","22","13","9","0","0","0","0","0","0","2","1","1","0","0","0","0","0","0","20","12","8","0","0","0","0","0","0","0","0","0","-2"
"181738","Union College","2020","On-tenure track, instructors","1","0","1","0","0","0","0","0","0","0","0","0","0","0","0","0","0","0","1","0","1","0","0","0","0","0","0","0","0","0","-2"
"181738","Union College","2020","Not on tenure track/No tenure system system total","1","0","1","0","0","0","0","0","0","0","0","0","0","0","0","0","0","0","1","0","1","0","0","0","0","0","0","0","0","0","-2"
"181738","Union College","2020","Not on tenure/no tenure system, lecturers","1","0","1","0","0","0","0","0","0","0","0","0","0","0","0","0","0","0","1","0","1","0","0","0","0","0","0","0","0","0","-2"
"181853","York College","2020","Tenured total","9","8","1","0","0","0","0","0","0","0","0","0","1","1","0","0","0","0","8","7","1","0","0","0","0","0","0","0","0","0","-2"
"181853","York College","2020","Tenured, professors","4","4","0","0","0","0","0","0","0","0","0","0","0","0","0","0","0","0","4","4","0","0","0","0","0","0","0","0","0","0","-2"
"181853","York College","2020","Tenured, associate professors","5","4","1","0","0","0","0","0","0","0","0","0","1","1","0","0","0","0","4","3","1","0","0","0","0","0","0","0","0","0","-2"
"181853","York College","2020","On-Tenure track total","3","3","0","0","0","0","0","0","0","0","0","0","1","1","0","0","0","0","2","2","0","0","0","0","0","0","0","0","0","0","-2"
"181853","York College","2020","On-tenure track, associate professors","3","3","0","0","0","0","0","0","0","0","0","0","1","1","0","0","0","0","2","2","0","0","0","0","0","0","0","0","0","0","-2"
"181853","York College","2020","Not on tenure track/No tenure system system total","14","7","7","0","0","0","0","0","0","0","0","0","0","0","0","0","0","0","14","7","7","0","0","0","0","0","0","0","0","0","-2"
"181853","York College","2020","Not on tenure/no tenure system, professors","2","2","0","0","0","0","0","0","0","0","0","0","0","0","0","0","0","0","2","2","0","0","0","0","0","0","0","0","0","0","-2"
"181853","York College","2020","Not on tenure/no tenure system, associate professors","1","1","0","0","0","0","0","0","0","0","0","0","0","0","0","0","0","0","1","1","0","0","0","0","0","0","0","0","0","0","-2"
"181853","York College","2020","Not on tenure/no tenure system, assistant professors","11","4","7","0","0","0","0","0","0","0","0","0","0","0","0","0","0","0","11","4","7","0","0","0","0","0","0","0","0","0","-2"
"182306","Great Basin College","2020","Tenured total","36","20","16","0","0","0","2","1","1","1","0","1","4","2","2","0","0","0","28","16","12","0","0","0","0","0","0","1","1","0","-2"
"182306","Great Basin College","2020","Tenured, professors","36","20","16","0","0","0","2","1","1","1","0","1","4","2","2","0","0","0","28","16","12","0","0","0","0","0","0","1","1","0","-2"
"182306","Great Basin College","2020","On-Tenure track total","21","12","9","0","0","0","0","0","0","0","0","0","2","2","0","0","0","0","17","9","8","1","0","1","0","0","0","1","1","0","-2"
"182306","Great Basin College","2020","On-tenure track, instructors","21","12","9","0","0","0","0","0","0","0","0","0","2","2","0","0","0","0","17","9","8","1","0","1","0","0","0","1","1","0","-2"
"182306","Great Basin College","2020","Not on tenure track/No tenure system system total","14","12","2","0","0","0","0","0","0","0","0","0","1","1","0","0","0","0","13","11","2","0","0","0","0","0","0","0","0","0","-2"
"182306","Great Basin College","2020","Not on tenure/no tenure system, instructors","13","11","2","0","0","0","0","0","0","0","0","0","1","1","0","0","0","0","12","10","2","0","0","0","0","0","0","0","0","0","-2"
"182306","Great Basin College","2020","Not on tenure/no tenure system, no academic rank","1","1","0","0","0","0","0","0","0","0","0","0","0","0","0","0","0","0","1","1","0","0","0","0","0","0","0","0","0","0","-2"
"182564","Western Nevada College","2020","Tenured total","32","15","17","0","0","0","0","0","0","0","0","0","0","0","0","0","0","0","32","15","17","0","0","0","0","0","0","0","0","0","-2"
"182564","Western Nevada College","2020","Tenured, professors","32","15","17","0","0","0","0","0","0","0","0","0","0","0","0","0","0","0","32","15","17","0","0","0","0","0","0","0","0","0","-2"
"182564","Western Nevada College","2020","On-Tenure track total","13","8","5","0","0","0","1","0","1","0","0","0","1","1","0","1","1","0","10","6","4","0","0","0","0","0","0","0","0","0","-2"
"182564","Western Nevada College","2020","On-tenure track, instructors","13","8","5","0","0","0","1","0","1","0","0","0","1","1","0","1","1","0","10","6","4","0","0","0","0","0","0","0","0","0","-2"
"182564","Western Nevada College","2020","Not on tenure track/No tenure system system total","6","2","4","0","0","0","1","0","1","0","0","0","1","1","0","0","0","0","3","0","3","0","0","0","1","1","0","0","0","0","-2"
"182564","Western Nevada College","2020","Not on tenure/no tenure system, instructors","6","2","4","0","0","0","1","0","1","0","0","0","1","1","0","0","0","0","3","0","3","0","0","0","1","1","0","0","0","0","-2"
"184348","Drew University","2020","Tenured total","92","50","42","1","1","0","7","2","5","6","5","1","6","4","2","0","0","0","62","32","30","0","0","0","5","2","3","5","4","1","-2"
"184348","Drew University","2020","Tenured, professors","50","27","23","0","0","0","3","1","2","2","1","1","3","2","1","0","0","0","34","19","15","0","0","0","5","2","3","3","2","1","-2"
"184348","Drew University","2020","Tenured, associate professors","42","23","19","1","1","0","4","1","3","4","4","0","3","2","1","0","0","0","28","13","15","0","0","0","0","0","0","2","2","0","-2"
"184348","Drew University","2020","On-Tenure track total","14","7","7","0","0","0","0","0","0","1","0","1","0","0","0","0","0","0","8","4","4","0","0","0","2","0","2","3","3","0","-2"
"184348","Drew University","2020","On-tenure track, assistant professors","14","7","7","0","0","0","0","0","0","1","0","1","0","0","0","0","0","0","8","4","4","0","0","0","2","0","2","3","3","0","-2"
"184348","Drew University","2020","Not on tenure track/No tenure system system total","24","11","13","0","0","0","0","0","0","2","1","1","1","0","1","2","0","2","14","9","5","0","0","0","3","0","3","2","1","1","-2"
"184348","Drew University","2020","Not on tenure/no tenure system, associate professors","3","1","2","0","0","0","0","0","0","0","0","0","0","0","0","0","0","0","3","1","2","0","0","0","0","0","0","0","0","0","-2"
"184348","Drew University","2020","Not on tenure/no tenure system, assistant professors","20","10","10","0","0","0","0","0","0","2","1","1","1","0","1","2","0","2","10","8","2","0","0","0","3","0","3","2","1","1","-2"
"184348","Drew University","2020","Not on tenure/no tenure system, instructors","1","0","1","0","0","0","0","0","0","0","0","0","0","0","0","0","0","0","1","0","1","0","0","0","0","0","0","0","0","0","-2"
"184694","Fairleigh Dickinson University-Florham Campus","2020","Tenured total","78","48","30","0","0","0","11","7","4","1","1","0","0","0","0","0","0","0","64","39","25","2","1","1","0","0","0","0","0","0","-2"
"184694","Fairleigh Dickinson University-Florham Campus","2020","Tenured, professors","45","30","15","0","0","0","7","5","2","0","0","0","0","0","0","0","0","0","37","25","12","1","0","1","0","0","0","0","0","0","-2"
"184694","Fairleigh Dickinson University-Florham Campus","2020","Tenured, associate professors","31","16","15","0","0","0","3","1","2","1","1","0","0","0","0","0","0","0","26","13","13","1","1","0","0","0","0","0","0","0","-2"
"184694","Fairleigh Dickinson University-Florham Campus","2020","Tenured, assistant professors","2","2","0","0","0","0","1","1","0","0","0","0","0","0","0","0","0","0","1","1","0","0","0","0","0","0","0","0","0","0","-2"
"184694","Fairleigh Dickinson University-Florham Campus","2020","On-Tenure track total","43","16","27","0","0","0","7","1","6","3","0","3","3","1","2","0","0","0","23","11","12","2","0","2","5","3","2","0","0","0","-2"
"184694","Fairleigh Dickinson University-Florham Campus","2020","On-tenure track, professors","1","0","1","0","0","0","0","0","0","0","0","0","0","0","0","0","0","0","1","0","1","0","0","0","0","0","0","0","0","0","-2"
"184694","Fairleigh Dickinson University-Florham Campus","2020","On-tenure track, associate professors","9","3","6","0","0","0","1","0","1","0","0","0","0","0","0","0","0","0","7","3","4","1","0","1","0","0","0","0","0","0","-2"
"184694","Fairleigh Dickinson University-Florham Campus","2020","On-tenure track, assistant professors","33","13","20","0","0","0","6","1","5","3","0","3","3","1","2","0","0","0","15","8","7","1","0","1","5","3","2","0","0","0","-2"
"184694","Fairleigh Dickinson University-Florham Campus","2020","Not on tenure track/No tenure system system total","42","11","31","0","0","0","6","1","5","3","2","1","0","0","0","0","0","0","30","8","22","2","0","2","1","0","1","0","0","0","-2"
"184694","Fairleigh Dickinson University-Florham Campus","2020","Not on tenure/no tenure system, associate professors","3","1","2","0","0","0","0","0","0","0","0","0","0","0","0","0","0","0","3","1","2","0","0","0","0","0","0","0","0","0","-2"
"184694","Fairleigh Dickinson University-Florham Campus","2020","Not on tenure/no tenure system, assistant professors","17","2","15","0","0","0","4","1","3","1","0","1","0","0","0","0","0","0","11","1","10","1","0","1","0","0","0","0","0","0","-2"
"184694","Fairleigh Dickinson University-Florham Campus","2020","Not on tenure/no tenure system, instructors","1","0","1","0","0","0","0","0","0","0","0","0","0","0","0","0","0","0","1","0","1","0","0","0","0","0","0","0","0","0","-2"
"184694","Fairleigh Dickinson University-Florham Campus","2020","Not on tenure/no tenure system, lecturers","21","8","13","0","0","0","2","0","2","2","2","0","0","0","0","0","0","0","15","6","9","1","0","1","1","0","1","0","0","0","-2"
"185828","New Jersey Institute of Technology","2020","Tenured total","224","185","39","0","0","0","67","54","13","10","6","4","6","5","1","0","0","0","125","107","18","0","0","0","11","11","0","5","2","3","-2"
"185828","New Jersey Institute of Technology","2020","Tenured, professors","134","117","17","0","0","0","38","33","5","7","4","3","2","2","0","0","0","0","75","66","9","0","0","0","11","11","0","1","1","0","-2"
"185828","New Jersey Institute of Technology","2020","Tenured, associate professors","90","68","22","0","0","0","29","21","8","3","2","1","4","3","1","0","0","0","50","41","9","0","0","0","0","0","0","4","1","3","-2"
"185828","New Jersey Institute of Technology","2020","On-Tenure track total","89","60","29","0","0","0","22","17","5","0","0","0","1","1","0","0","0","0","36","21","15","0","0","0","0","0","0","30","21","9","-2"
"185828","New Jersey Institute of Technology","2020","On-tenure track, professors","1","1","0","0","0","0","0","0","0","0","0","0","0","0","0","0","0","0","1","1","0","0","0","0","0","0","0","0","0","0","-2"
"185828","New Jersey Institute of Technology","2020","On-tenure track, associate professors","8","7","1","0","0","0","3","3","0","0","0","0","0","0","0","0","0","0","2","1","1","0","0","0","0","0","0","3","3","0","-2"
"185828","New Jersey Institute of Technology","2020","On-tenure track, assistant professors","80","52","28","0","0","0","19","14","5","0","0","0","1","1","0","0","0","0","33","19","14","0","0","0","0","0","0","27","18","9","-2"
"185828","New Jersey Institute of Technology","2020","Not on tenure track/No tenure system system total","131","89","42","0","0","0","15","11","4","2","2","0","10","10","0","0","0","0","93","59","34","2","0","2","1","1","0","8","6","2","-2"
"185828","New Jersey Institute of Technology","2020","Not on tenure/no tenure system, assistant professors","1","1","0","0","0","0","0","0","0","0","0","0","0","0","0","0","0","0","0","0","0","0","0","0","0","0","0","1","1","0","-2"
"185828","New Jersey Institute of Technology","2020","Not on tenure/no tenure system, instructors","1","0","1","0","0","0","0","0","0","0","0","0","0","0","0","0","0","0","0","0","0","0","0","0","0","0","0","1","0","1","-2"
"185828","New Jersey Institute of Technology","2020","Not on tenure/no tenure system, lecturers","129","88","41","0","0","0","15","11","4","2","2","0","10","10","0","0","0","0","93","59","34","2","0","2","1","1","0","6","5","1","-2"
"186201","Ramapo College of New Jersey","2020","Tenured total","168","79","89","0","0","0","25","13","12","11","5","6","13","2","11","0","0","0","115","58","57","3","1","2","0","0","0","1","0","1","-2"
"186201","Ramapo College of New Jersey","2020","Tenured, professors","67","34","33","0","0","0","8","4","4","4","2","2","4","0","4","0","0","0","49","27","22","2","1","1","0","0","0","0","0","0","-2"
"186201","Ramapo College of New Jersey","2020","Tenured, associate professors","88","39","49","0","0","0","12","7","5","3","1","2","9","2","7","0","0","0","62","29","33","1","0","1","0","0","0","1","0","1","-2"
"186201","Ramapo College of New Jersey","2020","Tenured, assistant professors","13","6","7","0","0","0","5","2","3","4","2","2","0","0","0","0","0","0","4","2","2","0","0","0","0","0","0","0","0","0","-2"
"186201","Ramapo College of New Jersey","2020","On-Tenure track total","37","17","20","0","0","0","6","2","4","7","3","4","3","2","1","0","0","0","18","9","9","0","0","0","2","1","1","1","0","1","-2"
"186201","Ramapo College of New Jersey","2020","On-tenure track, associate professors","3","2","1","0","0","0","0","0","0","0","0","0","1","1","0","0","0","0","1","1","0","0","0","0","0","0","0","1","0","1","-2"
"186201","Ramapo College of New Jersey","2020","On-tenure track, assistant professors","34","15","19","0","0","0","6","2","4","7","3","4","2","1","1","0","0","0","17","8","9","0","0","0","2","1","1","0","0","0","-2"
"186201","Ramapo College of New Jersey","2020","Not on tenure track/No tenure system system total","10","5","5","0","0","0","2","0","2","0","0","0","0","0","0","0","0","0","8","5","3","0","0","0","0","0","0","0","0","0","-2"
"186201","Ramapo College of New Jersey","2020","Not on tenure/no tenure system, assistant professors","9","5","4","0","0","0","2","0","2","0","0","0","0","0","0","0","0","0","7","5","2","0","0","0","0","0","0","0","0","0","-2"
"186201","Ramapo College of New Jersey","2020","Not on tenure/no tenure system, instructors","1","0","1","0","0","0","0","0","0","0","0","0","0","0","0","0","0","0","1","0","1","0","0","0","0","0","0","0","0","0","-2"
"186283","Rider University","2020","Tenured total","142","78","64","0","0","0","17","8","9","6","2","4","3","1","2","0","0","0","115","66","49","0","0","0","0","0","0","1","1","0","-2"
"186283","Rider University","2020","Tenured, professors","70","44","26","0","0","0","6","4","2","3","2","1","3","1","2","0","0","0","58","37","21","0","0","0","0","0","0","0","0","0","-2"
"186283","Rider University","2020","Tenured, associate professors","71","34","37","0","0","0","11","4","7","3","0","3","0","0","0","0","0","0","56","29","27","0","0","0","0","0","0","1","1","0","-2"
"186283","Rider University","2020","Tenured, assistant professors","1","0","1","0","0","0","0","0","0","0","0","0","0","0","0","0","0","0","1","0","1","0","0","0","0","0","0","0","0","0","-2"
"186283","Rider University","2020","On-Tenure track total","41","16","25","0","0","0","4","2","2","1","1","0","1","0","1","0","0","0","29","9","20","0","0","0","0","0","0","6","4","2","-2"
"186283","Rider University","2020","On-tenure track, professors","2","0","2","0","0","0","0","0","0","0","0","0","0","0","0","0","0","0","2","0","2","0","0","0","0","0","0","0","0","0","-2"
"186283","Rider University","2020","On-tenure track, associate professors","8","3","5","0","0","0","1","1","0","0","0","0","0","0","0","0","0","0","7","2","5","0","0","0","0","0","0","0","0","0","-2"
"186283","Rider University","2020","On-tenure track, assistant professors","30","12","18","0","0","0","3","1","2","1","1","0","1","0","1","0","0","0","19","6","13","0","0","0","0","0","0","6","4","2","-2"
"186283","Rider University","2020","On-tenure track, lecturers","1","1","0","0","0","0","0","0","0","0","0","0","0","0","0","0","0","0","1","1","0","0","0","0","0","0","0","0","0","0","-2"
"186283","Rider University","2020","Not on tenure track/No tenure system system total","11","4","7","0","0","0","0","0","0","1","1","0","0","0","0","0","0","0","9","3","6","1","0","1","0","0","0","0","0","0","-2"
"186283","Rider University","2020","Not on tenure/no tenure system, professors","1","0","1","0","0","0","0","0","0","0","0","0","0","0","0","0","0","0","0","0","0","1","0","1","0","0","0","0","0","0","-2"
"186283","Rider University","2020","Not on tenure/no tenure system, assistant professors","4","2","2","0","0","0","0","0","0","0","0","0","0","0","0","0","0","0","4","2","2","0","0","0","0","0","0","0","0","0","-2"
"186283","Rider University","2020","Not on tenure/no tenure system, lecturers","6","2","4","0","0","0","0","0","0","1","1","0","0","0","0","0","0","0","5","1","4","0","0","0","0","0","0","0","0","0","-2"
"186371","Rutgers University-Camden","2020","Tenured total","174","109","65","0","0","0","25","22","3","5","3","2","6","4","2","0","0","0","104","61","43","2","2","0","16","8","8","16","9","7","-2"
"186371","Rutgers University-Camden","2020","Tenured, professors","96","65","31","0","0","0","17","17","0","2","0","2","2","1","1","0","0","0","63","39","24","1","1","0","6","3","3","5","4","1","-2"
"186371","Rutgers University-Camden","2020","Tenured, associate professors","78","44","34","0","0","0","8","5","3","3","3","0","4","3","1","0","0","0","41","22","19","1","1","0","10","5","5","11","5","6","-2"
"186371","Rutgers University-Camden","2020","On-Tenure track total","61","22","39","0","0","0","2","1","1","4","0","4","2","1","1","0","0","0","13","2","11","0","0","0","27","14","13","13","4","9","-2"
"186371","Rutgers University-Camden","2020","On-tenure track, professors","1","0","1","0","0","0","0","0","0","0","0","0","0","0","0","0","0","0","1","0","1","0","0","0","0","0","0","0","0","0","-2"
"186371","Rutgers University-Camden","2020","On-tenure track, associate professors","4","3","1","0","0","0","0","0","0","0","0","0","0","0","0","0","0","0","0","0","0","0","0","0","3","2","1","1","1","0","-2"
"186371","Rutgers University-Camden","2020","On-tenure track, assistant professors","56","19","37","0","0","0","2","1","1","4","0","4","2","1","1","0","0","0","12","2","10","0","0","0","24","12","12","12","3","9","-2"
"186371","Rutgers University-Camden","2020","Not on tenure track/No tenure system system total","75","32","43","0","0","0","2","2","0","1","0","1","1","1","0","0","0","0","39","10","29","1","1","0","23","11","12","8","7","1","-2"
"186371","Rutgers University-Camden","2020","Not on tenure/no tenure system, professors","11","2","9","0","0","0","0","0","0","0","0","0","0","0","0","0","0","0","10","2","8","0","0","0","1","0","1","0","0","0","-2"
"186371","Rutgers University-Camden","2020","Not on tenure/no tenure system, associate professors","12","5","7","0","0","0","1","1","0","0","0","0","0","0","0","0","0","0","8","2","6","0","0","0","3","2","1","0","0","0","-2"
"186371","Rutgers University-Camden","2020","Not on tenure/no tenure system, assistant professors","43","18","25","0","0","0","1","1","0","1","0","1","0","0","0","0","0","0","19","5","14","1","1","0","15","6","9","6","5","1","-2"
"186371","Rutgers University-Camden","2020","Not on tenure/no tenure system, instructors","8","6","2","0","0","0","0","0","0","0","0","0","1","1","0","0","0","0","1","0","1","0","0","0","4","3","1","2","2","0","-2"
"186371","Rutgers University-Camden","2020","Not on tenure/no tenure system, lecturers","1","1","0","0","0","0","0","0","0","0","0","0","0","0","0","0","0","0","1","1","0","0","0","0","0","0","0","0","0","0","-2"
"186584","Seton Hall University","2020","Tenured total","217","125","92","0","0","0","23","11","12","7","4","3","9","6","3","0","0","0","173","101","72","0","0","0","4","2","2","1","1","0","-2"
"186584","Seton Hall University","2020","Tenured, professors","111","65","46","0","0","0","11","7","4","4","3","1","5","3","2","0","0","0","89","52","37","0","0","0","2","0","2","0","0","0","-2"
"186584","Seton Hall University","2020","Tenured, associate professors","105","59","46","0","0","0","12","4","8","3","1","2","4","3","1","0","0","0","83","48","35","0","0","0","2","2","0","1","1","0","-2"
"186584","Seton Hall University","2020","Tenured, assistant professors","1","1","0","0","0","0","0","0","0","0","0","0","0","0","0","0","0","0","1","1","0","0","0","0","0","0","0","0","0","0","-2"
"186584","Seton Hall University","2020","On-Tenure track total","58","26","32","1","0","1","3","1","2","1","1","0","2","1","1","0","0","0","41","19","22","0","0","0","5","1","4","5","3","2","-2"
"186584","Seton Hall University","2020","On-tenure track, professors","1","1","0","0","0","0","0","0","0","0","0","0","0","0","0","0","0","0","1","1","0","0","0","0","0","0","0","0","0","0","-2"
"186584","Seton Hall University","2020","On-tenure track, associate professors","8","4","4","0","0","0","0","0","0","0","0","0","0","0","0","0","0","0","8","4","4","0","0","0","0","0","0","0","0","0","-2"
"186584","Seton Hall University","2020","On-tenure track, assistant professors","49","21","28","1","0","1","3","1","2","1","1","0","2","1","1","0","0","0","32","14","18","0","0","0","5","1","4","5","3","2","-2"
"186584","Seton Hall University","2020","Not on tenure track/No tenure system system total","190","85","105","0","0","0","11","5","6","11","4","7","10","4","6","0","0","0","151","68","83","1","0","1","1","1","0","5","3","2","-2"
"186584","Seton Hall University","2020","Not on tenure/no tenure system, professors","5","3","2","0","0","0","0","0","0","0","0","0","0","0","0","0","0","0","5","3","2","0","0","0","0","0","0","0","0","0","-2"
"186584","Seton Hall University","2020","Not on tenure/no tenure system, associate professors","28","13","15","0","0","0","3","2","1","1","1","0","2","1","1","0","0","0","22","9","13","0","0","0","0","0","0","0","0","0","-2"
"186584","Seton Hall University","2020","Not on tenure/no tenure system, assistant professors","36","8","28","0","0","0","1","1","0","4","0","4","1","0","1","0","0","0","29","6","23","0","0","0","0","0","0","1","1","0","-2"
"186584","Seton Hall University","2020","Not on tenure/no tenure system, instructors","23","2","21","0","0","0","1","0","1","2","0","2","3","0","3","0","0","0","17","2","15","0","0","0","0","0","0","0","0","0","-2"
"186584","Seton Hall University","2020","Not on tenure/no tenure system, lecturers","17","9","8","0","0","0","1","0","1","0","0","0","0","0","0","0","0","0","16","9","7","0","0","0","0","0","0","0","0","0","-2"
"186584","Seton Hall University","2020","Not on tenure/no tenure system, no academic rank","81","50","31","0","0","0","5","2","3","4","3","1","4","3","1","0","0","0","62","39","23","1","0","1","1","1","0","4","2","2","-2"
"188429","Adelphi University","2020","Tenured total","224","112","112","0","0","0","34","12","22","7","2","5","15","7","8","0","0","0","164","91","73","1","0","1","3","0","3","0","0","0","-2"
"188429","Adelphi University","2020","Tenured, professors","95","50","45","0","0","0","12","4","8","2","0","2","5","3","2","0","0","0","74","43","31","0","0","0","2","0","2","0","0","0","-2"
"188429","Adelphi University","2020","Tenured, associate professors","127","61","66","0","0","0","22","8","14","5","2","3","10","4","6","0","0","0","88","47","41","1","0","1","1","0","1","0","0","0","-2"
"188429","Adelphi University","2020","Tenured, assistant professors","2","1","1","0","0","0","0","0","0","0","0","0","0","0","0","0","0","0","2","1","1","0","0","0","0","0","0","0","0","0","-2"
"188429","Adelphi University","2020","On-Tenure track total","64","30","34","0","0","0","11","7","4","4","0","4","7","3","4","0","0","0","37","18","19","2","1","1","3","1","2","0","0","0","-2"
"188429","Adelphi University","2020","On-tenure track, associate professors","3","2","1","0","0","0","0","0","0","0","0","0","1","1","0","0","0","0","1","0","1","1","1","0","0","0","0","0","0","0","-2"
"188429","Adelphi University","2020","On-tenure track, assistant professors","61","28","33","0","0","0","11","7","4","4","0","4","6","2","4","0","0","0","36","18","18","1","0","1","3","1","2","0","0","0","-2"
"188429","Adelphi University","2020","Not on tenure track/No tenure system system total","60","20","40","0","0","0","2","1","1","3","0","3","5","2","3","0","0","0","48","16","32","1","0","1","1","1","0","0","0","0","-2"
"188429","Adelphi University","2020","Not on tenure/no tenure system, instructors","8","2","6","0","0","0","1","1","0","0","0","0","0","0","0","0","0","0","7","1","6","0","0","0","0","0","0","0","0","0","-2"
"188429","Adelphi University","2020","Not on tenure/no tenure system, lecturers","19","7","12","0","0","0","0","0","0","2","0","2","2","0","2","0","0","0","13","6","7","1","0","1","1","1","0","0","0","0","-2"
"188429","Adelphi University","2020","Not on tenure/no tenure system, no academic rank","33","11","22","0","0","0","1","0","1","1","0","1","3","2","1","0","0","0","28","9","19","0","0","0","0","0","0","0","0","0","-2"
"190549","CUNY Brooklyn College","2020","Tenured total","366","206","160","0","0","0","45","23","22","25","17","8","19","8","11","0","0","0","258","149","109","2","1","1","1","0","1","16","8","8","-2"
"190549","CUNY Brooklyn College","2020","Tenured, professors","193","121","72","0","0","0","17","11","6","9","5","4","9","5","4","0","0","0","153","97","56","1","1","0","1","0","1","3","2","1","-2"
"190549","CUNY Brooklyn College","2020","Tenured, associate professors","135","68","67","0","0","0","24","10","14","12","9","3","8","2","6","0","0","0","79","41","38","0","0","0","0","0","0","12","6","6","-2"
"190549","CUNY Brooklyn College","2020","Tenured, assistant professors","17","8","9","0","0","0","3","2","1","2","1","1","2","1","1","0","0","0","9","4","5","0","0","0","0","0","0","1","0","1","-2"
"190549","CUNY Brooklyn College","2020","Tenured, lecturers","21","9","12","0","0","0","1","0","1","2","2","0","0","0","0","0","0","0","17","7","10","1","0","1","0","0","0","0","0","0","-2"
"190549","CUNY Brooklyn College","2020","On-Tenure track total","82","35","47","0","0","0","14","3","11","6","3","3","9","4","5","0","0","0","45","20","25","2","1","1","1","1","0","5","3","2","-2"
"190549","CUNY Brooklyn College","2020","On-tenure track, professors","1","0","1","0","0","0","1","0","1","0","0","0","0","0","0","0","0","0","0","0","0","0","0","0","0","0","0","0","0","0","-2"
"190549","CUNY Brooklyn College","2020","On-tenure track, associate professors","5","3","2","0","0","0","0","0","0","0","0","0","0","0","0","0","0","0","4","2","2","0","0","0","0","0","0","1","1","0","-2"
"190549","CUNY Brooklyn College","2020","On-tenure track, assistant professors","68","28","40","0","0","0","12","3","9","6","3","3","9","4","5","0","0","0","35","14","21","2","1","1","1","1","0","3","2","1","-2"
"190549","CUNY Brooklyn College","2020","On-tenure track, lecturers","8","4","4","0","0","0","1","0","1","0","0","0","0","0","0","0","0","0","6","4","2","0","0","0","0","0","0","1","0","1","-2"
"190549","CUNY Brooklyn College","2020","Not on tenure track/No tenure system system total","23","10","13","0","0","0","1","1","0","3","0","3","3","1","2","0","0","0","16","8","8","0","0","0","0","0","0","0","0","0","-2"
"190549","CUNY Brooklyn College","2020","Not on tenure/no tenure system, professors","7","3","4","0","0","0","0","0","0","0","0","0","1","1","0","0","0","0","6","2","4","0","0","0","0","0","0","0","0","0","-2"
"190549","CUNY Brooklyn College","2020","Not on tenure/no tenure system, associate professors","1","0","1","0","0","0","0","0","0","0","0","0","1","0","1","0","0","0","0","0","0","0","0","0","0","0","0","0","0","0","-2"
"190549","CUNY Brooklyn College","2020","Not on tenure/no tenure system, lecturers","15","7","8","0","0","0","1","1","0","3","0","3","1","0","1","0","0","0","10","6","4","0","0","0","0","0","0","0","0","0","-2"
"190646","CUNY Medgar Evers College","2020","Tenured total","88","52","36","0","0","0","8","4","4","55","35","20","8","5","3","0","0","0","12","7","5","2","1","1","0","0","0","3","0","3","-2"
"190646","CUNY Medgar Evers College","2020","Tenured, professors","37","21","16","0","0","0","5","3","2","22","13","9","2","1","1","0","0","0","7","4","3","0","0","0","0","0","0","1","0","1","-2"
"190646","CUNY Medgar Evers College","2020","Tenured, associate professors","21","9","12","0","0","0","1","0","1","10","5","5","3","2","1","0","0","0","4","2","2","1","0","1","0","0","0","2","0","2","-2"
"190646","CUNY Medgar Evers College","2020","Tenured, assistant professors","9","6","3","0","0","0","1","1","0","5","2","3","2","2","0","0","0","0","0","0","0","1","1","0","0","0","0","0","0","0","-2"
"190646","CUNY Medgar Evers College","2020","Tenured, lecturers","21","16","5","0","0","0","1","0","1","18","15","3","1","0","1","0","0","0","1","1","0","0","0","0","0","0","0","0","0","0","-2"
"190646","CUNY Medgar Evers College","2020","On-Tenure track total","45","18","27","0","0","0","6","4","2","27","9","18","2","1","1","0","0","0","6","2","4","2","0","2","0","0","0","2","2","0","-2"
"190646","CUNY Medgar Evers College","2020","On-tenure track, professors","1","1","0","0","0","0","0","0","0","1","1","0","0","0","0","0","0","0","0","0","0","0","0","0","0","0","0","0","0","0","-2"
"190646","CUNY Medgar Evers College","2020","On-tenure track, associate professors","11","6","5","0","0","0","3","2","1","5","3","2","1","0","1","0","0","0","1","0","1","0","0","0","0","0","0","1","1","0","-2"
"190646","CUNY Medgar Evers College","2020","On-tenure track, assistant professors","28","11","17","0","0","0","3","2","1","16","5","11","1","1","0","0","0","0","5","2","3","2","0","2","0","0","0","1","1","0","-2"
"190646","CUNY Medgar Evers College","2020","On-tenure track, instructors","1","0","1","0","0","0","0","0","0","1","0","1","0","0","0","0","0","0","0","0","0","0","0","0","0","0","0","0","0","0","-2"
"190646","CUNY Medgar Evers College","2020","On-tenure track, lecturers","4","0","4","0","0","0","0","0","0","4","0","4","0","0","0","0","0","0","0","0","0","0","0","0","0","0","0","0","0","0","-2"
"190646","CUNY Medgar Evers College","2020","Not on tenure track/No tenure system system total","12","7","5","0","0","0","1","1","0","10","6","4","1","0","1","0","0","0","0","0","0","0","0","0","0","0","0","0","0","0","-2"
"190646","CUNY Medgar Evers College","2020","Not on tenure/no tenure system, assistant professors","4","3","1","0","0","0","1","1","0","3","2","1","0","0","0","0","0","0","0","0","0","0","0","0","0","0","0","0","0","0","-2"
"190646","CUNY Medgar Evers College","2020","Not on tenure/no tenure system, instructors","1","1","0","0","0","0","0","0","0","1","1","0","0","0","0","0","0","0","0","0","0","0","0","0","0","0","0","0","0","0","-2"
"190646","CUNY Medgar Evers College","2020","Not on tenure/no tenure system, lecturers","7","3","4","0","0","0","0","0","0","6","3","3","1","0","1","0","0","0","0","0","0","0","0","0","0","0","0","0","0","0","-2"
"191241","Fordham University","2020","Tenured total","456","273","183","0","0","0","50","29","21","18","11","7","15","11","4","0","0","0","346","213","133","10","4","6","3","0","3","14","5","9","-2"
"191241","Fordham University","2020","Tenured, professors","244","158","86","0","0","0","25","17","8","7","5","2","9","6","3","0","0","0","194","125","69","4","3","1","1","0","1","4","2","2","-2"
"191241","Fordham University","2020","Tenured, associate professors","195","106","89","0","0","0","24","11","13","9","5","4","6","5","1","0","0","0","139","81","58","6","1","5","1","0","1","10","3","7","-2"
"191241","Fordham University","2020","Tenured, assistant professors","17","9","8","0","0","0","1","1","0","2","1","1","0","0","0","0","0","0","13","7","6","0","0","0","1","0","1","0","0","0","-2"
"191241","Fordham University","2020","On-Tenure track total","120","49","71","0","0","0","18","5","13","13","5","8","7","4","3","0","0","0","46","12","34","5","3","2","5","2","3","26","18","8","-2"
"191241","Fordham University","2020","On-tenure track, associate professors","11","6","5","0","0","0","2","2","0","0","0","0","1","1","0","0","0","0","6","2","4","0","0","0","2","1","1","0","0","0","-2"
"191241","Fordham University","2020","On-tenure track, assistant professors","109","43","66","0","0","0","16","3","13","13","5","8","6","3","3","0","0","0","40","10","30","5","3","2","3","1","2","26","18","8","-2"
"191241","Fordham University","2020","Not on tenure track/No tenure system system total","14","8","6","0","0","0","3","1","2","2","0","2","0","0","0","0","0","0","3","3","0","2","1","1","0","0","0","4","3","1","-2"
"191241","Fordham University","2020","Not on tenure/no tenure system, instructors","14","8","6","0","0","0","3","1","2","2","0","2","0","0","0","0","0","0","3","3","0","2","1","1","0","0","0","4","3","1","-2"
"191931","Iona College","2020","Tenured total","90","55","35","0","0","0","13","6","7","2","1","1","1","0","1","0","0","0","73","47","26","0","0","0","0","0","0","1","1","0","-2"
"191931","Iona College","2020","Tenured, professors","39","28","11","0","0","0","2","1","1","1","1","0","1","0","1","0","0","0","34","25","9","0","0","0","0","0","0","1","1","0","-2"
"191931","Iona College","2020","Tenured, associate professors","50","27","23","0","0","0","11","5","6","1","0","1","0","0","0","0","0","0","38","22","16","0","0","0","0","0","0","0","0","0","-2"
"191931","Iona College","2020","Tenured, assistant professors","1","0","1","0","0","0","0","0","0","0","0","0","0","0","0","0","0","0","1","0","1","0","0","0","0","0","0","0","0","0","-2"
"191931","Iona College","2020","On-Tenure track total","51","19","32","0","0","0","9","4","5","6","1","5","2","1","1","0","0","0","33","13","20","0","0","0","0","0","0","1","0","1","-2"
"191931","Iona College","2020","On-tenure track, associate professors","2","0","2","0","0","0","1","0","1","0","0","0","0","0","0","0","0","0","1","0","1","0","0","0","0","0","0","0","0","0","-2"
"191931","Iona College","2020","On-tenure track, assistant professors","49","19","30","0","0","0","8","4","4","6","1","5","2","1","1","0","0","0","32","13","19","0","0","0","0","0","0","1","0","1","-2"
"191931","Iona College","2020","Not on tenure track/No tenure system system total","22","12","10","0","0","0","2","0","2","1","0","1","2","1","1","0","0","0","15","10","5","1","1","0","1","0","1","0","0","0","-2"
"191931","Iona College","2020","Not on tenure/no tenure system, professors","2","1","1","0","0","0","0","0","0","1","0","1","0","0","0","0","0","0","1","1","0","0","0","0","0","0","0","0","0","0","-2"
"191931","Iona College","2020","Not on tenure/no tenure system, assistant professors","2","1","1","0","0","0","0","0","0","0","0","0","1","1","0","0","0","0","1","0","1","0","0","0","0","0","0","0","0","0","-2"
"191931","Iona College","2020","Not on tenure/no tenure system, instructors","2","1","1","0","0","0","1","0","1","0","0","0","0","0","0","0","0","0","1","1","0","0","0","0","0","0","0","0","0","0","-2"
"191931","Iona College","2020","Not on tenure/no tenure system, lecturers","16","9","7","0","0","0","1","0","1","0","0","0","1","0","1","0","0","0","12","8","4","1","1","0","1","0","1","0","0","0","-2"
"192703","Manhattan College","2020","Tenured total","146","81","65","0","0","0","13","7","6","3","2","1","5","2","3","0","0","0","107","61","46","0","0","0","18","9","9","0","0","0","-2"
"192703","Manhattan College","2020","Tenured, professors","62","38","24","0","0","0","4","3","1","0","0","0","0","0","0","0","0","0","56","33","23","0","0","0","2","2","0","0","0","0","-2"
"192703","Manhattan College","2020","Tenured, associate professors","60","33","27","0","0","0","4","2","2","2","2","0","3","1","2","0","0","0","41","24","17","0","0","0","10","4","6","0","0","0","-2"
"192703","Manhattan College","2020","Tenured, assistant professors","24","10","14","0","0","0","5","2","3","1","0","1","2","1","1","0","0","0","10","4","6","0","0","0","6","3","3","0","0","0","-2"
"192703","Manhattan College","2020","On-Tenure track total","70","34","36","0","0","0","10","4","6","1","0","1","2","0","2","0","0","0","41","21","20","2","0","2","14","9","5","0","0","0","-2"
"192703","Manhattan College","2020","On-tenure track, professors","2","1","1","0","0","0","0","0","0","0","0","0","0","0","0","0","0","0","2","1","1","0","0","0","0","0","0","0","0","0","-2"
"192703","Manhattan College","2020","On-tenure track, associate professors","10","6","4","0","0","0","2","2","0","0","0","0","0","0","0","0","0","0","4","1","3","0","0","0","4","3","1","0","0","0","-2"
"192703","Manhattan College","2020","On-tenure track, assistant professors","56","27","29","0","0","0","8","2","6","1","0","1","2","0","2","0","0","0","33","19","14","2","0","2","10","6","4","0","0","0","-2"
"192703","Manhattan College","2020","On-tenure track, instructors","2","0","2","0","0","0","0","0","0","0","0","0","0","0","0","0","0","0","2","0","2","0","0","0","0","0","0","0","0","0","-2"
"192703","Manhattan College","2020","Not on tenure track/No tenure system system total","26","18","8","0","0","0","4","3","1","1","0","1","1","1","0","0","0","0","14","9","5","0","0","0","5","4","1","1","1","0","-2"
"192703","Manhattan College","2020","Not on tenure/no tenure system, professors","5","3","2","0","0","0","0","0","0","0","0","0","0","0","0","0","0","0","4","2","2","0","0","0","1","1","0","0","0","0","-2"
"192703","Manhattan College","2020","Not on tenure/no tenure system, associate professors","2","1","1","0","0","0","0","0","0","0","0","0","0","0","0","0","0","0","2","1","1","0","0","0","0","0","0","0","0","0","-2"
"192703","Manhattan College","2020","Not on tenure/no tenure system, assistant professors","18","14","4","0","0","0","3","3","0","1","0","1","1","1","0","0","0","0","8","6","2","0","0","0","4","3","1","1","1","0","-2"
"192703","Manhattan College","2020","Not on tenure/no tenure system, instructors","1","0","1","0","0","0","1","0","1","0","0","0","0","0","0","0","0","0","0","0","0","0","0","0","0","0","0","0","0","0","-2"
"193353","Mount Saint Mary College","2020","Tenured total","50","25","25","0","0","0","1","0","1","2","0","2","1","1","0","0","0","0","44","23","21","0","0","0","0","0","0","2","1","1","-2"
"193353","Mount Saint Mary College","2020","Tenured, professors","23","13","10","0","0","0","0","0","0","0","0","0","0","0","0","0","0","0","22","12","10","0","0","0","0","0","0","1","1","0","-2"
"193353","Mount Saint Mary College","2020","Tenured, associate professors","27","12","15","0","0","0","1","0","1","2","0","2","1","1","0","0","0","0","22","11","11","0","0","0","0","0","0","1","0","1","-2"
"193353","Mount Saint Mary College","2020","On-Tenure track total","34","11","23","0","0","0","5","1","4","0","0","0","1","1","0","0","0","0","22","8","14","0","0","0","6","1","5","0","0","0","-2"
"193353","Mount Saint Mary College","2020","On-tenure track, associate professors","2","0","2","0","0","0","0","0","0","0","0","0","0","0","0","0","0","0","0","0","0","0","0","0","2","0","2","0","0","0","-2"
"193353","Mount Saint Mary College","2020","On-tenure track, assistant professors","22","10","12","0","0","0","4","1","3","0","0","0","1","1","0","0","0","0","15","7","8","0","0","0","2","1","1","0","0","0","-2"
"193353","Mount Saint Mary College","2020","On-tenure track, instructors","10","1","9","0","0","0","1","0","1","0","0","0","0","0","0","0","0","0","7","1","6","0","0","0","2","0","2","0","0","0","-2"
"193353","Mount Saint Mary College","2020","Not on tenure track/No tenure system system total","2","1","1","0","0","0","0","0","0","0","0","0","0","0","0","0","0","0","2","1","1","0","0","0","0","0","0","0","0","0","-2"
"193353","Mount Saint Mary College","2020","Not on tenure/no tenure system, lecturers","2","1","1","0","0","0","0","0","0","0","0","0","0","0","0","0","0","0","2","1","1","0","0","0","0","0","0","0","0","0","-2"
"194091","New York Institute of Technology","2020","Tenured total","144","90","54","1","1","0","27","15","12","3","2","1","4","4","0","0","0","0","105","65","40","0","0","0","0","0","0","4","3","1","-2"
"194091","New York Institute of Technology","2020","Tenured, professors","51","38","13","1","1","0","12","7","5","2","2","0","0","0","0","0","0","0","35","27","8","0","0","0","0","0","0","1","1","0","-2"
"194091","New York Institute of Technology","2020","Tenured, associate professors","91","50","41","0","0","0","15","8","7","1","0","1","3","3","0","0","0","0","69","37","32","0","0","0","0","0","0","3","2","1","-2"
"194091","New York Institute of Technology","2020","Tenured, assistant professors","2","2","0","0","0","0","0","0","0","0","0","0","1","1","0","0","0","0","1","1","0","0","0","0","0","0","0","0","0","0","-2"
"194091","New York Institute of Technology","2020","On-Tenure track total","64","35","29","0","0","0","17","11","6","2","1","1","0","0","0","0","0","0","34","16","18","1","0","1","0","0","0","10","7","3","-2"
"194091","New York Institute of Technology","2020","On-tenure track, professors","1","0","1","0","0","0","1","0","1","0","0","0","0","0","0","0","0","0","0","0","0","0","0","0","0","0","0","0","0","0","-2"
"194091","New York Institute of Technology","2020","On-tenure track, associate professors","8","5","3","0","0","0","2","2","0","0","0","0","0","0","0","0","0","0","5","2","3","0","0","0","0","0","0","1","1","0","-2"
"194091","New York Institute of Technology","2020","On-tenure track, assistant professors","54","29","25","0","0","0","14","9","5","2","1","1","0","0","0","0","0","0","28","13","15","1","0","1","0","0","0","9","6","3","-2"
"194091","New York Institute of Technology","2020","On-tenure track, instructors","1","1","0","0","0","0","0","0","0","0","0","0","0","0","0","0","0","0","1","1","0","0","0","0","0","0","0","0","0","0","-2"
"194091","New York Institute of Technology","2020","Not on tenure track/No tenure system system total","131","73","58","0","0","0","20","15","5","5","2","3","7","3","4","0","0","0","91","50","41","5","1","4","0","0","0","3","2","1","-2"
"194091","New York Institute of Technology","2020","Not on tenure/no tenure system, professors","8","7","1","0","0","0","2","2","0","0","0","0","0","0","0","0","0","0","6","5","1","0","0","0","0","0","0","0","0","0","-2"
"194091","New York Institute of Technology","2020","Not on tenure/no tenure system, associate professors","52","27","25","0","0","0","8","6","2","2","1","1","2","1","1","0","0","0","40","19","21","0","0","0","0","0","0","0","0","0","-2"
"194091","New York Institute of Technology","2020","Not on tenure/no tenure system, assistant professors","63","32","31","0","0","0","7","4","3","3","1","2","4","1","3","0","0","0","42","23","19","4","1","3","0","0","0","3","2","1","-2"
"194091","New York Institute of Technology","2020","Not on tenure/no tenure system, instructors","7","7","0","0","0","0","3","3","0","0","0","0","1","1","0","0","0","0","3","3","0","0","0","0","0","0","0","0","0","0","-2"
"194091","New York Institute of Technology","2020","Not on tenure/no tenure system, no academic rank","1","0","1","0","0","0","0","0","0","0","0","0","0","0","0","0","0","0","0","0","0","1","0","1","0","0","0","0","0","0","-2"
"196176","State University of New York at New Paltz","2020","Tenured total","193","102","91","0","0","0","20","14","6","5","5","0","8","5","3","0","0","0","159","78","81","0","0","0","0","0","0","1","0","1","-2"
"196176","State University of New York at New Paltz","2020","Tenured, professors","57","37","20","0","0","0","10","7","3","1","1","0","1","1","0","0","0","0","45","28","17","0","0","0","0","0","0","0","0","0","-2"
"196176","State University of New York at New Paltz","2020","Tenured, associate professors","127","62","65","0","0","0","10","7","3","3","3","0","7","4","3","0","0","0","106","48","58","0","0","0","0","0","0","1","0","1","-2"
"196176","State University of New York at New Paltz","2020","Tenured, assistant professors","4","3","1","0","0","0","0","0","0","1","1","0","0","0","0","0","0","0","3","2","1","0","0","0","0","0","0","0","0","0","-2"
"196176","State University of New York at New Paltz","2020","Tenured, instructors","5","0","5","0","0","0","0","0","0","0","0","0","0","0","0","0","0","0","5","0","5","0","0","0","0","0","0","0","0","0","-2"
"196176","State University of New York at New Paltz","2020","On-Tenure track total","84","35","49","0","0","0","11","7","4","7","3","4","6","3","3","0","0","0","51","16","35","2","1","1","0","0","0","7","5","2","-2"
"196176","State University of New York at New Paltz","2020","On-tenure track, associate professors","15","3","12","0","0","0","2","1","1","1","0","1","1","0","1","0","0","0","10","2","8","1","0","1","0","0","0","0","0","0","-2"
"196176","State University of New York at New Paltz","2020","On-tenure track, assistant professors","64","31","33","0","0","0","9","6","3","6","3","3","5","3","2","0","0","0","36","13","23","1","1","0","0","0","0","7","5","2","-2"
"196176","State University of New York at New Paltz","2020","On-tenure track, instructors","5","1","4","0","0","0","0","0","0","0","0","0","0","0","0","0","0","0","5","1","4","0","0","0","0","0","0","0","0","0","-2"
"196176","State University of New York at New Paltz","2020","Not on tenure track/No tenure system system total","66","25","41","0","0","0","4","3","1","1","1","0","4","1","3","0","0","0","54","20","34","1","0","1","0","0","0","2","0","2","-2"
"196176","State University of New York at New Paltz","2020","Not on tenure/no tenure system, assistant professors","4","1","3","0","0","0","1","0","1","0","0","0","0","0","0","0","0","0","2","1","1","0","0","0","0","0","0","1","0","1","-2"
"196176","State University of New York at New Paltz","2020","Not on tenure/no tenure system, lecturers","62","24","38","0","0","0","3","3","0","1","1","0","4","1","3","0","0","0","52","19","33","1","0","1","0","0","0","1","0","1","-2"
"197230","Wells College","2020","Tenured total","17","11","6","0","0","0","0","0","0","1","1","0","1","0","1","2","2","0","13","8","5","0","0","0","0","0","0","0","0","0","-2"
"197230","Wells College","2020","Tenured, professors","13","7","6","0","0","0","0","0","0","1","1","0","1","0","1","1","1","0","10","5","5","0","0","0","0","0","0","0","0","0","-2"
"197230","Wells College","2020","Tenured, associate professors","4","4","0","0","0","0","0","0","0","0","0","0","0","0","0","1","1","0","3","3","0","0","0","0","0","0","0","0","0","0","-2"
"197230","Wells College","2020","On-Tenure track total","7","2","5","0","0","0","0","0","0","0","0","0","0","0","0","0","0","0","6","1","5","1","1","0","0","0","0","0","0","0","-2"
"197230","Wells College","2020","On-tenure track, assistant professors","7","2","5","0","0","0","0","0","0","0","0","0","0","0","0","0","0","0","6","1","5","1","1","0","0","0","0","0","0","0","-2"
"197230","Wells College","2020","Not on tenure track/No tenure system system total","7","3","4","0","0","0","0","0","0","0","0","0","1","1","0","0","0","0","5","1","4","1","1","0","0","0","0","0","0","0","-2"
"197230","Wells College","2020","Not on tenure/no tenure system, assistant professors","5","3","2","0","0","0","0","0","0","0","0","0","1","1","0","0","0","0","3","1","2","1","1","0","0","0","0","0","0","0","-2"
"197230","Wells College","2020","Not on tenure/no tenure system, instructors","1","0","1","0","0","0","0","0","0","0","0","0","0","0","0","0","0","0","1","0","1","0","0","0","0","0","0","0","0","0","-2"
"197230","Wells College","2020","Not on tenure/no tenure system, lecturers","1","0","1","0","0","0","0","0","0","0","0","0","0","0","0","0","0","0","1","0","1","0","0","0","0","0","0","0","0","0","-2"
"199607","Salem College","2020","Tenured total","24","6","18","0","0","0","1","1","0","0","0","0","2","0","2","0","0","0","21","5","16","0","0","0","0","0","0","0","0","0","-2"
"199607","Salem College","2020","Tenured, professors","8","1","7","0","0","0","0","0","0","0","0","0","0","0","0","0","0","0","8","1","7","0","0","0","0","0","0","0","0","0","-2"
"199607","Salem College","2020","Tenured, associate professors","15","4","11","0","0","0","1","1","0","0","0","0","2","0","2","0","0","0","12","3","9","0","0","0","0","0","0","0","0","0","-2"
"199607","Salem College","2020","Tenured, assistant professors","1","1","0","0","0","0","0","0","0","0","0","0","0","0","0","0","0","0","1","1","0","0","0","0","0","0","0","0","0","0","-2"
"199607","Salem College","2020","On-Tenure track total","2","0","2","0","0","0","1","0","1","0","0","0","0","0","0","0","0","0","1","0","1","0","0","0","0","0","0","0","0","0","-2"
"199607","Salem College","2020","On-tenure track, associate professors","1","0","1","0","0","0","1","0","1","0","0","0","0","0","0","0","0","0","0","0","0","0","0","0","0","0","0","0","0","0","-2"
"199607","Salem College","2020","On-tenure track, assistant professors","1","0","1","0","0","0","0","0","0","0","0","0","0","0","0","0","0","0","1","0","1","0","0","0","0","0","0","0","0","0","-2"
"199607","Salem College","2020","Not on tenure track/No tenure system system total","14","0","14","0","0","0","0","0","0","2","0","2","0","0","0","0","0","0","12","0","12","0","0","0","0","0","0","0","0","0","-2"
"199607","Salem College","2020","Not on tenure/no tenure system, associate professors","5","0","5","0","0","0","0","0","0","0","0","0","0","0","0","0","0","0","5","0","5","0","0","0","0","0","0","0","0","0","-2"
"199607","Salem College","2020","Not on tenure/no tenure system, assistant professors","8","0","8","0","0","0","0","0","0","2","0","2","0","0","0","0","0","0","6","0","6","0","0","0","0","0","0","0","0","0","-2"
"199607","Salem College","2020","Not on tenure/no tenure system, no academic rank","1","0","1","0","0","0","0","0","0","0","0","0","0","0","0","0","0","0","1","0","1","0","0","0","0","0","0","0","0","0","-2"
"206862","Southern Nazarene University","2020","Not on tenure track/No tenure system system total","73","36","37","3","1","2","1","1","0","5","3","2","1","1","0","0","0","0","62","30","32","1","0","1","0","0","0","0","0","0","-2"
"206862","Southern Nazarene University","2020","Not on tenure/no tenure system, professors","27","13","14","2","1","1","1","1","0","0","0","0","0","0","0","0","0","0","24","11","13","0","0","0","0","0","0","0","0","0","-2"
"206862","Southern Nazarene University","2020","Not on tenure/no tenure system, associate professors","21","11","10","0","0","0","0","0","0","1","1","0","0","0","0","0","0","0","20","10","10","0","0","0","0","0","0","0","0","0","-2"
"206862","Southern Nazarene University","2020","Not on tenure/no tenure system, assistant professors","25","12","13","1","0","1","0","0","0","4","2","2","1","1","0","0","0","0","18","9","9","1","0","1","0","0","0","0","0","0","-2"
"209065","Linfield University-McMinnville Campus","2020","Tenured total","80","37","43","0","0","0","5","2","3","1","0","1","3","1","2","0","0","0","71","34","37","0","0","0","0","0","0","0","0","0","209065"
"209065","Linfield University-McMinnville Campus","2020","Tenured, professors","44","25","19","0","0","0","3","1","2","0","0","0","2","1","1","0","0","0","39","23","16","0","0","0","0","0","0","0","0","0","209065"
"209065","Linfield University-McMinnville Campus","2020","Tenured, associate professors","32","10","22","0","0","0","2","1","1","1","0","1","1","0","1","0","0","0","28","9","19","0","0","0","0","0","0","0","0","0","209065"
"209065","Linfield University-McMinnville Campus","2020","Tenured, assistant professors","4","2","2","0","0","0","0","0","0","0","0","0","0","0","0","0","0","0","4","2","2","0","0","0","0","0","0","0","0","0","209065"
"209065","Linfield University-McMinnville Campus","2020","On-Tenure track total","24","10","14","1","0","1","2","1","1","0","0","0","2","0","2","1","1","0","16","7","9","0","0","0","2","1","1","0","0","0","209065"
"209065","Linfield University-McMinnville Campus","2020","On-tenure track, professors","1","1","0","0","0","0","0","0","0","0","0","0","0","0","0","0","0","0","1","1","0","0","0","0","0","0","0","0","0","0","209065"
"209065","Linfield University-McMinnville Campus","2020","On-tenure track, associate professors","2","1","1","0","0","0","1","1","0","0","0","0","0","0","0","0","0","0","1","0","1","0","0","0","0","0","0","0","0","0","209065"
"209065","Linfield University-McMinnville Campus","2020","On-tenure track, assistant professors","21","8","13","1","0","1","1","0","1","0","0","0","2","0","2","1","1","0","14","6","8","0","0","0","2","1","1","0","0","0","209065"
"209065","Linfield University-McMinnville Campus","2020","Not on tenure track/No tenure system system total","29","6","23","1","0","1","0","0","0","1","0","1","0","0","0","1","0","1","26","6","20","0","0","0","0","0","0","0","0","0","209065"
"209065","Linfield University-McMinnville Campus","2020","Not on tenure/no tenure system, professors","2","0","2","0","0","0","0","0","0","0","0","0","0","0","0","0","0","0","2","0","2","0","0","0","0","0","0","0","0","0","209065"
"209065","Linfield University-McMinnville Campus","2020","Not on tenure/no tenure system, associate professors","4","1","3","1","0","1","0","0","0","0","0","0","0","0","0","0","0","0","3","1","2","0","0","0","0","0","0","0","0","0","209065"
"209065","Linfield University-McMinnville Campus","2020","Not on tenure/no tenure system, assistant professors","23","5","18","0","0","0","0","0","0","1","0","1","0","0","0","1","0","1","21","5","16","0","0","0","0","0","0","0","0","0","209065"
"209612","Pacific University","2020","Tenured total","132","72","60","1","0","1","10","3","7","1","0","1","5","1","4","0","0","0","111","64","47","3","3","0","1","1","0","0","0","0","-2"
"209612","Pacific University","2020","Tenured, professors","66","41","25","0","0","0","3","2","1","0","0","0","2","0","2","0","0","0","60","38","22","1","1","0","0","0","0","0","0","0","-2"
"209612","Pacific University","2020","Tenured, associate professors","62","28","34","1","0","1","7","1","6","1","0","1","3","1","2","0","0","0","48","24","24","2","2","0","0","0","0","0","0","0","-2"
"209612","Pacific University","2020","Tenured, assistant professors","4","3","1","0","0","0","0","0","0","0","0","0","0","0","0","0","0","0","3","2","1","0","0","0","1","1","0","0","0","0","-2"
"209612","Pacific University","2020","On-Tenure track total","55","18","37","1","1","0","7","1","6","2","1","1","2","1","1","0","0","0","31","10","21","4","1","3","4","1","3","4","2","2","-2"
"209612","Pacific University","2020","On-tenure track, professors","1","1","0","0","0","0","0","0","0","0","0","0","0","0","0","0","0","0","1","1","0","0","0","0","0","0","0","0","0","0","-2"
"209612","Pacific University","2020","On-tenure track, associate professors","6","3","3","0","0","0","1","1","0","0","0","0","0","0","0","0","0","0","2","1","1","1","1","0","1","0","1","1","0","1","-2"
"209612","Pacific University","2020","On-tenure track, assistant professors","48","14","34","1","1","0","6","0","6","2","1","1","2","1","1","0","0","0","28","8","20","3","0","3","3","1","2","3","2","1","-2"
"209612","Pacific University","2020","Not on tenure track/No tenure system system total","94","32","62","1","1","0","7","3","4","0","0","0","5","1","4","0","0","0","72","24","48","4","3","1","4","0","4","1","0","1","-2"
"209612","Pacific University","2020","Not on tenure/no tenure system, professors","5","3","2","0","0","0","0","0","0","0","0","0","0","0","0","0","0","0","5","3","2","0","0","0","0","0","0","0","0","0","-2"
"209612","Pacific University","2020","Not on tenure/no tenure system, associate professors","19","10","9","1","1","0","0","0","0","0","0","0","0","0","0","0","0","0","17","8","9","1","1","0","0","0","0","0","0","0","-2"
"209612","Pacific University","2020","Not on tenure/no tenure system, assistant professors","59","16","43","0","0","0","6","3","3","0","0","0","3","1","2","0","0","0","43","10","33","3","2","1","4","0","4","0","0","0","-2"
"209612","Pacific University","2020","Not on tenure/no tenure system, instructors","10","3","7","0","0","0","1","0","1","0","0","0","2","0","2","0","0","0","7","3","4","0","0","0","0","0","0","0","0","0","-2"
"209612","Pacific University","2020","Not on tenure/no tenure system, no academic rank","1","0","1","0","0","0","0","0","0","0","0","0","0","0","0","0","0","0","0","0","0","0","0","0","0","0","0","1","0","1","-2"
"209807","Portland State University","2020","Tenured total","388","230","158","3","0","3","50","30","20","10","5","5","24","16","8","0","0","0","262","153","109","8","4","4","31","22","9","0","0","0","-2"
"209807","Portland State University","2020","Tenured, professors","200","132","68","2","0","2","27","18","9","3","2","1","12","8","4","0","0","0","135","90","45","4","2","2","17","12","5","0","0","0","-2"
"209807","Portland State University","2020","Tenured, associate professors","187","97","90","1","0","1","23","12","11","7","3","4","12","8","4","0","0","0","126","62","64","4","2","2","14","10","4","0","0","0","-2"
"209807","Portland State University","2020","Tenured, assistant professors","1","1","0","0","0","0","0","0","0","0","0","0","0","0","0","0","0","0","1","1","0","0","0","0","0","0","0","0","0","0","-2"
"209807","Portland State University","2020","On-Tenure track total","112","46","66","0","0","0","19","9","10","8","1","7","12","8","4","0","0","0","58","24","34","11","3","8","4","1","3","0","0","0","-2"
"209807","Portland State University","2020","On-tenure track, associate professors","2","2","0","0","0","0","1","1","0","0","0","0","0","0","0","0","0","0","1","1","0","0","0","0","0","0","0","0","0","0","-2"
"209807","Portland State University","2020","On-tenure track, assistant professors","110","44","66","0","0","0","18","8","10","8","1","7","12","8","4","0","0","0","57","23","34","11","3","8","4","1","3","0","0","0","-2"
"209807","Portland State University","2020","Not on tenure track/No tenure system system total","242","101","141","1","0","1","14","2","12","9","5","4","16","7","9","1","1","0","174","69","105","8","5","3","19","12","7","0","0","0","-2"
"209807","Portland State University","2020","Not on tenure/no tenure system, professors","12","7","5","0","0","0","0","0","0","0","0","0","0","0","0","0","0","0","12","7","5","0","0","0","0","0","0","0","0","0","-2"
"209807","Portland State University","2020","Not on tenure/no tenure system, associate professors","20","12","8","0","0","0","0","0","0","1","1","0","1","0","1","0","0","0","17","10","7","0","0","0","1","1","0","0","0","0","-2"
"209807","Portland State University","2020","Not on tenure/no tenure system, assistant professors","61","26","35","1","0","1","1","0","1","4","2","2","7","2","5","1","1","0","36","14","22","2","1","1","9","6","3","0","0","0","-2"
"209807","Portland State University","2020","Not on tenure/no tenure system, instructors","149","56","93","0","0","0","13","2","11","4","2","2","8","5","3","0","0","0","109","38","71","6","4","2","9","5","4","0","0","0","-2"
"210429","Western Oregon University","2020","Tenured total","127","61","66","0","0","0","6","1","5","3","2","1","7","2","5","0","0","0","106","54","52","0","0","0","5","2","3","0","0","0","-2"
"210429","Western Oregon University","2020","Tenured, professors","86","44","42","0","0","0","3","1","2","3","2","1","4","0","4","0","0","0","75","40","35","0","0","0","1","1","0","0","0","0","-2"
"210429","Western Oregon University","2020","Tenured, associate professors","41","17","24","0","0","0","3","0","3","0","0","0","3","2","1","0","0","0","31","14","17","0","0","0","4","1","3","0","0","0","-2"
"210429","Western Oregon University","2020","On-Tenure track total","37","15","22","0","0","0","2","1","1","0","0","0","2","1","1","0","0","0","20","9","11","0","0","0","9","4","5","4","0","4","-2"
"210429","Western Oregon University","2020","On-tenure track, associate professors","1","1","0","0","0","0","0","0","0","0","0","0","0","0","0","0","0","0","1","1","0","0","0","0","0","0","0","0","0","0","-2"
"210429","Western Oregon University","2020","On-tenure track, assistant professors","36","14","22","0","0","0","2","1","1","0","0","0","2","1","1","0","0","0","19","8","11","0","0","0","9","4","5","4","0","4","-2"
"210429","Western Oregon University","2020","Not on tenure track/No tenure system system total","124","52","72","0","0","0","4","2","2","1","0","1","6","0","6","0","0","0","90","38","52","2","0","2","19","10","9","2","2","0","-2"
"210429","Western Oregon University","2020","Not on tenure/no tenure system, assistant professors","53","22","31","0","0","0","2","1","1","0","0","0","1","0","1","0","0","0","38","14","24","0","0","0","11","6","5","1","1","0","-2"
"210429","Western Oregon University","2020","Not on tenure/no tenure system, instructors","67","29","38","0","0","0","2","1","1","1","0","1","5","0","5","0","0","0","49","23","26","2","0","2","7","4","3","1","1","0","-2"
"210429","Western Oregon University","2020","Not on tenure/no tenure system, lecturers","4","1","3","0","0","0","0","0","0","0","0","0","0","0","0","0","0","0","3","1","2","0","0","0","1","0","1","0","0","0","-2"
"210571","Albright College","2020","Tenured total","52","31","21","1","1","0","2","1","1","3","0","3","1","0","1","0","0","0","43","27","16","2","2","0","0","0","0","0","0","0","-2"
"210571","Albright College","2020","Tenured, professors","23","14","9","1","1","0","0","0","0","2","0","2","0","0","0","0","0","0","18","11","7","2","2","0","0","0","0","0","0","0","-2"
"210571","Albright College","2020","Tenured, associate professors","29","17","12","0","0","0","2","1","1","1","0","1","1","0","1","0","0","0","25","16","9","0","0","0","0","0","0","0","0","0","-2"
"210571","Albright College","2020","On-Tenure track total","31","15","16","1","1","0","1","0","1","1","0","1","2","1","1","0","0","0","20","9","11","0","0","0","6","4","2","0","0","0","-2"
"210571","Albright College","2020","On-tenure track, associate professors","9","4","5","0","0","0","0","0","0","1","0","1","0","0","0","0","0","0","8","4","4","0","0","0","0","0","0","0","0","0","-2"
"210571","Albright College","2020","On-tenure track, assistant professors","22","11","11","1","1","0","1","0","1","0","0","0","2","1","1","0","0","0","12","5","7","0","0","0","6","4","2","0","0","0","-2"
"210571","Albright College","2020","Not on tenure track/No tenure system system total","29","8","21","1","0","1","4","1","3","0","0","0","1","0","1","0","0","0","21","7","14","0","0","0","2","0","2","0","0","0","-2"
"210571","Albright College","2020","Not on tenure/no tenure system, associate professors","3","2","1","0","0","0","0","0","0","0","0","0","0","0","0","0","0","0","3","2","1","0","0","0","0","0","0","0","0","0","-2"
"210571","Albright College","2020","Not on tenure/no tenure system, assistant professors","10","2","8","0","0","0","2","1","1","0","0","0","0","0","0","0","0","0","8","1","7","0","0","0","0","0","0","0","0","0","-2"
"210571","Albright College","2020","Not on tenure/no tenure system, instructors","16","4","12","1","0","1","2","0","2","0","0","0","1","0","1","0","0","0","10","4","6","0","0","0","2","0","2","0","0","0","-2"
"212133","Eastern University","2020","Tenured total","35","19","16","0","0","0","3","1","2","5","4","1","2","1","1","0","0","0","25","13","12","0","0","0","0","0","0","0","0","0","-2"
"212133","Eastern University","2020","Tenured, professors","24","14","10","0","0","0","3","1","2","2","2","0","2","1","1","0","0","0","17","10","7","0","0","0","0","0","0","0","0","0","-2"
"212133","Eastern University","2020","Tenured, associate professors","11","5","6","0","0","0","0","0","0","3","2","1","0","0","0","0","0","0","8","3","5","0","0","0","0","0","0","0","0","0","-2"
"212133","Eastern University","2020","On-Tenure track total","31","15","16","0","0","0","3","2","1","2","1","1","0","0","0","0","0","0","24","12","12","1","0","1","1","0","1","0","0","0","-2"
"212133","Eastern University","2020","On-tenure track, professors","5","3","2","0","0","0","1","1","0","0","0","0","0","0","0","0","0","0","4","2","2","0","0","0","0","0","0","0","0","0","-2"
"212133","Eastern University","2020","On-tenure track, associate professors","10","7","3","0","0","0","1","1","0","1","1","0","0","0","0","0","0","0","8","5","3","0","0","0","0","0","0","0","0","0","-2"
"212133","Eastern University","2020","On-tenure track, assistant professors","16","5","11","0","0","0","1","0","1","1","0","1","0","0","0","0","0","0","12","5","7","1","0","1","1","0","1","0","0","0","-2"
"212133","Eastern University","2020","Not on tenure track/No tenure system system total","30","10","20","0","0","0","0","0","0","2","1","1","2","0","2","0","0","0","26","9","17","0","0","0","0","0","0","0","0","0","-2"
"212133","Eastern University","2020","Not on tenure/no tenure system, assistant professors","1","0","1","0","0","0","0","0","0","0","0","0","0","0","0","0","0","0","1","0","1","0","0","0","0","0","0","0","0","0","-2"
"212133","Eastern University","2020","Not on tenure/no tenure system, lecturers","22","6","16","0","0","0","0","0","0","1","0","1","2","0","2","0","0","0","19","6","13","0","0","0","0","0","0","0","0","0","-2"
"212133","Eastern University","2020","Not on tenure/no tenure system, no academic rank","7","4","3","0","0","0","0","0","0","1","1","0","0","0","0","0","0","0","6","3","3","0","0","0","0","0","0","0","0","0","-2"
"213367","La Salle University","2020","Tenured total","117","57","60","0","0","0","8","4","4","2","1","1","4","2","2","0","0","0","101","48","53","1","1","0","0","0","0","1","1","0","-2"
"213367","La Salle University","2020","Tenured, professors","36","21","15","0","0","0","2","1","1","1","1","0","2","2","0","0","0","0","30","16","14","1","1","0","0","0","0","0","0","0","-2"
"213367","La Salle University","2020","Tenured, associate professors","77","34","43","0","0","0","6","3","3","1","0","1","2","0","2","0","0","0","67","30","37","0","0","0","0","0","0","1","1","0","-2"
"213367","La Salle University","2020","Tenured, assistant professors","4","2","2","0","0","0","0","0","0","0","0","0","0","0","0","0","0","0","4","2","2","0","0","0","0","0","0","0","0","0","-2"
"213367","La Salle University","2020","On-Tenure track total","38","14","24","0","0","0","2","1","1","2","1","1","3","2","1","0","0","0","29","9","20","0","0","0","0","0","0","2","1","1","-2"
"213367","La Salle University","2020","On-tenure track, associate professors","3","1","2","0","0","0","0","0","0","0","0","0","1","1","0","0","0","0","2","0","2","0","0","0","0","0","0","0","0","0","-2"
"213367","La Salle University","2020","On-tenure track, assistant professors","35","13","22","0","0","0","2","1","1","2","1","1","2","1","1","0","0","0","27","9","18","0","0","0","0","0","0","2","1","1","-2"
"213367","La Salle University","2020","Not on tenure track/No tenure system system total","41","10","31","0","0","0","0","0","0","4","1","3","0","0","0","0","0","0","37","9","28","0","0","0","0","0","0","0","0","0","-2"
"213367","La Salle University","2020","Not on tenure/no tenure system, associate professors","1","0","1","0","0","0","0","0","0","0","0","0","0","0","0","0","0","0","1","0","1","0","0","0","0","0","0","0","0","0","-2"
"213367","La Salle University","2020","Not on tenure/no tenure system, assistant professors","31","9","22","0","0","0","0","0","0","3","1","2","0","0","0","0","0","0","28","8","20","0","0","0","0","0","0","0","0","0","-2"
"213367","La Salle University","2020","Not on tenure/no tenure system, instructors","9","1","8","0","0","0","0","0","0","1","0","1","0","0","0","0","0","0","8","1","7","0","0","0","0","0","0","0","0","0","-2"
"217420","Rhode Island College","2020","Tenured total","242","100","142","1","0","1","21","8","13","4","1","3","8","5","3","2","2","0","201","80","121","5","4","1","0","0","0","0","0","0","-2"
"217420","Rhode Island College","2020","Tenured, professors","119","52","67","1","0","1","10","4","6","1","0","1","1","1","0","1","1","0","104","45","59","1","1","0","0","0","0","0","0","0","-2"
"217420","Rhode Island College","2020","Tenured, associate professors","116","46","70","0","0","0","10","3","7","3","1","2","7","4","3","1","1","0","91","34","57","4","3","1","0","0","0","0","0","0","-2"
"217420","Rhode Island College","2020","Tenured, assistant professors","7","2","5","0","0","0","1","1","0","0","0","0","0","0","0","0","0","0","6","1","5","0","0","0","0","0","0","0","0","0","-2"
"217420","Rhode Island College","2020","On-Tenure track total","49","17","32","0","0","0","4","2","2","4","0","4","3","2","1","1","1","0","37","12","25","0","0","0","0","0","0","0","0","0","-2"
"217420","Rhode Island College","2020","On-tenure track, associate professors","1","0","1","0","0","0","0","0","0","0","0","0","0","0","0","0","0","0","1","0","1","0","0","0","0","0","0","0","0","0","-2"
"217420","Rhode Island College","2020","On-tenure track, assistant professors","48","17","31","0","0","0","4","2","2","4","0","4","3","2","1","1","1","0","36","12","24","0","0","0","0","0","0","0","0","0","-2"
"217420","Rhode Island College","2020","Not on tenure track/No tenure system system total","28","5","23","1","0","1","3","1","2","0","0","0","2","1","1","0","0","0","22","3","19","0","0","0","0","0","0","0","0","0","-2"
"217420","Rhode Island College","2020","Not on tenure/no tenure system, associate professors","1","0","1","1","0","1","0","0","0","0","0","0","0","0","0","0","0","0","0","0","0","0","0","0","0","0","0","0","0","0","-2"
"217420","Rhode Island College","2020","Not on tenure/no tenure system, assistant professors","27","5","22","0","0","0","3","1","2","0","0","0","2","1","1","0","0","0","22","3","19","0","0","0","0","0","0","0","0","0","-2"
"221661","Southern Adventist University","2020","Not on tenure track/No tenure system system total","138","65","73","1","0","1","5","3","2","10","2","8","9","4","5","1","1","0","110","53","57","0","0","0","2","2","0","0","0","0","-2"
"221661","Southern Adventist University","2020","Not on tenure/no tenure system, professors","60","32","28","0","0","0","3","2","1","3","1","2","1","0","1","0","0","0","52","28","24","0","0","0","1","1","0","0","0","0","-2"
"221661","Southern Adventist University","2020","Not on tenure/no tenure system, associate professors","56","29","27","0","0","0","1","1","0","3","0","3","6","4","2","1","1","0","45","23","22","0","0","0","0","0","0","0","0","0","-2"
"221661","Southern Adventist University","2020","Not on tenure/no tenure system, assistant professors","22","4","18","1","0","1","1","0","1","4","1","3","2","0","2","0","0","0","13","2","11","0","0","0","1","1","0","0","0","0","-2"
"222178","Abilene Christian University","2020","Tenured total","135","100","35","1","1","0","3","2","1","5","3","2","3","2","1","0","0","0","120","90","30","3","2","1","0","0","0","0","0","0","-2"
"222178","Abilene Christian University","2020","Tenured, professors","66","54","12","1","1","0","1","1","0","2","1","1","1","0","1","0","0","0","59","50","9","2","1","1","0","0","0","0","0","0","-2"
"222178","Abilene Christian University","2020","Tenured, associate professors","64","42","22","0","0","0","1","0","1","3","2","1","2","2","0","0","0","0","57","37","20","1","1","0","0","0","0","0","0","0","-2"
"222178","Abilene Christian University","2020","Tenured, assistant professors","5","4","1","0","0","0","1","1","0","0","0","0","0","0","0","0","0","0","4","3","1","0","0","0","0","0","0","0","0","0","-2"
"222178","Abilene Christian University","2020","On-Tenure track total","50","23","27","0","0","0","0","0","0","4","3","1","2","1","1","0","0","0","43","19","24","1","0","1","0","0","0","0","0","0","-2"
"222178","Abilene Christian University","2020","On-tenure track, associate professors","5","4","1","0","0","0","0","0","0","0","0","0","0","0","0","0","0","0","5","4","1","0","0","0","0","0","0","0","0","0","-2"
"222178","Abilene Christian University","2020","On-tenure track, assistant professors","42","19","23","0","0","0","0","0","0","4","3","1","2","1","1","0","0","0","35","15","20","1","0","1","0","0","0","0","0","0","-2"
"222178","Abilene Christian University","2020","On-tenure track, no academic rank","3","0","3","0","0","0","0","0","0","0","0","0","0","0","0","0","0","0","3","0","3","0","0","0","0","0","0","0","0","0","-2"
"222178","Abilene Christian University","2020","Not on tenure track/No tenure system system total","87","30","57","0","0","0","0","0","0","4","1","3","7","4","3","0","0","0","72","23","49","0","0","0","1","0","1","3","2","1","-2"
"222178","Abilene Christian University","2020","Not on tenure/no tenure system, professors","2","0","2","0","0","0","0","0","0","0","0","0","0","0","0","0","0","0","2","0","2","0","0","0","0","0","0","0","0","0","-2"
"222178","Abilene Christian University","2020","Not on tenure/no tenure system, associate professors","8","5","3","0","0","0","0","0","0","1","1","0","1","1","0","0","0","0","6","3","3","0","0","0","0","0","0","0","0","0","-2"
"222178","Abilene Christian University","2020","Not on tenure/no tenure system, assistant professors","13","5","8","0","0","0","0","0","0","0","0","0","0","0","0","0","0","0","13","5","8","0","0","0","0","0","0","0","0","0","-2"
"222178","Abilene Christian University","2020","Not on tenure/no tenure system, instructors","30","7","23","0","0","0","0","0","0","2","0","2","3","1","2","0","0","0","24","5","19","0","0","0","0","0","0","1","1","0","-2"
"222178","Abilene Christian University","2020","Not on tenure/no tenure system, no academic rank","34","13","21","0","0","0","0","0","0","1","0","1","3","2","1","0","0","0","27","10","17","0","0","0","1","0","1","2","1","1","-2"
"222983","Austin College","2020","Tenured total","68","49","19","1","1","0","2","1","1","1","0","1","4","1","3","0","0","0","59","45","14","0","0","0","1","1","0","0","0","0","-2"
"222983","Austin College","2020","Tenured, professors","28","21","7","1","1","0","0","0","0","1","0","1","2","0","2","0","0","0","24","20","4","0","0","0","0","0","0","0","0","0","-2"
"222983","Austin College","2020","Tenured, associate professors","40","28","12","0","0","0","2","1","1","0","0","0","2","1","1","0","0","0","35","25","10","0","0","0","1","1","0","0","0","0","-2"
"222983","Austin College","2020","On-Tenure track total","23","9","14","0","0","0","4","2","2","3","2","1","1","0","1","0","0","0","14","4","10","0","0","0","0","0","0","1","1","0","-2"
"222983","Austin College","2020","On-tenure track, assistant professors","23","9","14","0","0","0","4","2","2","3","2","1","1","0","1","0","0","0","14","4","10","0","0","0","0","0","0","1","1","0","-2"
"222983","Austin College","2020","Not on tenure track/No tenure system system total","9","1","8","1","0","1","0","0","0","0","0","0","0","0","0","0","0","0","8","1","7","0","0","0","0","0","0","0","0","0","-2"
"222983","Austin College","2020","Not on tenure/no tenure system, assistant professors","4","1","3","0","0","0","0","0","0","0","0","0","0","0","0","0","0","0","4","1","3","0","0","0","0","0","0","0","0","0","-2"
"222983","Austin College","2020","Not on tenure/no tenure system, instructors","5","0","5","1","0","1","0","0","0","0","0","0","0","0","0","0","0","0","4","0","4","0","0","0","0","0","0","0","0","0","-2"
"223232","Baylor University","2020","Tenured total","523","375","148","0","0","0","36","29","7","11","5","6","25","19","6","1","1","0","440","313","127","9","7","2","0","0","0","1","1","0","-2"
"223232","Baylor University","2020","Tenured, professors","283","223","60","0","0","0","9","9","0","7","4","3","11","9","2","1","1","0","249","195","54","6","5","1","0","0","0","0","0","0","-2"
"223232","Baylor University","2020","Tenured, associate professors","240","152","88","0","0","0","27","20","7","4","1","3","14","10","4","0","0","0","191","118","73","3","2","1","0","0","0","1","1","0","-2"
"223232","Baylor University","2020","On-Tenure track total","172","86","86","0","0","0","19","12","7","12","4","8","9","5","4","0","0","0","115","54","61","2","2","0","7","5","2","8","4","4","-2"
"223232","Baylor University","2020","On-tenure track, associate professors","19","10","9","0","0","0","2","2","0","3","2","1","0","0","0","0","0","0","13","6","7","0","0","0","0","0","0","1","0","1","-2"
"223232","Baylor University","2020","On-tenure track, assistant professors","153","76","77","0","0","0","17","10","7","9","2","7","9","5","4","0","0","0","102","48","54","2","2","0","7","5","2","7","4","3","-2"
"223232","Baylor University","2020","Not on tenure track/No tenure system system total","389","153","236","0","0","0","10","3","7","10","3","7","21","6","15","0","0","0","328","133","195","10","5","5","4","1","3","6","2","4","-2"
"223232","Baylor University","2020","Not on tenure/no tenure system, professors","14","4","10","0","0","0","0","0","0","0","0","0","1","1","0","0","0","0","13","3","10","0","0","0","0","0","0","0","0","0","-2"
"223232","Baylor University","2020","Not on tenure/no tenure system, associate professors","46","15","31","0","0","0","2","1","1","1","1","0","1","0","1","0","0","0","41","12","29","0","0","0","0","0","0","1","1","0","-2"
"223232","Baylor University","2020","Not on tenure/no tenure system, assistant professors","83","28","55","0","0","0","2","0","2","5","0","5","3","1","2","0","0","0","68","25","43","4","2","2","1","0","1","0","0","0","-2"
"223232","Baylor University","2020","Not on tenure/no tenure system, instructors","5","0","5","0","0","0","0","0","0","1","0","1","0","0","0","0","0","0","4","0","4","0","0","0","0","0","0","0","0","0","-2"
"223232","Baylor University","2020","Not on tenure/no tenure system, lecturers","241","106","135","0","0","0","6","2","4","3","2","1","16","4","12","0","0","0","202","93","109","6","3","3","3","1","2","5","1","4","-2"
"224323","University of Dallas","2020","Tenured total","79","55","24","0","0","0","1","0","1","1","1","0","7","4","3","0","0","0","66","49","17","2","0","2","2","1","1","0","0","0","-2"
"224323","University of Dallas","2020","Tenured, professors","18","15","3","0","0","0","0","0","0","0","0","0","0","0","0","0","0","0","18","15","3","0","0","0","0","0","0","0","0","0","-2"
"224323","University of Dallas","2020","Tenured, associate professors","57","37","20","0","0","0","1","0","1","1","1","0","7","4","3","0","0","0","45","31","14","1","0","1","2","1","1","0","0","0","-2"
"224323","University of Dallas","2020","Tenured, assistant professors","4","3","1","0","0","0","0","0","0","0","0","0","0","0","0","0","0","0","3","3","0","1","0","1","0","0","0","0","0","0","-2"
"224323","University of Dallas","2020","On-Tenure track total","33","16","17","0","0","0","2","1","1","2","1","1","3","2","1","0","0","0","23","10","13","2","2","0","1","0","1","0","0","0","-2"
"224323","University of Dallas","2020","On-tenure track, associate professors","6","3","3","0","0","0","2","1","1","0","0","0","1","0","1","0","0","0","3","2","1","0","0","0","0","0","0","0","0","0","-2"
"224323","University of Dallas","2020","On-tenure track, assistant professors","27","13","14","0","0","0","0","0","0","2","1","1","2","2","0","0","0","0","20","8","12","2","2","0","1","0","1","0","0","0","-2"
"224323","University of Dallas","2020","Not on tenure track/No tenure system system total","31","13","18","0","0","0","1","0","1","0","0","0","3","1","2","0","0","0","26","12","14","0","0","0","1","0","1","0","0","0","-2"
"224323","University of Dallas","2020","Not on tenure/no tenure system, instructors","31","13","18","0","0","0","1","0","1","0","0","0","3","1","2","0","0","0","26","12","14","0","0","0","1","0","1","0","0","0","-2"
"224545","Texas A&M University-Texarkana","2020","Tenured total","32","25","7","0","0","0","5","5","0","1","1","0","1","0","1","0","0","0","22","17","5","0","0","0","3","2","1","0","0","0","-2"
"224545","Texas A&M University-Texarkana","2020","Tenured, professors","18","14","4","0","0","0","3","3","0","1","1","0","1","0","1","0","0","0","13","10","3","0","0","0","0","0","0","0","0","0","-2"
"224545","Texas A&M University-Texarkana","2020","Tenured, associate professors","14","11","3","0","0","0","2","2","0","0","0","0","0","0","0","0","0","0","9","7","2","0","0","0","3","2","1","0","0","0","-2"
"224545","Texas A&M University-Texarkana","2020","On-Tenure track total","31","17","14","0","0","0","5","2","3","2","1","1","2","2","0","0","0","0","16","8","8","0","0","0","1","0","1","5","4","1","-2"
"224545","Texas A&M University-Texarkana","2020","On-tenure track, professors","1","1","0","0","0","0","0","0","0","0","0","0","0","0","0","0","0","0","1","1","0","0","0","0","0","0","0","0","0","0","-2"
"224545","Texas A&M University-Texarkana","2020","On-tenure track, associate professors","5","4","1","0","0","0","2","1","1","0","0","0","0","0","0","0","0","0","2","2","0","0","0","0","0","0","0","1","1","0","-2"
"224545","Texas A&M University-Texarkana","2020","On-tenure track, assistant professors","25","12","13","0","0","0","3","1","2","2","1","1","2","2","0","0","0","0","13","5","8","0","0","0","1","0","1","4","3","1","-2"
"224545","Texas A&M University-Texarkana","2020","Not on tenure track/No tenure system system total","30","5","25","0","0","0","0","0","0","2","1","1","3","1","2","0","0","0","23","3","20","0","0","0","2","0","2","0","0","0","-2"
"224545","Texas A&M University-Texarkana","2020","Not on tenure/no tenure system, professors","2","0","2","0","0","0","0","0","0","1","0","1","0","0","0","0","0","0","1","0","1","0","0","0","0","0","0","0","0","0","-2"
"224545","Texas A&M University-Texarkana","2020","Not on tenure/no tenure system, associate professors","1","0","1","0","0","0","0","0","0","0","0","0","0","0","0","0","0","0","1","0","1","0","0","0","0","0","0","0","0","0","-2"
"224545","Texas A&M University-Texarkana","2020","Not on tenure/no tenure system, assistant professors","7","1","6","0","0","0","0","0","0","0","0","0","1","0","1","0","0","0","6","1","5","0","0","0","0","0","0","0","0","0","-2"
"224545","Texas A&M University-Texarkana","2020","Not on tenure/no tenure system, instructors","19","3","16","0","0","0","0","0","0","1","1","0","1","0","1","0","0","0","15","2","13","0","0","0","2","0","2","0","0","0","-2"
"224545","Texas A&M University-Texarkana","2020","Not on tenure/no tenure system, lecturers","1","1","0","0","0","0","0","0","0","0","0","0","1","1","0","0","0","0","0","0","0","0","0","0","0","0","0","0","0","0","-2"
"224554","Texas A & M University-Commerce","2020","Tenured total","177","109","68","1","1","0","29","22","7","18","10","8","14","7","7","1","0","1","107","63","44","1","1","0","3","3","0","3","2","1","-2"
"224554","Texas A & M University-Commerce","2020","Tenured, professors","64","45","19","1","1","0","14","12","2","7","5","2","3","2","1","0","0","0","38","24","14","1","1","0","0","0","0","0","0","0","-2"
"224554","Texas A & M University-Commerce","2020","Tenured, associate professors","107","60","47","0","0","0","15","10","5","10","4","6","11","5","6","1","0","1","66","38","28","0","0","0","3","3","0","1","0","1","-2"
"224554","Texas A & M University-Commerce","2020","Tenured, assistant professors","6","4","2","0","0","0","0","0","0","1","1","0","0","0","0","0","0","0","3","1","2","0","0","0","0","0","0","2","2","0","-2"
"224554","Texas A & M University-Commerce","2020","On-Tenure track total","97","45","52","0","0","0","12","4","8","7","1","6","8","1","7","0","0","0","42","21","21","1","1","0","5","3","2","22","14","8","-2"
"224554","Texas A & M University-Commerce","2020","On-tenure track, associate professors","3","2","1","0","0","0","3","2","1","0","0","0","0","0","0","0","0","0","0","0","0","0","0","0","0","0","0","0","0","0","-2"
"224554","Texas A & M University-Commerce","2020","On-tenure track, assistant professors","93","42","51","0","0","0","9","2","7","7","1","6","8","1","7","0","0","0","42","21","21","1","1","0","5","3","2","21","13","8","-2"
"224554","Texas A & M University-Commerce","2020","On-tenure track, instructors","1","1","0","0","0","0","0","0","0","0","0","0","0","0","0","0","0","0","0","0","0","0","0","0","0","0","0","1","1","0","-2"
"224554","Texas A & M University-Commerce","2020","Not on tenure track/No tenure system system total","96","37","59","0","0","0","4","0","4","6","1","5","0","0","0","0","0","0","84","35","49","0","0","0","0","0","0","2","1","1","-2"
"224554","Texas A & M University-Commerce","2020","Not on tenure/no tenure system, associate professors","15","6","9","0","0","0","1","0","1","0","0","0","0","0","0","0","0","0","14","6","8","0","0","0","0","0","0","0","0","0","-2"
"224554","Texas A & M University-Commerce","2020","Not on tenure/no tenure system, assistant professors","19","9","10","0","0","0","2","0","2","0","0","0","0","0","0","0","0","0","17","9","8","0","0","0","0","0","0","0","0","0","-2"
"224554","Texas A & M University-Commerce","2020","Not on tenure/no tenure system, instructors","53","18","35","0","0","0","1","0","1","6","1","5","0","0","0","0","0","0","44","16","28","0","0","0","0","0","0","2","1","1","-2"
"224554","Texas A & M University-Commerce","2020","Not on tenure/no tenure system, lecturers","9","4","5","0","0","0","0","0","0","0","0","0","0","0","0","0","0","0","9","4","5","0","0","0","0","0","0","0","0","0","-2"
"225247","Hardin-Simmons University","2020","Tenured total","68","44","24","0","0","0","1","1","0","2","1","1","0","0","0","0","0","0","65","42","23","0","0","0","0","0","0","0","0","0","-2"
"225247","Hardin-Simmons University","2020","Tenured, professors","48","32","16","0","0","0","0","0","0","0","0","0","0","0","0","0","0","0","48","32","16","0","0","0","0","0","0","0","0","0","-2"
"225247","Hardin-Simmons University","2020","Tenured, associate professors","18","11","7","0","0","0","1","1","0","2","1","1","0","0","0","0","0","0","15","9","6","0","0","0","0","0","0","0","0","0","-2"
"225247","Hardin-Simmons University","2020","Tenured, assistant professors","2","1","1","0","0","0","0","0","0","0","0","0","0","0","0","0","0","0","2","1","1","0","0","0","0","0","0","0","0","0","-2"
"225247","Hardin-Simmons University","2020","Not on tenure track/No tenure system system total","36","17","19","0","0","0","0","0","0","0","0","0","3","0","3","0","0","0","32","17","15","0","0","0","1","0","1","0","0","0","-2"
"225247","Hardin-Simmons University","2020","Not on tenure/no tenure system, professors","1","1","0","0","0","0","0","0","0","0","0","0","0","0","0","0","0","0","1","1","0","0","0","0","0","0","0","0","0","0","-2"
"225247","Hardin-Simmons University","2020","Not on tenure/no tenure system, associate professors","6","3","3","0","0","0","0","0","0","0","0","0","1","0","1","0","0","0","5","3","2","0","0","0","0","0","0","0","0","0","-2"
"225247","Hardin-Simmons University","2020","Not on tenure/no tenure system, assistant professors","25","11","14","0","0","0","0","0","0","0","0","0","2","0","2","0","0","0","22","11","11","0","0","0","1","0","1","0","0","0","-2"
"225247","Hardin-Simmons University","2020","Not on tenure/no tenure system, instructors","4","2","2","0","0","0","0","0","0","0","0","0","0","0","0","0","0","0","4","2","2","0","0","0","0","0","0","0","0","0","-2"
"226091","Lamar University","2020","Tenured total","200","124","76","1","0","1","10","9","1","8","3","5","7","5","2","0","0","0","117","71","46","0","0","0","2","2","0","55","34","21","-2"
"226091","Lamar University","2020","Tenured, professors","84","56","28","0","0","0","7","6","1","2","0","2","2","1","1","0","0","0","51","31","20","0","0","0","0","0","0","22","18","4","-2"
"226091","Lamar University","2020","Tenured, associate professors","109","65","44","1","0","1","3","3","0","6","3","3","5","4","1","0","0","0","60","38","22","0","0","0","1","1","0","33","16","17","-2"
"226091","Lamar University","2020","Tenured, assistant professors","7","3","4","0","0","0","0","0","0","0","0","0","0","0","0","0","0","0","6","2","4","0","0","0","1","1","0","0","0","0","-2"
"226091","Lamar University","2020","On-Tenure track total","78","40","38","0","0","0","6","4","2","10","2","8","6","4","2","0","0","0","40","18","22","0","0","0","2","2","0","14","10","4","-2"
"226091","Lamar University","2020","On-tenure track, associate professors","3","1","2","0","0","0","0","0","0","1","0","1","0","0","0","0","0","0","2","1","1","0","0","0","0","0","0","0","0","0","-2"
"226091","Lamar University","2020","On-tenure track, assistant professors","72","37","35","0","0","0","6","4","2","9","2","7","6","4","2","0","0","0","36","16","20","0","0","0","2","2","0","13","9","4","-2"
"226091","Lamar University","2020","On-tenure track, instructors","3","2","1","0","0","0","0","0","0","0","0","0","0","0","0","0","0","0","2","1","1","0","0","0","0","0","0","1","1","0","-2"
"226091","Lamar University","2020","Not on tenure track/No tenure system system total","156","54","102","1","0","1","4","2","2","7","1","6","8","3","5","0","0","0","121","38","83","0","0","0","1","0","1","14","10","4","-2"
"226091","Lamar University","2020","Not on tenure/no tenure system, professors","1","0","1","0","0","0","0","0","0","0","0","0","0","0","0","0","0","0","1","0","1","0","0","0","0","0","0","0","0","0","-2"
"226091","Lamar University","2020","Not on tenure/no tenure system, assistant professors","11","5","6","0","0","0","1","0","1","1","0","1","1","1","0","0","0","0","6","2","4","0","0","0","0","0","0","2","2","0","-2"
"226091","Lamar University","2020","Not on tenure/no tenure system, instructors","144","49","95","1","0","1","3","2","1","6","1","5","7","2","5","0","0","0","114","36","78","0","0","0","1","0","1","12","8","4","-2"
"226383","Lubbock Christian University","2020","Tenured total","51","29","22","0","0","0","0","0","0","0","0","0","2","2","0","0","0","0","49","27","22","0","0","0","0","0","0","0","0","0","-2"
"226383","Lubbock Christian University","2020","Tenured, professors","28","17","11","0","0","0","0","0","0","0","0","0","0","0","0","0","0","0","28","17","11","0","0","0","0","0","0","0","0","0","-2"
"226383","Lubbock Christian University","2020","Tenured, associate professors","18","12","6","0","0","0","0","0","0","0","0","0","2","2","0","0","0","0","16","10","6","0","0","0","0","0","0","0","0","0","-2"
"226383","Lubbock Christian University","2020","Tenured, assistant professors","5","0","5","0","0","0","0","0","0","0","0","0","0","0","0","0","0","0","5","0","5","0","0","0","0","0","0","0","0","0","-2"
"226383","Lubbock Christian University","2020","On-Tenure track total","31","15","16","0","0","0","0","0","0","1","0","1","1","0","1","0","0","0","29","15","14","0","0","0","0","0","0","0","0","0","-2"
"226383","Lubbock Christian University","2020","On-tenure track, professors","2","1","1","0","0","0","0","0","0","0","0","0","0","0","0","0","0","0","2","1","1","0","0","0","0","0","0","0","0","0","-2"
"226383","Lubbock Christian University","2020","On-tenure track, associate professors","6","6","0","0","0","0","0","0","0","0","0","0","0","0","0","0","0","0","6","6","0","0","0","0","0","0","0","0","0","0","-2"
"226383","Lubbock Christian University","2020","On-tenure track, assistant professors","21","8","13","0","0","0","0","0","0","1","0","1","1","0","1","0","0","0","19","8","11","0","0","0","0","0","0","0","0","0","-2"
"226383","Lubbock Christian University","2020","On-tenure track, instructors","2","0","2","0","0","0","0","0","0","0","0","0","0","0","0","0","0","0","2","0","2","0","0","0","0","0","0","0","0","0","-2"
"226383","Lubbock Christian University","2020","Not on tenure track/No tenure system system total","5","2","3","0","0","0","0","0","0","0","0","0","0","0","0","0","0","0","5","2","3","0","0","0","0","0","0","0","0","0","-2"
"226383","Lubbock Christian University","2020","Not on tenure/no tenure system, no academic rank","5","2","3","0","0","0","0","0","0","0","0","0","0","0","0","0","0","0","5","2","3","0","0","0","0","0","0","0","0","0","-2"
"226471","University of Mary Hardin-Baylor","2020","Tenured total","69","35","34","0","0","0","4","2","2","1","0","1","2","0","2","0","0","0","60","31","29","1","1","0","1","1","0","0","0","0","-2"
"226471","University of Mary Hardin-Baylor","2020","Tenured, professors","54","26","28","0","0","0","3","1","2","1","0","1","1","0","1","0","0","0","48","24","24","0","0","0","1","1","0","0","0","0","-2"
"226471","University of Mary Hardin-Baylor","2020","Tenured, associate professors","15","9","6","0","0","0","1","1","0","0","0","0","1","0","1","0","0","0","12","7","5","1","1","0","0","0","0","0","0","0","-2"
"226471","University of Mary Hardin-Baylor","2020","On-Tenure track total","58","25","33","0","0","0","5","3","2","7","5","2","1","0","1","1","1","0","41","16","25","1","0","1","2","0","2","0","0","0","-2"
"226471","University of Mary Hardin-Baylor","2020","On-tenure track, professors","7","3","4","0","0","0","0","0","0","0","0","0","0","0","0","0","0","0","5","3","2","0","0","0","2","0","2","0","0","0","-2"
"226471","University of Mary Hardin-Baylor","2020","On-tenure track, associate professors","13","6","7","0","0","0","0","0","0","2","0","2","1","0","1","0","0","0","10","6","4","0","0","0","0","0","0","0","0","0","-2"
"226471","University of Mary Hardin-Baylor","2020","On-tenure track, assistant professors","38","16","22","0","0","0","5","3","2","5","5","0","0","0","0","1","1","0","26","7","19","1","0","1","0","0","0","0","0","0","-2"
"226471","University of Mary Hardin-Baylor","2020","Not on tenure track/No tenure system system total","36","10","26","0","0","0","1","1","0","0","0","0","0","0","0","0","0","0","31","8","23","2","0","2","2","1","1","0","0","0","-2"
"226471","University of Mary Hardin-Baylor","2020","Not on tenure/no tenure system, professors","1","1","0","0","0","0","0","0","0","0","0","0","0","0","0","0","0","0","1","1","0","0","0","0","0","0","0","0","0","0","-2"
"226471","University of Mary Hardin-Baylor","2020","Not on tenure/no tenure system, associate professors","1","0","1","0","0","0","0","0","0","0","0","0","0","0","0","0","0","0","1","0","1","0","0","0","0","0","0","0","0","0","-2"
"226471","University of Mary Hardin-Baylor","2020","Not on tenure/no tenure system, assistant professors","23","5","18","0","0","0","0","0","0","0","0","0","0","0","0","0","0","0","21","5","16","1","0","1","1","0","1","0","0","0","-2"
"226471","University of Mary Hardin-Baylor","2020","Not on tenure/no tenure system, instructors","11","4","7","0","0","0","1","1","0","0","0","0","0","0","0","0","0","0","8","2","6","1","0","1","1","1","0","0","0","0","-2"
"226833","Midwestern State University","2020","Tenured total","126","72","54","1","0","1","6","4","2","1","0","1","5","3","2","0","0","0","95","54","41","1","1","0","1","0","1","16","10","6","-2"
"226833","Midwestern State University","2020","Tenured, professors","47","32","15","1","0","1","4","3","1","0","0","0","3","2","1","0","0","0","33","23","10","0","0","0","1","0","1","5","4","1","-2"
"226833","Midwestern State University","2020","Tenured, associate professors","74","37","37","0","0","0","2","1","1","1","0","1","2","1","1","0","0","0","57","28","29","1","1","0","0","0","0","11","6","5","-2"
"226833","Midwestern State University","2020","Tenured, assistant professors","5","3","2","0","0","0","0","0","0","0","0","0","0","0","0","0","0","0","5","3","2","0","0","0","0","0","0","0","0","0","-2"
"226833","Midwestern State University","2020","On-Tenure track total","57","26","31","1","0","1","3","1","2","0","0","0","4","2","2","0","0","0","38","16","22","0","0","0","0","0","0","11","7","4","-2"
"226833","Midwestern State University","2020","On-tenure track, associate professors","3","1","2","0","0","0","1","0","1","0","0","0","0","0","0","0","0","0","2","1","1","0","0","0","0","0","0","0","0","0","-2"
"226833","Midwestern State University","2020","On-tenure track, assistant professors","54","25","29","1","0","1","2","1","1","0","0","0","4","2","2","0","0","0","36","15","21","0","0","0","0","0","0","11","7","4","-2"
"226833","Midwestern State University","2020","Not on tenure track/No tenure system system total","50","15","35","0","0","0","0","0","0","1","0","1","0","0","0","0","0","0","45","13","32","1","1","0","1","1","0","2","0","2","-2"
"226833","Midwestern State University","2020","Not on tenure/no tenure system, associate professors","1","1","0","0","0","0","0","0","0","0","0","0","0","0","0","0","0","0","1","1","0","0","0","0","0","0","0","0","0","0","-2"
"226833","Midwestern State University","2020","Not on tenure/no tenure system, assistant professors","26","2","24","0","0","0","0","0","0","1","0","1","0","0","0","0","0","0","25","2","23","0","0","0","0","0","0","0","0","0","-2"
"226833","Midwestern State University","2020","Not on tenure/no tenure system, instructors","16","7","9","0","0","0","0","0","0","0","0","0","0","0","0","0","0","0","16","7","9","0","0","0","0","0","0","0","0","0","-2"
"226833","Midwestern State University","2020","Not on tenure/no tenure system, lecturers","7","5","2","0","0","0","0","0","0","0","0","0","0","0","0","0","0","0","3","3","0","1","1","0","1","1","0","2","0","2","-2"
"227881","Sam Houston State University","2020","Tenured total","365","221","144","1","0","1","42","26","16","8","3","5","25","12","13","0","0","0","288","180","108","1","0","1","0","0","0","0","0","0","-2"
"227881","Sam Houston State University","2020","Tenured, professors","190","124","66","0","0","0","22","15","7","3","2","1","13","7","6","0","0","0","152","100","52","0","0","0","0","0","0","0","0","0","-2"
"227881","Sam Houston State University","2020","Tenured, associate professors","172","97","75","1","0","1","20","11","9","5","1","4","12","5","7","0","0","0","133","80","53","1","0","1","0","0","0","0","0","0","-2"
"227881","Sam Houston State University","2020","Tenured, assistant professors","2","0","2","0","0","0","0","0","0","0","0","0","0","0","0","0","0","0","2","0","2","0","0","0","0","0","0","0","0","0","-2"
"227881","Sam Houston State University","2020","Tenured, instructors","1","0","1","0","0","0","0","0","0","0","0","0","0","0","0","0","0","0","1","0","1","0","0","0","0","0","0","0","0","0","-2"
"227881","Sam Houston State University","2020","On-Tenure track total","197","94","103","1","0","1","14","10","4","11","7","4","16","10","6","0","0","0","127","57","70","5","0","5","0","0","0","23","10","13","-2"
"227881","Sam Houston State University","2020","On-tenure track, professors","1","1","0","0","0","0","0","0","0","0","0","0","0","0","0","0","0","0","1","1","0","0","0","0","0","0","0","0","0","0","-2"
"227881","Sam Houston State University","2020","On-tenure track, associate professors","13","9","4","0","0","0","2","1","1","0","0","0","0","0","0","0","0","0","10","8","2","1","0","1","0","0","0","0","0","0","-2"
"227881","Sam Houston State University","2020","On-tenure track, assistant professors","183","84","99","1","0","1","12","9","3","11","7","4","16","10","6","0","0","0","116","48","68","4","0","4","0","0","0","23","10","13","-2"
"227881","Sam Houston State University","2020","Not on tenure track/No tenure system system total","242","95","147","1","1","0","6","0","6","20","7","13","20","10","10","0","0","0","179","72","107","7","2","5","0","0","0","9","3","6","-2"
"227881","Sam Houston State University","2020","Not on tenure/no tenure system, lecturers","242","95","147","1","1","0","6","0","6","20","7","13","20","10","10","0","0","0","179","72","107","7","2","5","0","0","0","9","3","6","-2"
"228343","Southwestern University","2020","Tenured total","75","36","39","1","1","0","4","1","3","2","1","1","7","3","4","0","0","0","59","28","31","0","0","0","1","1","0","1","1","0","-2"
"228343","Southwestern University","2020","Tenured, professors","39","15","24","0","0","0","2","1","1","0","0","0","3","1","2","0","0","0","33","12","21","0","0","0","1","1","0","0","0","0","-2"
"228343","Southwestern University","2020","Tenured, associate professors","36","21","15","1","1","0","2","0","2","2","1","1","4","2","2","0","0","0","26","16","10","0","0","0","0","0","0","1","1","0","-2"
"228343","Southwestern University","2020","On-Tenure track total","16","7","9","0","0","0","2","1","1","2","1","1","2","1","1","0","0","0","10","4","6","0","0","0","0","0","0","0","0","0","-2"
"228343","Southwestern University","2020","On-tenure track, assistant professors","16","7","9","0","0","0","2","1","1","2","1","1","2","1","1","0","0","0","10","4","6","0","0","0","0","0","0","0","0","0","-2"
"228343","Southwestern University","2020","Not on tenure track/No tenure system system total","19","6","13","0","0","0","1","0","1","1","0","1","5","1","4","0","0","0","10","4","6","2","1","1","0","0","0","0","0","0","-2"
"228343","Southwestern University","2020","Not on tenure/no tenure system, instructors","19","6","13","0","0","0","1","0","1","1","0","1","5","1","4","0","0","0","10","4","6","2","1","1","0","0","0","0","0","0","-2"
"228431","Stephen F Austin State University","2020","Tenured total","274","171","103","2","0","2","4","2","2","9","8","1","14","8","6","0","0","0","232","146","86","8","3","5","1","1","0","4","3","1","-2"
"228431","Stephen F Austin State University","2020","Tenured, professors","117","83","34","0","0","0","1","1","0","4","4","0","5","1","4","0","0","0","103","76","27","3","0","3","1","1","0","0","0","0","-2"
"228431","Stephen F Austin State University","2020","Tenured, associate professors","133","77","56","1","0","1","3","1","2","5","4","1","9","7","2","0","0","0","108","60","48","4","3","1","0","0","0","3","2","1","-2"
"228431","Stephen F Austin State University","2020","Tenured, assistant professors","19","10","9","1","0","1","0","0","0","0","0","0","0","0","0","0","0","0","16","9","7","1","0","1","0","0","0","1","1","0","-2"
"228431","Stephen F Austin State University","2020","Tenured, instructors","3","1","2","0","0","0","0","0","0","0","0","0","0","0","0","0","0","0","3","1","2","0","0","0","0","0","0","0","0","0","-2"
"228431","Stephen F Austin State University","2020","Tenured, lecturers","2","0","2","0","0","0","0","0","0","0","0","0","0","0","0","0","0","0","2","0","2","0","0","0","0","0","0","0","0","0","-2"
"228431","Stephen F Austin State University","2020","On-Tenure track total","115","54","61","1","1","0","6","2","4","3","1","2","6","5","1","0","0","0","91","43","48","0","0","0","1","0","1","7","2","5","-2"
"228431","Stephen F Austin State University","2020","On-tenure track, associate professors","13","6","7","1","1","0","1","0","1","0","0","0","0","0","0","0","0","0","11","5","6","0","0","0","0","0","0","0","0","0","-2"
"228431","Stephen F Austin State University","2020","On-tenure track, assistant professors","98","46","52","0","0","0","5","2","3","3","1","2","6","5","1","0","0","0","77","36","41","0","0","0","0","0","0","7","2","5","-2"
"228431","Stephen F Austin State University","2020","On-tenure track, instructors","4","2","2","0","0","0","0","0","0","0","0","0","0","0","0","0","0","0","3","2","1","0","0","0","1","0","1","0","0","0","-2"
"228431","Stephen F Austin State University","2020","Not on tenure track/No tenure system system total","141","41","100","1","0","1","1","0","1","3","1","2","8","2","6","0","0","0","123","34","89","3","3","0","0","0","0","2","1","1","-2"
"228431","Stephen F Austin State University","2020","Not on tenure/no tenure system, assistant professors","11","7","4","0","0","0","0","0","0","1","1","0","1","1","0","0","0","0","9","5","4","0","0","0","0","0","0","0","0","0","-2"
"228431","Stephen F Austin State University","2020","Not on tenure/no tenure system, instructors","43","4","39","0","0","0","0","0","0","2","0","2","3","0","3","0","0","0","38","4","34","0","0","0","0","0","0","0","0","0","-2"
"228431","Stephen F Austin State University","2020","Not on tenure/no tenure system, lecturers","78","27","51","1","0","1","1","0","1","0","0","0","4","1","3","0","0","0","68","22","46","3","3","0","0","0","0","1","1","0","-2"
"228431","Stephen F Austin State University","2020","Not on tenure/no tenure system, no academic rank","9","3","6","0","0","0","0","0","0","0","0","0","0","0","0","0","0","0","8","3","5","0","0","0","0","0","0","1","0","1","-2"
"228529","Tarleton State University","2020","Tenured total","178","115","63","2","1","1","12","7","5","5","3","2","13","8","5","0","0","0","140","91","49","1","1","0","4","3","1","1","1","0","-2"
"228529","Tarleton State University","2020","Tenured, professors","78","57","21","2","1","1","3","3","0","0","0","0","4","2","2","0","0","0","66","48","18","1","1","0","2","2","0","0","0","0","-2"
"228529","Tarleton State University","2020","Tenured, associate professors","100","58","42","0","0","0","9","4","5","5","3","2","9","6","3","0","0","0","74","43","31","0","0","0","2","1","1","1","1","0","-2"
"228529","Tarleton State University","2020","On-Tenure track total","122","65","57","1","1","0","8","6","2","8","2","6","5","4","1","0","0","0","86","41","45","3","2","1","1","1","0","10","8","2","-2"
"228529","Tarleton State University","2020","On-tenure track, professors","3","2","1","0","0","0","0","0","0","0","0","0","0","0","0","0","0","0","3","2","1","0","0","0","0","0","0","0","0","0","-2"
"228529","Tarleton State University","2020","On-tenure track, associate professors","8","5","3","1","1","0","0","0","0","1","0","1","1","1","0","0","0","0","5","3","2","0","0","0","0","0","0","0","0","0","-2"
"228529","Tarleton State University","2020","On-tenure track, assistant professors","110","57","53","0","0","0","8","6","2","7","2","5","4","3","1","0","0","0","77","35","42","3","2","1","1","1","0","10","8","2","-2"
"228529","Tarleton State University","2020","On-tenure track, instructors","1","1","0","0","0","0","0","0","0","0","0","0","0","0","0","0","0","0","1","1","0","0","0","0","0","0","0","0","0","0","-2"
"228529","Tarleton State University","2020","Not on tenure track/No tenure system system total","129","45","84","1","1","0","1","1","0","5","3","2","10","2","8","0","0","0","103","36","67","1","0","1","4","1","3","4","1","3","-2"
"228529","Tarleton State University","2020","Not on tenure/no tenure system, professors","2","2","0","1","1","0","0","0","0","0","0","0","0","0","0","0","0","0","1","1","0","0","0","0","0","0","0","0","0","0","-2"
"228529","Tarleton State University","2020","Not on tenure/no tenure system, associate professors","5","0","5","0","0","0","0","0","0","0","0","0","0","0","0","0","0","0","5","0","5","0","0","0","0","0","0","0","0","0","-2"
"228529","Tarleton State University","2020","Not on tenure/no tenure system, assistant professors","34","12","22","0","0","0","0","0","0","1","0","1","3","0","3","0","0","0","28","12","16","0","0","0","1","0","1","1","0","1","-2"
"228529","Tarleton State University","2020","Not on tenure/no tenure system, instructors","86","29","57","0","0","0","1","1","0","4","3","1","7","2","5","0","0","0","69","23","46","1","0","1","2","0","2","2","0","2","-2"
"228529","Tarleton State University","2020","Not on tenure/no tenure system, lecturers","2","2","0","0","0","0","0","0","0","0","0","0","0","0","0","0","0","0","0","0","0","0","0","0","1","1","0","1","1","0","-2"
"228787","The University of Texas at Dallas","2020","Tenured total","403","316","87","0","0","0","129","107","22","10","6","4","14","12","2","0","0","0","236","180","56","5","4","1","8","6","2","1","1","0","-2"
"228787","The University of Texas at Dallas","2020","Tenured, professors","252","208","44","0","0","0","84","71","13","0","0","0","7","6","1","0","0","0","155","125","30","2","2","0","4","4","0","0","0","0","-2"
"228787","The University of Texas at Dallas","2020","Tenured, associate professors","151","108","43","0","0","0","45","36","9","10","6","4","7","6","1","0","0","0","81","55","26","3","2","1","4","2","2","1","1","0","-2"
"228787","The University of Texas at Dallas","2020","On-Tenure track total","136","89","47","0","0","0","46","31","15","2","1","1","4","4","0","0","0","0","43","27","16","5","4","1","31","18","13","5","4","1","-2"
"228787","The University of Texas at Dallas","2020","On-tenure track, professors","1","1","0","0","0","0","0","0","0","0","0","0","0","0","0","0","0","0","1","1","0","0","0","0","0","0","0","0","0","0","-2"
"228787","The University of Texas at Dallas","2020","On-tenure track, associate professors","3","2","1","0","0","0","0","0","0","0","0","0","0","0","0","0","0","0","2","1","1","0","0","0","1","1","0","0","0","0","-2"
"228787","The University of Texas at Dallas","2020","On-tenure track, assistant professors","132","86","46","0","0","0","46","31","15","2","1","1","4","4","0","0","0","0","40","25","15","5","4","1","30","17","13","5","4","1","-2"
"228787","The University of Texas at Dallas","2020","Not on tenure track/No tenure system system total","369","196","173","0","0","0","90","47","43","9","6","3","11","7","4","0","0","0","227","116","111","5","4","1","26","16","10","1","0","1","-2"
"228787","The University of Texas at Dallas","2020","Not on tenure/no tenure system, lecturers","369","196","173","0","0","0","90","47","43","9","6","3","11","7","4","0","0","0","227","116","111","5","4","1","26","16","10","1","0","1","-2"
"228802","The University of Texas at Tyler","2020","Tenured total","151","94","57","0","0","0","23","16","7","8","3","5","9","8","1","0","0","0","109","65","44","0","0","0","2","2","0","0","0","0","-2"
"228802","The University of Texas at Tyler","2020","Tenured, professors","63","45","18","0","0","0","8","7","1","2","1","1","2","2","0","0","0","0","50","34","16","0","0","0","1","1","0","0","0","0","-2"
"228802","The University of Texas at Tyler","2020","Tenured, associate professors","88","49","39","0","0","0","15","9","6","6","2","4","7","6","1","0","0","0","59","31","28","0","0","0","1","1","0","0","0","0","-2"
"228802","The University of Texas at Tyler","2020","On-Tenure track total","68","34","34","0","0","0","15","7","8","1","1","0","2","1","1","0","0","0","43","21","22","1","1","0","6","3","3","0","0","0","-2"
"228802","The University of Texas at Tyler","2020","On-tenure track, associate professors","6","3","3","0","0","0","1","0","1","0","0","0","0","0","0","0","0","0","5","3","2","0","0","0","0","0","0","0","0","0","-2"
"228802","The University of Texas at Tyler","2020","On-tenure track, assistant professors","62","31","31","0","0","0","14","7","7","1","1","0","2","1","1","0","0","0","38","18","20","1","1","0","6","3","3","0","0","0","-2"
"228802","The University of Texas at Tyler","2020","Not on tenure track/No tenure system system total","139","38","101","0","0","0","8","6","2","8","4","4","7","3","4","0","0","0","110","22","88","0","0","0","6","3","3","0","0","0","-2"
"228802","The University of Texas at Tyler","2020","Not on tenure/no tenure system, professors","2","2","0","0","0","0","0","0","0","0","0","0","0","0","0","0","0","0","1","1","0","0","0","0","1","1","0","0","0","0","-2"
"228802","The University of Texas at Tyler","2020","Not on tenure/no tenure system, associate professors","2","0","2","0","0","0","0","0","0","0","0","0","0","0","0","0","0","0","2","0","2","0","0","0","0","0","0","0","0","0","-2"
"228802","The University of Texas at Tyler","2020","Not on tenure/no tenure system, assistant professors","1","0","1","0","0","0","0","0","0","0","0","0","0","0","0","0","0","0","1","0","1","0","0","0","0","0","0","0","0","0","-2"
"228802","The University of Texas at Tyler","2020","Not on tenure/no tenure system, instructors","81","13","68","0","0","0","3","2","1","4","1","3","4","2","2","0","0","0","66","7","59","0","0","0","4","1","3","0","0","0","-2"
"228802","The University of Texas at Tyler","2020","Not on tenure/no tenure system, lecturers","52","23","29","0","0","0","5","4","1","4","3","1","3","1","2","0","0","0","39","14","25","0","0","0","1","1","0","0","0","0","-2"
"228802","The University of Texas at Tyler","2020","Not on tenure/no tenure system, no academic rank","1","0","1","0","0","0","0","0","0","0","0","0","0","0","0","0","0","0","1","0","1","0","0","0","0","0","0","0","0","0","-2"
"229267","Trinity University","2020","Tenured total","181","108","73","1","0","1","16","8","8","6","4","2","18","11","7","0","0","0","139","84","55","0","0","0","1","1","0","0","0","0","-2"
"229267","Trinity University","2020","Tenured, professors","94","56","38","0","0","0","6","4","2","0","0","0","5","3","2","0","0","0","82","48","34","0","0","0","1","1","0","0","0","0","-2"
"229267","Trinity University","2020","Tenured, associate professors","87","52","35","1","0","1","10","4","6","6","4","2","13","8","5","0","0","0","57","36","21","0","0","0","0","0","0","0","0","0","-2"
"229267","Trinity University","2020","On-Tenure track total","46","22","24","0","0","0","9","3","6","0","0","0","6","4","2","0","0","0","31","15","16","0","0","0","0","0","0","0","0","0","-2"
"229267","Trinity University","2020","On-tenure track, assistant professors","46","22","24","0","0","0","9","3","6","0","0","0","6","4","2","0","0","0","31","15","16","0","0","0","0","0","0","0","0","0","-2"
"229267","Trinity University","2020","Not on tenure track/No tenure system system total","40","23","17","0","0","0","6","2","4","2","1","1","5","4","1","0","0","0","24","15","9","2","1","1","1","0","1","0","0","0","-2"
"229267","Trinity University","2020","Not on tenure/no tenure system, professors","5","5","0","0","0","0","1","1","0","0","0","0","1","1","0","0","0","0","2","2","0","1","1","0","0","0","0","0","0","0","-2"
"229267","Trinity University","2020","Not on tenure/no tenure system, associate professors","1","1","0","0","0","0","0","0","0","0","0","0","0","0","0","0","0","0","1","1","0","0","0","0","0","0","0","0","0","0","-2"
"229267","Trinity University","2020","Not on tenure/no tenure system, assistant professors","22","14","8","0","0","0","5","1","4","1","1","0","2","1","1","0","0","0","14","11","3","0","0","0","0","0","0","0","0","0","-2"
"229267","Trinity University","2020","Not on tenure/no tenure system, instructors","1","0","1","0","0","0","0","0","0","0","0","0","0","0","0","0","0","0","1","0","1","0","0","0","0","0","0","0","0","0","-2"
"229267","Trinity University","2020","Not on tenure/no tenure system, lecturers","10","3","7","0","0","0","0","0","0","1","0","1","2","2","0","0","0","0","5","1","4","1","0","1","1","0","1","0","0","0","-2"
"229267","Trinity University","2020","Not on tenure/no tenure system, no academic rank","1","0","1","0","0","0","0","0","0","0","0","0","0","0","0","0","0","0","1","0","1","0","0","0","0","0","0","0","0","0","-2"
"234827","Central Washington University","2020","Tenured total","152","90","62","0","0","0","10","5","5","2","1","1","7","4","3","3","3","0","128","76","52","2","1","1","0","0","0","0","0","0","-2"
"234827","Central Washington University","2020","Tenured, professors","78","49","29","0","0","0","4","3","1","0","0","0","2","2","0","3","3","0","68","41","27","1","0","1","0","0","0","0","0","0","-2"
"234827","Central Washington University","2020","Tenured, associate professors","73","40","33","0","0","0","6","2","4","2","1","1","5","2","3","0","0","0","59","34","25","1","1","0","0","0","0","0","0","0","-2"
"234827","Central Washington University","2020","Tenured, assistant professors","1","1","0","0","0","0","0","0","0","0","0","0","0","0","0","0","0","0","1","1","0","0","0","0","0","0","0","0","0","0","-2"
"234827","Central Washington University","2020","On-Tenure track total","83","42","41","0","0","0","7","4","3","3","1","2","3","1","2","0","0","0","68","35","33","0","0","0","0","0","0","2","1","1","-2"
"234827","Central Washington University","2020","On-tenure track, associate professors","2","1","1","0","0","0","0","0","0","0","0","0","0","0","0","0","0","0","2","1","1","0","0","0","0","0","0","0","0","0","-2"
"234827","Central Washington University","2020","On-tenure track, assistant professors","79","40","39","0","0","0","7","4","3","3","1","2","3","1","2","0","0","0","64","33","31","0","0","0","0","0","0","2","1","1","-2"
"234827","Central Washington University","2020","On-tenure track, lecturers","2","1","1","0","0","0","0","0","0","0","0","0","0","0","0","0","0","0","2","1","1","0","0","0","0","0","0","0","0","0","-2"
"234827","Central Washington University","2020","Not on tenure track/No tenure system system total","106","46","60","1","1","0","3","2","1","1","1","0","6","4","2","0","0","0","93","38","55","2","0","2","0","0","0","0","0","0","-2"
"234827","Central Washington University","2020","Not on tenure/no tenure system, professors","1","1","0","0","0","0","0","0","0","0","0","0","0","0","0","0","0","0","1","1","0","0","0","0","0","0","0","0","0","0","-2"
"234827","Central Washington University","2020","Not on tenure/no tenure system, assistant professors","2","0","2","0","0","0","0","0","0","0","0","0","0","0","0","0","0","0","2","0","2","0","0","0","0","0","0","0","0","0","-2"
"234827","Central Washington University","2020","Not on tenure/no tenure system, instructors","15","8","7","0","0","0","1","1","0","0","0","0","0","0","0","0","0","0","14","7","7","0","0","0","0","0","0","0","0","0","-2"
"234827","Central Washington University","2020","Not on tenure/no tenure system, lecturers","88","37","51","1","1","0","2","1","1","1","1","0","6","4","2","0","0","0","76","30","46","2","0","2","0","0","0","0","0","0","-2"
"235097","Eastern Washington University","2020","Tenured total","229","137","92","3","0","3","16","8","8","3","3","0","9","7","2","0","0","0","193","115","78","4","3","1","0","0","0","1","1","0","-2"
"235097","Eastern Washington University","2020","Tenured, professors","155","95","60","1","0","1","13","7","6","3","3","0","5","4","1","0","0","0","131","79","52","2","2","0","0","0","0","0","0","0","-2"
"235097","Eastern Washington University","2020","Tenured, associate professors","74","42","32","2","0","2","3","1","2","0","0","0","4","3","1","0","0","0","62","36","26","2","1","1","0","0","0","1","1","0","-2"
"235097","Eastern Washington University","2020","On-Tenure track total","66","25","41","0","0","0","4","2","2","3","3","0","3","1","2","0","0","0","47","15","32","3","2","1","0","0","0","6","2","4","-2"
"235097","Eastern Washington University","2020","On-tenure track, assistant professors","66","25","41","0","0","0","4","2","2","3","3","0","3","1","2","0","0","0","47","15","32","3","2","1","0","0","0","6","2","4","-2"
"235097","Eastern Washington University","2020","Not on tenure track/No tenure system system total","149","60","89","0","0","0","9","5","4","3","1","2","6","3","3","0","0","0","127","49","78","1","1","0","0","0","0","3","1","2","-2"
"235097","Eastern Washington University","2020","Not on tenure/no tenure system, lecturers","149","60","89","0","0","0","9","5","4","3","1","2","6","3","3","0","0","0","127","49","78","1","1","0","0","0","0","3","1","2","-2"
"235237","Pierce College District","2020","Tenured total","97","41","56","2","1","1","8","4","4","3","0","3","1","1","0","0","0","0","72","32","40","9","3","6","2","0","2","0","0","0","-2"
"235237","Pierce College District","2020","Tenured, instructors","97","41","56","2","1","1","8","4","4","3","0","3","1","1","0","0","0","0","72","32","40","9","3","6","2","0","2","0","0","0","-2"
"235237","Pierce College District","2020","On-Tenure track total","35","12","23","0","0","0","4","2","2","3","1","2","1","1","0","0","0","0","23","7","16","4","1","3","0","0","0","0","0","0","-2"
"235237","Pierce College District","2020","On-tenure track, instructors","35","12","23","0","0","0","4","2","2","3","1","2","1","1","0","0","0","0","23","7","16","4","1","3","0","0","0","0","0","0","-2"
"235237","Pierce College District","2020","Not on tenure track/No tenure system system total","10","3","7","0","0","0","0","0","0","1","0","1","0","0","0","0","0","0","8","3","5","1","0","1","0","0","0","0","0","0","-2"
"235237","Pierce College District","2020","Not on tenure/no tenure system, instructors","10","3","7","0","0","0","0","0","0","1","0","1","0","0","0","0","0","0","8","3","5","1","0","1","0","0","0","0","0","0","-2"
"236452","Saint Martin's University","2020","Tenured total","45","26","19","0","0","0","3","2","1","1","1","0","1","0","1","0","0","0","37","20","17","0","0","0","3","3","0","0","0","0","-2"
"236452","Saint Martin's University","2020","Tenured, professors","18","12","6","0","0","0","1","1","0","1","1","0","1","0","1","0","0","0","14","9","5","0","0","0","1","1","0","0","0","0","-2"
"236452","Saint Martin's University","2020","Tenured, associate professors","27","14","13","0","0","0","2","1","1","0","0","0","0","0","0","0","0","0","23","11","12","0","0","0","2","2","0","0","0","0","-2"
"236452","Saint Martin's University","2020","On-Tenure track total","33","16","17","1","0","1","4","3","1","0","0","0","0","0","0","0","0","0","22","9","13","3","3","0","3","1","2","0","0","0","-2"
"236452","Saint Martin's University","2020","On-tenure track, assistant professors","33","16","17","1","0","1","4","3","1","0","0","0","0","0","0","0","0","0","22","9","13","3","3","0","3","1","2","0","0","0","-2"
"236452","Saint Martin's University","2020","Not on tenure track/No tenure system system total","18","9","9","0","0","0","1","1","0","1","1","0","1","1","0","0","0","0","7","4","3","2","1","1","6","1","5","0","0","0","-2"
"236452","Saint Martin's University","2020","Not on tenure/no tenure system, assistant professors","3","3","0","0","0","0","1","1","0","1","1","0","0","0","0","0","0","0","1","1","0","0","0","0","0","0","0","0","0","0","-2"
"236452","Saint Martin's University","2020","Not on tenure/no tenure system, instructors","15","6","9","0","0","0","0","0","0","0","0","0","1","1","0","0","0","0","6","3","3","2","1","1","6","1","5","0","0","0","-2"
"236638","Skagit Valley College","2020","Tenured total","62","25","37","0","0","0","0","0","0","0","0","0","4","3","1","0","0","0","57","22","35","0","0","0","0","0","0","1","0","1","-2"
"236638","Skagit Valley College","2020","Tenured, no academic rank","62","25","37","0","0","0","0","0","0","0","0","0","4","3","1","0","0","0","57","22","35","0","0","0","0","0","0","1","0","1","-2"
"236638","Skagit Valley College","2020","On-Tenure track total","22","9","13","0","0","0","1","0","1","1","0","1","4","1","3","0","0","0","14","6","8","2","2","0","0","0","0","0","0","0","-2"
"236638","Skagit Valley College","2020","On-tenure track, no academic rank","22","9","13","0","0","0","1","0","1","1","0","1","4","1","3","0","0","0","14","6","8","2","2","0","0","0","0","0","0","0","-2"
"236638","Skagit Valley College","2020","Not on tenure track/No tenure system system total","6","2","4","0","0","0","1","1","0","0","0","0","0","0","0","0","0","0","5","1","4","0","0","0","0","0","0","0","0","0","-2"
"236638","Skagit Valley College","2020","Not on tenure/no tenure system, no academic rank","6","2","4","0","0","0","1","1","0","0","0","0","0","0","0","0","0","0","5","1","4","0","0","0","0","0","0","0","0","0","-2"
"236887","Walla Walla Community College","2020","Tenured total","62","29","33","3","2","1","1","0","1","0","0","0","0","0","0","0","0","0","57","27","30","1","0","1","0","0","0","0","0","0","-2"
"236887","Walla Walla Community College","2020","Tenured, no academic rank","62","29","33","3","2","1","1","0","1","0","0","0","0","0","0","0","0","0","57","27","30","1","0","1","0","0","0","0","0","0","-2"
"236887","Walla Walla Community College","2020","On-Tenure track total","10","6","4","0","0","0","0","0","0","0","0","0","1","1","0","0","0","0","9","5","4","0","0","0","0","0","0","0","0","0","-2"
"236887","Walla Walla Community College","2020","On-tenure track, no academic rank","10","6","4","0","0","0","0","0","0","0","0","0","1","1","0","0","0","0","9","5","4","0","0","0","0","0","0","0","0","0","-2"
"236887","Walla Walla Community College","2020","Not on tenure track/No tenure system system total","35","23","12","2","2","0","0","0","0","0","0","0","2","1","1","0","0","0","31","20","11","0","0","0","0","0","0","0","0","0","-2"
"236887","Walla Walla Community College","2020","Not on tenure/no tenure system, no academic rank","35","23","12","2","2","0","0","0","0","0","0","0","2","1","1","0","0","0","31","20","11","0","0","0","0","0","0","0","0","0","-2"
"236896","Walla Walla University","2020","Tenured total","53","35","18","0","0","0","1","1","0","0","0","0","2","0","2","0","0","0","48","32","16","1","1","0","1","1","0","0","0","0","-2"
"236896","Walla Walla University","2020","Tenured, professors","31","20","11","0","0","0","1","1","0","0","0","0","1","0","1","0","0","0","27","17","10","1","1","0","1","1","0","0","0","0","-2"
"236896","Walla Walla University","2020","Tenured, associate professors","18","12","6","0","0","0","0","0","0","0","0","0","1","0","1","0","0","0","17","12","5","0","0","0","0","0","0","0","0","0","-2"
"236896","Walla Walla University","2020","Tenured, assistant professors","4","3","1","0","0","0","0","0","0","0","0","0","0","0","0","0","0","0","4","3","1","0","0","0","0","0","0","0","0","0","-2"
"236896","Walla Walla University","2020","On-Tenure track total","27","10","17","0","0","0","2","0","2","2","0","2","4","2","2","0","0","0","18","8","10","0","0","0","1","0","1","0","0","0","-2"
"236896","Walla Walla University","2020","On-tenure track, professors","1","0","1","0","0","0","0","0","0","0","0","0","0","0","0","0","0","0","1","0","1","0","0","0","0","0","0","0","0","0","-2"
"236896","Walla Walla University","2020","On-tenure track, associate professors","6","3","3","0","0","0","0","0","0","0","0","0","0","0","0","0","0","0","6","3","3","0","0","0","0","0","0","0","0","0","-2"
"236896","Walla Walla University","2020","On-tenure track, assistant professors","18","7","11","0","0","0","2","0","2","2","0","2","4","2","2","0","0","0","9","5","4","0","0","0","1","0","1","0","0","0","-2"
"236896","Walla Walla University","2020","On-tenure track, instructors","2","0","2","0","0","0","0","0","0","0","0","0","0","0","0","0","0","0","2","0","2","0","0","0","0","0","0","0","0","0","-2"
"236896","Walla Walla University","2020","Not on tenure track/No tenure system system total","8","5","3","0","0","0","0","0","0","0","0","0","0","0","0","0","0","0","8","5","3","0","0","0","0","0","0","0","0","0","-2"
"236896","Walla Walla University","2020","Not on tenure/no tenure system, associate professors","1","0","1","0","0","0","0","0","0","0","0","0","0","0","0","0","0","0","1","0","1","0","0","0","0","0","0","0","0","0","-2"
"236896","Walla Walla University","2020","Not on tenure/no tenure system, assistant professors","2","0","2","0","0","0","0","0","0","0","0","0","0","0","0","0","0","0","2","0","2","0","0","0","0","0","0","0","0","0","-2"
"236896","Walla Walla University","2020","Not on tenure/no tenure system, instructors","5","5","0","0","0","0","0","0","0","0","0","0","0","0","0","0","0","0","5","5","0","0","0","0","0","0","0","0","0","0","-2"
"238430","Cardinal Stritch University","2020","Tenured total","32","17","15","0","0","0","1","0","1","4","3","1","1","0","1","0","0","0","26","14","12","0","0","0","0","0","0","0","0","0","-2"
"238430","Cardinal Stritch University","2020","Tenured, professors","7","4","3","0","0","0","0","0","0","0","0","0","1","0","1","0","0","0","6","4","2","0","0","0","0","0","0","0","0","0","-2"
"238430","Cardinal Stritch University","2020","Tenured, associate professors","19","9","10","0","0","0","1","0","1","4","3","1","0","0","0","0","0","0","14","6","8","0","0","0","0","0","0","0","0","0","-2"
"238430","Cardinal Stritch University","2020","Tenured, assistant professors","6","4","2","0","0","0","0","0","0","0","0","0","0","0","0","0","0","0","6","4","2","0","0","0","0","0","0","0","0","0","-2"
"238430","Cardinal Stritch University","2020","On-Tenure track total","5","1","4","0","0","0","0","0","0","0","0","0","0","0","0","0","0","0","5","1","4","0","0","0","0","0","0","0","0","0","-2"
"238430","Cardinal Stritch University","2020","On-tenure track, associate professors","1","0","1","0","0","0","0","0","0","0","0","0","0","0","0","0","0","0","1","0","1","0","0","0","0","0","0","0","0","0","-2"
"238430","Cardinal Stritch University","2020","On-tenure track, assistant professors","4","1","3","0","0","0","0","0","0","0","0","0","0","0","0","0","0","0","4","1","3","0","0","0","0","0","0","0","0","0","-2"
"238430","Cardinal Stritch University","2020","Not on tenure track/No tenure system system total","23","4","19","0","0","0","1","0","1","2","0","2","0","0","0","0","0","0","20","4","16","0","0","0","0","0","0","0","0","0","-2"
"238430","Cardinal Stritch University","2020","Not on tenure/no tenure system, assistant professors","23","4","19","0","0","0","1","0","1","2","0","2","0","0","0","0","0","0","20","4","16","0","0","0","0","0","0","0","0","0","-2"
"240374","University of Wisconsin-Parkside","2020","Tenured total","66","40","26","0","0","0","14","9","5","4","4","0","4","1","3","0","0","0","43","25","18","0","0","0","0","0","0","1","1","0","240374"
"240374","University of Wisconsin-Parkside","2020","Tenured, professors","26","15","11","0","0","0","6","4","2","2","2","0","2","0","2","0","0","0","15","8","7","0","0","0","0","0","0","1","1","0","240374"
"240374","University of Wisconsin-Parkside","2020","Tenured, associate professors","40","25","15","0","0","0","8","5","3","2","2","0","2","1","1","0","0","0","28","17","11","0","0","0","0","0","0","0","0","0","240374"
"240374","University of Wisconsin-Parkside","2020","On-Tenure track total","54","24","30","0","0","0","6","3","3","2","0","2","3","3","0","0","0","0","38","17","21","1","0","1","0","0","0","4","1","3","240374"
"240374","University of Wisconsin-Parkside","2020","On-tenure track, associate professors","18","9","9","0","0","0","1","0","1","0","0","0","1","1","0","0","0","0","14","7","7","0","0","0","0","0","0","2","1","1","240374"
"240374","University of Wisconsin-Parkside","2020","On-tenure track, assistant professors","36","15","21","0","0","0","5","3","2","2","0","2","2","2","0","0","0","0","24","10","14","1","0","1","0","0","0","2","0","2","240374"
"240374","University of Wisconsin-Parkside","2020","Not on tenure track/No tenure system system total","43","22","21","1","1","0","2","1","1","4","3","1","1","0","1","0","0","0","33","15","18","0","0","0","1","1","0","1","1","0","240374"
"240374","University of Wisconsin-Parkside","2020","Not on tenure/no tenure system, assistant professors","3","2","1","0","0","0","1","0","1","1","1","0","0","0","0","0","0","0","0","0","0","0","0","0","1","1","0","0","0","0","240374"
"240374","University of Wisconsin-Parkside","2020","Not on tenure/no tenure system, lecturers","40","20","20","1","1","0","1","1","0","3","2","1","1","0","1","0","0","0","33","15","18","0","0","0","0","0","0","1","1","0","240374"
"433660","Florida Gulf Coast University","2020","Tenured total","3","1","2","0","0","0","0","0","0","0","0","0","1","0","1","0","0","0","2","1","1","0","0","0","0","0","0","0","0","0","-2"
"433660","Florida Gulf Coast University","2020","Tenured, professors","2","1","1","0","0","0","0","0","0","0","0","0","1","0","1","0","0","0","1","1","0","0","0","0","0","0","0","0","0","0","-2"
"433660","Florida Gulf Coast University","2020","Tenured, associate professors","1","0","1","0","0","0","0","0","0","0","0","0","0","0","0","0","0","0","1","0","1","0","0","0","0","0","0","0","0","0","-2"
"433660","Florida Gulf Coast University","2020","Not on tenure track/No tenure system system total","513","282","231","3","3","0","46","35","11","20","12","8","27","10","17","1","0","1","395","208","187","5","4","1","0","0","0","16","10","6","-2"
"433660","Florida Gulf Coast University","2020","Not on tenure/no tenure system, professors","99","71","28","0","0","0","14","11","3","2","2","0","3","1","2","0","0","0","78","55","23","1","1","0","0","0","0","1","1","0","-2"
"433660","Florida Gulf Coast University","2020","Not on tenure/no tenure system, associate professors","133","85","48","0","0","0","17","12","5","6","4","2","8","5","3","0","0","0","99","62","37","0","0","0","0","0","0","3","2","1","-2"
"433660","Florida Gulf Coast University","2020","Not on tenure/no tenure system, assistant professors","146","70","76","3","3","0","11","9","2","8","3","5","10","2","8","1","0","1","101","44","57","2","2","0","0","0","0","10","7","3","-2"
"433660","Florida Gulf Coast University","2020","Not on tenure/no tenure system, instructors","134","56","78","0","0","0","4","3","1","4","3","1","6","2","4","0","0","0","117","47","70","2","1","1","0","0","0","1","0","1","-2"
"433660","Florida Gulf Coast University","2020","Not on tenure/no tenure system, lecturers","1","0","1","0","0","0","0","0","0","0","0","0","0","0","0","0","0","0","0","0","0","0","0","0","0","0","0","1","0","1","-2"
"447689","Georgia Gwinnett College","2020","Not on tenure track/No tenure system system total","453","217","236","2","1","1","58","28","30","52","20","32","19","13","6","0","0","0","296","137","159","3","2","1","6","5","1","17","11","6","-2"
"447689","Georgia Gwinnett College","2020","Not on tenure/no tenure system, professors","57","34","23","0","0","0","13","8","5","3","2","1","1","1","0","0","0","0","39","22","17","1","1","0","0","0","0","0","0","0","-2"
"447689","Georgia Gwinnett College","2020","Not on tenure/no tenure system, associate professors","184","93","91","1","0","1","26","12","14","20","7","13","8","5","3","0","0","0","116","60","56","0","0","0","1","1","0","12","8","4","-2"
"447689","Georgia Gwinnett College","2020","Not on tenure/no tenure system, assistant professors","154","73","81","1","1","0","15","8","7","20","8","12","8","6","2","0","0","0","100","43","57","1","1","0","4","3","1","5","3","2","-2"
"447689","Georgia Gwinnett College","2020","Not on tenure/no tenure system, instructors","31","5","26","0","0","0","1","0","1","3","0","3","1","0","1","0","0","0","25","5","20","1","0","1","0","0","0","0","0","0","-2"
"447689","Georgia Gwinnett College","2020","Not on tenure/no tenure system, lecturers","27","12","15","0","0","0","3","0","3","6","3","3","1","1","0","0","0","0","16","7","9","0","0","0","1","1","0","0","0","0","-2"
"484473","University of Florida-Online","2020","Not on tenure track/No tenure system system total","10","3","7","0","0","0","0","0","0","0","0","0","0","0","0","0","0","0","10","3","7","0","0","0","0","0","0","0","0","0","-2"
"484473","University of Florida-Online","2020","Not on tenure/no tenure system, lecturers","6","2","4","0","0","0","0","0","0","0","0","0","0","0","0","0","0","0","6","2","4","0","0","0","0","0","0","0","0","0","-2"
"484473","University of Florida-Online","2020","Not on tenure/no tenure system, no academic rank","4","1","3","0","0","0","0","0","0","0","0","0","0","0","0","0","0","0","4","1","3","0","0","0","0","0","0","0","0","0","-2"
"490805","Purdue University Northwest","2020","Tenured total","165","101","64","0","0","0","40","24","16","7","3","4","8","6","2","1","0","1","108","67","41","0","0","0","1","1","0","0","0","0","-2"
"490805","Purdue University Northwest","2020","Tenured, professors","79","53","26","0","0","0","23","14","9","3","3","0","3","2","1","0","0","0","49","33","16","0","0","0","1","1","0","0","0","0","-2"
"490805","Purdue University Northwest","2020","Tenured, associate professors","86","48","38","0","0","0","17","10","7","4","0","4","5","4","1","1","0","1","59","34","25","0","0","0","0","0","0","0","0","0","-2"
"490805","Purdue University Northwest","2020","On-Tenure track total","58","32","26","0","0","0","7","6","1","4","3","1","1","0","1","0","0","0","28","12","16","0","0","0","7","4","3","11","7","4","-2"
"490805","Purdue University Northwest","2020","On-tenure track, associate professors","6","5","1","0","0","0","2","2","0","0","0","0","0","0","0","0","0","0","3","2","1","0","0","0","0","0","0","1","1","0","-2"
"490805","Purdue University Northwest","2020","On-tenure track, assistant professors","52","27","25","0","0","0","5","4","1","4","3","1","1","0","1","0","0","0","25","10","15","0","0","0","7","4","3","10","6","4","-2"
"490805","Purdue University Northwest","2020","Not on tenure track/No tenure system system total","16","9","7","0","0","0","1","0","1","0","0","0","0","0","0","0","0","0","11","6","5","0","0","0","3","2","1","1","1","0","-2"
"490805","Purdue University Northwest","2020","Not on tenure/no tenure system, assistant professors","3","2","1","0","0","0","0","0","0","0","0","0","0","0","0","0","0","0","2","1","1","0","0","0","0","0","0","1","1","0","-2"
"490805","Purdue University Northwest","2020","Not on tenure/no tenure system, instructors","13","7","6","0","0","0","1","0","1","0","0","0","0","0","0","0","0","0","9","5","4","0","0","0","3","2","1","0","0","0","-2"
