"unitid","institution name","year","S2017_IS.Instructional staff category","S2017_IS_RV.Grand total","S2017_IS_RV.Grand total men","S2017_IS_RV.Grand total women","S2017_IS_RV.American Indian or Alaska Native total","S2017_IS_RV.American Indian or Alaska Native men","S2017_IS_RV.American Indian or Alaska Native women","S2017_IS_RV.Asian total","S2017_IS_RV.Asian men","S2017_IS_RV.Asian women","S2017_IS_RV.Black or African American total","S2017_IS_RV.Black or African American men","S2017_IS_RV.Black or African American women","S2017_IS_RV.Hispanic or Latino total","S2017_IS_RV.Hispanic or Latino men","S2017_IS_RV.Hispanic or Latino women","S2017_IS_RV.Native Hawaiian or Other Pacific Islander total","S2017_IS_RV.Native Hawaiian or Other Pacific Islander men","S2017_IS_RV.Native Hawaiian or Other Pacific Islander women","S2017_IS_RV.White total","S2017_IS_RV.White men","S2017_IS_RV.White women","S2017_IS_RV.Two or more races total","S2017_IS_RV.Two or more races men","S2017_IS_RV.Two or more races women","S2017_IS_RV.Race/ethnicity unknown total","S2017_IS_RV.Race/ethnicity unknown men","S2017_IS_RV.Race/ethnicity unknown women","S2017_IS_RV.Nonresident alien total","S2017_IS_RV.Nonresident alien men","S2017_IS_RV.Nonresident alien women","IDX_HR"
"105899","Arizona Christian University","2017","Not on tenure track/No tenure system system total","17","12","5","0","0","0","0","0","0","0","0","0","0","0","0","0","0","0","16","11","5","1","1","0","0","0","0","0","0","0","-2"
"105899","Arizona Christian University","2017","Not on tenure/no tenure system, professors","2","1","1","0","0","0","0","0","0","0","0","0","0","0","0","0","0","0","2","1","1","0","0","0","0","0","0","0","0","0","-2"
"105899","Arizona Christian University","2017","Not on tenure/no tenure system, associate professors","5","2","3","0","0","0","0","0","0","0","0","0","0","0","0","0","0","0","5","2","3","0","0","0","0","0","0","0","0","0","-2"
"105899","Arizona Christian University","2017","Not on tenure/no tenure system, assistant professors","6","5","1","0","0","0","0","0","0","0","0","0","0","0","0","0","0","0","5","4","1","1","1","0","0","0","0","0","0","0","-2"
"105899","Arizona Christian University","2017","Not on tenure/no tenure system, instructors","4","4","0","0","0","0","0","0","0","0","0","0","0","0","0","0","0","0","4","4","0","0","0","0","0","0","0","0","0","0","-2"
"110097","Biola University","2017","Tenured total","118","92","26","0","0","0","13","7","6","1","0","1","8","5","3","1","1","0","93","79","14","0","0","0","0","0","0","2","0","2","-2"
"110097","Biola University","2017","Tenured, professors","69","59","10","0","0","0","5","4","1","0","0","0","5","4","1","1","1","0","57","50","7","0","0","0","0","0","0","1","0","1","-2"
"110097","Biola University","2017","Tenured, associate professors","49","33","16","0","0","0","8","3","5","1","0","1","3","1","2","0","0","0","36","29","7","0","0","0","0","0","0","1","0","1","-2"
"110097","Biola University","2017","On-Tenure track total","108","62","46","0","0","0","20","8","12","6","4","2","8","4","4","1","1","0","69","43","26","0","0","0","1","0","1","3","2","1","-2"
"110097","Biola University","2017","On-tenure track, professors","8","8","0","0","0","0","1","1","0","0","0","0","1","1","0","0","0","0","5","5","0","0","0","0","0","0","0","1","1","0","-2"
"110097","Biola University","2017","On-tenure track, associate professors","66","33","33","0","0","0","12","5","7","3","2","1","4","1","3","0","0","0","46","25","21","0","0","0","1","0","1","0","0","0","-2"
"110097","Biola University","2017","On-tenure track, assistant professors","34","21","13","0","0","0","7","2","5","3","2","1","3","2","1","1","1","0","18","13","5","0","0","0","0","0","0","2","1","1","-2"
"110097","Biola University","2017","Not on tenure track/No tenure system system total","48","24","24","2","1","1","2","0","2","0","0","0","4","2","2","0","0","0","40","21","19","0","0","0","0","0","0","0","0","0","-2"
"110097","Biola University","2017","Not on tenure/no tenure system, professors","1","1","0","0","0","0","0","0","0","0","0","0","0","0","0","0","0","0","1","1","0","0","0","0","0","0","0","0","0","0","-2"
"110097","Biola University","2017","Not on tenure/no tenure system, associate professors","24","12","12","2","1","1","1","0","1","0","0","0","3","1","2","0","0","0","18","10","8","0","0","0","0","0","0","0","0","0","-2"
"110097","Biola University","2017","Not on tenure/no tenure system, assistant professors","13","5","8","0","0","0","0","0","0","0","0","0","0","0","0","0","0","0","13","5","8","0","0","0","0","0","0","0","0","0","-2"
"110097","Biola University","2017","Not on tenure/no tenure system, instructors","10","6","4","0","0","0","1","0","1","0","0","0","1","1","0","0","0","0","8","5","3","0","0","0","0","0","0","0","0","0","-2"
"110316","California Institute of Integral Studies","2017","Not on tenure track/No tenure system system total","63","29","34","0","0","0","10","5","5","2","0","2","4","1","3","0","0","0","47","23","24","0","0","0","0","0","0","0","0","0","-2"
"110316","California Institute of Integral Studies","2017","Not on tenure/no tenure system, professors","26","16","10","0","0","0","2","2","0","0","0","0","0","0","0","0","0","0","24","14","10","0","0","0","0","0","0","0","0","0","-2"
"110316","California Institute of Integral Studies","2017","Not on tenure/no tenure system, associate professors","13","4","9","0","0","0","3","0","3","0","0","0","1","0","1","0","0","0","9","4","5","0","0","0","0","0","0","0","0","0","-2"
"110316","California Institute of Integral Studies","2017","Not on tenure/no tenure system, assistant professors","15","4","11","0","0","0","2","0","2","2","0","2","2","1","1","0","0","0","9","3","6","0","0","0","0","0","0","0","0","0","-2"
"110316","California Institute of Integral Studies","2017","Not on tenure/no tenure system, lecturers","9","5","4","0","0","0","3","3","0","0","0","0","1","0","1","0","0","0","5","2","3","0","0","0","0","0","0","0","0","0","-2"
"110422","California Polytechnic State University-San Luis Obispo","2017","Tenured total","447","309","138","1","1","0","44","27","17","7","5","2","32","23","9","1","1","0","334","231","103","6","5","1","19","14","5","3","2","1","-2"
"110422","California Polytechnic State University-San Luis Obispo","2017","Tenured, professors","311","230","81","1","1","0","29","19","10","5","4","1","19","13","6","1","1","0","234","173","61","5","5","0","16","13","3","1","1","0","-2"
"110422","California Polytechnic State University-San Luis Obispo","2017","Tenured, associate professors","134","77","57","0","0","0","15","8","7","2","1","1","12","9","3","0","0","0","99","57","42","1","0","1","3","1","2","2","1","1","-2"
"110422","California Polytechnic State University-San Luis Obispo","2017","Tenured, no academic rank","2","2","0","0","0","0","0","0","0","0","0","0","1","1","0","0","0","0","1","1","0","0","0","0","0","0","0","0","0","0","-2"
"110422","California Polytechnic State University-San Luis Obispo","2017","On-Tenure track total","218","124","94","2","1","1","18","11","7","5","3","2","8","2","6","0","0","0","148","84","64","0","0","0","12","9","3","25","14","11","-2"
"110422","California Polytechnic State University-San Luis Obispo","2017","On-tenure track, professors","4","4","0","0","0","0","0","0","0","0","0","0","0","0","0","0","0","0","3","3","0","0","0","0","0","0","0","1","1","0","-2"
"110422","California Polytechnic State University-San Luis Obispo","2017","On-tenure track, associate professors","20","16","4","0","0","0","5","5","0","0","0","0","2","1","1","0","0","0","9","7","2","0","0","0","3","2","1","1","1","0","-2"
"110422","California Polytechnic State University-San Luis Obispo","2017","On-tenure track, assistant professors","194","104","90","2","1","1","13","6","7","5","3","2","6","1","5","0","0","0","136","74","62","0","0","0","9","7","2","23","12","11","-2"
"110422","California Polytechnic State University-San Luis Obispo","2017","Not on tenure track/No tenure system system total","211","131","80","0","0","0","5","1","4","0","0","0","3","3","0","0","0","0","175","108","67","1","1","0","13","10","3","14","8","6","-2"
"110422","California Polytechnic State University-San Luis Obispo","2017","Not on tenure/no tenure system, lecturers","211","131","80","0","0","0","5","1","4","0","0","0","3","3","0","0","0","0","175","108","67","1","1","0","13","10","3","14","8","6","-2"
"111188","California State University Maritime Academy","2017","Tenured total","34","27","7","0","0","0","3","2","1","2","2","0","3","2","1","0","0","0","26","21","5","0","0","0","0","0","0","0","0","0","-2"
"111188","California State University Maritime Academy","2017","Tenured, professors","18","13","5","0","0","0","1","0","1","1","1","0","2","1","1","0","0","0","14","11","3","0","0","0","0","0","0","0","0","0","-2"
"111188","California State University Maritime Academy","2017","Tenured, associate professors","16","14","2","0","0","0","2","2","0","1","1","0","1","1","0","0","0","0","12","10","2","0","0","0","0","0","0","0","0","0","-2"
"111188","California State University Maritime Academy","2017","On-Tenure track total","18","11","7","0","0","0","3","2","1","0","0","0","0","0","0","0","0","0","15","9","6","0","0","0","0","0","0","0","0","0","-2"
"111188","California State University Maritime Academy","2017","On-tenure track, assistant professors","18","11","7","0","0","0","3","2","1","0","0","0","0","0","0","0","0","0","15","9","6","0","0","0","0","0","0","0","0","0","-2"
"111188","California State University Maritime Academy","2017","Not on tenure track/No tenure system system total","19","13","6","1","0","1","1","0","1","1","1","0","0","0","0","0","0","0","16","12","4","0","0","0","0","0","0","0","0","0","-2"
"111188","California State University Maritime Academy","2017","Not on tenure/no tenure system, lecturers","19","13","6","1","0","1","1","0","1","1","1","0","0","0","0","0","0","0","16","12","4","0","0","0","0","0","0","0","0","0","-2"
"111948","Chapman University","2017","Tenured total","237","158","79","0","0","0","18","8","10","6","4","2","8","4","4","0","0","0","169","116","53","3","2","1","33","24","9","0","0","0","-2"
"111948","Chapman University","2017","Tenured, professors","132","98","34","0","0","0","10","5","5","3","3","0","3","2","1","0","0","0","94","71","23","1","1","0","21","16","5","0","0","0","-2"
"111948","Chapman University","2017","Tenured, associate professors","105","60","45","0","0","0","8","3","5","3","1","2","5","2","3","0","0","0","75","45","30","2","1","1","12","8","4","0","0","0","-2"
"111948","Chapman University","2017","On-Tenure track total","92","45","47","0","0","0","7","1","6","0","0","0","3","3","0","0","0","0","23","12","11","0","0","0","49","24","25","10","5","5","-2"
"111948","Chapman University","2017","On-tenure track, associate professors","5","4","1","0","0","0","0","0","0","0","0","0","1","1","0","0","0","0","1","1","0","0","0","0","3","2","1","0","0","0","-2"
"111948","Chapman University","2017","On-tenure track, assistant professors","87","41","46","0","0","0","7","1","6","0","0","0","2","2","0","0","0","0","22","11","11","0","0","0","46","22","24","10","5","5","-2"
"111948","Chapman University","2017","Not on tenure track/No tenure system system total","160","81","79","0","0","0","13","5","8","3","1","2","7","3","4","0","0","0","74","40","34","0","0","0","60","32","28","3","0","3","-2"
"111948","Chapman University","2017","Not on tenure/no tenure system, professors","23","11","12","0","0","0","1","0","1","0","0","0","0","0","0","0","0","0","17","8","9","0","0","0","5","3","2","0","0","0","-2"
"111948","Chapman University","2017","Not on tenure/no tenure system, associate professors","26","16","10","0","0","0","2","2","0","1","1","0","2","1","1","0","0","0","13","7","6","0","0","0","8","5","3","0","0","0","-2"
"111948","Chapman University","2017","Not on tenure/no tenure system, assistant professors","79","37","42","0","0","0","8","3","5","1","0","1","3","0","3","0","0","0","29","17","12","0","0","0","36","17","19","2","0","2","-2"
"111948","Chapman University","2017","Not on tenure/no tenure system, instructors","30","15","15","0","0","0","2","0","2","1","0","1","2","2","0","0","0","0","13","6","7","0","0","0","11","7","4","1","0","1","-2"
"111948","Chapman University","2017","Not on tenure/no tenure system, no academic rank","2","2","0","0","0","0","0","0","0","0","0","0","0","0","0","0","0","0","2","2","0","0","0","0","0","0","0","0","0","0","-2"
"112260","Claremont McKenna College","2017","Tenured total","107","72","35","0","0","0","10","5","5","2","1","1","2","2","0","0","0","0","87","61","26","0","0","0","3","2","1","3","1","2","-2"
"112260","Claremont McKenna College","2017","Tenured, professors","61","45","16","0","0","0","4","3","1","2","1","1","1","1","0","0","0","0","50","38","12","0","0","0","2","2","0","2","0","2","-2"
"112260","Claremont McKenna College","2017","Tenured, associate professors","46","27","19","0","0","0","6","2","4","0","0","0","1","1","0","0","0","0","37","23","14","0","0","0","1","0","1","1","1","0","-2"
"112260","Claremont McKenna College","2017","On-Tenure track total","21","12","9","0","0","0","3","1","2","0","0","0","2","2","0","0","0","0","14","8","6","1","1","0","0","0","0","1","0","1","-2"
"112260","Claremont McKenna College","2017","On-tenure track, assistant professors","21","12","9","0","0","0","3","1","2","0","0","0","2","2","0","0","0","0","14","8","6","1","1","0","0","0","0","1","0","1","-2"
"112260","Claremont McKenna College","2017","Not on tenure track/No tenure system system total","34","21","13","0","0","0","1","1","0","0","0","0","1","1","0","0","0","0","32","19","13","0","0","0","0","0","0","0","0","0","-2"
"112260","Claremont McKenna College","2017","Not on tenure/no tenure system, professors","1","1","0","0","0","0","0","0","0","0","0","0","0","0","0","0","0","0","1","1","0","0","0","0","0","0","0","0","0","0","-2"
"112260","Claremont McKenna College","2017","Not on tenure/no tenure system, associate professors","3","3","0","0","0","0","1","1","0","0","0","0","0","0","0","0","0","0","2","2","0","0","0","0","0","0","0","0","0","0","-2"
"112260","Claremont McKenna College","2017","Not on tenure/no tenure system, assistant professors","30","17","13","0","0","0","0","0","0","0","0","0","1","1","0","0","0","0","29","16","13","0","0","0","0","0","0","0","0","0","-2"
"112570","Columbia College Hollywood","2017","Not on tenure track/No tenure system system total","5","5","0","0","0","0","0","0","0","0","0","0","0","0","0","0","0","0","5","5","0","0","0","0","0","0","0","0","0","0","-2"
"112570","Columbia College Hollywood","2017","Not on tenure/no tenure system, instructors","5","5","0","0","0","0","0","0","0","0","0","0","0","0","0","0","0","0","5","5","0","0","0","0","0","0","0","0","0","0","-2"
"115083","Golden Gate University-San Francisco","2017","Tenured total","26","16","10","0","0","0","4","2","2","2","2","0","1","0","1","0","0","0","19","12","7","0","0","0","0","0","0","0","0","0","-2"
"115083","Golden Gate University-San Francisco","2017","Tenured, professors","26","16","10","0","0","0","4","2","2","2","2","0","1","0","1","0","0","0","19","12","7","0","0","0","0","0","0","0","0","0","-2"
"115083","Golden Gate University-San Francisco","2017","On-Tenure track total","4","1","3","0","0","0","1","0","1","1","0","1","0","0","0","1","0","1","1","1","0","0","0","0","0","0","0","0","0","0","-2"
"115083","Golden Gate University-San Francisco","2017","On-tenure track, professors","1","1","0","0","0","0","0","0","0","0","0","0","0","0","0","0","0","0","1","1","0","0","0","0","0","0","0","0","0","0","-2"
"115083","Golden Gate University-San Francisco","2017","On-tenure track, associate professors","3","0","3","0","0","0","1","0","1","1","0","1","0","0","0","1","0","1","0","0","0","0","0","0","0","0","0","0","0","0","-2"
"115083","Golden Gate University-San Francisco","2017","Not on tenure track/No tenure system system total","34","17","17","0","0","0","3","1","2","1","1","0","0","0","0","0","0","0","30","15","15","0","0","0","0","0","0","0","0","0","-2"
"115083","Golden Gate University-San Francisco","2017","Not on tenure/no tenure system, professors","2","2","0","0","0","0","1","1","0","0","0","0","0","0","0","0","0","0","1","1","0","0","0","0","0","0","0","0","0","0","-2"
"115083","Golden Gate University-San Francisco","2017","Not on tenure/no tenure system, associate professors","17","8","9","0","0","0","1","0","1","0","0","0","0","0","0","0","0","0","16","8","8","0","0","0","0","0","0","0","0","0","-2"
"115083","Golden Gate University-San Francisco","2017","Not on tenure/no tenure system, assistant professors","9","4","5","0","0","0","1","0","1","0","0","0","0","0","0","0","0","0","8","4","4","0","0","0","0","0","0","0","0","0","-2"
"115083","Golden Gate University-San Francisco","2017","Not on tenure/no tenure system, instructors","6","3","3","0","0","0","0","0","0","1","1","0","0","0","0","0","0","0","5","2","3","0","0","0","0","0","0","0","0","0","-2"
"115409","Harvey Mudd College","2017","Tenured total","67","43","24","0","0","0","9","4","5","2","1","1","3","2","1","0","0","0","52","36","16","0","0","0","1","0","1","0","0","0","-2"
"115409","Harvey Mudd College","2017","Tenured, professors","53","38","15","0","0","0","7","4","3","1","1","0","3","2","1","0","0","0","42","31","11","0","0","0","0","0","0","0","0","0","-2"
"115409","Harvey Mudd College","2017","Tenured, associate professors","14","5","9","0","0","0","2","0","2","1","0","1","0","0","0","0","0","0","10","5","5","0","0","0","1","0","1","0","0","0","-2"
"115409","Harvey Mudd College","2017","On-Tenure track total","26","14","12","0","0","0","5","3","2","1","1","0","1","1","0","0","0","0","16","7","9","1","0","1","2","2","0","0","0","0","-2"
"115409","Harvey Mudd College","2017","On-tenure track, associate professors","3","2","1","0","0","0","0","0","0","0","0","0","0","0","0","0","0","0","2","1","1","0","0","0","1","1","0","0","0","0","-2"
"115409","Harvey Mudd College","2017","On-tenure track, assistant professors","23","12","11","0","0","0","5","3","2","1","1","0","1","1","0","0","0","0","14","6","8","1","0","1","1","1","0","0","0","0","-2"
"115409","Harvey Mudd College","2017","Not on tenure track/No tenure system system total","8","2","6","0","0","0","2","1","1","0","0","0","1","0","1","0","0","0","4","1","3","1","0","1","0","0","0","0","0","0","-2"
"115409","Harvey Mudd College","2017","Not on tenure/no tenure system, professors","1","1","0","0","0","0","1","1","0","0","0","0","0","0","0","0","0","0","0","0","0","0","0","0","0","0","0","0","0","0","-2"
"115409","Harvey Mudd College","2017","Not on tenure/no tenure system, assistant professors","7","1","6","0","0","0","1","0","1","0","0","0","1","0","1","0","0","0","4","1","3","1","0","1","0","0","0","0","0","0","-2"
"117168","Laguna College of Art and Design","2017","Not on tenure track/No tenure system system total","22","18","4","0","0","0","1","1","0","0","0","0","0","0","0","0","0","0","21","17","4","0","0","0","0","0","0","0","0","0","-2"
"117168","Laguna College of Art and Design","2017","Not on tenure/no tenure system, professors","6","4","2","0","0","0","0","0","0","0","0","0","0","0","0","0","0","0","6","4","2","0","0","0","0","0","0","0","0","0","-2"
"117168","Laguna College of Art and Design","2017","Not on tenure/no tenure system, associate professors","8","7","1","0","0","0","1","1","0","0","0","0","0","0","0","0","0","0","7","6","1","0","0","0","0","0","0","0","0","0","-2"
"117168","Laguna College of Art and Design","2017","Not on tenure/no tenure system, assistant professors","8","7","1","0","0","0","0","0","0","0","0","0","0","0","0","0","0","0","8","7","1","0","0","0","0","0","0","0","0","0","-2"
"117575","Southern California Seminary","2017","Not on tenure track/No tenure system system total","6","6","0","0","0","0","1","1","0","0","0","0","1","1","0","0","0","0","3","3","0","0","0","0","0","0","0","1","1","0","-2"
"117575","Southern California Seminary","2017","Not on tenure/no tenure system, professors","6","6","0","0","0","0","1","1","0","0","0","0","1","1","0","0","0","0","3","3","0","0","0","0","0","0","0","1","1","0","-2"
"117946","Loyola Marymount University","2017","Tenured total","355","200","155","1","0","1","37","24","13","19","11","8","39","15","24","0","0","0","234","137","97","5","2","3","18","11","7","2","0","2","-2"
"117946","Loyola Marymount University","2017","Tenured, professors","222","145","77","0","0","0","22","16","6","11","7","4","21","9","12","0","0","0","151","103","48","2","1","1","15","9","6","0","0","0","-2"
"117946","Loyola Marymount University","2017","Tenured, associate professors","130","53","77","1","0","1","14","7","7","8","4","4","18","6","12","0","0","0","82","34","48","2","0","2","3","2","1","2","0","2","-2"
"117946","Loyola Marymount University","2017","Tenured, assistant professors","3","2","1","0","0","0","1","1","0","0","0","0","0","0","0","0","0","0","1","0","1","1","1","0","0","0","0","0","0","0","-2"
"117946","Loyola Marymount University","2017","On-Tenure track total","74","38","36","0","0","0","16","2","14","5","3","2","5","1","4","0","0","0","37","25","12","1","1","0","5","3","2","5","3","2","-2"
"117946","Loyola Marymount University","2017","On-tenure track, associate professors","1","1","0","0","0","0","0","0","0","0","0","0","0","0","0","0","0","0","1","1","0","0","0","0","0","0","0","0","0","0","-2"
"117946","Loyola Marymount University","2017","On-tenure track, assistant professors","73","37","36","0","0","0","16","2","14","5","3","2","5","1","4","0","0","0","36","24","12","1","1","0","5","3","2","5","3","2","-2"
"117946","Loyola Marymount University","2017","Not on tenure track/No tenure system system total","156","74","82","0","0","0","12","4","8","12","4","8","12","5","7","0","0","0","102","48","54","4","2","2","12","9","3","2","2","0","-2"
"117946","Loyola Marymount University","2017","Not on tenure/no tenure system, professors","12","9","3","0","0","0","0","0","0","0","0","0","0","0","0","0","0","0","12","9","3","0","0","0","0","0","0","0","0","0","-2"
"117946","Loyola Marymount University","2017","Not on tenure/no tenure system, associate professors","29","9","20","0","0","0","1","0","1","1","0","1","2","1","1","0","0","0","23","6","17","0","0","0","2","2","0","0","0","0","-2"
"117946","Loyola Marymount University","2017","Not on tenure/no tenure system, assistant professors","86","43","43","0","0","0","8","3","5","10","3","7","8","3","5","0","0","0","47","25","22","4","2","2","7","5","2","2","2","0","-2"
"117946","Loyola Marymount University","2017","Not on tenure/no tenure system, instructors","29","13","16","0","0","0","3","1","2","1","1","0","2","1","1","0","0","0","20","8","12","0","0","0","3","2","1","0","0","0","-2"
"120403","Otis College of Art and Design","2017","Not on tenure track/No tenure system system total","54","24","30","1","1","0","5","2","3","0","0","0","4","3","1","0","0","0","40","17","23","2","1","1","2","0","2","0","0","0","-2"
"120403","Otis College of Art and Design","2017","Not on tenure/no tenure system, professors","20","7","13","0","0","0","3","0","3","0","0","0","0","0","0","0","0","0","16","7","9","0","0","0","1","0","1","0","0","0","-2"
"120403","Otis College of Art and Design","2017","Not on tenure/no tenure system, associate professors","19","9","10","1","1","0","0","0","0","0","0","0","3","3","0","0","0","0","14","5","9","0","0","0","1","0","1","0","0","0","-2"
"120403","Otis College of Art and Design","2017","Not on tenure/no tenure system, assistant professors","15","8","7","0","0","0","2","2","0","0","0","0","1","0","1","0","0","0","10","5","5","2","1","1","0","0","0","0","0","0","-2"
"120698","Palo Alto University","2017","Tenured total","13","6","7","0","0","0","2","0","2","0","0","0","2","1","1","0","0","0","9","5","4","0","0","0","0","0","0","0","0","0","-2"
"120698","Palo Alto University","2017","Tenured, professors","7","4","3","0","0","0","1","0","1","0","0","0","1","1","0","0","0","0","5","3","2","0","0","0","0","0","0","0","0","0","-2"
"120698","Palo Alto University","2017","Tenured, associate professors","6","2","4","0","0","0","1","0","1","0","0","0","1","0","1","0","0","0","4","2","2","0","0","0","0","0","0","0","0","0","-2"
"120698","Palo Alto University","2017","On-Tenure track total","6","2","4","0","0","0","0","0","0","1","1","0","0","0","0","0","0","0","5","1","4","0","0","0","0","0","0","0","0","0","-2"
"120698","Palo Alto University","2017","On-tenure track, assistant professors","6","2","4","0","0","0","0","0","0","1","1","0","0","0","0","0","0","0","5","1","4","0","0","0","0","0","0","0","0","0","-2"
"120698","Palo Alto University","2017","Not on tenure track/No tenure system system total","23","8","15","0","0","0","1","0","1","1","0","1","4","1","3","0","0","0","16","7","9","1","0","1","0","0","0","0","0","0","-2"
"120698","Palo Alto University","2017","Not on tenure/no tenure system, professors","4","2","2","0","0","0","0","0","0","0","0","0","1","1","0","0","0","0","3","1","2","0","0","0","0","0","0","0","0","0","-2"
"120698","Palo Alto University","2017","Not on tenure/no tenure system, associate professors","7","3","4","0","0","0","0","0","0","1","0","1","0","0","0","0","0","0","6","3","3","0","0","0","0","0","0","0","0","0","-2"
"120698","Palo Alto University","2017","Not on tenure/no tenure system, assistant professors","7","1","6","0","0","0","1","0","1","0","0","0","0","0","0","0","0","0","5","1","4","1","0","1","0","0","0","0","0","0","-2"
"120698","Palo Alto University","2017","Not on tenure/no tenure system, no academic rank","5","2","3","0","0","0","0","0","0","0","0","0","3","0","3","0","0","0","2","2","0","0","0","0","0","0","0","0","0","0","-2"
"120883","University of the Pacific","2017","Tenured total","259","159","100","0","0","0","40","23","17","4","2","2","9","5","4","0","0","0","198","127","71","1","0","1","0","0","0","7","2","5","-2"
"120883","University of the Pacific","2017","Tenured, professors","135","93","42","0","0","0","24","18","6","2","2","0","7","5","2","0","0","0","97","67","30","0","0","0","0","0","0","5","1","4","-2"
"120883","University of the Pacific","2017","Tenured, associate professors","120","64","56","0","0","0","16","5","11","2","0","2","2","0","2","0","0","0","98","58","40","0","0","0","0","0","0","2","1","1","-2"
"120883","University of the Pacific","2017","Tenured, assistant professors","4","2","2","0","0","0","0","0","0","0","0","0","0","0","0","0","0","0","3","2","1","1","0","1","0","0","0","0","0","0","-2"
"120883","University of the Pacific","2017","On-Tenure track total","67","30","37","1","0","1","18","6","12","0","0","0","7","2","5","0","0","0","33","18","15","2","0","2","2","2","0","4","2","2","-2"
"120883","University of the Pacific","2017","On-tenure track, associate professors","4","2","2","0","0","0","1","0","1","0","0","0","0","0","0","0","0","0","3","2","1","0","0","0","0","0","0","0","0","0","-2"
"120883","University of the Pacific","2017","On-tenure track, assistant professors","63","28","35","1","0","1","17","6","11","0","0","0","7","2","5","0","0","0","30","16","14","2","0","2","2","2","0","4","2","2","-2"
"120883","University of the Pacific","2017","Not on tenure track/No tenure system system total","111","58","53","0","0","0","11","4","7","2","0","2","6","2","4","0","0","0","82","46","36","0","0","0","8","6","2","2","0","2","-2"
"120883","University of the Pacific","2017","Not on tenure/no tenure system, professors","21","8","13","0","0","0","2","1","1","0","0","0","1","0","1","0","0","0","17","6","11","0","0","0","1","1","0","0","0","0","-2"
"120883","University of the Pacific","2017","Not on tenure/no tenure system, associate professors","14","7","7","0","0","0","1","1","0","0","0","0","0","0","0","0","0","0","12","5","7","0","0","0","1","1","0","0","0","0","-2"
"120883","University of the Pacific","2017","Not on tenure/no tenure system, assistant professors","47","27","20","0","0","0","6","1","5","2","0","2","3","2","1","0","0","0","29","20","9","0","0","0","6","4","2","1","0","1","-2"
"120883","University of the Pacific","2017","Not on tenure/no tenure system, instructors","8","5","3","0","0","0","1","1","0","0","0","0","0","0","0","0","0","0","7","4","3","0","0","0","0","0","0","0","0","0","-2"
"120883","University of the Pacific","2017","Not on tenure/no tenure system, lecturers","21","11","10","0","0","0","1","0","1","0","0","0","2","0","2","0","0","0","17","11","6","0","0","0","0","0","0","1","0","1","-2"
"121309","Point Loma Nazarene University","2017","Tenured total","68","48","20","0","0","0","3","2","1","2","2","0","4","1","3","0","0","0","59","43","16","0","0","0","0","0","0","0","0","0","-2"
"121309","Point Loma Nazarene University","2017","Tenured, professors","66","47","19","0","0","0","3","2","1","2","2","0","4","1","3","0","0","0","57","42","15","0","0","0","0","0","0","0","0","0","-2"
"121309","Point Loma Nazarene University","2017","Tenured, associate professors","2","1","1","0","0","0","0","0","0","0","0","0","0","0","0","0","0","0","2","1","1","0","0","0","0","0","0","0","0","0","-2"
"121309","Point Loma Nazarene University","2017","On-Tenure track total","58","28","30","1","0","1","5","1","4","3","0","3","4","2","2","0","0","0","41","22","19","1","1","0","3","2","1","0","0","0","-2"
"121309","Point Loma Nazarene University","2017","On-tenure track, professors","10","6","4","0","0","0","1","0","1","1","0","1","1","0","1","0","0","0","6","5","1","0","0","0","1","1","0","0","0","0","-2"
"121309","Point Loma Nazarene University","2017","On-tenure track, associate professors","37","18","19","0","0","0","3","1","2","2","0","2","2","1","1","0","0","0","28","14","14","1","1","0","1","1","0","0","0","0","-2"
"121309","Point Loma Nazarene University","2017","On-tenure track, assistant professors","11","4","7","1","0","1","1","0","1","0","0","0","1","1","0","0","0","0","7","3","4","0","0","0","1","0","1","0","0","0","-2"
"121309","Point Loma Nazarene University","2017","Not on tenure track/No tenure system system total","17","8","9","0","0","0","1","1","0","0","0","0","1","0","1","0","0","0","15","7","8","0","0","0","0","0","0","0","0","0","-2"
"121309","Point Loma Nazarene University","2017","Not on tenure/no tenure system, professors","2","1","1","0","0","0","0","0","0","0","0","0","0","0","0","0","0","0","2","1","1","0","0","0","0","0","0","0","0","0","-2"
"121309","Point Loma Nazarene University","2017","Not on tenure/no tenure system, associate professors","9","3","6","0","0","0","1","1","0","0","0","0","1","0","1","0","0","0","7","2","5","0","0","0","0","0","0","0","0","0","-2"
"121309","Point Loma Nazarene University","2017","Not on tenure/no tenure system, assistant professors","6","4","2","0","0","0","0","0","0","0","0","0","0","0","0","0","0","0","6","4","2","0","0","0","0","0","0","0","0","0","-2"
"121345","Pomona College","2017","Tenured total","149","88","61","0","0","0","21","7","14","4","3","1","17","12","5","0","0","0","81","49","32","4","4","0","20","12","8","2","1","1","-2"
"121345","Pomona College","2017","Tenured, professors","84","50","34","0","0","0","13","4","9","2","1","1","11","7","4","0","0","0","50","32","18","1","1","0","7","5","2","0","0","0","-2"
"121345","Pomona College","2017","Tenured, associate professors","65","38","27","0","0","0","8","3","5","2","2","0","6","5","1","0","0","0","31","17","14","3","3","0","13","7","6","2","1","1","-2"
"121345","Pomona College","2017","On-Tenure track total","32","18","14","0","0","0","6","3","3","4","1","3","3","2","1","0","0","0","15","10","5","0","0","0","1","0","1","3","2","1","-2"
"121345","Pomona College","2017","On-tenure track, assistant professors","31","17","14","0","0","0","6","3","3","4","1","3","3","2","1","0","0","0","14","9","5","0","0","0","1","0","1","3","2","1","-2"
"121345","Pomona College","2017","On-tenure track, instructors","1","1","0","0","0","0","0","0","0","0","0","0","0","0","0","0","0","0","1","1","0","0","0","0","0","0","0","0","0","0","-2"
"121345","Pomona College","2017","Not on tenure track/No tenure system system total","2","0","2","0","0","0","1","0","1","0","0","0","1","0","1","0","0","0","0","0","0","0","0","0","0","0","0","0","0","0","-2"
"121345","Pomona College","2017","Not on tenure/no tenure system, professors","2","0","2","0","0","0","1","0","1","0","0","0","1","0","1","0","0","0","0","0","0","0","0","0","0","0","0","0","0","0","-2"
"122296","Samuel Merritt University","2017","Not on tenure track/No tenure system system total","164","39","125","0","0","0","14","4","10","8","0","8","7","1","6","0","0","0","131","33","98","3","1","2","1","0","1","0","0","0","-2"
"122296","Samuel Merritt University","2017","Not on tenure/no tenure system, professors","18","6","12","0","0","0","2","0","2","1","0","1","1","0","1","0","0","0","13","5","8","1","1","0","0","0","0","0","0","0","-2"
"122296","Samuel Merritt University","2017","Not on tenure/no tenure system, associate professors","24","5","19","0","0","0","2","0","2","0","0","0","0","0","0","0","0","0","22","5","17","0","0","0","0","0","0","0","0","0","-2"
"122296","Samuel Merritt University","2017","Not on tenure/no tenure system, assistant professors","87","22","65","0","0","0","9","3","6","4","0","4","4","1","3","0","0","0","68","18","50","2","0","2","0","0","0","0","0","0","-2"
"122296","Samuel Merritt University","2017","Not on tenure/no tenure system, instructors","35","6","29","0","0","0","1","1","0","3","0","3","2","0","2","0","0","0","28","5","23","0","0","0","1","0","1","0","0","0","-2"
"122436","University of San Diego","2017","Tenured total","273","160","113","0","0","0","29","14","15","7","6","1","18","7","11","0","0","0","214","130","84","3","2","1","1","1","0","1","0","1","-2"
"122436","University of San Diego","2017","Tenured, professors","164","109","55","0","0","0","15","9","6","4","3","1","9","6","3","0","0","0","133","89","44","2","2","0","0","0","0","1","0","1","-2"
"122436","University of San Diego","2017","Tenured, associate professors","108","50","58","0","0","0","14","5","9","3","3","0","9","1","8","0","0","0","80","40","40","1","0","1","1","1","0","0","0","0","-2"
"122436","University of San Diego","2017","Tenured, assistant professors","1","1","0","0","0","0","0","0","0","0","0","0","0","0","0","0","0","0","1","1","0","0","0","0","0","0","0","0","0","0","-2"
"122436","University of San Diego","2017","On-Tenure track total","95","47","48","0","0","0","12","5","7","6","4","2","15","10","5","0","0","0","51","24","27","2","0","2","1","0","1","8","4","4","-2"
"122436","University of San Diego","2017","On-tenure track, professors","2","2","0","0","0","0","0","0","0","0","0","0","0","0","0","0","0","0","2","2","0","0","0","0","0","0","0","0","0","0","-2"
"122436","University of San Diego","2017","On-tenure track, associate professors","9","1","8","0","0","0","1","0","1","0","0","0","0","0","0","0","0","0","8","1","7","0","0","0","0","0","0","0","0","0","-2"
"122436","University of San Diego","2017","On-tenure track, assistant professors","83","43","40","0","0","0","11","5","6","6","4","2","15","10","5","0","0","0","40","20","20","2","0","2","1","0","1","8","4","4","-2"
"122436","University of San Diego","2017","On-tenure track, instructors","1","1","0","0","0","0","0","0","0","0","0","0","0","0","0","0","0","0","1","1","0","0","0","0","0","0","0","0","0","0","-2"
"122436","University of San Diego","2017","Not on tenure track/No tenure system system total","90","37","53","1","1","0","6","1","5","4","2","2","7","3","4","0","0","0","65","26","39","1","1","0","2","0","2","4","3","1","-2"
"122436","University of San Diego","2017","Not on tenure/no tenure system, professors","25","11","14","0","0","0","1","1","0","0","0","0","2","1","1","0","0","0","20","8","12","0","0","0","0","0","0","2","1","1","-2"
"122436","University of San Diego","2017","Not on tenure/no tenure system, associate professors","9","4","5","1","1","0","1","0","1","0","0","0","1","0","1","0","0","0","6","3","3","0","0","0","0","0","0","0","0","0","-2"
"122436","University of San Diego","2017","Not on tenure/no tenure system, assistant professors","29","11","18","0","0","0","2","0","2","0","0","0","2","2","0","0","0","0","23","8","15","1","1","0","1","0","1","0","0","0","-2"
"122436","University of San Diego","2017","Not on tenure/no tenure system, instructors","19","7","12","0","0","0","1","0","1","0","0","0","1","0","1","0","0","0","16","7","9","0","0","0","1","0","1","0","0","0","-2"
"122436","University of San Diego","2017","Not on tenure/no tenure system, no academic rank","8","4","4","0","0","0","1","0","1","4","2","2","1","0","1","0","0","0","0","0","0","0","0","0","0","0","0","2","2","0","-2"
"122454","San Francisco Art Institute","2017","Tenured total","16","10","6","1","1","0","0","0","0","1","1","0","1","1","0","0","0","0","13","7","6","0","0","0","0","0","0","0","0","0","-2"
"122454","San Francisco Art Institute","2017","Tenured, professors","4","3","1","1","1","0","0","0","0","0","0","0","1","1","0","0","0","0","2","1","1","0","0","0","0","0","0","0","0","0","-2"
"122454","San Francisco Art Institute","2017","Tenured, associate professors","12","7","5","0","0","0","0","0","0","1","1","0","0","0","0","0","0","0","11","6","5","0","0","0","0","0","0","0","0","0","-2"
"122454","San Francisco Art Institute","2017","On-Tenure track total","9","3","6","0","0","0","2","0","2","0","0","0","1","0","1","0","0","0","5","2","3","0","0","0","0","0","0","1","1","0","-2"
"122454","San Francisco Art Institute","2017","On-tenure track, assistant professors","9","3","6","0","0","0","2","0","2","0","0","0","1","0","1","0","0","0","5","2","3","0","0","0","0","0","0","1","1","0","-2"
"122454","San Francisco Art Institute","2017","Not on tenure track/No tenure system system total","2","1","1","0","0","0","1","0","1","1","1","0","0","0","0","0","0","0","0","0","0","0","0","0","0","0","0","0","0","0","-2"
"122454","San Francisco Art Institute","2017","Not on tenure/no tenure system, no academic rank","2","1","1","0","0","0","1","0","1","1","1","0","0","0","0","0","0","0","0","0","0","0","0","0","0","0","0","0","0","0","-2"
"122612","University of San Francisco","2017","Tenured total","234","125","109","1","0","1","29","15","14","10","2","8","24","16","8","1","1","0","146","80","66","5","4","1","17","6","11","1","1","0","-2"
"122612","University of San Francisco","2017","Tenured, professors","143","86","57","0","0","0","11","6","5","4","2","2","14","9","5","1","1","0","98","59","39","5","4","1","10","5","5","0","0","0","-2"
"122612","University of San Francisco","2017","Tenured, associate professors","90","38","52","1","0","1","18","9","9","6","0","6","10","7","3","0","0","0","48","21","27","0","0","0","6","0","6","1","1","0","-2"
"122612","University of San Francisco","2017","Tenured, assistant professors","1","1","0","0","0","0","0","0","0","0","0","0","0","0","0","0","0","0","0","0","0","0","0","0","1","1","0","0","0","0","-2"
"122612","University of San Francisco","2017","On-Tenure track total","126","50","76","0","0","0","18","7","11","7","3","4","15","5","10","0","0","0","57","24","33","4","2","2","12","5","7","13","4","9","-2"
"122612","University of San Francisco","2017","On-tenure track, professors","4","1","3","0","0","0","2","0","2","0","0","0","1","1","0","0","0","0","1","0","1","0","0","0","0","0","0","0","0","0","-2"
"122612","University of San Francisco","2017","On-tenure track, associate professors","23","11","12","0","0","0","1","1","0","3","2","1","1","1","0","0","0","0","15","5","10","1","0","1","2","2","0","0","0","0","-2"
"122612","University of San Francisco","2017","On-tenure track, assistant professors","98","37","61","0","0","0","15","6","9","4","1","3","13","3","10","0","0","0","41","19","22","2","1","1","10","3","7","13","4","9","-2"
"122612","University of San Francisco","2017","On-tenure track, instructors","1","1","0","0","0","0","0","0","0","0","0","0","0","0","0","0","0","0","0","0","0","1","1","0","0","0","0","0","0","0","-2"
"122612","University of San Francisco","2017","Not on tenure track/No tenure system system total","139","54","85","0","0","0","21","6","15","4","0","4","14","6","8","0","0","0","77","31","46","7","4","3","14","7","7","2","0","2","-2"
"122612","University of San Francisco","2017","Not on tenure/no tenure system, professors","15","9","6","0","0","0","1","1","0","1","0","1","0","0","0","0","0","0","10","6","4","1","1","0","2","1","1","0","0","0","-2"
"122612","University of San Francisco","2017","Not on tenure/no tenure system, associate professors","30","12","18","0","0","0","6","1","5","1","0","1","2","1","1","0","0","0","17","7","10","0","0","0","4","3","1","0","0","0","-2"
"122612","University of San Francisco","2017","Not on tenure/no tenure system, assistant professors","79","26","53","0","0","0","11","2","9","2","0","2","12","5","7","0","0","0","41","15","26","4","1","3","7","3","4","2","0","2","-2"
"122612","University of San Francisco","2017","Not on tenure/no tenure system, instructors","15","7","8","0","0","0","3","2","1","0","0","0","0","0","0","0","0","0","9","3","6","2","2","0","1","0","1","0","0","0","-2"
"122728","William Jessup University","2017","Tenured total","5","3","2","1","1","0","0","0","0","0","0","0","0","0","0","0","0","0","4","2","2","0","0","0","0","0","0","0","0","0","-2"
"122728","William Jessup University","2017","Tenured, professors","5","3","2","1","1","0","0","0","0","0","0","0","0","0","0","0","0","0","4","2","2","0","0","0","0","0","0","0","0","0","-2"
"122728","William Jessup University","2017","On-Tenure track total","34","24","10","0","0","0","1","1","0","3","1","2","1","1","0","0","0","0","28","20","8","0","0","0","1","1","0","0","0","0","-2"
"122728","William Jessup University","2017","On-tenure track, professors","2","2","0","0","0","0","0","0","0","0","0","0","0","0","0","0","0","0","2","2","0","0","0","0","0","0","0","0","0","0","-2"
"122728","William Jessup University","2017","On-tenure track, associate professors","12","7","5","0","0","0","1","1","0","1","0","1","1","1","0","0","0","0","9","5","4","0","0","0","0","0","0","0","0","0","-2"
"122728","William Jessup University","2017","On-tenure track, assistant professors","20","15","5","0","0","0","0","0","0","2","1","1","0","0","0","0","0","0","17","13","4","0","0","0","1","1","0","0","0","0","-2"
"122931","Santa Clara University","2017","Tenured total","297","187","110","0","0","0","44","26","18","7","3","4","21","13","8","1","1","0","218","139","79","3","3","0","2","1","1","1","1","0","-2"
"122931","Santa Clara University","2017","Tenured, professors","155","104","51","0","0","0","17","13","4","3","3","0","11","9","2","0","0","0","122","77","45","2","2","0","0","0","0","0","0","0","-2"
"122931","Santa Clara University","2017","Tenured, associate professors","142","83","59","0","0","0","27","13","14","4","0","4","10","4","6","1","1","0","96","62","34","1","1","0","2","1","1","1","1","0","-2"
"122931","Santa Clara University","2017","On-Tenure track total","93","51","42","0","0","0","25","13","12","6","4","2","10","5","5","0","0","0","45","25","20","0","0","0","2","0","2","5","4","1","-2"
"122931","Santa Clara University","2017","On-tenure track, associate professors","2","2","0","0","0","0","1","1","0","0","0","0","0","0","0","0","0","0","1","1","0","0","0","0","0","0","0","0","0","0","-2"
"122931","Santa Clara University","2017","On-tenure track, assistant professors","91","49","42","0","0","0","24","12","12","6","4","2","10","5","5","0","0","0","44","24","20","0","0","0","2","0","2","5","4","1","-2"
"122931","Santa Clara University","2017","Not on tenure track/No tenure system system total","152","66","86","0","0","0","17","9","8","5","2","3","12","3","9","1","1","0","113","51","62","2","0","2","2","0","2","0","0","0","-2"
"122931","Santa Clara University","2017","Not on tenure/no tenure system, lecturers","149","64","85","0","0","0","16","8","8","5","2","3","12","3","9","1","1","0","111","50","61","2","0","2","2","0","2","0","0","0","-2"
"122931","Santa Clara University","2017","Not on tenure/no tenure system, no academic rank","3","2","1","0","0","0","1","1","0","0","0","0","0","0","0","0","0","0","2","1","1","0","0","0","0","0","0","0","0","0","-2"
"123299","Shasta College","2017","Tenured total","63","37","26","1","1","0","2","2","0","2","0","2","2","2","0","0","0","0","56","32","24","0","0","0","0","0","0","0","0","0","-2"
"123299","Shasta College","2017","Tenured, instructors","63","37","26","1","1","0","2","2","0","2","0","2","2","2","0","0","0","0","56","32","24","0","0","0","0","0","0","0","0","0","-2"
"123299","Shasta College","2017","On-Tenure track total","29","17","12","0","0","0","0","0","0","0","0","0","3","2","1","0","0","0","26","15","11","0","0","0","0","0","0","0","0","0","-2"
"123299","Shasta College","2017","On-tenure track, instructors","29","17","12","0","0","0","0","0","0","0","0","0","3","2","1","0","0","0","26","15","11","0","0","0","0","0","0","0","0","0","-2"
"123299","Shasta College","2017","Not on tenure track/No tenure system system total","55","26","29","0","0","0","5","2","3","1","1","0","7","3","4","0","0","0","42","20","22","0","0","0","0","0","0","0","0","0","-2"
"123299","Shasta College","2017","Not on tenure/no tenure system, instructors","55","26","29","0","0","0","5","2","3","1","1","0","7","3","4","0","0","0","42","20","22","0","0","0","0","0","0","0","0","0","-2"
"123457","Simpson University","2017","Not on tenure track/No tenure system system total","49","26","23","0","0","0","2","1","1","0","0","0","2","0","2","0","0","0","41","21","20","4","4","0","0","0","0","0","0","0","-2"
"123457","Simpson University","2017","Not on tenure/no tenure system, professors","7","5","2","0","0","0","0","0","0","0","0","0","1","0","1","0","0","0","5","4","1","1","1","0","0","0","0","0","0","0","-2"
"123457","Simpson University","2017","Not on tenure/no tenure system, associate professors","14","10","4","0","0","0","0","0","0","0","0","0","0","0","0","0","0","0","12","8","4","2","2","0","0","0","0","0","0","0","-2"
"123457","Simpson University","2017","Not on tenure/no tenure system, assistant professors","26","11","15","0","0","0","2","1","1","0","0","0","1","0","1","0","0","0","22","9","13","1","1","0","0","0","0","0","0","0","-2"
"123457","Simpson University","2017","Not on tenure/no tenure system, instructors","2","0","2","0","0","0","0","0","0","0","0","0","0","0","0","0","0","0","2","0","2","0","0","0","0","0","0","0","0","0","-2"
"124292","Thomas Aquinas College","2017","Not on tenure track/No tenure system system total","34","31","3","0","0","0","0","0","0","0","0","0","3","3","0","0","0","0","27","25","2","0","0","0","4","3","1","0","0","0","-2"
"124292","Thomas Aquinas College","2017","Not on tenure/no tenure system, no academic rank","34","31","3","0","0","0","0","0","0","0","0","0","3","3","0","0","0","0","27","25","2","0","0","0","4","3","1","0","0","0","-2"
"125727","Westmont College","2017","Tenured total","59","40","19","0","0","0","3","2","1","0","0","0","3","1","2","0","0","0","53","37","16","0","0","0","0","0","0","0","0","0","-2"
"125727","Westmont College","2017","Tenured, professors","48","36","12","0","0","0","3","2","1","0","0","0","2","1","1","0","0","0","43","33","10","0","0","0","0","0","0","0","0","0","-2"
"125727","Westmont College","2017","Tenured, associate professors","10","4","6","0","0","0","0","0","0","0","0","0","1","0","1","0","0","0","9","4","5","0","0","0","0","0","0","0","0","0","-2"
"125727","Westmont College","2017","Tenured, no academic rank","1","0","1","0","0","0","0","0","0","0","0","0","0","0","0","0","0","0","1","0","1","0","0","0","0","0","0","0","0","0","-2"
"125727","Westmont College","2017","On-Tenure track total","21","7","14","1","0","1","4","3","1","1","0","1","0","0","0","0","0","0","13","4","9","0","0","0","2","0","2","0","0","0","-2"
"125727","Westmont College","2017","On-tenure track, professors","2","1","1","0","0","0","0","0","0","0","0","0","0","0","0","0","0","0","1","1","0","0","0","0","1","0","1","0","0","0","-2"
"125727","Westmont College","2017","On-tenure track, associate professors","6","2","4","1","0","1","2","1","1","0","0","0","0","0","0","0","0","0","3","1","2","0","0","0","0","0","0","0","0","0","-2"
"125727","Westmont College","2017","On-tenure track, assistant professors","12","4","8","0","0","0","2","2","0","1","0","1","0","0","0","0","0","0","8","2","6","0","0","0","1","0","1","0","0","0","-2"
"125727","Westmont College","2017","On-tenure track, no academic rank","1","0","1","0","0","0","0","0","0","0","0","0","0","0","0","0","0","0","1","0","1","0","0","0","0","0","0","0","0","0","-2"
"125727","Westmont College","2017","Not on tenure track/No tenure system system total","16","9","7","1","0","1","3","3","0","1","0","1","0","0","0","0","0","0","11","6","5","0","0","0","0","0","0","0","0","0","-2"
"125727","Westmont College","2017","Not on tenure/no tenure system, associate professors","5","3","2","0","0","0","1","1","0","0","0","0","0","0","0","0","0","0","4","2","2","0","0","0","0","0","0","0","0","0","-2"
"125727","Westmont College","2017","Not on tenure/no tenure system, assistant professors","7","4","3","0","0","0","2","2","0","1","0","1","0","0","0","0","0","0","4","2","2","0","0","0","0","0","0","0","0","0","-2"
"125727","Westmont College","2017","Not on tenure/no tenure system, instructors","4","2","2","1","0","1","0","0","0","0","0","0","0","0","0","0","0","0","3","2","1","0","0","0","0","0","0","0","0","0","-2"
"126580","University of Colorado Colorado Springs","2017","Tenured total","162","97","65","1","0","1","11","6","5","2","1","1","10","6","4","0","0","0","132","81","51","0","0","0","6","3","3","0","0","0","-2"
"126580","University of Colorado Colorado Springs","2017","Tenured, professors","81","56","25","0","0","0","6","6","0","0","0","0","4","2","2","0","0","0","69","47","22","0","0","0","2","1","1","0","0","0","-2"
"126580","University of Colorado Colorado Springs","2017","Tenured, associate professors","81","41","40","1","0","1","5","0","5","2","1","1","6","4","2","0","0","0","63","34","29","0","0","0","4","2","2","0","0","0","-2"
"126580","University of Colorado Colorado Springs","2017","On-Tenure track total","92","43","49","1","0","1","17","11","6","2","0","2","2","0","2","0","0","0","55","25","30","1","0","1","14","7","7","0","0","0","-2"
"126580","University of Colorado Colorado Springs","2017","On-tenure track, assistant professors","92","43","49","1","0","1","17","11","6","2","0","2","2","0","2","0","0","0","55","25","30","1","0","1","14","7","7","0","0","0","-2"
"126580","University of Colorado Colorado Springs","2017","Not on tenure track/No tenure system system total","188","72","116","1","0","1","5","1","4","3","0","3","11","6","5","0","0","0","143","55","88","4","2","2","21","8","13","0","0","0","-2"
"126580","University of Colorado Colorado Springs","2017","Not on tenure/no tenure system, professors","1","1","0","0","0","0","1","1","0","0","0","0","0","0","0","0","0","0","0","0","0","0","0","0","0","0","0","0","0","0","-2"
"126580","University of Colorado Colorado Springs","2017","Not on tenure/no tenure system, assistant professors","3","2","1","0","0","0","0","0","0","0","0","0","0","0","0","0","0","0","3","2","1","0","0","0","0","0","0","0","0","0","-2"
"126580","University of Colorado Colorado Springs","2017","Not on tenure/no tenure system, instructors","184","69","115","1","0","1","4","0","4","3","0","3","11","6","5","0","0","0","140","53","87","4","2","2","21","8","13","0","0","0","-2"
"127200","Front Range Community College","2017","Tenured total","192","82","110","1","0","1","6","2","4","2","1","1","9","3","6","0","0","0","172","76","96","1","0","1","1","0","1","0","0","0","-2"
"127200","Front Range Community College","2017","Tenured, professors","192","82","110","1","0","1","6","2","4","2","1","1","9","3","6","0","0","0","172","76","96","1","0","1","1","0","1","0","0","0","-2"
"127200","Front Range Community College","2017","On-Tenure track total","41","15","26","0","0","0","2","1","1","0","0","0","7","2","5","0","0","0","32","12","20","0","0","0","0","0","0","0","0","0","-2"
"127200","Front Range Community College","2017","On-tenure track, professors","41","15","26","0","0","0","2","1","1","0","0","0","7","2","5","0","0","0","32","12","20","0","0","0","0","0","0","0","0","0","-2"
"127200","Front Range Community College","2017","Not on tenure track/No tenure system system total","12","4","8","0","0","0","0","0","0","0","0","0","2","1","1","0","0","0","10","3","7","0","0","0","0","0","0","0","0","0","-2"
"127200","Front Range Community College","2017","Not on tenure/no tenure system, professors","12","4","8","0","0","0","0","0","0","0","0","0","2","1","1","0","0","0","10","3","7","0","0","0","0","0","0","0","0","0","-2"
"127556","Colorado Mesa University","2017","Tenured total","96","59","37","0","0","0","2","2","0","0","0","0","1","1","0","0","0","0","77","45","32","0","0","0","14","10","4","2","1","1","-2"
"127556","Colorado Mesa University","2017","Tenured, professors","53","29","24","0","0","0","1","1","0","0","0","0","1","1","0","0","0","0","41","22","19","0","0","0","9","5","4","1","0","1","-2"
"127556","Colorado Mesa University","2017","Tenured, associate professors","40","28","12","0","0","0","1","1","0","0","0","0","0","0","0","0","0","0","34","22","12","0","0","0","4","4","0","1","1","0","-2"
"127556","Colorado Mesa University","2017","Tenured, assistant professors","3","2","1","0","0","0","0","0","0","0","0","0","0","0","0","0","0","0","2","1","1","0","0","0","1","1","0","0","0","0","-2"
"127556","Colorado Mesa University","2017","On-Tenure track total","83","41","42","0","0","0","1","1","0","0","0","0","2","2","0","0","0","0","66","29","37","0","0","0","8","6","2","6","3","3","-2"
"127556","Colorado Mesa University","2017","On-tenure track, professors","3","3","0","0","0","0","0","0","0","0","0","0","0","0","0","0","0","0","2","2","0","0","0","0","1","1","0","0","0","0","-2"
"127556","Colorado Mesa University","2017","On-tenure track, associate professors","7","4","3","0","0","0","0","0","0","0","0","0","0","0","0","0","0","0","6","3","3","0","0","0","1","1","0","0","0","0","-2"
"127556","Colorado Mesa University","2017","On-tenure track, assistant professors","73","34","39","0","0","0","1","1","0","0","0","0","2","2","0","0","0","0","58","24","34","0","0","0","6","4","2","6","3","3","-2"
"127556","Colorado Mesa University","2017","Not on tenure track/No tenure system system total","116","59","57","0","0","0","1","0","1","0","0","0","3","2","1","0","0","0","97","51","46","0","0","0","11","5","6","4","1","3","-2"
"127556","Colorado Mesa University","2017","Not on tenure/no tenure system, associate professors","1","0","1","0","0","0","0","0","0","0","0","0","0","0","0","0","0","0","1","0","1","0","0","0","0","0","0","0","0","0","-2"
"127556","Colorado Mesa University","2017","Not on tenure/no tenure system, assistant professors","1","0","1","0","0","0","0","0","0","0","0","0","0","0","0","0","0","0","1","0","1","0","0","0","0","0","0","0","0","0","-2"
"127556","Colorado Mesa University","2017","Not on tenure/no tenure system, instructors","105","55","50","0","0","0","1","0","1","0","0","0","3","2","1","0","0","0","88","48","40","0","0","0","9","4","5","4","1","3","-2"
"127556","Colorado Mesa University","2017","Not on tenure/no tenure system, lecturers","8","3","5","0","0","0","0","0","0","0","0","0","0","0","0","0","0","0","6","2","4","0","0","0","2","1","1","0","0","0","-2"
"127556","Colorado Mesa University","2017","Not on tenure/no tenure system, no academic rank","1","1","0","0","0","0","0","0","0","0","0","0","0","0","0","0","0","0","1","1","0","0","0","0","0","0","0","0","0","0","-2"
"127820","Pikes Peak Community College","2017","Not on tenure track/No tenure system system total","180","62","118","0","0","0","6","2","4","7","1","6","7","3","4","0","0","0","156","54","102","0","0","0","4","2","2","0","0","0","-2"
"127820","Pikes Peak Community College","2017","Not on tenure/no tenure system, no academic rank","180","62","118","0","0","0","6","2","4","7","1","6","7","3","4","0","0","0","156","54","102","0","0","0","4","2","2","0","0","0","-2"
"127909","Red Rocks Community College","2017","Not on tenure track/No tenure system system total","96","35","61","0","0","0","1","0","1","0","0","0","4","2","2","0","0","0","88","33","55","1","0","1","2","0","2","0","0","0","-2"
"127909","Red Rocks Community College","2017","Not on tenure/no tenure system, instructors","96","35","61","0","0","0","1","0","1","0","0","0","4","2","2","0","0","0","88","33","55","1","0","1","2","0","2","0","0","0","-2"
"127918","Regis University","2017","Tenured total","76","43","33","0","0","0","2","1","1","3","3","0","6","2","4","0","0","0","65","37","28","0","0","0","0","0","0","0","0","0","-2"
"127918","Regis University","2017","Tenured, professors","27","13","14","0","0","0","1","1","0","0","0","0","3","1","2","0","0","0","23","11","12","0","0","0","0","0","0","0","0","0","-2"
"127918","Regis University","2017","Tenured, associate professors","48","29","19","0","0","0","1","0","1","3","3","0","3","1","2","0","0","0","41","25","16","0","0","0","0","0","0","0","0","0","-2"
"127918","Regis University","2017","Tenured, assistant professors","1","1","0","0","0","0","0","0","0","0","0","0","0","0","0","0","0","0","1","1","0","0","0","0","0","0","0","0","0","0","-2"
"127918","Regis University","2017","On-Tenure track total","31","11","20","0","0","0","1","1","0","1","1","0","3","1","2","0","0","0","26","8","18","0","0","0","0","0","0","0","0","0","-2"
"127918","Regis University","2017","On-tenure track, associate professors","1","0","1","0","0","0","0","0","0","0","0","0","0","0","0","0","0","0","1","0","1","0","0","0","0","0","0","0","0","0","-2"
"127918","Regis University","2017","On-tenure track, assistant professors","30","11","19","0","0","0","1","1","0","1","1","0","3","1","2","0","0","0","25","8","17","0","0","0","0","0","0","0","0","0","-2"
"127918","Regis University","2017","Not on tenure track/No tenure system system total","209","77","132","0","0","0","7","2","5","5","2","3","9","6","3","0","0","0","184","66","118","1","0","1","2","0","2","1","1","0","-2"
"127918","Regis University","2017","Not on tenure/no tenure system, professors","42","17","25","0","0","0","1","1","0","2","1","1","1","1","0","0","0","0","37","14","23","1","0","1","0","0","0","0","0","0","-2"
"127918","Regis University","2017","Not on tenure/no tenure system, associate professors","58","19","39","0","0","0","3","0","3","1","0","1","2","2","0","0","0","0","52","17","35","0","0","0","0","0","0","0","0","0","-2"
"127918","Regis University","2017","Not on tenure/no tenure system, assistant professors","59","21","38","0","0","0","3","1","2","0","0","0","3","2","1","0","0","0","52","17","35","0","0","0","0","0","0","1","1","0","-2"
"127918","Regis University","2017","Not on tenure/no tenure system, instructors","32","11","21","0","0","0","0","0","0","2","1","1","1","0","1","0","0","0","28","10","18","0","0","0","1","0","1","0","0","0","-2"
"127918","Regis University","2017","Not on tenure/no tenure system, lecturers","14","9","5","0","0","0","0","0","0","0","0","0","1","1","0","0","0","0","12","8","4","0","0","0","1","0","1","0","0","0","-2"
"127918","Regis University","2017","Not on tenure/no tenure system, no academic rank","4","0","4","0","0","0","0","0","0","0","0","0","1","0","1","0","0","0","3","0","3","0","0","0","0","0","0","0","0","0","-2"
"128391","Western Colorado University","2017","Tenured total","57","37","20","0","0","0","0","0","0","0","0","0","0","0","0","1","0","1","53","35","18","3","2","1","0","0","0","0","0","0","-2"
"128391","Western Colorado University","2017","Tenured, professors","44","28","16","0","0","0","0","0","0","0","0","0","0","0","0","1","0","1","41","26","15","2","2","0","0","0","0","0","0","0","-2"
"128391","Western Colorado University","2017","Tenured, associate professors","13","9","4","0","0","0","0","0","0","0","0","0","0","0","0","0","0","0","12","9","3","1","0","1","0","0","0","0","0","0","-2"
"128391","Western Colorado University","2017","On-Tenure track total","28","15","13","0","0","0","0","0","0","1","1","0","2","1","1","0","0","0","24","13","11","1","0","1","0","0","0","0","0","0","-2"
"128391","Western Colorado University","2017","On-tenure track, associate professors","3","1","2","0","0","0","0","0","0","0","0","0","0","0","0","0","0","0","2","1","1","1","0","1","0","0","0","0","0","0","-2"
"128391","Western Colorado University","2017","On-tenure track, assistant professors","25","14","11","0","0","0","0","0","0","1","1","0","2","1","1","0","0","0","22","12","10","0","0","0","0","0","0","0","0","0","-2"
"128391","Western Colorado University","2017","Not on tenure track/No tenure system system total","44","21","23","0","0","0","3","1","2","0","0","0","1","0","1","0","0","0","40","20","20","0","0","0","0","0","0","0","0","0","-2"
"128391","Western Colorado University","2017","Not on tenure/no tenure system, lecturers","44","21","23","0","0","0","3","1","2","0","0","0","1","0","1","0","0","0","40","20","20","0","0","0","0","0","0","0","0","0","-2"
"128498","Albertus Magnus College","2017","Tenured total","8","4","4","0","0","0","0","0","0","0","0","0","0","0","0","0","0","0","7","3","4","0","0","0","1","1","0","0","0","0","-2"
"128498","Albertus Magnus College","2017","Tenured, professors","7","3","4","0","0","0","0","0","0","0","0","0","0","0","0","0","0","0","7","3","4","0","0","0","0","0","0","0","0","0","-2"
"128498","Albertus Magnus College","2017","Tenured, associate professors","1","1","0","0","0","0","0","0","0","0","0","0","0","0","0","0","0","0","0","0","0","0","0","0","1","1","0","0","0","0","-2"
"128498","Albertus Magnus College","2017","Not on tenure track/No tenure system system total","33","20","13","0","0","0","1","1","0","0","0","0","0","0","0","0","0","0","25","16","9","0","0","0","7","3","4","0","0","0","-2"
"128498","Albertus Magnus College","2017","Not on tenure/no tenure system, professors","8","7","1","0","0","0","0","0","0","0","0","0","0","0","0","0","0","0","5","4","1","0","0","0","3","3","0","0","0","0","-2"
"128498","Albertus Magnus College","2017","Not on tenure/no tenure system, associate professors","13","5","8","0","0","0","1","1","0","0","0","0","0","0","0","0","0","0","9","4","5","0","0","0","3","0","3","0","0","0","-2"
"128498","Albertus Magnus College","2017","Not on tenure/no tenure system, assistant professors","11","8","3","0","0","0","0","0","0","0","0","0","0","0","0","0","0","0","10","8","2","0","0","0","1","0","1","0","0","0","-2"
"128498","Albertus Magnus College","2017","Not on tenure/no tenure system, lecturers","1","0","1","0","0","0","0","0","0","0","0","0","0","0","0","0","0","0","1","0","1","0","0","0","0","0","0","0","0","0","-2"
"128771","Central Connecticut State University","2017","Tenured total","307","183","124","2","2","0","27","17","10","17","10","7","16","11","5","0","0","0","241","140","101","3","2","1","0","0","0","1","1","0","-2"
"128771","Central Connecticut State University","2017","Tenured, professors","194","119","75","2","2","0","17","10","7","13","8","5","13","10","3","0","0","0","147","88","59","2","1","1","0","0","0","0","0","0","-2"
"128771","Central Connecticut State University","2017","Tenured, associate professors","102","58","44","0","0","0","10","7","3","4","2","2","2","1","1","0","0","0","84","46","38","1","1","0","0","0","0","1","1","0","-2"
"128771","Central Connecticut State University","2017","Tenured, assistant professors","11","6","5","0","0","0","0","0","0","0","0","0","1","0","1","0","0","0","10","6","4","0","0","0","0","0","0","0","0","0","-2"
"128771","Central Connecticut State University","2017","On-Tenure track total","104","52","52","0","0","0","13","10","3","4","1","3","6","2","4","0","0","0","65","30","35","1","1","0","0","0","0","15","8","7","-2"
"128771","Central Connecticut State University","2017","On-tenure track, professors","1","1","0","0","0","0","0","0","0","0","0","0","0","0","0","0","0","0","1","1","0","0","0","0","0","0","0","0","0","0","-2"
"128771","Central Connecticut State University","2017","On-tenure track, associate professors","24","13","11","0","0","0","5","4","1","0","0","0","0","0","0","0","0","0","16","7","9","0","0","0","0","0","0","3","2","1","-2"
"128771","Central Connecticut State University","2017","On-tenure track, assistant professors","78","37","41","0","0","0","8","6","2","4","1","3","6","2","4","0","0","0","47","21","26","1","1","0","0","0","0","12","6","6","-2"
"128771","Central Connecticut State University","2017","On-tenure track, instructors","1","1","0","0","0","0","0","0","0","0","0","0","0","0","0","0","0","0","1","1","0","0","0","0","0","0","0","0","0","0","-2"
"128771","Central Connecticut State University","2017","Not on tenure track/No tenure system system total","37","17","20","0","0","0","2","1","1","2","1","1","6","2","4","0","0","0","25","12","13","0","0","0","1","1","0","1","0","1","-2"
"128771","Central Connecticut State University","2017","Not on tenure/no tenure system, associate professors","6","5","1","0","0","0","0","0","0","1","1","0","1","1","0","0","0","0","2","2","0","0","0","0","1","1","0","1","0","1","-2"
"128771","Central Connecticut State University","2017","Not on tenure/no tenure system, assistant professors","24","11","13","0","0","0","1","1","0","1","0","1","5","1","4","0","0","0","17","9","8","0","0","0","0","0","0","0","0","0","-2"
"128771","Central Connecticut State University","2017","Not on tenure/no tenure system, instructors","7","1","6","0","0","0","1","0","1","0","0","0","0","0","0","0","0","0","6","1","5","0","0","0","0","0","0","0","0","0","-2"
"129154","Goodwin University","2017","Not on tenure track/No tenure system system total","88","21","67","1","0","1","1","0","1","10","1","9","1","0","1","0","0","0","75","20","55","0","0","0","0","0","0","0","0","0","-2"
"129154","Goodwin University","2017","Not on tenure/no tenure system, associate professors","24","5","19","1","0","1","1","0","1","0","0","0","0","0","0","0","0","0","22","5","17","0","0","0","0","0","0","0","0","0","-2"
"129154","Goodwin University","2017","Not on tenure/no tenure system, assistant professors","49","13","36","0","0","0","0","0","0","10","1","9","0","0","0","0","0","0","39","12","27","0","0","0","0","0","0","0","0","0","-2"
"129154","Goodwin University","2017","Not on tenure/no tenure system, instructors","15","3","12","0","0","0","0","0","0","0","0","0","1","0","1","0","0","0","14","3","11","0","0","0","0","0","0","0","0","0","-2"
"129774","Mitchell College","2017","Tenured total","3","2","1","0","0","0","0","0","0","0","0","0","0","0","0","0","0","0","3","2","1","0","0","0","0","0","0","0","0","0","-2"
"129774","Mitchell College","2017","Tenured, associate professors","2","1","1","0","0","0","0","0","0","0","0","0","0","0","0","0","0","0","2","1","1","0","0","0","0","0","0","0","0","0","-2"
"129774","Mitchell College","2017","Tenured, assistant professors","1","1","0","0","0","0","0","0","0","0","0","0","0","0","0","0","0","0","1","1","0","0","0","0","0","0","0","0","0","0","-2"
"129774","Mitchell College","2017","Not on tenure track/No tenure system system total","18","8","10","0","0","0","0","0","0","0","0","0","0","0","0","0","0","0","18","8","10","0","0","0","0","0","0","0","0","0","-2"
"129774","Mitchell College","2017","Not on tenure/no tenure system, professors","1","0","1","0","0","0","0","0","0","0","0","0","0","0","0","0","0","0","1","0","1","0","0","0","0","0","0","0","0","0","-2"
"129774","Mitchell College","2017","Not on tenure/no tenure system, associate professors","9","3","6","0","0","0","0","0","0","0","0","0","0","0","0","0","0","0","9","3","6","0","0","0","0","0","0","0","0","0","-2"
"129774","Mitchell College","2017","Not on tenure/no tenure system, assistant professors","8","5","3","0","0","0","0","0","0","0","0","0","0","0","0","0","0","0","8","5","3","0","0","0","0","0","0","0","0","0","-2"
"132657","Lynn University","2017","Not on tenure track/No tenure system system total","131","78","53","1","1","0","3","3","0","2","1","1","8","5","3","0","0","0","83","48","35","3","0","3","28","19","9","3","1","2","-2"
"132657","Lynn University","2017","Not on tenure/no tenure system, professors","28","18","10","0","0","0","1","1","0","0","0","0","2","1","1","0","0","0","21","14","7","1","0","1","3","2","1","0","0","0","-2"
"132657","Lynn University","2017","Not on tenure/no tenure system, associate professors","29","16","13","0","0","0","0","0","0","1","1","0","0","0","0","0","0","0","25","14","11","1","0","1","1","0","1","1","1","0","-2"
"132657","Lynn University","2017","Not on tenure/no tenure system, assistant professors","47","23","24","1","1","0","2","2","0","0","0","0","2","0","2","0","0","0","31","16","15","1","0","1","9","4","5","1","0","1","-2"
"132657","Lynn University","2017","Not on tenure/no tenure system, instructors","21","17","4","0","0","0","0","0","0","0","0","0","3","3","0","0","0","0","5","3","2","0","0","0","12","11","1","1","0","1","-2"
"132657","Lynn University","2017","Not on tenure/no tenure system, no academic rank","6","4","2","0","0","0","0","0","0","1","0","1","1","1","0","0","0","0","1","1","0","0","0","0","3","2","1","0","0","0","-2"
"132693","Eastern Florida State College","2017","Tenured total","195","77","118","0","0","0","10","6","4","16","7","9","2","0","2","0","0","0","163","61","102","4","3","1","0","0","0","0","0","0","-2"
"132693","Eastern Florida State College","2017","Tenured, professors","47","20","27","0","0","0","5","3","2","2","1","1","2","0","2","0","0","0","35","13","22","3","3","0","0","0","0","0","0","0","-2"
"132693","Eastern Florida State College","2017","Tenured, associate professors","53","22","31","0","0","0","2","1","1","5","2","3","0","0","0","0","0","0","46","19","27","0","0","0","0","0","0","0","0","0","-2"
"132693","Eastern Florida State College","2017","Tenured, assistant professors","43","13","30","0","0","0","2","1","1","5","1","4","0","0","0","0","0","0","36","11","25","0","0","0","0","0","0","0","0","0","-2"
"132693","Eastern Florida State College","2017","Tenured, instructors","52","22","30","0","0","0","1","1","0","4","3","1","0","0","0","0","0","0","46","18","28","1","0","1","0","0","0","0","0","0","-2"
"132693","Eastern Florida State College","2017","On-Tenure track total","61","29","32","0","0","0","0","0","0","3","0","3","5","1","4","0","0","0","49","25","24","3","2","1","1","1","0","0","0","0","-2"
"132693","Eastern Florida State College","2017","On-tenure track, assistant professors","1","1","0","0","0","0","0","0","0","0","0","0","0","0","0","0","0","0","1","1","0","0","0","0","0","0","0","0","0","0","-2"
"132693","Eastern Florida State College","2017","On-tenure track, instructors","60","28","32","0","0","0","0","0","0","3","0","3","5","1","4","0","0","0","48","24","24","3","2","1","1","1","0","0","0","0","-2"
"132693","Eastern Florida State College","2017","Not on tenure track/No tenure system system total","7","2","5","0","0","0","0","0","0","1","1","0","1","0","1","0","0","0","5","1","4","0","0","0","0","0","0","0","0","0","-2"
"132693","Eastern Florida State College","2017","Not on tenure/no tenure system, instructors","7","2","5","0","0","0","0","0","0","1","1","0","1","0","1","0","0","0","5","1","4","0","0","0","0","0","0","0","0","0","-2"
"132879","Johnson University Florida","2017","Not on tenure track/No tenure system system total","10","4","6","0","0","0","1","0","1","0","0","0","0","0","0","0","0","0","9","4","5","0","0","0","0","0","0","0","0","0","-2"
"132879","Johnson University Florida","2017","Not on tenure/no tenure system, professors","6","2","4","0","0","0","1","0","1","0","0","0","0","0","0","0","0","0","5","2","3","0","0","0","0","0","0","0","0","0","-2"
"132879","Johnson University Florida","2017","Not on tenure/no tenure system, associate professors","1","0","1","0","0","0","0","0","0","0","0","0","0","0","0","0","0","0","1","0","1","0","0","0","0","0","0","0","0","0","-2"
"132879","Johnson University Florida","2017","Not on tenure/no tenure system, assistant professors","3","2","1","0","0","0","0","0","0","0","0","0","0","0","0","0","0","0","3","2","1","0","0","0","0","0","0","0","0","0","-2"
"133386","Daytona State College","2017","Tenured total","210","114","96","1","0","1","7","6","1","19","9","10","9","6","3","0","0","0","172","91","81","0","0","0","0","0","0","2","2","0","-2"
"133386","Daytona State College","2017","Tenured, professors","119","65","54","1","0","1","6","5","1","10","3","7","4","3","1","0","0","0","97","53","44","0","0","0","0","0","0","1","1","0","-2"
"133386","Daytona State College","2017","Tenured, associate professors","76","40","36","0","0","0","1","1","0","7","5","2","3","2","1","0","0","0","64","31","33","0","0","0","0","0","0","1","1","0","-2"
"133386","Daytona State College","2017","Tenured, assistant professors","14","8","6","0","0","0","0","0","0","2","1","1","2","1","1","0","0","0","10","6","4","0","0","0","0","0","0","0","0","0","-2"
"133386","Daytona State College","2017","Tenured, instructors","1","1","0","0","0","0","0","0","0","0","0","0","0","0","0","0","0","0","1","1","0","0","0","0","0","0","0","0","0","0","-2"
"133386","Daytona State College","2017","On-Tenure track total","46","17","29","0","0","0","0","0","0","3","0","3","3","0","3","0","0","0","40","17","23","0","0","0","0","0","0","0","0","0","-2"
"133386","Daytona State College","2017","On-tenure track, associate professors","10","4","6","0","0","0","0","0","0","1","0","1","0","0","0","0","0","0","9","4","5","0","0","0","0","0","0","0","0","0","-2"
"133386","Daytona State College","2017","On-tenure track, assistant professors","29","6","23","0","0","0","0","0","0","2","0","2","3","0","3","0","0","0","24","6","18","0","0","0","0","0","0","0","0","0","-2"
"133386","Daytona State College","2017","On-tenure track, instructors","7","7","0","0","0","0","0","0","0","0","0","0","0","0","0","0","0","0","7","7","0","0","0","0","0","0","0","0","0","0","-2"
"134130","University of Florida","2017","Tenured total","1524","1108","416","0","0","0","197","153","44","45","27","18","85","63","22","0","0","0","1174","847","327","17","14","3","2","2","0","4","2","2","-2"
"134130","University of Florida","2017","Tenured, professors","983","764","219","0","0","0","119","101","18","23","15","8","47","38","9","0","0","0","781","601","180","7","5","2","2","2","0","4","2","2","-2"
"134130","University of Florida","2017","Tenured, associate professors","537","341","196","0","0","0","78","52","26","22","12","10","38","25","13","0","0","0","389","243","146","10","9","1","0","0","0","0","0","0","-2"
"134130","University of Florida","2017","Tenured, assistant professors","4","3","1","0","0","0","0","0","0","0","0","0","0","0","0","0","0","0","4","3","1","0","0","0","0","0","0","0","0","0","-2"
"134130","University of Florida","2017","On-Tenure track total","486","295","191","2","0","2","68","40","28","17","5","12","38","25","13","0","0","0","289","170","119","7","4","3","4","3","1","61","48","13","-2"
"134130","University of Florida","2017","On-tenure track, professors","23","17","6","0","0","0","4","3","1","0","0","0","1","0","1","0","0","0","16","12","4","0","0","0","1","1","0","1","1","0","-2"
"134130","University of Florida","2017","On-tenure track, associate professors","67","44","23","0","0","0","14","9","5","4","1","3","7","5","2","0","0","0","39","27","12","1","1","0","0","0","0","2","1","1","-2"
"134130","University of Florida","2017","On-tenure track, assistant professors","396","234","162","2","0","2","50","28","22","13","4","9","30","20","10","0","0","0","234","131","103","6","3","3","3","2","1","58","46","12","-2"
"134130","University of Florida","2017","Not on tenure track/No tenure system system total","603","249","354","1","1","0","38","12","26","32","14","18","47","15","32","0","0","0","456","192","264","7","4","3","2","1","1","20","10","10","-2"
"134130","University of Florida","2017","Not on tenure/no tenure system, professors","25","18","7","0","0","0","2","1","1","2","1","1","1","1","0","0","0","0","20","15","5","0","0","0","0","0","0","0","0","0","-2"
"134130","University of Florida","2017","Not on tenure/no tenure system, associate professors","25","5","20","0","0","0","1","0","1","0","0","0","1","1","0","0","0","0","22","3","19","0","0","0","0","0","0","1","1","0","-2"
"134130","University of Florida","2017","Not on tenure/no tenure system, assistant professors","86","31","55","1","1","0","1","0","1","5","3","2","9","1","8","0","0","0","65","23","42","2","1","1","1","1","0","2","1","1","-2"
"134130","University of Florida","2017","Not on tenure/no tenure system, lecturers","356","150","206","0","0","0","22","5","17","21","8","13","32","11","21","0","0","0","262","116","146","4","3","1","1","0","1","14","7","7","-2"
"134130","University of Florida","2017","Not on tenure/no tenure system, no academic rank","111","45","66","0","0","0","12","6","6","4","2","2","4","1","3","0","0","0","87","35","52","1","0","1","0","0","0","3","1","2","-2"
"135188","Lake-Sumter State College","2017","Tenured total","39","15","24","1","1","0","0","0","0","3","1","2","1","1","0","0","0","0","34","12","22","0","0","0","0","0","0","0","0","0","-2"
"135188","Lake-Sumter State College","2017","Tenured, professors","1","0","1","0","0","0","0","0","0","0","0","0","0","0","0","0","0","0","1","0","1","0","0","0","0","0","0","0","0","0","-2"
"135188","Lake-Sumter State College","2017","Tenured, associate professors","6","2","4","0","0","0","0","0","0","0","0","0","0","0","0","0","0","0","6","2","4","0","0","0","0","0","0","0","0","0","-2"
"135188","Lake-Sumter State College","2017","Tenured, assistant professors","12","4","8","0","0","0","0","0","0","2","0","2","1","1","0","0","0","0","9","3","6","0","0","0","0","0","0","0","0","0","-2"
"135188","Lake-Sumter State College","2017","Tenured, instructors","20","9","11","1","1","0","0","0","0","1","1","0","0","0","0","0","0","0","18","7","11","0","0","0","0","0","0","0","0","0","-2"
"135188","Lake-Sumter State College","2017","On-Tenure track total","41","18","23","1","0","1","1","1","0","3","2","1","3","2","1","0","0","0","33","13","20","0","0","0","0","0","0","0","0","0","-2"
"135188","Lake-Sumter State College","2017","On-tenure track, instructors","37","15","22","1","0","1","1","1","0","3","2","1","3","2","1","0","0","0","29","10","19","0","0","0","0","0","0","0","0","0","-2"
"135188","Lake-Sumter State College","2017","On-tenure track, no academic rank","4","3","1","0","0","0","0","0","0","0","0","0","0","0","0","0","0","0","4","3","1","0","0","0","0","0","0","0","0","0","-2"
"135188","Lake-Sumter State College","2017","Not on tenure track/No tenure system system total","2","0","2","0","0","0","0","0","0","0","0","0","0","0","0","0","0","0","2","0","2","0","0","0","0","0","0","0","0","0","-2"
"135188","Lake-Sumter State College","2017","Not on tenure/no tenure system, instructors","2","0","2","0","0","0","0","0","0","0","0","0","0","0","0","0","0","0","2","0","2","0","0","0","0","0","0","0","0","0","-2"
"135391","State College of Florida-Manatee-Sarasota","2017","Tenured total","85","36","49","0","0","0","3","3","0","6","4","2","5","2","3","0","0","0","70","27","43","0","0","0","1","0","1","0","0","0","-2"
"135391","State College of Florida-Manatee-Sarasota","2017","Tenured, professors","42","21","21","0","0","0","3","3","0","2","1","1","2","0","2","0","0","0","35","17","18","0","0","0","0","0","0","0","0","0","-2"
"135391","State College of Florida-Manatee-Sarasota","2017","Tenured, associate professors","24","12","12","0","0","0","0","0","0","3","2","1","2","1","1","0","0","0","18","9","9","0","0","0","1","0","1","0","0","0","-2"
"135391","State College of Florida-Manatee-Sarasota","2017","Tenured, assistant professors","16","3","13","0","0","0","0","0","0","1","1","0","1","1","0","0","0","0","14","1","13","0","0","0","0","0","0","0","0","0","-2"
"135391","State College of Florida-Manatee-Sarasota","2017","Tenured, instructors","3","0","3","0","0","0","0","0","0","0","0","0","0","0","0","0","0","0","3","0","3","0","0","0","0","0","0","0","0","0","-2"
"135391","State College of Florida-Manatee-Sarasota","2017","On-Tenure track total","29","12","17","0","0","0","0","0","0","0","0","0","2","2","0","0","0","0","26","10","16","0","0","0","1","0","1","0","0","0","-2"
"135391","State College of Florida-Manatee-Sarasota","2017","On-tenure track, assistant professors","20","7","13","0","0","0","0","0","0","0","0","0","1","1","0","0","0","0","18","6","12","0","0","0","1","0","1","0","0","0","-2"
"135391","State College of Florida-Manatee-Sarasota","2017","On-tenure track, instructors","9","5","4","0","0","0","0","0","0","0","0","0","1","1","0","0","0","0","8","4","4","0","0","0","0","0","0","0","0","0","-2"
"135391","State College of Florida-Manatee-Sarasota","2017","Not on tenure track/No tenure system system total","14","6","8","0","0","0","1","0","1","0","0","0","0","0","0","0","0","0","13","6","7","0","0","0","0","0","0","0","0","0","-2"
"135391","State College of Florida-Manatee-Sarasota","2017","Not on tenure/no tenure system, assistant professors","2","2","0","0","0","0","0","0","0","0","0","0","0","0","0","0","0","0","2","2","0","0","0","0","0","0","0","0","0","0","-2"
"135391","State College of Florida-Manatee-Sarasota","2017","Not on tenure/no tenure system, lecturers","5","4","1","0","0","0","1","0","1","0","0","0","0","0","0","0","0","0","4","4","0","0","0","0","0","0","0","0","0","0","-2"
"135391","State College of Florida-Manatee-Sarasota","2017","Not on tenure/no tenure system, no academic rank","7","0","7","0","0","0","0","0","0","0","0","0","0","0","0","0","0","0","7","0","7","0","0","0","0","0","0","0","0","0","-2"
"136330","Palm Beach Atlantic University","2017","Not on tenure track/No tenure system system total","171","94","77","0","0","0","4","1","3","10","3","7","10","6","4","0","0","0","137","82","55","1","0","1","2","0","2","7","2","5","-2"
"136330","Palm Beach Atlantic University","2017","Not on tenure/no tenure system, professors","53","38","15","0","0","0","1","1","0","1","1","0","1","0","1","0","0","0","50","36","14","0","0","0","0","0","0","0","0","0","-2"
"136330","Palm Beach Atlantic University","2017","Not on tenure/no tenure system, associate professors","57","29","28","0","0","0","3","0","3","4","1","3","5","4","1","0","0","0","40","22","18","1","0","1","1","0","1","3","2","1","-2"
"136330","Palm Beach Atlantic University","2017","Not on tenure/no tenure system, assistant professors","56","27","29","0","0","0","0","0","0","5","1","4","3","2","1","0","0","0","43","24","19","0","0","0","1","0","1","4","0","4","-2"
"136330","Palm Beach Atlantic University","2017","Not on tenure/no tenure system, instructors","5","0","5","0","0","0","0","0","0","0","0","0","1","0","1","0","0","0","4","0","4","0","0","0","0","0","0","0","0","0","-2"
"136400","Pasco-Hernando State College","2017","Tenured total","89","31","58","0","0","0","0","0","0","6","3","3","5","4","1","1","0","1","77","24","53","0","0","0","0","0","0","0","0","0","-2"
"136400","Pasco-Hernando State College","2017","Tenured, professors","29","10","19","0","0","0","0","0","0","0","0","0","1","1","0","0","0","0","28","9","19","0","0","0","0","0","0","0","0","0","-2"
"136400","Pasco-Hernando State College","2017","Tenured, associate professors","32","9","23","0","0","0","0","0","0","5","2","3","2","1","1","1","0","1","24","6","18","0","0","0","0","0","0","0","0","0","-2"
"136400","Pasco-Hernando State College","2017","Tenured, assistant professors","26","11","15","0","0","0","0","0","0","1","1","0","2","2","0","0","0","0","23","8","15","0","0","0","0","0","0","0","0","0","-2"
"136400","Pasco-Hernando State College","2017","Tenured, instructors","2","1","1","0","0","0","0","0","0","0","0","0","0","0","0","0","0","0","2","1","1","0","0","0","0","0","0","0","0","0","-2"
"136400","Pasco-Hernando State College","2017","On-Tenure track total","56","17","39","0","0","0","1","0","1","5","2","3","3","1","2","0","0","0","45","14","31","2","0","2","0","0","0","0","0","0","-2"
"136400","Pasco-Hernando State College","2017","On-tenure track, professors","7","4","3","0","0","0","0","0","0","1","0","1","0","0","0","0","0","0","6","4","2","0","0","0","0","0","0","0","0","0","-2"
"136400","Pasco-Hernando State College","2017","On-tenure track, associate professors","3","2","1","0","0","0","0","0","0","1","1","0","0","0","0","0","0","0","2","1","1","0","0","0","0","0","0","0","0","0","-2"
"136400","Pasco-Hernando State College","2017","On-tenure track, assistant professors","12","3","9","0","0","0","1","0","1","0","0","0","2","1","1","0","0","0","8","2","6","1","0","1","0","0","0","0","0","0","-2"
"136400","Pasco-Hernando State College","2017","On-tenure track, instructors","34","8","26","0","0","0","0","0","0","3","1","2","1","0","1","0","0","0","29","7","22","1","0","1","0","0","0","0","0","0","-2"
"136400","Pasco-Hernando State College","2017","Not on tenure track/No tenure system system total","8","6","2","0","0","0","0","0","0","1","1","0","0","0","0","0","0","0","7","5","2","0","0","0","0","0","0","0","0","0","-2"
"136400","Pasco-Hernando State College","2017","Not on tenure/no tenure system, instructors","1","0","1","0","0","0","0","0","0","0","0","0","0","0","0","0","0","0","1","0","1","0","0","0","0","0","0","0","0","0","-2"
"136400","Pasco-Hernando State College","2017","Not on tenure/no tenure system, no academic rank","7","6","1","0","0","0","0","0","0","1","1","0","0","0","0","0","0","0","6","5","1","0","0","0","0","0","0","0","0","0","-2"
"136774","Ringling College of Art and Design","2017","Not on tenure track/No tenure system system total","112","76","36","0","0","0","1","1","0","1","1","0","2","1","1","0","0","0","104","73","31","0","0","0","3","0","3","1","0","1","-2"
"136774","Ringling College of Art and Design","2017","Not on tenure/no tenure system, no academic rank","112","76","36","0","0","0","1","1","0","1","1","0","2","1","1","0","0","0","104","73","31","0","0","0","3","0","3","1","0","1","-2"
"136950","Rollins College","2017","Tenured total","112","62","50","0","0","0","5","2","3","5","5","0","7","4","3","0","0","0","94","51","43","0","0","0","1","0","1","0","0","0","-2"
"136950","Rollins College","2017","Tenured, professors","63","40","23","0","0","0","3","1","2","1","1","0","4","3","1","0","0","0","55","35","20","0","0","0","0","0","0","0","0","0","-2"
"136950","Rollins College","2017","Tenured, associate professors","49","22","27","0","0","0","2","1","1","4","4","0","3","1","2","0","0","0","39","16","23","0","0","0","1","0","1","0","0","0","-2"
"136950","Rollins College","2017","On-Tenure track total","67","31","36","0","0","0","2","0","2","5","2","3","1","0","1","0","0","0","50","24","26","0","0","0","4","3","1","5","2","3","-2"
"136950","Rollins College","2017","On-tenure track, professors","1","0","1","0","0","0","0","0","0","0","0","0","0","0","0","0","0","0","1","0","1","0","0","0","0","0","0","0","0","0","-2"
"136950","Rollins College","2017","On-tenure track, associate professors","16","7","9","0","0","0","0","0","0","2","1","1","0","0","0","0","0","0","12","4","8","0","0","0","2","2","0","0","0","0","-2"
"136950","Rollins College","2017","On-tenure track, assistant professors","50","24","26","0","0","0","2","0","2","3","1","2","1","0","1","0","0","0","37","20","17","0","0","0","2","1","1","5","2","3","-2"
"136950","Rollins College","2017","Not on tenure track/No tenure system system total","53","23","30","0","0","0","1","1","0","0","0","0","3","1","2","0","0","0","48","20","28","0","0","0","0","0","0","1","1","0","-2"
"136950","Rollins College","2017","Not on tenure/no tenure system, assistant professors","13","7","6","0","0","0","0","0","0","0","0","0","0","0","0","0","0","0","13","7","6","0","0","0","0","0","0","0","0","0","-2"
"136950","Rollins College","2017","Not on tenure/no tenure system, lecturers","40","16","24","0","0","0","1","1","0","0","0","0","3","1","2","0","0","0","35","13","22","0","0","0","0","0","0","1","1","0","-2"
"137032","Saint Leo University","2017","Tenured total","64","40","24","1","0","1","2","2","0","6","3","3","2","1","1","0","0","0","53","34","19","0","0","0","0","0","0","0","0","0","-2"
"137032","Saint Leo University","2017","Tenured, professors","25","17","8","1","0","1","0","0","0","1","1","0","1","1","0","0","0","0","22","15","7","0","0","0","0","0","0","0","0","0","-2"
"137032","Saint Leo University","2017","Tenured, associate professors","32","19","13","0","0","0","2","2","0","4","1","3","1","0","1","0","0","0","25","16","9","0","0","0","0","0","0","0","0","0","-2"
"137032","Saint Leo University","2017","Tenured, assistant professors","7","4","3","0","0","0","0","0","0","1","1","0","0","0","0","0","0","0","6","3","3","0","0","0","0","0","0","0","0","0","-2"
"137032","Saint Leo University","2017","On-Tenure track total","47","26","21","0","0","0","2","2","0","4","2","2","1","0","1","0","0","0","38","20","18","0","0","0","2","2","0","0","0","0","-2"
"137032","Saint Leo University","2017","On-tenure track, professors","2","0","2","0","0","0","0","0","0","0","0","0","0","0","0","0","0","0","2","0","2","0","0","0","0","0","0","0","0","0","-2"
"137032","Saint Leo University","2017","On-tenure track, associate professors","16","11","5","0","0","0","0","0","0","2","1","1","1","0","1","0","0","0","12","9","3","0","0","0","1","1","0","0","0","0","-2"
"137032","Saint Leo University","2017","On-tenure track, assistant professors","29","15","14","0","0","0","2","2","0","2","1","1","0","0","0","0","0","0","24","11","13","0","0","0","1","1","0","0","0","0","-2"
"137032","Saint Leo University","2017","Not on tenure track/No tenure system system total","75","34","41","0","0","0","3","2","1","20","6","14","4","2","2","0","0","0","44","21","23","0","0","0","4","3","1","0","0","0","-2"
"137032","Saint Leo University","2017","Not on tenure/no tenure system, professors","3","2","1","0","0","0","0","0","0","0","0","0","0","0","0","0","0","0","3","2","1","0","0","0","0","0","0","0","0","0","-2"
"137032","Saint Leo University","2017","Not on tenure/no tenure system, associate professors","6","2","4","0","0","0","0","0","0","2","0","2","0","0","0","0","0","0","3","1","2","0","0","0","1","1","0","0","0","0","-2"
"137032","Saint Leo University","2017","Not on tenure/no tenure system, assistant professors","36","22","14","0","0","0","3","2","1","13","6","7","1","1","0","0","0","0","16","11","5","0","0","0","3","2","1","0","0","0","-2"
"137032","Saint Leo University","2017","Not on tenure/no tenure system, instructors","30","8","22","0","0","0","0","0","0","5","0","5","3","1","2","0","0","0","22","7","15","0","0","0","0","0","0","0","0","0","-2"
"137078","St Petersburg College","2017","Tenured total","273","128","145","0","0","0","7","5","2","24","13","11","15","4","11","0","0","0","219","103","116","7","3","4","1","0","1","0","0","0","-2"
"137078","St Petersburg College","2017","Tenured, no academic rank","273","128","145","0","0","0","7","5","2","24","13","11","15","4","11","0","0","0","219","103","116","7","3","4","1","0","1","0","0","0","-2"
"137078","St Petersburg College","2017","On-Tenure track total","94","30","64","0","0","0","3","2","1","12","3","9","5","2","3","0","0","0","74","23","51","0","0","0","0","0","0","0","0","0","-2"
"137078","St Petersburg College","2017","On-tenure track, no academic rank","94","30","64","0","0","0","3","2","1","12","3","9","5","2","3","0","0","0","74","23","51","0","0","0","0","0","0","0","0","0","-2"
"137096","Santa Fe College","2017","Tenured total","149","66","83","0","0","0","4","3","1","9","4","5","11","3","8","0","0","0","122","53","69","1","1","0","2","2","0","0","0","0","-2"
"137096","Santa Fe College","2017","Tenured, no academic rank","149","66","83","0","0","0","4","3","1","9","4","5","11","3","8","0","0","0","122","53","69","1","1","0","2","2","0","0","0","0","-2"
"137096","Santa Fe College","2017","On-Tenure track total","93","39","54","0","0","0","2","1","1","7","3","4","2","1","1","0","0","0","75","32","43","2","0","2","5","2","3","0","0","0","-2"
"137096","Santa Fe College","2017","On-tenure track, no academic rank","93","39","54","0","0","0","2","1","1","7","3","4","2","1","1","0","0","0","75","32","43","2","0","2","5","2","3","0","0","0","-2"
"137546","Stetson University","2017","Tenured total","153","91","62","0","0","0","4","1","3","8","3","5","6","3","3","0","0","0","125","76","49","5","4","1","2","1","1","3","3","0","-2"
"137546","Stetson University","2017","Tenured, professors","104","61","43","0","0","0","3","1","2","5","2","3","3","1","2","0","0","0","88","53","35","3","3","0","1","0","1","1","1","0","-2"
"137546","Stetson University","2017","Tenured, associate professors","49","30","19","0","0","0","1","0","1","3","1","2","3","2","1","0","0","0","37","23","14","2","1","1","1","1","0","2","2","0","-2"
"137546","Stetson University","2017","On-Tenure track total","66","29","37","0","0","0","4","2","2","3","1","2","4","2","2","0","0","0","48","21","27","2","0","2","1","1","0","4","2","2","-2"
"137546","Stetson University","2017","On-tenure track, professors","1","1","0","0","0","0","1","1","0","0","0","0","0","0","0","0","0","0","0","0","0","0","0","0","0","0","0","0","0","0","-2"
"137546","Stetson University","2017","On-tenure track, associate professors","4","2","2","0","0","0","1","1","0","0","0","0","0","0","0","0","0","0","3","1","2","0","0","0","0","0","0","0","0","0","-2"
"137546","Stetson University","2017","On-tenure track, assistant professors","60","25","35","0","0","0","2","0","2","3","1","2","4","2","2","0","0","0","44","19","25","2","0","2","1","1","0","4","2","2","-2"
"137546","Stetson University","2017","On-tenure track, no academic rank","1","1","0","0","0","0","0","0","0","0","0","0","0","0","0","0","0","0","1","1","0","0","0","0","0","0","0","0","0","0","-2"
"137546","Stetson University","2017","Not on tenure track/No tenure system system total","49","20","29","1","0","1","1","1","0","0","0","0","8","2","6","0","0","0","33","13","20","1","0","1","2","2","0","3","2","1","-2"
"137546","Stetson University","2017","Not on tenure/no tenure system, instructors","8","4","4","0","0","0","0","0","0","0","0","0","1","0","1","0","0","0","3","1","2","1","0","1","1","1","0","2","2","0","-2"
"137546","Stetson University","2017","Not on tenure/no tenure system, no academic rank","41","16","25","1","0","1","1","1","0","0","0","0","7","2","5","0","0","0","30","12","18","0","0","0","1","1","0","1","0","1","-2"
"137564","Southeastern University","2017","Not on tenure track/No tenure system system total","160","93","67","0","0","0","6","3","3","12","10","2","8","3","5","0","0","0","131","75","56","3","2","1","0","0","0","0","0","0","-2"
"137564","Southeastern University","2017","Not on tenure/no tenure system, professors","48","36","12","0","0","0","2","0","2","2","2","0","2","1","1","0","0","0","41","32","9","1","1","0","0","0","0","0","0","0","-2"
"137564","Southeastern University","2017","Not on tenure/no tenure system, associate professors","42","27","15","0","0","0","2","1","1","4","4","0","1","0","1","0","0","0","35","22","13","0","0","0","0","0","0","0","0","0","-2"
"137564","Southeastern University","2017","Not on tenure/no tenure system, assistant professors","53","24","29","0","0","0","1","1","0","6","4","2","5","2","3","0","0","0","39","16","23","2","1","1","0","0","0","0","0","0","-2"
"137564","Southeastern University","2017","Not on tenure/no tenure system, instructors","8","2","6","0","0","0","0","0","0","0","0","0","0","0","0","0","0","0","8","2","6","0","0","0","0","0","0","0","0","0","-2"
"137564","Southeastern University","2017","Not on tenure/no tenure system, lecturers","9","4","5","0","0","0","1","1","0","0","0","0","0","0","0","0","0","0","8","3","5","0","0","0","0","0","0","0","0","0","-2"
"137962","Trinity College of Florida","2017","Not on tenure track/No tenure system system total","9","5","4","0","0","0","0","0","0","0","0","0","0","0","0","0","0","0","9","5","4","0","0","0","0","0","0","0","0","0","-2"
"137962","Trinity College of Florida","2017","Not on tenure/no tenure system, professors","9","5","4","0","0","0","0","0","0","0","0","0","0","0","0","0","0","0","9","5","4","0","0","0","0","0","0","0","0","0","-2"
"139700","Georgia Highlands College","2017","Tenured total","67","35","32","0","0","0","1","1","0","3","2","1","0","0","0","0","0","0","63","32","31","0","0","0","0","0","0","0","0","0","-2"
"139700","Georgia Highlands College","2017","Tenured, professors","25","16","9","0","0","0","0","0","0","1","0","1","0","0","0","0","0","0","24","16","8","0","0","0","0","0","0","0","0","0","-2"
"139700","Georgia Highlands College","2017","Tenured, associate professors","34","15","19","0","0","0","0","0","0","2","2","0","0","0","0","0","0","0","32","13","19","0","0","0","0","0","0","0","0","0","-2"
"139700","Georgia Highlands College","2017","Tenured, assistant professors","8","4","4","0","0","0","1","1","0","0","0","0","0","0","0","0","0","0","7","3","4","0","0","0","0","0","0","0","0","0","-2"
"139700","Georgia Highlands College","2017","On-Tenure track total","33","10","23","0","0","0","1","1","0","5","0","5","0","0","0","0","0","0","27","9","18","0","0","0","0","0","0","0","0","0","-2"
"139700","Georgia Highlands College","2017","On-tenure track, associate professors","2","1","1","0","0","0","0","0","0","0","0","0","0","0","0","0","0","0","2","1","1","0","0","0","0","0","0","0","0","0","-2"
"139700","Georgia Highlands College","2017","On-tenure track, assistant professors","31","9","22","0","0","0","1","1","0","5","0","5","0","0","0","0","0","0","25","8","17","0","0","0","0","0","0","0","0","0","-2"
"139700","Georgia Highlands College","2017","Not on tenure track/No tenure system system total","29","10","19","1","1","0","4","3","1","4","1","3","0","0","0","0","0","0","19","5","14","0","0","0","1","0","1","0","0","0","-2"
"139700","Georgia Highlands College","2017","Not on tenure/no tenure system, instructors","29","10","19","1","1","0","4","3","1","4","1","3","0","0","0","0","0","0","19","5","14","0","0","0","1","0","1","0","0","0","-2"
"140252","Life University","2017","Not on tenure track/No tenure system system total","126","72","54","0","0","0","8","3","5","18","6","12","4","2","2","0","0","0","95","61","34","1","0","1","0","0","0","0","0","0","-2"
"140252","Life University","2017","Not on tenure/no tenure system, professors","22","16","6","0","0","0","2","1","1","1","1","0","0","0","0","0","0","0","19","14","5","0","0","0","0","0","0","0","0","0","-2"
"140252","Life University","2017","Not on tenure/no tenure system, associate professors","32","20","12","0","0","0","3","1","2","4","0","4","1","1","0","0","0","0","24","18","6","0","0","0","0","0","0","0","0","0","-2"
"140252","Life University","2017","Not on tenure/no tenure system, assistant professors","70","35","35","0","0","0","3","1","2","13","5","8","3","1","2","0","0","0","50","28","22","1","0","1","0","0","0","0","0","0","-2"
"140252","Life University","2017","Not on tenure/no tenure system, instructors","2","1","1","0","0","0","0","0","0","0","0","0","0","0","0","0","0","0","2","1","1","0","0","0","0","0","0","0","0","0","-2"
"141565","University of Hawaii at Hilo","2017","Tenured total","136","82","54","1","1","0","39","23","16","1","1","0","4","4","0","11","4","7","77","47","30","0","0","0","0","0","0","3","2","1","-2"
"141565","University of Hawaii at Hilo","2017","Tenured, professors","67","41","26","1","1","0","19","13","6","1","1","0","1","1","0","1","1","0","44","24","20","0","0","0","0","0","0","0","0","0","-2"
"141565","University of Hawaii at Hilo","2017","Tenured, associate professors","69","41","28","0","0","0","20","10","10","0","0","0","3","3","0","10","3","7","33","23","10","0","0","0","0","0","0","3","2","1","-2"
"141565","University of Hawaii at Hilo","2017","On-Tenure track total","43","21","22","0","0","0","12","7","5","0","0","0","0","0","0","2","0","2","20","10","10","5","2","3","0","0","0","4","2","2","-2"
"141565","University of Hawaii at Hilo","2017","On-tenure track, associate professors","5","4","1","0","0","0","2","2","0","0","0","0","0","0","0","0","0","0","3","2","1","0","0","0","0","0","0","0","0","0","-2"
"141565","University of Hawaii at Hilo","2017","On-tenure track, assistant professors","38","17","21","0","0","0","10","5","5","0","0","0","0","0","0","2","0","2","17","8","9","5","2","3","0","0","0","4","2","2","-2"
"141565","University of Hawaii at Hilo","2017","Not on tenure track/No tenure system system total","40","13","27","0","0","0","3","0","3","1","0","1","1","0","1","2","0","2","30","12","18","2","1","1","0","0","0","1","0","1","-2"
"141565","University of Hawaii at Hilo","2017","Not on tenure/no tenure system, assistant professors","5","3","2","0","0","0","0","0","0","1","0","1","0","0","0","0","0","0","4","3","1","0","0","0","0","0","0","0","0","0","-2"
"141565","University of Hawaii at Hilo","2017","Not on tenure/no tenure system, instructors","35","10","25","0","0","0","3","0","3","0","0","0","1","0","1","2","0","2","26","9","17","2","1","1","0","0","0","1","0","1","-2"
"141839","University of Hawaii Maui College","2017","Tenured total","52","21","31","0","0","0","10","3","7","1","1","0","0","0","0","5","4","1","33","11","22","1","0","1","0","0","0","2","2","0","-2"
"141839","University of Hawaii Maui College","2017","Tenured, professors","11","3","8","0","0","0","1","0","1","1","1","0","0","0","0","1","1","0","8","1","7","0","0","0","0","0","0","0","0","0","-2"
"141839","University of Hawaii Maui College","2017","Tenured, associate professors","21","5","16","0","0","0","5","1","4","0","0","0","0","0","0","3","2","1","12","1","11","0","0","0","0","0","0","1","1","0","-2"
"141839","University of Hawaii Maui College","2017","Tenured, assistant professors","20","13","7","0","0","0","4","2","2","0","0","0","0","0","0","1","1","0","13","9","4","1","0","1","0","0","0","1","1","0","-2"
"141839","University of Hawaii Maui College","2017","On-Tenure track total","28","15","13","0","0","0","5","2","3","0","0","0","0","0","0","2","1","1","17","9","8","3","2","1","0","0","0","1","1","0","-2"
"141839","University of Hawaii Maui College","2017","On-tenure track, instructors","28","15","13","0","0","0","5","2","3","0","0","0","0","0","0","2","1","1","17","9","8","3","2","1","0","0","0","1","1","0","-2"
"141839","University of Hawaii Maui College","2017","Not on tenure track/No tenure system system total","1","0","1","0","0","0","0","0","0","0","0","0","0","0","0","0","0","0","1","0","1","0","0","0","0","0","0","0","0","0","-2"
"141839","University of Hawaii Maui College","2017","Not on tenure/no tenure system, instructors","1","0","1","0","0","0","0","0","0","0","0","0","0","0","0","0","0","0","1","0","1","0","0","0","0","0","0","0","0","0","-2"
"142559","College of Southern Idaho","2017","Not on tenure track/No tenure system system total","143","67","76","0","0","0","3","0","3","0","0","0","4","1","3","0","0","0","128","61","67","1","1","0","7","4","3","0","0","0","-2"
"142559","College of Southern Idaho","2017","Not on tenure/no tenure system, professors","57","24","33","0","0","0","0","0","0","0","0","0","4","1","3","0","0","0","52","23","29","0","0","0","1","0","1","0","0","0","-2"
"142559","College of Southern Idaho","2017","Not on tenure/no tenure system, associate professors","24","10","14","0","0","0","0","0","0","0","0","0","0","0","0","0","0","0","21","9","12","0","0","0","3","1","2","0","0","0","-2"
"142559","College of Southern Idaho","2017","Not on tenure/no tenure system, assistant professors","30","14","16","0","0","0","1","0","1","0","0","0","0","0","0","0","0","0","27","12","15","0","0","0","2","2","0","0","0","0","-2"
"142559","College of Southern Idaho","2017","Not on tenure/no tenure system, instructors","32","19","13","0","0","0","2","0","2","0","0","0","0","0","0","0","0","0","28","17","11","1","1","0","1","1","0","0","0","0","-2"
"144281","Columbia College Chicago","2017","Tenured total","185","104","81","0","0","0","4","2","2","16","4","12","8","5","3","0","0","0","149","90","59","2","1","1","6","2","4","0","0","0","-2"
"144281","Columbia College Chicago","2017","Tenured, professors","31","20","11","0","0","0","1","0","1","4","2","2","1","1","0","0","0","0","24","16","8","0","0","0","1","1","0","0","0","0","-2"
"144281","Columbia College Chicago","2017","Tenured, associate professors","154","84","70","0","0","0","3","2","1","12","2","10","7","4","3","0","0","0","125","74","51","2","1","1","5","1","4","0","0","0","-2"
"144281","Columbia College Chicago","2017","On-Tenure track total","22","6","16","0","0","0","2","0","2","2","1","1","0","0","0","0","0","0","12","2","10","0","0","0","6","3","3","0","0","0","-2"
"144281","Columbia College Chicago","2017","On-tenure track, assistant professors","22","6","16","0","0","0","2","0","2","2","1","1","0","0","0","0","0","0","12","2","10","0","0","0","6","3","3","0","0","0","-2"
"144281","Columbia College Chicago","2017","Not on tenure track/No tenure system system total","65","36","29","0","0","0","1","0","1","4","1","3","2","2","0","0","0","0","53","31","22","0","0","0","5","2","3","0","0","0","-2"
"144281","Columbia College Chicago","2017","Not on tenure/no tenure system, lecturers","65","36","29","0","0","0","1","0","1","4","1","3","2","2","0","0","0","0","53","31","22","0","0","0","5","2","3","0","0","0","-2"
"144740","DePaul University","2017","Tenured total","557","318","239","2","1","1","35","21","14","43","23","20","38","16","22","0","0","0","359","208","151","4","2","2","31","19","12","45","28","17","-2"
"144740","DePaul University","2017","Tenured, professors","200","124","76","0","0","0","11","9","2","9","4","5","13","5","8","0","0","0","144","92","52","3","2","1","11","5","6","9","7","2","-2"
"144740","DePaul University","2017","Tenured, associate professors","355","192","163","2","1","1","24","12","12","34","19","15","25","11","14","0","0","0","214","115","99","1","0","1","19","13","6","36","21","15","-2"
"144740","DePaul University","2017","Tenured, assistant professors","2","2","0","0","0","0","0","0","0","0","0","0","0","0","0","0","0","0","1","1","0","0","0","0","1","1","0","0","0","0","-2"
"144740","DePaul University","2017","On-Tenure track total","161","70","91","0","0","0","9","2","7","14","3","11","8","5","3","0","0","0","83","38","45","2","1","1","31","15","16","14","6","8","-2"
"144740","DePaul University","2017","On-tenure track, professors","1","1","0","0","0","0","0","0","0","0","0","0","0","0","0","0","0","0","1","1","0","0","0","0","0","0","0","0","0","0","-2"
"144740","DePaul University","2017","On-tenure track, associate professors","5","0","5","0","0","0","0","0","0","1","0","1","0","0","0","0","0","0","3","0","3","0","0","0","1","0","1","0","0","0","-2"
"144740","DePaul University","2017","On-tenure track, assistant professors","152","66","86","0","0","0","9","2","7","13","3","10","8","5","3","0","0","0","79","37","42","2","1","1","28","13","15","13","5","8","-2"
"144740","DePaul University","2017","On-tenure track, instructors","3","3","0","0","0","0","0","0","0","0","0","0","0","0","0","0","0","0","0","0","0","0","0","0","2","2","0","1","1","0","-2"
"144740","DePaul University","2017","Not on tenure track/No tenure system system total","199","106","93","1","1","0","7","6","1","10","3","7","6","6","0","0","0","0","142","72","70","2","2","0","22","11","11","9","5","4","-2"
"144740","DePaul University","2017","Not on tenure/no tenure system, professors","1","1","0","0","0","0","0","0","0","0","0","0","0","0","0","0","0","0","1","1","0","0","0","0","0","0","0","0","0","0","-2"
"144740","DePaul University","2017","Not on tenure/no tenure system, associate professors","2","1","1","0","0","0","0","0","0","0","0","0","0","0","0","0","0","0","1","1","0","0","0","0","1","0","1","0","0","0","-2"
"144740","DePaul University","2017","Not on tenure/no tenure system, assistant professors","22","9","13","0","0","0","2","1","1","3","0","3","1","1","0","0","0","0","14","6","8","0","0","0","2","1","1","0","0","0","-2"
"144740","DePaul University","2017","Not on tenure/no tenure system, instructors","174","95","79","1","1","0","5","5","0","7","3","4","5","5","0","0","0","0","126","64","62","2","2","0","19","10","9","9","5","4","-2"
"144883","East-West University","2017","Not on tenure track/No tenure system system total","10","4","6","0","0","0","5","1","4","0","0","0","0","0","0","0","0","0","5","3","2","0","0","0","0","0","0","0","0","0","-2"
"144883","East-West University","2017","Not on tenure/no tenure system, associate professors","5","0","5","0","0","0","3","0","3","0","0","0","0","0","0","0","0","0","2","0","2","0","0","0","0","0","0","0","0","0","-2"
"144883","East-West University","2017","Not on tenure/no tenure system, assistant professors","5","4","1","0","0","0","2","1","1","0","0","0","0","0","0","0","0","0","3","3","0","0","0","0","0","0","0","0","0","0","-2"
"144962","Elmhurst University","2017","Tenured total","90","39","51","0","0","0","5","4","1","3","1","2","3","1","2","0","0","0","79","33","46","0","0","0","0","0","0","0","0","0","-2"
"144962","Elmhurst University","2017","Tenured, professors","53","24","29","0","0","0","4","3","1","1","1","0","1","0","1","0","0","0","47","20","27","0","0","0","0","0","0","0","0","0","-2"
"144962","Elmhurst University","2017","Tenured, associate professors","35","14","21","0","0","0","1","1","0","2","0","2","2","1","1","0","0","0","30","12","18","0","0","0","0","0","0","0","0","0","-2"
"144962","Elmhurst University","2017","Tenured, assistant professors","2","1","1","0","0","0","0","0","0","0","0","0","0","0","0","0","0","0","2","1","1","0","0","0","0","0","0","0","0","0","-2"
"144962","Elmhurst University","2017","On-Tenure track total","21","6","15","0","0","0","2","0","2","0","0","0","0","0","0","0","0","0","19","6","13","0","0","0","0","0","0","0","0","0","-2"
"144962","Elmhurst University","2017","On-tenure track, assistant professors","21","6","15","0","0","0","2","0","2","0","0","0","0","0","0","0","0","0","19","6","13","0","0","0","0","0","0","0","0","0","-2"
"144962","Elmhurst University","2017","Not on tenure track/No tenure system system total","38","13","25","0","0","0","1","0","1","2","0","2","1","0","1","0","0","0","34","13","21","0","0","0","0","0","0","0","0","0","-2"
"144962","Elmhurst University","2017","Not on tenure/no tenure system, associate professors","9","2","7","0","0","0","0","0","0","2","0","2","0","0","0","0","0","0","7","2","5","0","0","0","0","0","0","0","0","0","-2"
"144962","Elmhurst University","2017","Not on tenure/no tenure system, assistant professors","17","5","12","0","0","0","1","0","1","0","0","0","0","0","0","0","0","0","16","5","11","0","0","0","0","0","0","0","0","0","-2"
"144962","Elmhurst University","2017","Not on tenure/no tenure system, instructors","5","4","1","0","0","0","0","0","0","0","0","0","0","0","0","0","0","0","5","4","1","0","0","0","0","0","0","0","0","0","-2"
"144962","Elmhurst University","2017","Not on tenure/no tenure system, lecturers","5","1","4","0","0","0","0","0","0","0","0","0","1","0","1","0","0","0","4","1","3","0","0","0","0","0","0","0","0","0","-2"
"144962","Elmhurst University","2017","Not on tenure/no tenure system, no academic rank","2","1","1","0","0","0","0","0","0","0","0","0","0","0","0","0","0","0","2","1","1","0","0","0","0","0","0","0","0","0","-2"
"145336","Governors State University","2017","Tenured total","94","43","51","0","0","0","14","8","6","15","6","9","1","0","1","0","0","0","45","24","21","3","0","3","16","5","11","0","0","0","-2"
"145336","Governors State University","2017","Tenured, professors","32","13","19","0","0","0","5","2","3","5","1","4","0","0","0","0","0","0","14","7","7","1","0","1","7","3","4","0","0","0","-2"
"145336","Governors State University","2017","Tenured, associate professors","62","30","32","0","0","0","9","6","3","10","5","5","1","0","1","0","0","0","31","17","14","2","0","2","9","2","7","0","0","0","-2"
"145336","Governors State University","2017","On-Tenure track total","55","17","38","1","0","1","8","3","5","10","4","6","3","0","3","0","0","0","29","8","21","0","0","0","2","1","1","2","1","1","-2"
"145336","Governors State University","2017","On-tenure track, assistant professors","55","17","38","1","0","1","8","3","5","10","4","6","3","0","3","0","0","0","29","8","21","0","0","0","2","1","1","2","1","1","-2"
"145336","Governors State University","2017","Not on tenure track/No tenure system system total","81","32","49","0","0","0","5","2","3","16","6","10","0","0","0","0","0","0","46","19","27","2","1","1","12","4","8","0","0","0","-2"
"145336","Governors State University","2017","Not on tenure/no tenure system, lecturers","58","26","32","0","0","0","2","1","1","11","5","6","0","0","0","0","0","0","37","17","20","2","1","1","6","2","4","0","0","0","-2"
"145336","Governors State University","2017","Not on tenure/no tenure system, no academic rank","23","6","17","0","0","0","3","1","2","5","1","4","0","0","0","0","0","0","9","2","7","0","0","0","6","2","4","0","0","0","-2"
"145619","Benedictine University","2017","Tenured total","73","37","36","0","0","0","7","3","4","3","1","2","1","1","0","0","0","0","60","31","29","0","0","0","2","1","1","0","0","0","-2"
"145619","Benedictine University","2017","Tenured, professors","45","26","19","0","0","0","4","2","2","2","1","1","0","0","0","0","0","0","38","23","15","0","0","0","1","0","1","0","0","0","-2"
"145619","Benedictine University","2017","Tenured, associate professors","28","11","17","0","0","0","3","1","2","1","0","1","1","1","0","0","0","0","22","8","14","0","0","0","1","1","0","0","0","0","-2"
"145619","Benedictine University","2017","On-Tenure track total","44","18","26","0","0","0","4","2","2","2","0","2","2","1","1","0","0","0","36","15","21","0","0","0","0","0","0","0","0","0","-2"
"145619","Benedictine University","2017","On-tenure track, associate professors","4","2","2","0","0","0","0","0","0","0","0","0","0","0","0","0","0","0","4","2","2","0","0","0","0","0","0","0","0","0","-2"
"145619","Benedictine University","2017","On-tenure track, assistant professors","40","16","24","0","0","0","4","2","2","2","0","2","2","1","1","0","0","0","32","13","19","0","0","0","0","0","0","0","0","0","-2"
"145619","Benedictine University","2017","Not on tenure track/No tenure system system total","38","16","22","0","0","0","2","1","1","1","0","1","2","1","1","0","0","0","30","11","19","0","0","0","3","3","0","0","0","0","-2"
"145619","Benedictine University","2017","Not on tenure/no tenure system, associate professors","2","0","2","0","0","0","0","0","0","1","0","1","0","0","0","0","0","0","1","0","1","0","0","0","0","0","0","0","0","0","-2"
"145619","Benedictine University","2017","Not on tenure/no tenure system, assistant professors","23","9","14","0","0","0","2","1","1","0","0","0","2","1","1","0","0","0","18","6","12","0","0","0","1","1","0","0","0","0","-2"
"145619","Benedictine University","2017","Not on tenure/no tenure system, instructors","13","7","6","0","0","0","0","0","0","0","0","0","0","0","0","0","0","0","11","5","6","0","0","0","2","2","0","0","0","0","-2"
"145725","Illinois Institute of Technology","2017","Tenured total","210","169","41","2","1","1","46","38","8","5","3","2","5","4","1","1","1","0","127","101","26","0","0","0","6","6","0","18","15","3","-2"
"145725","Illinois Institute of Technology","2017","Tenured, professors","125","101","24","1","0","1","29","24","5","3","2","1","0","0","0","0","0","0","83","67","16","0","0","0","2","2","0","7","6","1","-2"
"145725","Illinois Institute of Technology","2017","Tenured, associate professors","85","68","17","1","1","0","17","14","3","2","1","1","5","4","1","1","1","0","44","34","10","0","0","0","4","4","0","11","9","2","-2"
"145725","Illinois Institute of Technology","2017","On-Tenure track total","56","35","21","0","0","0","12","7","5","1","0","1","2","2","0","1","0","1","22","11","11","0","0","0","10","8","2","8","7","1","-2"
"145725","Illinois Institute of Technology","2017","On-tenure track, associate professors","1","1","0","0","0","0","0","0","0","0","0","0","0","0","0","0","0","0","0","0","0","0","0","0","1","1","0","0","0","0","-2"
"145725","Illinois Institute of Technology","2017","On-tenure track, assistant professors","55","34","21","0","0","0","12","7","5","1","0","1","2","2","0","1","0","1","22","11","11","0","0","0","9","7","2","8","7","1","-2"
"145725","Illinois Institute of Technology","2017","Not on tenure track/No tenure system system total","147","97","50","0","0","0","10","5","5","1","0","1","1","0","1","0","0","0","88","61","27","0","0","0","28","19","9","19","12","7","-2"
"145725","Illinois Institute of Technology","2017","Not on tenure/no tenure system, professors","32","22","10","0","0","0","3","1","2","0","0","0","1","0","1","0","0","0","23","17","6","0","0","0","5","4","1","0","0","0","-2"
"145725","Illinois Institute of Technology","2017","Not on tenure/no tenure system, associate professors","22","16","6","0","0","0","0","0","0","0","0","0","0","0","0","0","0","0","19","14","5","0","0","0","1","0","1","2","2","0","-2"
"145725","Illinois Institute of Technology","2017","Not on tenure/no tenure system, assistant professors","33","21","12","0","0","0","2","1","1","0","0","0","0","0","0","0","0","0","7","4","3","0","0","0","16","11","5","8","5","3","-2"
"145725","Illinois Institute of Technology","2017","Not on tenure/no tenure system, instructors","10","6","4","0","0","0","0","0","0","0","0","0","0","0","0","0","0","0","9","5","4","0","0","0","0","0","0","1","1","0","-2"
"145725","Illinois Institute of Technology","2017","Not on tenure/no tenure system, lecturers","42","28","14","0","0","0","5","3","2","1","0","1","0","0","0","0","0","0","28","20","8","0","0","0","3","1","2","5","4","1","-2"
"145725","Illinois Institute of Technology","2017","Not on tenure/no tenure system, no academic rank","8","4","4","0","0","0","0","0","0","0","0","0","0","0","0","0","0","0","2","1","1","0","0","0","3","3","0","3","0","3","-2"
"146339","Judson University","2017","Tenured total","32","20","12","0","0","0","3","1","2","1","1","0","0","0","0","0","0","0","28","18","10","0","0","0","0","0","0","0","0","0","-2"
"146339","Judson University","2017","Tenured, professors","27","18","9","0","0","0","3","1","2","1","1","0","0","0","0","0","0","0","23","16","7","0","0","0","0","0","0","0","0","0","-2"
"146339","Judson University","2017","Tenured, associate professors","5","2","3","0","0","0","0","0","0","0","0","0","0","0","0","0","0","0","5","2","3","0","0","0","0","0","0","0","0","0","-2"
"146339","Judson University","2017","On-Tenure track total","5","4","1","0","0","0","0","0","0","0","0","0","0","0","0","0","0","0","5","4","1","0","0","0","0","0","0","0","0","0","-2"
"146339","Judson University","2017","On-tenure track, professors","2","2","0","0","0","0","0","0","0","0","0","0","0","0","0","0","0","0","2","2","0","0","0","0","0","0","0","0","0","0","-2"
"146339","Judson University","2017","On-tenure track, associate professors","3","2","1","0","0","0","0","0","0","0","0","0","0","0","0","0","0","0","3","2","1","0","0","0","0","0","0","0","0","0","-2"
"146339","Judson University","2017","Not on tenure track/No tenure system system total","21","5","16","0","0","0","1","0","1","2","0","2","0","0","0","0","0","0","17","5","12","0","0","0","0","0","0","1","0","1","-2"
"146339","Judson University","2017","Not on tenure/no tenure system, professors","1","0","1","0","0","0","0","0","0","1","0","1","0","0","0","0","0","0","0","0","0","0","0","0","0","0","0","0","0","0","-2"
"146339","Judson University","2017","Not on tenure/no tenure system, associate professors","8","2","6","0","0","0","1","0","1","0","0","0","0","0","0","0","0","0","7","2","5","0","0","0","0","0","0","0","0","0","-2"
"146339","Judson University","2017","Not on tenure/no tenure system, assistant professors","12","3","9","0","0","0","0","0","0","1","0","1","0","0","0","0","0","0","10","3","7","0","0","0","0","0","0","1","0","1","-2"
"146612","Lewis University","2017","Tenured total","88","49","39","0","0","0","5","4","1","4","2","2","1","0","1","0","0","0","78","43","35","0","0","0","0","0","0","0","0","0","-2"
"146612","Lewis University","2017","Tenured, professors","57","36","21","0","0","0","4","3","1","3","2","1","0","0","0","0","0","0","50","31","19","0","0","0","0","0","0","0","0","0","-2"
"146612","Lewis University","2017","Tenured, associate professors","31","13","18","0","0","0","1","1","0","1","0","1","1","0","1","0","0","0","28","12","16","0","0","0","0","0","0","0","0","0","-2"
"146612","Lewis University","2017","On-Tenure track total","42","26","16","0","0","0","6","4","2","3","3","0","3","1","2","0","0","0","29","18","11","0","0","0","0","0","0","1","0","1","-2"
"146612","Lewis University","2017","On-tenure track, associate professors","9","6","3","0","0","0","2","2","0","1","1","0","1","0","1","0","0","0","5","3","2","0","0","0","0","0","0","0","0","0","-2"
"146612","Lewis University","2017","On-tenure track, assistant professors","33","20","13","0","0","0","4","2","2","2","2","0","2","1","1","0","0","0","24","15","9","0","0","0","0","0","0","1","0","1","-2"
"146612","Lewis University","2017","Not on tenure track/No tenure system system total","95","42","53","0","0","0","3","0","3","7","2","5","1","1","0","0","0","0","84","39","45","0","0","0","0","0","0","0","0","0","-2"
"146612","Lewis University","2017","Not on tenure/no tenure system, professors","1","1","0","0","0","0","0","0","0","0","0","0","0","0","0","0","0","0","1","1","0","0","0","0","0","0","0","0","0","0","-2"
"146612","Lewis University","2017","Not on tenure/no tenure system, associate professors","19","10","9","0","0","0","1","0","1","2","0","2","0","0","0","0","0","0","16","10","6","0","0","0","0","0","0","0","0","0","-2"
"146612","Lewis University","2017","Not on tenure/no tenure system, assistant professors","61","27","34","0","0","0","2","0","2","4","2","2","1","1","0","0","0","0","54","24","30","0","0","0","0","0","0","0","0","0","-2"
"146612","Lewis University","2017","Not on tenure/no tenure system, instructors","14","4","10","0","0","0","0","0","0","1","0","1","0","0","0","0","0","0","13","4","9","0","0","0","0","0","0","0","0","0","-2"
"146719","Loyola University Chicago","2017","Tenured total","438","269","169","0","0","0","32","23","9","15","6","9","19","11","8","1","0","1","362","226","136","5","1","4","2","1","1","2","1","1","-2"
"146719","Loyola University Chicago","2017","Tenured, professors","227","157","70","0","0","0","13","11","2","2","1","1","13","10","3","1","0","1","195","134","61","2","0","2","1","1","0","0","0","0","-2"
"146719","Loyola University Chicago","2017","Tenured, associate professors","202","105","97","0","0","0","17","10","7","12","5","7","6","1","5","0","0","0","162","87","75","3","1","2","1","0","1","1","1","0","-2"
"146719","Loyola University Chicago","2017","Tenured, assistant professors","9","7","2","0","0","0","2","2","0","1","0","1","0","0","0","0","0","0","5","5","0","0","0","0","0","0","0","1","0","1","-2"
"146719","Loyola University Chicago","2017","On-Tenure track total","142","74","68","0","0","0","14","5","9","7","3","4","5","2","3","0","0","0","96","52","44","0","0","0","2","1","1","18","11","7","-2"
"146719","Loyola University Chicago","2017","On-tenure track, professors","3","1","2","0","0","0","1","0","1","0","0","0","0","0","0","0","0","0","1","0","1","0","0","0","0","0","0","1","1","0","-2"
"146719","Loyola University Chicago","2017","On-tenure track, associate professors","6","4","2","0","0","0","0","0","0","0","0","0","0","0","0","0","0","0","6","4","2","0","0","0","0","0","0","0","0","0","-2"
"146719","Loyola University Chicago","2017","On-tenure track, assistant professors","130","67","63","0","0","0","13","5","8","7","3","4","5","2","3","0","0","0","86","46","40","0","0","0","2","1","1","17","10","7","-2"
"146719","Loyola University Chicago","2017","On-tenure track, instructors","3","2","1","0","0","0","0","0","0","0","0","0","0","0","0","0","0","0","3","2","1","0","0","0","0","0","0","0","0","0","-2"
"146719","Loyola University Chicago","2017","Not on tenure track/No tenure system system total","344","145","199","0","0","0","18","7","11","24","7","17","16","9","7","1","0","1","279","120","159","2","1","1","1","0","1","3","1","2","-2"
"146719","Loyola University Chicago","2017","Not on tenure/no tenure system, instructors","344","145","199","0","0","0","18","7","11","24","7","17","16","9","7","1","0","1","279","120","159","2","1","1","1","0","1","3","1","2","-2"
"147660","North Central College","2017","Tenured total","70","44","26","0","0","0","4","2","2","2","1","1","1","1","0","0","0","0","62","40","22","0","0","0","0","0","0","1","0","1","-2"
"147660","North Central College","2017","Tenured, professors","36","24","12","0","0","0","2","1","1","1","1","0","0","0","0","0","0","0","33","22","11","0","0","0","0","0","0","0","0","0","-2"
"147660","North Central College","2017","Tenured, associate professors","34","20","14","0","0","0","2","1","1","1","0","1","1","1","0","0","0","0","29","18","11","0","0","0","0","0","0","1","0","1","-2"
"147660","North Central College","2017","On-Tenure track total","38","14","24","0","0","0","3","1","2","0","0","0","2","1","1","0","0","0","22","10","12","2","0","2","2","0","2","7","2","5","-2"
"147660","North Central College","2017","On-tenure track, professors","2","2","0","0","0","0","0","0","0","0","0","0","0","0","0","0","0","0","2","2","0","0","0","0","0","0","0","0","0","0","-2"
"147660","North Central College","2017","On-tenure track, associate professors","3","2","1","0","0","0","1","1","0","0","0","0","0","0","0","0","0","0","2","1","1","0","0","0","0","0","0","0","0","0","-2"
"147660","North Central College","2017","On-tenure track, assistant professors","33","10","23","0","0","0","2","0","2","0","0","0","2","1","1","0","0","0","18","7","11","2","0","2","2","0","2","7","2","5","-2"
"147660","North Central College","2017","Not on tenure track/No tenure system system total","43","19","24","0","0","0","0","0","0","0","0","0","2","1","1","0","0","0","37","16","21","0","0","0","1","0","1","3","2","1","-2"
"147660","North Central College","2017","Not on tenure/no tenure system, professors","5","4","1","0","0","0","0","0","0","0","0","0","0","0","0","0","0","0","5","4","1","0","0","0","0","0","0","0","0","0","-2"
"147660","North Central College","2017","Not on tenure/no tenure system, associate professors","5","2","3","0","0","0","0","0","0","0","0","0","0","0","0","0","0","0","5","2","3","0","0","0","0","0","0","0","0","0","-2"
"147660","North Central College","2017","Not on tenure/no tenure system, assistant professors","30","12","18","0","0","0","0","0","0","0","0","0","2","1","1","0","0","0","24","9","15","0","0","0","1","0","1","3","2","1","-2"
"147660","North Central College","2017","Not on tenure/no tenure system, instructors","3","1","2","0","0","0","0","0","0","0","0","0","0","0","0","0","0","0","3","1","2","0","0","0","0","0","0","0","0","0","-2"
"148405","Rockford University","2017","Tenured total","33","19","14","0","0","0","0","0","0","0","0","0","1","1","0","0","0","0","31","17","14","1","1","0","0","0","0","0","0","0","-2"
"148405","Rockford University","2017","Tenured, professors","15","8","7","0","0","0","0","0","0","0","0","0","0","0","0","0","0","0","14","7","7","1","1","0","0","0","0","0","0","0","-2"
"148405","Rockford University","2017","Tenured, associate professors","13","10","3","0","0","0","0","0","0","0","0","0","1","1","0","0","0","0","12","9","3","0","0","0","0","0","0","0","0","0","-2"
"148405","Rockford University","2017","Tenured, assistant professors","5","1","4","0","0","0","0","0","0","0","0","0","0","0","0","0","0","0","5","1","4","0","0","0","0","0","0","0","0","0","-2"
"148405","Rockford University","2017","On-Tenure track total","33","14","19","0","0","0","2","0","2","1","0","1","2","1","1","0","0","0","28","13","15","0","0","0","0","0","0","0","0","0","-2"
"148405","Rockford University","2017","On-tenure track, associate professors","9","7","2","0","0","0","1","0","1","0","0","0","1","1","0","0","0","0","7","6","1","0","0","0","0","0","0","0","0","0","-2"
"148405","Rockford University","2017","On-tenure track, assistant professors","24","7","17","0","0","0","1","0","1","1","0","1","1","0","1","0","0","0","21","7","14","0","0","0","0","0","0","0","0","0","-2"
"148405","Rockford University","2017","Not on tenure track/No tenure system system total","10","4","6","0","0","0","0","0","0","0","0","0","0","0","0","0","0","0","9","3","6","0","0","0","0","0","0","1","1","0","-2"
"148405","Rockford University","2017","Not on tenure/no tenure system, associate professors","2","1","1","0","0","0","0","0","0","0","0","0","0","0","0","0","0","0","2","1","1","0","0","0","0","0","0","0","0","0","-2"
"148405","Rockford University","2017","Not on tenure/no tenure system, assistant professors","8","3","5","0","0","0","0","0","0","0","0","0","0","0","0","0","0","0","7","2","5","0","0","0","0","0","0","1","1","0","-2"
"148584","University of St Francis","2017","Tenured total","40","17","23","0","0","0","2","0","2","2","1","1","1","0","1","0","0","0","35","16","19","0","0","0","0","0","0","0","0","0","-2"
"148584","University of St Francis","2017","Tenured, professors","19","8","11","0","0","0","1","0","1","1","0","1","0","0","0","0","0","0","17","8","9","0","0","0","0","0","0","0","0","0","-2"
"148584","University of St Francis","2017","Tenured, associate professors","19","8","11","0","0","0","1","0","1","1","1","0","0","0","0","0","0","0","17","7","10","0","0","0","0","0","0","0","0","0","-2"
"148584","University of St Francis","2017","Tenured, assistant professors","2","1","1","0","0","0","0","0","0","0","0","0","1","0","1","0","0","0","1","1","0","0","0","0","0","0","0","0","0","0","-2"
"148584","University of St Francis","2017","On-Tenure track total","29","8","21","0","0","0","0","0","0","4","0","4","1","0","1","0","0","0","22","7","15","0","0","0","0","0","0","2","1","1","-2"
"148584","University of St Francis","2017","On-tenure track, associate professors","1","0","1","0","0","0","0","0","0","0","0","0","0","0","0","0","0","0","0","0","0","0","0","0","0","0","0","1","0","1","-2"
"148584","University of St Francis","2017","On-tenure track, assistant professors","28","8","20","0","0","0","0","0","0","4","0","4","1","0","1","0","0","0","22","7","15","0","0","0","0","0","0","1","1","0","-2"
"148584","University of St Francis","2017","Not on tenure track/No tenure system system total","35","12","23","0","0","0","1","1","0","2","0","2","3","1","2","0","0","0","29","10","19","0","0","0","0","0","0","0","0","0","-2"
"148584","University of St Francis","2017","Not on tenure/no tenure system, professors","6","5","1","0","0","0","0","0","0","0","0","0","1","1","0","0","0","0","5","4","1","0","0","0","0","0","0","0","0","0","-2"
"148584","University of St Francis","2017","Not on tenure/no tenure system, assistant professors","8","0","8","0","0","0","0","0","0","2","0","2","0","0","0","0","0","0","6","0","6","0","0","0","0","0","0","0","0","0","-2"
"148584","University of St Francis","2017","Not on tenure/no tenure system, instructors","21","7","14","0","0","0","1","1","0","0","0","0","2","0","2","0","0","0","18","6","12","0","0","0","0","0","0","0","0","0","-2"
"149763","Resurrection University","2017","Not on tenure track/No tenure system system total","50","4","46","0","0","0","5","1","4","8","0","8","1","0","1","1","0","1","34","3","31","1","0","1","0","0","0","0","0","0","-2"
"149763","Resurrection University","2017","Not on tenure/no tenure system, professors","1","0","1","0","0","0","0","0","0","0","0","0","0","0","0","0","0","0","1","0","1","0","0","0","0","0","0","0","0","0","-2"
"149763","Resurrection University","2017","Not on tenure/no tenure system, associate professors","6","0","6","0","0","0","1","0","1","0","0","0","0","0","0","0","0","0","5","0","5","0","0","0","0","0","0","0","0","0","-2"
"149763","Resurrection University","2017","Not on tenure/no tenure system, assistant professors","22","1","21","0","0","0","3","0","3","4","0","4","0","0","0","1","0","1","13","1","12","1","0","1","0","0","0","0","0","0","-2"
"149763","Resurrection University","2017","Not on tenure/no tenure system, instructors","21","3","18","0","0","0","1","1","0","4","0","4","1","0","1","0","0","0","15","2","13","0","0","0","0","0","0","0","0","0","-2"
"150668","Goshen College","2017","Tenured total","31","16","15","0","0","0","0","0","0","0","0","0","0","0","0","0","0","0","30","15","15","1","1","0","0","0","0","0","0","0","-2"
"150668","Goshen College","2017","Tenured, professors","29","15","14","0","0","0","0","0","0","0","0","0","0","0","0","0","0","0","29","15","14","0","0","0","0","0","0","0","0","0","-2"
"150668","Goshen College","2017","Tenured, associate professors","2","1","1","0","0","0","0","0","0","0","0","0","0","0","0","0","0","0","1","0","1","1","1","0","0","0","0","0","0","0","-2"
"150668","Goshen College","2017","On-Tenure track total","11","8","3","0","0","0","1","1","0","0","0","0","1","1","0","0","0","0","9","6","3","0","0","0","0","0","0","0","0","0","-2"
"150668","Goshen College","2017","On-tenure track, professors","2","2","0","0","0","0","0","0","0","0","0","0","0","0","0","0","0","0","2","2","0","0","0","0","0","0","0","0","0","0","-2"
"150668","Goshen College","2017","On-tenure track, associate professors","8","5","3","0","0","0","1","1","0","0","0","0","1","1","0","0","0","0","6","3","3","0","0","0","0","0","0","0","0","0","-2"
"150668","Goshen College","2017","On-tenure track, assistant professors","1","1","0","0","0","0","0","0","0","0","0","0","0","0","0","0","0","0","1","1","0","0","0","0","0","0","0","0","0","0","-2"
"150668","Goshen College","2017","Not on tenure track/No tenure system system total","24","6","18","0","0","0","0","0","0","1","0","1","2","1","1","0","0","0","20","5","15","1","0","1","0","0","0","0","0","0","-2"
"150668","Goshen College","2017","Not on tenure/no tenure system, professors","1","0","1","0","0","0","0","0","0","0","0","0","0","0","0","0","0","0","1","0","1","0","0","0","0","0","0","0","0","0","-2"
"150668","Goshen College","2017","Not on tenure/no tenure system, associate professors","13","4","9","0","0","0","0","0","0","0","0","0","0","0","0","0","0","0","12","4","8","1","0","1","0","0","0","0","0","0","-2"
"150668","Goshen College","2017","Not on tenure/no tenure system, assistant professors","9","2","7","0","0","0","0","0","0","1","0","1","2","1","1","0","0","0","6","1","5","0","0","0","0","0","0","0","0","0","-2"
"150668","Goshen College","2017","Not on tenure/no tenure system, no academic rank","1","0","1","0","0","0","0","0","0","0","0","0","0","0","0","0","0","0","1","0","1","0","0","0","0","0","0","0","0","0","-2"
"150774","Holy Cross College","2017","Tenured total","4","3","1","0","0","0","0","0","0","0","0","0","1","1","0","0","0","0","3","2","1","0","0","0","0","0","0","0","0","0","-2"
"150774","Holy Cross College","2017","Tenured, professors","2","1","1","0","0","0","0","0","0","0","0","0","0","0","0","0","0","0","2","1","1","0","0","0","0","0","0","0","0","0","-2"
"150774","Holy Cross College","2017","Tenured, associate professors","2","2","0","0","0","0","0","0","0","0","0","0","1","1","0","0","0","0","1","1","0","0","0","0","0","0","0","0","0","0","-2"
"150774","Holy Cross College","2017","On-Tenure track total","9","4","5","0","0","0","0","0","0","1","1","0","1","1","0","0","0","0","6","2","4","1","0","1","0","0","0","0","0","0","-2"
"150774","Holy Cross College","2017","On-tenure track, associate professors","7","4","3","0","0","0","0","0","0","1","1","0","1","1","0","0","0","0","5","2","3","0","0","0","0","0","0","0","0","0","-2"
"150774","Holy Cross College","2017","On-tenure track, assistant professors","2","0","2","0","0","0","0","0","0","0","0","0","0","0","0","0","0","0","1","0","1","1","0","1","0","0","0","0","0","0","-2"
"150774","Holy Cross College","2017","Not on tenure track/No tenure system system total","3","0","3","0","0","0","0","0","0","0","0","0","0","0","0","0","0","0","2","0","2","1","0","1","0","0","0","0","0","0","-2"
"150774","Holy Cross College","2017","Not on tenure/no tenure system, assistant professors","1","0","1","0","0","0","0","0","0","0","0","0","0","0","0","0","0","0","1","0","1","0","0","0","0","0","0","0","0","0","-2"
"150774","Holy Cross College","2017","Not on tenure/no tenure system, instructors","2","0","2","0","0","0","0","0","0","0","0","0","0","0","0","0","0","0","1","0","1","1","0","1","0","0","0","0","0","0","-2"
"152637","Vincennes University","2017","Tenured total","50","26","24","0","0","0","1","1","0","2","2","0","0","0","0","0","0","0","46","23","23","0","0","0","0","0","0","1","0","1","-2"
"152637","Vincennes University","2017","Tenured, professors","29","12","17","0","0","0","1","1","0","1","1","0","0","0","0","0","0","0","27","10","17","0","0","0","0","0","0","0","0","0","-2"
"152637","Vincennes University","2017","Tenured, associate professors","19","12","7","0","0","0","0","0","0","1","1","0","0","0","0","0","0","0","17","11","6","0","0","0","0","0","0","1","0","1","-2"
"152637","Vincennes University","2017","Tenured, assistant professors","1","1","0","0","0","0","0","0","0","0","0","0","0","0","0","0","0","0","1","1","0","0","0","0","0","0","0","0","0","0","-2"
"152637","Vincennes University","2017","Tenured, instructors","1","1","0","0","0","0","0","0","0","0","0","0","0","0","0","0","0","0","1","1","0","0","0","0","0","0","0","0","0","0","-2"
"152637","Vincennes University","2017","On-Tenure track total","17","8","9","1","0","1","0","0","0","0","0","0","0","0","0","0","0","0","16","8","8","0","0","0","0","0","0","0","0","0","-2"
"152637","Vincennes University","2017","On-tenure track, professors","1","0","1","0","0","0","0","0","0","0","0","0","0","0","0","0","0","0","1","0","1","0","0","0","0","0","0","0","0","0","-2"
"152637","Vincennes University","2017","On-tenure track, associate professors","11","4","7","1","0","1","0","0","0","0","0","0","0","0","0","0","0","0","10","4","6","0","0","0","0","0","0","0","0","0","-2"
"152637","Vincennes University","2017","On-tenure track, assistant professors","5","4","1","0","0","0","0","0","0","0","0","0","0","0","0","0","0","0","5","4","1","0","0","0","0","0","0","0","0","0","-2"
"152637","Vincennes University","2017","Not on tenure track/No tenure system system total","127","61","66","1","0","1","0","0","0","3","2","1","0","0","0","0","0","0","118","56","62","1","0","1","0","0","0","4","3","1","-2"
"152637","Vincennes University","2017","Not on tenure/no tenure system, professors","3","0","3","0","0","0","0","0","0","0","0","0","0","0","0","0","0","0","3","0","3","0","0","0","0","0","0","0","0","0","-2"
"152637","Vincennes University","2017","Not on tenure/no tenure system, associate professors","28","14","14","1","0","1","0","0","0","1","1","0","0","0","0","0","0","0","25","12","13","0","0","0","0","0","0","1","1","0","-2"
"152637","Vincennes University","2017","Not on tenure/no tenure system, assistant professors","69","22","47","0","0","0","0","0","0","2","1","1","0","0","0","0","0","0","63","19","44","1","0","1","0","0","0","3","2","1","-2"
"152637","Vincennes University","2017","Not on tenure/no tenure system, instructors","25","24","1","0","0","0","0","0","0","0","0","0","0","0","0","0","0","0","25","24","1","0","0","0","0","0","0","0","0","0","-2"
"152637","Vincennes University","2017","Not on tenure/no tenure system, lecturers","1","0","1","0","0","0","0","0","0","0","0","0","0","0","0","0","0","0","1","0","1","0","0","0","0","0","0","0","0","0","-2"
"152637","Vincennes University","2017","Not on tenure/no tenure system, no academic rank","1","1","0","0","0","0","0","0","0","0","0","0","0","0","0","0","0","0","1","1","0","0","0","0","0","0","0","0","0","0","-2"
"152992","Briar Cliff University","2017","Tenured total","29","19","10","0","0","0","0","0","0","0","0","0","0","0","0","0","0","0","29","19","10","0","0","0","0","0","0","0","0","0","-2"
"152992","Briar Cliff University","2017","Tenured, professors","12","9","3","0","0","0","0","0","0","0","0","0","0","0","0","0","0","0","12","9","3","0","0","0","0","0","0","0","0","0","-2"
"152992","Briar Cliff University","2017","Tenured, associate professors","15","9","6","0","0","0","0","0","0","0","0","0","0","0","0","0","0","0","15","9","6","0","0","0","0","0","0","0","0","0","-2"
"152992","Briar Cliff University","2017","Tenured, assistant professors","2","1","1","0","0","0","0","0","0","0","0","0","0","0","0","0","0","0","2","1","1","0","0","0","0","0","0","0","0","0","-2"
"152992","Briar Cliff University","2017","On-Tenure track total","36","20","16","2","2","0","0","0","0","0","0","0","1","1","0","0","0","0","30","15","15","1","0","1","0","0","0","2","2","0","-2"
"152992","Briar Cliff University","2017","On-tenure track, professors","3","2","1","0","0","0","0","0","0","0","0","0","0","0","0","0","0","0","3","2","1","0","0","0","0","0","0","0","0","0","-2"
"152992","Briar Cliff University","2017","On-tenure track, associate professors","7","5","2","0","0","0","0","0","0","0","0","0","1","1","0","0","0","0","6","4","2","0","0","0","0","0","0","0","0","0","-2"
"152992","Briar Cliff University","2017","On-tenure track, assistant professors","24","13","11","2","2","0","0","0","0","0","0","0","0","0","0","0","0","0","19","9","10","1","0","1","0","0","0","2","2","0","-2"
"152992","Briar Cliff University","2017","On-tenure track, instructors","2","0","2","0","0","0","0","0","0","0","0","0","0","0","0","0","0","0","2","0","2","0","0","0","0","0","0","0","0","0","-2"
"152992","Briar Cliff University","2017","Not on tenure track/No tenure system system total","2","1","1","0","0","0","0","0","0","0","0","0","0","0","0","0","0","0","2","1","1","0","0","0","0","0","0","0","0","0","-2"
"152992","Briar Cliff University","2017","Not on tenure/no tenure system, assistant professors","1","1","0","0","0","0","0","0","0","0","0","0","0","0","0","0","0","0","1","1","0","0","0","0","0","0","0","0","0","0","-2"
"152992","Briar Cliff University","2017","Not on tenure/no tenure system, instructors","1","0","1","0","0","0","0","0","0","0","0","0","0","0","0","0","0","0","1","0","1","0","0","0","0","0","0","0","0","0","-2"
"154721","Bethany College","2017","Tenured total","13","7","6","0","0","0","0","0","0","0","0","0","0","0","0","0","0","0","13","7","6","0","0","0","0","0","0","0","0","0","-2"
"154721","Bethany College","2017","Tenured, professors","4","2","2","0","0","0","0","0","0","0","0","0","0","0","0","0","0","0","4","2","2","0","0","0","0","0","0","0","0","0","-2"
"154721","Bethany College","2017","Tenured, associate professors","6","4","2","0","0","0","0","0","0","0","0","0","0","0","0","0","0","0","6","4","2","0","0","0","0","0","0","0","0","0","-2"
"154721","Bethany College","2017","Tenured, assistant professors","3","1","2","0","0","0","0","0","0","0","0","0","0","0","0","0","0","0","3","1","2","0","0","0","0","0","0","0","0","0","-2"
"154721","Bethany College","2017","On-Tenure track total","17","10","7","0","0","0","0","0","0","0","0","0","0","0","0","0","0","0","16","9","7","0","0","0","1","1","0","0","0","0","-2"
"154721","Bethany College","2017","On-tenure track, associate professors","2","2","0","0","0","0","0","0","0","0","0","0","0","0","0","0","0","0","2","2","0","0","0","0","0","0","0","0","0","0","-2"
"154721","Bethany College","2017","On-tenure track, assistant professors","15","8","7","0","0","0","0","0","0","0","0","0","0","0","0","0","0","0","14","7","7","0","0","0","1","1","0","0","0","0","-2"
"154721","Bethany College","2017","Not on tenure track/No tenure system system total","8","4","4","0","0","0","1","1","0","0","0","0","0","0","0","0","0","0","6","2","4","0","0","0","1","1","0","0","0","0","-2"
"154721","Bethany College","2017","Not on tenure/no tenure system, assistant professors","8","4","4","0","0","0","1","1","0","0","0","0","0","0","0","0","0","0","6","2","4","0","0","0","1","1","0","0","0","0","-2"
"155414","Kansas Wesleyan University","2017","Tenured total","19","11","8","0","0","0","1","1","0","0","0","0","0","0","0","0","0","0","18","10","8","0","0","0","0","0","0","0","0","0","-2"
"155414","Kansas Wesleyan University","2017","Tenured, professors","6","4","2","0","0","0","0","0","0","0","0","0","0","0","0","0","0","0","6","4","2","0","0","0","0","0","0","0","0","0","-2"
"155414","Kansas Wesleyan University","2017","Tenured, associate professors","13","7","6","0","0","0","1","1","0","0","0","0","0","0","0","0","0","0","12","6","6","0","0","0","0","0","0","0","0","0","-2"
"155414","Kansas Wesleyan University","2017","On-Tenure track total","18","6","12","0","0","0","0","0","0","2","2","0","1","0","1","0","0","0","15","4","11","0","0","0","0","0","0","0","0","0","-2"
"155414","Kansas Wesleyan University","2017","On-tenure track, assistant professors","18","6","12","0","0","0","0","0","0","2","2","0","1","0","1","0","0","0","15","4","11","0","0","0","0","0","0","0","0","0","-2"
"155414","Kansas Wesleyan University","2017","Not on tenure track/No tenure system system total","6","2","4","0","0","0","0","0","0","0","0","0","0","0","0","0","0","0","6","2","4","0","0","0","0","0","0","0","0","0","-2"
"155414","Kansas Wesleyan University","2017","Not on tenure/no tenure system, assistant professors","2","0","2","0","0","0","0","0","0","0","0","0","0","0","0","0","0","0","2","0","2","0","0","0","0","0","0","0","0","0","-2"
"155414","Kansas Wesleyan University","2017","Not on tenure/no tenure system, instructors","4","2","2","0","0","0","0","0","0","0","0","0","0","0","0","0","0","0","4","2","2","0","0","0","0","0","0","0","0","0","-2"
"155511","McPherson College","2017","Tenured total","23","16","7","0","0","0","2","1","1","1","1","0","0","0","0","0","0","0","20","14","6","0","0","0","0","0","0","0","0","0","-2"
"155511","McPherson College","2017","Tenured, professors","9","6","3","0","0","0","0","0","0","0","0","0","0","0","0","0","0","0","9","6","3","0","0","0","0","0","0","0","0","0","-2"
"155511","McPherson College","2017","Tenured, associate professors","14","10","4","0","0","0","2","1","1","1","1","0","0","0","0","0","0","0","11","8","3","0","0","0","0","0","0","0","0","0","-2"
"155511","McPherson College","2017","On-Tenure track total","15","8","7","0","0","0","0","0","0","0","0","0","1","0","1","0","0","0","14","8","6","0","0","0","0","0","0","0","0","0","-2"
"155511","McPherson College","2017","On-tenure track, associate professors","3","3","0","0","0","0","0","0","0","0","0","0","0","0","0","0","0","0","3","3","0","0","0","0","0","0","0","0","0","0","-2"
"155511","McPherson College","2017","On-tenure track, assistant professors","12","5","7","0","0","0","0","0","0","0","0","0","1","0","1","0","0","0","11","5","6","0","0","0","0","0","0","0","0","0","-2"
"155511","McPherson College","2017","Not on tenure track/No tenure system system total","5","3","2","0","0","0","0","0","0","0","0","0","0","0","0","0","0","0","5","3","2","0","0","0","0","0","0","0","0","0","-2"
"155511","McPherson College","2017","Not on tenure/no tenure system, assistant professors","5","3","2","0","0","0","0","0","0","0","0","0","0","0","0","0","0","0","5","3","2","0","0","0","0","0","0","0","0","0","-2"
"159656","Loyola University New Orleans","2017","Tenured total","130","78","52","0","0","0","3","1","2","10","6","4","10","5","5","0","0","0","105","65","40","2","1","1","0","0","0","0","0","0","-2"
"159656","Loyola University New Orleans","2017","Tenured, professors","75","49","26","0","0","0","1","0","1","7","5","2","7","4","3","0","0","0","59","40","19","1","0","1","0","0","0","0","0","0","-2"
"159656","Loyola University New Orleans","2017","Tenured, associate professors","53","29","24","0","0","0","2","1","1","3","1","2","3","1","2","0","0","0","44","25","19","1","1","0","0","0","0","0","0","0","-2"
"159656","Loyola University New Orleans","2017","Tenured, assistant professors","2","0","2","0","0","0","0","0","0","0","0","0","0","0","0","0","0","0","2","0","2","0","0","0","0","0","0","0","0","0","-2"
"159656","Loyola University New Orleans","2017","On-Tenure track total","45","26","19","0","0","0","4","3","1","3","1","2","2","2","0","0","0","0","33","17","16","1","1","0","1","1","0","1","1","0","-2"
"159656","Loyola University New Orleans","2017","On-tenure track, associate professors","8","5","3","0","0","0","1","1","0","1","1","0","0","0","0","0","0","0","6","3","3","0","0","0","0","0","0","0","0","0","-2"
"159656","Loyola University New Orleans","2017","On-tenure track, assistant professors","37","21","16","0","0","0","3","2","1","2","0","2","2","2","0","0","0","0","27","14","13","1","1","0","1","1","0","1","1","0","-2"
"159656","Loyola University New Orleans","2017","Not on tenure track/No tenure system system total","76","32","44","0","0","0","2","1","1","2","1","1","3","2","1","0","0","0","62","26","36","0","0","0","6","1","5","1","1","0","-2"
"159656","Loyola University New Orleans","2017","Not on tenure/no tenure system, lecturers","76","32","44","0","0","0","2","1","1","2","1","1","3","2","1","0","0","0","62","26","36","0","0","0","6","1","5","1","1","0","-2"
"162210","Washington Adventist University","2017","Not on tenure track/No tenure system system total","47","22","25","0","0","0","6","1","5","20","7","13","2","2","0","0","0","0","18","12","6","0","0","0","1","0","1","0","0","0","-2"
"162210","Washington Adventist University","2017","Not on tenure/no tenure system, professors","16","9","7","0","0","0","1","0","1","8","4","4","0","0","0","0","0","0","7","5","2","0","0","0","0","0","0","0","0","0","-2"
"162210","Washington Adventist University","2017","Not on tenure/no tenure system, associate professors","15","6","9","0","0","0","3","1","2","6","2","4","0","0","0","0","0","0","6","3","3","0","0","0","0","0","0","0","0","0","-2"
"162210","Washington Adventist University","2017","Not on tenure/no tenure system, assistant professors","15","6","9","0","0","0","2","0","2","6","1","5","2","2","0","0","0","0","4","3","1","0","0","0","1","0","1","0","0","0","-2"
"162210","Washington Adventist University","2017","Not on tenure/no tenure system, instructors","1","1","0","0","0","0","0","0","0","0","0","0","0","0","0","0","0","0","1","1","0","0","0","0","0","0","0","0","0","0","-2"
"164447","American International College","2017","Tenured total","36","20","16","0","0","0","0","0","0","1","0","1","0","0","0","0","0","0","34","19","15","1","1","0","0","0","0","0","0","0","-2"
"164447","American International College","2017","Tenured, professors","13","5","8","0","0","0","0","0","0","0","0","0","0","0","0","0","0","0","13","5","8","0","0","0","0","0","0","0","0","0","-2"
"164447","American International College","2017","Tenured, associate professors","22","14","8","0","0","0","0","0","0","1","0","1","0","0","0","0","0","0","20","13","7","1","1","0","0","0","0","0","0","0","-2"
"164447","American International College","2017","Tenured, assistant professors","1","1","0","0","0","0","0","0","0","0","0","0","0","0","0","0","0","0","1","1","0","0","0","0","0","0","0","0","0","0","-2"
"164447","American International College","2017","On-Tenure track total","20","4","16","0","0","0","3","0","3","1","0","1","0","0","0","0","0","0","12","2","10","1","0","1","3","2","1","0","0","0","-2"
"164447","American International College","2017","On-tenure track, associate professors","4","1","3","0","0","0","0","0","0","0","0","0","0","0","0","0","0","0","4","1","3","0","0","0","0","0","0","0","0","0","-2"
"164447","American International College","2017","On-tenure track, assistant professors","16","3","13","0","0","0","3","0","3","1","0","1","0","0","0","0","0","0","8","1","7","1","0","1","3","2","1","0","0","0","-2"
"164447","American International College","2017","Not on tenure track/No tenure system system total","13","4","9","0","0","0","0","0","0","2","0","2","0","0","0","0","0","0","10","4","6","1","0","1","0","0","0","0","0","0","-2"
"164447","American International College","2017","Not on tenure/no tenure system, assistant professors","8","1","7","0","0","0","0","0","0","2","0","2","0","0","0","0","0","0","5","1","4","1","0","1","0","0","0","0","0","0","-2"
"164447","American International College","2017","Not on tenure/no tenure system, instructors","5","3","2","0","0","0","0","0","0","0","0","0","0","0","0","0","0","0","5","3","2","0","0","0","0","0","0","0","0","0","-2"
"164632","Bay Path University","2017","Not on tenure track/No tenure system system total","66","14","52","0","0","0","4","2","2","3","1","2","1","0","1","0","0","0","57","11","46","1","0","1","0","0","0","0","0","0","-2"
"164632","Bay Path University","2017","Not on tenure/no tenure system, professors","8","3","5","0","0","0","0","0","0","0","0","0","0","0","0","0","0","0","8","3","5","0","0","0","0","0","0","0","0","0","-2"
"164632","Bay Path University","2017","Not on tenure/no tenure system, associate professors","15","6","9","0","0","0","2","1","1","0","0","0","0","0","0","0","0","0","13","5","8","0","0","0","0","0","0","0","0","0","-2"
"164632","Bay Path University","2017","Not on tenure/no tenure system, assistant professors","37","5","32","0","0","0","2","1","1","3","1","2","1","0","1","0","0","0","30","3","27","1","0","1","0","0","0","0","0","0","-2"
"164632","Bay Path University","2017","Not on tenure/no tenure system, instructors","3","0","3","0","0","0","0","0","0","0","0","0","0","0","0","0","0","0","3","0","3","0","0","0","0","0","0","0","0","0","-2"
"164632","Bay Path University","2017","Not on tenure/no tenure system, no academic rank","3","0","3","0","0","0","0","0","0","0","0","0","0","0","0","0","0","0","3","0","3","0","0","0","0","0","0","0","0","0","-2"
"164872","Boston Architectural College","2017","Not on tenure track/No tenure system system total","17","9","8","0","0","0","1","0","1","2","1","1","2","1","1","0","0","0","12","7","5","0","0","0","0","0","0","0","0","0","-2"
"164872","Boston Architectural College","2017","Not on tenure/no tenure system, no academic rank","17","9","8","0","0","0","1","0","1","2","1","1","2","1","1","0","0","0","12","7","5","0","0","0","0","0","0","0","0","0","-2"
"165644","Eastern Nazarene College","2017","Tenured total","11","8","3","0","0","0","0","0","0","0","0","0","0","0","0","0","0","0","9","6","3","1","1","0","0","0","0","1","1","0","-2"
"165644","Eastern Nazarene College","2017","Tenured, professors","6","5","1","0","0","0","0","0","0","0","0","0","0","0","0","0","0","0","4","3","1","1","1","0","0","0","0","1","1","0","-2"
"165644","Eastern Nazarene College","2017","Tenured, associate professors","5","3","2","0","0","0","0","0","0","0","0","0","0","0","0","0","0","0","5","3","2","0","0","0","0","0","0","0","0","0","-2"
"165644","Eastern Nazarene College","2017","On-Tenure track total","13","8","5","0","0","0","0","0","0","2","1","1","0","0","0","0","0","0","10","6","4","0","0","0","1","1","0","0","0","0","-2"
"165644","Eastern Nazarene College","2017","On-tenure track, associate professors","4","3","1","0","0","0","0","0","0","0","0","0","0","0","0","0","0","0","4","3","1","0","0","0","0","0","0","0","0","0","-2"
"165644","Eastern Nazarene College","2017","On-tenure track, assistant professors","9","5","4","0","0","0","0","0","0","2","1","1","0","0","0","0","0","0","6","3","3","0","0","0","1","1","0","0","0","0","-2"
"165644","Eastern Nazarene College","2017","Not on tenure track/No tenure system system total","13","9","4","0","0","0","1","0","1","0","0","0","1","1","0","0","0","0","11","8","3","0","0","0","0","0","0","0","0","0","-2"
"165644","Eastern Nazarene College","2017","Not on tenure/no tenure system, associate professors","1","1","0","0","0","0","0","0","0","0","0","0","0","0","0","0","0","0","1","1","0","0","0","0","0","0","0","0","0","0","-2"
"165644","Eastern Nazarene College","2017","Not on tenure/no tenure system, assistant professors","4","3","1","0","0","0","0","0","0","0","0","0","0","0","0","0","0","0","4","3","1","0","0","0","0","0","0","0","0","0","-2"
"165644","Eastern Nazarene College","2017","Not on tenure/no tenure system, instructors","8","5","3","0","0","0","1","0","1","0","0","0","1","1","0","0","0","0","6","4","2","0","0","0","0","0","0","0","0","0","-2"
"165866","Framingham State University","2017","Tenured total","112","45","67","0","0","0","7","4","3","2","1","1","1","0","1","0","0","0","100","39","61","2","1","1","0","0","0","0","0","0","-2"
"165866","Framingham State University","2017","Tenured, professors","55","20","35","0","0","0","4","3","1","1","1","0","1","0","1","0","0","0","48","15","33","1","1","0","0","0","0","0","0","0","-2"
"165866","Framingham State University","2017","Tenured, associate professors","52","23","29","0","0","0","3","1","2","1","0","1","0","0","0","0","0","0","47","22","25","1","0","1","0","0","0","0","0","0","-2"
"165866","Framingham State University","2017","Tenured, assistant professors","5","2","3","0","0","0","0","0","0","0","0","0","0","0","0","0","0","0","5","2","3","0","0","0","0","0","0","0","0","0","-2"
"165866","Framingham State University","2017","On-Tenure track total","63","29","34","0","0","0","9","4","5","4","2","2","6","3","3","0","0","0","43","19","24","1","1","0","0","0","0","0","0","0","-2"
"165866","Framingham State University","2017","On-tenure track, professors","1","0","1","0","0","0","0","0","0","0","0","0","0","0","0","0","0","0","1","0","1","0","0","0","0","0","0","0","0","0","-2"
"165866","Framingham State University","2017","On-tenure track, associate professors","1","0","1","0","0","0","0","0","0","0","0","0","0","0","0","0","0","0","1","0","1","0","0","0","0","0","0","0","0","0","-2"
"165866","Framingham State University","2017","On-tenure track, assistant professors","60","29","31","0","0","0","9","4","5","4","2","2","6","3","3","0","0","0","40","19","21","1","1","0","0","0","0","0","0","0","-2"
"165866","Framingham State University","2017","On-tenure track, instructors","1","0","1","0","0","0","0","0","0","0","0","0","0","0","0","0","0","0","1","0","1","0","0","0","0","0","0","0","0","0","-2"
"165866","Framingham State University","2017","Not on tenure track/No tenure system system total","22","9","13","0","0","0","4","0","4","1","1","0","1","0","1","0","0","0","15","8","7","1","0","1","0","0","0","0","0","0","-2"
"165866","Framingham State University","2017","Not on tenure/no tenure system, assistant professors","18","9","9","0","0","0","4","0","4","1","1","0","1","0","1","0","0","0","11","8","3","1","0","1","0","0","0","0","0","0","-2"
"165866","Framingham State University","2017","Not on tenure/no tenure system, instructors","4","0","4","0","0","0","0","0","0","0","0","0","0","0","0","0","0","0","4","0","4","0","0","0","0","0","0","0","0","0","-2"
"166452","Lesley University","2017","Not on tenure track/No tenure system system total","145","51","94","0","0","0","13","4","9","7","4","3","8","2","6","0","0","0","115","39","76","2","2","0","0","0","0","0","0","0","-2"
"166452","Lesley University","2017","Not on tenure/no tenure system, professors","36","14","22","0","0","0","4","1","3","2","1","1","1","0","1","0","0","0","29","12","17","0","0","0","0","0","0","0","0","0","-2"
"166452","Lesley University","2017","Not on tenure/no tenure system, associate professors","54","22","32","0","0","0","4","1","3","3","1","2","4","1","3","0","0","0","42","18","24","1","1","0","0","0","0","0","0","0","-2"
"166452","Lesley University","2017","Not on tenure/no tenure system, assistant professors","45","12","33","0","0","0","5","2","3","2","2","0","3","1","2","0","0","0","34","6","28","1","1","0","0","0","0","0","0","0","-2"
"166452","Lesley University","2017","Not on tenure/no tenure system, instructors","10","3","7","0","0","0","0","0","0","0","0","0","0","0","0","0","0","0","10","3","7","0","0","0","0","0","0","0","0","0","-2"
"166638","University of Massachusetts-Boston","2017","Tenured total","338","191","147","0","0","0","53","36","17","22","10","12","17","9","8","0","0","0","221","119","102","0","0","0","23","16","7","2","1","1","-2"
"166638","University of Massachusetts-Boston","2017","Tenured, professors","114","76","38","0","0","0","17","13","4","6","6","0","4","2","2","0","0","0","84","52","32","0","0","0","3","3","0","0","0","0","-2"
"166638","University of Massachusetts-Boston","2017","Tenured, associate professors","223","115","108","0","0","0","36","23","13","16","4","12","12","7","5","0","0","0","137","67","70","0","0","0","20","13","7","2","1","1","-2"
"166638","University of Massachusetts-Boston","2017","Tenured, assistant professors","1","0","1","0","0","0","0","0","0","0","0","0","1","0","1","0","0","0","0","0","0","0","0","0","0","0","0","0","0","0","-2"
"166638","University of Massachusetts-Boston","2017","On-Tenure track total","167","72","95","1","1","0","21","10","11","8","2","6","14","5","9","0","0","0","72","32","40","1","1","0","19","9","10","31","12","19","-2"
"166638","University of Massachusetts-Boston","2017","On-tenure track, associate professors","10","5","5","0","0","0","2","1","1","1","1","0","1","1","0","0","0","0","4","1","3","0","0","0","1","0","1","1","1","0","-2"
"166638","University of Massachusetts-Boston","2017","On-tenure track, assistant professors","157","67","90","1","1","0","19","9","10","7","1","6","13","4","9","0","0","0","68","31","37","1","1","0","18","9","9","30","11","19","-2"
"166638","University of Massachusetts-Boston","2017","Not on tenure track/No tenure system system total","195","84","111","0","0","0","13","7","6","10","7","3","6","3","3","0","0","0","141","58","83","0","0","0","20","5","15","5","4","1","-2"
"166638","University of Massachusetts-Boston","2017","Not on tenure/no tenure system, lecturers","166","71","95","0","0","0","12","6","6","7","6","1","5","2","3","0","0","0","124","50","74","0","0","0","14","4","10","4","3","1","-2"
"166638","University of Massachusetts-Boston","2017","Not on tenure/no tenure system, no academic rank","29","13","16","0","0","0","1","1","0","3","1","2","1","1","0","0","0","0","17","8","9","0","0","0","6","1","5","1","1","0","-2"
"167455","Pine Manor College","2017","Tenured total","7","2","5","0","0","0","1","0","1","0","0","0","1","0","1","0","0","0","5","2","3","0","0","0","0","0","0","0","0","0","-2"
"167455","Pine Manor College","2017","Tenured, professors","6","2","4","0","0","0","1","0","1","0","0","0","1","0","1","0","0","0","4","2","2","0","0","0","0","0","0","0","0","0","-2"
"167455","Pine Manor College","2017","Tenured, associate professors","1","0","1","0","0","0","0","0","0","0","0","0","0","0","0","0","0","0","1","0","1","0","0","0","0","0","0","0","0","0","-2"
"167455","Pine Manor College","2017","On-Tenure track total","8","1","7","0","0","0","0","0","0","0","0","0","1","0","1","0","0","0","7","1","6","0","0","0","0","0","0","0","0","0","-2"
"167455","Pine Manor College","2017","On-tenure track, associate professors","1","0","1","0","0","0","0","0","0","0","0","0","0","0","0","0","0","0","1","0","1","0","0","0","0","0","0","0","0","0","-2"
"167455","Pine Manor College","2017","On-tenure track, assistant professors","7","1","6","0","0","0","0","0","0","0","0","0","1","0","1","0","0","0","6","1","5","0","0","0","0","0","0","0","0","0","-2"
"167455","Pine Manor College","2017","Not on tenure track/No tenure system system total","5","0","5","0","0","0","0","0","0","0","0","0","0","0","0","0","0","0","5","0","5","0","0","0","0","0","0","0","0","0","-2"
"167455","Pine Manor College","2017","Not on tenure/no tenure system, assistant professors","5","0","5","0","0","0","0","0","0","0","0","0","0","0","0","0","0","0","5","0","5","0","0","0","0","0","0","0","0","0","-2"
"167729","Salem State University","2017","Tenured total","246","124","122","0","0","0","21","11","10","10","6","4","9","5","4","0","0","0","201","99","102","0","0","0","5","3","2","0","0","0","-2"
"167729","Salem State University","2017","Tenured, professors","143","79","64","0","0","0","8","5","3","2","2","0","4","3","1","0","0","0","128","69","59","0","0","0","1","0","1","0","0","0","-2"
"167729","Salem State University","2017","Tenured, associate professors","98","43","55","0","0","0","12","5","7","8","4","4","5","2","3","0","0","0","69","29","40","0","0","0","4","3","1","0","0","0","-2"
"167729","Salem State University","2017","Tenured, assistant professors","5","2","3","0","0","0","1","1","0","0","0","0","0","0","0","0","0","0","4","1","3","0","0","0","0","0","0","0","0","0","-2"
"167729","Salem State University","2017","On-Tenure track total","81","33","48","0","0","0","12","2","10","12","8","4","5","4","1","0","0","0","50","19","31","0","0","0","2","0","2","0","0","0","-2"
"167729","Salem State University","2017","On-tenure track, professors","1","1","0","0","0","0","0","0","0","0","0","0","1","1","0","0","0","0","0","0","0","0","0","0","0","0","0","0","0","0","-2"
"167729","Salem State University","2017","On-tenure track, associate professors","7","4","3","0","0","0","2","0","2","1","1","0","1","1","0","0","0","0","3","2","1","0","0","0","0","0","0","0","0","0","-2"
"167729","Salem State University","2017","On-tenure track, assistant professors","71","28","43","0","0","0","10","2","8","11","7","4","3","2","1","0","0","0","45","17","28","0","0","0","2","0","2","0","0","0","-2"
"167729","Salem State University","2017","On-tenure track, instructors","2","0","2","0","0","0","0","0","0","0","0","0","0","0","0","0","0","0","2","0","2","0","0","0","0","0","0","0","0","0","-2"
"167729","Salem State University","2017","Not on tenure track/No tenure system system total","13","3","10","0","0","0","1","0","1","2","1","1","1","0","1","0","0","0","7","2","5","0","0","0","2","0","2","0","0","0","-2"
"167729","Salem State University","2017","Not on tenure/no tenure system, assistant professors","7","1","6","0","0","0","1","0","1","1","1","0","1","0","1","0","0","0","3","0","3","0","0","0","1","0","1","0","0","0","-2"
"167729","Salem State University","2017","Not on tenure/no tenure system, instructors","6","2","4","0","0","0","0","0","0","1","0","1","0","0","0","0","0","0","4","2","2","0","0","0","1","0","1","0","0","0","-2"
"168740","Andrews University","2017","Tenured total","58","40","18","0","0","0","8","7","1","2","1","1","4","3","1","0","0","0","40","27","13","2","2","0","0","0","0","2","0","2","-2"
"168740","Andrews University","2017","Tenured, professors","35","27","8","0","0","0","5","4","1","1","1","0","1","1","0","0","0","0","28","21","7","0","0","0","0","0","0","0","0","0","-2"
"168740","Andrews University","2017","Tenured, associate professors","20","11","9","0","0","0","3","3","0","1","0","1","2","1","1","0","0","0","11","6","5","1","1","0","0","0","0","2","0","2","-2"
"168740","Andrews University","2017","Tenured, assistant professors","3","2","1","0","0","0","0","0","0","0","0","0","1","1","0","0","0","0","1","0","1","1","1","0","0","0","0","0","0","0","-2"
"168740","Andrews University","2017","On-Tenure track total","141","81","60","0","0","0","8","4","4","20","9","11","13","8","5","0","0","0","87","54","33","2","1","1","6","3","3","5","2","3","-2"
"168740","Andrews University","2017","On-tenure track, professors","21","18","3","0","0","0","3","2","1","2","1","1","1","1","0","0","0","0","14","13","1","0","0","0","1","1","0","0","0","0","-2"
"168740","Andrews University","2017","On-tenure track, associate professors","50","27","23","0","0","0","2","1","1","9","4","5","3","3","0","0","0","0","30","17","13","1","1","0","3","0","3","2","1","1","-2"
"168740","Andrews University","2017","On-tenure track, assistant professors","67","35","32","0","0","0","2","1","1","9","4","5","7","3","4","0","0","0","43","24","19","1","0","1","2","2","0","3","1","2","-2"
"168740","Andrews University","2017","On-tenure track, instructors","3","1","2","0","0","0","1","0","1","0","0","0","2","1","1","0","0","0","0","0","0","0","0","0","0","0","0","0","0","0","-2"
"168740","Andrews University","2017","Not on tenure track/No tenure system system total","18","8","10","0","0","0","1","1","0","3","0","3","3","3","0","0","0","0","10","4","6","0","0","0","1","0","1","0","0","0","-2"
"168740","Andrews University","2017","Not on tenure/no tenure system, professors","1","0","1","0","0","0","0","0","0","0","0","0","0","0","0","0","0","0","0","0","0","0","0","0","1","0","1","0","0","0","-2"
"168740","Andrews University","2017","Not on tenure/no tenure system, associate professors","7","4","3","0","0","0","0","0","0","1","0","1","2","2","0","0","0","0","4","2","2","0","0","0","0","0","0","0","0","0","-2"
"168740","Andrews University","2017","Not on tenure/no tenure system, assistant professors","6","2","4","0","0","0","0","0","0","2","0","2","0","0","0","0","0","0","4","2","2","0","0","0","0","0","0","0","0","0","-2"
"168740","Andrews University","2017","Not on tenure/no tenure system, instructors","4","2","2","0","0","0","1","1","0","0","0","0","1","1","0","0","0","0","2","0","2","0","0","0","0","0","0","0","0","0","-2"
"170532","Kalamazoo College","2017","Tenured total","62","32","30","0","0","0","4","0","4","2","1","1","3","0","3","0","0","0","51","30","21","0","0","0","2","1","1","0","0","0","-2"
"170532","Kalamazoo College","2017","Tenured, professors","35","21","14","0","0","0","1","0","1","0","0","0","2","0","2","0","0","0","32","21","11","0","0","0","0","0","0","0","0","0","-2"
"170532","Kalamazoo College","2017","Tenured, associate professors","27","11","16","0","0","0","3","0","3","2","1","1","1","0","1","0","0","0","19","9","10","0","0","0","2","1","1","0","0","0","-2"
"170532","Kalamazoo College","2017","On-Tenure track total","25","11","14","1","0","1","3","1","2","3","2","1","3","1","2","0","0","0","11","4","7","2","1","1","0","0","0","2","2","0","-2"
"170532","Kalamazoo College","2017","On-tenure track, assistant professors","25","11","14","1","0","1","3","1","2","3","2","1","3","1","2","0","0","0","11","4","7","2","1","1","0","0","0","2","2","0","-2"
"170532","Kalamazoo College","2017","Not on tenure track/No tenure system system total","24","9","15","0","0","0","1","1","0","0","0","0","2","2","0","0","0","0","20","6","14","0","0","0","0","0","0","1","0","1","-2"
"170532","Kalamazoo College","2017","Not on tenure/no tenure system, assistant professors","18","8","10","0","0","0","1","1","0","0","0","0","2","2","0","0","0","0","14","5","9","0","0","0","0","0","0","1","0","1","-2"
"170532","Kalamazoo College","2017","Not on tenure/no tenure system, instructors","6","1","5","0","0","0","0","0","0","0","0","0","0","0","0","0","0","0","6","1","5","0","0","0","0","0","0","0","0","0","-2"
"172033","Sacred Heart Major Seminary","2017","Not on tenure track/No tenure system system total","18","14","4","0","0","0","0","0","0","0","0","0","2","2","0","0","0","0","16","12","4","0","0","0","0","0","0","0","0","0","-2"
"172033","Sacred Heart Major Seminary","2017","Not on tenure/no tenure system, professors","9","7","2","0","0","0","0","0","0","0","0","0","1","1","0","0","0","0","8","6","2","0","0","0","0","0","0","0","0","0","-2"
"172033","Sacred Heart Major Seminary","2017","Not on tenure/no tenure system, associate professors","4","3","1","0","0","0","0","0","0","0","0","0","1","1","0","0","0","0","3","2","1","0","0","0","0","0","0","0","0","0","-2"
"172033","Sacred Heart Major Seminary","2017","Not on tenure/no tenure system, assistant professors","4","3","1","0","0","0","0","0","0","0","0","0","0","0","0","0","0","0","4","3","1","0","0","0","0","0","0","0","0","0","-2"
"172033","Sacred Heart Major Seminary","2017","Not on tenure/no tenure system, instructors","1","1","0","0","0","0","0","0","0","0","0","0","0","0","0","0","0","0","1","1","0","0","0","0","0","0","0","0","0","0","-2"
"177083","Conception Seminary College","2017","Not on tenure track/No tenure system system total","5","2","3","0","0","0","0","0","0","0","0","0","1","0","1","0","0","0","4","2","2","0","0","0","0","0","0","0","0","0","-2"
"177083","Conception Seminary College","2017","Not on tenure/no tenure system, professors","3","2","1","0","0","0","0","0","0","0","0","0","0","0","0","0","0","0","3","2","1","0","0","0","0","0","0","0","0","0","-2"
"177083","Conception Seminary College","2017","Not on tenure/no tenure system, assistant professors","1","0","1","0","0","0","0","0","0","0","0","0","0","0","0","0","0","0","1","0","1","0","0","0","0","0","0","0","0","0","-2"
"177083","Conception Seminary College","2017","Not on tenure/no tenure system, instructors","1","0","1","0","0","0","0","0","0","0","0","0","1","0","1","0","0","0","0","0","0","0","0","0","0","0","0","0","0","0","-2"
"178721","Park University","2017","Tenured total","47","32","15","0","0","0","3","1","2","1","1","0","0","0","0","0","0","0","42","30","12","1","0","1","0","0","0","0","0","0","-2"
"178721","Park University","2017","Tenured, professors","22","16","6","0","0","0","2","0","2","1","1","0","0","0","0","0","0","0","19","15","4","0","0","0","0","0","0","0","0","0","-2"
"178721","Park University","2017","Tenured, associate professors","25","16","9","0","0","0","1","1","0","0","0","0","0","0","0","0","0","0","23","15","8","1","0","1","0","0","0","0","0","0","-2"
"178721","Park University","2017","On-Tenure track total","33","17","16","0","0","0","2","1","1","2","1","1","0","0","0","0","0","0","29","15","14","0","0","0","0","0","0","0","0","0","-2"
"178721","Park University","2017","On-tenure track, professors","1","1","0","0","0","0","0","0","0","0","0","0","0","0","0","0","0","0","1","1","0","0","0","0","0","0","0","0","0","0","-2"
"178721","Park University","2017","On-tenure track, associate professors","10","5","5","0","0","0","1","0","1","1","1","0","0","0","0","0","0","0","8","4","4","0","0","0","0","0","0","0","0","0","-2"
"178721","Park University","2017","On-tenure track, assistant professors","22","11","11","0","0","0","1","1","0","1","0","1","0","0","0","0","0","0","20","10","10","0","0","0","0","0","0","0","0","0","-2"
"178721","Park University","2017","Not on tenure track/No tenure system system total","33","9","24","0","0","0","0","0","0","1","0","1","0","0","0","0","0","0","30","8","22","2","1","1","0","0","0","0","0","0","-2"
"178721","Park University","2017","Not on tenure/no tenure system, associate professors","1","1","0","0","0","0","0","0","0","0","0","0","0","0","0","0","0","0","1","1","0","0","0","0","0","0","0","0","0","0","-2"
"178721","Park University","2017","Not on tenure/no tenure system, assistant professors","19","2","17","0","0","0","0","0","0","1","0","1","0","0","0","0","0","0","16","1","15","2","1","1","0","0","0","0","0","0","-2"
"178721","Park University","2017","Not on tenure/no tenure system, instructors","4","2","2","0","0","0","0","0","0","0","0","0","0","0","0","0","0","0","4","2","2","0","0","0","0","0","0","0","0","0","-2"
"178721","Park University","2017","Not on tenure/no tenure system, lecturers","9","4","5","0","0","0","0","0","0","0","0","0","0","0","0","0","0","0","9","4","5","0","0","0","0","0","0","0","0","0","-2"
"181738","Union College","2017","Tenured total","15","8","7","0","0","0","0","0","0","1","0","1","0","0","0","0","0","0","14","8","6","0","0","0","0","0","0","0","0","0","-2"
"181738","Union College","2017","Tenured, professors","11","7","4","0","0","0","0","0","0","1","0","1","0","0","0","0","0","0","10","7","3","0","0","0","0","0","0","0","0","0","-2"
"181738","Union College","2017","Tenured, associate professors","4","1","3","0","0","0","0","0","0","0","0","0","0","0","0","0","0","0","4","1","3","0","0","0","0","0","0","0","0","0","-2"
"181738","Union College","2017","On-Tenure track total","43","19","24","0","0","0","1","1","0","4","2","2","0","0","0","0","0","0","37","15","22","0","0","0","0","0","0","1","1","0","-2"
"181738","Union College","2017","On-tenure track, professors","6","4","2","0","0","0","0","0","0","1","1","0","0","0","0","0","0","0","5","3","2","0","0","0","0","0","0","0","0","0","-2"
"181738","Union College","2017","On-tenure track, associate professors","13","5","8","0","0","0","1","1","0","1","0","1","0","0","0","0","0","0","10","3","7","0","0","0","0","0","0","1","1","0","-2"
"181738","Union College","2017","On-tenure track, assistant professors","22","9","13","0","0","0","0","0","0","2","1","1","0","0","0","0","0","0","20","8","12","0","0","0","0","0","0","0","0","0","-2"
"181738","Union College","2017","On-tenure track, instructors","2","1","1","0","0","0","0","0","0","0","0","0","0","0","0","0","0","0","2","1","1","0","0","0","0","0","0","0","0","0","-2"
"181853","York College","2017","Tenured total","12","10","2","0","0","0","0","0","0","0","0","0","2","2","0","0","0","0","10","8","2","0","0","0","0","0","0","0","0","0","-2"
"181853","York College","2017","Tenured, professors","4","4","0","0","0","0","0","0","0","0","0","0","0","0","0","0","0","0","4","4","0","0","0","0","0","0","0","0","0","0","-2"
"181853","York College","2017","Tenured, associate professors","8","6","2","0","0","0","0","0","0","0","0","0","2","2","0","0","0","0","6","4","2","0","0","0","0","0","0","0","0","0","-2"
"181853","York College","2017","On-Tenure track total","4","3","1","0","0","0","0","0","0","0","0","0","1","0","1","0","0","0","3","3","0","0","0","0","0","0","0","0","0","0","-2"
"181853","York College","2017","On-tenure track, associate professors","3","3","0","0","0","0","0","0","0","0","0","0","0","0","0","0","0","0","3","3","0","0","0","0","0","0","0","0","0","0","-2"
"181853","York College","2017","On-tenure track, assistant professors","1","0","1","0","0","0","0","0","0","0","0","0","1","0","1","0","0","0","0","0","0","0","0","0","0","0","0","0","0","0","-2"
"181853","York College","2017","Not on tenure track/No tenure system system total","10","3","7","0","0","0","0","0","0","0","0","0","0","0","0","0","0","0","10","3","7","0","0","0","0","0","0","0","0","0","-2"
"181853","York College","2017","Not on tenure/no tenure system, professors","1","1","0","0","0","0","0","0","0","0","0","0","0","0","0","0","0","0","1","1","0","0","0","0","0","0","0","0","0","0","-2"
"181853","York College","2017","Not on tenure/no tenure system, assistant professors","9","2","7","0","0","0","0","0","0","0","0","0","0","0","0","0","0","0","9","2","7","0","0","0","0","0","0","0","0","0","-2"
"182306","Great Basin College","2017","Tenured total","28","13","15","0","0","0","2","1","1","1","0","1","3","2","1","0","0","0","22","10","12","0","0","0","0","0","0","0","0","0","-2"
"182306","Great Basin College","2017","Tenured, professors","28","13","15","0","0","0","2","1","1","1","0","1","3","2","1","0","0","0","22","10","12","0","0","0","0","0","0","0","0","0","-2"
"182306","Great Basin College","2017","On-Tenure track total","21","12","9","0","0","0","1","1","0","1","1","0","2","0","2","0","0","0","17","10","7","0","0","0","0","0","0","0","0","0","-2"
"182306","Great Basin College","2017","On-tenure track, instructors","21","12","9","0","0","0","1","1","0","1","1","0","2","0","2","0","0","0","17","10","7","0","0","0","0","0","0","0","0","0","-2"
"182306","Great Basin College","2017","Not on tenure track/No tenure system system total","16","12","4","0","0","0","0","0","0","0","0","0","1","1","0","0","0","0","15","11","4","0","0","0","0","0","0","0","0","0","-2"
"182306","Great Basin College","2017","Not on tenure/no tenure system, instructors","16","12","4","0","0","0","0","0","0","0","0","0","1","1","0","0","0","0","15","11","4","0","0","0","0","0","0","0","0","0","-2"
"182564","Western Nevada College","2017","Tenured total","29","16","13","0","0","0","0","0","0","0","0","0","1","1","0","0","0","0","28","15","13","0","0","0","0","0","0","0","0","0","-2"
"182564","Western Nevada College","2017","Tenured, professors","29","16","13","0","0","0","0","0","0","0","0","0","1","1","0","0","0","0","28","15","13","0","0","0","0","0","0","0","0","0","-2"
"182564","Western Nevada College","2017","On-Tenure track total","14","4","10","0","0","0","1","0","1","0","0","0","1","1","0","0","0","0","12","3","9","0","0","0","0","0","0","0","0","0","-2"
"182564","Western Nevada College","2017","On-tenure track, instructors","14","4","10","0","0","0","1","0","1","0","0","0","1","1","0","0","0","0","12","3","9","0","0","0","0","0","0","0","0","0","-2"
"182564","Western Nevada College","2017","Not on tenure track/No tenure system system total","13","7","6","0","0","0","1","0","1","1","1","0","0","0","0","0","0","0","11","6","5","0","0","0","0","0","0","0","0","0","-2"
"182564","Western Nevada College","2017","Not on tenure/no tenure system, instructors","13","7","6","0","0","0","1","0","1","1","1","0","0","0","0","0","0","0","11","6","5","0","0","0","0","0","0","0","0","0","-2"
"183974","Centenary University","2017","Tenured total","13","7","6","0","0","0","2","1","1","0","0","0","0","0","0","0","0","0","11","6","5","0","0","0","0","0","0","0","0","0","-2"
"183974","Centenary University","2017","Tenured, professors","6","3","3","0","0","0","1","0","1","0","0","0","0","0","0","0","0","0","5","3","2","0","0","0","0","0","0","0","0","0","-2"
"183974","Centenary University","2017","Tenured, associate professors","7","4","3","0","0","0","1","1","0","0","0","0","0","0","0","0","0","0","6","3","3","0","0","0","0","0","0","0","0","0","-2"
"183974","Centenary University","2017","On-Tenure track total","19","11","8","0","0","0","3","2","1","0","0","0","0","0","0","0","0","0","16","9","7","0","0","0","0","0","0","0","0","0","-2"
"183974","Centenary University","2017","On-tenure track, associate professors","4","2","2","0","0","0","1","0","1","0","0","0","0","0","0","0","0","0","3","2","1","0","0","0","0","0","0","0","0","0","-2"
"183974","Centenary University","2017","On-tenure track, assistant professors","15","9","6","0","0","0","2","2","0","0","0","0","0","0","0","0","0","0","13","7","6","0","0","0","0","0","0","0","0","0","-2"
"183974","Centenary University","2017","Not on tenure track/No tenure system system total","50","21","29","0","0","0","1","0","1","1","0","1","1","0","1","0","0","0","47","21","26","0","0","0","0","0","0","0","0","0","-2"
"183974","Centenary University","2017","Not on tenure/no tenure system, professors","4","1","3","0","0","0","0","0","0","0","0","0","0","0","0","0","0","0","4","1","3","0","0","0","0","0","0","0","0","0","-2"
"183974","Centenary University","2017","Not on tenure/no tenure system, associate professors","14","5","9","0","0","0","1","0","1","1","0","1","0","0","0","0","0","0","12","5","7","0","0","0","0","0","0","0","0","0","-2"
"183974","Centenary University","2017","Not on tenure/no tenure system, assistant professors","31","15","16","0","0","0","0","0","0","0","0","0","1","0","1","0","0","0","30","15","15","0","0","0","0","0","0","0","0","0","-2"
"183974","Centenary University","2017","Not on tenure/no tenure system, instructors","1","0","1","0","0","0","0","0","0","0","0","0","0","0","0","0","0","0","1","0","1","0","0","0","0","0","0","0","0","0","-2"
"184348","Drew University","2017","Tenured total","106","61","45","0","0","0","7","2","5","8","5","3","7","5","2","0","0","0","70","40","30","0","0","0","8","4","4","6","5","1","-2"
"184348","Drew University","2017","Tenured, professors","53","31","22","0","0","0","2","1","1","3","1","2","2","1","1","0","0","0","39","24","15","0","0","0","6","3","3","1","1","0","-2"
"184348","Drew University","2017","Tenured, associate professors","53","30","23","0","0","0","5","1","4","5","4","1","5","4","1","0","0","0","31","16","15","0","0","0","2","1","1","5","4","1","-2"
"184348","Drew University","2017","On-Tenure track total","10","4","6","1","1","0","0","0","0","2","1","1","0","0","0","0","0","0","6","2","4","0","0","0","1","0","1","0","0","0","-2"
"184348","Drew University","2017","On-tenure track, assistant professors","10","4","6","1","1","0","0","0","0","2","1","1","0","0","0","0","0","0","6","2","4","0","0","0","1","0","1","0","0","0","-2"
"184348","Drew University","2017","Not on tenure track/No tenure system system total","32","13","19","0","0","0","1","0","1","1","1","0","2","1","1","0","0","0","22","9","13","0","0","0","4","1","3","2","1","1","-2"
"184348","Drew University","2017","Not on tenure/no tenure system, associate professors","4","2","2","0","0","0","0","0","0","0","0","0","0","0","0","0","0","0","4","2","2","0","0","0","0","0","0","0","0","0","-2"
"184348","Drew University","2017","Not on tenure/no tenure system, assistant professors","25","10","15","0","0","0","1","0","1","0","0","0","2","1","1","0","0","0","17","7","10","0","0","0","3","1","2","2","1","1","-2"
"184348","Drew University","2017","Not on tenure/no tenure system, instructors","3","1","2","0","0","0","0","0","0","1","1","0","0","0","0","0","0","0","1","0","1","0","0","0","1","0","1","0","0","0","-2"
"184694","Fairleigh Dickinson University-Florham Campus","2017","Tenured total","69","46","23","0","0","0","8","6","2","1","1","0","3","1","2","0","0","0","57","38","19","0","0","0","0","0","0","0","0","0","-2"
"184694","Fairleigh Dickinson University-Florham Campus","2017","Tenured, professors","35","24","11","0","0","0","7","5","2","0","0","0","1","0","1","0","0","0","27","19","8","0","0","0","0","0","0","0","0","0","-2"
"184694","Fairleigh Dickinson University-Florham Campus","2017","Tenured, associate professors","31","19","12","0","0","0","0","0","0","1","1","0","2","1","1","0","0","0","28","17","11","0","0","0","0","0","0","0","0","0","-2"
"184694","Fairleigh Dickinson University-Florham Campus","2017","Tenured, assistant professors","3","3","0","0","0","0","1","1","0","0","0","0","0","0","0","0","0","0","2","2","0","0","0","0","0","0","0","0","0","0","-2"
"184694","Fairleigh Dickinson University-Florham Campus","2017","On-Tenure track total","41","17","24","0","0","0","12","4","8","1","0","1","0","0","0","0","0","0","28","13","15","0","0","0","0","0","0","0","0","0","-2"
"184694","Fairleigh Dickinson University-Florham Campus","2017","On-tenure track, professors","4","2","2","0","0","0","1","1","0","0","0","0","0","0","0","0","0","0","3","1","2","0","0","0","0","0","0","0","0","0","-2"
"184694","Fairleigh Dickinson University-Florham Campus","2017","On-tenure track, associate professors","6","3","3","0","0","0","3","2","1","0","0","0","0","0","0","0","0","0","3","1","2","0","0","0","0","0","0","0","0","0","-2"
"184694","Fairleigh Dickinson University-Florham Campus","2017","On-tenure track, assistant professors","30","11","19","0","0","0","8","1","7","1","0","1","0","0","0","0","0","0","21","10","11","0","0","0","0","0","0","0","0","0","-2"
"184694","Fairleigh Dickinson University-Florham Campus","2017","On-tenure track, instructors","1","1","0","0","0","0","0","0","0","0","0","0","0","0","0","0","0","0","1","1","0","0","0","0","0","0","0","0","0","0","-2"
"184694","Fairleigh Dickinson University-Florham Campus","2017","Not on tenure track/No tenure system system total","42","12","30","0","0","0","4","0","4","3","1","2","2","0","2","0","0","0","33","11","22","0","0","0","0","0","0","0","0","0","-2"
"184694","Fairleigh Dickinson University-Florham Campus","2017","Not on tenure/no tenure system, assistant professors","16","4","12","0","0","0","3","0","3","0","0","0","0","0","0","0","0","0","13","4","9","0","0","0","0","0","0","0","0","0","-2"
"184694","Fairleigh Dickinson University-Florham Campus","2017","Not on tenure/no tenure system, instructors","2","0","2","0","0","0","0","0","0","1","0","1","0","0","0","0","0","0","1","0","1","0","0","0","0","0","0","0","0","0","-2"
"184694","Fairleigh Dickinson University-Florham Campus","2017","Not on tenure/no tenure system, lecturers","24","8","16","0","0","0","1","0","1","2","1","1","2","0","2","0","0","0","19","7","12","0","0","0","0","0","0","0","0","0","-2"
"185828","New Jersey Institute of Technology","2017","Tenured total","224","193","31","0","0","0","54","46","8","8","5","3","2","2","0","0","0","0","129","111","18","0","0","0","31","29","2","0","0","0","-2"
"185828","New Jersey Institute of Technology","2017","Tenured, professors","140","126","14","0","0","0","33","31","2","5","4","1","1","1","0","0","0","0","76","66","10","0","0","0","25","24","1","0","0","0","-2"
"185828","New Jersey Institute of Technology","2017","Tenured, associate professors","84","67","17","0","0","0","21","15","6","3","1","2","1","1","0","0","0","0","53","45","8","0","0","0","6","5","1","0","0","0","-2"
"185828","New Jersey Institute of Technology","2017","On-Tenure track total","81","56","25","0","0","0","26","21","5","0","0","0","5","3","2","0","0","0","30","18","12","0","0","0","0","0","0","20","14","6","-2"
"185828","New Jersey Institute of Technology","2017","On-tenure track, associate professors","7","4","3","0","0","0","3","2","1","0","0","0","0","0","0","0","0","0","2","1","1","0","0","0","0","0","0","2","1","1","-2"
"185828","New Jersey Institute of Technology","2017","On-tenure track, assistant professors","74","52","22","0","0","0","23","19","4","0","0","0","5","3","2","0","0","0","28","17","11","0","0","0","0","0","0","18","13","5","-2"
"185828","New Jersey Institute of Technology","2017","Not on tenure track/No tenure system system total","115","78","37","0","0","0","10","7","3","6","4","2","4","4","0","0","0","0","83","51","32","0","0","0","8","8","0","4","4","0","-2"
"185828","New Jersey Institute of Technology","2017","Not on tenure/no tenure system, lecturers","115","78","37","0","0","0","10","7","3","6","4","2","4","4","0","0","0","0","83","51","32","0","0","0","8","8","0","4","4","0","-2"
"186201","Ramapo College of New Jersey","2017","Tenured total","176","85","91","0","0","0","23","13","10","11","5","6","13","3","10","0","0","0","124","62","62","4","2","2","1","0","1","0","0","0","-2"
"186201","Ramapo College of New Jersey","2017","Tenured, professors","68","36","32","0","0","0","7","5","2","4","2","2","5","1","4","0","0","0","50","27","23","2","1","1","0","0","0","0","0","0","-2"
"186201","Ramapo College of New Jersey","2017","Tenured, associate professors","89","39","50","0","0","0","13","6","7","3","1","2","7","2","5","0","0","0","64","30","34","1","0","1","1","0","1","0","0","0","-2"
"186201","Ramapo College of New Jersey","2017","Tenured, assistant professors","18","10","8","0","0","0","3","2","1","4","2","2","1","0","1","0","0","0","9","5","4","1","1","0","0","0","0","0","0","0","-2"
"186201","Ramapo College of New Jersey","2017","Tenured, instructors","1","0","1","0","0","0","0","0","0","0","0","0","0","0","0","0","0","0","1","0","1","0","0","0","0","0","0","0","0","0","-2"
"186201","Ramapo College of New Jersey","2017","On-Tenure track total","27","13","14","0","0","0","9","3","6","1","0","1","1","1","0","0","0","0","14","8","6","0","0","0","1","1","0","1","0","1","-2"
"186201","Ramapo College of New Jersey","2017","On-tenure track, associate professors","2","2","0","0","0","0","1","1","0","0","0","0","1","1","0","0","0","0","0","0","0","0","0","0","0","0","0","0","0","0","-2"
"186201","Ramapo College of New Jersey","2017","On-tenure track, assistant professors","25","11","14","0","0","0","8","2","6","1","0","1","0","0","0","0","0","0","14","8","6","0","0","0","1","1","0","1","0","1","-2"
"186201","Ramapo College of New Jersey","2017","Not on tenure track/No tenure system system total","13","8","5","0","0","0","1","0","1","2","2","0","0","0","0","0","0","0","10","6","4","0","0","0","0","0","0","0","0","0","-2"
"186201","Ramapo College of New Jersey","2017","Not on tenure/no tenure system, assistant professors","13","8","5","0","0","0","1","0","1","2","2","0","0","0","0","0","0","0","10","6","4","0","0","0","0","0","0","0","0","0","-2"
"186283","Rider University","2017","Tenured total","181","102","79","0","0","0","22","11","11","6","2","4","3","1","2","0","0","0","149","87","62","0","0","0","0","0","0","1","1","0","-2"
"186283","Rider University","2017","Tenured, professors","93","54","39","0","0","0","9","5","4","3","2","1","2","1","1","0","0","0","79","46","33","0","0","0","0","0","0","0","0","0","-2"
"186283","Rider University","2017","Tenured, associate professors","88","48","40","0","0","0","13","6","7","3","0","3","1","0","1","0","0","0","70","41","29","0","0","0","0","0","0","1","1","0","-2"
"186283","Rider University","2017","On-Tenure track total","43","15","28","0","0","0","3","1","2","0","0","0","0","0","0","0","0","0","32","10","22","0","0","0","0","0","0","8","4","4","-2"
"186283","Rider University","2017","On-tenure track, associate professors","8","3","5","0","0","0","1","1","0","0","0","0","0","0","0","0","0","0","6","2","4","0","0","0","0","0","0","1","0","1","-2"
"186283","Rider University","2017","On-tenure track, assistant professors","35","12","23","0","0","0","2","0","2","0","0","0","0","0","0","0","0","0","26","8","18","0","0","0","0","0","0","7","4","3","-2"
"186283","Rider University","2017","Not on tenure track/No tenure system system total","9","3","6","0","0","0","0","0","0","0","0","0","0","0","0","0","0","0","9","3","6","0","0","0","0","0","0","0","0","0","-2"
"186283","Rider University","2017","Not on tenure/no tenure system, assistant professors","8","2","6","0","0","0","0","0","0","0","0","0","0","0","0","0","0","0","8","2","6","0","0","0","0","0","0","0","0","0","-2"
"186283","Rider University","2017","Not on tenure/no tenure system, instructors","1","1","0","0","0","0","0","0","0","0","0","0","0","0","0","0","0","0","1","1","0","0","0","0","0","0","0","0","0","0","-2"
"186371","Rutgers University-Camden","2017","Tenured total","163","104","59","0","0","0","24","22","2","4","2","2","3","1","2","0","0","0","110","68","42","0","0","0","12","6","6","10","5","5","-2"
"186371","Rutgers University-Camden","2017","Tenured, professors","94","63","31","0","0","0","12","12","0","2","0","2","2","1","1","0","0","0","68","44","24","0","0","0","5","2","3","5","4","1","-2"
"186371","Rutgers University-Camden","2017","Tenured, associate professors","69","41","28","0","0","0","12","10","2","2","2","0","1","0","1","0","0","0","42","24","18","0","0","0","7","4","3","5","1","4","-2"
"186371","Rutgers University-Camden","2017","On-Tenure track total","76","32","44","0","0","0","3","1","2","8","1","7","3","2","1","0","0","0","18","7","11","0","0","0","27","12","15","17","9","8","-2"
"186371","Rutgers University-Camden","2017","On-tenure track, professors","2","0","2","0","0","0","0","0","0","0","0","0","0","0","0","0","0","0","1","0","1","0","0","0","1","0","1","0","0","0","-2"
"186371","Rutgers University-Camden","2017","On-tenure track, associate professors","4","0","4","0","0","0","0","0","0","1","0","1","0","0","0","0","0","0","1","0","1","0","0","0","2","0","2","0","0","0","-2"
"186371","Rutgers University-Camden","2017","On-tenure track, assistant professors","70","32","38","0","0","0","3","1","2","7","1","6","3","2","1","0","0","0","16","7","9","0","0","0","24","12","12","17","9","8","-2"
"186371","Rutgers University-Camden","2017","Not on tenure track/No tenure system system total","76","31","45","0","0","0","3","2","1","3","3","0","1","1","0","0","0","0","45","10","35","1","1","0","19","10","9","4","4","0","-2"
"186371","Rutgers University-Camden","2017","Not on tenure/no tenure system, professors","12","3","9","0","0","0","0","0","0","1","1","0","0","0","0","0","0","0","9","1","8","0","0","0","1","0","1","1","1","0","-2"
"186371","Rutgers University-Camden","2017","Not on tenure/no tenure system, associate professors","9","4","5","0","0","0","1","1","0","0","0","0","0","0","0","0","0","0","6","2","4","0","0","0","2","1","1","0","0","0","-2"
"186371","Rutgers University-Camden","2017","Not on tenure/no tenure system, assistant professors","34","13","21","0","0","0","1","1","0","2","2","0","0","0","0","0","0","0","20","4","16","1","1","0","8","3","5","2","2","0","-2"
"186371","Rutgers University-Camden","2017","Not on tenure/no tenure system, instructors","18","10","8","0","0","0","1","0","1","0","0","0","0","0","0","0","0","0","9","3","6","0","0","0","7","6","1","1","1","0","-2"
"186371","Rutgers University-Camden","2017","Not on tenure/no tenure system, lecturers","3","1","2","0","0","0","0","0","0","0","0","0","1","1","0","0","0","0","1","0","1","0","0","0","1","0","1","0","0","0","-2"
"186584","Seton Hall University","2017","Tenured total","231","134","97","0","0","0","24","12","12","8","4","4","10","7","3","0","0","0","184","108","76","0","0","0","3","1","2","2","2","0","-2"
"186584","Seton Hall University","2017","Tenured, professors","102","62","40","0","0","0","9","6","3","4","2","2","5","3","2","0","0","0","83","51","32","0","0","0","1","0","1","0","0","0","-2"
"186584","Seton Hall University","2017","Tenured, associate professors","127","70","57","0","0","0","15","6","9","4","2","2","5","4","1","0","0","0","99","55","44","0","0","0","2","1","1","2","2","0","-2"
"186584","Seton Hall University","2017","Tenured, assistant professors","2","2","0","0","0","0","0","0","0","0","0","0","0","0","0","0","0","0","2","2","0","0","0","0","0","0","0","0","0","0","-2"
"186584","Seton Hall University","2017","On-Tenure track total","56","27","29","1","0","1","4","2","2","3","2","1","3","1","2","0","0","0","33","15","18","0","0","0","6","4","2","6","3","3","-2"
"186584","Seton Hall University","2017","On-tenure track, associate professors","6","3","3","0","0","0","0","0","0","0","0","0","0","0","0","0","0","0","5","2","3","0","0","0","1","1","0","0","0","0","-2"
"186584","Seton Hall University","2017","On-tenure track, assistant professors","50","24","26","1","0","1","4","2","2","3","2","1","3","1","2","0","0","0","28","13","15","0","0","0","5","3","2","6","3","3","-2"
"186584","Seton Hall University","2017","Not on tenure track/No tenure system system total","194","78","116","0","0","0","10","4","6","10","1","9","11","6","5","0","0","0","155","63","92","0","0","0","5","2","3","3","2","1","-2"
"186584","Seton Hall University","2017","Not on tenure/no tenure system, professors","5","3","2","0","0","0","1","1","0","0","0","0","0","0","0","0","0","0","3","1","2","0","0","0","0","0","0","1","1","0","-2"
"186584","Seton Hall University","2017","Not on tenure/no tenure system, associate professors","31","14","17","0","0","0","2","2","0","1","0","1","1","1","0","0","0","0","27","11","16","0","0","0","0","0","0","0","0","0","-2"
"186584","Seton Hall University","2017","Not on tenure/no tenure system, assistant professors","53","19","34","0","0","0","2","1","1","3","0","3","3","2","1","0","0","0","42","14","28","0","0","0","2","1","1","1","1","0","-2"
"186584","Seton Hall University","2017","Not on tenure/no tenure system, instructors","54","19","35","0","0","0","1","0","1","4","1","3","3","1","2","0","0","0","44","17","27","0","0","0","1","0","1","1","0","1","-2"
"186584","Seton Hall University","2017","Not on tenure/no tenure system, lecturers","9","3","6","0","0","0","1","0","1","0","0","0","0","0","0","0","0","0","8","3","5","0","0","0","0","0","0","0","0","0","-2"
"186584","Seton Hall University","2017","Not on tenure/no tenure system, no academic rank","42","20","22","0","0","0","3","0","3","2","0","2","4","2","2","0","0","0","31","17","14","0","0","0","2","1","1","0","0","0","-2"
"188429","Adelphi University","2017","Tenured total","214","106","108","0","0","0","31","12","19","10","2","8","9","5","4","0","0","0","163","87","76","0","0","0","1","0","1","0","0","0","-2"
"188429","Adelphi University","2017","Tenured, professors","85","51","34","0","0","0","10","5","5","2","0","2","4","2","2","0","0","0","68","44","24","0","0","0","1","0","1","0","0","0","-2"
"188429","Adelphi University","2017","Tenured, associate professors","127","54","73","0","0","0","21","7","14","8","2","6","5","3","2","0","0","0","93","42","51","0","0","0","0","0","0","0","0","0","-2"
"188429","Adelphi University","2017","Tenured, assistant professors","2","1","1","0","0","0","0","0","0","0","0","0","0","0","0","0","0","0","2","1","1","0","0","0","0","0","0","0","0","0","-2"
"188429","Adelphi University","2017","On-Tenure track total","67","32","35","0","0","0","10","3","7","4","0","4","7","3","4","0","0","0","42","25","17","2","1","1","2","0","2","0","0","0","-2"
"188429","Adelphi University","2017","On-tenure track, professors","1","0","1","0","0","0","0","0","0","0","0","0","0","0","0","0","0","0","1","0","1","0","0","0","0","0","0","0","0","0","-2"
"188429","Adelphi University","2017","On-tenure track, associate professors","2","2","0","0","0","0","0","0","0","0","0","0","0","0","0","0","0","0","1","1","0","1","1","0","0","0","0","0","0","0","-2"
"188429","Adelphi University","2017","On-tenure track, assistant professors","64","30","34","0","0","0","10","3","7","4","0","4","7","3","4","0","0","0","40","24","16","1","0","1","2","0","2","0","0","0","-2"
"188429","Adelphi University","2017","Not on tenure track/No tenure system system total","54","16","38","0","0","0","3","1","2","2","1","1","3","1","2","0","0","0","44","13","31","2","0","2","0","0","0","0","0","0","-2"
"188429","Adelphi University","2017","Not on tenure/no tenure system, instructors","6","1","5","0","0","0","1","1","0","0","0","0","0","0","0","0","0","0","5","0","5","0","0","0","0","0","0","0","0","0","-2"
"188429","Adelphi University","2017","Not on tenure/no tenure system, lecturers","15","5","10","0","0","0","1","0","1","0","0","0","1","0","1","0","0","0","12","5","7","1","0","1","0","0","0","0","0","0","-2"
"188429","Adelphi University","2017","Not on tenure/no tenure system, no academic rank","33","10","23","0","0","0","1","0","1","2","1","1","2","1","1","0","0","0","27","8","19","1","0","1","0","0","0","0","0","0","-2"
"190248","Concordia College","2017","Not on tenure track/No tenure system system total","49","13","36","0","0","0","3","1","2","3","0","3","1","0","1","0","0","0","42","12","30","0","0","0","0","0","0","0","0","0","-2"
"190248","Concordia College","2017","Not on tenure/no tenure system, professors","10","4","6","0","0","0","1","1","0","1","0","1","0","0","0","0","0","0","8","3","5","0","0","0","0","0","0","0","0","0","-2"
"190248","Concordia College","2017","Not on tenure/no tenure system, associate professors","9","3","6","0","0","0","0","0","0","0","0","0","0","0","0","0","0","0","9","3","6","0","0","0","0","0","0","0","0","0","-2"
"190248","Concordia College","2017","Not on tenure/no tenure system, assistant professors","27","6","21","0","0","0","2","0","2","2","0","2","1","0","1","0","0","0","22","6","16","0","0","0","0","0","0","0","0","0","-2"
"190248","Concordia College","2017","Not on tenure/no tenure system, instructors","3","0","3","0","0","0","0","0","0","0","0","0","0","0","0","0","0","0","3","0","3","0","0","0","0","0","0","0","0","0","-2"
"190503","Culinary Institute of America","2017","Not on tenure track/No tenure system system total","142","102","40","2","2","0","3","1","2","1","0","1","4","2","2","4","3","1","119","87","32","6","6","0","3","1","2","0","0","0","-2"
"190503","Culinary Institute of America","2017","Not on tenure/no tenure system, professors","37","27","10","0","0","0","2","0","2","0","0","0","0","0","0","1","1","0","31","24","7","1","1","0","2","1","1","0","0","0","-2"
"190503","Culinary Institute of America","2017","Not on tenure/no tenure system, associate professors","52","37","15","1","1","0","1","1","0","1","0","1","2","2","0","0","0","0","46","32","14","1","1","0","0","0","0","0","0","0","-2"
"190503","Culinary Institute of America","2017","Not on tenure/no tenure system, assistant professors","24","19","5","0","0","0","0","0","0","0","0","0","0","0","0","0","0","0","22","18","4","1","1","0","1","0","1","0","0","0","-2"
"190503","Culinary Institute of America","2017","Not on tenure/no tenure system, instructors","29","19","10","1","1","0","0","0","0","0","0","0","2","0","2","3","2","1","20","13","7","3","3","0","0","0","0","0","0","0","-2"
"190512","CUNY Bernard M Baruch College","2017","Tenured total","334","211","123","0","0","0","40","29","11","16","7","9","12","4","8","0","0","0","242","154","88","1","1","0","0","0","0","23","16","7","-2"
"190512","CUNY Bernard M Baruch College","2017","Tenured, professors","179","120","59","0","0","0","21","17","4","4","2","2","7","2","5","0","0","0","143","95","48","0","0","0","0","0","0","4","4","0","-2"
"190512","CUNY Bernard M Baruch College","2017","Tenured, associate professors","124","72","52","0","0","0","17","10","7","9","5","4","1","1","0","0","0","0","77","43","34","1","1","0","0","0","0","19","12","7","-2"
"190512","CUNY Bernard M Baruch College","2017","Tenured, assistant professors","6","4","2","0","0","0","1","1","0","0","0","0","1","0","1","0","0","0","4","3","1","0","0","0","0","0","0","0","0","0","-2"
"190512","CUNY Bernard M Baruch College","2017","Tenured, lecturers","25","15","10","0","0","0","1","1","0","3","0","3","3","1","2","0","0","0","18","13","5","0","0","0","0","0","0","0","0","0","-2"
"190512","CUNY Bernard M Baruch College","2017","On-Tenure track total","121","68","53","0","0","0","8","5","3","6","4","2","5","2","3","0","0","0","65","34","31","1","1","0","1","0","1","35","22","13","-2"
"190512","CUNY Bernard M Baruch College","2017","On-tenure track, associate professors","4","3","1","0","0","0","1","0","1","0","0","0","1","1","0","0","0","0","2","2","0","0","0","0","0","0","0","0","0","0","-2"
"190512","CUNY Bernard M Baruch College","2017","On-tenure track, assistant professors","99","56","43","0","0","0","7","5","2","3","3","0","3","1","2","0","0","0","50","24","26","1","1","0","0","0","0","35","22","13","-2"
"190512","CUNY Bernard M Baruch College","2017","On-tenure track, lecturers","18","9","9","0","0","0","0","0","0","3","1","2","1","0","1","0","0","0","13","8","5","0","0","0","1","0","1","0","0","0","-2"
"190512","CUNY Bernard M Baruch College","2017","Not on tenure track/No tenure system system total","24","11","13","0","0","0","1","0","1","1","0","1","2","0","2","0","0","0","16","10","6","0","0","0","0","0","0","4","1","3","-2"
"190512","CUNY Bernard M Baruch College","2017","Not on tenure/no tenure system, professors","13","10","3","0","0","0","0","0","0","1","0","1","0","0","0","0","0","0","12","10","2","0","0","0","0","0","0","0","0","0","-2"
"190512","CUNY Bernard M Baruch College","2017","Not on tenure/no tenure system, assistant professors","7","1","6","0","0","0","1","0","1","0","0","0","2","0","2","0","0","0","2","0","2","0","0","0","0","0","0","2","1","1","-2"
"190512","CUNY Bernard M Baruch College","2017","Not on tenure/no tenure system, instructors","1","0","1","0","0","0","0","0","0","0","0","0","0","0","0","0","0","0","0","0","0","0","0","0","0","0","0","1","0","1","-2"
"190512","CUNY Bernard M Baruch College","2017","Not on tenure/no tenure system, lecturers","3","0","3","0","0","0","0","0","0","0","0","0","0","0","0","0","0","0","2","0","2","0","0","0","0","0","0","1","0","1","-2"
"190549","CUNY Brooklyn College","2017","Tenured total","384","219","165","1","0","1","43","24","19","23","14","9","22","9","13","0","0","0","281","163","118","1","1","0","0","0","0","13","8","5","-2"
"190549","CUNY Brooklyn College","2017","Tenured, professors","195","124","71","1","0","1","12","11","1","8","4","4","9","4","5","0","0","0","162","103","59","0","0","0","0","0","0","3","2","1","-2"
"190549","CUNY Brooklyn College","2017","Tenured, associate professors","149","75","74","0","0","0","27","11","16","11","9","2","11","4","7","0","0","0","91","45","46","1","1","0","0","0","0","8","5","3","-2"
"190549","CUNY Brooklyn College","2017","Tenured, assistant professors","21","11","10","0","0","0","3","2","1","3","0","3","1","0","1","0","0","0","12","8","4","0","0","0","0","0","0","2","1","1","-2"
"190549","CUNY Brooklyn College","2017","Tenured, lecturers","19","9","10","0","0","0","1","0","1","1","1","0","1","1","0","0","0","0","16","7","9","0","0","0","0","0","0","0","0","0","-2"
"190549","CUNY Brooklyn College","2017","On-Tenure track total","105","51","54","0","0","0","12","4","8","7","6","1","9","4","5","0","0","0","66","32","34","2","0","2","0","0","0","9","5","4","-2"
"190549","CUNY Brooklyn College","2017","On-tenure track, associate professors","7","5","2","0","0","0","1","0","1","0","0","0","0","0","0","0","0","0","4","3","1","0","0","0","0","0","0","2","2","0","-2"
"190549","CUNY Brooklyn College","2017","On-tenure track, assistant professors","89","41","48","0","0","0","11","4","7","6","5","1","9","4","5","0","0","0","55","25","30","1","0","1","0","0","0","7","3","4","-2"
"190549","CUNY Brooklyn College","2017","On-tenure track, lecturers","9","5","4","0","0","0","0","0","0","1","1","0","0","0","0","0","0","0","7","4","3","1","0","1","0","0","0","0","0","0","-2"
"190549","CUNY Brooklyn College","2017","Not on tenure track/No tenure system system total","35","13","22","0","0","0","4","1","3","5","3","2","0","0","0","0","0","0","25","9","16","0","0","0","0","0","0","1","0","1","-2"
"190549","CUNY Brooklyn College","2017","Not on tenure/no tenure system, professors","6","2","4","0","0","0","1","0","1","0","0","0","0","0","0","0","0","0","5","2","3","0","0","0","0","0","0","0","0","0","-2"
"190549","CUNY Brooklyn College","2017","Not on tenure/no tenure system, assistant professors","1","1","0","0","0","0","0","0","0","0","0","0","0","0","0","0","0","0","1","1","0","0","0","0","0","0","0","0","0","0","-2"
"190549","CUNY Brooklyn College","2017","Not on tenure/no tenure system, lecturers","28","10","18","0","0","0","3","1","2","5","3","2","0","0","0","0","0","0","19","6","13","0","0","0","0","0","0","1","0","1","-2"
"190646","CUNY Medgar Evers College","2017","Tenured total","107","61","46","0","0","0","11","6","5","74","44","30","5","2","3","0","0","0","13","7","6","2","2","0","0","0","0","2","0","2","-2"
"190646","CUNY Medgar Evers College","2017","Tenured, professors","43","27","16","0","0","0","8","5","3","26","16","10","1","1","0","0","0","0","7","4","3","1","1","0","0","0","0","0","0","0","-2"
"190646","CUNY Medgar Evers College","2017","Tenured, associate professors","22","8","14","0","0","0","1","0","1","13","6","7","2","0","2","0","0","0","4","2","2","0","0","0","0","0","0","2","0","2","-2"
"190646","CUNY Medgar Evers College","2017","Tenured, assistant professors","12","6","6","0","0","0","1","1","0","8","3","5","1","1","0","0","0","0","1","0","1","1","1","0","0","0","0","0","0","0","-2"
"190646","CUNY Medgar Evers College","2017","Tenured, lecturers","30","20","10","0","0","0","1","0","1","27","19","8","1","0","1","0","0","0","1","1","0","0","0","0","0","0","0","0","0","0","-2"
"190646","CUNY Medgar Evers College","2017","On-Tenure track total","49","25","24","0","0","0","6","3","3","27","11","16","3","3","0","0","0","0","8","6","2","2","0","2","1","1","0","2","1","1","-2"
"190646","CUNY Medgar Evers College","2017","On-tenure track, professors","2","2","0","0","0","0","0","0","0","1","1","0","0","0","0","0","0","0","1","1","0","0","0","0","0","0","0","0","0","0","-2"
"190646","CUNY Medgar Evers College","2017","On-tenure track, associate professors","17","11","6","0","0","0","4","2","2","8","6","2","1","1","0","0","0","0","3","2","1","1","0","1","0","0","0","0","0","0","-2"
"190646","CUNY Medgar Evers College","2017","On-tenure track, assistant professors","28","12","16","0","0","0","2","1","1","16","4","12","2","2","0","0","0","0","4","3","1","1","0","1","1","1","0","2","1","1","-2"
"190646","CUNY Medgar Evers College","2017","On-tenure track, lecturers","2","0","2","0","0","0","0","0","0","2","0","2","0","0","0","0","0","0","0","0","0","0","0","0","0","0","0","0","0","0","-2"
"190646","CUNY Medgar Evers College","2017","Not on tenure track/No tenure system system total","16","9","7","0","0","0","2","1","1","13","7","6","1","1","0","0","0","0","0","0","0","0","0","0","0","0","0","0","0","0","-2"
"190646","CUNY Medgar Evers College","2017","Not on tenure/no tenure system, professors","1","0","1","0","0","0","0","0","0","1","0","1","0","0","0","0","0","0","0","0","0","0","0","0","0","0","0","0","0","0","-2"
"190646","CUNY Medgar Evers College","2017","Not on tenure/no tenure system, assistant professors","8","3","5","0","0","0","1","0","1","6","2","4","1","1","0","0","0","0","0","0","0","0","0","0","0","0","0","0","0","0","-2"
"190646","CUNY Medgar Evers College","2017","Not on tenure/no tenure system, instructors","1","1","0","0","0","0","1","1","0","0","0","0","0","0","0","0","0","0","0","0","0","0","0","0","0","0","0","0","0","0","-2"
"190646","CUNY Medgar Evers College","2017","Not on tenure/no tenure system, lecturers","6","5","1","0","0","0","0","0","0","6","5","1","0","0","0","0","0","0","0","0","0","0","0","0","0","0","0","0","0","0","-2"
"191126","Fashion Institute of Technology","2017","Tenured total","197","89","108","0","0","0","8","5","3","9","4","5","8","4","4","0","0","0","95","38","57","0","0","0","77","38","39","0","0","0","-2"
"191126","Fashion Institute of Technology","2017","Tenured, professors","47","21","26","0","0","0","2","2","0","1","0","1","1","0","1","0","0","0","25","10","15","0","0","0","18","9","9","0","0","0","-2"
"191126","Fashion Institute of Technology","2017","Tenured, associate professors","53","29","24","0","0","0","3","3","0","2","2","0","0","0","0","0","0","0","25","8","17","0","0","0","23","16","7","0","0","0","-2"
"191126","Fashion Institute of Technology","2017","Tenured, assistant professors","71","32","39","0","0","0","2","0","2","4","1","3","5","3","2","0","0","0","35","17","18","0","0","0","25","11","14","0","0","0","-2"
"191126","Fashion Institute of Technology","2017","Tenured, no academic rank","26","7","19","0","0","0","1","0","1","2","1","1","2","1","1","0","0","0","10","3","7","0","0","0","11","2","9","0","0","0","-2"
"191126","Fashion Institute of Technology","2017","On-Tenure track total","29","9","20","0","0","0","1","0","1","1","0","1","0","0","0","0","0","0","20","6","14","0","0","0","7","3","4","0","0","0","-2"
"191126","Fashion Institute of Technology","2017","On-tenure track, professors","1","1","0","0","0","0","0","0","0","0","0","0","0","0","0","0","0","0","1","1","0","0","0","0","0","0","0","0","0","0","-2"
"191126","Fashion Institute of Technology","2017","On-tenure track, associate professors","1","0","1","0","0","0","0","0","0","0","0","0","0","0","0","0","0","0","1","0","1","0","0","0","0","0","0","0","0","0","-2"
"191126","Fashion Institute of Technology","2017","On-tenure track, assistant professors","19","6","13","0","0","0","1","0","1","0","0","0","0","0","0","0","0","0","14","5","9","0","0","0","4","1","3","0","0","0","-2"
"191126","Fashion Institute of Technology","2017","On-tenure track, no academic rank","8","2","6","0","0","0","0","0","0","1","0","1","0","0","0","0","0","0","4","0","4","0","0","0","3","2","1","0","0","0","-2"
"191241","Fordham University","2017","Tenured total","437","276","161","0","0","0","36","21","15","14","9","5","20","12","8","0","0","0","320","204","116","2","1","1","30","22","8","15","7","8","-2"
"191241","Fordham University","2017","Tenured, professors","218","151","67","0","0","0","16","12","4","6","4","2","9","5","4","0","0","0","172","118","54","1","1","0","13","10","3","1","1","0","-2"
"191241","Fordham University","2017","Tenured, associate professors","200","114","86","0","0","0","20","9","11","8","5","3","11","7","4","0","0","0","130","75","55","1","0","1","17","12","5","13","6","7","-2"
"191241","Fordham University","2017","Tenured, assistant professors","19","11","8","0","0","0","0","0","0","0","0","0","0","0","0","0","0","0","18","11","7","0","0","0","0","0","0","1","0","1","-2"
"191241","Fordham University","2017","On-Tenure track total","119","55","64","0","0","0","21","8","13","11","5","6","8","5","3","0","0","0","55","25","30","1","1","0","0","0","0","23","11","12","-2"
"191241","Fordham University","2017","On-tenure track, associate professors","15","7","8","0","0","0","2","1","1","1","1","0","1","1","0","0","0","0","8","4","4","0","0","0","0","0","0","3","0","3","-2"
"191241","Fordham University","2017","On-tenure track, assistant professors","102","46","56","0","0","0","19","7","12","10","4","6","6","3","3","0","0","0","47","21","26","1","1","0","0","0","0","19","10","9","-2"
"191241","Fordham University","2017","On-tenure track, instructors","2","2","0","0","0","0","0","0","0","0","0","0","1","1","0","0","0","0","0","0","0","0","0","0","0","0","0","1","1","0","-2"
"191241","Fordham University","2017","Not on tenure track/No tenure system system total","15","11","4","0","0","0","3","2","1","0","0","0","1","1","0","0","0","0","6","3","3","0","0","0","0","0","0","5","5","0","-2"
"191241","Fordham University","2017","Not on tenure/no tenure system, instructors","15","11","4","0","0","0","3","2","1","0","0","0","1","1","0","0","0","0","6","3","3","0","0","0","0","0","0","5","5","0","-2"
"191931","Iona College","2017","Tenured total","105","64","41","0","0","0","11","6","5","5","1","4","1","0","1","0","0","0","85","55","30","0","0","0","0","0","0","3","2","1","-2"
"191931","Iona College","2017","Tenured, professors","48","34","14","0","0","0","2","1","1","4","1","3","0","0","0","0","0","0","41","31","10","0","0","0","0","0","0","1","1","0","-2"
"191931","Iona College","2017","Tenured, associate professors","54","28","26","0","0","0","9","5","4","1","0","1","1","0","1","0","0","0","41","22","19","0","0","0","0","0","0","2","1","1","-2"
"191931","Iona College","2017","Tenured, assistant professors","3","2","1","0","0","0","0","0","0","0","0","0","0","0","0","0","0","0","3","2","1","0","0","0","0","0","0","0","0","0","-2"
"191931","Iona College","2017","On-Tenure track total","50","19","31","0","0","0","9","2","7","3","1","2","2","1","1","0","0","0","34","14","20","0","0","0","2","1","1","0","0","0","-2"
"191931","Iona College","2017","On-tenure track, assistant professors","50","19","31","0","0","0","9","2","7","3","1","2","2","1","1","0","0","0","34","14","20","0","0","0","2","1","1","0","0","0","-2"
"191931","Iona College","2017","Not on tenure track/No tenure system system total","16","10","6","0","0","0","1","0","1","1","0","1","0","0","0","0","0","0","14","10","4","0","0","0","0","0","0","0","0","0","-2"
"191931","Iona College","2017","Not on tenure/no tenure system, assistant professors","3","2","1","0","0","0","0","0","0","0","0","0","0","0","0","0","0","0","3","2","1","0","0","0","0","0","0","0","0","0","-2"
"191931","Iona College","2017","Not on tenure/no tenure system, instructors","2","2","0","0","0","0","0","0","0","0","0","0","0","0","0","0","0","0","2","2","0","0","0","0","0","0","0","0","0","0","-2"
"191931","Iona College","2017","Not on tenure/no tenure system, lecturers","11","6","5","0","0","0","1","0","1","1","0","1","0","0","0","0","0","0","9","6","3","0","0","0","0","0","0","0","0","0","-2"
"192703","Manhattan College","2017","Tenured total","134","78","56","0","0","0","7","3","4","4","2","2","6","3","3","0","0","0","113","70","43","0","0","0","4","0","4","0","0","0","-2"
"192703","Manhattan College","2017","Tenured, professors","61","40","21","0","0","0","3","2","1","0","0","0","1","1","0","0","0","0","57","37","20","0","0","0","0","0","0","0","0","0","-2"
"192703","Manhattan College","2017","Tenured, associate professors","61","30","31","0","0","0","3","1","2","3","2","1","4","2","2","0","0","0","47","25","22","0","0","0","4","0","4","0","0","0","-2"
"192703","Manhattan College","2017","Tenured, assistant professors","12","8","4","0","0","0","1","0","1","1","0","1","1","0","1","0","0","0","9","8","1","0","0","0","0","0","0","0","0","0","-2"
"192703","Manhattan College","2017","On-Tenure track total","77","40","37","0","0","0","10","3","7","2","1","1","4","2","2","0","0","0","40","22","18","2","0","2","8","5","3","11","7","4","-2"
"192703","Manhattan College","2017","On-tenure track, professors","3","2","1","0","0","0","1","1","0","0","0","0","0","0","0","0","0","0","2","1","1","0","0","0","0","0","0","0","0","0","-2"
"192703","Manhattan College","2017","On-tenure track, associate professors","7","7","0","0","0","0","0","0","0","0","0","0","1","1","0","0","0","0","4","4","0","0","0","0","2","2","0","0","0","0","-2"
"192703","Manhattan College","2017","On-tenure track, assistant professors","67","31","36","0","0","0","9","2","7","2","1","1","3","1","2","0","0","0","34","17","17","2","0","2","6","3","3","11","7","4","-2"
"192703","Manhattan College","2017","Not on tenure track/No tenure system system total","24","12","12","0","0","0","1","0","1","0","0","0","2","1","1","0","0","0","20","11","9","0","0","0","1","0","1","0","0","0","-2"
"192703","Manhattan College","2017","Not on tenure/no tenure system, professors","2","2","0","0","0","0","0","0","0","0","0","0","0","0","0","0","0","0","2","2","0","0","0","0","0","0","0","0","0","0","-2"
"192703","Manhattan College","2017","Not on tenure/no tenure system, associate professors","1","1","0","0","0","0","0","0","0","0","0","0","0","0","0","0","0","0","1","1","0","0","0","0","0","0","0","0","0","0","-2"
"192703","Manhattan College","2017","Not on tenure/no tenure system, assistant professors","18","7","11","0","0","0","1","0","1","0","0","0","2","1","1","0","0","0","14","6","8","0","0","0","1","0","1","0","0","0","-2"
"192703","Manhattan College","2017","Not on tenure/no tenure system, instructors","3","2","1","0","0","0","0","0","0","0","0","0","0","0","0","0","0","0","3","2","1","0","0","0","0","0","0","0","0","0","-2"
"192864","Marymount Manhattan College","2017","Tenured total","65","27","38","0","0","0","4","1","3","0","0","0","0","0","0","0","0","0","54","24","30","0","0","0","7","2","5","0","0","0","-2"
"192864","Marymount Manhattan College","2017","Tenured, professors","26","10","16","0","0","0","2","0","2","0","0","0","0","0","0","0","0","0","24","10","14","0","0","0","0","0","0","0","0","0","-2"
"192864","Marymount Manhattan College","2017","Tenured, associate professors","39","17","22","0","0","0","2","1","1","0","0","0","0","0","0","0","0","0","30","14","16","0","0","0","7","2","5","0","0","0","-2"
"192864","Marymount Manhattan College","2017","On-Tenure track total","19","5","14","0","0","0","2","1","1","0","0","0","0","0","0","0","0","0","6","0","6","1","1","0","10","3","7","0","0","0","-2"
"192864","Marymount Manhattan College","2017","On-tenure track, assistant professors","17","5","12","0","0","0","2","1","1","0","0","0","0","0","0","0","0","0","5","0","5","1","1","0","9","3","6","0","0","0","-2"
"192864","Marymount Manhattan College","2017","On-tenure track, instructors","2","0","2","0","0","0","0","0","0","0","0","0","0","0","0","0","0","0","1","0","1","0","0","0","1","0","1","0","0","0","-2"
"192864","Marymount Manhattan College","2017","Not on tenure track/No tenure system system total","7","1","6","0","0","0","1","1","0","0","0","0","0","0","0","0","0","0","3","0","3","0","0","0","3","0","3","0","0","0","-2"
"192864","Marymount Manhattan College","2017","Not on tenure/no tenure system, assistant professors","4","1","3","0","0","0","1","1","0","0","0","0","0","0","0","0","0","0","3","0","3","0","0","0","0","0","0","0","0","0","-2"
"192864","Marymount Manhattan College","2017","Not on tenure/no tenure system, instructors","3","0","3","0","0","0","0","0","0","0","0","0","0","0","0","0","0","0","0","0","0","0","0","0","3","0","3","0","0","0","-2"
"193292","Molloy College","2017","Tenured total","135","36","99","0","0","0","5","1","4","12","1","11","7","4","3","0","0","0","110","30","80","1","0","1","0","0","0","0","0","0","-2"
"193292","Molloy College","2017","Tenured, professors","57","15","42","0","0","0","1","0","1","3","0","3","4","2","2","0","0","0","49","13","36","0","0","0","0","0","0","0","0","0","-2"
"193292","Molloy College","2017","Tenured, associate professors","50","15","35","0","0","0","3","1","2","6","1","5","2","2","0","0","0","0","38","11","27","1","0","1","0","0","0","0","0","0","-2"
"193292","Molloy College","2017","Tenured, assistant professors","28","6","22","0","0","0","1","0","1","3","0","3","1","0","1","0","0","0","23","6","17","0","0","0","0","0","0","0","0","0","-2"
"193292","Molloy College","2017","On-Tenure track total","59","16","43","0","0","0","6","0","6","5","0","5","1","1","0","0","0","0","46","15","31","1","0","1","0","0","0","0","0","0","-2"
"193292","Molloy College","2017","On-tenure track, associate professors","6","4","2","0","0","0","0","0","0","1","0","1","1","1","0","0","0","0","4","3","1","0","0","0","0","0","0","0","0","0","-2"
"193292","Molloy College","2017","On-tenure track, assistant professors","42","8","34","0","0","0","5","0","5","3","0","3","0","0","0","0","0","0","33","8","25","1","0","1","0","0","0","0","0","0","-2"
"193292","Molloy College","2017","On-tenure track, instructors","11","4","7","0","0","0","1","0","1","1","0","1","0","0","0","0","0","0","9","4","5","0","0","0","0","0","0","0","0","0","-2"
"193353","Mount Saint Mary College","2017","Tenured total","54","26","28","0","0","0","2","0","2","2","0","2","1","1","0","0","0","0","47","23","24","0","0","0","0","0","0","2","2","0","-2"
"193353","Mount Saint Mary College","2017","Tenured, professors","23","12","11","0","0","0","1","0","1","0","0","0","0","0","0","0","0","0","22","12","10","0","0","0","0","0","0","0","0","0","-2"
"193353","Mount Saint Mary College","2017","Tenured, associate professors","30","14","16","0","0","0","1","0","1","2","0","2","1","1","0","0","0","0","24","11","13","0","0","0","0","0","0","2","2","0","-2"
"193353","Mount Saint Mary College","2017","Tenured, assistant professors","1","0","1","0","0","0","0","0","0","0","0","0","0","0","0","0","0","0","1","0","1","0","0","0","0","0","0","0","0","0","-2"
"193353","Mount Saint Mary College","2017","On-Tenure track total","27","9","18","0","0","0","3","1","2","1","0","1","0","0","0","0","0","0","22","8","14","0","0","0","0","0","0","1","0","1","-2"
"193353","Mount Saint Mary College","2017","On-tenure track, assistant professors","22","9","13","0","0","0","3","1","2","0","0","0","0","0","0","0","0","0","18","8","10","0","0","0","0","0","0","1","0","1","-2"
"193353","Mount Saint Mary College","2017","On-tenure track, instructors","5","0","5","0","0","0","0","0","0","1","0","1","0","0","0","0","0","0","4","0","4","0","0","0","0","0","0","0","0","0","-2"
"193353","Mount Saint Mary College","2017","Not on tenure track/No tenure system system total","9","4","5","0","0","0","0","0","0","0","0","0","1","1","0","0","0","0","8","3","5","0","0","0","0","0","0","0","0","0","-2"
"193353","Mount Saint Mary College","2017","Not on tenure/no tenure system, associate professors","1","0","1","0","0","0","0","0","0","0","0","0","0","0","0","0","0","0","1","0","1","0","0","0","0","0","0","0","0","0","-2"
"193353","Mount Saint Mary College","2017","Not on tenure/no tenure system, assistant professors","6","3","3","0","0","0","0","0","0","0","0","0","1","1","0","0","0","0","5","2","3","0","0","0","0","0","0","0","0","0","-2"
"193353","Mount Saint Mary College","2017","Not on tenure/no tenure system, instructors","2","1","1","0","0","0","0","0","0","0","0","0","0","0","0","0","0","0","2","1","1","0","0","0","0","0","0","0","0","0","-2"
"194091","New York Institute of Technology","2017","Tenured total","154","95","59","1","1","0","31","17","14","3","2","1","2","2","0","0","0","0","117","73","44","0","0","0","0","0","0","0","0","0","-2"
"194091","New York Institute of Technology","2017","Tenured, professors","58","47","11","1","1","0","11","7","4","2","2","0","0","0","0","0","0","0","44","37","7","0","0","0","0","0","0","0","0","0","-2"
"194091","New York Institute of Technology","2017","Tenured, associate professors","87","46","41","0","0","0","20","10","10","0","0","0","1","1","0","0","0","0","66","35","31","0","0","0","0","0","0","0","0","0","-2"
"194091","New York Institute of Technology","2017","Tenured, assistant professors","9","2","7","0","0","0","0","0","0","1","0","1","1","1","0","0","0","0","7","1","6","0","0","0","0","0","0","0","0","0","-2"
"194091","New York Institute of Technology","2017","On-Tenure track total","71","45","26","0","0","0","20","12","8","2","2","0","1","1","0","0","0","0","48","30","18","0","0","0","0","0","0","0","0","0","-2"
"194091","New York Institute of Technology","2017","On-tenure track, professors","1","1","0","0","0","0","0","0","0","0","0","0","0","0","0","0","0","0","1","1","0","0","0","0","0","0","0","0","0","0","-2"
"194091","New York Institute of Technology","2017","On-tenure track, associate professors","11","7","4","0","0","0","0","0","0","1","1","0","1","1","0","0","0","0","9","5","4","0","0","0","0","0","0","0","0","0","-2"
"194091","New York Institute of Technology","2017","On-tenure track, assistant professors","59","37","22","0","0","0","20","12","8","1","1","0","0","0","0","0","0","0","38","24","14","0","0","0","0","0","0","0","0","0","-2"
"194091","New York Institute of Technology","2017","Not on tenure track/No tenure system system total","103","58","45","0","0","0","14","10","4","6","1","5","4","2","2","0","0","0","78","44","34","1","1","0","0","0","0","0","0","0","-2"
"194091","New York Institute of Technology","2017","Not on tenure/no tenure system, professors","10","8","2","0","0","0","0","0","0","0","0","0","1","1","0","0","0","0","9","7","2","0","0","0","0","0","0","0","0","0","-2"
"194091","New York Institute of Technology","2017","Not on tenure/no tenure system, associate professors","38","24","14","0","0","0","8","6","2","1","1","0","1","0","1","0","0","0","28","17","11","0","0","0","0","0","0","0","0","0","-2"
"194091","New York Institute of Technology","2017","Not on tenure/no tenure system, assistant professors","51","24","27","0","0","0","4","3","1","4","0","4","2","1","1","0","0","0","40","19","21","1","1","0","0","0","0","0","0","0","-2"
"194091","New York Institute of Technology","2017","Not on tenure/no tenure system, instructors","4","2","2","0","0","0","2","1","1","1","0","1","0","0","0","0","0","0","1","1","0","0","0","0","0","0","0","0","0","0","-2"
"195243","St. Thomas Aquinas College","2017","Tenured total","35","16","19","0","0","0","1","0","1","0","0","0","0","0","0","0","0","0","34","16","18","0","0","0","0","0","0","0","0","0","-2"
"195243","St. Thomas Aquinas College","2017","Tenured, professors","20","8","12","0","0","0","1","0","1","0","0","0","0","0","0","0","0","0","19","8","11","0","0","0","0","0","0","0","0","0","-2"
"195243","St. Thomas Aquinas College","2017","Tenured, associate professors","13","7","6","0","0","0","0","0","0","0","0","0","0","0","0","0","0","0","13","7","6","0","0","0","0","0","0","0","0","0","-2"
"195243","St. Thomas Aquinas College","2017","Tenured, assistant professors","2","1","1","0","0","0","0","0","0","0","0","0","0","0","0","0","0","0","2","1","1","0","0","0","0","0","0","0","0","0","-2"
"195243","St. Thomas Aquinas College","2017","On-Tenure track total","13","4","9","0","0","0","1","0","1","0","0","0","0","0","0","0","0","0","12","4","8","0","0","0","0","0","0","0","0","0","-2"
"195243","St. Thomas Aquinas College","2017","On-tenure track, assistant professors","13","4","9","0","0","0","1","0","1","0","0","0","0","0","0","0","0","0","12","4","8","0","0","0","0","0","0","0","0","0","-2"
"195243","St. Thomas Aquinas College","2017","Not on tenure track/No tenure system system total","4","1","3","0","0","0","0","0","0","0","0","0","0","0","0","0","0","0","4","1","3","0","0","0","0","0","0","0","0","0","-2"
"195243","St. Thomas Aquinas College","2017","Not on tenure/no tenure system, instructors","4","1","3","0","0","0","0","0","0","0","0","0","0","0","0","0","0","0","4","1","3","0","0","0","0","0","0","0","0","0","-2"
"195562","St. Joseph's College-Long Island","2017","Tenured total","46","16","30","0","0","0","1","0","1","1","0","1","1","0","1","0","0","0","42","16","26","0","0","0","1","0","1","0","0","0","-2"
"195562","St. Joseph's College-Long Island","2017","Tenured, professors","22","10","12","0","0","0","0","0","0","1","0","1","0","0","0","0","0","0","21","10","11","0","0","0","0","0","0","0","0","0","-2"
"195562","St. Joseph's College-Long Island","2017","Tenured, associate professors","24","6","18","0","0","0","1","0","1","0","0","0","1","0","1","0","0","0","21","6","15","0","0","0","1","0","1","0","0","0","-2"
"195562","St. Joseph's College-Long Island","2017","On-Tenure track total","53","21","32","1","0","1","2","1","1","0","0","0","0","0","0","0","0","0","43","17","26","0","0","0","7","3","4","0","0","0","-2"
"195562","St. Joseph's College-Long Island","2017","On-tenure track, associate professors","12","6","6","0","0","0","1","1","0","0","0","0","0","0","0","0","0","0","9","3","6","0","0","0","2","2","0","0","0","0","-2"
"195562","St. Joseph's College-Long Island","2017","On-tenure track, assistant professors","40","15","25","0","0","0","1","0","1","0","0","0","0","0","0","0","0","0","34","14","20","0","0","0","5","1","4","0","0","0","-2"
"195562","St. Joseph's College-Long Island","2017","On-tenure track, instructors","1","0","1","1","0","1","0","0","0","0","0","0","0","0","0","0","0","0","0","0","0","0","0","0","0","0","0","0","0","0","-2"
"195562","St. Joseph's College-Long Island","2017","Not on tenure track/No tenure system system total","7","3","4","0","0","0","0","0","0","1","0","1","0","0","0","1","1","0","5","2","3","0","0","0","0","0","0","0","0","0","-2"
"195562","St. Joseph's College-Long Island","2017","Not on tenure/no tenure system, instructors","2","0","2","0","0","0","0","0","0","1","0","1","0","0","0","0","0","0","1","0","1","0","0","0","0","0","0","0","0","0","-2"
"195562","St. Joseph's College-Long Island","2017","Not on tenure/no tenure system, lecturers","5","3","2","0","0","0","0","0","0","0","0","0","0","0","0","1","1","0","4","2","2","0","0","0","0","0","0","0","0","0","-2"
"196024","SUNY College of Technology at Delhi","2017","Tenured total","62","35","27","0","0","0","1","0","1","1","0","1","1","1","0","0","0","0","59","34","25","0","0","0","0","0","0","0","0","0","-2"
"196024","SUNY College of Technology at Delhi","2017","Tenured, professors","27","16","11","0","0","0","0","0","0","0","0","0","0","0","0","0","0","0","27","16","11","0","0","0","0","0","0","0","0","0","-2"
"196024","SUNY College of Technology at Delhi","2017","Tenured, associate professors","19","10","9","0","0","0","1","0","1","1","0","1","1","1","0","0","0","0","16","9","7","0","0","0","0","0","0","0","0","0","-2"
"196024","SUNY College of Technology at Delhi","2017","Tenured, assistant professors","12","7","5","0","0","0","0","0","0","0","0","0","0","0","0","0","0","0","12","7","5","0","0","0","0","0","0","0","0","0","-2"
"196024","SUNY College of Technology at Delhi","2017","Tenured, instructors","4","2","2","0","0","0","0","0","0","0","0","0","0","0","0","0","0","0","4","2","2","0","0","0","0","0","0","0","0","0","-2"
"196024","SUNY College of Technology at Delhi","2017","On-Tenure track total","85","43","42","0","0","0","4","2","2","2","2","0","0","0","0","0","0","0","79","39","40","0","0","0","0","0","0","0","0","0","-2"
"196024","SUNY College of Technology at Delhi","2017","On-tenure track, professors","2","0","2","0","0","0","0","0","0","0","0","0","0","0","0","0","0","0","2","0","2","0","0","0","0","0","0","0","0","0","-2"
"196024","SUNY College of Technology at Delhi","2017","On-tenure track, associate professors","13","5","8","0","0","0","1","0","1","1","1","0","0","0","0","0","0","0","11","4","7","0","0","0","0","0","0","0","0","0","-2"
"196024","SUNY College of Technology at Delhi","2017","On-tenure track, assistant professors","53","23","30","0","0","0","3","2","1","1","1","0","0","0","0","0","0","0","49","20","29","0","0","0","0","0","0","0","0","0","-2"
"196024","SUNY College of Technology at Delhi","2017","On-tenure track, instructors","17","15","2","0","0","0","0","0","0","0","0","0","0","0","0","0","0","0","17","15","2","0","0","0","0","0","0","0","0","0","-2"
"196024","SUNY College of Technology at Delhi","2017","Not on tenure track/No tenure system system total","7","2","5","0","0","0","0","0","0","0","0","0","0","0","0","0","0","0","7","2","5","0","0","0","0","0","0","0","0","0","-2"
"196024","SUNY College of Technology at Delhi","2017","Not on tenure/no tenure system, instructors","7","2","5","0","0","0","0","0","0","0","0","0","0","0","0","0","0","0","7","2","5","0","0","0","0","0","0","0","0","0","-2"
"196042","Farmingdale State College","2017","Tenured total","102","57","45","0","0","0","11","9","2","4","2","2","5","4","1","0","0","0","82","42","40","0","0","0","0","0","0","0","0","0","-2"
"196042","Farmingdale State College","2017","Tenured, professors","52","29","23","0","0","0","7","6","1","1","1","0","2","1","1","0","0","0","42","21","21","0","0","0","0","0","0","0","0","0","-2"
"196042","Farmingdale State College","2017","Tenured, associate professors","38","20","18","0","0","0","2","1","1","3","1","2","1","1","0","0","0","0","32","17","15","0","0","0","0","0","0","0","0","0","-2"
"196042","Farmingdale State College","2017","Tenured, assistant professors","12","8","4","0","0","0","2","2","0","0","0","0","2","2","0","0","0","0","8","4","4","0","0","0","0","0","0","0","0","0","-2"
"196042","Farmingdale State College","2017","On-Tenure track total","114","56","58","0","0","0","16","7","9","9","3","6","6","4","2","0","0","0","78","38","40","3","2","1","0","0","0","2","2","0","-2"
"196042","Farmingdale State College","2017","On-tenure track, professors","2","1","1","0","0","0","1","0","1","0","0","0","0","0","0","0","0","0","1","1","0","0","0","0","0","0","0","0","0","0","-2"
"196042","Farmingdale State College","2017","On-tenure track, associate professors","9","2","7","0","0","0","2","1","1","2","0","2","1","1","0","0","0","0","4","0","4","0","0","0","0","0","0","0","0","0","-2"
"196042","Farmingdale State College","2017","On-tenure track, assistant professors","103","53","50","0","0","0","13","6","7","7","3","4","5","3","2","0","0","0","73","37","36","3","2","1","0","0","0","2","2","0","-2"
"196042","Farmingdale State College","2017","Not on tenure track/No tenure system system total","21","9","12","0","0","0","2","0","2","1","0","1","1","1","0","0","0","0","17","8","9","0","0","0","0","0","0","0","0","0","-2"
"196042","Farmingdale State College","2017","Not on tenure/no tenure system, associate professors","1","1","0","0","0","0","0","0","0","0","0","0","0","0","0","0","0","0","1","1","0","0","0","0","0","0","0","0","0","0","-2"
"196042","Farmingdale State College","2017","Not on tenure/no tenure system, assistant professors","13","5","8","0","0","0","2","0","2","0","0","0","1","1","0","0","0","0","10","4","6","0","0","0","0","0","0","0","0","0","-2"
"196042","Farmingdale State College","2017","Not on tenure/no tenure system, lecturers","7","3","4","0","0","0","0","0","0","1","0","1","0","0","0","0","0","0","6","3","3","0","0","0","0","0","0","0","0","0","-2"
"196176","State University of New York at New Paltz","2017","Tenured total","195","107","88","0","0","0","18","12","6","7","7","0","9","6","3","0","0","0","161","82","79","0","0","0","0","0","0","0","0","0","-2"
"196176","State University of New York at New Paltz","2017","Tenured, professors","50","30","20","0","0","0","9","6","3","1","1","0","1","1","0","0","0","0","39","22","17","0","0","0","0","0","0","0","0","0","-2"
"196176","State University of New York at New Paltz","2017","Tenured, associate professors","137","74","63","0","0","0","9","6","3","5","5","0","8","5","3","0","0","0","115","58","57","0","0","0","0","0","0","0","0","0","-2"
"196176","State University of New York at New Paltz","2017","Tenured, assistant professors","5","3","2","0","0","0","0","0","0","1","1","0","0","0","0","0","0","0","4","2","2","0","0","0","0","0","0","0","0","0","-2"
"196176","State University of New York at New Paltz","2017","Tenured, instructors","3","0","3","0","0","0","0","0","0","0","0","0","0","0","0","0","0","0","3","0","3","0","0","0","0","0","0","0","0","0","-2"
"196176","State University of New York at New Paltz","2017","On-Tenure track total","95","37","58","0","0","0","11","7","4","7","2","5","7","2","5","0","0","0","61","22","39","3","1","2","0","0","0","6","3","3","-2"
"196176","State University of New York at New Paltz","2017","On-tenure track, associate professors","8","4","4","0","0","0","1","1","0","1","1","0","0","0","0","0","0","0","4","2","2","1","0","1","0","0","0","1","0","1","-2"
"196176","State University of New York at New Paltz","2017","On-tenure track, assistant professors","82","32","50","0","0","0","10","6","4","6","1","5","6","2","4","0","0","0","53","19","34","2","1","1","0","0","0","5","3","2","-2"
"196176","State University of New York at New Paltz","2017","On-tenure track, instructors","5","1","4","0","0","0","0","0","0","0","0","0","1","0","1","0","0","0","4","1","3","0","0","0","0","0","0","0","0","0","-2"
"196176","State University of New York at New Paltz","2017","Not on tenure track/No tenure system system total","61","28","33","0","0","0","4","4","0","0","0","0","3","0","3","0","0","0","50","22","28","0","0","0","0","0","0","4","2","2","-2"
"196176","State University of New York at New Paltz","2017","Not on tenure/no tenure system, assistant professors","4","3","1","0","0","0","1","1","0","0","0","0","0","0","0","0","0","0","2","1","1","0","0","0","0","0","0","1","1","0","-2"
"196176","State University of New York at New Paltz","2017","Not on tenure/no tenure system, lecturers","57","25","32","0","0","0","3","3","0","0","0","0","3","0","3","0","0","0","48","21","27","0","0","0","0","0","0","3","1","2","-2"
"197230","Wells College","2017","Tenured total","23","11","12","0","0","0","0","0","0","1","1","0","1","0","1","2","1","1","19","9","10","0","0","0","0","0","0","0","0","0","-2"
"197230","Wells College","2017","Tenured, professors","14","8","6","0","0","0","0","0","0","1","1","0","1","0","1","1","1","0","11","6","5","0","0","0","0","0","0","0","0","0","-2"
"197230","Wells College","2017","Tenured, associate professors","9","3","6","0","0","0","0","0","0","0","0","0","0","0","0","1","0","1","8","3","5","0","0","0","0","0","0","0","0","0","-2"
"197230","Wells College","2017","On-Tenure track total","10","4","6","0","0","0","0","0","0","0","0","0","0","0","0","1","1","0","8","2","6","1","1","0","0","0","0","0","0","0","-2"
"197230","Wells College","2017","On-tenure track, assistant professors","10","4","6","0","0","0","0","0","0","0","0","0","0","0","0","1","1","0","8","2","6","1","1","0","0","0","0","0","0","0","-2"
"197230","Wells College","2017","Not on tenure track/No tenure system system total","8","2","6","0","0","0","0","0","0","0","0","0","1","1","0","0","0","0","6","1","5","0","0","0","0","0","0","1","0","1","-2"
"197230","Wells College","2017","Not on tenure/no tenure system, assistant professors","4","1","3","0","0","0","0","0","0","0","0","0","1","1","0","0","0","0","2","0","2","0","0","0","0","0","0","1","0","1","-2"
"197230","Wells College","2017","Not on tenure/no tenure system, instructors","2","1","1","0","0","0","0","0","0","0","0","0","0","0","0","0","0","0","2","1","1","0","0","0","0","0","0","0","0","0","-2"
"197230","Wells College","2017","Not on tenure/no tenure system, lecturers","2","0","2","0","0","0","0","0","0","0","0","0","0","0","0","0","0","0","2","0","2","0","0","0","0","0","0","0","0","0","-2"
"199607","Salem College","2017","Tenured total","27","9","18","0","0","0","1","1","0","1","0","1","1","0","1","0","0","0","24","8","16","0","0","0","0","0","0","0","0","0","-2"
"199607","Salem College","2017","Tenured, professors","10","2","8","0","0","0","0","0","0","0","0","0","0","0","0","0","0","0","10","2","8","0","0","0","0","0","0","0","0","0","-2"
"199607","Salem College","2017","Tenured, associate professors","16","6","10","0","0","0","1","1","0","1","0","1","1","0","1","0","0","0","13","5","8","0","0","0","0","0","0","0","0","0","-2"
"199607","Salem College","2017","Tenured, assistant professors","1","1","0","0","0","0","0","0","0","0","0","0","0","0","0","0","0","0","1","1","0","0","0","0","0","0","0","0","0","0","-2"
"199607","Salem College","2017","On-Tenure track total","15","2","13","0","0","0","0","0","0","1","0","1","1","0","1","0","0","0","13","2","11","0","0","0","0","0","0","0","0","0","-2"
"199607","Salem College","2017","On-tenure track, associate professors","1","0","1","0","0","0","0","0","0","0","0","0","0","0","0","0","0","0","1","0","1","0","0","0","0","0","0","0","0","0","-2"
"199607","Salem College","2017","On-tenure track, assistant professors","14","2","12","0","0","0","0","0","0","1","0","1","1","0","1","0","0","0","12","2","10","0","0","0","0","0","0","0","0","0","-2"
"199607","Salem College","2017","Not on tenure track/No tenure system system total","17","0","17","0","0","0","1","0","1","2","0","2","0","0","0","0","0","0","14","0","14","0","0","0","0","0","0","0","0","0","-2"
"199607","Salem College","2017","Not on tenure/no tenure system, associate professors","5","0","5","0","0","0","0","0","0","1","0","1","0","0","0","0","0","0","4","0","4","0","0","0","0","0","0","0","0","0","-2"
"199607","Salem College","2017","Not on tenure/no tenure system, assistant professors","10","0","10","0","0","0","1","0","1","1","0","1","0","0","0","0","0","0","8","0","8","0","0","0","0","0","0","0","0","0","-2"
"199607","Salem College","2017","Not on tenure/no tenure system, instructors","1","0","1","0","0","0","0","0","0","0","0","0","0","0","0","0","0","0","1","0","1","0","0","0","0","0","0","0","0","0","-2"
"199607","Salem College","2017","Not on tenure/no tenure system, no academic rank","1","0","1","0","0","0","0","0","0","0","0","0","0","0","0","0","0","0","1","0","1","0","0","0","0","0","0","0","0","0","-2"
"205027","Pontifical College Josephinum","2017","Not on tenure track/No tenure system system total","21","18","3","0","0","0","0","0","0","0","0","0","0","0","0","0","0","0","21","18","3","0","0","0","0","0","0","0","0","0","-2"
"205027","Pontifical College Josephinum","2017","Not on tenure/no tenure system, professors","4","4","0","0","0","0","0","0","0","0","0","0","0","0","0","0","0","0","4","4","0","0","0","0","0","0","0","0","0","0","-2"
"205027","Pontifical College Josephinum","2017","Not on tenure/no tenure system, associate professors","7","7","0","0","0","0","0","0","0","0","0","0","0","0","0","0","0","0","7","7","0","0","0","0","0","0","0","0","0","0","-2"
"205027","Pontifical College Josephinum","2017","Not on tenure/no tenure system, assistant professors","9","7","2","0","0","0","0","0","0","0","0","0","0","0","0","0","0","0","9","7","2","0","0","0","0","0","0","0","0","0","-2"
"205027","Pontifical College Josephinum","2017","Not on tenure/no tenure system, instructors","1","0","1","0","0","0","0","0","0","0","0","0","0","0","0","0","0","0","1","0","1","0","0","0","0","0","0","0","0","0","-2"
"206862","Southern Nazarene University","2017","Not on tenure track/No tenure system system total","71","38","33","3","2","1","1","1","0","0","0","0","1","1","0","0","0","0","66","34","32","0","0","0","0","0","0","0","0","0","-2"
"206862","Southern Nazarene University","2017","Not on tenure/no tenure system, professors","23","14","9","1","1","0","1","1","0","0","0","0","0","0","0","0","0","0","21","12","9","0","0","0","0","0","0","0","0","0","-2"
"206862","Southern Nazarene University","2017","Not on tenure/no tenure system, associate professors","21","11","10","2","1","1","0","0","0","0","0","0","0","0","0","0","0","0","19","10","9","0","0","0","0","0","0","0","0","0","-2"
"206862","Southern Nazarene University","2017","Not on tenure/no tenure system, assistant professors","23","10","13","0","0","0","0","0","0","0","0","0","1","1","0","0","0","0","22","9","13","0","0","0","0","0","0","0","0","0","-2"
"206862","Southern Nazarene University","2017","Not on tenure/no tenure system, instructors","3","2","1","0","0","0","0","0","0","0","0","0","0","0","0","0","0","0","3","2","1","0","0","0","0","0","0","0","0","0","-2"
"206862","Southern Nazarene University","2017","Not on tenure/no tenure system, no academic rank","1","1","0","0","0","0","0","0","0","0","0","0","0","0","0","0","0","0","1","1","0","0","0","0","0","0","0","0","0","0","-2"
"207157","Randall University","2017","Not on tenure track/No tenure system system total","17","9","8","4","2","2","0","0","0","1","1","0","1","1","0","0","0","0","11","5","6","0","0","0","0","0","0","0","0","0","-2"
"207157","Randall University","2017","Not on tenure/no tenure system, no academic rank","17","9","8","4","2","2","0","0","0","1","1","0","1","1","0","0","0","0","11","5","6","0","0","0","0","0","0","0","0","0","-2"
"207397","Oklahoma State University-Oklahoma City","2017","Tenured total","31","14","17","0","0","0","1","0","1","1","1","0","2","1","1","0","0","0","27","12","15","0","0","0","0","0","0","0","0","0","-2"
"207397","Oklahoma State University-Oklahoma City","2017","Tenured, professors","9","6","3","0","0","0","0","0","0","0","0","0","1","1","0","0","0","0","8","5","3","0","0","0","0","0","0","0","0","0","-2"
"207397","Oklahoma State University-Oklahoma City","2017","Tenured, associate professors","22","8","14","0","0","0","1","0","1","1","1","0","1","0","1","0","0","0","19","7","12","0","0","0","0","0","0","0","0","0","-2"
"207397","Oklahoma State University-Oklahoma City","2017","On-Tenure track total","48","14","34","2","0","2","0","0","0","1","0","1","1","1","0","0","0","0","42","13","29","2","0","2","0","0","0","0","0","0","-2"
"207397","Oklahoma State University-Oklahoma City","2017","On-tenure track, assistant professors","25","8","17","0","0","0","0","0","0","0","0","0","1","1","0","0","0","0","22","7","15","2","0","2","0","0","0","0","0","0","-2"
"207397","Oklahoma State University-Oklahoma City","2017","On-tenure track, instructors","23","6","17","2","0","2","0","0","0","1","0","1","0","0","0","0","0","0","20","6","14","0","0","0","0","0","0","0","0","0","-2"
"209065","Linfield University-McMinnville Campus","2017","Tenured total","95","45","50","0","0","0","5","2","3","1","1","0","3","1","2","0","0","0","86","41","45","0","0","0","0","0","0","0","0","0","209065"
"209065","Linfield University-McMinnville Campus","2017","Tenured, professors","50","26","24","0","0","0","2","1","1","1","1","0","2","1","1","0","0","0","45","23","22","0","0","0","0","0","0","0","0","0","209065"
"209065","Linfield University-McMinnville Campus","2017","Tenured, associate professors","43","18","25","0","0","0","3","1","2","0","0","0","1","0","1","0","0","0","39","17","22","0","0","0","0","0","0","0","0","0","209065"
"209065","Linfield University-McMinnville Campus","2017","Tenured, assistant professors","2","1","1","0","0","0","0","0","0","0","0","0","0","0","0","0","0","0","2","1","1","0","0","0","0","0","0","0","0","0","209065"
"209065","Linfield University-McMinnville Campus","2017","On-Tenure track total","33","13","20","0","0","0","2","1","1","1","0","1","3","1","2","1","1","0","25","9","16","0","0","0","1","1","0","0","0","0","209065"
"209065","Linfield University-McMinnville Campus","2017","On-tenure track, professors","1","0","1","0","0","0","0","0","0","0","0","0","0","0","0","0","0","0","1","0","1","0","0","0","0","0","0","0","0","0","209065"
"209065","Linfield University-McMinnville Campus","2017","On-tenure track, associate professors","3","1","2","0","0","0","1","1","0","0","0","0","0","0","0","0","0","0","2","0","2","0","0","0","0","0","0","0","0","0","209065"
"209065","Linfield University-McMinnville Campus","2017","On-tenure track, assistant professors","29","12","17","0","0","0","1","0","1","1","0","1","3","1","2","1","1","0","22","9","13","0","0","0","1","1","0","0","0","0","209065"
"209065","Linfield University-McMinnville Campus","2017","Not on tenure track/No tenure system system total","24","7","17","1","0","1","1","0","1","2","0","2","1","0","1","0","0","0","15","5","10","0","0","0","4","2","2","0","0","0","209065"
"209065","Linfield University-McMinnville Campus","2017","Not on tenure/no tenure system, professors","1","0","1","0","0","0","0","0","0","0","0","0","0","0","0","0","0","0","1","0","1","0","0","0","0","0","0","0","0","0","209065"
"209065","Linfield University-McMinnville Campus","2017","Not on tenure/no tenure system, associate professors","2","1","1","1","0","1","0","0","0","0","0","0","0","0","0","0","0","0","1","1","0","0","0","0","0","0","0","0","0","0","209065"
"209065","Linfield University-McMinnville Campus","2017","Not on tenure/no tenure system, assistant professors","21","6","15","0","0","0","1","0","1","2","0","2","1","0","1","0","0","0","13","4","9","0","0","0","4","2","2","0","0","0","209065"
"209287","Multnomah University","2017","Tenured total","3","3","0","0","0","0","0","0","0","0","0","0","0","0","0","0","0","0","3","3","0","0","0","0","0","0","0","0","0","0","-2"
"209287","Multnomah University","2017","Tenured, professors","3","3","0","0","0","0","0","0","0","0","0","0","0","0","0","0","0","0","3","3","0","0","0","0","0","0","0","0","0","0","-2"
"209287","Multnomah University","2017","Not on tenure track/No tenure system system total","25","17","8","0","0","0","2","1","1","1","0","1","0","0","0","0","0","0","22","16","6","0","0","0","0","0","0","0","0","0","-2"
"209287","Multnomah University","2017","Not on tenure/no tenure system, professors","5","5","0","0","0","0","0","0","0","0","0","0","0","0","0","0","0","0","5","5","0","0","0","0","0","0","0","0","0","0","-2"
"209287","Multnomah University","2017","Not on tenure/no tenure system, associate professors","6","5","1","0","0","0","1","1","0","0","0","0","0","0","0","0","0","0","5","4","1","0","0","0","0","0","0","0","0","0","-2"
"209287","Multnomah University","2017","Not on tenure/no tenure system, assistant professors","12","7","5","0","0","0","1","0","1","0","0","0","0","0","0","0","0","0","11","7","4","0","0","0","0","0","0","0","0","0","-2"
"209287","Multnomah University","2017","Not on tenure/no tenure system, instructors","2","0","2","0","0","0","0","0","0","1","0","1","0","0","0","0","0","0","1","0","1","0","0","0","0","0","0","0","0","0","-2"
"209490","Oregon Health & Science University","2017","Tenured total","104","66","38","0","0","0","13","10","3","0","0","0","2","1","1","0","0","0","82","50","32","0","0","0","6","4","2","1","1","0","-2"
"209490","Oregon Health & Science University","2017","Tenured, professors","78","54","24","0","0","0","9","6","3","0","0","0","1","1","0","0","0","0","63","43","20","0","0","0","5","4","1","0","0","0","-2"
"209490","Oregon Health & Science University","2017","Tenured, associate professors","25","11","14","0","0","0","4","4","0","0","0","0","1","0","1","0","0","0","19","7","12","0","0","0","1","0","1","0","0","0","-2"
"209490","Oregon Health & Science University","2017","Tenured, assistant professors","1","1","0","0","0","0","0","0","0","0","0","0","0","0","0","0","0","0","0","0","0","0","0","0","0","0","0","1","1","0","-2"
"209490","Oregon Health & Science University","2017","On-Tenure track total","43","30","13","0","0","0","7","5","2","2","2","0","2","0","2","1","0","1","26","19","7","0","0","0","2","1","1","3","3","0","-2"
"209490","Oregon Health & Science University","2017","On-tenure track, professors","4","3","1","0","0","0","0","0","0","0","0","0","0","0","0","0","0","0","4","3","1","0","0","0","0","0","0","0","0","0","-2"
"209490","Oregon Health & Science University","2017","On-tenure track, associate professors","13","9","4","0","0","0","3","2","1","1","1","0","1","0","1","0","0","0","8","6","2","0","0","0","0","0","0","0","0","0","-2"
"209490","Oregon Health & Science University","2017","On-tenure track, assistant professors","26","18","8","0","0","0","4","3","1","1","1","0","1","0","1","1","0","1","14","10","4","0","0","0","2","1","1","3","3","0","-2"
"209490","Oregon Health & Science University","2017","Not on tenure track/No tenure system system total","1452","632","820","2","0","2","174","95","79","13","8","5","43","24","19","4","0","4","1033","422","611","10","3","7","137","60","77","36","20","16","-2"
"209490","Oregon Health & Science University","2017","Not on tenure/no tenure system, professors","150","103","47","0","0","0","17","14","3","0","0","0","6","6","0","0","0","0","120","79","41","0","0","0","7","4","3","0","0","0","-2"
"209490","Oregon Health & Science University","2017","Not on tenure/no tenure system, associate professors","261","146","115","1","0","1","35","22","13","3","3","0","8","7","1","0","0","0","194","101","93","2","2","0","13","8","5","5","3","2","-2"
"209490","Oregon Health & Science University","2017","Not on tenure/no tenure system, assistant professors","629","265","364","1","0","1","93","49","44","8","4","4","16","7","9","2","0","2","411","163","248","6","1","5","71","31","40","21","10","11","-2"
"209490","Oregon Health & Science University","2017","Not on tenure/no tenure system, instructors","407","118","289","0","0","0","29","10","19","2","1","1","13","4","9","2","0","2","304","79","225","1","0","1","46","17","29","10","7","3","-2"
"209490","Oregon Health & Science University","2017","Not on tenure/no tenure system, lecturers","5","0","5","0","0","0","0","0","0","0","0","0","0","0","0","0","0","0","4","0","4","1","0","1","0","0","0","0","0","0","-2"
"209612","Pacific University","2017","Tenured total","140","76","64","0","0","0","11","4","7","1","0","1","2","1","1","0","0","0","122","69","53","1","1","0","0","0","0","3","1","2","-2"
"209612","Pacific University","2017","Tenured, professors","67","41","26","0","0","0","3","1","2","0","0","0","1","0","1","0","0","0","62","40","22","0","0","0","0","0","0","1","0","1","-2"
"209612","Pacific University","2017","Tenured, associate professors","72","34","38","0","0","0","8","3","5","1","0","1","1","1","0","0","0","0","59","28","31","1","1","0","0","0","0","2","1","1","-2"
"209612","Pacific University","2017","Tenured, assistant professors","1","1","0","0","0","0","0","0","0","0","0","0","0","0","0","0","0","0","1","1","0","0","0","0","0","0","0","0","0","0","-2"
"209612","Pacific University","2017","On-Tenure track total","61","20","41","2","1","1","7","2","5","1","1","0","0","0","0","0","0","0","38","12","26","5","2","3","3","1","2","5","1","4","-2"
"209612","Pacific University","2017","On-tenure track, associate professors","11","2","9","0","0","0","0","0","0","0","0","0","0","0","0","0","0","0","7","1","6","2","1","1","1","0","1","1","0","1","-2"
"209612","Pacific University","2017","On-tenure track, assistant professors","50","18","32","2","1","1","7","2","5","1","1","0","0","0","0","0","0","0","31","11","20","3","1","2","2","1","1","4","1","3","-2"
"209612","Pacific University","2017","Not on tenure track/No tenure system system total","99","40","59","1","1","0","7","3","4","0","0","0","6","2","4","0","0","0","81","32","49","2","2","0","2","0","2","0","0","0","-2"
"209612","Pacific University","2017","Not on tenure/no tenure system, professors","4","3","1","0","0","0","0","0","0","0","0","0","0","0","0","0","0","0","4","3","1","0","0","0","0","0","0","0","0","0","-2"
"209612","Pacific University","2017","Not on tenure/no tenure system, associate professors","14","6","8","0","0","0","2","0","2","0","0","0","0","0","0","0","0","0","11","5","6","1","1","0","0","0","0","0","0","0","-2"
"209612","Pacific University","2017","Not on tenure/no tenure system, assistant professors","63","22","41","0","0","0","3","2","1","0","0","0","2","0","2","0","0","0","55","19","36","1","1","0","2","0","2","0","0","0","-2"
"209612","Pacific University","2017","Not on tenure/no tenure system, instructors","18","9","9","1","1","0","2","1","1","0","0","0","4","2","2","0","0","0","11","5","6","0","0","0","0","0","0","0","0","0","-2"
"209807","Portland State University","2017","Tenured total","418","256","162","5","1","4","13","8","5","8","6","2","16","9","7","0","0","0","253","151","102","8","4","4","29","20","9","86","57","29","-2"
"209807","Portland State University","2017","Tenured, professors","223","155","68","2","0","2","9","7","2","5","4","1","5","3","2","0","0","0","135","92","43","2","1","1","19","13","6","46","35","11","-2"
"209807","Portland State University","2017","Tenured, associate professors","194","100","94","3","1","2","4","1","3","3","2","1","11","6","5","0","0","0","117","58","59","6","3","3","10","7","3","40","22","18","-2"
"209807","Portland State University","2017","Tenured, assistant professors","1","1","0","0","0","0","0","0","0","0","0","0","0","0","0","0","0","0","1","1","0","0","0","0","0","0","0","0","0","0","-2"
"209807","Portland State University","2017","On-Tenure track total","166","78","88","0","0","0","5","2","3","9","4","5","14","5","9","0","0","0","84","38","46","5","1","4","9","4","5","40","24","16","-2"
"209807","Portland State University","2017","On-tenure track, professors","1","0","1","0","0","0","0","0","0","0","0","0","0","0","0","0","0","0","1","0","1","0","0","0","0","0","0","0","0","0","-2"
"209807","Portland State University","2017","On-tenure track, associate professors","5","4","1","0","0","0","0","0","0","0","0","0","0","0","0","0","0","0","1","0","1","0","0","0","0","0","0","4","4","0","-2"
"209807","Portland State University","2017","On-tenure track, assistant professors","160","74","86","0","0","0","5","2","3","9","4","5","14","5","9","0","0","0","82","38","44","5","1","4","9","4","5","36","20","16","-2"
"209807","Portland State University","2017","Not on tenure track/No tenure system system total","258","105","153","1","0","1","11","4","7","4","1","3","10","4","6","1","1","0","183","75","108","5","2","3","12","8","4","31","10","21","-2"
"209807","Portland State University","2017","Not on tenure/no tenure system, professors","7","6","1","0","0","0","0","0","0","0","0","0","0","0","0","0","0","0","6","6","0","0","0","0","0","0","0","1","0","1","-2"
"209807","Portland State University","2017","Not on tenure/no tenure system, associate professors","22","13","9","0","0","0","1","1","0","0","0","0","0","0","0","0","0","0","18","9","9","0","0","0","1","1","0","2","2","0","-2"
"209807","Portland State University","2017","Not on tenure/no tenure system, assistant professors","74","28","46","0","0","0","2","0","2","2","0","2","7","2","5","1","1","0","49","17","32","1","0","1","7","5","2","5","3","2","-2"
"209807","Portland State University","2017","Not on tenure/no tenure system, instructors","155","58","97","1","0","1","8","3","5","2","1","1","3","2","1","0","0","0","110","43","67","4","2","2","4","2","2","23","5","18","-2"
"210429","Western Oregon University","2017","Tenured total","138","72","66","0","0","0","5","1","4","3","2","1","8","3","5","0","0","0","118","63","55","0","0","0","4","3","1","0","0","0","-2"
"210429","Western Oregon University","2017","Tenured, professors","87","48","39","0","0","0","3","1","2","2","1","1","2","1","1","0","0","0","78","43","35","0","0","0","2","2","0","0","0","0","-2"
"210429","Western Oregon University","2017","Tenured, associate professors","51","24","27","0","0","0","2","0","2","1","1","0","6","2","4","0","0","0","40","20","20","0","0","0","2","1","1","0","0","0","-2"
"210429","Western Oregon University","2017","On-Tenure track total","29","6","23","0","0","0","1","0","1","0","0","0","0","0","0","0","0","0","19","5","14","0","0","0","4","0","4","5","1","4","-2"
"210429","Western Oregon University","2017","On-tenure track, assistant professors","29","6","23","0","0","0","1","0","1","0","0","0","0","0","0","0","0","0","19","5","14","0","0","0","4","0","4","5","1","4","-2"
"210429","Western Oregon University","2017","Not on tenure track/No tenure system system total","120","54","66","0","0","0","5","2","3","0","0","0","7","1","6","1","1","0","92","43","49","3","1","2","11","5","6","1","1","0","-2"
"210429","Western Oregon University","2017","Not on tenure/no tenure system, assistant professors","35","15","20","0","0","0","3","1","2","0","0","0","2","1","1","0","0","0","26","10","16","0","0","0","4","3","1","0","0","0","-2"
"210429","Western Oregon University","2017","Not on tenure/no tenure system, instructors","76","38","38","0","0","0","2","1","1","0","0","0","5","0","5","1","1","0","57","32","25","3","1","2","7","2","5","1","1","0","-2"
"210429","Western Oregon University","2017","Not on tenure/no tenure system, lecturers","9","1","8","0","0","0","0","0","0","0","0","0","0","0","0","0","0","0","9","1","8","0","0","0","0","0","0","0","0","0","-2"
"210571","Albright College","2017","Tenured total","52","30","22","1","1","0","1","0","1","3","0","3","2","1","1","0","0","0","43","26","17","0","0","0","2","2","0","0","0","0","-2"
"210571","Albright College","2017","Tenured, professors","19","11","8","1","1","0","0","0","0","1","0","1","1","1","0","0","0","0","14","7","7","0","0","0","2","2","0","0","0","0","-2"
"210571","Albright College","2017","Tenured, associate professors","33","19","14","0","0","0","1","0","1","2","0","2","1","0","1","0","0","0","29","19","10","0","0","0","0","0","0","0","0","0","-2"
"210571","Albright College","2017","On-Tenure track total","29","16","13","0","0","0","4","2","2","1","0","1","1","1","0","0","0","0","23","13","10","0","0","0","0","0","0","0","0","0","-2"
"210571","Albright College","2017","On-tenure track, associate professors","3","1","2","0","0","0","0","0","0","0","0","0","0","0","0","0","0","0","3","1","2","0","0","0","0","0","0","0","0","0","-2"
"210571","Albright College","2017","On-tenure track, assistant professors","26","15","11","0","0","0","4","2","2","1","0","1","1","1","0","0","0","0","20","12","8","0","0","0","0","0","0","0","0","0","-2"
"210571","Albright College","2017","Not on tenure track/No tenure system system total","30","9","21","0","0","0","1","0","1","1","0","1","2","0","2","0","0","0","23","9","14","0","0","0","3","0","3","0","0","0","-2"
"210571","Albright College","2017","Not on tenure/no tenure system, associate professors","3","2","1","0","0","0","0","0","0","0","0","0","0","0","0","0","0","0","3","2","1","0","0","0","0","0","0","0","0","0","-2"
"210571","Albright College","2017","Not on tenure/no tenure system, assistant professors","10","2","8","0","0","0","0","0","0","1","0","1","0","0","0","0","0","0","9","2","7","0","0","0","0","0","0","0","0","0","-2"
"210571","Albright College","2017","Not on tenure/no tenure system, instructors","17","5","12","0","0","0","1","0","1","0","0","0","2","0","2","0","0","0","11","5","6","0","0","0","3","0","3","0","0","0","-2"
"212133","Eastern University","2017","Tenured total","54","32","22","0","0","0","4","2","2","7","5","2","2","1","1","0","0","0","41","24","17","0","0","0","0","0","0","0","0","0","-2"
"212133","Eastern University","2017","Tenured, professors","30","18","12","0","0","0","3","1","2","1","1","0","1","0","1","0","0","0","25","16","9","0","0","0","0","0","0","0","0","0","-2"
"212133","Eastern University","2017","Tenured, associate professors","24","14","10","0","0","0","1","1","0","6","4","2","1","1","0","0","0","0","16","8","8","0","0","0","0","0","0","0","0","0","-2"
"212133","Eastern University","2017","On-Tenure track total","27","9","18","0","0","0","2","1","1","3","1","2","0","0","0","0","0","0","22","7","15","0","0","0","0","0","0","0","0","0","-2"
"212133","Eastern University","2017","On-tenure track, professors","4","2","2","0","0","0","1","1","0","0","0","0","0","0","0","0","0","0","3","1","2","0","0","0","0","0","0","0","0","0","-2"
"212133","Eastern University","2017","On-tenure track, associate professors","7","3","4","0","0","0","0","0","0","0","0","0","0","0","0","0","0","0","7","3","4","0","0","0","0","0","0","0","0","0","-2"
"212133","Eastern University","2017","On-tenure track, assistant professors","16","4","12","0","0","0","1","0","1","3","1","2","0","0","0","0","0","0","12","3","9","0","0","0","0","0","0","0","0","0","-2"
"212133","Eastern University","2017","Not on tenure track/No tenure system system total","43","19","24","0","0","0","0","0","0","2","0","2","2","1","1","0","0","0","36","18","18","2","0","2","1","0","1","0","0","0","-2"
"212133","Eastern University","2017","Not on tenure/no tenure system, professors","1","1","0","0","0","0","0","0","0","0","0","0","0","0","0","0","0","0","1","1","0","0","0","0","0","0","0","0","0","0","-2"
"212133","Eastern University","2017","Not on tenure/no tenure system, assistant professors","2","1","1","0","0","0","0","0","0","0","0","0","0","0","0","0","0","0","1","1","0","0","0","0","1","0","1","0","0","0","-2"
"212133","Eastern University","2017","Not on tenure/no tenure system, lecturers","25","8","17","0","0","0","0","0","0","2","0","2","1","0","1","0","0","0","20","8","12","2","0","2","0","0","0","0","0","0","-2"
"212133","Eastern University","2017","Not on tenure/no tenure system, no academic rank","15","9","6","0","0","0","0","0","0","0","0","0","1","1","0","0","0","0","14","8","6","0","0","0","0","0","0","0","0","0","-2"
"213367","La Salle University","2017","Tenured total","119","61","58","0","0","0","8","4","4","2","1","1","3","2","1","0","0","0","104","52","52","1","1","0","0","0","0","1","1","0","-2"
"213367","La Salle University","2017","Tenured, professors","43","24","19","0","0","0","2","1","1","1","1","0","2","2","0","0","0","0","37","19","18","1","1","0","0","0","0","0","0","0","-2"
"213367","La Salle University","2017","Tenured, associate professors","73","36","37","0","0","0","6","3","3","1","0","1","1","0","1","0","0","0","64","32","32","0","0","0","0","0","0","1","1","0","-2"
"213367","La Salle University","2017","Tenured, assistant professors","3","1","2","0","0","0","0","0","0","0","0","0","0","0","0","0","0","0","3","1","2","0","0","0","0","0","0","0","0","0","-2"
"213367","La Salle University","2017","On-Tenure track total","48","19","29","0","0","0","3","2","1","4","2","2","1","0","1","0","0","0","38","13","25","1","1","0","0","0","0","1","1","0","-2"
"213367","La Salle University","2017","On-tenure track, professors","2","1","1","0","0","0","0","0","0","0","0","0","0","0","0","0","0","0","2","1","1","0","0","0","0","0","0","0","0","0","-2"
"213367","La Salle University","2017","On-tenure track, associate professors","5","0","5","0","0","0","0","0","0","0","0","0","0","0","0","0","0","0","5","0","5","0","0","0","0","0","0","0","0","0","-2"
"213367","La Salle University","2017","On-tenure track, assistant professors","41","18","23","0","0","0","3","2","1","4","2","2","1","0","1","0","0","0","31","12","19","1","1","0","0","0","0","1","1","0","-2"
"213367","La Salle University","2017","Not on tenure track/No tenure system system total","42","10","32","0","0","0","0","0","0","3","0","3","3","2","1","0","0","0","36","8","28","0","0","0","0","0","0","0","0","0","-2"
"213367","La Salle University","2017","Not on tenure/no tenure system, assistant professors","30","9","21","0","0","0","0","0","0","2","0","2","2","2","0","0","0","0","26","7","19","0","0","0","0","0","0","0","0","0","-2"
"213367","La Salle University","2017","Not on tenure/no tenure system, instructors","12","1","11","0","0","0","0","0","0","1","0","1","1","0","1","0","0","0","10","1","9","0","0","0","0","0","0","0","0","0","-2"
"213774","Manor College","2017","Not on tenure track/No tenure system system total","22","5","17","0","0","0","1","1","0","1","0","1","0","0","0","0","0","0","20","4","16","0","0","0","0","0","0","0","0","0","-2"
"213774","Manor College","2017","Not on tenure/no tenure system, professors","13","3","10","0","0","0","1","1","0","1","0","1","0","0","0","0","0","0","11","2","9","0","0","0","0","0","0","0","0","0","-2"
"213774","Manor College","2017","Not on tenure/no tenure system, associate professors","2","1","1","0","0","0","0","0","0","0","0","0","0","0","0","0","0","0","2","1","1","0","0","0","0","0","0","0","0","0","-2"
"213774","Manor College","2017","Not on tenure/no tenure system, assistant professors","6","1","5","0","0","0","0","0","0","0","0","0","0","0","0","0","0","0","6","1","5","0","0","0","0","0","0","0","0","0","-2"
"213774","Manor College","2017","Not on tenure/no tenure system, instructors","1","0","1","0","0","0","0","0","0","0","0","0","0","0","0","0","0","0","1","0","1","0","0","0","0","0","0","0","0","0","-2"
"216542","University of Valley Forge","2017","Not on tenure track/No tenure system system total","25","14","11","0","0","0","0","0","0","2","0","2","0","0","0","1","0","1","22","14","8","0","0","0","0","0","0","0","0","0","-2"
"216542","University of Valley Forge","2017","Not on tenure/no tenure system, professors","10","6","4","0","0","0","0","0","0","1","0","1","0","0","0","1","0","1","8","6","2","0","0","0","0","0","0","0","0","0","-2"
"216542","University of Valley Forge","2017","Not on tenure/no tenure system, associate professors","5","3","2","0","0","0","0","0","0","0","0","0","0","0","0","0","0","0","5","3","2","0","0","0","0","0","0","0","0","0","-2"
"216542","University of Valley Forge","2017","Not on tenure/no tenure system, assistant professors","10","5","5","0","0","0","0","0","0","1","0","1","0","0","0","0","0","0","9","5","4","0","0","0","0","0","0","0","0","0","-2"
"217420","Rhode Island College","2017","Tenured total","224","93","131","1","0","1","19","7","12","3","1","2","8","5","3","2","2","0","188","75","113","3","3","0","0","0","0","0","0","0","-2"
"217420","Rhode Island College","2017","Tenured, professors","113","51","62","1","0","1","9","4","5","2","1","1","2","1","1","1","1","0","98","44","54","0","0","0","0","0","0","0","0","0","-2"
"217420","Rhode Island College","2017","Tenured, associate professors","101","38","63","0","0","0","9","2","7","1","0","1","5","4","1","1","1","0","82","28","54","3","3","0","0","0","0","0","0","0","-2"
"217420","Rhode Island College","2017","Tenured, assistant professors","10","4","6","0","0","0","1","1","0","0","0","0","1","0","1","0","0","0","8","3","5","0","0","0","0","0","0","0","0","0","-2"
"217420","Rhode Island College","2017","On-Tenure track total","75","28","47","0","0","0","10","5","5","3","1","2","3","1","2","0","0","0","57","20","37","2","1","1","0","0","0","0","0","0","-2"
"217420","Rhode Island College","2017","On-tenure track, professors","1","1","0","0","0","0","0","0","0","0","0","0","0","0","0","0","0","0","1","1","0","0","0","0","0","0","0","0","0","0","-2"
"217420","Rhode Island College","2017","On-tenure track, associate professors","2","1","1","0","0","0","0","0","0","0","0","0","0","0","0","0","0","0","2","1","1","0","0","0","0","0","0","0","0","0","-2"
"217420","Rhode Island College","2017","On-tenure track, assistant professors","72","26","46","0","0","0","10","5","5","3","1","2","3","1","2","0","0","0","54","18","36","2","1","1","0","0","0","0","0","0","-2"
"217420","Rhode Island College","2017","Not on tenure track/No tenure system system total","36","9","27","1","0","1","1","0","1","0","0","0","1","0","1","0","0","0","33","9","24","0","0","0","0","0","0","0","0","0","-2"
"217420","Rhode Island College","2017","Not on tenure/no tenure system, associate professors","1","1","0","0","0","0","0","0","0","0","0","0","0","0","0","0","0","0","1","1","0","0","0","0","0","0","0","0","0","0","-2"
"217420","Rhode Island College","2017","Not on tenure/no tenure system, assistant professors","35","8","27","1","0","1","1","0","1","0","0","0","1","0","1","0","0","0","32","8","24","0","0","0","0","0","0","0","0","0","-2"
"221661","Southern Adventist University","2017","Not on tenure track/No tenure system system total","134","60","74","1","0","1","1","0","1","7","1","6","9","4","5","1","1","0","113","53","60","0","0","0","2","1","1","0","0","0","-2"
"221661","Southern Adventist University","2017","Not on tenure/no tenure system, professors","52","32","20","0","0","0","0","0","0","3","1","2","1","1","0","0","0","0","48","30","18","0","0","0","0","0","0","0","0","0","-2"
"221661","Southern Adventist University","2017","Not on tenure/no tenure system, associate professors","56","23","33","0","0","0","1","0","1","1","0","1","4","1","3","1","1","0","48","20","28","0","0","0","1","1","0","0","0","0","-2"
"221661","Southern Adventist University","2017","Not on tenure/no tenure system, assistant professors","25","5","20","1","0","1","0","0","0","3","0","3","4","2","2","0","0","0","16","3","13","0","0","0","1","0","1","0","0","0","-2"
"221661","Southern Adventist University","2017","Not on tenure/no tenure system, instructors","1","0","1","0","0","0","0","0","0","0","0","0","0","0","0","0","0","0","1","0","1","0","0","0","0","0","0","0","0","0","-2"
"222178","Abilene Christian University","2017","Tenured total","140","99","41","1","1","0","2","2","0","5","3","2","4","2","2","0","0","0","125","89","36","3","2","1","0","0","0","0","0","0","-2"
"222178","Abilene Christian University","2017","Tenured, professors","64","52","12","1","1","0","1","1","0","0","0","0","3","1","2","0","0","0","58","49","9","1","0","1","0","0","0","0","0","0","-2"
"222178","Abilene Christian University","2017","Tenured, associate professors","74","45","29","0","0","0","0","0","0","5","3","2","1","1","0","0","0","0","66","39","27","2","2","0","0","0","0","0","0","0","-2"
"222178","Abilene Christian University","2017","Tenured, assistant professors","2","2","0","0","0","0","1","1","0","0","0","0","0","0","0","0","0","0","1","1","0","0","0","0","0","0","0","0","0","0","-2"
"222178","Abilene Christian University","2017","On-Tenure track total","51","34","17","0","0","0","1","0","1","0","0","0","5","4","1","0","0","0","44","30","14","1","0","1","0","0","0","0","0","0","-2"
"222178","Abilene Christian University","2017","On-tenure track, professors","1","1","0","0","0","0","0","0","0","0","0","0","0","0","0","0","0","0","1","1","0","0","0","0","0","0","0","0","0","0","-2"
"222178","Abilene Christian University","2017","On-tenure track, associate professors","5","4","1","0","0","0","0","0","0","0","0","0","0","0","0","0","0","0","5","4","1","0","0","0","0","0","0","0","0","0","-2"
"222178","Abilene Christian University","2017","On-tenure track, assistant professors","45","29","16","0","0","0","1","0","1","0","0","0","5","4","1","0","0","0","38","25","13","1","0","1","0","0","0","0","0","0","-2"
"222178","Abilene Christian University","2017","Not on tenure track/No tenure system system total","75","25","50","0","0","0","0","0","0","4","2","2","2","0","2","0","0","0","67","21","46","0","0","0","0","0","0","2","2","0","-2"
"222178","Abilene Christian University","2017","Not on tenure/no tenure system, professors","1","0","1","0","0","0","0","0","0","0","0","0","0","0","0","0","0","0","1","0","1","0","0","0","0","0","0","0","0","0","-2"
"222178","Abilene Christian University","2017","Not on tenure/no tenure system, associate professors","6","4","2","0","0","0","0","0","0","1","1","0","0","0","0","0","0","0","5","3","2","0","0","0","0","0","0","0","0","0","-2"
"222178","Abilene Christian University","2017","Not on tenure/no tenure system, assistant professors","8","2","6","0","0","0","0","0","0","0","0","0","0","0","0","0","0","0","8","2","6","0","0","0","0","0","0","0","0","0","-2"
"222178","Abilene Christian University","2017","Not on tenure/no tenure system, instructors","45","13","32","0","0","0","0","0","0","1","0","1","1","0","1","0","0","0","42","12","30","0","0","0","0","0","0","1","1","0","-2"
"222178","Abilene Christian University","2017","Not on tenure/no tenure system, no academic rank","15","6","9","0","0","0","0","0","0","2","1","1","1","0","1","0","0","0","11","4","7","0","0","0","0","0","0","1","1","0","-2"
"222983","Austin College","2017","Tenured total","67","49","18","1","1","0","2","1","1","1","0","1","5","2","3","0","0","0","57","44","13","0","0","0","0","0","0","1","1","0","-2"
"222983","Austin College","2017","Tenured, professors","28","21","7","1","1","0","0","0","0","1","0","1","1","0","1","0","0","0","25","20","5","0","0","0","0","0","0","0","0","0","-2"
"222983","Austin College","2017","Tenured, associate professors","39","28","11","0","0","0","2","1","1","0","0","0","4","2","2","0","0","0","32","24","8","0","0","0","0","0","0","1","1","0","-2"
"222983","Austin College","2017","On-Tenure track total","24","11","13","0","0","0","4","1","3","2","2","0","1","0","1","0","0","0","17","8","9","0","0","0","0","0","0","0","0","0","-2"
"222983","Austin College","2017","On-tenure track, assistant professors","24","11","13","0","0","0","4","1","3","2","2","0","1","0","1","0","0","0","17","8","9","0","0","0","0","0","0","0","0","0","-2"
"222983","Austin College","2017","Not on tenure track/No tenure system system total","7","3","4","0","0","0","0","0","0","1","0","1","0","0","0","0","0","0","6","3","3","0","0","0","0","0","0","0","0","0","-2"
"222983","Austin College","2017","Not on tenure/no tenure system, professors","5","3","2","0","0","0","0","0","0","0","0","0","0","0","0","0","0","0","5","3","2","0","0","0","0","0","0","0","0","0","-2"
"222983","Austin College","2017","Not on tenure/no tenure system, assistant professors","1","0","1","0","0","0","0","0","0","1","0","1","0","0","0","0","0","0","0","0","0","0","0","0","0","0","0","0","0","0","-2"
"222983","Austin College","2017","Not on tenure/no tenure system, instructors","1","0","1","0","0","0","0","0","0","0","0","0","0","0","0","0","0","0","1","0","1","0","0","0","0","0","0","0","0","0","-2"
"223232","Baylor University","2017","Tenured total","521","380","141","1","1","0","33","26","7","12","6","6","19","14","5","1","1","0","439","319","120","11","9","2","0","0","0","5","4","1","-2"
"223232","Baylor University","2017","Tenured, professors","283","230","53","1","1","0","6","5","1","6","4","2","8","7","1","1","1","0","248","202","46","9","7","2","0","0","0","4","3","1","-2"
"223232","Baylor University","2017","Tenured, associate professors","238","150","88","0","0","0","27","21","6","6","2","4","11","7","4","0","0","0","191","117","74","2","2","0","0","0","0","1","1","0","-2"
"223232","Baylor University","2017","On-Tenure track total","146","79","67","0","0","0","10","9","1","6","2","4","4","4","0","0","0","0","110","55","55","2","1","1","2","2","0","12","6","6","-2"
"223232","Baylor University","2017","On-tenure track, professors","2","0","2","0","0","0","0","0","0","0","0","0","0","0","0","0","0","0","2","0","2","0","0","0","0","0","0","0","0","0","-2"
"223232","Baylor University","2017","On-tenure track, associate professors","10","7","3","0","0","0","2","2","0","0","0","0","0","0","0","0","0","0","8","5","3","0","0","0","0","0","0","0","0","0","-2"
"223232","Baylor University","2017","On-tenure track, assistant professors","134","72","62","0","0","0","8","7","1","6","2","4","4","4","0","0","0","0","100","50","50","2","1","1","2","2","0","12","6","6","-2"
"223232","Baylor University","2017","Not on tenure track/No tenure system system total","403","167","236","1","1","0","9","2","7","7","2","5","16","5","11","0","0","0","345","147","198","9","3","6","3","1","2","13","6","7","-2"
"223232","Baylor University","2017","Not on tenure/no tenure system, professors","11","5","6","0","0","0","0","0","0","0","0","0","1","1","0","0","0","0","10","4","6","0","0","0","0","0","0","0","0","0","-2"
"223232","Baylor University","2017","Not on tenure/no tenure system, associate professors","19","9","10","1","1","0","0","0","0","0","0","0","0","0","0","0","0","0","17","7","10","0","0","0","0","0","0","1","1","0","-2"
"223232","Baylor University","2017","Not on tenure/no tenure system, assistant professors","60","16","44","0","0","0","2","0","2","1","0","1","1","0","1","0","0","0","52","14","38","2","1","1","1","0","1","1","1","0","-2"
"223232","Baylor University","2017","Not on tenure/no tenure system, instructors","3","0","3","0","0","0","0","0","0","0","0","0","0","0","0","0","0","0","3","0","3","0","0","0","0","0","0","0","0","0","-2"
"223232","Baylor University","2017","Not on tenure/no tenure system, lecturers","310","137","173","0","0","0","7","2","5","6","2","4","14","4","10","0","0","0","263","122","141","7","2","5","2","1","1","11","4","7","-2"
"224226","Dallas Baptist University","2017","Not on tenure track/No tenure system system total","126","80","46","0","0","0","10","9","1","3","1","2","5","4","1","0","0","0","108","66","42","0","0","0","0","0","0","0","0","0","-2"
"224226","Dallas Baptist University","2017","Not on tenure/no tenure system, professors","57","34","23","0","0","0","4","3","1","2","1","1","2","2","0","0","0","0","49","28","21","0","0","0","0","0","0","0","0","0","-2"
"224226","Dallas Baptist University","2017","Not on tenure/no tenure system, associate professors","19","13","6","0","0","0","0","0","0","0","0","0","2","1","1","0","0","0","17","12","5","0","0","0","0","0","0","0","0","0","-2"
"224226","Dallas Baptist University","2017","Not on tenure/no tenure system, assistant professors","50","33","17","0","0","0","6","6","0","1","0","1","1","1","0","0","0","0","42","26","16","0","0","0","0","0","0","0","0","0","-2"
"224244","Dallas Christian College","2017","Not on tenure track/No tenure system system total","7","4","3","0","0","0","0","0","0","1","1","0","0","0","0","0","0","0","6","3","3","0","0","0","0","0","0","0","0","0","-2"
"224244","Dallas Christian College","2017","Not on tenure/no tenure system, professors","4","3","1","0","0","0","0","0","0","0","0","0","0","0","0","0","0","0","4","3","1","0","0","0","0","0","0","0","0","0","-2"
"224244","Dallas Christian College","2017","Not on tenure/no tenure system, associate professors","2","1","1","0","0","0","0","0","0","1","1","0","0","0","0","0","0","0","1","0","1","0","0","0","0","0","0","0","0","0","-2"
"224244","Dallas Christian College","2017","Not on tenure/no tenure system, instructors","1","0","1","0","0","0","0","0","0","0","0","0","0","0","0","0","0","0","1","0","1","0","0","0","0","0","0","0","0","0","-2"
"224323","University of Dallas","2017","Tenured total","85","61","24","1","0","1","2","1","1","0","0","0","5","3","2","0","0","0","74","56","18","3","1","2","0","0","0","0","0","0","-2"
"224323","University of Dallas","2017","Tenured, professors","23","18","5","0","0","0","1","1","0","0","0","0","0","0","0","0","0","0","22","17","5","0","0","0","0","0","0","0","0","0","-2"
"224323","University of Dallas","2017","Tenured, associate professors","57","39","18","1","0","1","1","0","1","0","0","0","4","2","2","0","0","0","49","36","13","2","1","1","0","0","0","0","0","0","-2"
"224323","University of Dallas","2017","Tenured, assistant professors","5","4","1","0","0","0","0","0","0","0","0","0","1","1","0","0","0","0","3","3","0","1","0","1","0","0","0","0","0","0","-2"
"224323","University of Dallas","2017","On-Tenure track total","26","13","13","0","0","0","0","0","0","1","1","0","2","1","1","0","0","0","22","10","12","1","1","0","0","0","0","0","0","0","-2"
"224323","University of Dallas","2017","On-tenure track, assistant professors","26","13","13","0","0","0","0","0","0","1","1","0","2","1","1","0","0","0","22","10","12","1","1","0","0","0","0","0","0","0","-2"
"224323","University of Dallas","2017","Not on tenure track/No tenure system system total","31","16","15","0","0","0","1","0","1","0","0","0","4","1","3","0","0","0","24","14","10","2","1","1","0","0","0","0","0","0","-2"
"224323","University of Dallas","2017","Not on tenure/no tenure system, instructors","31","16","15","0","0","0","1","0","1","0","0","0","4","1","3","0","0","0","24","14","10","2","1","1","0","0","0","0","0","0","-2"
"224545","Texas A&M University-Texarkana","2017","Tenured total","28","17","11","0","0","0","2","2","0","1","1","0","1","0","1","0","0","0","24","14","10","0","0","0","0","0","0","0","0","0","-2"
"224545","Texas A&M University-Texarkana","2017","Tenured, professors","17","10","7","0","0","0","2","2","0","1","1","0","1","0","1","0","0","0","13","7","6","0","0","0","0","0","0","0","0","0","-2"
"224545","Texas A&M University-Texarkana","2017","Tenured, associate professors","11","7","4","0","0","0","0","0","0","0","0","0","0","0","0","0","0","0","11","7","4","0","0","0","0","0","0","0","0","0","-2"
"224545","Texas A&M University-Texarkana","2017","On-Tenure track total","36","21","15","0","0","0","5","4","1","2","2","0","0","0","0","0","0","0","22","11","11","1","0","1","4","2","2","2","2","0","-2"
"224545","Texas A&M University-Texarkana","2017","On-tenure track, professors","2","2","0","0","0","0","1","1","0","0","0","0","0","0","0","0","0","0","1","1","0","0","0","0","0","0","0","0","0","0","-2"
"224545","Texas A&M University-Texarkana","2017","On-tenure track, associate professors","13","8","5","0","0","0","3","2","1","0","0","0","0","0","0","0","0","0","9","5","4","0","0","0","1","1","0","0","0","0","-2"
"224545","Texas A&M University-Texarkana","2017","On-tenure track, assistant professors","21","11","10","0","0","0","1","1","0","2","2","0","0","0","0","0","0","0","12","5","7","1","0","1","3","1","2","2","2","0","-2"
"224545","Texas A&M University-Texarkana","2017","Not on tenure track/No tenure system system total","17","6","11","0","0","0","1","1","0","0","0","0","1","0","1","0","0","0","11","3","8","1","1","0","2","0","2","1","1","0","-2"
"224545","Texas A&M University-Texarkana","2017","Not on tenure/no tenure system, professors","4","3","1","0","0","0","1","1","0","0","0","0","0","0","0","0","0","0","2","1","1","1","1","0","0","0","0","0","0","0","-2"
"224545","Texas A&M University-Texarkana","2017","Not on tenure/no tenure system, assistant professors","1","1","0","0","0","0","0","0","0","0","0","0","0","0","0","0","0","0","0","0","0","0","0","0","0","0","0","1","1","0","-2"
"224545","Texas A&M University-Texarkana","2017","Not on tenure/no tenure system, instructors","12","2","10","0","0","0","0","0","0","0","0","0","1","0","1","0","0","0","9","2","7","0","0","0","2","0","2","0","0","0","-2"
"224554","Texas A & M University-Commerce","2017","Tenured total","139","88","51","1","1","0","18","14","4","10","6","4","8","6","2","0","0","0","100","60","40","1","0","1","1","1","0","0","0","0","-2"
"224554","Texas A & M University-Commerce","2017","Tenured, professors","69","45","24","1","1","0","12","10","2","6","4","2","3","3","0","0","0","0","47","27","20","0","0","0","0","0","0","0","0","0","-2"
"224554","Texas A & M University-Commerce","2017","Tenured, associate professors","66","41","25","0","0","0","6","4","2","4","2","2","4","3","1","0","0","0","50","31","19","1","0","1","1","1","0","0","0","0","-2"
"224554","Texas A & M University-Commerce","2017","Tenured, assistant professors","3","2","1","0","0","0","0","0","0","0","0","0","1","0","1","0","0","0","2","2","0","0","0","0","0","0","0","0","0","0","-2"
"224554","Texas A & M University-Commerce","2017","Tenured, instructors","1","0","1","0","0","0","0","0","0","0","0","0","0","0","0","0","0","0","1","0","1","0","0","0","0","0","0","0","0","0","-2"
"224554","Texas A & M University-Commerce","2017","On-Tenure track total","113","64","49","0","0","0","29","18","11","13","7","6","11","5","6","1","0","1","56","32","24","1","0","1","2","2","0","0","0","0","-2"
"224554","Texas A & M University-Commerce","2017","On-tenure track, professors","4","2","2","0","0","0","0","0","0","2","2","0","2","0","2","0","0","0","0","0","0","0","0","0","0","0","0","0","0","0","-2"
"224554","Texas A & M University-Commerce","2017","On-tenure track, associate professors","15","11","4","0","0","0","4","4","0","2","1","1","2","2","0","0","0","0","7","4","3","0","0","0","0","0","0","0","0","0","-2"
"224554","Texas A & M University-Commerce","2017","On-tenure track, assistant professors","94","51","43","0","0","0","25","14","11","9","4","5","7","3","4","1","0","1","49","28","21","1","0","1","2","2","0","0","0","0","-2"
"224554","Texas A & M University-Commerce","2017","Not on tenure track/No tenure system system total","121","48","73","0","0","0","17","9","8","9","3","6","3","0","3","0","0","0","89","34","55","0","0","0","3","2","1","0","0","0","-2"
"224554","Texas A & M University-Commerce","2017","Not on tenure/no tenure system, professors","10","3","7","0","0","0","1","1","0","2","0","2","0","0","0","0","0","0","7","2","5","0","0","0","0","0","0","0","0","0","-2"
"224554","Texas A & M University-Commerce","2017","Not on tenure/no tenure system, associate professors","6","2","4","0","0","0","2","1","1","1","0","1","0","0","0","0","0","0","2","0","2","0","0","0","1","1","0","0","0","0","-2"
"224554","Texas A & M University-Commerce","2017","Not on tenure/no tenure system, assistant professors","50","26","24","0","0","0","12","7","5","3","1","2","2","0","2","0","0","0","31","17","14","0","0","0","2","1","1","0","0","0","-2"
"224554","Texas A & M University-Commerce","2017","Not on tenure/no tenure system, instructors","43","10","33","0","0","0","2","0","2","2","1","1","1","0","1","0","0","0","38","9","29","0","0","0","0","0","0","0","0","0","-2"
"224554","Texas A & M University-Commerce","2017","Not on tenure/no tenure system, lecturers","12","7","5","0","0","0","0","0","0","1","1","0","0","0","0","0","0","0","11","6","5","0","0","0","0","0","0","0","0","0","-2"
"225247","Hardin-Simmons University","2017","Tenured total","99","63","36","0","0","0","1","1","0","2","1","1","0","0","0","0","0","0","96","61","35","0","0","0","0","0","0","0","0","0","-2"
"225247","Hardin-Simmons University","2017","Tenured, professors","60","44","16","0","0","0","0","0","0","0","0","0","0","0","0","0","0","0","60","44","16","0","0","0","0","0","0","0","0","0","-2"
"225247","Hardin-Simmons University","2017","Tenured, associate professors","33","17","16","0","0","0","1","1","0","1","1","0","0","0","0","0","0","0","31","15","16","0","0","0","0","0","0","0","0","0","-2"
"225247","Hardin-Simmons University","2017","Tenured, assistant professors","6","2","4","0","0","0","0","0","0","1","0","1","0","0","0","0","0","0","5","2","3","0","0","0","0","0","0","0","0","0","-2"
"225247","Hardin-Simmons University","2017","On-Tenure track total","18","8","10","0","0","0","1","0","1","0","0","0","2","0","2","0","0","0","14","8","6","0","0","0","1","0","1","0","0","0","-2"
"225247","Hardin-Simmons University","2017","On-tenure track, associate professors","3","1","2","0","0","0","0","0","0","0","0","0","1","0","1","0","0","0","2","1","1","0","0","0","0","0","0","0","0","0","-2"
"225247","Hardin-Simmons University","2017","On-tenure track, assistant professors","13","6","7","0","0","0","1","0","1","0","0","0","1","0","1","0","0","0","10","6","4","0","0","0","1","0","1","0","0","0","-2"
"225247","Hardin-Simmons University","2017","On-tenure track, instructors","2","1","1","0","0","0","0","0","0","0","0","0","0","0","0","0","0","0","2","1","1","0","0","0","0","0","0","0","0","0","-2"
"225247","Hardin-Simmons University","2017","Not on tenure track/No tenure system system total","17","12","5","0","0","0","0","0","0","0","0","0","0","0","0","0","0","0","17","12","5","0","0","0","0","0","0","0","0","0","-2"
"225247","Hardin-Simmons University","2017","Not on tenure/no tenure system, professors","2","2","0","0","0","0","0","0","0","0","0","0","0","0","0","0","0","0","2","2","0","0","0","0","0","0","0","0","0","0","-2"
"225247","Hardin-Simmons University","2017","Not on tenure/no tenure system, associate professors","1","0","1","0","0","0","0","0","0","0","0","0","0","0","0","0","0","0","1","0","1","0","0","0","0","0","0","0","0","0","-2"
"225247","Hardin-Simmons University","2017","Not on tenure/no tenure system, assistant professors","11","8","3","0","0","0","0","0","0","0","0","0","0","0","0","0","0","0","11","8","3","0","0","0","0","0","0","0","0","0","-2"
"225247","Hardin-Simmons University","2017","Not on tenure/no tenure system, instructors","3","2","1","0","0","0","0","0","0","0","0","0","0","0","0","0","0","0","3","2","1","0","0","0","0","0","0","0","0","0","-2"
"226091","Lamar University","2017","Tenured total","210","128","82","1","0","1","48","33","15","8","2","6","5","3","2","0","0","0","147","89","58","0","0","0","1","1","0","0","0","0","-2"
"226091","Lamar University","2017","Tenured, professors","93","62","31","0","0","0","23","18","5","2","0","2","0","0","0","0","0","0","68","44","24","0","0","0","0","0","0","0","0","0","-2"
"226091","Lamar University","2017","Tenured, associate professors","107","61","46","1","0","1","24","14","10","6","2","4","4","2","2","0","0","0","71","42","29","0","0","0","1","1","0","0","0","0","-2"
"226091","Lamar University","2017","Tenured, assistant professors","10","5","5","0","0","0","1","1","0","0","0","0","1","1","0","0","0","0","8","3","5","0","0","0","0","0","0","0","0","0","-2"
"226091","Lamar University","2017","On-Tenure track total","125","70","55","1","0","1","30","20","10","14","5","9","11","8","3","0","0","0","66","35","31","0","0","0","1","0","1","2","2","0","-2"
"226091","Lamar University","2017","On-tenure track, associate professors","9","6","3","0","0","0","2","2","0","0","0","0","1","1","0","0","0","0","6","3","3","0","0","0","0","0","0","0","0","0","-2"
"226091","Lamar University","2017","On-tenure track, assistant professors","114","64","50","1","0","1","28","18","10","14","5","9","10","7","3","0","0","0","58","32","26","0","0","0","1","0","1","2","2","0","-2"
"226091","Lamar University","2017","On-tenure track, instructors","2","0","2","0","0","0","0","0","0","0","0","0","0","0","0","0","0","0","2","0","2","0","0","0","0","0","0","0","0","0","-2"
"226091","Lamar University","2017","Not on tenure track/No tenure system system total","145","52","93","0","0","0","10","8","2","11","2","9","9","3","6","0","0","0","113","37","76","0","0","0","1","1","0","1","1","0","-2"
"226091","Lamar University","2017","Not on tenure/no tenure system, professors","1","1","0","0","0","0","0","0","0","0","0","0","0","0","0","0","0","0","1","1","0","0","0","0","0","0","0","0","0","0","-2"
"226091","Lamar University","2017","Not on tenure/no tenure system, associate professors","1","1","0","0","0","0","0","0","0","0","0","0","0","0","0","0","0","0","1","1","0","0","0","0","0","0","0","0","0","0","-2"
"226091","Lamar University","2017","Not on tenure/no tenure system, assistant professors","16","6","10","0","0","0","3","3","0","1","0","1","2","1","1","0","0","0","10","2","8","0","0","0","0","0","0","0","0","0","-2"
"226091","Lamar University","2017","Not on tenure/no tenure system, instructors","127","44","83","0","0","0","7","5","2","10","2","8","7","2","5","0","0","0","101","33","68","0","0","0","1","1","0","1","1","0","-2"
"226383","Lubbock Christian University","2017","Tenured total","58","29","29","0","0","0","0","0","0","0","0","0","4","4","0","0","0","0","54","25","29","0","0","0","0","0","0","0","0","0","-2"
"226383","Lubbock Christian University","2017","Tenured, professors","28","17","11","0","0","0","0","0","0","0","0","0","2","2","0","0","0","0","26","15","11","0","0","0","0","0","0","0","0","0","-2"
"226383","Lubbock Christian University","2017","Tenured, associate professors","23","11","12","0","0","0","0","0","0","0","0","0","2","2","0","0","0","0","21","9","12","0","0","0","0","0","0","0","0","0","-2"
"226383","Lubbock Christian University","2017","Tenured, assistant professors","7","1","6","0","0","0","0","0","0","0","0","0","0","0","0","0","0","0","7","1","6","0","0","0","0","0","0","0","0","0","-2"
"226383","Lubbock Christian University","2017","On-Tenure track total","32","19","13","0","0","0","0","0","0","0","0","0","0","0","0","0","0","0","32","19","13","0","0","0","0","0","0","0","0","0","-2"
"226383","Lubbock Christian University","2017","On-tenure track, professors","2","1","1","0","0","0","0","0","0","0","0","0","0","0","0","0","0","0","2","1","1","0","0","0","0","0","0","0","0","0","-2"
"226383","Lubbock Christian University","2017","On-tenure track, associate professors","8","7","1","0","0","0","0","0","0","0","0","0","0","0","0","0","0","0","8","7","1","0","0","0","0","0","0","0","0","0","-2"
"226383","Lubbock Christian University","2017","On-tenure track, assistant professors","22","11","11","0","0","0","0","0","0","0","0","0","0","0","0","0","0","0","22","11","11","0","0","0","0","0","0","0","0","0","-2"
"226383","Lubbock Christian University","2017","Not on tenure track/No tenure system system total","3","1","2","0","0","0","0","0","0","0","0","0","0","0","0","0","0","0","3","1","2","0","0","0","0","0","0","0","0","0","-2"
"226383","Lubbock Christian University","2017","Not on tenure/no tenure system, lecturers","3","1","2","0","0","0","0","0","0","0","0","0","0","0","0","0","0","0","3","1","2","0","0","0","0","0","0","0","0","0","-2"
"226471","University of Mary Hardin-Baylor","2017","Tenured total","60","30","30","0","0","0","5","3","2","0","0","0","0","0","0","0","0","0","53","26","27","0","0","0","1","1","0","1","0","1","-2"
"226471","University of Mary Hardin-Baylor","2017","Tenured, professors","41","23","18","0","0","0","2","2","0","0","0","0","0","0","0","0","0","0","37","20","17","0","0","0","1","1","0","1","0","1","-2"
"226471","University of Mary Hardin-Baylor","2017","Tenured, associate professors","19","7","12","0","0","0","3","1","2","0","0","0","0","0","0","0","0","0","16","6","10","0","0","0","0","0","0","0","0","0","-2"
"226471","University of Mary Hardin-Baylor","2017","On-Tenure track total","59","28","31","0","0","0","2","2","0","4","0","4","2","0","2","1","1","0","45","23","22","2","1","1","2","0","2","1","1","0","-2"
"226471","University of Mary Hardin-Baylor","2017","On-tenure track, professors","6","2","4","0","0","0","0","0","0","0","0","0","0","0","0","0","0","0","5","2","3","1","0","1","0","0","0","0","0","0","-2"
"226471","University of Mary Hardin-Baylor","2017","On-tenure track, associate professors","19","7","12","0","0","0","1","1","0","3","0","3","1","0","1","0","0","0","12","6","6","0","0","0","2","0","2","0","0","0","-2"
"226471","University of Mary Hardin-Baylor","2017","On-tenure track, assistant professors","34","19","15","0","0","0","1","1","0","1","0","1","1","0","1","1","1","0","28","15","13","1","1","0","0","0","0","1","1","0","-2"
"226471","University of Mary Hardin-Baylor","2017","Not on tenure track/No tenure system system total","37","10","27","0","0","0","0","0","0","0","0","0","1","0","1","0","0","0","35","10","25","1","0","1","0","0","0","0","0","0","-2"
"226471","University of Mary Hardin-Baylor","2017","Not on tenure/no tenure system, professors","1","1","0","0","0","0","0","0","0","0","0","0","0","0","0","0","0","0","1","1","0","0","0","0","0","0","0","0","0","0","-2"
"226471","University of Mary Hardin-Baylor","2017","Not on tenure/no tenure system, associate professors","4","2","2","0","0","0","0","0","0","0","0","0","0","0","0","0","0","0","4","2","2","0","0","0","0","0","0","0","0","0","-2"
"226471","University of Mary Hardin-Baylor","2017","Not on tenure/no tenure system, assistant professors","20","6","14","0","0","0","0","0","0","0","0","0","1","0","1","0","0","0","19","6","13","0","0","0","0","0","0","0","0","0","-2"
"226471","University of Mary Hardin-Baylor","2017","Not on tenure/no tenure system, instructors","12","1","11","0","0","0","0","0","0","0","0","0","0","0","0","0","0","0","11","1","10","1","0","1","0","0","0","0","0","0","-2"
"226833","Midwestern State University","2017","Tenured total","115","72","43","1","0","1","8","6","2","1","0","1","3","2","1","0","0","0","94","60","34","1","1","0","1","0","1","6","3","3","-2"
"226833","Midwestern State University","2017","Tenured, professors","39","28","11","1","0","1","4","4","0","0","0","0","3","2","1","0","0","0","29","20","9","0","0","0","0","0","0","2","2","0","-2"
"226833","Midwestern State University","2017","Tenured, associate professors","69","39","30","0","0","0","4","2","2","1","0","1","0","0","0","0","0","0","58","35","23","1","1","0","1","0","1","4","1","3","-2"
"226833","Midwestern State University","2017","Tenured, assistant professors","7","5","2","0","0","0","0","0","0","0","0","0","0","0","0","0","0","0","7","5","2","0","0","0","0","0","0","0","0","0","-2"
"226833","Midwestern State University","2017","On-Tenure track total","63","34","29","0","0","0","1","0","1","2","0","2","3","2","1","0","0","0","40","18","22","0","0","0","0","0","0","17","14","3","-2"
"226833","Midwestern State University","2017","On-tenure track, professors","1","1","0","0","0","0","0","0","0","0","0","0","0","0","0","0","0","0","1","1","0","0","0","0","0","0","0","0","0","0","-2"
"226833","Midwestern State University","2017","On-tenure track, associate professors","7","6","1","0","0","0","0","0","0","0","0","0","0","0","0","0","0","0","3","2","1","0","0","0","0","0","0","4","4","0","-2"
"226833","Midwestern State University","2017","On-tenure track, assistant professors","55","27","28","0","0","0","1","0","1","2","0","2","3","2","1","0","0","0","36","15","21","0","0","0","0","0","0","13","10","3","-2"
"226833","Midwestern State University","2017","Not on tenure track/No tenure system system total","62","12","50","0","0","0","0","0","0","1","0","1","3","1","2","0","0","0","53","9","44","0","0","0","2","1","1","3","1","2","-2"
"226833","Midwestern State University","2017","Not on tenure/no tenure system, assistant professors","34","4","30","0","0","0","0","0","0","1","0","1","2","1","1","0","0","0","29","2","27","0","0","0","1","0","1","1","1","0","-2"
"226833","Midwestern State University","2017","Not on tenure/no tenure system, instructors","23","5","18","0","0","0","0","0","0","0","0","0","1","0","1","0","0","0","20","5","15","0","0","0","0","0","0","2","0","2","-2"
"226833","Midwestern State University","2017","Not on tenure/no tenure system, lecturers","5","3","2","0","0","0","0","0","0","0","0","0","0","0","0","0","0","0","4","2","2","0","0","0","1","1","0","0","0","0","-2"
"227429","Paul Quinn College","2017","Not on tenure track/No tenure system system total","9","5","4","0","0","0","0","0","0","6","4","2","2","1","1","0","0","0","1","0","1","0","0","0","0","0","0","0","0","0","-2"
"227429","Paul Quinn College","2017","Not on tenure/no tenure system, associate professors","9","5","4","0","0","0","0","0","0","6","4","2","2","1","1","0","0","0","1","0","1","0","0","0","0","0","0","0","0","0","-2"
"227881","Sam Houston State University","2017","Tenured total","351","222","129","1","1","0","33","21","12","8","4","4","19","12","7","0","0","0","288","183","105","1","0","1","0","0","0","1","1","0","-2"
"227881","Sam Houston State University","2017","Tenured, professors","167","114","53","1","1","0","11","9","2","3","3","0","5","4","1","0","0","0","147","97","50","0","0","0","0","0","0","0","0","0","-2"
"227881","Sam Houston State University","2017","Tenured, associate professors","180","107","73","0","0","0","21","11","10","5","1","4","14","8","6","0","0","0","138","86","52","1","0","1","0","0","0","1","1","0","-2"
"227881","Sam Houston State University","2017","Tenured, assistant professors","3","1","2","0","0","0","1","1","0","0","0","0","0","0","0","0","0","0","2","0","2","0","0","0","0","0","0","0","0","0","-2"
"227881","Sam Houston State University","2017","Tenured, instructors","1","0","1","0","0","0","0","0","0","0","0","0","0","0","0","0","0","0","1","0","1","0","0","0","0","0","0","0","0","0","-2"
"227881","Sam Houston State University","2017","On-Tenure track total","207","102","105","2","0","2","14","6","8","11","5","6","17","10","7","0","0","0","137","65","72","1","0","1","0","0","0","25","16","9","-2"
"227881","Sam Houston State University","2017","On-tenure track, professors","1","1","0","0","0","0","0","0","0","0","0","0","0","0","0","0","0","0","1","1","0","0","0","0","0","0","0","0","0","0","-2"
"227881","Sam Houston State University","2017","On-tenure track, associate professors","15","11","4","0","0","0","2","1","1","1","1","0","0","0","0","0","0","0","12","9","3","0","0","0","0","0","0","0","0","0","-2"
"227881","Sam Houston State University","2017","On-tenure track, assistant professors","191","90","101","2","0","2","12","5","7","10","4","6","17","10","7","0","0","0","124","55","69","1","0","1","0","0","0","25","16","9","-2"
"227881","Sam Houston State University","2017","Not on tenure track/No tenure system system total","209","87","122","2","0","2","5","1","4","11","4","7","16","8","8","0","0","0","162","64","98","4","4","0","0","0","0","9","6","3","-2"
"227881","Sam Houston State University","2017","Not on tenure/no tenure system, lecturers","209","87","122","2","0","2","5","1","4","11","4","7","16","8","8","0","0","0","162","64","98","4","4","0","0","0","0","9","6","3","-2"
"228325","Southwestern Assemblies of God University","2017","Not on tenure track/No tenure system system total","87","52","35","1","1","0","4","0","4","5","3","2","2","2","0","0","0","0","75","46","29","0","0","0","0","0","0","0","0","0","-2"
"228325","Southwestern Assemblies of God University","2017","Not on tenure/no tenure system, professors","26","19","7","0","0","0","1","0","1","1","1","0","1","1","0","0","0","0","23","17","6","0","0","0","0","0","0","0","0","0","-2"
"228325","Southwestern Assemblies of God University","2017","Not on tenure/no tenure system, associate professors","12","5","7","0","0","0","1","0","1","1","0","1","0","0","0","0","0","0","10","5","5","0","0","0","0","0","0","0","0","0","-2"
"228325","Southwestern Assemblies of God University","2017","Not on tenure/no tenure system, assistant professors","22","14","8","0","0","0","1","0","1","1","0","1","0","0","0","0","0","0","20","14","6","0","0","0","0","0","0","0","0","0","-2"
"228325","Southwestern Assemblies of God University","2017","Not on tenure/no tenure system, instructors","26","14","12","1","1","0","1","0","1","2","2","0","1","1","0","0","0","0","21","10","11","0","0","0","0","0","0","0","0","0","-2"
"228325","Southwestern Assemblies of God University","2017","Not on tenure/no tenure system, lecturers","1","0","1","0","0","0","0","0","0","0","0","0","0","0","0","0","0","0","1","0","1","0","0","0","0","0","0","0","0","0","-2"
"228343","Southwestern University","2017","Tenured total","79","42","37","1","1","0","2","1","1","2","1","1","8","4","4","0","0","0","65","34","31","0","0","0","1","1","0","0","0","0","-2"
"228343","Southwestern University","2017","Tenured, professors","42","19","23","0","0","0","1","1","0","0","0","0","2","0","2","0","0","0","38","17","21","0","0","0","1","1","0","0","0","0","-2"
"228343","Southwestern University","2017","Tenured, associate professors","37","23","14","1","1","0","1","0","1","2","1","1","6","4","2","0","0","0","27","17","10","0","0","0","0","0","0","0","0","0","-2"
"228343","Southwestern University","2017","On-Tenure track total","13","6","7","0","0","0","2","0","2","0","0","0","1","0","1","0","0","0","9","5","4","0","0","0","0","0","0","1","1","0","-2"
"228343","Southwestern University","2017","On-tenure track, assistant professors","13","6","7","0","0","0","2","0","2","0","0","0","1","0","1","0","0","0","9","5","4","0","0","0","0","0","0","1","1","0","-2"
"228343","Southwestern University","2017","Not on tenure track/No tenure system system total","23","8","15","0","0","0","2","0","2","0","0","0","4","1","3","0","0","0","16","7","9","0","0","0","1","0","1","0","0","0","-2"
"228343","Southwestern University","2017","Not on tenure/no tenure system, associate professors","2","2","0","0","0","0","0","0","0","0","0","0","0","0","0","0","0","0","2","2","0","0","0","0","0","0","0","0","0","0","-2"
"228343","Southwestern University","2017","Not on tenure/no tenure system, assistant professors","5","2","3","0","0","0","1","0","1","0","0","0","1","0","1","0","0","0","3","2","1","0","0","0","0","0","0","0","0","0","-2"
"228343","Southwestern University","2017","Not on tenure/no tenure system, instructors","16","4","12","0","0","0","1","0","1","0","0","0","3","1","2","0","0","0","11","3","8","0","0","0","1","0","1","0","0","0","-2"
"228431","Stephen F Austin State University","2017","Tenured total","261","160","101","1","0","1","1","1","0","10","8","2","12","6","6","0","0","0","227","140","87","7","3","4","1","1","0","2","1","1","-2"
"228431","Stephen F Austin State University","2017","Tenured, professors","101","70","31","0","0","0","0","0","0","4","3","1","3","0","3","0","0","0","92","66","26","1","0","1","1","1","0","0","0","0","-2"
"228431","Stephen F Austin State University","2017","Tenured, associate professors","133","77","56","0","0","0","1","1","0","6","5","1","9","6","3","0","0","0","112","63","49","4","2","2","0","0","0","1","0","1","-2"
"228431","Stephen F Austin State University","2017","Tenured, assistant professors","21","12","9","1","0","1","0","0","0","0","0","0","0","0","0","0","0","0","17","10","7","2","1","1","0","0","0","1","1","0","-2"
"228431","Stephen F Austin State University","2017","Tenured, instructors","5","1","4","0","0","0","0","0","0","0","0","0","0","0","0","0","0","0","5","1","4","0","0","0","0","0","0","0","0","0","-2"
"228431","Stephen F Austin State University","2017","Tenured, lecturers","1","0","1","0","0","0","0","0","0","0","0","0","0","0","0","0","0","0","1","0","1","0","0","0","0","0","0","0","0","0","-2"
"228431","Stephen F Austin State University","2017","On-Tenure track total","143","76","67","1","0","1","5","2","3","2","1","1","10","8","2","0","0","0","119","63","56","0","0","0","1","0","1","5","2","3","-2"
"228431","Stephen F Austin State University","2017","On-tenure track, associate professors","13","10","3","0","0","0","0","0","0","1","1","0","1","1","0","0","0","0","11","8","3","0","0","0","0","0","0","0","0","0","-2"
"228431","Stephen F Austin State University","2017","On-tenure track, assistant professors","126","64","62","1","0","1","5","2","3","1","0","1","9","7","2","0","0","0","104","53","51","0","0","0","1","0","1","5","2","3","-2"
"228431","Stephen F Austin State University","2017","On-tenure track, instructors","4","2","2","0","0","0","0","0","0","0","0","0","0","0","0","0","0","0","4","2","2","0","0","0","0","0","0","0","0","0","-2"
"228431","Stephen F Austin State University","2017","Not on tenure track/No tenure system system total","120","36","84","2","1","1","4","1","3","2","0","2","4","2","2","0","0","0","103","29","74","4","3","1","0","0","0","1","0","1","-2"
"228431","Stephen F Austin State University","2017","Not on tenure/no tenure system, professors","1","1","0","0","0","0","0","0","0","0","0","0","0","0","0","0","0","0","1","1","0","0","0","0","0","0","0","0","0","0","-2"
"228431","Stephen F Austin State University","2017","Not on tenure/no tenure system, assistant professors","12","4","8","0","0","0","0","0","0","0","0","0","0","0","0","0","0","0","11","4","7","0","0","0","0","0","0","1","0","1","-2"
"228431","Stephen F Austin State University","2017","Not on tenure/no tenure system, instructors","37","5","32","0","0","0","0","0","0","2","0","2","2","0","2","0","0","0","33","5","28","0","0","0","0","0","0","0","0","0","-2"
"228431","Stephen F Austin State University","2017","Not on tenure/no tenure system, lecturers","64","23","41","2","1","1","4","1","3","0","0","0","2","2","0","0","0","0","52","16","36","4","3","1","0","0","0","0","0","0","-2"
"228431","Stephen F Austin State University","2017","Not on tenure/no tenure system, no academic rank","6","3","3","0","0","0","0","0","0","0","0","0","0","0","0","0","0","0","6","3","3","0","0","0","0","0","0","0","0","0","-2"
"228529","Tarleton State University","2017","Tenured total","107","74","33","2","2","0","6","5","1","0","0","0","6","5","1","0","0","0","91","60","31","1","1","0","1","1","0","0","0","0","-2"
"228529","Tarleton State University","2017","Tenured, professors","64","45","19","2","2","0","3","3","0","0","0","0","2","2","0","0","0","0","56","37","19","0","0","0","1","1","0","0","0","0","-2"
"228529","Tarleton State University","2017","Tenured, associate professors","43","29","14","0","0","0","3","2","1","0","0","0","4","3","1","0","0","0","35","23","12","1","1","0","0","0","0","0","0","0","-2"
"228529","Tarleton State University","2017","On-Tenure track total","180","94","86","2","1","1","11","5","6","9","4","5","10","7","3","0","0","0","132","66","66","5","3","2","3","2","1","8","6","2","-2"
"228529","Tarleton State University","2017","On-tenure track, professors","4","2","2","1","0","1","0","0","0","0","0","0","0","0","0","0","0","0","3","2","1","0","0","0","0","0","0","0","0","0","-2"
"228529","Tarleton State University","2017","On-tenure track, associate professors","30","14","16","1","1","0","1","0","1","0","0","0","2","1","1","0","0","0","25","11","14","0","0","0","1","1","0","0","0","0","-2"
"228529","Tarleton State University","2017","On-tenure track, assistant professors","146","78","68","0","0","0","10","5","5","9","4","5","8","6","2","0","0","0","104","53","51","5","3","2","2","1","1","8","6","2","-2"
"228529","Tarleton State University","2017","Not on tenure track/No tenure system system total","129","51","78","2","2","0","4","3","1","2","2","0","7","1","6","0","0","0","106","39","67","2","0","2","3","1","2","3","3","0","-2"
"228529","Tarleton State University","2017","Not on tenure/no tenure system, associate professors","2","0","2","0","0","0","0","0","0","0","0","0","1","0","1","0","0","0","1","0","1","0","0","0","0","0","0","0","0","0","-2"
"228529","Tarleton State University","2017","Not on tenure/no tenure system, assistant professors","42","16","26","0","0","0","0","0","0","1","1","0","2","0","2","0","0","0","36","13","23","0","0","0","1","0","1","2","2","0","-2"
"228529","Tarleton State University","2017","Not on tenure/no tenure system, instructors","82","34","48","2","2","0","4","3","1","1","1","0","4","1","3","0","0","0","69","26","43","1","0","1","1","1","0","0","0","0","-2"
"228529","Tarleton State University","2017","Not on tenure/no tenure system, lecturers","3","1","2","0","0","0","0","0","0","0","0","0","0","0","0","0","0","0","0","0","0","1","0","1","1","0","1","1","1","0","-2"
"228653","The University of Texas Medical Branch at Galveston","2017","Tenured total","215","149","66","0","0","0","51","33","18","5","3","2","16","11","5","0","0","0","135","97","38","1","1","0","0","0","0","7","4","3","-2"
"228653","The University of Texas Medical Branch at Galveston","2017","Tenured, professors","158","119","39","0","0","0","39","28","11","3","2","1","13","10","3","0","0","0","101","77","24","1","1","0","0","0","0","1","1","0","-2"
"228653","The University of Texas Medical Branch at Galveston","2017","Tenured, associate professors","55","29","26","0","0","0","12","5","7","2","1","1","3","1","2","0","0","0","32","19","13","0","0","0","0","0","0","6","3","3","-2"
"228653","The University of Texas Medical Branch at Galveston","2017","Tenured, assistant professors","2","1","1","0","0","0","0","0","0","0","0","0","0","0","0","0","0","0","2","1","1","0","0","0","0","0","0","0","0","0","-2"
"228653","The University of Texas Medical Branch at Galveston","2017","On-Tenure track total","96","59","37","0","0","0","25","18","7","4","1","3","5","3","2","0","0","0","50","29","21","1","0","1","0","0","0","11","8","3","-2"
"228653","The University of Texas Medical Branch at Galveston","2017","On-tenure track, professors","2","2","0","0","0","0","0","0","0","0","0","0","0","0","0","0","0","0","2","2","0","0","0","0","0","0","0","0","0","0","-2"
"228653","The University of Texas Medical Branch at Galveston","2017","On-tenure track, associate professors","31","18","13","0","0","0","7","7","0","2","1","1","2","0","2","0","0","0","17","8","9","0","0","0","0","0","0","3","2","1","-2"
"228653","The University of Texas Medical Branch at Galveston","2017","On-tenure track, assistant professors","63","39","24","0","0","0","18","11","7","2","0","2","3","3","0","0","0","0","31","19","12","1","0","1","0","0","0","8","6","2","-2"
"228653","The University of Texas Medical Branch at Galveston","2017","Not on tenure track/No tenure system system total","101","22","79","0","0","0","9","3","6","3","1","2","12","4","8","0","0","0","72","12","60","3","2","1","0","0","0","2","0","2","-2"
"228653","The University of Texas Medical Branch at Galveston","2017","Not on tenure/no tenure system, professors","10","6","4","0","0","0","0","0","0","0","0","0","0","0","0","0","0","0","10","6","4","0","0","0","0","0","0","0","0","0","-2"
"228653","The University of Texas Medical Branch at Galveston","2017","Not on tenure/no tenure system, associate professors","17","2","15","0","0","0","2","0","2","0","0","0","2","1","1","0","0","0","13","1","12","0","0","0","0","0","0","0","0","0","-2"
"228653","The University of Texas Medical Branch at Galveston","2017","Not on tenure/no tenure system, assistant professors","72","13","59","0","0","0","7","3","4","3","1","2","10","3","7","0","0","0","47","4","43","3","2","1","0","0","0","2","0","2","-2"
"228653","The University of Texas Medical Branch at Galveston","2017","Not on tenure/no tenure system, instructors","1","0","1","0","0","0","0","0","0","0","0","0","0","0","0","0","0","0","1","0","1","0","0","0","0","0","0","0","0","0","-2"
"228653","The University of Texas Medical Branch at Galveston","2017","Not on tenure/no tenure system, no academic rank","1","1","0","0","0","0","0","0","0","0","0","0","0","0","0","0","0","0","1","1","0","0","0","0","0","0","0","0","0","0","-2"
"228787","The University of Texas at Dallas","2017","Tenured total","393","312","81","0","0","0","114","93","21","5","2","3","12","12","0","1","1","0","247","192","55","5","5","0","5","4","1","4","3","1","-2"
"228787","The University of Texas at Dallas","2017","Tenured, professors","253","216","37","0","0","0","77","68","9","0","0","0","8","8","0","1","1","0","161","133","28","3","3","0","2","2","0","1","1","0","-2"
"228787","The University of Texas at Dallas","2017","Tenured, associate professors","140","96","44","0","0","0","37","25","12","5","2","3","4","4","0","0","0","0","86","59","27","2","2","0","3","2","1","3","2","1","-2"
"228787","The University of Texas at Dallas","2017","On-Tenure track total","144","106","38","0","0","0","45","36","9","8","6","2","5","4","1","0","0","0","51","35","16","3","3","0","10","6","4","22","16","6","-2"
"228787","The University of Texas at Dallas","2017","On-tenure track, associate professors","8","7","1","0","0","0","2","2","0","1","1","0","1","1","0","0","0","0","3","2","1","0","0","0","1","1","0","0","0","0","-2"
"228787","The University of Texas at Dallas","2017","On-tenure track, assistant professors","136","99","37","0","0","0","43","34","9","7","5","2","4","3","1","0","0","0","48","33","15","3","3","0","9","5","4","22","16","6","-2"
"228787","The University of Texas at Dallas","2017","Not on tenure track/No tenure system system total","326","174","152","0","0","0","63","32","31","8","4","4","11","8","3","0","0","0","224","117","107","2","2","0","9","4","5","9","7","2","-2"
"228787","The University of Texas at Dallas","2017","Not on tenure/no tenure system, lecturers","326","174","152","0","0","0","63","32","31","8","4","4","11","8","3","0","0","0","224","117","107","2","2","0","9","4","5","9","7","2","-2"
"228802","The University of Texas at Tyler","2017","Tenured total","133","83","50","1","1","0","14","11","3","8","4","4","4","4","0","0","0","0","106","63","43","0","0","0","0","0","0","0","0","0","-2"
"228802","The University of Texas at Tyler","2017","Tenured, professors","60","43","17","1","1","0","9","7","2","1","1","0","1","1","0","0","0","0","48","33","15","0","0","0","0","0","0","0","0","0","-2"
"228802","The University of Texas at Tyler","2017","Tenured, associate professors","73","40","33","0","0","0","5","4","1","7","3","4","3","3","0","0","0","0","58","30","28","0","0","0","0","0","0","0","0","0","-2"
"228802","The University of Texas at Tyler","2017","On-Tenure track total","93","43","50","0","0","0","18","11","7","3","1","2","4","3","1","0","0","0","61","22","39","0","0","0","6","6","0","1","0","1","-2"
"228802","The University of Texas at Tyler","2017","On-tenure track, professors","1","0","1","0","0","0","0","0","0","0","0","0","0","0","0","0","0","0","1","0","1","0","0","0","0","0","0","0","0","0","-2"
"228802","The University of Texas at Tyler","2017","On-tenure track, associate professors","6","2","4","0","0","0","0","0","0","0","0","0","0","0","0","0","0","0","4","0","4","0","0","0","2","2","0","0","0","0","-2"
"228802","The University of Texas at Tyler","2017","On-tenure track, assistant professors","86","41","45","0","0","0","18","11","7","3","1","2","4","3","1","0","0","0","56","22","34","0","0","0","4","4","0","1","0","1","-2"
"228802","The University of Texas at Tyler","2017","Not on tenure track/No tenure system system total","114","21","93","0","0","0","4","2","2","6","1","5","6","2","4","0","0","0","93","15","78","0","0","0","5","1","4","0","0","0","-2"
"228802","The University of Texas at Tyler","2017","Not on tenure/no tenure system, instructors","68","8","60","0","0","0","2","2","0","5","1","4","2","0","2","0","0","0","56","5","51","0","0","0","3","0","3","0","0","0","-2"
"228802","The University of Texas at Tyler","2017","Not on tenure/no tenure system, lecturers","46","13","33","0","0","0","2","0","2","1","0","1","4","2","2","0","0","0","37","10","27","0","0","0","2","1","1","0","0","0","-2"
"229267","Trinity University","2017","Tenured total","176","106","70","1","0","1","12","7","5","7","4","3","17","10","7","0","0","0","137","84","53","0","0","0","2","1","1","0","0","0","-2"
"229267","Trinity University","2017","Tenured, professors","84","51","33","0","0","0","4","3","1","0","0","0","3","2","1","0","0","0","76","45","31","0","0","0","1","1","0","0","0","0","-2"
"229267","Trinity University","2017","Tenured, associate professors","92","55","37","1","0","1","8","4","4","7","4","3","14","8","6","0","0","0","61","39","22","0","0","0","1","0","1","0","0","0","-2"
"229267","Trinity University","2017","On-Tenure track total","49","23","26","0","0","0","7","3","4","0","0","0","5","4","1","0","0","0","36","16","20","0","0","0","0","0","0","1","0","1","-2"
"229267","Trinity University","2017","On-tenure track, associate professors","1","0","1","0","0","0","0","0","0","0","0","0","0","0","0","0","0","0","1","0","1","0","0","0","0","0","0","0","0","0","-2"
"229267","Trinity University","2017","On-tenure track, assistant professors","48","23","25","0","0","0","7","3","4","0","0","0","5","4","1","0","0","0","35","16","19","0","0","0","0","0","0","1","0","1","-2"
"229267","Trinity University","2017","Not on tenure track/No tenure system system total","27","14","13","0","0","0","1","1","0","1","0","1","2","0","2","0","0","0","21","12","9","0","0","0","2","1","1","0","0","0","-2"
"229267","Trinity University","2017","Not on tenure/no tenure system, professors","4","4","0","0","0","0","1","1","0","0","0","0","0","0","0","0","0","0","3","3","0","0","0","0","0","0","0","0","0","0","-2"
"229267","Trinity University","2017","Not on tenure/no tenure system, associate professors","1","1","0","0","0","0","0","0","0","0","0","0","0","0","0","0","0","0","1","1","0","0","0","0","0","0","0","0","0","0","-2"
"229267","Trinity University","2017","Not on tenure/no tenure system, assistant professors","15","8","7","0","0","0","0","0","0","0","0","0","0","0","0","0","0","0","14","8","6","0","0","0","1","0","1","0","0","0","-2"
"229267","Trinity University","2017","Not on tenure/no tenure system, instructors","6","1","5","0","0","0","0","0","0","1","0","1","1","0","1","0","0","0","3","0","3","0","0","0","1","1","0","0","0","0","-2"
"229267","Trinity University","2017","Not on tenure/no tenure system, lecturers","1","0","1","0","0","0","0","0","0","0","0","0","1","0","1","0","0","0","0","0","0","0","0","0","0","0","0","0","0","0","-2"
"232706","Marymount University","2017","Tenured total","86","21","65","0","0","0","3","0","3","1","0","1","1","0","1","0","0","0","74","20","54","2","0","2","4","1","3","1","0","1","-2"
"232706","Marymount University","2017","Tenured, professors","47","9","38","0","0","0","2","0","2","1","0","1","1","0","1","0","0","0","41","8","33","1","0","1","1","1","0","0","0","0","-2"
"232706","Marymount University","2017","Tenured, associate professors","39","12","27","0","0","0","1","0","1","0","0","0","0","0","0","0","0","0","33","12","21","1","0","1","3","0","3","1","0","1","-2"
"232706","Marymount University","2017","On-Tenure track total","42","14","28","1","0","1","0","0","0","1","1","0","3","2","1","0","0","0","34","11","23","1","0","1","2","0","2","0","0","0","-2"
"232706","Marymount University","2017","On-tenure track, associate professors","5","2","3","0","0","0","0","0","0","0","0","0","0","0","0","0","0","0","5","2","3","0","0","0","0","0","0","0","0","0","-2"
"232706","Marymount University","2017","On-tenure track, assistant professors","37","12","25","1","0","1","0","0","0","1","1","0","3","2","1","0","0","0","29","9","20","1","0","1","2","0","2","0","0","0","-2"
"232706","Marymount University","2017","Not on tenure track/No tenure system system total","34","9","25","0","0","0","0","0","0","3","1","2","0","0","0","1","0","1","28","7","21","0","0","0","2","1","1","0","0","0","-2"
"232706","Marymount University","2017","Not on tenure/no tenure system, professors","2","2","0","0","0","0","0","0","0","0","0","0","0","0","0","0","0","0","2","2","0","0","0","0","0","0","0","0","0","0","-2"
"232706","Marymount University","2017","Not on tenure/no tenure system, associate professors","1","1","0","0","0","0","0","0","0","0","0","0","0","0","0","0","0","0","1","1","0","0","0","0","0","0","0","0","0","0","-2"
"232706","Marymount University","2017","Not on tenure/no tenure system, assistant professors","3","0","3","0","0","0","0","0","0","0","0","0","0","0","0","0","0","0","3","0","3","0","0","0","0","0","0","0","0","0","-2"
"232706","Marymount University","2017","Not on tenure/no tenure system, instructors","26","6","20","0","0","0","0","0","0","3","1","2","0","0","0","1","0","1","20","4","16","0","0","0","2","1","1","0","0","0","-2"
"232706","Marymount University","2017","Not on tenure/no tenure system, no academic rank","2","0","2","0","0","0","0","0","0","0","0","0","0","0","0","0","0","0","2","0","2","0","0","0","0","0","0","0","0","0","-2"
"234827","Central Washington University","2017","Tenured total","271","166","105","2","1","1","13","7","6","8","4","4","10","5","5","4","4","0","193","121","72","2","1","1","28","16","12","11","7","4","-2"
"234827","Central Washington University","2017","Tenured, professors","156","99","57","1","0","1","8","5","3","4","1","3","5","4","1","3","3","0","118","76","42","1","0","1","14","8","6","2","2","0","-2"
"234827","Central Washington University","2017","Tenured, associate professors","112","66","46","1","1","0","5","2","3","4","3","1","5","1","4","1","1","0","72","44","28","1","1","0","14","8","6","9","5","4","-2"
"234827","Central Washington University","2017","Tenured, assistant professors","3","1","2","0","0","0","0","0","0","0","0","0","0","0","0","0","0","0","3","1","2","0","0","0","0","0","0","0","0","0","-2"
"234827","Central Washington University","2017","On-Tenure track total","96","42","54","0","0","0","5","2","3","1","0","1","5","1","4","0","0","0","48","17","31","0","0","0","35","21","14","2","1","1","-2"
"234827","Central Washington University","2017","On-tenure track, associate professors","2","1","1","0","0","0","0","0","0","0","0","0","0","0","0","0","0","0","1","1","0","0","0","0","1","0","1","0","0","0","-2"
"234827","Central Washington University","2017","On-tenure track, assistant professors","94","41","53","0","0","0","5","2","3","1","0","1","5","1","4","0","0","0","47","16","31","0","0","0","34","21","13","2","1","1","-2"
"234827","Central Washington University","2017","Not on tenure track/No tenure system system total","140","76","64","1","1","0","2","0","2","2","2","0","4","2","2","1","1","0","98","54","44","2","1","1","29","14","15","1","1","0","-2"
"234827","Central Washington University","2017","Not on tenure/no tenure system, instructors","8","7","1","0","0","0","0","0","0","0","0","0","0","0","0","1","1","0","5","5","0","1","1","0","1","0","1","0","0","0","-2"
"234827","Central Washington University","2017","Not on tenure/no tenure system, lecturers","132","69","63","1","1","0","2","0","2","2","2","0","4","2","2","0","0","0","93","49","44","1","0","1","28","14","14","1","1","0","-2"
"235097","Eastern Washington University","2017","Tenured total","224","131","93","2","1","1","17","11","6","4","4","0","7","4","3","0","0","0","190","110","80","3","1","2","0","0","0","1","0","1","-2"
"235097","Eastern Washington University","2017","Tenured, professors","157","102","55","2","1","1","11","9","2","3","3","0","4","3","1","0","0","0","137","86","51","0","0","0","0","0","0","0","0","0","-2"
"235097","Eastern Washington University","2017","Tenured, associate professors","67","29","38","0","0","0","6","2","4","1","1","0","3","1","2","0","0","0","53","24","29","3","1","2","0","0","0","1","0","1","-2"
"235097","Eastern Washington University","2017","On-Tenure track total","102","47","55","2","0","2","6","2","4","3","3","0","7","3","4","0","0","0","74","34","40","3","2","1","0","0","0","7","3","4","-2"
"235097","Eastern Washington University","2017","On-tenure track, assistant professors","102","47","55","2","0","2","6","2","4","3","3","0","7","3","4","0","0","0","74","34","40","3","2","1","0","0","0","7","3","4","-2"
"235097","Eastern Washington University","2017","Not on tenure track/No tenure system system total","152","69","83","0","0","0","12","8","4","4","1","3","5","3","2","1","1","0","121","51","70","4","1","3","0","0","0","5","4","1","-2"
"235097","Eastern Washington University","2017","Not on tenure/no tenure system, lecturers","57","26","31","0","0","0","3","1","2","1","0","1","0","0","0","1","1","0","52","24","28","0","0","0","0","0","0","0","0","0","-2"
"235097","Eastern Washington University","2017","Not on tenure/no tenure system, no academic rank","95","43","52","0","0","0","9","7","2","3","1","2","5","3","2","0","0","0","69","27","42","4","1","3","0","0","0","5","4","1","-2"
"235237","Pierce College District","2017","Tenured total","48","22","26","1","1","0","1","0","1","0","0","0","2","1","1","0","0","0","39","18","21","5","2","3","0","0","0","0","0","0","-2"
"235237","Pierce College District","2017","Tenured, no academic rank","48","22","26","1","1","0","1","0","1","0","0","0","2","1","1","0","0","0","39","18","21","5","2","3","0","0","0","0","0","0","-2"
"235237","Pierce College District","2017","On-Tenure track total","26","7","19","0","0","0","2","0","2","3","0","3","1","0","1","0","0","0","19","7","12","1","0","1","0","0","0","0","0","0","-2"
"235237","Pierce College District","2017","On-tenure track, no academic rank","26","7","19","0","0","0","2","0","2","3","0","3","1","0","1","0","0","0","19","7","12","1","0","1","0","0","0","0","0","0","-2"
"235237","Pierce College District","2017","Not on tenure track/No tenure system system total","10","2","8","0","0","0","0","0","0","1","0","1","0","0","0","0","0","0","9","2","7","0","0","0","0","0","0","0","0","0","-2"
"235237","Pierce College District","2017","Not on tenure/no tenure system, no academic rank","10","2","8","0","0","0","0","0","0","1","0","1","0","0","0","0","0","0","9","2","7","0","0","0","0","0","0","0","0","0","-2"
"236452","Saint Martin's University","2017","Tenured total","40","23","17","0","0","0","4","3","1","2","2","0","2","1","1","0","0","0","32","17","15","0","0","0","0","0","0","0","0","0","-2"
"236452","Saint Martin's University","2017","Tenured, professors","16","10","6","0","0","0","3","2","1","1","1","0","1","0","1","0","0","0","11","7","4","0","0","0","0","0","0","0","0","0","-2"
"236452","Saint Martin's University","2017","Tenured, associate professors","23","13","10","0","0","0","1","1","0","1","1","0","1","1","0","0","0","0","20","10","10","0","0","0","0","0","0","0","0","0","-2"
"236452","Saint Martin's University","2017","Tenured, assistant professors","1","0","1","0","0","0","0","0","0","0","0","0","0","0","0","0","0","0","1","0","1","0","0","0","0","0","0","0","0","0","-2"
"236452","Saint Martin's University","2017","On-Tenure track total","37","16","21","0","0","0","5","3","2","0","0","0","1","0","1","0","0","0","31","13","18","0","0","0","0","0","0","0","0","0","-2"
"236452","Saint Martin's University","2017","On-tenure track, professors","2","2","0","0","0","0","1","1","0","0","0","0","0","0","0","0","0","0","1","1","0","0","0","0","0","0","0","0","0","0","-2"
"236452","Saint Martin's University","2017","On-tenure track, associate professors","7","4","3","0","0","0","1","0","1","0","0","0","0","0","0","0","0","0","6","4","2","0","0","0","0","0","0","0","0","0","-2"
"236452","Saint Martin's University","2017","On-tenure track, assistant professors","28","10","18","0","0","0","3","2","1","0","0","0","1","0","1","0","0","0","24","8","16","0","0","0","0","0","0","0","0","0","-2"
"236452","Saint Martin's University","2017","Not on tenure track/No tenure system system total","9","6","3","1","1","0","0","0","0","1","0","1","0","0","0","0","0","0","7","5","2","0","0","0","0","0","0","0","0","0","-2"
"236452","Saint Martin's University","2017","Not on tenure/no tenure system, associate professors","1","1","0","0","0","0","0","0","0","0","0","0","0","0","0","0","0","0","1","1","0","0","0","0","0","0","0","0","0","0","-2"
"236452","Saint Martin's University","2017","Not on tenure/no tenure system, assistant professors","1","1","0","0","0","0","0","0","0","0","0","0","0","0","0","0","0","0","1","1","0","0","0","0","0","0","0","0","0","0","-2"
"236452","Saint Martin's University","2017","Not on tenure/no tenure system, instructors","7","4","3","1","1","0","0","0","0","1","0","1","0","0","0","0","0","0","5","3","2","0","0","0","0","0","0","0","0","0","-2"
"236638","Skagit Valley College","2017","Tenured total","78","35","43","2","2","0","1","0","1","1","1","0","3","3","0","0","0","0","70","29","41","0","0","0","0","0","0","1","0","1","-2"
"236638","Skagit Valley College","2017","Tenured, no academic rank","78","35","43","2","2","0","1","0","1","1","1","0","3","3","0","0","0","0","70","29","41","0","0","0","0","0","0","1","0","1","-2"
"236638","Skagit Valley College","2017","On-Tenure track total","17","6","11","0","0","0","1","0","1","0","0","0","1","0","1","0","0","0","15","6","9","0","0","0","0","0","0","0","0","0","-2"
"236638","Skagit Valley College","2017","On-tenure track, no academic rank","17","6","11","0","0","0","1","0","1","0","0","0","1","0","1","0","0","0","15","6","9","0","0","0","0","0","0","0","0","0","-2"
"236638","Skagit Valley College","2017","Not on tenure track/No tenure system system total","9","3","6","0","0","0","1","0","1","0","0","0","1","0","1","0","0","0","6","2","4","1","1","0","0","0","0","0","0","0","-2"
"236638","Skagit Valley College","2017","Not on tenure/no tenure system, no academic rank","9","3","6","0","0","0","1","0","1","0","0","0","1","0","1","0","0","0","6","2","4","1","1","0","0","0","0","0","0","0","-2"
"236887","Walla Walla Community College","2017","Tenured total","65","34","31","4","3","1","1","0","1","0","0","0","0","0","0","0","0","0","59","31","28","1","0","1","0","0","0","0","0","0","-2"
"236887","Walla Walla Community College","2017","Tenured, no academic rank","65","34","31","4","3","1","1","0","1","0","0","0","0","0","0","0","0","0","59","31","28","1","0","1","0","0","0","0","0","0","-2"
"236887","Walla Walla Community College","2017","On-Tenure track total","12","5","7","0","0","0","0","0","0","0","0","0","0","0","0","0","0","0","12","5","7","0","0","0","0","0","0","0","0","0","-2"
"236887","Walla Walla Community College","2017","On-tenure track, no academic rank","12","5","7","0","0","0","0","0","0","0","0","0","0","0","0","0","0","0","12","5","7","0","0","0","0","0","0","0","0","0","-2"
"236887","Walla Walla Community College","2017","Not on tenure track/No tenure system system total","43","30","13","0","0","0","0","0","0","0","0","0","3","3","0","0","0","0","39","27","12","1","0","1","0","0","0","0","0","0","-2"
"236887","Walla Walla Community College","2017","Not on tenure/no tenure system, no academic rank","43","30","13","0","0","0","0","0","0","0","0","0","3","3","0","0","0","0","39","27","12","1","0","1","0","0","0","0","0","0","-2"
"236896","Walla Walla University","2017","Tenured total","52","35","17","0","0","0","1","1","0","1","1","0","1","0","1","0","0","0","48","33","15","0","0","0","1","0","1","0","0","0","-2"
"236896","Walla Walla University","2017","Tenured, professors","33","23","10","0","0","0","1","1","0","1","1","0","1","0","1","0","0","0","29","21","8","0","0","0","1","0","1","0","0","0","-2"
"236896","Walla Walla University","2017","Tenured, associate professors","14","8","6","0","0","0","0","0","0","0","0","0","0","0","0","0","0","0","14","8","6","0","0","0","0","0","0","0","0","0","-2"
"236896","Walla Walla University","2017","Tenured, assistant professors","5","4","1","0","0","0","0","0","0","0","0","0","0","0","0","0","0","0","5","4","1","0","0","0","0","0","0","0","0","0","-2"
"236896","Walla Walla University","2017","On-Tenure track total","34","17","17","0","0","0","0","0","0","4","2","2","2","0","2","0","0","0","27","14","13","0","0","0","1","1","0","0","0","0","-2"
"236896","Walla Walla University","2017","On-tenure track, professors","4","2","2","0","0","0","0","0","0","0","0","0","0","0","0","0","0","0","3","1","2","0","0","0","1","1","0","0","0","0","-2"
"236896","Walla Walla University","2017","On-tenure track, associate professors","8","4","4","0","0","0","0","0","0","2","1","1","0","0","0","0","0","0","6","3","3","0","0","0","0","0","0","0","0","0","-2"
"236896","Walla Walla University","2017","On-tenure track, assistant professors","20","10","10","0","0","0","0","0","0","2","1","1","2","0","2","0","0","0","16","9","7","0","0","0","0","0","0","0","0","0","-2"
"236896","Walla Walla University","2017","On-tenure track, instructors","2","1","1","0","0","0","0","0","0","0","0","0","0","0","0","0","0","0","2","1","1","0","0","0","0","0","0","0","0","0","-2"
"236896","Walla Walla University","2017","Not on tenure track/No tenure system system total","12","6","6","0","0","0","1","0","1","0","0","0","0","0","0","0","0","0","10","6","4","0","0","0","1","0","1","0","0","0","-2"
"236896","Walla Walla University","2017","Not on tenure/no tenure system, professors","3","3","0","0","0","0","0","0","0","0","0","0","0","0","0","0","0","0","3","3","0","0","0","0","0","0","0","0","0","0","-2"
"236896","Walla Walla University","2017","Not on tenure/no tenure system, associate professors","2","0","2","0","0","0","0","0","0","0","0","0","0","0","0","0","0","0","1","0","1","0","0","0","1","0","1","0","0","0","-2"
"236896","Walla Walla University","2017","Not on tenure/no tenure system, assistant professors","4","1","3","0","0","0","0","0","0","0","0","0","0","0","0","0","0","0","4","1","3","0","0","0","0","0","0","0","0","0","-2"
"236896","Walla Walla University","2017","Not on tenure/no tenure system, instructors","3","2","1","0","0","0","1","0","1","0","0","0","0","0","0","0","0","0","2","2","0","0","0","0","0","0","0","0","0","0","-2"
"238430","Cardinal Stritch University","2017","Tenured total","42","17","25","0","0","0","1","0","1","3","2","1","1","0","1","0","0","0","37","15","22","0","0","0","0","0","0","0","0","0","-2"
"238430","Cardinal Stritch University","2017","Tenured, professors","8","4","4","0","0","0","0","0","0","0","0","0","1","0","1","0","0","0","7","4","3","0","0","0","0","0","0","0","0","0","-2"
"238430","Cardinal Stritch University","2017","Tenured, associate professors","15","5","10","0","0","0","1","0","1","1","1","0","0","0","0","0","0","0","13","4","9","0","0","0","0","0","0","0","0","0","-2"
"238430","Cardinal Stritch University","2017","Tenured, assistant professors","19","8","11","0","0","0","0","0","0","2","1","1","0","0","0","0","0","0","17","7","10","0","0","0","0","0","0","0","0","0","-2"
"238430","Cardinal Stritch University","2017","On-Tenure track total","16","6","10","0","0","0","0","0","0","3","2","1","0","0","0","0","0","0","13","4","9","0","0","0","0","0","0","0","0","0","-2"
"238430","Cardinal Stritch University","2017","On-tenure track, assistant professors","16","6","10","0","0","0","0","0","0","3","2","1","0","0","0","0","0","0","13","4","9","0","0","0","0","0","0","0","0","0","-2"
"238430","Cardinal Stritch University","2017","Not on tenure track/No tenure system system total","21","6","15","1","1","0","1","0","1","1","0","1","1","1","0","0","0","0","16","4","12","0","0","0","1","0","1","0","0","0","-2"
"238430","Cardinal Stritch University","2017","Not on tenure/no tenure system, assistant professors","18","6","12","1","1","0","1","0","1","1","0","1","1","1","0","0","0","0","14","4","10","0","0","0","0","0","0","0","0","0","-2"
"238430","Cardinal Stritch University","2017","Not on tenure/no tenure system, instructors","3","0","3","0","0","0","0","0","0","0","0","0","0","0","0","0","0","0","2","0","2","0","0","0","1","0","1","0","0","0","-2"
"239309","Milwaukee Institute of Art & Design","2017","Not on tenure track/No tenure system system total","35","22","13","0","0","0","2","1","1","0","0","0","0","0","0","0","0","0","32","20","12","1","1","0","0","0","0","0","0","0","-2"
"239309","Milwaukee Institute of Art & Design","2017","Not on tenure/no tenure system, professors","23","15","8","0","0","0","2","1","1","0","0","0","0","0","0","0","0","0","21","14","7","0","0","0","0","0","0","0","0","0","-2"
"239309","Milwaukee Institute of Art & Design","2017","Not on tenure/no tenure system, associate professors","3","2","1","0","0","0","0","0","0","0","0","0","0","0","0","0","0","0","2","1","1","1","1","0","0","0","0","0","0","0","-2"
"239309","Milwaukee Institute of Art & Design","2017","Not on tenure/no tenure system, assistant professors","5","2","3","0","0","0","0","0","0","0","0","0","0","0","0","0","0","0","5","2","3","0","0","0","0","0","0","0","0","0","-2"
"239309","Milwaukee Institute of Art & Design","2017","Not on tenure/no tenure system, instructors","4","3","1","0","0","0","0","0","0","0","0","0","0","0","0","0","0","0","4","3","1","0","0","0","0","0","0","0","0","0","-2"
"240374","University of Wisconsin-Parkside","2017","Tenured total","70","40","30","0","0","0","17","10","7","4","4","0","4","1","3","0","0","0","44","24","20","0","0","0","0","0","0","1","1","0","240374"
"240374","University of Wisconsin-Parkside","2017","Tenured, professors","26","17","9","0","0","0","8","5","3","2","2","0","1","0","1","0","0","0","15","10","5","0","0","0","0","0","0","0","0","0","240374"
"240374","University of Wisconsin-Parkside","2017","Tenured, associate professors","44","23","21","0","0","0","9","5","4","2","2","0","3","1","2","0","0","0","29","14","15","0","0","0","0","0","0","1","1","0","240374"
"240374","University of Wisconsin-Parkside","2017","On-Tenure track total","40","21","19","0","0","0","1","1","0","1","1","0","1","1","0","0","0","0","35","18","17","0","0","0","0","0","0","2","0","2","240374"
"240374","University of Wisconsin-Parkside","2017","On-tenure track, associate professors","1","1","0","0","0","0","0","0","0","0","0","0","0","0","0","0","0","0","1","1","0","0","0","0","0","0","0","0","0","0","240374"
"240374","University of Wisconsin-Parkside","2017","On-tenure track, assistant professors","39","20","19","0","0","0","1","1","0","1","1","0","1","1","0","0","0","0","34","17","17","0","0","0","0","0","0","2","0","2","240374"
"240374","University of Wisconsin-Parkside","2017","Not on tenure track/No tenure system system total","48","21","27","1","1","0","5","2","3","3","1","2","4","2","2","0","0","0","35","15","20","0","0","0","0","0","0","0","0","0","240374"
"240374","University of Wisconsin-Parkside","2017","Not on tenure/no tenure system, associate professors","1","1","0","0","0","0","0","0","0","0","0","0","1","1","0","0","0","0","0","0","0","0","0","0","0","0","0","0","0","0","240374"
"240374","University of Wisconsin-Parkside","2017","Not on tenure/no tenure system, assistant professors","3","1","2","0","0","0","2","0","2","0","0","0","0","0","0","0","0","0","1","1","0","0","0","0","0","0","0","0","0","0","240374"
"240374","University of Wisconsin-Parkside","2017","Not on tenure/no tenure system, lecturers","44","19","25","1","1","0","3","2","1","3","1","2","3","1","2","0","0","0","34","14","20","0","0","0","0","0","0","0","0","0","240374"
"243823","Parker University","2017","Not on tenure track/No tenure system system total","66","37","29","0","0","0","3","3","0","8","4","4","6","4","2","0","0","0","44","24","20","0","0","0","5","2","3","0","0","0","-2"
"243823","Parker University","2017","Not on tenure/no tenure system, professors","14","10","4","0","0","0","1","1","0","0","0","0","0","0","0","0","0","0","11","8","3","0","0","0","2","1","1","0","0","0","-2"
"243823","Parker University","2017","Not on tenure/no tenure system, associate professors","14","8","6","0","0","0","1","1","0","0","0","0","1","1","0","0","0","0","10","5","5","0","0","0","2","1","1","0","0","0","-2"
"243823","Parker University","2017","Not on tenure/no tenure system, assistant professors","19","12","7","0","0","0","1","1","0","2","2","0","3","1","2","0","0","0","13","8","5","0","0","0","0","0","0","0","0","0","-2"
"243823","Parker University","2017","Not on tenure/no tenure system, instructors","19","7","12","0","0","0","0","0","0","6","2","4","2","2","0","0","0","0","10","3","7","0","0","0","1","0","1","0","0","0","-2"
"244233","City College-Fort Lauderdale","2017","Not on tenure track/No tenure system system total","9","4","5","0","0","0","1","1","0","3","0","3","1","0","1","0","0","0","4","3","1","0","0","0","0","0","0","0","0","0","-2"
"244233","City College-Fort Lauderdale","2017","Not on tenure/no tenure system, instructors","9","4","5","0","0","0","1","1","0","3","0","3","1","0","1","0","0","0","4","3","1","0","0","0","0","0","0","0","0","0","-2"
"247834","Collin County Community College District","2017","Not on tenure track/No tenure system system total","410","176","234","4","2","2","27","7","20","21","9","12","22","8","14","0","0","0","332","147","185","4","3","1","0","0","0","0","0","0","-2"
"247834","Collin County Community College District","2017","Not on tenure/no tenure system, no academic rank","410","176","234","4","2","2","27","7","20","21","9","12","22","8","14","0","0","0","332","147","185","4","3","1","0","0","0","0","0","0","-2"
"262086","Brandman University","2017","Not on tenure track/No tenure system system total","81","28","53","0","0","0","5","3","2","6","3","3","6","3","3","0","0","0","47","13","34","1","0","1","16","6","10","0","0","0","-2"
"262086","Brandman University","2017","Not on tenure/no tenure system, professors","11","7","4","0","0","0","1","1","0","0","0","0","0","0","0","0","0","0","8","5","3","0","0","0","2","1","1","0","0","0","-2"
"262086","Brandman University","2017","Not on tenure/no tenure system, associate professors","17","9","8","0","0","0","2","2","0","2","2","0","0","0","0","0","0","0","10","3","7","0","0","0","3","2","1","0","0","0","-2"
"262086","Brandman University","2017","Not on tenure/no tenure system, assistant professors","53","12","41","0","0","0","2","0","2","4","1","3","6","3","3","0","0","0","29","5","24","1","0","1","11","3","8","0","0","0","-2"
"262129","New College of Florida","2017","Tenured total","52","23","29","0","0","0","1","1","0","1","0","1","3","1","2","0","0","0","46","21","25","0","0","0","0","0","0","1","0","1","-2"
"262129","New College of Florida","2017","Tenured, professors","30","17","13","0","0","0","0","0","0","0","0","0","1","1","0","0","0","0","29","16","13","0","0","0","0","0","0","0","0","0","-2"
"262129","New College of Florida","2017","Tenured, associate professors","22","6","16","0","0","0","1","1","0","1","0","1","2","0","2","0","0","0","17","5","12","0","0","0","0","0","0","1","0","1","-2"
"262129","New College of Florida","2017","On-Tenure track total","20","11","9","0","0","0","1","0","1","2","0","2","1","1","0","0","0","0","11","9","2","0","0","0","0","0","0","5","1","4","-2"
"262129","New College of Florida","2017","On-tenure track, assistant professors","20","11","9","0","0","0","1","0","1","2","0","2","1","1","0","0","0","0","11","9","2","0","0","0","0","0","0","5","1","4","-2"
"262129","New College of Florida","2017","Not on tenure track/No tenure system system total","11","1","10","0","0","0","2","0","2","0","0","0","1","0","1","0","0","0","7","1","6","0","0","0","0","0","0","1","0","1","-2"
"262129","New College of Florida","2017","Not on tenure/no tenure system, assistant professors","5","1","4","0","0","0","1","0","1","0","0","0","0","0","0","0","0","0","4","1","3","0","0","0","0","0","0","0","0","0","-2"
"262129","New College of Florida","2017","Not on tenure/no tenure system, instructors","3","0","3","0","0","0","1","0","1","0","0","0","1","0","1","0","0","0","1","0","1","0","0","0","0","0","0","0","0","0","-2"
"262129","New College of Florida","2017","Not on tenure/no tenure system, no academic rank","3","0","3","0","0","0","0","0","0","0","0","0","0","0","0","0","0","0","2","0","2","0","0","0","0","0","0","1","0","1","-2"
"377564","University of Washington-Tacoma Campus","2017","Tenured total","95","54","41","0","0","0","19","11","8","3","1","2","7","5","2","0","0","0","56","30","26","2","1","1","7","5","2","1","1","0","-2"
"377564","University of Washington-Tacoma Campus","2017","Tenured, professors","42","27","15","0","0","0","10","7","3","2","1","1","1","1","0","0","0","0","24","14","10","2","1","1","3","3","0","0","0","0","-2"
"377564","University of Washington-Tacoma Campus","2017","Tenured, associate professors","53","27","26","0","0","0","9","4","5","1","0","1","6","4","2","0","0","0","32","16","16","0","0","0","4","2","2","1","1","0","-2"
"377564","University of Washington-Tacoma Campus","2017","On-Tenure track total","55","25","30","1","0","1","6","3","3","1","0","1","3","1","2","0","0","0","31","15","16","3","1","2","3","3","0","7","2","5","-2"
"377564","University of Washington-Tacoma Campus","2017","On-tenure track, assistant professors","55","25","30","1","0","1","6","3","3","1","0","1","3","1","2","0","0","0","31","15","16","3","1","2","3","3","0","7","2","5","-2"
"377564","University of Washington-Tacoma Campus","2017","Not on tenure track/No tenure system system total","97","41","56","0","0","0","3","0","3","1","0","1","3","1","2","2","1","1","63","29","34","3","0","3","16","8","8","6","2","4","-2"
"377564","University of Washington-Tacoma Campus","2017","Not on tenure/no tenure system, lecturers","97","41","56","0","0","0","3","0","3","1","0","1","3","1","2","2","1","1","63","29","34","3","0","3","16","8","8","6","2","4","-2"
"385619","Everglades University","2017","Not on tenure track/No tenure system system total","63","32","31","0","0","0","4","2","2","3","2","1","5","3","2","1","1","0","48","23","25","2","1","1","0","0","0","0","0","0","-2"
"385619","Everglades University","2017","Not on tenure/no tenure system, instructors","63","32","31","0","0","0","4","2","2","3","2","1","5","3","2","1","1","0","48","23","25","2","1","1","0","0","0","0","0","0","-2"
"386472","Herzing University-Orlando","2017","Not on tenure track/No tenure system system total","25","3","22","0","0","0","0","0","0","5","1","4","3","0","3","0","0","0","15","2","13","2","0","2","0","0","0","0","0","0","-2"
"386472","Herzing University-Orlando","2017","Not on tenure/no tenure system, professors","4","2","2","0","0","0","0","0","0","0","0","0","0","0","0","0","0","0","4","2","2","0","0","0","0","0","0","0","0","0","-2"
"386472","Herzing University-Orlando","2017","Not on tenure/no tenure system, associate professors","6","0","6","0","0","0","0","0","0","3","0","3","1","0","1","0","0","0","2","0","2","0","0","0","0","0","0","0","0","0","-2"
"386472","Herzing University-Orlando","2017","Not on tenure/no tenure system, assistant professors","12","1","11","0","0","0","0","0","0","2","1","1","2","0","2","0","0","0","7","0","7","1","0","1","0","0","0","0","0","0","-2"
"386472","Herzing University-Orlando","2017","Not on tenure/no tenure system, instructors","3","0","3","0","0","0","0","0","0","0","0","0","0","0","0","0","0","0","2","0","2","1","0","1","0","0","0","0","0","0","-2"
"388520","College of Biblical Studies-Houston","2017","Not on tenure track/No tenure system system total","15","13","2","0","0","0","0","0","0","5","4","1","2","2","0","0","0","0","8","7","1","0","0","0","0","0","0","0","0","0","-2"
"388520","College of Biblical Studies-Houston","2017","Not on tenure/no tenure system, professors","12","10","2","0","0","0","0","0","0","4","3","1","1","1","0","0","0","0","7","6","1","0","0","0","0","0","0","0","0","0","-2"
"388520","College of Biblical Studies-Houston","2017","Not on tenure/no tenure system, associate professors","1","1","0","0","0","0","0","0","0","0","0","0","0","0","0","0","0","0","1","1","0","0","0","0","0","0","0","0","0","0","-2"
"388520","College of Biblical Studies-Houston","2017","Not on tenure/no tenure system, assistant professors","2","2","0","0","0","0","0","0","0","1","1","0","1","1","0","0","0","0","0","0","0","0","0","0","0","0","0","0","0","0","-2"
"418126","New York College of Health Professions","2017","Not on tenure track/No tenure system system total","7","4","3","0","0","0","5","3","2","0","0","0","0","0","0","0","0","0","2","1","1","0","0","0","0","0","0","0","0","0","-2"
"418126","New York College of Health Professions","2017","Not on tenure/no tenure system, no academic rank","7","4","3","0","0","0","5","3","2","0","0","0","0","0","0","0","0","0","2","1","1","0","0","0","0","0","0","0","0","0","-2"
"420574","Arizona State University-Polytechnic","2017","Tenured total","58","40","18","0","0","0","9","6","3","2","1","1","0","0","0","0","0","0","46","32","14","0","0","0","1","1","0","0","0","0","-2"
"420574","Arizona State University-Polytechnic","2017","Tenured, professors","20","17","3","0","0","0","2","2","0","1","1","0","0","0","0","0","0","0","17","14","3","0","0","0","0","0","0","0","0","0","-2"
"420574","Arizona State University-Polytechnic","2017","Tenured, associate professors","38","23","15","0","0","0","7","4","3","1","0","1","0","0","0","0","0","0","29","18","11","0","0","0","1","1","0","0","0","0","-2"
"420574","Arizona State University-Polytechnic","2017","On-Tenure track total","38","26","12","0","0","0","9","8","1","2","0","2","2","1","1","0","0","0","21","14","7","2","1","1","0","0","0","2","2","0","-2"
"420574","Arizona State University-Polytechnic","2017","On-tenure track, associate professors","1","1","0","0","0","0","1","1","0","0","0","0","0","0","0","0","0","0","0","0","0","0","0","0","0","0","0","0","0","0","-2"
"420574","Arizona State University-Polytechnic","2017","On-tenure track, assistant professors","37","25","12","0","0","0","8","7","1","2","0","2","2","1","1","0","0","0","21","14","7","2","1","1","0","0","0","2","2","0","-2"
"420574","Arizona State University-Polytechnic","2017","Not on tenure track/No tenure system system total","107","51","56","0","0","0","6","2","4","5","2","3","7","4","3","0","0","0","78","36","42","2","1","1","1","1","0","8","5","3","-2"
"420574","Arizona State University-Polytechnic","2017","Not on tenure/no tenure system, professors","3","3","0","0","0","0","0","0","0","0","0","0","0","0","0","0","0","0","3","3","0","0","0","0","0","0","0","0","0","0","-2"
"420574","Arizona State University-Polytechnic","2017","Not on tenure/no tenure system, associate professors","5","1","4","0","0","0","0","0","0","1","0","1","1","0","1","0","0","0","2","0","2","1","1","0","0","0","0","0","0","0","-2"
"420574","Arizona State University-Polytechnic","2017","Not on tenure/no tenure system, assistant professors","5","1","4","0","0","0","0","0","0","0","0","0","1","0","1","0","0","0","3","0","3","0","0","0","0","0","0","1","1","0","-2"
"420574","Arizona State University-Polytechnic","2017","Not on tenure/no tenure system, instructors","37","13","24","0","0","0","2","0","2","3","1","2","1","0","1","0","0","0","28","10","18","1","0","1","1","1","0","1","1","0","-2"
"420574","Arizona State University-Polytechnic","2017","Not on tenure/no tenure system, lecturers","57","33","24","0","0","0","4","2","2","1","1","0","4","4","0","0","0","0","42","23","19","0","0","0","0","0","0","6","3","3","-2"
"426314","Embry-Riddle Aeronautical University-Worldwide","2017","Tenured total","9","6","3","0","0","0","0","0","0","0","0","0","0","0","0","0","0","0","9","6","3","0","0","0","0","0","0","0","0","0","-2"
"426314","Embry-Riddle Aeronautical University-Worldwide","2017","Tenured, professors","3","2","1","0","0","0","0","0","0","0","0","0","0","0","0","0","0","0","3","2","1","0","0","0","0","0","0","0","0","0","-2"
"426314","Embry-Riddle Aeronautical University-Worldwide","2017","Tenured, associate professors","6","4","2","0","0","0","0","0","0","0","0","0","0","0","0","0","0","0","6","4","2","0","0","0","0","0","0","0","0","0","-2"
"426314","Embry-Riddle Aeronautical University-Worldwide","2017","On-Tenure track total","31","14","17","0","0","0","1","1","0","3","0","3","0","0","0","0","0","0","25","11","14","0","0","0","1","1","0","1","1","0","-2"
"426314","Embry-Riddle Aeronautical University-Worldwide","2017","On-tenure track, associate professors","7","6","1","0","0","0","1","1","0","0","0","0","0","0","0","0","0","0","5","4","1","0","0","0","1","1","0","0","0","0","-2"
"426314","Embry-Riddle Aeronautical University-Worldwide","2017","On-tenure track, assistant professors","24","8","16","0","0","0","0","0","0","3","0","3","0","0","0","0","0","0","20","7","13","0","0","0","0","0","0","1","1","0","-2"
"426314","Embry-Riddle Aeronautical University-Worldwide","2017","Not on tenure track/No tenure system system total","58","42","16","0","0","0","0","0","0","4","4","0","1","1","0","0","0","0","46","33","13","1","0","1","6","4","2","0","0","0","-2"
"426314","Embry-Riddle Aeronautical University-Worldwide","2017","Not on tenure/no tenure system, professors","1","1","0","0","0","0","0","0","0","0","0","0","0","0","0","0","0","0","1","1","0","0","0","0","0","0","0","0","0","0","-2"
"426314","Embry-Riddle Aeronautical University-Worldwide","2017","Not on tenure/no tenure system, associate professors","8","7","1","0","0","0","0","0","0","0","0","0","0","0","0","0","0","0","8","7","1","0","0","0","0","0","0","0","0","0","-2"
"426314","Embry-Riddle Aeronautical University-Worldwide","2017","Not on tenure/no tenure system, assistant professors","40","27","13","0","0","0","0","0","0","4","4","0","1","1","0","0","0","0","31","20","11","1","0","1","3","2","1","0","0","0","-2"
"426314","Embry-Riddle Aeronautical University-Worldwide","2017","Not on tenure/no tenure system, instructors","9","7","2","0","0","0","0","0","0","0","0","0","0","0","0","0","0","0","6","5","1","0","0","0","3","2","1","0","0","0","-2"
"433660","Florida Gulf Coast University","2017","Tenured total","4","1","3","0","0","0","0","0","0","0","0","0","1","0","1","0","0","0","3","1","2","0","0","0","0","0","0","0","0","0","-2"
"433660","Florida Gulf Coast University","2017","Tenured, professors","3","1","2","0","0","0","0","0","0","0","0","0","1","0","1","0","0","0","2","1","1","0","0","0","0","0","0","0","0","0","-2"
"433660","Florida Gulf Coast University","2017","Tenured, associate professors","1","0","1","0","0","0","0","0","0","0","0","0","0","0","0","0","0","0","1","0","1","0","0","0","0","0","0","0","0","0","-2"
"433660","Florida Gulf Coast University","2017","Not on tenure track/No tenure system system total","461","251","210","2","2","0","36","25","11","16","11","5","24","11","13","1","0","1","360","189","171","5","4","1","0","0","0","17","9","8","-2"
"433660","Florida Gulf Coast University","2017","Not on tenure/no tenure system, professors","66","44","22","0","0","0","4","4","0","0","0","0","5","3","2","0","0","0","55","35","20","1","1","0","0","0","0","1","1","0","-2"
"433660","Florida Gulf Coast University","2017","Not on tenure/no tenure system, associate professors","126","85","41","0","0","0","15","11","4","8","6","2","7","4","3","0","0","0","94","63","31","0","0","0","0","0","0","2","1","1","-2"
"433660","Florida Gulf Coast University","2017","Not on tenure/no tenure system, assistant professors","148","77","71","2","2","0","15","9","6","5","3","2","8","3","5","0","0","0","105","54","51","1","1","0","0","0","0","12","5","7","-2"
"433660","Florida Gulf Coast University","2017","Not on tenure/no tenure system, instructors","119","44","75","0","0","0","2","1","1","3","2","1","4","1","3","1","0","1","104","36","68","3","2","1","0","0","0","2","2","0","-2"
"433660","Florida Gulf Coast University","2017","Not on tenure/no tenure system, lecturers","2","1","1","0","0","0","0","0","0","0","0","0","0","0","0","0","0","0","2","1","1","0","0","0","0","0","0","0","0","0","-2"
"439288","Johnson & Wales University-Denver","2017","Not on tenure track/No tenure system system total","50","27","23","0","0","0","0","0","0","0","0","0","2","1","1","0","0","0","48","26","22","0","0","0","0","0","0","0","0","0","-2"
"439288","Johnson & Wales University-Denver","2017","Not on tenure/no tenure system, professors","4","2","2","0","0","0","0","0","0","0","0","0","1","0","1","0","0","0","3","2","1","0","0","0","0","0","0","0","0","0","-2"
"439288","Johnson & Wales University-Denver","2017","Not on tenure/no tenure system, associate professors","23","14","9","0","0","0","0","0","0","0","0","0","1","1","0","0","0","0","22","13","9","0","0","0","0","0","0","0","0","0","-2"
"439288","Johnson & Wales University-Denver","2017","Not on tenure/no tenure system, assistant professors","13","6","7","0","0","0","0","0","0","0","0","0","0","0","0","0","0","0","13","6","7","0","0","0","0","0","0","0","0","0","-2"
"439288","Johnson & Wales University-Denver","2017","Not on tenure/no tenure system, instructors","8","4","4","0","0","0","0","0","0","0","0","0","0","0","0","0","0","0","8","4","4","0","0","0","0","0","0","0","0","0","-2"
"439288","Johnson & Wales University-Denver","2017","Not on tenure/no tenure system, lecturers","2","1","1","0","0","0","0","0","0","0","0","0","0","0","0","0","0","0","2","1","1","0","0","0","0","0","0","0","0","0","-2"
"446233","Ecclesia College","2017","Not on tenure track/No tenure system system total","16","15","1","0","0","0","0","0","0","0","0","0","1","0","1","0","0","0","11","11","0","0","0","0","4","4","0","0","0","0","-2"
"446233","Ecclesia College","2017","Not on tenure/no tenure system, no academic rank","16","15","1","0","0","0","0","0","0","0","0","0","1","0","1","0","0","0","11","11","0","0","0","0","4","4","0","0","0","0","-2"
"447689","Georgia Gwinnett College","2017","Not on tenure track/No tenure system system total","450","220","230","2","1","1","52","27","25","46","20","26","14","10","4","0","0","0","307","144","163","3","2","1","5","4","1","21","12","9","-2"
"447689","Georgia Gwinnett College","2017","Not on tenure/no tenure system, professors","38","24","14","0","0","0","7","6","1","4","2","2","0","0","0","0","0","0","27","16","11","0","0","0","0","0","0","0","0","0","-2"
"447689","Georgia Gwinnett College","2017","Not on tenure/no tenure system, associate professors","144","80","64","1","0","1","22","11","11","15","5","10","5","4","1","0","0","0","93","55","38","0","0","0","1","1","0","7","4","3","-2"
"447689","Georgia Gwinnett College","2017","Not on tenure/no tenure system, assistant professors","212","99","113","1","1","0","19","9","10","21","10","11","8","6","2","0","0","0","145","62","83","1","1","0","3","2","1","14","8","6","-2"
"447689","Georgia Gwinnett College","2017","Not on tenure/no tenure system, instructors","34","6","28","0","0","0","1","0","1","2","0","2","1","0","1","0","0","0","29","6","23","1","0","1","0","0","0","0","0","0","-2"
"447689","Georgia Gwinnett College","2017","Not on tenure/no tenure system, lecturers","22","11","11","0","0","0","3","1","2","4","3","1","0","0","0","0","0","0","13","5","8","1","1","0","1","1","0","0","0","0","-2"
"448840","University of South Florida-St Petersburg","2017","Tenured total","65","37","28","1","1","0","7","4","3","0","0","0","6","3","3","0","0","0","50","29","21","0","0","0","0","0","0","1","0","1","-2"
"448840","University of South Florida-St Petersburg","2017","Tenured, professors","31","22","9","0","0","0","4","2","2","0","0","0","2","2","0","0","0","0","25","18","7","0","0","0","0","0","0","0","0","0","-2"
"448840","University of South Florida-St Petersburg","2017","Tenured, associate professors","34","15","19","1","1","0","3","2","1","0","0","0","4","1","3","0","0","0","25","11","14","0","0","0","0","0","0","1","0","1","-2"
"448840","University of South Florida-St Petersburg","2017","On-Tenure track total","29","12","17","0","0","0","1","0","1","4","3","1","5","2","3","0","0","0","18","6","12","0","0","0","0","0","0","1","1","0","-2"
"448840","University of South Florida-St Petersburg","2017","On-tenure track, associate professors","4","2","2","0","0","0","1","0","1","0","0","0","0","0","0","0","0","0","3","2","1","0","0","0","0","0","0","0","0","0","-2"
"448840","University of South Florida-St Petersburg","2017","On-tenure track, assistant professors","23","10","13","0","0","0","0","0","0","4","3","1","5","2","3","0","0","0","13","4","9","0","0","0","0","0","0","1","1","0","-2"
"448840","University of South Florida-St Petersburg","2017","On-tenure track, instructors","2","0","2","0","0","0","0","0","0","0","0","0","0","0","0","0","0","0","2","0","2","0","0","0","0","0","0","0","0","0","-2"
"448840","University of South Florida-St Petersburg","2017","Not on tenure track/No tenure system system total","44","21","23","1","1","0","5","1","4","2","0","2","2","1","1","0","0","0","34","18","16","0","0","0","0","0","0","0","0","0","-2"
"448840","University of South Florida-St Petersburg","2017","Not on tenure/no tenure system, assistant professors","7","4","3","1","1","0","1","0","1","0","0","0","0","0","0","0","0","0","5","3","2","0","0","0","0","0","0","0","0","0","-2"
"448840","University of South Florida-St Petersburg","2017","Not on tenure/no tenure system, instructors","31","16","15","0","0","0","3","1","2","1","0","1","1","1","0","0","0","0","26","14","12","0","0","0","0","0","0","0","0","0","-2"
"448840","University of South Florida-St Petersburg","2017","Not on tenure/no tenure system, no academic rank","6","1","5","0","0","0","1","0","1","1","0","1","1","0","1","0","0","0","3","1","2","0","0","0","0","0","0","0","0","0","-2"
"451671","University of South Florida-Sarasota-Manatee","2017","Tenured total","26","12","14","0","0","0","4","2","2","2","1","1","0","0","0","0","0","0","19","8","11","0","0","0","0","0","0","1","1","0","-2"
"451671","University of South Florida-Sarasota-Manatee","2017","Tenured, professors","7","4","3","0","0","0","1","1","0","0","0","0","0","0","0","0","0","0","6","3","3","0","0","0","0","0","0","0","0","0","-2"
"451671","University of South Florida-Sarasota-Manatee","2017","Tenured, associate professors","19","8","11","0","0","0","3","1","2","2","1","1","0","0","0","0","0","0","13","5","8","0","0","0","0","0","0","1","1","0","-2"
"451671","University of South Florida-Sarasota-Manatee","2017","On-Tenure track total","16","9","7","0","0","0","1","0","1","1","0","1","2","2","0","0","0","0","9","5","4","0","0","0","0","0","0","3","2","1","-2"
"451671","University of South Florida-Sarasota-Manatee","2017","On-tenure track, assistant professors","16","9","7","0","0","0","1","0","1","1","0","1","2","2","0","0","0","0","9","5","4","0","0","0","0","0","0","3","2","1","-2"
"451671","University of South Florida-Sarasota-Manatee","2017","Not on tenure track/No tenure system system total","44","24","20","0","0","0","4","2","2","1","1","0","3","1","2","0","0","0","32","16","16","0","0","0","0","0","0","4","4","0","-2"
"451671","University of South Florida-Sarasota-Manatee","2017","Not on tenure/no tenure system, associate professors","1","1","0","0","0","0","0","0","0","1","1","0","0","0","0","0","0","0","0","0","0","0","0","0","0","0","0","0","0","0","-2"
"451671","University of South Florida-Sarasota-Manatee","2017","Not on tenure/no tenure system, assistant professors","1","0","1","0","0","0","0","0","0","0","0","0","0","0","0","0","0","0","1","0","1","0","0","0","0","0","0","0","0","0","-2"
"451671","University of South Florida-Sarasota-Manatee","2017","Not on tenure/no tenure system, instructors","41","23","18","0","0","0","4","2","2","0","0","0","2","1","1","0","0","0","31","16","15","0","0","0","0","0","0","4","4","0","-2"
"451671","University of South Florida-Sarasota-Manatee","2017","Not on tenure/no tenure system, no academic rank","1","0","1","0","0","0","0","0","0","0","0","0","1","0","1","0","0","0","0","0","0","0","0","0","0","0","0","0","0","0","-2"
"455664","The Chicago School of Professional Psychology at Los Angeles","2017","Not on tenure track/No tenure system system total","22","13","9","0","0","0","0","0","0","4","1","3","3","2","1","0","0","0","13","8","5","1","1","0","1","1","0","0","0","0","-2"
"455664","The Chicago School of Professional Psychology at Los Angeles","2017","Not on tenure/no tenure system, professors","4","3","1","0","0","0","0","0","0","2","1","1","0","0","0","0","0","0","1","1","0","0","0","0","1","1","0","0","0","0","-2"
"455664","The Chicago School of Professional Psychology at Los Angeles","2017","Not on tenure/no tenure system, associate professors","14","9","5","0","0","0","0","0","0","2","0","2","2","2","0","0","0","0","9","6","3","1","1","0","0","0","0","0","0","0","-2"
"455664","The Chicago School of Professional Psychology at Los Angeles","2017","Not on tenure/no tenure system, assistant professors","4","1","3","0","0","0","0","0","0","0","0","0","1","0","1","0","0","0","3","1","2","0","0","0","0","0","0","0","0","0","-2"
"459824","Touro University Nevada","2017","Not on tenure track/No tenure system system total","72","32","40","0","0","0","7","5","2","2","0","2","1","0","1","0","0","0","57","25","32","0","0","0","5","2","3","0","0","0","-2"
"459824","Touro University Nevada","2017","Not on tenure/no tenure system, professors","9","7","2","0","0","0","3","2","1","0","0","0","0","0","0","0","0","0","5","4","1","0","0","0","1","1","0","0","0","0","-2"
"459824","Touro University Nevada","2017","Not on tenure/no tenure system, associate professors","12","5","7","0","0","0","0","0","0","0","0","0","0","0","0","0","0","0","11","5","6","0","0","0","1","0","1","0","0","0","-2"
"459824","Touro University Nevada","2017","Not on tenure/no tenure system, assistant professors","50","19","31","0","0","0","3","2","1","2","0","2","1","0","1","0","0","0","41","16","25","0","0","0","3","1","2","0","0","0","-2"
"459824","Touro University Nevada","2017","Not on tenure/no tenure system, instructors","1","1","0","0","0","0","1","1","0","0","0","0","0","0","0","0","0","0","0","0","0","0","0","0","0","0","0","0","0","0","-2"
"459842","Herzing University-Kenosha","2017","Not on tenure track/No tenure system system total","14","2","12","0","0","0","1","0","1","0","0","0","1","0","1","0","0","0","12","2","10","0","0","0","0","0","0","0","0","0","-2"
"459842","Herzing University-Kenosha","2017","Not on tenure/no tenure system, professors","2","1","1","0","0","0","0","0","0","0","0","0","0","0","0","0","0","0","2","1","1","0","0","0","0","0","0","0","0","0","-2"
"459842","Herzing University-Kenosha","2017","Not on tenure/no tenure system, associate professors","4","1","3","0","0","0","0","0","0","0","0","0","0","0","0","0","0","0","4","1","3","0","0","0","0","0","0","0","0","0","-2"
"459842","Herzing University-Kenosha","2017","Not on tenure/no tenure system, assistant professors","8","0","8","0","0","0","1","0","1","0","0","0","1","0","1","0","0","0","6","0","6","0","0","0","0","0","0","0","0","0","-2"
"460899","Stevens-Henager College","2017","Not on tenure track/No tenure system system total","6","3","3","0","0","0","1","0","1","0","0","0","0","0","0","0","0","0","5","3","2","0","0","0","0","0","0","0","0","0","-2"
"460899","Stevens-Henager College","2017","Not on tenure/no tenure system, no academic rank","6","3","3","0","0","0","1","0","1","0","0","0","0","0","0","0","0","0","5","3","2","0","0","0","0","0","0","0","0","0","-2"
"461795","North American University","2017","Not on tenure track/No tenure system system total","7","5","2","0","0","0","1","1","0","0","0","0","0","0","0","0","0","0","4","2","2","0","0","0","0","0","0","2","2","0","-2"
"461795","North American University","2017","Not on tenure/no tenure system, associate professors","1","1","0","0","0","0","0","0","0","0","0","0","0","0","0","0","0","0","1","1","0","0","0","0","0","0","0","0","0","0","-2"
"461795","North American University","2017","Not on tenure/no tenure system, assistant professors","4","2","2","0","0","0","1","1","0","0","0","0","0","0","0","0","0","0","2","0","2","0","0","0","0","0","0","1","1","0","-2"
"461795","North American University","2017","Not on tenure/no tenure system, instructors","2","2","0","0","0","0","0","0","0","0","0","0","0","0","0","0","0","0","1","1","0","0","0","0","0","0","0","1","1","0","-2"
"482936","Florida Polytechnic University","2017","Not on tenure track/No tenure system system total","64","52","12","0","0","0","15","12","3","2","2","0","3","3","0","0","0","0","39","30","9","0","0","0","0","0","0","5","5","0","-2"
"482936","Florida Polytechnic University","2017","Not on tenure/no tenure system, professors","5","5","0","0","0","0","1","1","0","0","0","0","0","0","0","0","0","0","4","4","0","0","0","0","0","0","0","0","0","0","-2"
"482936","Florida Polytechnic University","2017","Not on tenure/no tenure system, associate professors","15","12","3","0","0","0","5","4","1","0","0","0","1","1","0","0","0","0","9","7","2","0","0","0","0","0","0","0","0","0","-2"
"482936","Florida Polytechnic University","2017","Not on tenure/no tenure system, assistant professors","36","27","9","0","0","0","6","4","2","2","2","0","1","1","0","0","0","0","22","15","7","0","0","0","0","0","0","5","5","0","-2"
"482936","Florida Polytechnic University","2017","Not on tenure/no tenure system, instructors","8","8","0","0","0","0","3","3","0","0","0","0","1","1","0","0","0","0","4","4","0","0","0","0","0","0","0","0","0","0","-2"
"483124","Arizona State University Digital Immersion","2017","Tenured total","186","119","67","1","0","1","19","14","5","5","1","4","10","7","3","0","0","0","141","91","50","4","2","2","2","2","0","4","2","2","-2"
"483124","Arizona State University Digital Immersion","2017","Tenured, professors","94","72","22","0","0","0","13","11","2","2","1","1","3","3","0","0","0","0","72","53","19","2","2","0","1","1","0","1","1","0","-2"
"483124","Arizona State University Digital Immersion","2017","Tenured, associate professors","92","47","45","1","0","1","6","3","3","3","0","3","7","4","3","0","0","0","69","38","31","2","0","2","1","1","0","3","1","2","-2"
"483124","Arizona State University Digital Immersion","2017","On-Tenure track total","60","26","34","1","1","0","11","4","7","1","0","1","8","5","3","0","0","0","30","12","18","2","0","2","2","2","0","5","2","3","-2"
"483124","Arizona State University Digital Immersion","2017","On-tenure track, associate professors","3","2","1","0","0","0","0","0","0","0","0","0","0","0","0","0","0","0","3","2","1","0","0","0","0","0","0","0","0","0","-2"
"483124","Arizona State University Digital Immersion","2017","On-tenure track, assistant professors","57","24","33","1","1","0","11","4","7","1","0","1","8","5","3","0","0","0","27","10","17","2","0","2","2","2","0","5","2","3","-2"
"483124","Arizona State University Digital Immersion","2017","Not on tenure track/No tenure system system total","451","171","280","3","1","2","24","6","18","17","4","13","35","14","21","1","0","1","350","137","213","6","2","4","6","3","3","9","4","5","-2"
"483124","Arizona State University Digital Immersion","2017","Not on tenure/no tenure system, professors","21","12","9","0","0","0","0","0","0","0","0","0","1","0","1","0","0","0","18","11","7","0","0","0","2","1","1","0","0","0","-2"
"483124","Arizona State University Digital Immersion","2017","Not on tenure/no tenure system, associate professors","25","9","16","0","0","0","1","1","0","2","1","1","2","1","1","0","0","0","19","6","13","1","0","1","0","0","0","0","0","0","-2"
"483124","Arizona State University Digital Immersion","2017","Not on tenure/no tenure system, assistant professors","39","10","29","0","0","0","2","0","2","1","0","1","4","0","4","1","0","1","30","9","21","0","0","0","0","0","0","1","1","0","-2"
"483124","Arizona State University Digital Immersion","2017","Not on tenure/no tenure system, instructors","157","60","97","1","1","0","5","1","4","7","1","6","14","5","9","0","0","0","123","49","74","2","1","1","4","2","2","1","0","1","-2"
"483124","Arizona State University Digital Immersion","2017","Not on tenure/no tenure system, lecturers","209","80","129","2","0","2","16","4","12","7","2","5","14","8","6","0","0","0","160","62","98","3","1","2","0","0","0","7","3","4","-2"
"484473","University of Florida-Online","2017","Not on tenure track/No tenure system system total","7","2","5","0","0","0","0","0","0","0","0","0","0","0","0","0","0","0","7","2","5","0","0","0","0","0","0","0","0","0","-2"
"484473","University of Florida-Online","2017","Not on tenure/no tenure system, lecturers","3","1","2","0","0","0","0","0","0","0","0","0","0","0","0","0","0","0","3","1","2","0","0","0","0","0","0","0","0","0","-2"
"484473","University of Florida-Online","2017","Not on tenure/no tenure system, no academic rank","4","1","3","0","0","0","0","0","0","0","0","0","0","0","0","0","0","0","4","1","3","0","0","0","0","0","0","0","0","0","-2"
"490805","Purdue University Northwest","2017","Tenured total","188","113","75","0","0","0","44","27","17","5","2","3","13","8","5","0","0","0","126","76","50","0","0","0","0","0","0","0","0","0","-2"
"490805","Purdue University Northwest","2017","Tenured, professors","75","50","25","0","0","0","19","11","8","2","2","0","5","3","2","0","0","0","49","34","15","0","0","0","0","0","0","0","0","0","-2"
"490805","Purdue University Northwest","2017","Tenured, associate professors","112","63","49","0","0","0","25","16","9","3","0","3","8","5","3","0","0","0","76","42","34","0","0","0","0","0","0","0","0","0","-2"
"490805","Purdue University Northwest","2017","Tenured, assistant professors","1","0","1","0","0","0","0","0","0","0","0","0","0","0","0","0","0","0","1","0","1","0","0","0","0","0","0","0","0","0","-2"
"490805","Purdue University Northwest","2017","On-Tenure track total","56","25","31","0","0","0","8","7","1","5","4","1","0","0","0","0","0","0","30","7","23","0","0","0","2","1","1","11","6","5","-2"
"490805","Purdue University Northwest","2017","On-tenure track, associate professors","1","1","0","0","0","0","0","0","0","0","0","0","0","0","0","0","0","0","0","0","0","0","0","0","0","0","0","1","1","0","-2"
"490805","Purdue University Northwest","2017","On-tenure track, assistant professors","55","24","31","0","0","0","8","7","1","5","4","1","0","0","0","0","0","0","30","7","23","0","0","0","2","1","1","10","5","5","-2"
"490805","Purdue University Northwest","2017","Not on tenure track/No tenure system system total","32","8","24","0","0","0","1","1","0","0","0","0","0","0","0","0","0","0","24","5","19","0","0","0","6","1","5","1","1","0","-2"
"490805","Purdue University Northwest","2017","Not on tenure/no tenure system, assistant professors","8","4","4","0","0","0","1","1","0","0","0","0","0","0","0","0","0","0","3","1","2","0","0","0","3","1","2","1","1","0","-2"
"490805","Purdue University Northwest","2017","Not on tenure/no tenure system, instructors","19","4","15","0","0","0","0","0","0","0","0","0","0","0","0","0","0","0","19","4","15","0","0","0","0","0","0","0","0","0","-2"
"490805","Purdue University Northwest","2017","Not on tenure/no tenure system, lecturers","5","0","5","0","0","0","0","0","0","0","0","0","0","0","0","0","0","0","2","0","2","0","0","0","3","0","3","0","0","0","-2"
