"unitid","institution name","year","S2011_F.Tenure status and academic rank of full-time instruction/research/public service staff","S2011_F_RV.Grand total","S2011_F_RV.Grand total men","S2011_F_RV.Grand total women","S2011_F_RV.American Indian or Alaska Native total","S2011_F_RV.American Indian or Alaska Native men","S2011_F_RV.American Indian or Alaska Native women","S2011_F_RV.Asian total","S2011_F_RV.Asian men","S2011_F_RV.Asian women","S2011_F_RV.Black or African American total","S2011_F_RV.Black or African American men","S2011_F_RV.Black or African American women","S2011_F_RV.Hispanic or Latino total","S2011_F_RV.Hispanic or Latino men","S2011_F_RV.Hispanic or Latino women","S2011_F_RV.Native Hawaiian or Other Pacific Islander total","S2011_F_RV.Native Hawaiian or Other Pacific Islander men","S2011_F_RV.Native Hawaiian or Other Pacific Islander women","S2011_F_RV.White total","S2011_F_RV.White men","S2011_F_RV.White women","S2011_F_RV.Two or more races total","S2011_F_RV.Two or more races men","S2011_F_RV.Two or more races women","S2011_F_RV.Race/ethnicity unknown total","S2011_F_RV.Race/ethnicity unknown men","S2011_F_RV.Race/ethnicity unknown women","S2011_F_RV.Nonresident alien total","S2011_F_RV.Nonresident alien men","S2011_F_RV.Nonresident alien women","IDX_HR"
"105899","Arizona Christian University","2011","Total full-time Instruction/research/public service, Non-tenured not on tenure track, Professors","1","1","0","0","0","0","0","0","0","0","0","0","0","0","0","0","0","0","1","1","0","0","0","0","0","0","0","0","0","0","-2"
"105899","Arizona Christian University","2011","Total full-time Instruction/research/public service, Non-tenured not on tenure track, Associate professors","9","5","4","0","0","0","0","0","0","0","0","0","0","0","0","0","0","0","9","5","4","0","0","0","0","0","0","0","0","0","-2"
"105899","Arizona Christian University","2011","Total full-time Instruction/research/public servicey, Non-tenured not on tenure track, Assistant professors","4","1","3","0","0","0","0","0","0","0","0","0","0","0","0","0","0","0","4","1","3","0","0","0","0","0","0","0","0","0","-2"
"105899","Arizona Christian University","2011","Total full-time Instruction/research/public service, Non-tenured not on tenure track, Instructors","1","1","0","0","0","0","0","0","0","0","0","0","0","0","0","0","0","0","1","1","0","0","0","0","0","0","0","0","0","0","-2"
"105899","Arizona Christian University","2011","Total full-time Instruction/research/public service, Non-tenured not on tenure track total","15","8","7","0","0","0","0","0","0","0","0","0","0","0","0","0","0","0","15","8","7","0","0","0","0","0","0","0","0","0","-2"
"110097","Biola University","2011","Total full-time Instruction/research/public service, Tenured, Professors","55","47","8","0","0","0","0","0","0","0","0","0","2","2","0","0","0","0","53","45","8","0","0","0","0","0","0","0","0","0","-2"
"110097","Biola University","2011","Total full-time Instruction/research/public service, Tenured, Associate professors","46","35","11","0","0","0","6","5","1","1","0","1","0","0","0","0","0","0","39","30","9","0","0","0","0","0","0","0","0","0","-2"
"110097","Biola University","2011","Total full-time Instruction/research/public service, Tenured total","101","82","19","0","0","0","6","5","1","1","0","1","2","2","0","0","0","0","92","75","17","0","0","0","0","0","0","0","0","0","-2"
"110097","Biola University","2011","Total full-time Instruction/research/public service, Non-tenured on tenure track, Professors","9","7","2","0","0","0","0","0","0","0","0","0","1","0","1","0","0","0","8","7","1","0","0","0","0","0","0","0","0","0","-2"
"110097","Biola University","2011","Total full-time Instruction/research/public service, Non-tenured on tenure track, Associate professors","37","28","9","0","0","0","8","5","3","1","1","0","3","2","1","0","0","0","25","20","5","0","0","0","0","0","0","0","0","0","-2"
"110097","Biola University","2011","Total full-time Instruction/research/public service, Non-tenured on tenure track, Assistant professors","32","17","15","0","0","0","7","1","6","2","0","2","2","1","1","0","0","0","21","15","6","0","0","0","0","0","0","0","0","0","-2"
"110097","Biola University","2011","Total full-time Instruction/research/public service, Non-tenured on tenure track total","78","52","26","0","0","0","15","6","9","3","1","2","6","3","3","0","0","0","54","42","12","0","0","0","0","0","0","0","0","0","-2"
"110097","Biola University","2011","Total full-time Instruction/research/public service, Non-tenured not on tenure track, Professors","1","1","0","0","0","0","0","0","0","0","0","0","0","0","0","0","0","0","1","1","0","0","0","0","0","0","0","0","0","0","-2"
"110097","Biola University","2011","Total full-time Instruction/research/public service, Non-tenured not on tenure track, Associate professors","19","13","6","0","0","0","0","0","0","0","0","0","1","1","0","0","0","0","18","12","6","0","0","0","0","0","0","0","0","0","-2"
"110097","Biola University","2011","Total full-time Instruction/research/public servicey, Non-tenured not on tenure track, Assistant professors","36","13","23","0","0","0","3","1","2","2","2","0","4","0","4","0","0","0","27","10","17","0","0","0","0","0","0","0","0","0","-2"
"110097","Biola University","2011","Total full-time Instruction/research/public service, Non-tenured not on tenure track, Instructors","6","1","5","0","0","0","0","0","0","0","0","0","0","0","0","0","0","0","6","1","5","0","0","0","0","0","0","0","0","0","-2"
"110097","Biola University","2011","Total full-time Instruction/research/public service, Non-tenured not on tenure track, No academic rank","2","2","0","0","0","0","0","0","0","0","0","0","0","0","0","0","0","0","2","2","0","0","0","0","0","0","0","0","0","0","-2"
"110097","Biola University","2011","Total full-time Instruction/research/public service, Non-tenured not on tenure track total","64","30","34","0","0","0","3","1","2","2","2","0","5","1","4","0","0","0","54","26","28","0","0","0","0","0","0","0","0","0","-2"
"110316","California Institute of Integral Studies","2011","Total full-time Instruction/research/public service, Non-tenured not on tenure track, Professors","29","16","13","0","0","0","4","2","2","1","0","1","0","0","0","0","0","0","24","14","10","0","0","0","0","0","0","0","0","0","-2"
"110316","California Institute of Integral Studies","2011","Total full-time Instruction/research/public service, Non-tenured not on tenure track, Associate professors","14","7","7","0","0","0","0","0","0","2","0","2","2","0","2","0","0","0","9","7","2","1","0","1","0","0","0","0","0","0","-2"
"110316","California Institute of Integral Studies","2011","Total full-time Instruction/research/public servicey, Non-tenured not on tenure track, Assistant professors","15","6","9","0","0","0","5","1","4","0","0","0","3","3","0","0","0","0","7","2","5","0","0","0","0","0","0","0","0","0","-2"
"110316","California Institute of Integral Studies","2011","Total full-time Instruction/research/public service, Non-tenured not on tenure track total","58","29","29","0","0","0","9","3","6","3","0","3","5","3","2","0","0","0","40","23","17","1","0","1","0","0","0","0","0","0","-2"
"110422","California Polytechnic State University-San Luis Obispo","2011","Total full-time Instruction/research/public service, Tenured, Professors","263","201","62","0","0","0","23","20","3","5","4","1","14","10","4","1","1","0","203","150","53","3","3","0","14","13","1","0","0","0","-2"
"110422","California Polytechnic State University-San Luis Obispo","2011","Total full-time Instruction/research/public service, Tenured, Associate professors","161","117","44","0","0","0","16","10","6","2","1","1","14","8","6","0","0","0","115","87","28","4","3","1","9","7","2","1","1","0","-2"
"110422","California Polytechnic State University-San Luis Obispo","2011","Total full-time Instruction/research/public service, Tenured, No academic rank","3","3","0","0","0","0","0","0","0","0","0","0","0","0","0","0","0","0","3","3","0","0","0","0","0","0","0","0","0","0","-2"
"110422","California Polytechnic State University-San Luis Obispo","2011","Total full-time Instruction/research/public service, Tenured total","427","321","106","0","0","0","39","30","9","7","5","2","28","18","10","1","1","0","321","240","81","7","6","1","23","20","3","1","1","0","-2"
"110422","California Polytechnic State University-San Luis Obispo","2011","Total full-time Instruction/research/public service, Non-tenured on tenure track, Associate professors","24","17","7","1","1","0","4","2","2","2","1","1","2","2","0","0","0","0","14","10","4","0","0","0","0","0","0","1","1","0","-2"
"110422","California Polytechnic State University-San Luis Obispo","2011","Total full-time Instruction/research/public service, Non-tenured on tenure track, Assistant professors","155","83","72","1","0","1","7","2","5","2","1","1","7","6","1","0","0","0","118","64","54","2","1","1","6","3","3","12","6","6","-2"
"110422","California Polytechnic State University-San Luis Obispo","2011","Total full-time Instruction/research/public service, Non-tenured on tenure track total","179","100","79","2","1","1","11","4","7","4","2","2","9","8","1","0","0","0","132","74","58","2","1","1","6","3","3","13","7","6","-2"
"110422","California Polytechnic State University-San Luis Obispo","2011","Total full-time Instruction/research/public service, Non-tenured not on tenure track, Lecturers","122","65","57","0","0","0","3","1","2","0","0","0","5","5","0","0","0","0","105","55","50","1","1","0","4","1","3","4","2","2","-2"
"110422","California Polytechnic State University-San Luis Obispo","2011","Total full-time Instruction/research/public service, Non-tenured not on tenure track total","122","65","57","0","0","0","3","1","2","0","0","0","5","5","0","0","0","0","105","55","50","1","1","0","4","1","3","4","2","2","-2"
"111188","California State University Maritime Academy","2011","Total full-time Instruction/research/public service, Tenured, Professors","12","8","4","0","0","0","1","0","1","0","0","0","1","1","0","0","0","0","10","7","3","0","0","0","0","0","0","0","0","0","-2"
"111188","California State University Maritime Academy","2011","Total full-time Instruction/research/public service, Tenured, Associate professors","6","6","0","0","0","0","1","1","0","0","0","0","0","0","0","0","0","0","5","5","0","0","0","0","0","0","0","0","0","0","-2"
"111188","California State University Maritime Academy","2011","Total full-time Instruction/research/public service, Tenured, Assistant professors","3","3","0","0","0","0","0","0","0","1","1","0","0","0","0","0","0","0","2","2","0","0","0","0","0","0","0","0","0","0","-2"
"111188","California State University Maritime Academy","2011","Total full-time Instruction/research/public service, Tenured, Instructors","1","1","0","0","0","0","0","0","0","0","0","0","0","0","0","0","0","0","1","1","0","0","0","0","0","0","0","0","0","0","-2"
"111188","California State University Maritime Academy","2011","Total full-time Instruction/research/public service, Tenured, No academic rank","4","4","0","0","0","0","0","0","0","0","0","0","0","0","0","0","0","0","4","4","0","0","0","0","0","0","0","0","0","0","-2"
"111188","California State University Maritime Academy","2011","Total full-time Instruction/research/public service, Tenured total","26","22","4","0","0","0","2","1","1","1","1","0","1","1","0","0","0","0","22","19","3","0","0","0","0","0","0","0","0","0","-2"
"111188","California State University Maritime Academy","2011","Total full-time Instruction/research/public service, Non-tenured on tenure track, Associate professors","1","0","1","0","0","0","1","0","1","0","0","0","0","0","0","0","0","0","0","0","0","0","0","0","0","0","0","0","0","0","-2"
"111188","California State University Maritime Academy","2011","Total full-time Instruction/research/public service, Non-tenured on tenure track, Assistant professors","11","9","2","0","0","0","1","1","0","0","0","0","2","1","1","0","0","0","8","7","1","0","0","0","0","0","0","0","0","0","-2"
"111188","California State University Maritime Academy","2011","Total full-time Instruction/research/public service, Non-tenured on tenure track, Instructors","2","2","0","0","0","0","0","0","0","0","0","0","0","0","0","0","0","0","2","2","0","0","0","0","0","0","0","0","0","0","-2"
"111188","California State University Maritime Academy","2011","Total full-time Instruction/research/public service, Non-tenured on tenure track total","14","11","3","0","0","0","2","1","1","0","0","0","2","1","1","0","0","0","10","9","1","0","0","0","0","0","0","0","0","0","-2"
"111188","California State University Maritime Academy","2011","Total full-time Instruction/research/public service, Non-tenured not on tenure track, Lecturers","10","9","1","0","0","0","0","0","0","0","0","0","0","0","0","0","0","0","10","9","1","0","0","0","0","0","0","0","0","0","-2"
"111188","California State University Maritime Academy","2011","Total full-time Instruction/research/public service, Non-tenured not on tenure track total","10","9","1","0","0","0","0","0","0","0","0","0","0","0","0","0","0","0","10","9","1","0","0","0","0","0","0","0","0","0","-2"
"111948","Chapman University","2011","Total full-time Instruction/research/public service, Tenured, Professors","106","77","29","0","0","0","8","4","4","3","3","0","2","2","0","0","0","0","89","65","24","0","0","0","3","2","1","1","1","0","-2"
"111948","Chapman University","2011","Total full-time Instruction/research/public service, Tenured, Associate professors","69","43","26","1","1","0","3","3","0","2","0","2","2","0","2","0","0","0","58","36","22","0","0","0","2","2","0","1","1","0","-2"
"111948","Chapman University","2011","Total full-time Instruction/research/public service, Tenured total","175","120","55","1","1","0","11","7","4","5","3","2","4","2","2","0","0","0","147","101","46","0","0","0","5","4","1","2","2","0","-2"
"111948","Chapman University","2011","Total full-time Instruction/research/public service, Non-tenured on tenure track, Professors","2","2","0","0","0","0","0","0","0","0","0","0","0","0","0","0","0","0","0","0","0","0","0","0","2","2","0","0","0","0","-2"
"111948","Chapman University","2011","Total full-time Instruction/research/public service, Non-tenured on tenure track, Associate professors","12","8","4","0","0","0","0","0","0","1","0","1","0","0","0","0","0","0","8","6","2","0","0","0","2","2","0","1","0","1","-2"
"111948","Chapman University","2011","Total full-time Instruction/research/public service, Non-tenured on tenure track, Assistant professors","67","29","38","0","0","0","5","1","4","1","1","0","4","1","3","0","0","0","44","19","25","1","0","1","6","2","4","6","5","1","-2"
"111948","Chapman University","2011","Total full-time Instruction/research/public service, Non-tenured on tenure track, Instructors","2","1","1","0","0","0","0","0","0","0","0","0","0","0","0","0","0","0","0","0","0","0","0","0","2","1","1","0","0","0","-2"
"111948","Chapman University","2011","Total full-time Instruction/research/public service, Non-tenured on tenure track total","83","40","43","0","0","0","5","1","4","2","1","1","4","1","3","0","0","0","52","25","27","1","0","1","12","7","5","7","5","2","-2"
"111948","Chapman University","2011","Total full-time Instruction/research/public service, Non-tenured not on tenure track, Professors","16","14","2","0","0","0","0","0","0","0","0","0","0","0","0","0","0","0","10","9","1","0","0","0","5","4","1","1","1","0","-2"
"111948","Chapman University","2011","Total full-time Instruction/research/public service, Non-tenured not on tenure track, Associate professors","33","19","14","0","0","0","2","1","1","0","0","0","2","1","1","0","0","0","24","14","10","0","0","0","2","1","1","3","2","1","-2"
"111948","Chapman University","2011","Total full-time Instruction/research/public servicey, Non-tenured not on tenure track, Assistant professors","53","29","24","0","0","0","4","2","2","3","2","1","2","0","2","0","0","0","38","21","17","0","0","0","3","2","1","3","2","1","-2"
"111948","Chapman University","2011","Total full-time Instruction/research/public service, Non-tenured not on tenure track, Instructors","25","8","17","0","0","0","3","0","3","0","0","0","2","0","2","0","0","0","13","3","10","0","0","0","7","5","2","0","0","0","-2"
"111948","Chapman University","2011","Total full-time Instruction/research/public service, Non-tenured not on tenure track, Lecturers","7","1","6","0","0","0","0","0","0","0","0","0","1","0","1","0","0","0","2","1","1","0","0","0","4","0","4","0","0","0","-2"
"111948","Chapman University","2011","Total full-time Instruction/research/public service, Non-tenured not on tenure track total","134","71","63","0","0","0","9","3","6","3","2","1","7","1","6","0","0","0","87","48","39","0","0","0","21","12","9","7","5","2","-2"
"112260","Claremont McKenna College","2011","Total full-time Instruction/research/public service, Tenured, Professors","53","41","12","1","1","0","1","1","0","3","1","2","1","1","0","0","0","0","46","37","9","0","0","0","0","0","0","1","0","1","-2"
"112260","Claremont McKenna College","2011","Total full-time Instruction/research/public service, Tenured, Associate professors","35","25","10","0","0","0","5","2","3","0","0","0","2","2","0","0","0","0","26","19","7","0","0","0","2","2","0","0","0","0","-2"
"112260","Claremont McKenna College","2011","Total full-time Instruction/research/public service, Tenured, Lecturers","1","1","0","0","0","0","0","0","0","0","0","0","0","0","0","0","0","0","1","1","0","0","0","0","0","0","0","0","0","0","-2"
"112260","Claremont McKenna College","2011","Total full-time Instruction/research/public service, Tenured total","89","67","22","1","1","0","6","3","3","3","1","2","3","3","0","0","0","0","73","57","16","0","0","0","2","2","0","1","0","1","-2"
"112260","Claremont McKenna College","2011","Total full-time Instruction/research/public service, Non-tenured on tenure track, Assistant professors","34","22","12","0","0","0","4","3","1","0","0","0","0","0","0","0","0","0","25","16","9","0","0","0","1","0","1","4","3","1","-2"
"112260","Claremont McKenna College","2011","Total full-time Instruction/research/public service, Non-tenured on tenure track total","34","22","12","0","0","0","4","3","1","0","0","0","0","0","0","0","0","0","25","16","9","0","0","0","1","0","1","4","3","1","-2"
"112260","Claremont McKenna College","2011","Total full-time Instruction/research/public service, Non-tenured not on tenure track, Professors","1","1","0","0","0","0","0","0","0","0","0","0","0","0","0","0","0","0","1","1","0","0","0","0","0","0","0","0","0","0","-2"
"112260","Claremont McKenna College","2011","Total full-time Instruction/research/public service, Non-tenured not on tenure track, Associate professors","6","2","4","0","0","0","1","0","1","0","0","0","0","0","0","0","0","0","5","2","3","0","0","0","0","0","0","0","0","0","-2"
"112260","Claremont McKenna College","2011","Total full-time Instruction/research/public servicey, Non-tenured not on tenure track, Assistant professors","21","11","10","0","0","0","2","0","2","0","0","0","3","1","2","0","0","0","15","9","6","1","1","0","0","0","0","0","0","0","-2"
"112260","Claremont McKenna College","2011","Total full-time Instruction/research/public service, Non-tenured not on tenure track, Instructors","1","0","1","0","0","0","0","0","0","0","0","0","1","0","1","0","0","0","0","0","0","0","0","0","0","0","0","0","0","0","-2"
"112260","Claremont McKenna College","2011","Total full-time Instruction/research/public service, Non-tenured not on tenure track total","29","14","15","0","0","0","3","0","3","0","0","0","4","1","3","0","0","0","21","12","9","1","1","0","0","0","0","0","0","0","-2"
"112570","Columbia College Hollywood","2011","Total full-time Instruction/research/public service, Tenured, Professors","1","1","0","0","0","0","0","0","0","0","0","0","0","0","0","0","0","0","1","1","0","0","0","0","0","0","0","0","0","0","-2"
"112570","Columbia College Hollywood","2011","Total full-time Instruction/research/public service, Tenured total","1","1","0","0","0","0","0","0","0","0","0","0","0","0","0","0","0","0","1","1","0","0","0","0","0","0","0","0","0","0","-2"
"115083","Golden Gate University-San Francisco","2011","Total full-time Instruction/research/public service, Tenured, Professors","35","24","11","0","0","0","4","3","1","1","1","0","1","1","0","0","0","0","29","19","10","0","0","0","0","0","0","0","0","0","-2"
"115083","Golden Gate University-San Francisco","2011","Total full-time Instruction/research/public service, Tenured, Associate professors","3","2","1","0","0","0","0","0","0","0","0","0","0","0","0","0","0","0","3","2","1","0","0","0","0","0","0","0","0","0","-2"
"115083","Golden Gate University-San Francisco","2011","Total full-time Instruction/research/public service, Tenured total","38","26","12","0","0","0","4","3","1","1","1","0","1","1","0","0","0","0","32","21","11","0","0","0","0","0","0","0","0","0","-2"
"115083","Golden Gate University-San Francisco","2011","Total full-time Instruction/research/public service, Non-tenured on tenure track, Professors","3","2","1","0","0","0","0","0","0","0","0","0","0","0","0","0","0","0","3","2","1","0","0","0","0","0","0","0","0","0","-2"
"115083","Golden Gate University-San Francisco","2011","Total full-time Instruction/research/public service, Non-tenured on tenure track, Associate professors","18","9","9","0","0","0","4","2","2","0","0","0","1","0","1","0","0","0","13","7","6","0","0","0","0","0","0","0","0","0","-2"
"115083","Golden Gate University-San Francisco","2011","Total full-time Instruction/research/public service, Non-tenured on tenure track, Assistant professors","5","4","1","0","0","0","0","0","0","0","0","0","0","0","0","0","0","0","5","4","1","0","0","0","0","0","0","0","0","0","-2"
"115083","Golden Gate University-San Francisco","2011","Total full-time Instruction/research/public service, Non-tenured on tenure track total","26","15","11","0","0","0","4","2","2","0","0","0","1","0","1","0","0","0","21","13","8","0","0","0","0","0","0","0","0","0","-2"
"115083","Golden Gate University-San Francisco","2011","Total full-time Instruction/research/public service, Non-tenured not on tenure track, Professors","5","2","3","0","0","0","0","0","0","1","1","0","0","0","0","0","0","0","4","1","3","0","0","0","0","0","0","0","0","0","-2"
"115083","Golden Gate University-San Francisco","2011","Total full-time Instruction/research/public servicey, Non-tenured not on tenure track, Assistant professors","1","0","1","0","0","0","0","0","0","0","0","0","0","0","0","0","0","0","1","0","1","0","0","0","0","0","0","0","0","0","-2"
"115083","Golden Gate University-San Francisco","2011","Total full-time Instruction/research/public service, Non-tenured not on tenure track, Instructors","6","2","4","0","0","0","0","0","0","0","0","0","0","0","0","0","0","0","6","2","4","0","0","0","0","0","0","0","0","0","-2"
"115083","Golden Gate University-San Francisco","2011","Total full-time Instruction/research/public service, Non-tenured not on tenure track, No academic rank","3","1","2","0","0","0","1","0","1","1","0","1","0","0","0","0","0","0","1","1","0","0","0","0","0","0","0","0","0","0","-2"
"115083","Golden Gate University-San Francisco","2011","Total full-time Instruction/research/public service, Non-tenured not on tenure track total","15","5","10","0","0","0","1","0","1","2","1","1","0","0","0","0","0","0","12","4","8","0","0","0","0","0","0","0","0","0","-2"
"115409","Harvey Mudd College","2011","Total full-time Instruction/research/public service, Tenured, Professors","41","34","7","0","0","0","4","3","1","1","1","0","3","2","1","0","0","0","33","28","5","0","0","0","0","0","0","0","0","0","-2"
"115409","Harvey Mudd College","2011","Total full-time Instruction/research/public service, Tenured, Associate professors","27","11","16","0","0","0","4","0","4","0","0","0","1","1","0","0","0","0","22","10","12","0","0","0","0","0","0","0","0","0","-2"
"115409","Harvey Mudd College","2011","Total full-time Instruction/research/public service, Tenured total","68","45","23","0","0","0","8","3","5","1","1","0","4","3","1","0","0","0","55","38","17","0","0","0","0","0","0","0","0","0","-2"
"115409","Harvey Mudd College","2011","Total full-time Instruction/research/public service, Non-tenured on tenure track, Assistant professors","13","4","9","0","0","0","2","0","2","2","1","1","0","0","0","0","0","0","9","3","6","0","0","0","0","0","0","0","0","0","-2"
"115409","Harvey Mudd College","2011","Total full-time Instruction/research/public service, Non-tenured on tenure track total","13","4","9","0","0","0","2","0","2","2","1","1","0","0","0","0","0","0","9","3","6","0","0","0","0","0","0","0","0","0","-2"
"115409","Harvey Mudd College","2011","Total full-time Instruction/research/public service, Non-tenured not on tenure track, Professors","1","0","1","0","0","0","0","0","0","0","0","0","0","0","0","0","0","0","1","0","1","0","0","0","0","0","0","0","0","0","-2"
"115409","Harvey Mudd College","2011","Total full-time Instruction/research/public servicey, Non-tenured not on tenure track, Assistant professors","4","3","1","0","0","0","2","1","1","0","0","0","0","0","0","0","0","0","2","2","0","0","0","0","0","0","0","0","0","0","-2"
"115409","Harvey Mudd College","2011","Total full-time Instruction/research/public service, Non-tenured not on tenure track total","5","3","2","0","0","0","2","1","1","0","0","0","0","0","0","0","0","0","3","2","1","0","0","0","0","0","0","0","0","0","-2"
"117168","Laguna College of Art and Design","2011","Total full-time Instruction/research/public service, Non-tenured not on tenure track, Professors","4","2","2","0","0","0","0","0","0","0","0","0","0","0","0","0","0","0","4","2","2","0","0","0","0","0","0","0","0","0","-2"
"117168","Laguna College of Art and Design","2011","Total full-time Instruction/research/public service, Non-tenured not on tenure track, Associate professors","6","5","1","0","0","0","0","0","0","0","0","0","0","0","0","0","0","0","6","5","1","0","0","0","0","0","0","0","0","0","-2"
"117168","Laguna College of Art and Design","2011","Total full-time Instruction/research/public servicey, Non-tenured not on tenure track, Assistant professors","5","4","1","0","0","0","1","1","0","0","0","0","0","0","0","0","0","0","4","3","1","0","0","0","0","0","0","0","0","0","-2"
"117168","Laguna College of Art and Design","2011","Total full-time Instruction/research/public service, Non-tenured not on tenure track total","15","11","4","0","0","0","1","1","0","0","0","0","0","0","0","0","0","0","14","10","4","0","0","0","0","0","0","0","0","0","-2"
"117575","Southern California Seminary","2011","Total full-time Instruction/research/public service, Non-tenured not on tenure track, Professors","3","3","0","0","0","0","1","1","0","0","0","0","1","1","0","0","0","0","1","1","0","0","0","0","0","0","0","0","0","0","-2"
"117575","Southern California Seminary","2011","Total full-time Instruction/research/public service, Non-tenured not on tenure track total","3","3","0","0","0","0","1","1","0","0","0","0","1","1","0","0","0","0","1","1","0","0","0","0","0","0","0","0","0","0","-2"
"117946","Loyola Marymount University","2011","Total full-time Instruction/research/public service, Tenured, Professors","208","147","61","0","0","0","17","14","3","8","6","2","16","7","9","0","0","0","149","108","41","2","1","1","16","11","5","0","0","0","-2"
"117946","Loyola Marymount University","2011","Total full-time Instruction/research/public service, Tenured, Associate professors","124","68","56","1","0","1","13","7","6","8","7","1","17","8","9","0","0","0","80","43","37","1","1","0","4","2","2","0","0","0","-2"
"117946","Loyola Marymount University","2011","Total full-time Instruction/research/public service, Tenured, Assistant professors","8","5","3","0","0","0","1","1","0","0","0","0","1","1","0","0","0","0","6","3","3","0","0","0","0","0","0","0","0","0","-2"
"117946","Loyola Marymount University","2011","Total full-time Instruction/research/public service, Tenured total","340","220","120","1","0","1","31","22","9","16","13","3","34","16","18","0","0","0","235","154","81","3","2","1","20","13","7","0","0","0","-2"
"117946","Loyola Marymount University","2011","Total full-time Instruction/research/public service, Non-tenured on tenure track, Associate professors","13","6","7","0","0","0","2","0","2","1","0","1","2","0","2","0","0","0","5","4","1","0","0","0","2","2","0","1","0","1","-2"
"117946","Loyola Marymount University","2011","Total full-time Instruction/research/public service, Non-tenured on tenure track, Assistant professors","78","29","49","0","0","0","9","2","7","2","1","1","10","4","6","0","0","0","47","19","28","3","0","3","0","0","0","7","3","4","-2"
"117946","Loyola Marymount University","2011","Total full-time Instruction/research/public service, Non-tenured on tenure track total","91","35","56","0","0","0","11","2","9","3","1","2","12","4","8","0","0","0","52","23","29","3","0","3","2","2","0","8","3","5","-2"
"117946","Loyola Marymount University","2011","Total full-time Instruction/research/public service, Non-tenured not on tenure track, Professors","2","1","1","0","0","0","0","0","0","1","1","0","0","0","0","0","0","0","1","0","1","0","0","0","0","0","0","0","0","0","-2"
"117946","Loyola Marymount University","2011","Total full-time Instruction/research/public service, Non-tenured not on tenure track, Associate professors","21","7","14","0","0","0","2","1","1","1","0","1","1","0","1","0","0","0","14","6","8","0","0","0","3","0","3","0","0","0","-2"
"117946","Loyola Marymount University","2011","Total full-time Instruction/research/public servicey, Non-tenured not on tenure track, Assistant professors","32","17","15","0","0","0","4","1","3","2","1","1","4","2","2","0","0","0","19","12","7","0","0","0","2","1","1","1","0","1","-2"
"117946","Loyola Marymount University","2011","Total full-time Instruction/research/public service, Non-tenured not on tenure track, Instructors","47","19","28","0","0","0","2","0","2","5","3","2","8","4","4","0","0","0","32","12","20","0","0","0","0","0","0","0","0","0","-2"
"117946","Loyola Marymount University","2011","Total full-time Instruction/research/public service, Non-tenured not on tenure track, No academic rank","1","1","0","0","0","0","0","0","0","0","0","0","0","0","0","0","0","0","0","0","0","0","0","0","0","0","0","1","1","0","-2"
"117946","Loyola Marymount University","2011","Total full-time Instruction/research/public service, Non-tenured not on tenure track total","103","45","58","0","0","0","8","2","6","9","5","4","13","6","7","0","0","0","66","30","36","0","0","0","5","1","4","2","1","1","-2"
"120403","Otis College of Art and Design","2011","Total full-time Instruction/research/public service, Non-tenured not on tenure track, Professors","17","9","8","0","0","0","1","0","1","0","0","0","0","0","0","0","0","0","16","9","7","0","0","0","0","0","0","0","0","0","-2"
"120403","Otis College of Art and Design","2011","Total full-time Instruction/research/public service, Non-tenured not on tenure track, Associate professors","28","11","17","0","0","0","2","0","2","1","0","1","2","2","0","0","0","0","23","9","14","0","0","0","0","0","0","0","0","0","-2"
"120403","Otis College of Art and Design","2011","Total full-time Instruction/research/public servicey, Non-tenured not on tenure track, Assistant professors","10","4","6","0","0","0","0","0","0","0","0","0","2","1","1","0","0","0","8","3","5","0","0","0","0","0","0","0","0","0","-2"
"120403","Otis College of Art and Design","2011","Total full-time Instruction/research/public service, Non-tenured not on tenure track total","55","24","31","0","0","0","3","0","3","1","0","1","4","3","1","0","0","0","47","21","26","0","0","0","0","0","0","0","0","0","-2"
"120698","Palo Alto University","2011","Total full-time Instruction/research/public service, Tenured, Professors","8","7","1","0","0","0","0","0","0","1","1","0","0","0","0","0","0","0","7","6","1","0","0","0","0","0","0","0","0","0","-2"
"120698","Palo Alto University","2011","Total full-time Instruction/research/public service, Tenured, Associate professors","1","1","0","0","0","0","0","0","0","0","0","0","0","0","0","0","0","0","1","1","0","0","0","0","0","0","0","0","0","0","-2"
"120698","Palo Alto University","2011","Total full-time Instruction/research/public service, Tenured total","9","8","1","0","0","0","0","0","0","1","1","0","0","0","0","0","0","0","8","7","1","0","0","0","0","0","0","0","0","0","-2"
"120698","Palo Alto University","2011","Total full-time Instruction/research/public service, Non-tenured on tenure track, Assistant professors","6","1","5","0","0","0","1","0","1","0","0","0","0","0","0","0","0","0","4","1","3","0","0","0","1","0","1","0","0","0","-2"
"120698","Palo Alto University","2011","Total full-time Instruction/research/public service, Non-tenured on tenure track total","6","1","5","0","0","0","1","0","1","0","0","0","0","0","0","0","0","0","4","1","3","0","0","0","1","0","1","0","0","0","-2"
"120698","Palo Alto University","2011","Total full-time Instruction/research/public service, Non-tenured not on tenure track, Professors","5","3","2","0","0","0","1","0","1","0","0","0","0","0","0","0","0","0","4","3","1","0","0","0","0","0","0","0","0","0","-2"
"120698","Palo Alto University","2011","Total full-time Instruction/research/public service, Non-tenured not on tenure track, Associate professors","1","1","0","0","0","0","0","0","0","0","0","0","0","0","0","0","0","0","1","1","0","0","0","0","0","0","0","0","0","0","-2"
"120698","Palo Alto University","2011","Total full-time Instruction/research/public servicey, Non-tenured not on tenure track, Assistant professors","6","0","6","0","0","0","0","0","0","1","0","1","0","0","0","0","0","0","5","0","5","0","0","0","0","0","0","0","0","0","-2"
"120698","Palo Alto University","2011","Total full-time Instruction/research/public service, Non-tenured not on tenure track total","12","4","8","0","0","0","1","0","1","1","0","1","0","0","0","0","0","0","10","4","6","0","0","0","0","0","0","0","0","0","-2"
"120883","University of the Pacific","2011","Total full-time Instruction/research/public service, Tenured, Professors","133","101","32","0","0","0","14","10","4","5","3","2","6","5","1","0","0","0","103","79","24","0","0","0","1","1","0","4","3","1","-2"
"120883","University of the Pacific","2011","Total full-time Instruction/research/public service, Tenured, Associate professors","120","68","52","0","0","0","18","12","6","2","0","2","2","1","1","0","0","0","92","53","39","0","0","0","2","2","0","4","0","4","-2"
"120883","University of the Pacific","2011","Total full-time Instruction/research/public service, Tenured, Assistant professors","7","5","2","0","0","0","0","0","0","0","0","0","0","0","0","0","0","0","6","5","1","1","0","1","0","0","0","0","0","0","-2"
"120883","University of the Pacific","2011","Total full-time Instruction/research/public service, Tenured total","260","174","86","0","0","0","32","22","10","7","3","4","8","6","2","0","0","0","201","137","64","1","0","1","3","3","0","8","3","5","-2"
"120883","University of the Pacific","2011","Total full-time Instruction/research/public service, Non-tenured on tenure track, Professors","2","2","0","0","0","0","0","0","0","0","0","0","1","1","0","0","0","0","1","1","0","0","0","0","0","0","0","0","0","0","-2"
"120883","University of the Pacific","2011","Total full-time Instruction/research/public service, Non-tenured on tenure track, Associate professors","10","4","6","0","0","0","4","1","3","0","0","0","0","0","0","0","0","0","6","3","3","0","0","0","0","0","0","0","0","0","-2"
"120883","University of the Pacific","2011","Total full-time Instruction/research/public service, Non-tenured on tenure track, Assistant professors","82","38","44","0","0","0","12","4","8","2","0","2","1","0","1","0","0","0","59","30","29","1","0","1","5","3","2","2","1","1","-2"
"120883","University of the Pacific","2011","Total full-time Instruction/research/public service, Non-tenured on tenure track total","94","44","50","0","0","0","16","5","11","2","0","2","2","1","1","0","0","0","66","34","32","1","0","1","5","3","2","2","1","1","-2"
"120883","University of the Pacific","2011","Total full-time Instruction/research/public service, Non-tenured not on tenure track, Professors","10","8","2","0","0","0","0","0","0","0","0","0","0","0","0","0","0","0","8","6","2","0","0","0","2","2","0","0","0","0","-2"
"120883","University of the Pacific","2011","Total full-time Instruction/research/public service, Non-tenured not on tenure track, Associate professors","12","8","4","0","0","0","1","1","0","0","0","0","1","0","1","0","0","0","10","7","3","0","0","0","0","0","0","0","0","0","-2"
"120883","University of the Pacific","2011","Total full-time Instruction/research/public servicey, Non-tenured not on tenure track, Assistant professors","38","19","19","0","0","0","10","7","3","1","0","1","3","1","2","0","0","0","23","10","13","0","0","0","1","1","0","0","0","0","-2"
"120883","University of the Pacific","2011","Total full-time Instruction/research/public service, Non-tenured not on tenure track, Instructors","17","5","12","0","0","0","3","1","2","0","0","0","0","0","0","0","0","0","13","4","9","0","0","0","0","0","0","1","0","1","-2"
"120883","University of the Pacific","2011","Total full-time Instruction/research/public service, Non-tenured not on tenure track, Lecturers","14","6","8","0","0","0","2","0","2","0","0","0","1","0","1","0","0","0","11","6","5","0","0","0","0","0","0","0","0","0","-2"
"120883","University of the Pacific","2011","Total full-time Instruction/research/public service, Non-tenured not on tenure track, No academic rank","4","2","2","0","0","0","1","1","0","0","0","0","0","0","0","0","0","0","2","0","2","0","0","0","0","0","0","1","1","0","-2"
"120883","University of the Pacific","2011","Total full-time Instruction/research/public service, Non-tenured not on tenure track total","95","48","47","0","0","0","17","10","7","1","0","1","5","1","4","0","0","0","67","33","34","0","0","0","3","3","0","2","1","1","-2"
"121309","Point Loma Nazarene University","2011","Total full-time Instruction/research/public service, Tenured, Professors","67","48","19","0","0","0","3","1","2","2","2","0","4","1","3","0","0","0","58","44","14","0","0","0","0","0","0","0","0","0","-2"
"121309","Point Loma Nazarene University","2011","Total full-time Instruction/research/public service, Tenured total","67","48","19","0","0","0","3","1","2","2","2","0","4","1","3","0","0","0","58","44","14","0","0","0","0","0","0","0","0","0","-2"
"121309","Point Loma Nazarene University","2011","Total full-time Instruction/research/public service, Non-tenured on tenure track, Professors","19","8","11","0","0","0","0","0","0","1","0","1","0","0","0","0","0","0","18","8","10","0","0","0","0","0","0","0","0","0","-2"
"121309","Point Loma Nazarene University","2011","Total full-time Instruction/research/public service, Non-tenured on tenure track, Associate professors","31","17","14","0","0","0","1","1","0","0","0","0","2","0","2","0","0","0","28","16","12","0","0","0","0","0","0","0","0","0","-2"
"121309","Point Loma Nazarene University","2011","Total full-time Instruction/research/public service, Non-tenured on tenure track, Assistant professors","26","14","12","0","0","0","2","1","1","2","0","2","0","0","0","0","0","0","22","13","9","0","0","0","0","0","0","0","0","0","-2"
"121309","Point Loma Nazarene University","2011","Total full-time Instruction/research/public service, Non-tenured on tenure track total","76","39","37","0","0","0","3","2","1","3","0","3","2","0","2","0","0","0","68","37","31","0","0","0","0","0","0","0","0","0","-2"
"121345","Pomona College","2011","Total full-time Instruction/research/public service, Tenured, Professors","87","55","32","0","0","0","8","2","6","2","1","1","12","7","5","0","0","0","51","33","18","4","3","1","10","9","1","0","0","0","-2"
"121345","Pomona College","2011","Total full-time Instruction/research/public service, Tenured, Associate professors","49","26","23","0","0","0","9","4","5","1","1","0","5","4","1","0","0","0","25","11","14","1","1","0","8","5","3","0","0","0","-2"
"121345","Pomona College","2011","Total full-time Instruction/research/public service, Tenured total","136","81","55","0","0","0","17","6","11","3","2","1","17","11","6","0","0","0","76","44","32","5","4","1","18","14","4","0","0","0","-2"
"121345","Pomona College","2011","Total full-time Instruction/research/public service, Non-tenured on tenure track, Assistant professors","41","23","18","0","0","0","4","2","2","1","1","0","4","3","1","0","0","0","22","12","10","1","1","0","9","4","5","0","0","0","-2"
"121345","Pomona College","2011","Total full-time Instruction/research/public service, Non-tenured on tenure track, Instructors","1","1","0","0","0","0","0","0","0","0","0","0","0","0","0","0","0","0","1","1","0","0","0","0","0","0","0","0","0","0","-2"
"121345","Pomona College","2011","Total full-time Instruction/research/public service, Non-tenured on tenure track total","42","24","18","0","0","0","4","2","2","1","1","0","4","3","1","0","0","0","23","13","10","1","1","0","9","4","5","0","0","0","-2"
"121345","Pomona College","2011","Total full-time Instruction/research/public service, Non-tenured not on tenure track, Professors","3","1","2","0","0","0","1","0","1","0","0","0","1","0","1","0","0","0","0","0","0","0","0","0","1","1","0","0","0","0","-2"
"121345","Pomona College","2011","Total full-time Instruction/research/public service, Non-tenured not on tenure track, Associate professors","1","0","1","0","0","0","0","0","0","0","0","0","1","0","1","0","0","0","0","0","0","0","0","0","0","0","0","0","0","0","-2"
"121345","Pomona College","2011","Total full-time Instruction/research/public service, Non-tenured not on tenure track total","4","1","3","0","0","0","1","0","1","0","0","0","2","0","2","0","0","0","0","0","0","0","0","0","1","1","0","0","0","0","-2"
"122296","Samuel Merritt University","2011","Total full-time Instruction/research/public service, Non-tenured not on tenure track, Professors","11","8","3","0","0","0","0","0","0","0","0","0","0","0","0","0","0","0","11","8","3","0","0","0","0","0","0","0","0","0","-2"
"122296","Samuel Merritt University","2011","Total full-time Instruction/research/public service, Non-tenured not on tenure track, Associate professors","14","3","11","0","0","0","1","1","0","2","0","2","0","0","0","0","0","0","11","2","9","0","0","0","0","0","0","0","0","0","-2"
"122296","Samuel Merritt University","2011","Total full-time Instruction/research/public servicey, Non-tenured not on tenure track, Assistant professors","68","13","55","0","0","0","7","1","6","1","0","1","1","0","1","0","0","0","58","12","46","1","0","1","0","0","0","0","0","0","-2"
"122296","Samuel Merritt University","2011","Total full-time Instruction/research/public service, Non-tenured not on tenure track, Instructors","16","0","16","0","0","0","2","0","2","2","0","2","0","0","0","0","0","0","11","0","11","1","0","1","0","0","0","0","0","0","-2"
"122296","Samuel Merritt University","2011","Total full-time Instruction/research/public service, Non-tenured not on tenure track total","109","24","85","0","0","0","10","2","8","5","0","5","1","0","1","0","0","0","91","22","69","2","0","2","0","0","0","0","0","0","-2"
"122436","University of San Diego","2011","Total full-time Instruction/research/public service, Tenured, Professors","152","99","53","0","0","0","9","5","4","2","2","0","7","5","2","0","0","0","133","87","46","0","0","0","0","0","0","1","0","1","-2"
"122436","University of San Diego","2011","Total full-time Instruction/research/public service, Tenured, Associate professors","90","48","42","1","0","1","11","7","4","2","2","0","12","4","8","0","0","0","63","34","29","1","1","0","0","0","0","0","0","0","-2"
"122436","University of San Diego","2011","Total full-time Instruction/research/public service, Tenured, Assistant professors","1","0","1","0","0","0","0","0","0","0","0","0","0","0","0","0","0","0","1","0","1","0","0","0","0","0","0","0","0","0","-2"
"122436","University of San Diego","2011","Total full-time Instruction/research/public service, Tenured total","243","147","96","1","0","1","20","12","8","4","4","0","19","9","10","0","0","0","197","121","76","1","1","0","0","0","0","1","0","1","-2"
"122436","University of San Diego","2011","Total full-time Instruction/research/public service, Non-tenured on tenure track, Professors","4","1","3","0","0","0","0","0","0","0","0","0","0","0","0","0","0","0","4","1","3","0","0","0","0","0","0","0","0","0","-2"
"122436","University of San Diego","2011","Total full-time Instruction/research/public service, Non-tenured on tenure track, Associate professors","19","10","9","0","0","0","0","0","0","0","0","0","2","1","1","0","0","0","16","8","8","0","0","0","0","0","0","1","1","0","-2"
"122436","University of San Diego","2011","Total full-time Instruction/research/public service, Non-tenured on tenure track, Assistant professors","77","33","44","0","0","0","8","2","6","3","2","1","4","1","3","0","0","0","55","25","30","1","0","1","0","0","0","6","3","3","-2"
"122436","University of San Diego","2011","Total full-time Instruction/research/public service, Non-tenured on tenure track total","100","44","56","0","0","0","8","2","6","3","2","1","6","2","4","0","0","0","75","34","41","1","0","1","0","0","0","7","4","3","-2"
"122436","University of San Diego","2011","Total full-time Instruction/research/public service, Non-tenured not on tenure track, Professors","11","7","4","0","0","0","1","1","0","0","0","0","0","0","0","0","0","0","9","5","4","0","0","0","0","0","0","1","1","0","-2"
"122436","University of San Diego","2011","Total full-time Instruction/research/public service, Non-tenured not on tenure track, Associate professors","9","3","6","0","0","0","0","0","0","1","1","0","1","0","1","0","0","0","7","2","5","0","0","0","0","0","0","0","0","0","-2"
"122436","University of San Diego","2011","Total full-time Instruction/research/public servicey, Non-tenured not on tenure track, Assistant professors","18","9","9","1","0","1","1","0","1","1","1","0","0","0","0","0","0","0","15","8","7","0","0","0","0","0","0","0","0","0","-2"
"122436","University of San Diego","2011","Total full-time Instruction/research/public service, Non-tenured not on tenure track, Instructors","21","5","16","0","0","0","2","1","1","0","0","0","2","0","2","0","0","0","16","4","12","0","0","0","0","0","0","1","0","1","-2"
"122436","University of San Diego","2011","Total full-time Instruction/research/public service, Non-tenured not on tenure track total","59","24","35","1","0","1","4","2","2","2","2","0","3","0","3","0","0","0","47","19","28","0","0","0","0","0","0","2","1","1","-2"
"122454","San Francisco Art Institute","2011","Total full-time Instruction/research/public service, Tenured, Professors","5","4","1","0","0","0","0","0","0","0","0","0","1","1","0","0","0","0","4","3","1","0","0","0","0","0","0","0","0","0","-2"
"122454","San Francisco Art Institute","2011","Total full-time Instruction/research/public service, Tenured, Associate professors","18","12","6","0","0","0","1","1","0","1","1","0","0","0","0","0","0","0","16","10","6","0","0","0","0","0","0","0","0","0","-2"
"122454","San Francisco Art Institute","2011","Total full-time Instruction/research/public service, Tenured total","23","16","7","0","0","0","1","1","0","1","1","0","1","1","0","0","0","0","20","13","7","0","0","0","0","0","0","0","0","0","-2"
"122454","San Francisco Art Institute","2011","Total full-time Instruction/research/public service, Non-tenured on tenure track, Assistant professors","1","0","1","0","0","0","0","0","0","0","0","0","0","0","0","0","0","0","1","0","1","0","0","0","0","0","0","0","0","0","-2"
"122454","San Francisco Art Institute","2011","Total full-time Instruction/research/public service, Non-tenured on tenure track total","1","0","1","0","0","0","0","0","0","0","0","0","0","0","0","0","0","0","1","0","1","0","0","0","0","0","0","0","0","0","-2"
"122612","University of San Francisco","2011","Total full-time Instruction/research/public service, Tenured, Professors","131","87","44","0","0","0","9","7","2","3","0","3","8","6","2","1","1","0","93","63","30","4","3","1","12","7","5","1","0","1","-2"
"122612","University of San Francisco","2011","Total full-time Instruction/research/public service, Tenured, Associate professors","97","45","52","0","0","0","12","5","7","8","3","5","8","4","4","0","0","0","57","27","30","2","2","0","10","4","6","0","0","0","-2"
"122612","University of San Francisco","2011","Total full-time Instruction/research/public service, Tenured, Assistant professors","6","3","3","0","0","0","0","0","0","0","0","0","0","0","0","0","0","0","5","2","3","0","0","0","1","1","0","0","0","0","-2"
"122612","University of San Francisco","2011","Total full-time Instruction/research/public service, Tenured total","234","135","99","0","0","0","21","12","9","11","3","8","16","10","6","1","1","0","155","92","63","6","5","1","23","12","11","1","0","1","-2"
"122612","University of San Francisco","2011","Total full-time Instruction/research/public service, Non-tenured on tenure track, Associate professors","7","5","2","0","0","0","2","1","1","0","0","0","2","1","1","0","0","0","1","1","0","0","0","0","2","2","0","0","0","0","-2"
"122612","University of San Francisco","2011","Total full-time Instruction/research/public service, Non-tenured on tenure track, Assistant professors","75","27","48","0","0","0","11","6","5","6","2","4","7","4","3","0","0","0","33","9","24","4","2","2","10","2","8","4","2","2","-2"
"122612","University of San Francisco","2011","Total full-time Instruction/research/public service, Non-tenured on tenure track, Instructors","2","0","2","0","0","0","0","0","0","0","0","0","1","0","1","0","0","0","1","0","1","0","0","0","0","0","0","0","0","0","-2"
"122612","University of San Francisco","2011","Total full-time Instruction/research/public service, Non-tenured on tenure track total","84","32","52","0","0","0","13","7","6","6","2","4","10","5","5","0","0","0","35","10","25","4","2","2","12","4","8","4","2","2","-2"
"122612","University of San Francisco","2011","Total full-time Instruction/research/public service, Non-tenured not on tenure track, Professors","3","3","0","0","0","0","0","0","0","0","0","0","0","0","0","0","0","0","2","2","0","0","0","0","1","1","0","0","0","0","-2"
"122612","University of San Francisco","2011","Total full-time Instruction/research/public service, Non-tenured not on tenure track, Associate professors","14","6","8","0","0","0","1","1","0","1","0","1","0","0","0","0","0","0","11","4","7","1","1","0","0","0","0","0","0","0","-2"
"122612","University of San Francisco","2011","Total full-time Instruction/research/public servicey, Non-tenured not on tenure track, Assistant professors","55","28","27","0","0","0","7","2","5","4","0","4","6","4","2","0","0","0","30","17","13","1","1","0","5","3","2","2","1","1","-2"
"122612","University of San Francisco","2011","Total full-time Instruction/research/public service, Non-tenured not on tenure track, Instructors","16","7","9","1","0","1","1","0","1","0","0","0","0","0","0","0","0","0","11","6","5","1","1","0","2","0","2","0","0","0","-2"
"122612","University of San Francisco","2011","Total full-time Instruction/research/public service, Non-tenured not on tenure track total","88","44","44","1","0","1","9","3","6","5","0","5","6","4","2","0","0","0","54","29","25","3","3","0","8","4","4","2","1","1","-2"
"122728","William Jessup University","2011","Total full-time Instruction/research/public service, Tenured, Professors","6","2","4","0","0","0","0","0","0","0","0","0","1","0","1","0","0","0","5","2","3","0","0","0","0","0","0","0","0","0","-2"
"122728","William Jessup University","2011","Total full-time Instruction/research/public service, Tenured total","6","2","4","0","0","0","0","0","0","0","0","0","1","0","1","0","0","0","5","2","3","0","0","0","0","0","0","0","0","0","-2"
"122728","William Jessup University","2011","Total full-time Instruction/research/public service, Non-tenured on tenure track, Professors","4","3","1","0","0","0","0","0","0","0","0","0","0","0","0","0","0","0","4","3","1","0","0","0","0","0","0","0","0","0","-2"
"122728","William Jessup University","2011","Total full-time Instruction/research/public service, Non-tenured on tenure track, Associate professors","11","7","4","1","1","0","2","1","1","0","0","0","0","0","0","0","0","0","8","5","3","0","0","0","0","0","0","0","0","0","-2"
"122728","William Jessup University","2011","Total full-time Instruction/research/public service, Non-tenured on tenure track, Assistant professors","7","6","1","0","0","0","0","0","0","0","0","0","1","1","0","0","0","0","6","5","1","0","0","0","0","0","0","0","0","0","-2"
"122728","William Jessup University","2011","Total full-time Instruction/research/public service, Non-tenured on tenure track total","22","16","6","1","1","0","2","1","1","0","0","0","1","1","0","0","0","0","18","13","5","0","0","0","0","0","0","0","0","0","-2"
"122931","Santa Clara University","2011","Total full-time Instruction/research/public service, Tenured, Professors","142","101","41","0","0","0","10","9","1","0","0","0","9","8","1","0","0","0","122","83","39","1","1","0","0","0","0","0","0","0","-2"
"122931","Santa Clara University","2011","Total full-time Instruction/research/public service, Tenured, Associate professors","137","80","57","0","0","0","15","7","8","6","3","3","13","7","6","0","0","0","101","62","39","0","0","0","2","1","1","0","0","0","-2"
"122931","Santa Clara University","2011","Total full-time Instruction/research/public service, Tenured, Assistant professors","1","1","0","0","0","0","0","0","0","0","0","0","0","0","0","0","0","0","1","1","0","0","0","0","0","0","0","0","0","0","-2"
"122931","Santa Clara University","2011","Total full-time Instruction/research/public service, Tenured, No academic rank","1","1","0","0","0","0","0","0","0","0","0","0","0","0","0","0","0","0","1","1","0","0","0","0","0","0","0","0","0","0","-2"
"122931","Santa Clara University","2011","Total full-time Instruction/research/public service, Tenured total","281","183","98","0","0","0","25","16","9","6","3","3","22","15","7","0","0","0","225","147","78","1","1","0","2","1","1","0","0","0","-2"
"122931","Santa Clara University","2011","Total full-time Instruction/research/public service, Non-tenured on tenure track, Associate professors","7","4","3","0","0","0","2","1","1","0","0","0","1","0","1","0","0","0","4","3","1","0","0","0","0","0","0","0","0","0","-2"
"122931","Santa Clara University","2011","Total full-time Instruction/research/public service, Non-tenured on tenure track, Assistant professors","79","42","37","0","0","0","17","7","10","2","1","1","3","1","2","5","4","1","50","28","22","1","1","0","1","0","1","0","0","0","-2"
"122931","Santa Clara University","2011","Total full-time Instruction/research/public service, Non-tenured on tenure track total","86","46","40","0","0","0","19","8","11","2","1","1","4","1","3","5","4","1","54","31","23","1","1","0","1","0","1","0","0","0","-2"
"122931","Santa Clara University","2011","Total full-time Instruction/research/public service, Non-tenured not on tenure track, Lecturers","86","37","49","0","0","0","5","1","4","2","0","2","8","4","4","0","0","0","68","31","37","3","1","2","0","0","0","0","0","0","-2"
"122931","Santa Clara University","2011","Total full-time Instruction/research/public service, Non-tenured not on tenure track, No academic rank","30","15","15","0","0","0","2","1","1","0","0","0","2","0","2","1","1","0","24","12","12","1","1","0","0","0","0","0","0","0","-2"
"122931","Santa Clara University","2011","Total full-time Instruction/research/public service, Non-tenured not on tenure track total","116","52","64","0","0","0","7","2","5","2","0","2","10","4","6","1","1","0","92","43","49","4","2","2","0","0","0","0","0","0","-2"
"123299","Shasta College","2011","Total full-time Instruction/research/public service, Tenured, Instructors","96","51","45","2","1","1","2","1","1","2","0","2","4","2","2","0","0","0","86","47","39","0","0","0","0","0","0","0","0","0","-2"
"123299","Shasta College","2011","Total full-time Instruction/research/public service, Tenured total","96","51","45","2","1","1","2","1","1","2","0","2","4","2","2","0","0","0","86","47","39","0","0","0","0","0","0","0","0","0","-2"
"123299","Shasta College","2011","Total full-time Instruction/research/public service, Non-tenured on tenure track, Instructors","23","15","8","0","0","0","0","0","0","0","0","0","2","2","0","1","1","0","20","12","8","0","0","0","0","0","0","0","0","0","-2"
"123299","Shasta College","2011","Total full-time Instruction/research/public service, Non-tenured on tenure track total","23","15","8","0","0","0","0","0","0","0","0","0","2","2","0","1","1","0","20","12","8","0","0","0","0","0","0","0","0","0","-2"
"123299","Shasta College","2011","Total full-time Instruction/research/public service, Non-tenured not on tenure track, Instructors","17","7","10","0","0","0","0","0","0","2","2","0","0","0","0","0","0","0","15","5","10","0","0","0","0","0","0","0","0","0","-2"
"123299","Shasta College","2011","Total full-time Instruction/research/public service, Non-tenured not on tenure track total","17","7","10","0","0","0","0","0","0","2","2","0","0","0","0","0","0","0","15","5","10","0","0","0","0","0","0","0","0","0","-2"
"123457","Simpson University","2011","Total full-time Instruction/research/public service, Non-tenured not on tenure track, Professors","9","8","1","0","0","0","0","0","0","0","0","0","0","0","0","0","0","0","8","7","1","1","1","0","0","0","0","0","0","0","-2"
"123457","Simpson University","2011","Total full-time Instruction/research/public service, Non-tenured not on tenure track, Associate professors","11","6","5","0","0","0","0","0","0","0","0","0","0","0","0","0","0","0","11","6","5","0","0","0","0","0","0","0","0","0","-2"
"123457","Simpson University","2011","Total full-time Instruction/research/public servicey, Non-tenured not on tenure track, Assistant professors","25","17","8","1","1","0","1","1","0","0","0","0","1","1","0","1","1","0","20","12","8","0","0","0","0","0","0","1","1","0","-2"
"123457","Simpson University","2011","Total full-time Instruction/research/public service, Non-tenured not on tenure track total","45","31","14","1","1","0","1","1","0","0","0","0","1","1","0","1","1","0","39","25","14","1","1","0","0","0","0","1","1","0","-2"
"124292","Thomas Aquinas College","2011","Total full-time Instruction/research/public service, Tenured, Professors","13","11","2","0","0","0","0","0","0","0","0","0","1","1","0","0","0","0","11","10","1","0","0","0","0","0","0","1","0","1","-2"
"124292","Thomas Aquinas College","2011","Total full-time Instruction/research/public service, Tenured, Associate professors","8","8","0","0","0","0","0","0","0","0","0","0","0","0","0","0","0","0","6","6","0","2","2","0","0","0","0","0","0","0","-2"
"124292","Thomas Aquinas College","2011","Total full-time Instruction/research/public service, Tenured, Assistant professors","1","1","0","0","0","0","0","0","0","0","0","0","0","0","0","0","0","0","1","1","0","0","0","0","0","0","0","0","0","0","-2"
"124292","Thomas Aquinas College","2011","Total full-time Instruction/research/public service, Tenured total","22","20","2","0","0","0","0","0","0","0","0","0","1","1","0","0","0","0","18","17","1","2","2","0","0","0","0","1","0","1","-2"
"124292","Thomas Aquinas College","2011","Total full-time Instruction/research/public service, Non-tenured on tenure track, Professors","1","1","0","0","0","0","0","0","0","0","0","0","0","0","0","0","0","0","1","1","0","0","0","0","0","0","0","0","0","0","-2"
"124292","Thomas Aquinas College","2011","Total full-time Instruction/research/public service, Non-tenured on tenure track, Associate professors","2","2","0","0","0","0","0","0","0","0","0","0","0","0","0","0","0","0","2","2","0","0","0","0","0","0","0","0","0","0","-2"
"124292","Thomas Aquinas College","2011","Total full-time Instruction/research/public service, Non-tenured on tenure track, Assistant professors","4","3","1","0","0","0","0","0","0","0","0","0","0","0","0","0","0","0","3","3","0","0","0","0","1","0","1","0","0","0","-2"
"124292","Thomas Aquinas College","2011","Total full-time Instruction/research/public service, Non-tenured on tenure track total","7","6","1","0","0","0","0","0","0","0","0","0","0","0","0","0","0","0","6","6","0","0","0","0","1","0","1","0","0","0","-2"
"124292","Thomas Aquinas College","2011","Total full-time Instruction/research/public service, Non-tenured not on tenure track, Professors","1","1","0","0","0","0","0","0","0","0","0","0","0","0","0","0","0","0","1","1","0","0","0","0","0","0","0","0","0","0","-2"
"124292","Thomas Aquinas College","2011","Total full-time Instruction/research/public service, Non-tenured not on tenure track total","1","1","0","0","0","0","0","0","0","0","0","0","0","0","0","0","0","0","1","1","0","0","0","0","0","0","0","0","0","0","-2"
"125727","Westmont College","2011","Total full-time Instruction/research/public service, Tenured, Professors","49","38","11","0","0","0","1","1","0","0","0","0","1","1","0","0","0","0","47","36","11","0","0","0","0","0","0","0","0","0","-2"
"125727","Westmont College","2011","Total full-time Instruction/research/public service, Tenured, Associate professors","14","8","6","0","0","0","2","1","1","1","1","0","1","0","1","0","0","0","10","6","4","0","0","0","0","0","0","0","0","0","-2"
"125727","Westmont College","2011","Total full-time Instruction/research/public service, Tenured total","63","46","17","0","0","0","3","2","1","1","1","0","2","1","1","0","0","0","57","42","15","0","0","0","0","0","0","0","0","0","-2"
"125727","Westmont College","2011","Total full-time Instruction/research/public service, Non-tenured on tenure track, Professors","3","1","2","0","0","0","0","0","0","0","0","0","1","0","1","0","0","0","2","1","1","0","0","0","0","0","0","0","0","0","-2"
"125727","Westmont College","2011","Total full-time Instruction/research/public service, Non-tenured on tenure track, Associate professors","3","3","0","0","0","0","0","0","0","0","0","0","0","0","0","0","0","0","3","3","0","0","0","0","0","0","0","0","0","0","-2"
"125727","Westmont College","2011","Total full-time Instruction/research/public service, Non-tenured on tenure track, Assistant professors","16","9","7","1","0","1","2","2","0","0","0","0","0","0","0","0","0","0","13","7","6","0","0","0","0","0","0","0","0","0","-2"
"125727","Westmont College","2011","Total full-time Instruction/research/public service, Non-tenured on tenure track total","22","13","9","1","0","1","2","2","0","0","0","0","1","0","1","0","0","0","18","11","7","0","0","0","0","0","0","0","0","0","-2"
"125727","Westmont College","2011","Total full-time Instruction/research/public service, Non-tenured not on tenure track, Associate professors","3","2","1","0","0","0","0","0","0","0","0","0","0","0","0","0","0","0","3","2","1","0","0","0","0","0","0","0","0","0","-2"
"125727","Westmont College","2011","Total full-time Instruction/research/public servicey, Non-tenured not on tenure track, Assistant professors","6","2","4","0","0","0","0","0","0","0","0","0","0","0","0","0","0","0","6","2","4","0","0","0","0","0","0","0","0","0","-2"
"125727","Westmont College","2011","Total full-time Instruction/research/public service, Non-tenured not on tenure track, Instructors","1","0","1","0","0","0","0","0","0","0","0","0","0","0","0","0","0","0","1","0","1","0","0","0","0","0","0","0","0","0","-2"
"125727","Westmont College","2011","Total full-time Instruction/research/public service, Non-tenured not on tenure track total","10","4","6","0","0","0","0","0","0","0","0","0","0","0","0","0","0","0","10","4","6","0","0","0","0","0","0","0","0","0","-2"
"126580","University of Colorado Colorado Springs","2011","Total full-time Instruction/research/public service, Tenured, Professors","74","58","16","0","0","0","3","3","0","1","0","1","3","2","1","0","0","0","66","52","14","0","0","0","1","1","0","0","0","0","-2"
"126580","University of Colorado Colorado Springs","2011","Total full-time Instruction/research/public service, Tenured, Associate professors","68","32","36","1","0","1","2","2","0","2","0","2","2","1","1","0","0","0","57","28","29","0","0","0","4","1","3","0","0","0","-2"
"126580","University of Colorado Colorado Springs","2011","Total full-time Instruction/research/public service, Tenured total","142","90","52","1","0","1","5","5","0","3","0","3","5","3","2","0","0","0","123","80","43","0","0","0","5","2","3","0","0","0","-2"
"126580","University of Colorado Colorado Springs","2011","Total full-time Instruction/research/public service, Non-tenured on tenure track, Assistant professors","75","32","43","1","0","1","7","2","5","2","1","1","6","4","2","0","0","0","48","20","28","0","0","0","11","5","6","0","0","0","-2"
"126580","University of Colorado Colorado Springs","2011","Total full-time Instruction/research/public service, Non-tenured on tenure track total","75","32","43","1","0","1","7","2","5","2","1","1","6","4","2","0","0","0","48","20","28","0","0","0","11","5","6","0","0","0","-2"
"126580","University of Colorado Colorado Springs","2011","Total full-time Instruction/research/public service, Non-tenured not on tenure track, Instructors","113","36","77","2","1","1","2","1","1","2","1","1","9","3","6","0","0","0","92","29","63","0","0","0","6","1","5","0","0","0","-2"
"126580","University of Colorado Colorado Springs","2011","Total full-time Instruction/research/public service, Non-tenured not on tenure track, No academic rank","22","8","14","0","0","0","2","1","1","0","0","0","1","0","1","0","0","0","18","6","12","0","0","0","1","1","0","0","0","0","-2"
"126580","University of Colorado Colorado Springs","2011","Total full-time Instruction/research/public service, Non-tenured not on tenure track total","135","44","91","2","1","1","4","2","2","2","1","1","10","3","7","0","0","0","110","35","75","0","0","0","7","2","5","0","0","0","-2"
"127200","Front Range Community College","2011","Total full-time Instruction/research/public service, Tenured, Professors","136","60","76","1","0","1","3","1","2","3","1","2","7","4","3","0","0","0","120","53","67","0","0","0","1","0","1","1","1","0","-2"
"127200","Front Range Community College","2011","Total full-time Instruction/research/public service, Tenured total","136","60","76","1","0","1","3","1","2","3","1","2","7","4","3","0","0","0","120","53","67","0","0","0","1","0","1","1","1","0","-2"
"127200","Front Range Community College","2011","Total full-time Instruction/research/public service, Non-tenured on tenure track, Professors","68","22","46","2","1","1","2","0","2","0","0","0","1","0","1","0","0","0","63","21","42","0","0","0","0","0","0","0","0","0","-2"
"127200","Front Range Community College","2011","Total full-time Instruction/research/public service, Non-tenured on tenure track total","68","22","46","2","1","1","2","0","2","0","0","0","1","0","1","0","0","0","63","21","42","0","0","0","0","0","0","0","0","0","-2"
"127200","Front Range Community College","2011","Total full-time Instruction/research/public service, Non-tenured not on tenure track, Professors","31","9","22","0","0","0","3","0","3","0","0","0","0","0","0","0","0","0","28","9","19","0","0","0","0","0","0","0","0","0","-2"
"127200","Front Range Community College","2011","Total full-time Instruction/research/public service, Non-tenured not on tenure track total","31","9","22","0","0","0","3","0","3","0","0","0","0","0","0","0","0","0","28","9","19","0","0","0","0","0","0","0","0","0","-2"
"127556","Colorado Mesa University","2011","Total full-time Instruction/research/public service, Tenured, Professors","61","40","21","0","0","0","0","0","0","0","0","0","1","1","0","0","0","0","44","27","17","1","1","0","11","8","3","4","3","1","-2"
"127556","Colorado Mesa University","2011","Total full-time Instruction/research/public service, Tenured, Associate professors","17","6","11","0","0","0","1","1","0","0","0","0","0","0","0","0","0","0","13","4","9","0","0","0","1","0","1","2","1","1","-2"
"127556","Colorado Mesa University","2011","Total full-time Instruction/research/public service, Tenured, Assistant professors","1","1","0","0","0","0","0","0","0","1","1","0","0","0","0","0","0","0","0","0","0","0","0","0","0","0","0","0","0","0","-2"
"127556","Colorado Mesa University","2011","Total full-time Instruction/research/public service, Tenured, Instructors","1","1","0","0","0","0","0","0","0","0","0","0","0","0","0","0","0","0","1","1","0","0","0","0","0","0","0","0","0","0","-2"
"127556","Colorado Mesa University","2011","Total full-time Instruction/research/public service, Tenured total","80","48","32","0","0","0","1","1","0","1","1","0","1","1","0","0","0","0","58","32","26","1","1","0","12","8","4","6","4","2","-2"
"127556","Colorado Mesa University","2011","Total full-time Instruction/research/public service, Non-tenured on tenure track, Professors","3","3","0","0","0","0","0","0","0","0","0","0","0","0","0","0","0","0","2","2","0","0","0","0","1","1","0","0","0","0","-2"
"127556","Colorado Mesa University","2011","Total full-time Instruction/research/public service, Non-tenured on tenure track, Associate professors","13","10","3","0","0","0","0","0","0","0","0","0","0","0","0","0","0","0","13","10","3","0","0","0","0","0","0","0","0","0","-2"
"127556","Colorado Mesa University","2011","Total full-time Instruction/research/public service, Non-tenured on tenure track, Assistant professors","60","33","27","0","0","0","0","0","0","0","0","0","1","0","1","0","0","0","51","26","25","0","0","0","8","7","1","0","0","0","-2"
"127556","Colorado Mesa University","2011","Total full-time Instruction/research/public service, Non-tenured on tenure track total","76","46","30","0","0","0","0","0","0","0","0","0","1","0","1","0","0","0","66","38","28","0","0","0","9","8","1","0","0","0","-2"
"127556","Colorado Mesa University","2011","Total full-time Instruction/research/public service, Non-tenured not on tenure track, Professors","1","0","1","0","0","0","0","0","0","0","0","0","0","0","0","0","0","0","1","0","1","0","0","0","0","0","0","0","0","0","-2"
"127556","Colorado Mesa University","2011","Total full-time Instruction/research/public servicey, Non-tenured not on tenure track, Assistant professors","2","2","0","0","0","0","0","0","0","0","0","0","0","0","0","0","0","0","2","2","0","0","0","0","0","0","0","0","0","0","-2"
"127556","Colorado Mesa University","2011","Total full-time Instruction/research/public service, Non-tenured not on tenure track, Instructors","79","46","33","0","0","0","1","0","1","0","0","0","5","4","1","0","0","0","63","38","25","0","0","0","6","4","2","4","0","4","-2"
"127556","Colorado Mesa University","2011","Total full-time Instruction/research/public service, Non-tenured not on tenure track, Lecturers","3","2","1","0","0","0","0","0","0","0","0","0","0","0","0","0","0","0","2","1","1","0","0","0","1","1","0","0","0","0","-2"
"127556","Colorado Mesa University","2011","Total full-time Instruction/research/public service, Non-tenured not on tenure track, No academic rank","4","2","2","0","0","0","0","0","0","0","0","0","0","0","0","0","0","0","3","2","1","0","0","0","0","0","0","1","0","1","-2"
"127556","Colorado Mesa University","2011","Total full-time Instruction/research/public service, Non-tenured not on tenure track total","89","52","37","0","0","0","1","0","1","0","0","0","5","4","1","0","0","0","71","43","28","0","0","0","7","5","2","5","0","5","-2"
"127820","Pikes Peak Community College","2011","Total full-time Instruction/research/public service, Non-tenured not on tenure track, No academic rank","171","66","105","1","1","0","4","2","2","5","1","4","6","3","3","0","0","0","154","59","95","1","0","1","0","0","0","0","0","0","-2"
"127820","Pikes Peak Community College","2011","Total full-time Instruction/research/public service, Non-tenured not on tenure track total","171","66","105","1","1","0","4","2","2","5","1","4","6","3","3","0","0","0","154","59","95","1","0","1","0","0","0","0","0","0","-2"
"127909","Red Rocks Community College","2011","Total full-time Instruction/research/public service, Non-tenured not on tenure track, Instructors","88","33","55","2","0","2","1","0","1","0","0","0","2","1","1","0","0","0","82","32","50","0","0","0","1","0","1","0","0","0","-2"
"127909","Red Rocks Community College","2011","Total full-time Instruction/research/public service, Non-tenured not on tenure track total","88","33","55","2","0","2","1","0","1","0","0","0","2","1","1","0","0","0","82","32","50","0","0","0","1","0","1","0","0","0","-2"
"127918","Regis University","2011","Total full-time Instruction/research/public service, Tenured, Professors","17","10","7","0","0","0","1","1","0","0","0","0","1","0","1","0","0","0","15","9","6","0","0","0","0","0","0","0","0","0","-2"
"127918","Regis University","2011","Total full-time Instruction/research/public service, Tenured, Associate professors","46","23","23","0","0","0","0","0","0","0","0","0","5","3","2","0","0","0","41","20","21","0","0","0","0","0","0","0","0","0","-2"
"127918","Regis University","2011","Total full-time Instruction/research/public service, Tenured, Assistant professors","2","1","1","0","0","0","0","0","0","0","0","0","0","0","0","0","0","0","2","1","1","0","0","0","0","0","0","0","0","0","-2"
"127918","Regis University","2011","Total full-time Instruction/research/public service, Tenured total","65","34","31","0","0","0","1","1","0","0","0","0","6","3","3","0","0","0","58","30","28","0","0","0","0","0","0","0","0","0","-2"
"127918","Regis University","2011","Total full-time Instruction/research/public service, Non-tenured on tenure track, Professors","1","1","0","0","0","0","0","0","0","0","0","0","0","0","0","0","0","0","1","1","0","0","0","0","0","0","0","0","0","0","-2"
"127918","Regis University","2011","Total full-time Instruction/research/public service, Non-tenured on tenure track, Associate professors","4","0","4","0","0","0","0","0","0","0","0","0","0","0","0","0","0","0","4","0","4","0","0","0","0","0","0","0","0","0","-2"
"127918","Regis University","2011","Total full-time Instruction/research/public service, Non-tenured on tenure track, Assistant professors","32","15","17","0","0","0","3","0","3","2","1","1","3","0","3","0","0","0","23","13","10","0","0","0","1","1","0","0","0","0","-2"
"127918","Regis University","2011","Total full-time Instruction/research/public service, Non-tenured on tenure track, Instructors","6","2","4","0","0","0","0","0","0","0","0","0","0","0","0","0","0","0","6","2","4","0","0","0","0","0","0","0","0","0","-2"
"127918","Regis University","2011","Total full-time Instruction/research/public service, Non-tenured on tenure track, Lecturers","1","0","1","0","0","0","0","0","0","0","0","0","0","0","0","0","0","0","1","0","1","0","0","0","0","0","0","0","0","0","-2"
"127918","Regis University","2011","Total full-time Instruction/research/public service, Non-tenured on tenure track total","44","18","26","0","0","0","3","0","3","2","1","1","3","0","3","0","0","0","35","16","19","0","0","0","1","1","0","0","0","0","-2"
"127918","Regis University","2011","Total full-time Instruction/research/public service, Non-tenured not on tenure track, Professors","28","14","14","0","0","0","0","0","0","2","1","1","1","1","0","0","0","0","24","12","12","1","0","1","0","0","0","0","0","0","-2"
"127918","Regis University","2011","Total full-time Instruction/research/public service, Non-tenured not on tenure track, Associate professors","38","11","27","0","0","0","0","0","0","1","0","1","1","0","1","0","0","0","36","11","25","0","0","0","0","0","0","0","0","0","-2"
"127918","Regis University","2011","Total full-time Instruction/research/public servicey, Non-tenured not on tenure track, Assistant professors","77","29","48","0","0","0","1","0","1","2","2","0","0","0","0","0","0","0","74","27","47","0","0","0","0","0","0","0","0","0","-2"
"127918","Regis University","2011","Total full-time Instruction/research/public service, Non-tenured not on tenure track, Instructors","14","0","14","0","0","0","0","0","0","1","0","1","0","0","0","0","0","0","13","0","13","0","0","0","0","0","0","0","0","0","-2"
"127918","Regis University","2011","Total full-time Instruction/research/public service, Non-tenured not on tenure track, Lecturers","2","0","2","0","0","0","0","0","0","0","0","0","0","0","0","0","0","0","2","0","2","0","0","0","0","0","0","0","0","0","-2"
"127918","Regis University","2011","Total full-time Instruction/research/public service, Non-tenured not on tenure track total","159","54","105","0","0","0","1","0","1","6","3","3","2","1","1","0","0","0","149","50","99","1","0","1","0","0","0","0","0","0","-2"
"128391","Western Colorado University","2011","Total full-time Instruction/research/public service, Tenured, Professors","44","28","16","0","0","0","0","0","0","0","0","0","0","0","0","0","0","0","44","28","16","0","0","0","0","0","0","0","0","0","-2"
"128391","Western Colorado University","2011","Total full-time Instruction/research/public service, Tenured, Associate professors","12","7","5","0","0","0","1","0","1","0","0","0","0","0","0","0","0","0","8","6","2","0","0","0","1","0","1","2","1","1","-2"
"128391","Western Colorado University","2011","Total full-time Instruction/research/public service, Tenured total","56","35","21","0","0","0","1","0","1","0","0","0","0","0","0","0","0","0","52","34","18","0","0","0","1","0","1","2","1","1","-2"
"128391","Western Colorado University","2011","Total full-time Instruction/research/public service, Non-tenured on tenure track, Professors","2","1","1","0","0","0","0","0","0","0","0","0","0","0","0","0","0","0","2","1","1","0","0","0","0","0","0","0","0","0","-2"
"128391","Western Colorado University","2011","Total full-time Instruction/research/public service, Non-tenured on tenure track, Assistant professors","21","13","8","0","0","0","0","0","0","0","0","0","0","0","0","0","0","0","19","11","8","0","0","0","2","2","0","0","0","0","-2"
"128391","Western Colorado University","2011","Total full-time Instruction/research/public service, Non-tenured on tenure track total","23","14","9","0","0","0","0","0","0","0","0","0","0","0","0","0","0","0","21","12","9","0","0","0","2","2","0","0","0","0","-2"
"128391","Western Colorado University","2011","Total full-time Instruction/research/public service, Non-tenured not on tenure track, Lecturers","38","17","21","0","0","0","1","0","1","0","0","0","0","0","0","0","0","0","34","16","18","0","0","0","2","0","2","1","1","0","-2"
"128391","Western Colorado University","2011","Total full-time Instruction/research/public service, Non-tenured not on tenure track total","38","17","21","0","0","0","1","0","1","0","0","0","0","0","0","0","0","0","34","16","18","0","0","0","2","0","2","1","1","0","-2"
"128498","Albertus Magnus College","2011","Total full-time Instruction/research/public service, Tenured, Professors","8","4","4","0","0","0","0","0","0","0","0","0","0","0","0","0","0","0","8","4","4","0","0","0","0","0","0","0","0","0","-2"
"128498","Albertus Magnus College","2011","Total full-time Instruction/research/public service, Tenured, Associate professors","1","1","0","0","0","0","0","0","0","0","0","0","0","0","0","0","0","0","1","1","0","0","0","0","0","0","0","0","0","0","-2"
"128498","Albertus Magnus College","2011","Total full-time Instruction/research/public service, Tenured total","9","5","4","0","0","0","0","0","0","0","0","0","0","0","0","0","0","0","9","5","4","0","0","0","0","0","0","0","0","0","-2"
"128498","Albertus Magnus College","2011","Total full-time Instruction/research/public service, Non-tenured not on tenure track, Professors","4","3","1","0","0","0","0","0","0","0","0","0","0","0","0","0","0","0","4","3","1","0","0","0","0","0","0","0","0","0","-2"
"128498","Albertus Magnus College","2011","Total full-time Instruction/research/public service, Non-tenured not on tenure track, Associate professors","13","11","2","0","0","0","2","2","0","1","1","0","0","0","0","0","0","0","10","8","2","0","0","0","0","0","0","0","0","0","-2"
"128498","Albertus Magnus College","2011","Total full-time Instruction/research/public servicey, Non-tenured not on tenure track, Assistant professors","10","5","5","0","0","0","0","0","0","0","0","0","0","0","0","0","0","0","10","5","5","0","0","0","0","0","0","0","0","0","-2"
"128498","Albertus Magnus College","2011","Total full-time Instruction/research/public service, Non-tenured not on tenure track total","27","19","8","0","0","0","2","2","0","1","1","0","0","0","0","0","0","0","24","16","8","0","0","0","0","0","0","0","0","0","-2"
"128771","Central Connecticut State University","2011","Total full-time Instruction/research/public service, Tenured, Professors","181","112","69","2","2","0","13","7","6","11","7","4","13","9","4","0","0","0","139","86","53","3","1","2","0","0","0","0","0","0","-2"
"128771","Central Connecticut State University","2011","Total full-time Instruction/research/public service, Tenured, Associate professors","106","60","46","0","0","0","7","7","0","5","3","2","3","3","0","0","0","0","91","47","44","0","0","0","0","0","0","0","0","0","-2"
"128771","Central Connecticut State University","2011","Total full-time Instruction/research/public service, Tenured, Assistant professors","13","5","8","0","0","0","0","0","0","1","0","1","0","0","0","0","0","0","12","5","7","0","0","0","0","0","0","0","0","0","-2"
"128771","Central Connecticut State University","2011","Total full-time Instruction/research/public service, Tenured total","300","177","123","2","2","0","20","14","6","17","10","7","16","12","4","0","0","0","242","138","104","3","1","2","0","0","0","0","0","0","-2"
"128771","Central Connecticut State University","2011","Total full-time Instruction/research/public service, Non-tenured on tenure track, Professors","2","1","1","0","0","0","0","0","0","0","0","0","0","0","0","0","0","0","2","1","1","0","0","0","0","0","0","0","0","0","-2"
"128771","Central Connecticut State University","2011","Total full-time Instruction/research/public service, Non-tenured on tenure track, Associate professors","15","9","6","0","0","0","4","3","1","0","0","0","1","1","0","0","0","0","10","5","5","0","0","0","0","0","0","0","0","0","-2"
"128771","Central Connecticut State University","2011","Total full-time Instruction/research/public service, Non-tenured on tenure track, Assistant professors","60","31","29","0","0","0","3","3","0","4","3","1","2","0","2","0","0","0","45","22","23","1","1","0","0","0","0","5","2","3","-2"
"128771","Central Connecticut State University","2011","Total full-time Instruction/research/public service, Non-tenured on tenure track, Instructors","2","0","2","0","0","0","0","0","0","0","0","0","0","0","0","0","0","0","2","0","2","0","0","0","0","0","0","0","0","0","-2"
"128771","Central Connecticut State University","2011","Total full-time Instruction/research/public service, Non-tenured on tenure track total","79","41","38","0","0","0","7","6","1","4","3","1","3","1","2","0","0","0","59","28","31","1","1","0","0","0","0","5","2","3","-2"
"128771","Central Connecticut State University","2011","Total full-time Instruction/research/public service, Non-tenured not on tenure track, Professors","1","1","0","0","0","0","0","0","0","1","1","0","0","0","0","0","0","0","0","0","0","0","0","0","0","0","0","0","0","0","-2"
"128771","Central Connecticut State University","2011","Total full-time Instruction/research/public service, Non-tenured not on tenure track, Associate professors","2","2","0","0","0","0","0","0","0","0","0","0","0","0","0","0","0","0","2","2","0","0","0","0","0","0","0","0","0","0","-2"
"128771","Central Connecticut State University","2011","Total full-time Instruction/research/public servicey, Non-tenured not on tenure track, Assistant professors","38","25","13","0","0","0","1","1","0","3","1","2","0","0","0","0","0","0","29","18","11","0","0","0","1","1","0","4","4","0","-2"
"128771","Central Connecticut State University","2011","Total full-time Instruction/research/public service, Non-tenured not on tenure track, Instructors","20","11","9","0","0","0","0","0","0","0","0","0","1","0","1","0","0","0","18","10","8","0","0","0","0","0","0","1","1","0","-2"
"128771","Central Connecticut State University","2011","Total full-time Instruction/research/public service, Non-tenured not on tenure track total","61","39","22","0","0","0","1","1","0","4","2","2","1","0","1","0","0","0","49","30","19","0","0","0","1","1","0","5","5","0","-2"
"129154","Goodwin University","2011","Total full-time Instruction/research/public service, Non-tenured not on tenure track, Associate professors","26","8","18","0","0","0","2","0","2","0","0","0","1","0","1","0","0","0","22","8","14","1","0","1","0","0","0","0","0","0","-2"
"129154","Goodwin University","2011","Total full-time Instruction/research/public servicey, Non-tenured not on tenure track, Assistant professors","24","10","14","0","0","0","1","0","1","2","0","2","1","1","0","0","0","0","20","9","11","0","0","0","0","0","0","0","0","0","-2"
"129154","Goodwin University","2011","Total full-time Instruction/research/public service, Non-tenured not on tenure track, Instructors","3","0","3","0","0","0","0","0","0","0","0","0","1","0","1","0","0","0","2","0","2","0","0","0","0","0","0","0","0","0","-2"
"129154","Goodwin University","2011","Total full-time Instruction/research/public service, Non-tenured not on tenure track, No academic rank","4","1","3","0","0","0","0","0","0","0","0","0","0","0","0","0","0","0","4","1","3","0","0","0","0","0","0","0","0","0","-2"
"129154","Goodwin University","2011","Total full-time Instruction/research/public service, Non-tenured not on tenure track total","57","19","38","0","0","0","3","0","3","2","0","2","3","1","2","0","0","0","48","18","30","1","0","1","0","0","0","0","0","0","-2"
"129774","Mitchell College","2011","Total full-time Instruction/research/public service, Tenured, Professors","2","1","1","0","0","0","0","0","0","0","0","0","0","0","0","0","0","0","2","1","1","0","0","0","0","0","0","0","0","0","-2"
"129774","Mitchell College","2011","Total full-time Instruction/research/public service, Tenured, Associate professors","3","1","2","0","0","0","0","0","0","0","0","0","0","0","0","0","0","0","3","1","2","0","0","0","0","0","0","0","0","0","-2"
"129774","Mitchell College","2011","Total full-time Instruction/research/public service, Tenured, Assistant professors","2","1","1","0","0","0","0","0","0","0","0","0","0","0","0","0","0","0","2","1","1","0","0","0","0","0","0","0","0","0","-2"
"129774","Mitchell College","2011","Total full-time Instruction/research/public service, Tenured total","7","3","4","0","0","0","0","0","0","0","0","0","0","0","0","0","0","0","7","3","4","0","0","0","0","0","0","0","0","0","-2"
"129774","Mitchell College","2011","Total full-time Instruction/research/public service, Non-tenured not on tenure track, Professors","2","0","2","0","0","0","0","0","0","0","0","0","0","0","0","0","0","0","2","0","2","0","0","0","0","0","0","0","0","0","-2"
"129774","Mitchell College","2011","Total full-time Instruction/research/public service, Non-tenured not on tenure track, Associate professors","8","5","3","0","0","0","0","0","0","1","0","1","0","0","0","0","0","0","7","5","2","0","0","0","0","0","0","0","0","0","-2"
"129774","Mitchell College","2011","Total full-time Instruction/research/public servicey, Non-tenured not on tenure track, Assistant professors","19","10","9","0","0","0","0","0","0","1","1","0","1","0","1","0","0","0","17","9","8","0","0","0","0","0","0","0","0","0","-2"
"129774","Mitchell College","2011","Total full-time Instruction/research/public service, Non-tenured not on tenure track total","29","15","14","0","0","0","0","0","0","2","1","1","1","0","1","0","0","0","26","14","12","0","0","0","0","0","0","0","0","0","-2"
"132657","Lynn University","2011","Total full-time Instruction/research/public service, Non-tenured not on tenure track, Professors","20","14","6","1","0","1","0","0","0","0","0","0","0","0","0","0","0","0","17","13","4","0","0","0","2","1","1","0","0","0","-2"
"132657","Lynn University","2011","Total full-time Instruction/research/public service, Non-tenured not on tenure track, Associate professors","24","10","14","0","0","0","0","0","0","0","0","0","2","1","1","0","0","0","20","8","12","0","0","0","2","1","1","0","0","0","-2"
"132657","Lynn University","2011","Total full-time Instruction/research/public servicey, Non-tenured not on tenure track, Assistant professors","31","19","12","1","1","0","1","1","0","1","0","1","1","0","1","0","0","0","25","16","9","0","0","0","1","0","1","1","1","0","-2"
"132657","Lynn University","2011","Total full-time Instruction/research/public service, Non-tenured not on tenure track, Instructors","14","11","3","0","0","0","0","0","0","0","0","0","1","1","0","0","0","0","10","8","2","0","0","0","2","2","0","1","0","1","-2"
"132657","Lynn University","2011","Total full-time Instruction/research/public service, Non-tenured not on tenure track total","89","54","35","2","1","1","1","1","0","1","0","1","4","2","2","0","0","0","72","45","27","0","0","0","7","4","3","2","1","1","-2"
"132693","Eastern Florida State College","2011","Total full-time Instruction/research/public service, Tenured, Professors","56","30","26","0","0","0","6","3","3","2","1","1","1","1","0","0","0","0","47","25","22","0","0","0","0","0","0","0","0","0","-2"
"132693","Eastern Florida State College","2011","Total full-time Instruction/research/public service, Tenured, Associate professors","52","21","31","0","0","0","2","1","1","5","2","3","1","0","1","0","0","0","44","18","26","0","0","0","0","0","0","0","0","0","-2"
"132693","Eastern Florida State College","2011","Total full-time Instruction/research/public service, Tenured, Assistant professors","65","22","43","0","0","0","2","1","1","3","0","3","2","0","2","0","0","0","58","21","37","0","0","0","0","0","0","0","0","0","-2"
"132693","Eastern Florida State College","2011","Total full-time Instruction/research/public service, Tenured, Instructors","19","4","15","0","0","0","0","0","0","0","0","0","0","0","0","0","0","0","18","4","14","0","0","0","1","0","1","0","0","0","-2"
"132693","Eastern Florida State College","2011","Total full-time Instruction/research/public service, Tenured total","192","77","115","0","0","0","10","5","5","10","3","7","4","1","3","0","0","0","167","68","99","0","0","0","1","0","1","0","0","0","-2"
"132693","Eastern Florida State College","2011","Total full-time Instruction/research/public service, Non-tenured on tenure track, Assistant professors","8","3","5","0","0","0","0","0","0","1","1","0","0","0","0","0","0","0","7","2","5","0","0","0","0","0","0","0","0","0","-2"
"132693","Eastern Florida State College","2011","Total full-time Instruction/research/public service, Non-tenured on tenure track, Instructors","44","22","22","0","0","0","0","0","0","6","3","3","0","0","0","0","0","0","37","19","18","0","0","0","0","0","0","1","0","1","-2"
"132693","Eastern Florida State College","2011","Total full-time Instruction/research/public service, Non-tenured on tenure track total","52","25","27","0","0","0","0","0","0","7","4","3","0","0","0","0","0","0","44","21","23","0","0","0","0","0","0","1","0","1","-2"
"132693","Eastern Florida State College","2011","Total full-time Instruction/research/public service, Non-tenured not on tenure track, Instructors","10","3","7","0","0","0","0","0","0","1","0","1","0","0","0","0","0","0","9","3","6","0","0","0","0","0","0","0","0","0","-2"
"132693","Eastern Florida State College","2011","Total full-time Instruction/research/public service, Non-tenured not on tenure track total","10","3","7","0","0","0","0","0","0","1","0","1","0","0","0","0","0","0","9","3","6","0","0","0","0","0","0","0","0","0","-2"
"132879","Johnson University Florida","2011","Total full-time Instruction/research/public service, Non-tenured not on tenure track, Professors","4","2","2","0","0","0","1","0","1","0","0","0","0","0","0","0","0","0","3","2","1","0","0","0","0","0","0","0","0","0","-2"
"132879","Johnson University Florida","2011","Total full-time Instruction/research/public service, Non-tenured not on tenure track, Associate professors","8","7","1","0","0","0","0","0","0","0","0","0","0","0","0","0","0","0","8","7","1","0","0","0","0","0","0","0","0","0","-2"
"132879","Johnson University Florida","2011","Total full-time Instruction/research/public service, Non-tenured not on tenure track total","12","9","3","0","0","0","1","0","1","0","0","0","0","0","0","0","0","0","11","9","2","0","0","0","0","0","0","0","0","0","-2"
"133386","Daytona State College","2011","Total full-time Instruction/research/public service, Tenured, Professors","68","36","32","0","0","0","3","2","1","5","2","3","2","1","1","0","0","0","58","31","27","0","0","0","0","0","0","0","0","0","-2"
"133386","Daytona State College","2011","Total full-time Instruction/research/public service, Tenured, Associate professors","95","51","44","1","0","1","4","3","1","8","6","2","3","3","0","0","0","0","77","38","39","0","0","0","1","0","1","1","1","0","-2"
"133386","Daytona State College","2011","Total full-time Instruction/research/public service, Tenured, Assistant professors","33","20","13","0","0","0","0","0","0","2","2","0","2","2","0","0","0","0","28","15","13","0","0","0","1","1","0","0","0","0","-2"
"133386","Daytona State College","2011","Total full-time Instruction/research/public service, Tenured, Instructors","39","18","21","0","0","0","1","1","0","6","1","5","2","1","1","0","0","0","30","15","15","0","0","0","0","0","0","0","0","0","-2"
"133386","Daytona State College","2011","Total full-time Instruction/research/public service, Tenured total","235","125","110","1","0","1","8","6","2","21","11","10","9","7","2","0","0","0","193","99","94","0","0","0","2","1","1","1","1","0","-2"
"133386","Daytona State College","2011","Total full-time Instruction/research/public service, Non-tenured on tenure track, Professors","1","0","1","0","0","0","0","0","0","0","0","0","0","0","0","0","0","0","1","0","1","0","0","0","0","0","0","0","0","0","-2"
"133386","Daytona State College","2011","Total full-time Instruction/research/public service, Non-tenured on tenure track, Associate professors","18","8","10","0","0","0","1","1","0","2","0","2","1","0","1","0","0","0","13","6","7","0","0","0","0","0","0","1","1","0","-2"
"133386","Daytona State College","2011","Total full-time Instruction/research/public service, Non-tenured on tenure track, Assistant professors","49","22","27","0","0","0","1","0","1","1","0","1","2","1","1","0","0","0","36","16","20","0","0","0","6","3","3","3","2","1","-2"
"133386","Daytona State College","2011","Total full-time Instruction/research/public service, Non-tenured on tenure track, Instructors","14","8","6","0","0","0","0","0","0","1","0","1","1","1","0","0","0","0","12","7","5","0","0","0","0","0","0","0","0","0","-2"
"133386","Daytona State College","2011","Total full-time Instruction/research/public service, Non-tenured on tenure track total","82","38","44","0","0","0","2","1","1","4","0","4","4","2","2","0","0","0","62","29","33","0","0","0","6","3","3","4","3","1","-2"
"133386","Daytona State College","2011","Total full-time Instruction/research/public service, Non-tenured not on tenure track, Instructors","1","0","1","0","0","0","0","0","0","0","0","0","0","0","0","0","0","0","1","0","1","0","0","0","0","0","0","0","0","0","-2"
"133386","Daytona State College","2011","Total full-time Instruction/research/public service, Non-tenured not on tenure track total","1","0","1","0","0","0","0","0","0","0","0","0","0","0","0","0","0","0","1","0","1","0","0","0","0","0","0","0","0","0","-2"
"134130","University of Florida","2011","Total full-time Instruction/research/public service, Tenured, Professors","1009","823","186","0","0","0","94","82","12","15","8","7","31","26","5","0","0","0","860","699","161","6","5","1","1","1","0","2","2","0","-2"
"134130","University of Florida","2011","Total full-time Instruction/research/public service, Tenured, Associate professors","677","459","218","0","0","0","77","60","17","32","15","17","46","34","12","0","0","0","508","339","169","5","4","1","4","3","1","5","4","1","-2"
"134130","University of Florida","2011","Total full-time Instruction/research/public service, Tenured, Assistant professors","8","6","2","0","0","0","0","0","0","0","0","0","0","0","0","0","0","0","8","6","2","0","0","0","0","0","0","0","0","0","-2"
"134130","University of Florida","2011","Total full-time Instruction/research/public service, Tenured, Lecturers","1","1","0","0","0","0","0","0","0","0","0","0","0","0","0","0","0","0","1","1","0","0","0","0","0","0","0","0","0","0","-2"
"134130","University of Florida","2011","Total full-time Instruction/research/public service, Tenured, No academic rank","155","58","97","0","0","0","1","0","1","14","5","9","6","3","3","0","0","0","134","50","84","0","0","0","0","0","0","0","0","0","-2"
"134130","University of Florida","2011","Total full-time Instruction/research/public service, Tenured total","1850","1347","503","0","0","0","172","142","30","61","28","33","83","63","20","0","0","0","1511","1095","416","11","9","2","5","4","1","7","6","1","-2"
"134130","University of Florida","2011","Total full-time Instruction/research/public service, Non-tenured on tenure track, Professors","26","20","6","0","0","0","5","5","0","1","0","1","1","1","0","0","0","0","17","13","4","1","0","1","0","0","0","1","1","0","-2"
"134130","University of Florida","2011","Total full-time Instruction/research/public service, Non-tenured on tenure track, Associate professors","65","42","23","0","0","0","12","8","4","3","2","1","7","5","2","0","0","0","39","23","16","0","0","0","0","0","0","4","4","0","-2"
"134130","University of Florida","2011","Total full-time Instruction/research/public service, Non-tenured on tenure track, Assistant professors","450","289","161","1","1","0","68","44","24","20","14","6","33","16","17","1","1","0","267","172","95","6","5","1","1","1","0","53","35","18","-2"
"134130","University of Florida","2011","Total full-time Instruction/research/public service, Non-tenured on tenure track, Lecturers","2","1","1","0","0","0","0","0","0","0","0","0","0","0","0","0","0","0","2","1","1","0","0","0","0","0","0","0","0","0","-2"
"134130","University of Florida","2011","Total full-time Instruction/research/public service, Non-tenured on tenure track, No academic rank","126","41","85","2","1","1","4","1","3","4","1","3","5","0","5","0","0","0","107","38","69","0","0","0","0","0","0","4","0","4","-2"
"134130","University of Florida","2011","Total full-time Instruction/research/public service, Non-tenured on tenure track total","669","393","276","3","2","1","89","58","31","28","17","11","46","22","24","1","1","0","432","247","185","7","5","2","1","1","0","62","40","22","-2"
"134130","University of Florida","2011","Total full-time Instruction/research/public service, Non-tenured not on tenure track, Professors","110","90","20","0","0","0","7","3","4","1","1","0","6","6","0","0","0","0","91","76","15","0","0","0","0","0","0","5","4","1","-2"
"134130","University of Florida","2011","Total full-time Instruction/research/public service, Non-tenured not on tenure track, Associate professors","241","153","88","1","1","0","34","25","9","3","3","0","23","15","8","1","0","1","172","104","68","1","1","0","2","1","1","4","3","1","-2"
"134130","University of Florida","2011","Total full-time Instruction/research/public servicey, Non-tenured not on tenure track, Assistant professors","920","507","413","1","1","0","190","117","73","41","15","26","65","28","37","1","1","0","512","272","240","8","4","4","2","1","1","100","68","32","-2"
"134130","University of Florida","2011","Total full-time Instruction/research/public service, Non-tenured not on tenure track, Lecturers","258","110","148","1","0","1","17","3","14","13","4","9","18","5","13","0","0","0","199","93","106","0","0","0","0","0","0","10","5","5","-2"
"134130","University of Florida","2011","Total full-time Instruction/research/public service, Non-tenured not on tenure track, No academic rank","237","111","126","0","0","0","12","5","7","10","6","4","10","3","7","0","0","0","180","81","99","2","1","1","3","1","2","20","14","6","-2"
"134130","University of Florida","2011","Total full-time Instruction/research/public service, Non-tenured not on tenure track total","1766","971","795","3","2","1","260","153","107","68","29","39","122","57","65","2","1","1","1154","626","528","11","6","5","7","3","4","139","94","45","-2"
"135188","Lake-Sumter State College","2011","Total full-time Instruction/research/public service, Tenured, Professors","9","4","5","0","0","0","0","0","0","1","0","1","0","0","0","0","0","0","7","4","3","0","0","0","0","0","0","1","0","1","-2"
"135188","Lake-Sumter State College","2011","Total full-time Instruction/research/public service, Tenured, Associate professors","11","4","7","0","0","0","0","0","0","0","0","0","0","0","0","0","0","0","11","4","7","0","0","0","0","0","0","0","0","0","-2"
"135188","Lake-Sumter State College","2011","Total full-time Instruction/research/public service, Tenured, Assistant professors","9","1","8","0","0","0","0","0","0","1","0","1","0","0","0","0","0","0","8","1","7","0","0","0","0","0","0","0","0","0","-2"
"135188","Lake-Sumter State College","2011","Total full-time Instruction/research/public service, Tenured, Instructors","8","0","8","0","0","0","0","0","0","0","0","0","0","0","0","0","0","0","8","0","8","0","0","0","0","0","0","0","0","0","-2"
"135188","Lake-Sumter State College","2011","Total full-time Instruction/research/public service, Tenured total","37","9","28","0","0","0","0","0","0","2","0","2","0","0","0","0","0","0","34","9","25","0","0","0","0","0","0","1","0","1","-2"
"135188","Lake-Sumter State College","2011","Total full-time Instruction/research/public service, Non-tenured on tenure track, Instructors","32","13","19","1","1","0","0","0","0","1","0","1","1","1","0","0","0","0","29","11","18","0","0","0","0","0","0","0","0","0","-2"
"135188","Lake-Sumter State College","2011","Total full-time Instruction/research/public service, Non-tenured on tenure track, No academic rank","4","0","4","0","0","0","0","0","0","0","0","0","0","0","0","0","0","0","4","0","4","0","0","0","0","0","0","0","0","0","-2"
"135188","Lake-Sumter State College","2011","Total full-time Instruction/research/public service, Non-tenured on tenure track total","36","13","23","1","1","0","0","0","0","1","0","1","1","1","0","0","0","0","33","11","22","0","0","0","0","0","0","0","0","0","-2"
"135188","Lake-Sumter State College","2011","Total full-time Instruction/research/public service, Non-tenured not on tenure track, Instructors","5","2","3","0","0","0","0","0","0","0","0","0","0","0","0","0","0","0","5","2","3","0","0","0","0","0","0","0","0","0","-2"
"135188","Lake-Sumter State College","2011","Total full-time Instruction/research/public service, Non-tenured not on tenure track, No academic rank","1","1","0","0","0","0","0","0","0","0","0","0","0","0","0","0","0","0","1","1","0","0","0","0","0","0","0","0","0","0","-2"
"135188","Lake-Sumter State College","2011","Total full-time Instruction/research/public service, Non-tenured not on tenure track total","6","3","3","0","0","0","0","0","0","0","0","0","0","0","0","0","0","0","6","3","3","0","0","0","0","0","0","0","0","0","-2"
"135391","State College of Florida-Manatee-Sarasota","2011","Total full-time Instruction/research/public service, Tenured, Professors","28","12","16","0","0","0","1","1","0","3","2","1","0","0","0","0","0","0","24","9","15","0","0","0","0","0","0","0","0","0","-2"
"135391","State College of Florida-Manatee-Sarasota","2011","Total full-time Instruction/research/public service, Tenured, Associate professors","27","8","19","0","0","0","1","1","0","0","0","0","2","0","2","0","0","0","23","7","16","0","0","0","1","0","1","0","0","0","-2"
"135391","State College of Florida-Manatee-Sarasota","2011","Total full-time Instruction/research/public service, Tenured, Assistant professors","30","11","19","0","0","0","0","0","0","2","2","0","3","1","2","0","0","0","25","8","17","0","0","0","0","0","0","0","0","0","-2"
"135391","State College of Florida-Manatee-Sarasota","2011","Total full-time Instruction/research/public service, Tenured, Instructors","9","4","5","0","0","0","0","0","0","1","0","1","0","0","0","0","0","0","8","4","4","0","0","0","0","0","0","0","0","0","-2"
"135391","State College of Florida-Manatee-Sarasota","2011","Total full-time Instruction/research/public service, Tenured total","94","35","59","0","0","0","2","2","0","6","4","2","5","1","4","0","0","0","80","28","52","0","0","0","1","0","1","0","0","0","-2"
"135391","State College of Florida-Manatee-Sarasota","2011","Total full-time Instruction/research/public service, Non-tenured on tenure track, Associate professors","2","1","1","0","0","0","0","0","0","1","1","0","0","0","0","0","0","0","1","0","1","0","0","0","0","0","0","0","0","0","-2"
"135391","State College of Florida-Manatee-Sarasota","2011","Total full-time Instruction/research/public service, Non-tenured on tenure track, Assistant professors","13","5","8","0","0","0","1","1","0","0","0","0","1","1","0","0","0","0","11","3","8","0","0","0","0","0","0","0","0","0","-2"
"135391","State College of Florida-Manatee-Sarasota","2011","Total full-time Instruction/research/public service, Non-tenured on tenure track, Instructors","17","5","12","0","0","0","0","0","0","0","0","0","0","0","0","0","0","0","16","4","12","0","0","0","0","0","0","1","1","0","-2"
"135391","State College of Florida-Manatee-Sarasota","2011","Total full-time Instruction/research/public service, Non-tenured on tenure track total","32","11","21","0","0","0","1","1","0","1","1","0","1","1","0","0","0","0","28","7","21","0","0","0","0","0","0","1","1","0","-2"
"135391","State College of Florida-Manatee-Sarasota","2011","Total full-time Instruction/research/public service, Non-tenured not on tenure track, No academic rank","13","2","11","0","0","0","0","0","0","1","0","1","0","0","0","0","0","0","11","2","9","0","0","0","1","0","1","0","0","0","-2"
"135391","State College of Florida-Manatee-Sarasota","2011","Total full-time Instruction/research/public service, Non-tenured not on tenure track total","13","2","11","0","0","0","0","0","0","1","0","1","0","0","0","0","0","0","11","2","9","0","0","0","1","0","1","0","0","0","-2"
"136330","Palm Beach Atlantic University","2011","Total full-time Instruction/research/public service, Non-tenured not on tenure track, Professors","33","26","7","0","0","0","1","1","0","1","1","0","0","0","0","0","0","0","29","23","6","0","0","0","2","1","1","0","0","0","-2"
"136330","Palm Beach Atlantic University","2011","Total full-time Instruction/research/public service, Non-tenured not on tenure track, Associate professors","57","32","25","0","0","0","2","1","1","7","1","6","3","0","3","0","0","0","44","30","14","0","0","0","0","0","0","1","0","1","-2"
"136330","Palm Beach Atlantic University","2011","Total full-time Instruction/research/public servicey, Non-tenured not on tenure track, Assistant professors","64","25","39","0","0","0","5","0","5","2","0","2","1","1","0","0","0","0","51","23","28","0","0","0","2","0","2","3","1","2","-2"
"136330","Palm Beach Atlantic University","2011","Total full-time Instruction/research/public service, Non-tenured not on tenure track, Instructors","2","1","1","0","0","0","0","0","0","0","0","0","0","0","0","0","0","0","2","1","1","0","0","0","0","0","0","0","0","0","-2"
"136330","Palm Beach Atlantic University","2011","Total full-time Instruction/research/public service, Non-tenured not on tenure track total","156","84","72","0","0","0","8","2","6","10","2","8","4","1","3","0","0","0","126","77","49","0","0","0","4","1","3","4","1","3","-2"
"136400","Pasco-Hernando State College","2011","Total full-time Instruction/research/public service, Tenured, Professors","29","7","22","0","0","0","0","0","0","1","0","1","1","1","0","0","0","0","26","6","20","0","0","0","1","0","1","0","0","0","-2"
"136400","Pasco-Hernando State College","2011","Total full-time Instruction/research/public service, Tenured, Associate professors","19","2","17","0","0","0","0","0","0","1","0","1","0","0","0","0","0","0","18","2","16","0","0","0","0","0","0","0","0","0","-2"
"136400","Pasco-Hernando State College","2011","Total full-time Instruction/research/public service, Tenured, Assistant professors","25","9","16","0","0","0","0","0","0","4","2","2","1","1","0","1","0","1","19","6","13","0","0","0","0","0","0","0","0","0","-2"
"136400","Pasco-Hernando State College","2011","Total full-time Instruction/research/public service, Tenured, Instructors","8","3","5","0","0","0","0","0","0","0","0","0","0","0","0","0","0","0","8","3","5","0","0","0","0","0","0","0","0","0","-2"
"136400","Pasco-Hernando State College","2011","Total full-time Instruction/research/public service, Tenured total","81","21","60","0","0","0","0","0","0","6","2","4","2","2","0","1","0","1","71","17","54","0","0","0","1","0","1","0","0","0","-2"
"136400","Pasco-Hernando State College","2011","Total full-time Instruction/research/public service, Non-tenured on tenure track, Assistant professors","3","2","1","0","0","0","0","0","0","0","0","0","0","0","0","0","0","0","3","2","1","0","0","0","0","0","0","0","0","0","-2"
"136400","Pasco-Hernando State College","2011","Total full-time Instruction/research/public service, Non-tenured on tenure track, Instructors","28","10","18","0","0","0","0","0","0","1","1","0","2","1","1","0","0","0","24","7","17","0","0","0","1","1","0","0","0","0","-2"
"136400","Pasco-Hernando State College","2011","Total full-time Instruction/research/public service, Non-tenured on tenure track total","31","12","19","0","0","0","0","0","0","1","1","0","2","1","1","0","0","0","27","9","18","0","0","0","1","1","0","0","0","0","-2"
"136400","Pasco-Hernando State College","2011","Total full-time Instruction/research/public service, Non-tenured not on tenure track, Instructors","2","0","2","0","0","0","0","0","0","0","0","0","0","0","0","0","0","0","2","0","2","0","0","0","0","0","0","0","0","0","-2"
"136400","Pasco-Hernando State College","2011","Total full-time Instruction/research/public service, Non-tenured not on tenure track, No academic rank","6","4","2","0","0","0","0","0","0","0","0","0","0","0","0","0","0","0","6","4","2","0","0","0","0","0","0","0","0","0","-2"
"136400","Pasco-Hernando State College","2011","Total full-time Instruction/research/public service, Non-tenured not on tenure track total","8","4","4","0","0","0","0","0","0","0","0","0","0","0","0","0","0","0","8","4","4","0","0","0","0","0","0","0","0","0","-2"
"136774","Ringling College of Art and Design","2011","Total full-time Instruction/research/public service, Non-tenured not on tenure track, No academic rank","92","64","28","0","0","0","1","1","0","1","1","0","3","2","1","0","0","0","83","59","24","0","0","0","3","1","2","1","0","1","-2"
"136774","Ringling College of Art and Design","2011","Total full-time Instruction/research/public service, Non-tenured not on tenure track total","92","64","28","0","0","0","1","1","0","1","1","0","3","2","1","0","0","0","83","59","24","0","0","0","3","1","2","1","0","1","-2"
"136950","Rollins College","2011","Total full-time Instruction/research/public service, Tenured, Professors","79","56","23","0","0","0","2","1","1","0","0","0","3","2","1","0","0","0","73","52","21","0","0","0","1","1","0","0","0","0","-2"
"136950","Rollins College","2011","Total full-time Instruction/research/public service, Tenured, Associate professors","50","27","23","0","0","0","3","1","2","3","3","0","2","1","1","0","0","0","42","22","20","0","0","0","0","0","0","0","0","0","-2"
"136950","Rollins College","2011","Total full-time Instruction/research/public service, Tenured total","129","83","46","0","0","0","5","2","3","3","3","0","5","3","2","0","0","0","115","74","41","0","0","0","1","1","0","0","0","0","-2"
"136950","Rollins College","2011","Total full-time Instruction/research/public service, Non-tenured on tenure track, Associate professors","1","1","0","0","0","0","0","0","0","0","0","0","1","1","0","0","0","0","0","0","0","0","0","0","0","0","0","0","0","0","-2"
"136950","Rollins College","2011","Total full-time Instruction/research/public service, Non-tenured on tenure track, Assistant professors","33","14","19","0","0","0","1","1","0","1","1","0","3","1","2","0","0","0","26","10","16","0","0","0","2","1","1","0","0","0","-2"
"136950","Rollins College","2011","Total full-time Instruction/research/public service, Non-tenured on tenure track total","34","15","19","0","0","0","1","1","0","1","1","0","4","2","2","0","0","0","26","10","16","0","0","0","2","1","1","0","0","0","-2"
"136950","Rollins College","2011","Total full-time Instruction/research/public service, Non-tenured not on tenure track, Associate professors","2","2","0","0","0","0","0","0","0","0","0","0","1","1","0","0","0","0","1","1","0","0","0","0","0","0","0","0","0","0","-2"
"136950","Rollins College","2011","Total full-time Instruction/research/public servicey, Non-tenured not on tenure track, Assistant professors","16","8","8","0","0","0","0","0","0","0","0","0","0","0","0","0","0","0","16","8","8","0","0","0","0","0","0","0","0","0","-2"
"136950","Rollins College","2011","Total full-time Instruction/research/public service, Non-tenured not on tenure track, Instructors","3","2","1","0","0","0","1","0","1","0","0","0","0","0","0","0","0","0","1","1","0","0","0","0","1","1","0","0","0","0","-2"
"136950","Rollins College","2011","Total full-time Instruction/research/public service, Non-tenured not on tenure track, Lecturers","26","12","14","0","0","0","2","2","0","0","0","0","3","1","2","0","0","0","21","9","12","0","0","0","0","0","0","0","0","0","-2"
"136950","Rollins College","2011","Total full-time Instruction/research/public service, Non-tenured not on tenure track total","47","24","23","0","0","0","3","2","1","0","0","0","4","2","2","0","0","0","39","19","20","0","0","0","1","1","0","0","0","0","-2"
"137032","Saint Leo University","2011","Total full-time Instruction/research/public service, Tenured, Professors","16","14","2","0","0","0","0","0","0","0","0","0","0","0","0","0","0","0","16","14","2","0","0","0","0","0","0","0","0","0","-2"
"137032","Saint Leo University","2011","Total full-time Instruction/research/public service, Tenured, Associate professors","22","15","7","1","0","1","0","0","0","0","0","0","0","0","0","0","0","0","21","15","6","0","0","0","0","0","0","0","0","0","-2"
"137032","Saint Leo University","2011","Total full-time Instruction/research/public service, Tenured, Assistant professors","4","3","1","0","0","0","0","0","0","1","1","0","0","0","0","0","0","0","3","2","1","0","0","0","0","0","0","0","0","0","-2"
"137032","Saint Leo University","2011","Total full-time Instruction/research/public service, Tenured total","42","32","10","1","0","1","0","0","0","1","1","0","0","0","0","0","0","0","40","31","9","0","0","0","0","0","0","0","0","0","-2"
"137032","Saint Leo University","2011","Total full-time Instruction/research/public service, Non-tenured on tenure track, Professors","1","0","1","0","0","0","0","0","0","0","0","0","0","0","0","0","0","0","1","0","1","0","0","0","0","0","0","0","0","0","-2"
"137032","Saint Leo University","2011","Total full-time Instruction/research/public service, Non-tenured on tenure track, Associate professors","16","7","9","0","0","0","0","0","0","2","1","1","4","3","1","0","0","0","9","2","7","1","1","0","0","0","0","0","0","0","-2"
"137032","Saint Leo University","2011","Total full-time Instruction/research/public service, Non-tenured on tenure track, Assistant professors","42","25","17","1","1","0","1","0","1","10","6","4","2","1","1","0","0","0","26","15","11","1","1","0","1","1","0","0","0","0","-2"
"137032","Saint Leo University","2011","Total full-time Instruction/research/public service, Non-tenured on tenure track total","59","32","27","1","1","0","1","0","1","12","7","5","6","4","2","0","0","0","36","17","19","2","2","0","1","1","0","0","0","0","-2"
"137032","Saint Leo University","2011","Total full-time Instruction/research/public service, Non-tenured not on tenure track, Professors","4","4","0","0","0","0","0","0","0","0","0","0","0","0","0","0","0","0","4","4","0","0","0","0","0","0","0","0","0","0","-2"
"137032","Saint Leo University","2011","Total full-time Instruction/research/public service, Non-tenured not on tenure track, Associate professors","9","6","3","0","0","0","0","0","0","0","0","0","1","1","0","0","0","0","8","5","3","0","0","0","0","0","0","0","0","0","-2"
"137032","Saint Leo University","2011","Total full-time Instruction/research/public servicey, Non-tenured not on tenure track, Assistant professors","17","13","4","0","0","0","0","0","0","2","2","0","1","0","1","0","0","0","13","11","2","0","0","0","1","0","1","0","0","0","-2"
"137032","Saint Leo University","2011","Total full-time Instruction/research/public service, Non-tenured not on tenure track, Instructors","18","6","12","0","0","0","0","0","0","0","0","0","1","1","0","0","0","0","16","5","11","0","0","0","1","0","1","0","0","0","-2"
"137032","Saint Leo University","2011","Total full-time Instruction/research/public service, Non-tenured not on tenure track total","48","29","19","0","0","0","0","0","0","2","2","0","3","2","1","0","0","0","41","25","16","0","0","0","2","0","2","0","0","0","-2"
"137078","St Petersburg College","2011","Total full-time Instruction/research/public service, Tenured, No academic rank","211","100","111","1","1","0","5","3","2","18","10","8","10","3","7","0","0","0","169","77","92","7","5","2","1","1","0","0","0","0","-2"
"137078","St Petersburg College","2011","Total full-time Instruction/research/public service, Tenured total","211","100","111","1","1","0","5","3","2","18","10","8","10","3","7","0","0","0","169","77","92","7","5","2","1","1","0","0","0","0","-2"
"137078","St Petersburg College","2011","Total full-time Instruction/research/public service, Non-tenured on tenure track, No academic rank","119","47","72","0","0","0","1","1","0","11","3","8","9","1","8","0","0","0","96","42","54","2","0","2","0","0","0","0","0","0","-2"
"137078","St Petersburg College","2011","Total full-time Instruction/research/public service, Non-tenured on tenure track total","119","47","72","0","0","0","1","1","0","11","3","8","9","1","8","0","0","0","96","42","54","2","0","2","0","0","0","0","0","0","-2"
"137078","St Petersburg College","2011","Total full-time Instruction/research/public service, Non-tenured not on tenure track, No academic rank","2","0","2","0","0","0","0","0","0","0","0","0","0","0","0","0","0","0","1","0","1","0","0","0","1","0","1","0","0","0","-2"
"137078","St Petersburg College","2011","Total full-time Instruction/research/public service, Non-tenured not on tenure track total","2","0","2","0","0","0","0","0","0","0","0","0","0","0","0","0","0","0","1","0","1","0","0","0","1","0","1","0","0","0","-2"
"137096","Santa Fe College","2011","Total full-time Instruction/research/public service, Tenured, No academic rank","203","88","115","1","0","1","4","2","2","12","5","7","10","2","8","0","0","0","174","77","97","0","0","0","2","2","0","0","0","0","-2"
"137096","Santa Fe College","2011","Total full-time Instruction/research/public service, Tenured total","203","88","115","1","0","1","4","2","2","12","5","7","10","2","8","0","0","0","174","77","97","0","0","0","2","2","0","0","0","0","-2"
"137096","Santa Fe College","2011","Total full-time Instruction/research/public service, Non-tenured on tenure track, No academic rank","27","13","14","0","0","0","1","1","0","3","2","1","1","1","0","0","0","0","22","9","13","0","0","0","0","0","0","0","0","0","-2"
"137096","Santa Fe College","2011","Total full-time Instruction/research/public service, Non-tenured on tenure track total","27","13","14","0","0","0","1","1","0","3","2","1","1","1","0","0","0","0","22","9","13","0","0","0","0","0","0","0","0","0","-2"
"137546","Stetson University","2011","Total full-time Instruction/research/public service, Tenured, Professors","103","61","42","0","0","0","1","0","1","5","2","3","2","0","2","0","0","0","91","55","36","2","2","0","1","1","0","1","1","0","-2"
"137546","Stetson University","2011","Total full-time Instruction/research/public service, Tenured, Associate professors","63","37","26","0","0","0","1","0","1","5","2","3","3","3","0","0","0","0","47","27","20","3","2","1","3","2","1","1","1","0","-2"
"137546","Stetson University","2011","Total full-time Instruction/research/public service, Tenured total","166","98","68","0","0","0","2","0","2","10","4","6","5","3","2","0","0","0","138","82","56","5","4","1","4","3","1","2","2","0","-2"
"137546","Stetson University","2011","Total full-time Instruction/research/public service, Non-tenured on tenure track, Professors","1","1","0","0","0","0","0","0","0","0","0","0","0","0","0","0","0","0","1","1","0","0","0","0","0","0","0","0","0","0","-2"
"137546","Stetson University","2011","Total full-time Instruction/research/public service, Non-tenured on tenure track, Associate professors","6","4","2","0","0","0","0","0","0","0","0","0","0","0","0","0","0","0","6","4","2","0","0","0","0","0","0","0","0","0","-2"
"137546","Stetson University","2011","Total full-time Instruction/research/public service, Non-tenured on tenure track, Assistant professors","28","16","12","0","0","0","1","1","0","2","0","2","3","1","2","0","0","0","19","12","7","1","0","1","0","0","0","2","2","0","-2"
"137546","Stetson University","2011","Total full-time Instruction/research/public service, Non-tenured on tenure track total","35","21","14","0","0","0","1","1","0","2","0","2","3","1","2","0","0","0","26","17","9","1","0","1","0","0","0","2","2","0","-2"
"137546","Stetson University","2011","Total full-time Instruction/research/public service, Non-tenured not on tenure track, No academic rank","32","18","14","0","0","0","2","2","0","0","0","0","2","0","2","0","0","0","27","15","12","0","0","0","0","0","0","1","1","0","-2"
"137546","Stetson University","2011","Total full-time Instruction/research/public service, Non-tenured not on tenure track total","32","18","14","0","0","0","2","2","0","0","0","0","2","0","2","0","0","0","27","15","12","0","0","0","0","0","0","1","1","0","-2"
"137564","Southeastern University","2011","Total full-time Instruction/research/public service, Tenured, Professors","3","3","0","0","0","0","0","0","0","0","0","0","0","0","0","0","0","0","3","3","0","0","0","0","0","0","0","0","0","0","-2"
"137564","Southeastern University","2011","Total full-time Instruction/research/public service, Tenured, Associate professors","1","1","0","0","0","0","0","0","0","0","0","0","0","0","0","0","0","0","1","1","0","0","0","0","0","0","0","0","0","0","-2"
"137564","Southeastern University","2011","Total full-time Instruction/research/public service, Tenured total","4","4","0","0","0","0","0","0","0","0","0","0","0","0","0","0","0","0","4","4","0","0","0","0","0","0","0","0","0","0","-2"
"137564","Southeastern University","2011","Total full-time Instruction/research/public service, Non-tenured not on tenure track, Professors","18","15","3","0","0","0","0","0","0","0","0","0","1","0","1","0","0","0","17","15","2","0","0","0","0","0","0","0","0","0","-2"
"137564","Southeastern University","2011","Total full-time Instruction/research/public service, Non-tenured not on tenure track, Associate professors","32","22","10","0","0","0","2","0","2","4","3","1","0","0","0","0","0","0","25","18","7","1","1","0","0","0","0","0","0","0","-2"
"137564","Southeastern University","2011","Total full-time Instruction/research/public servicey, Non-tenured not on tenure track, Assistant professors","41","24","17","0","0","0","3","1","2","1","1","0","1","0","1","1","0","1","35","22","13","0","0","0","0","0","0","0","0","0","-2"
"137564","Southeastern University","2011","Total full-time Instruction/research/public service, Non-tenured not on tenure track total","91","61","30","0","0","0","5","1","4","5","4","1","2","0","2","1","0","1","77","55","22","1","1","0","0","0","0","0","0","0","-2"
"137962","Trinity College of Florida","2011","Total full-time Instruction/research/public service, Non-tenured not on tenure track, Professors","2","2","0","0","0","0","0","0","0","0","0","0","0","0","0","0","0","0","2","2","0","0","0","0","0","0","0","0","0","0","-2"
"137962","Trinity College of Florida","2011","Total full-time Instruction/research/public service, Non-tenured not on tenure track, Associate professors","2","2","0","0","0","0","0","0","0","0","0","0","0","0","0","0","0","0","2","2","0","0","0","0","0","0","0","0","0","0","-2"
"137962","Trinity College of Florida","2011","Total full-time Instruction/research/public servicey, Non-tenured not on tenure track, Assistant professors","4","2","2","0","0","0","0","0","0","0","0","0","0","0","0","0","0","0","4","2","2","0","0","0","0","0","0","0","0","0","-2"
"137962","Trinity College of Florida","2011","Total full-time Instruction/research/public service, Non-tenured not on tenure track total","8","6","2","0","0","0","0","0","0","0","0","0","0","0","0","0","0","0","8","6","2","0","0","0","0","0","0","0","0","0","-2"
"139700","Georgia Highlands College","2011","Total full-time Instruction/research/public service, Tenured, Professors","15","11","4","0","0","0","1","1","0","0","0","0","0","0","0","0","0","0","14","10","4","0","0","0","0","0","0","0","0","0","-2"
"139700","Georgia Highlands College","2011","Total full-time Instruction/research/public service, Tenured, Associate professors","28","10","18","0","0","0","0","0","0","1","0","1","1","0","1","0","0","0","26","10","16","0","0","0","0","0","0","0","0","0","-2"
"139700","Georgia Highlands College","2011","Total full-time Instruction/research/public service, Tenured, Assistant professors","6","2","4","0","0","0","0","0","0","0","0","0","0","0","0","0","0","0","6","2","4","0","0","0","0","0","0","0","0","0","-2"
"139700","Georgia Highlands College","2011","Total full-time Instruction/research/public service, Tenured total","49","23","26","0","0","0","1","1","0","1","0","1","1","0","1","0","0","0","46","22","24","0","0","0","0","0","0","0","0","0","-2"
"139700","Georgia Highlands College","2011","Total full-time Instruction/research/public service, Non-tenured on tenure track, Associate professors","2","1","1","0","0","0","0","0","0","1","0","1","0","0","0","0","0","0","1","1","0","0","0","0","0","0","0","0","0","0","-2"
"139700","Georgia Highlands College","2011","Total full-time Instruction/research/public service, Non-tenured on tenure track, Assistant professors","30","13","17","0","0","0","0","0","0","0","0","0","0","0","0","0","0","0","30","13","17","0","0","0","0","0","0","0","0","0","-2"
"139700","Georgia Highlands College","2011","Total full-time Instruction/research/public service, Non-tenured on tenure track, Instructors","35","12","23","0","0","0","1","1","0","2","1","1","0","0","0","0","0","0","32","10","22","0","0","0","0","0","0","0","0","0","-2"
"139700","Georgia Highlands College","2011","Total full-time Instruction/research/public service, Non-tenured on tenure track total","67","26","41","0","0","0","1","1","0","3","1","2","0","0","0","0","0","0","63","24","39","0","0","0","0","0","0","0","0","0","-2"
"139700","Georgia Highlands College","2011","Total full-time Instruction/research/public service, Non-tenured not on tenure track, Lecturers","18","5","13","0","0","0","1","1","0","2","1","1","1","0","1","0","0","0","14","3","11","0","0","0","0","0","0","0","0","0","-2"
"139700","Georgia Highlands College","2011","Total full-time Instruction/research/public service, Non-tenured not on tenure track total","18","5","13","0","0","0","1","1","0","2","1","1","1","0","1","0","0","0","14","3","11","0","0","0","0","0","0","0","0","0","-2"
"140252","Life University","2011","Total full-time Instruction/research/public service, Tenured, Professors","9","8","1","0","0","0","1","0","1","1","1","0","0","0","0","0","0","0","7","7","0","0","0","0","0","0","0","0","0","0","-2"
"140252","Life University","2011","Total full-time Instruction/research/public service, Tenured, Associate professors","3","1","2","0","0","0","1","0","1","0","0","0","0","0","0","0","0","0","2","1","1","0","0","0","0","0","0","0","0","0","-2"
"140252","Life University","2011","Total full-time Instruction/research/public service, Tenured, Assistant professors","2","0","2","0","0","0","0","0","0","0","0","0","0","0","0","0","0","0","2","0","2","0","0","0","0","0","0","0","0","0","-2"
"140252","Life University","2011","Total full-time Instruction/research/public service, Tenured total","14","9","5","0","0","0","2","0","2","1","1","0","0","0","0","0","0","0","11","8","3","0","0","0","0","0","0","0","0","0","-2"
"140252","Life University","2011","Total full-time Instruction/research/public service, Non-tenured not on tenure track, Professors","19","11","8","0","0","0","3","2","1","0","0","0","0","0","0","0","0","0","16","9","7","0","0","0","0","0","0","0","0","0","-2"
"140252","Life University","2011","Total full-time Instruction/research/public service, Non-tenured not on tenure track, Associate professors","25","20","5","0","0","0","2","1","1","0","0","0","0","0","0","0","0","0","23","19","4","0","0","0","0","0","0","0","0","0","-2"
"140252","Life University","2011","Total full-time Instruction/research/public servicey, Non-tenured not on tenure track, Assistant professors","56","26","30","0","0","0","5","4","1","11","3","8","4","2","2","0","0","0","36","17","19","0","0","0","0","0","0","0","0","0","-2"
"140252","Life University","2011","Total full-time Instruction/research/public service, Non-tenured not on tenure track, Instructors","6","3","3","0","0","0","1","0","1","1","1","0","0","0","0","0","0","0","4","2","2","0","0","0","0","0","0","0","0","0","-2"
"140252","Life University","2011","Total full-time Instruction/research/public service, Non-tenured not on tenure track, No academic rank","1","1","0","0","0","0","0","0","0","0","0","0","0","0","0","0","0","0","1","1","0","0","0","0","0","0","0","0","0","0","-2"
"140252","Life University","2011","Total full-time Instruction/research/public service, Non-tenured not on tenure track total","107","61","46","0","0","0","11","7","4","12","4","8","4","2","2","0","0","0","80","48","32","0","0","0","0","0","0","0","0","0","-2"
"141565","University of Hawaii at Hilo","2011","Total full-time Instruction/research/public service, Tenured, Professors","55","41","14","1","1","0","13","9","4","2","1","1","1","1","0","2","1","1","36","28","8","0","0","0","0","0","0","0","0","0","-2"
"141565","University of Hawaii at Hilo","2011","Total full-time Instruction/research/public service, Tenured, Associate professors","55","29","26","0","0","0","13","8","5","0","0","0","1","1","0","4","1","3","37","19","18","0","0","0","0","0","0","0","0","0","-2"
"141565","University of Hawaii at Hilo","2011","Total full-time Instruction/research/public service, Tenured, Assistant professors","2","2","0","0","0","0","0","0","0","0","0","0","0","0","0","1","1","0","0","0","0","0","0","0","0","0","0","1","1","0","-2"
"141565","University of Hawaii at Hilo","2011","Total full-time Instruction/research/public service, Tenured total","112","72","40","1","1","0","26","17","9","2","1","1","2","2","0","7","3","4","73","47","26","0","0","0","0","0","0","1","1","0","-2"
"141565","University of Hawaii at Hilo","2011","Total full-time Instruction/research/public service, Non-tenured on tenure track, Associate professors","6","2","4","0","0","0","3","0","3","0","0","0","0","0","0","0","0","0","3","2","1","0","0","0","0","0","0","0","0","0","-2"
"141565","University of Hawaii at Hilo","2011","Total full-time Instruction/research/public service, Non-tenured on tenure track, Assistant professors","75","39","36","0","0","0","19","8","11","0","0","0","2","2","0","6","1","5","42","24","18","0","0","0","0","0","0","6","4","2","-2"
"141565","University of Hawaii at Hilo","2011","Total full-time Instruction/research/public service, Non-tenured on tenure track total","81","41","40","0","0","0","22","8","14","0","0","0","2","2","0","6","1","5","45","26","19","0","0","0","0","0","0","6","4","2","-2"
"141565","University of Hawaii at Hilo","2011","Total full-time Instruction/research/public servicey, Non-tenured not on tenure track, Assistant professors","6","4","2","0","0","0","1","1","0","0","0","0","0","0","0","1","0","1","3","2","1","0","0","0","0","0","0","1","1","0","-2"
"141565","University of Hawaii at Hilo","2011","Total full-time Instruction/research/public service, Non-tenured not on tenure track, Instructors","25","9","16","0","0","0","0","0","0","0","0","0","0","0","0","1","0","1","23","8","15","1","1","0","0","0","0","0","0","0","-2"
"141565","University of Hawaii at Hilo","2011","Total full-time Instruction/research/public service, Non-tenured not on tenure track total","31","13","18","0","0","0","1","1","0","0","0","0","0","0","0","2","0","2","26","10","16","1","1","0","0","0","0","1","1","0","-2"
"141839","University of Hawaii Maui College","2011","Total full-time Instruction/research/public service, Tenured, Professors","12","4","8","0","0","0","3","1","2","0","0","0","0","0","0","0","0","0","9","3","6","0","0","0","0","0","0","0","0","0","-2"
"141839","University of Hawaii Maui College","2011","Total full-time Instruction/research/public service, Tenured, Associate professors","14","5","9","0","0","0","1","0","1","1","1","0","0","0","0","2","2","0","10","2","8","0","0","0","0","0","0","0","0","0","-2"
"141839","University of Hawaii Maui College","2011","Total full-time Instruction/research/public service, Tenured, Assistant professors","26","11","15","0","0","0","6","1","5","0","0","0","0","0","0","5","3","2","15","7","8","0","0","0","0","0","0","0","0","0","-2"
"141839","University of Hawaii Maui College","2011","Total full-time Instruction/research/public service, Tenured total","52","20","32","0","0","0","10","2","8","1","1","0","0","0","0","7","5","2","34","12","22","0","0","0","0","0","0","0","0","0","-2"
"141839","University of Hawaii Maui College","2011","Total full-time Instruction/research/public service, Non-tenured on tenure track, Associate professors","1","0","1","0","0","0","0","0","0","0","0","0","0","0","0","0","0","0","1","0","1","0","0","0","0","0","0","0","0","0","-2"
"141839","University of Hawaii Maui College","2011","Total full-time Instruction/research/public service, Non-tenured on tenure track, Assistant professors","4","3","1","0","0","0","1","1","0","0","0","0","0","0","0","0","0","0","3","2","1","0","0","0","0","0","0","0","0","0","-2"
"141839","University of Hawaii Maui College","2011","Total full-time Instruction/research/public service, Non-tenured on tenure track, Instructors","27","12","15","0","0","0","6","3","3","1","0","1","1","1","0","4","3","1","13","3","10","0","0","0","0","0","0","2","2","0","-2"
"141839","University of Hawaii Maui College","2011","Total full-time Instruction/research/public service, Non-tenured on tenure track total","32","15","17","0","0","0","7","4","3","1","0","1","1","1","0","4","3","1","17","5","12","0","0","0","0","0","0","2","2","0","-2"
"141839","University of Hawaii Maui College","2011","Total full-time Instruction/research/public servicey, Non-tenured not on tenure track, Assistant professors","2","2","0","0","0","0","1","1","0","0","0","0","0","0","0","1","1","0","0","0","0","0","0","0","0","0","0","0","0","0","-2"
"141839","University of Hawaii Maui College","2011","Total full-time Instruction/research/public service, Non-tenured not on tenure track, Instructors","15","7","8","0","0","0","1","0","1","0","0","0","1","0","1","2","1","1","11","6","5","0","0","0","0","0","0","0","0","0","-2"
"141839","University of Hawaii Maui College","2011","Total full-time Instruction/research/public service, Non-tenured not on tenure track total","17","9","8","0","0","0","2","1","1","0","0","0","1","0","1","3","2","1","11","6","5","0","0","0","0","0","0","0","0","0","-2"
"142559","College of Southern Idaho","2011","Total full-time Instruction/research/public service, Non-tenured not on tenure track, Professors","56","36","20","0","0","0","0","0","0","0","0","0","2","1","1","0","0","0","54","35","19","0","0","0","0","0","0","0","0","0","-2"
"142559","College of Southern Idaho","2011","Total full-time Instruction/research/public service, Non-tenured not on tenure track, Associate professors","39","17","22","0","0","0","0","0","0","0","0","0","0","0","0","0","0","0","38","17","21","1","0","1","0","0","0","0","0","0","-2"
"142559","College of Southern Idaho","2011","Total full-time Instruction/research/public servicey, Non-tenured not on tenure track, Assistant professors","35","17","18","0","0","0","1","0","1","0","0","0","1","0","1","0","0","0","33","17","16","0","0","0","0","0","0","0","0","0","-2"
"142559","College of Southern Idaho","2011","Total full-time Instruction/research/public service, Non-tenured not on tenure track, Instructors","40","15","25","1","0","1","0","0","0","0","0","0","1","1","0","0","0","0","38","14","24","0","0","0","0","0","0","0","0","0","-2"
"142559","College of Southern Idaho","2011","Total full-time Instruction/research/public service, Non-tenured not on tenure track total","170","85","85","1","0","1","1","0","1","0","0","0","4","2","2","0","0","0","163","83","80","1","0","1","0","0","0","0","0","0","-2"
"144281","Columbia College Chicago","2011","Total full-time Instruction/research/public service, Tenured, Professors","45","30","15","0","0","0","1","0","1","5","2","3","0","0","0","0","0","0","37","27","10","0","0","0","2","1","1","0","0","0","-2"
"144281","Columbia College Chicago","2011","Total full-time Instruction/research/public service, Tenured, Associate professors","167","90","77","0","0","0","1","1","0","22","8","14","9","7","2","0","0","0","135","74","61","0","0","0","0","0","0","0","0","0","-2"
"144281","Columbia College Chicago","2011","Total full-time Instruction/research/public service, Tenured, Assistant professors","1","0","1","0","0","0","0","0","0","0","0","0","0","0","0","0","0","0","1","0","1","0","0","0","0","0","0","0","0","0","-2"
"144281","Columbia College Chicago","2011","Total full-time Instruction/research/public service, Tenured, Lecturers","1","0","1","0","0","0","0","0","0","0","0","0","0","0","0","0","0","0","1","0","1","0","0","0","0","0","0","0","0","0","-2"
"144281","Columbia College Chicago","2011","Total full-time Instruction/research/public service, Tenured total","214","120","94","0","0","0","2","1","1","27","10","17","9","7","2","0","0","0","174","101","73","0","0","0","2","1","1","0","0","0","-2"
"144281","Columbia College Chicago","2011","Total full-time Instruction/research/public service, Non-tenured on tenure track, Professors","1","0","1","0","0","0","0","0","0","0","0","0","0","0","0","0","0","0","1","0","1","0","0","0","0","0","0","0","0","0","-2"
"144281","Columbia College Chicago","2011","Total full-time Instruction/research/public service, Non-tenured on tenure track, Assistant professors","90","45","45","0","0","0","6","3","3","6","3","3","3","1","2","0","0","0","66","35","31","0","0","0","9","3","6","0","0","0","-2"
"144281","Columbia College Chicago","2011","Total full-time Instruction/research/public service, Non-tenured on tenure track total","91","45","46","0","0","0","6","3","3","6","3","3","3","1","2","0","0","0","67","35","32","0","0","0","9","3","6","0","0","0","-2"
"144281","Columbia College Chicago","2011","Total full-time Instruction/research/public service, Non-tenured not on tenure track, Lecturers","66","31","35","0","0","0","2","1","1","3","1","2","2","0","2","0","0","0","55","28","27","0","0","0","4","1","3","0","0","0","-2"
"144281","Columbia College Chicago","2011","Total full-time Instruction/research/public service, Non-tenured not on tenure track total","66","31","35","0","0","0","2","1","1","3","1","2","2","0","2","0","0","0","55","28","27","0","0","0","4","1","3","0","0","0","-2"
"144740","DePaul University","2011","Total full-time Instruction/research/public service, Tenured, Professors","202","126","76","0","0","0","10","6","4","8","3","5","10","5","5","0","0","0","162","105","57","1","1","0","9","4","5","2","2","0","-2"
"144740","DePaul University","2011","Total full-time Instruction/research/public service, Tenured, Associate professors","367","204","163","0","0","0","20","10","10","32","18","14","16","7","9","0","0","0","248","139","109","2","1","1","16","7","9","33","22","11","-2"
"144740","DePaul University","2011","Total full-time Instruction/research/public service, Tenured, Assistant professors","5","5","0","0","0","0","0","0","0","1","1","0","0","0","0","0","0","0","3","3","0","0","0","0","1","1","0","0","0","0","-2"
"144740","DePaul University","2011","Total full-time Instruction/research/public service, Tenured total","574","335","239","0","0","0","30","16","14","41","22","19","26","12","14","0","0","0","413","247","166","3","2","1","26","12","14","35","24","11","-2"
"144740","DePaul University","2011","Total full-time Instruction/research/public service, Non-tenured on tenure track, Associate professors","9","5","4","0","0","0","1","1","0","1","0","1","0","0","0","0","0","0","5","3","2","0","0","0","2","1","1","0","0","0","-2"
"144740","DePaul University","2011","Total full-time Instruction/research/public service, Non-tenured on tenure track, Assistant professors","193","97","96","1","0","1","16","3","13","10","3","7","25","15","10","0","0","0","99","50","49","3","1","2","18","13","5","21","12","9","-2"
"144740","DePaul University","2011","Total full-time Instruction/research/public service, Non-tenured on tenure track total","202","102","100","1","0","1","17","4","13","11","3","8","25","15","10","0","0","0","104","53","51","3","1","2","20","14","6","21","12","9","-2"
"144740","DePaul University","2011","Total full-time Instruction/research/public service, Non-tenured not on tenure track, Professors","6","5","1","0","0","0","0","0","0","0","0","0","1","0","1","0","0","0","4","4","0","0","0","0","1","1","0","0","0","0","-2"
"144740","DePaul University","2011","Total full-time Instruction/research/public service, Non-tenured not on tenure track, Associate professors","7","5","2","0","0","0","0","0","0","0","0","0","0","0","0","0","0","0","4","3","1","0","0","0","3","2","1","0","0","0","-2"
"144740","DePaul University","2011","Total full-time Instruction/research/public servicey, Non-tenured not on tenure track, Assistant professors","66","35","31","1","1","0","1","0","1","4","0","4","8","4","4","0","0","0","35","20","15","1","1","0","10","6","4","6","3","3","-2"
"144740","DePaul University","2011","Total full-time Instruction/research/public service, Non-tenured not on tenure track, Instructors","101","49","52","0","0","0","2","2","0","1","1","0","4","2","2","0","0","0","83","40","43","1","0","1","7","3","4","3","1","2","-2"
"144740","DePaul University","2011","Total full-time Instruction/research/public service, Non-tenured not on tenure track total","180","94","86","1","1","0","3","2","1","5","1","4","13","6","7","0","0","0","126","67","59","2","1","1","21","12","9","9","4","5","-2"
"144883","East-West University","2011","Total full-time Instruction/research/public service, Non-tenured on tenure track, Associate professors","4","2","2","0","0","0","1","0","1","1","1","0","0","0","0","0","0","0","2","1","1","0","0","0","0","0","0","0","0","0","-2"
"144883","East-West University","2011","Total full-time Instruction/research/public service, Non-tenured on tenure track, Assistant professors","13","8","5","0","0","0","4","2","2","0","0","0","0","0","0","0","0","0","8","5","3","0","0","0","1","1","0","0","0","0","-2"
"144883","East-West University","2011","Total full-time Instruction/research/public service, Non-tenured on tenure track total","17","10","7","0","0","0","5","2","3","1","1","0","0","0","0","0","0","0","10","6","4","0","0","0","1","1","0","0","0","0","-2"
"144962","Elmhurst University","2011","Total full-time Instruction/research/public service, Tenured, Professors","43","23","20","0","0","0","3","3","0","1","1","0","1","1","0","0","0","0","38","18","20","0","0","0","0","0","0","0","0","0","-2"
"144962","Elmhurst University","2011","Total full-time Instruction/research/public service, Tenured, Associate professors","32","12","20","0","0","0","1","1","0","0","0","0","2","0","2","0","0","0","29","11","18","0","0","0","0","0","0","0","0","0","-2"
"144962","Elmhurst University","2011","Total full-time Instruction/research/public service, Tenured, Assistant professors","4","3","1","0","0","0","0","0","0","0","0","0","0","0","0","0","0","0","4","3","1","0","0","0","0","0","0","0","0","0","-2"
"144962","Elmhurst University","2011","Total full-time Instruction/research/public service, Tenured total","79","38","41","0","0","0","4","4","0","1","1","0","3","1","2","0","0","0","71","32","39","0","0","0","0","0","0","0","0","0","-2"
"144962","Elmhurst University","2011","Total full-time Instruction/research/public service, Non-tenured on tenure track, Associate professors","3","2","1","0","0","0","0","0","0","0","0","0","0","0","0","0","0","0","3","2","1","0","0","0","0","0","0","0","0","0","-2"
"144962","Elmhurst University","2011","Total full-time Instruction/research/public service, Non-tenured on tenure track, Assistant professors","30","13","17","0","0","0","2","1","1","2","0","2","0","0","0","0","0","0","25","11","14","0","0","0","0","0","0","1","1","0","-2"
"144962","Elmhurst University","2011","Total full-time Instruction/research/public service, Non-tenured on tenure track, Instructors","2","0","2","0","0","0","0","0","0","0","0","0","0","0","0","0","0","0","2","0","2","0","0","0","0","0","0","0","0","0","-2"
"144962","Elmhurst University","2011","Total full-time Instruction/research/public service, Non-tenured on tenure track total","35","15","20","0","0","0","2","1","1","2","0","2","0","0","0","0","0","0","30","13","17","0","0","0","0","0","0","1","1","0","-2"
"144962","Elmhurst University","2011","Total full-time Instruction/research/public service, Non-tenured not on tenure track, Associate professors","5","1","4","0","0","0","0","0","0","0","0","0","0","0","0","0","0","0","5","1","4","0","0","0","0","0","0","0","0","0","-2"
"144962","Elmhurst University","2011","Total full-time Instruction/research/public servicey, Non-tenured not on tenure track, Assistant professors","17","6","11","0","0","0","0","0","0","1","0","1","0","0","0","0","0","0","16","6","10","0","0","0","0","0","0","0","0","0","-2"
"144962","Elmhurst University","2011","Total full-time Instruction/research/public service, Non-tenured not on tenure track, Lecturers","4","3","1","0","0","0","0","0","0","0","0","0","1","0","1","0","0","0","3","3","0","0","0","0","0","0","0","0","0","0","-2"
"144962","Elmhurst University","2011","Total full-time Instruction/research/public service, Non-tenured not on tenure track total","26","10","16","0","0","0","0","0","0","1","0","1","1","0","1","0","0","0","24","10","14","0","0","0","0","0","0","0","0","0","-2"
"145336","Governors State University","2011","Total full-time Instruction/research/public service, Tenured, Professors","40","19","21","0","0","0","8","4","4","4","3","1","0","0","0","0","0","0","27","12","15","1","0","1","0","0","0","0","0","0","-2"
"145336","Governors State University","2011","Total full-time Instruction/research/public service, Tenured, Associate professors","49","18","31","1","0","1","7","5","2","14","7","7","3","1","2","0","0","0","22","5","17","1","0","1","1","0","1","0","0","0","-2"
"145336","Governors State University","2011","Total full-time Instruction/research/public service, Tenured, Assistant professors","1","1","0","0","0","0","0","0","0","1","1","0","0","0","0","0","0","0","0","0","0","0","0","0","0","0","0","0","0","0","-2"
"145336","Governors State University","2011","Total full-time Instruction/research/public service, Tenured total","90","38","52","1","0","1","15","9","6","19","11","8","3","1","2","0","0","0","49","17","32","2","0","2","1","0","1","0","0","0","-2"
"145336","Governors State University","2011","Total full-time Instruction/research/public service, Non-tenured on tenure track, Assistant professors","55","25","30","0","0","0","7","4","3","12","3","9","2","2","0","0","0","0","27","14","13","0","0","0","5","2","3","2","0","2","-2"
"145336","Governors State University","2011","Total full-time Instruction/research/public service, Non-tenured on tenure track, Instructors","7","1","6","0","0","0","0","0","0","2","0","2","0","0","0","0","0","0","3","1","2","0","0","0","0","0","0","2","0","2","-2"
"145336","Governors State University","2011","Total full-time Instruction/research/public service, Non-tenured on tenure track total","62","26","36","0","0","0","7","4","3","14","3","11","2","2","0","0","0","0","30","15","15","0","0","0","5","2","3","4","0","4","-2"
"145336","Governors State University","2011","Total full-time Instruction/research/public service, Non-tenured not on tenure track, Lecturers","57","23","34","0","0","0","0","0","0","9","4","5","3","1","2","0","0","0","44","17","27","1","1","0","0","0","0","0","0","0","-2"
"145336","Governors State University","2011","Total full-time Instruction/research/public service, Non-tenured not on tenure track, No academic rank","6","5","1","0","0","0","1","1","0","0","0","0","0","0","0","0","0","0","2","2","0","0","0","0","2","1","1","1","1","0","-2"
"145336","Governors State University","2011","Total full-time Instruction/research/public service, Non-tenured not on tenure track total","63","28","35","0","0","0","1","1","0","9","4","5","3","1","2","0","0","0","46","19","27","1","1","0","2","1","1","1","1","0","-2"
"145619","Benedictine University","2011","Total full-time Instruction/research/public service, Tenured, Professors","39","27","12","0","0","0","2","2","0","2","1","1","0","0","0","0","0","0","35","24","11","0","0","0","0","0","0","0","0","0","-2"
"145619","Benedictine University","2011","Total full-time Instruction/research/public service, Tenured, Associate professors","36","19","17","0","0","0","3","1","2","1","0","1","0","0","0","0","0","0","31","18","13","0","0","0","1","0","1","0","0","0","-2"
"145619","Benedictine University","2011","Total full-time Instruction/research/public service, Tenured, Assistant professors","2","1","1","0","0","0","0","0","0","0","0","0","0","0","0","0","0","0","2","1","1","0","0","0","0","0","0","0","0","0","-2"
"145619","Benedictine University","2011","Total full-time Instruction/research/public service, Tenured total","77","47","30","0","0","0","5","3","2","3","1","2","0","0","0","0","0","0","68","43","25","0","0","0","1","0","1","0","0","0","-2"
"145619","Benedictine University","2011","Total full-time Instruction/research/public service, Non-tenured on tenure track, Professors","1","0","1","0","0","0","0","0","0","0","0","0","0","0","0","0","0","0","1","0","1","0","0","0","0","0","0","0","0","0","-2"
"145619","Benedictine University","2011","Total full-time Instruction/research/public service, Non-tenured on tenure track, Associate professors","8","3","5","0","0","0","2","2","0","1","0","1","0","0","0","0","0","0","5","1","4","0","0","0","0","0","0","0","0","0","-2"
"145619","Benedictine University","2011","Total full-time Instruction/research/public service, Non-tenured on tenure track, Assistant professors","29","11","18","0","0","0","1","0","1","0","0","0","1","1","0","0","0","0","26","9","17","0","0","0","1","1","0","0","0","0","-2"
"145619","Benedictine University","2011","Total full-time Instruction/research/public service, Non-tenured on tenure track total","38","14","24","0","0","0","3","2","1","1","0","1","1","1","0","0","0","0","32","10","22","0","0","0","1","1","0","0","0","0","-2"
"145619","Benedictine University","2011","Total full-time Instruction/research/public service, Non-tenured not on tenure track, Professors","1","1","0","0","0","0","1","1","0","0","0","0","0","0","0","0","0","0","0","0","0","0","0","0","0","0","0","0","0","0","-2"
"145619","Benedictine University","2011","Total full-time Instruction/research/public servicey, Non-tenured not on tenure track, Assistant professors","9","3","6","0","0","0","2","2","0","0","0","0","0","0","0","0","0","0","7","1","6","0","0","0","0","0","0","0","0","0","-2"
"145619","Benedictine University","2011","Total full-time Instruction/research/public service, Non-tenured not on tenure track, Instructors","18","6","12","1","0","1","2","0","2","0","0","0","0","0","0","0","0","0","15","6","9","0","0","0","0","0","0","0","0","0","-2"
"145619","Benedictine University","2011","Total full-time Instruction/research/public service, Non-tenured not on tenure track total","28","10","18","1","0","1","5","3","2","0","0","0","0","0","0","0","0","0","22","7","15","0","0","0","0","0","0","0","0","0","-2"
"145725","Illinois Institute of Technology","2011","Total full-time Instruction/research/public service, Tenured, Professors","113","100","13","0","0","0","4","4","0","0","0","0","0","0","0","0","0","0","6","4","2","0","0","0","97","86","11","6","6","0","-2"
"145725","Illinois Institute of Technology","2011","Total full-time Instruction/research/public service, Tenured, Associate professors","75","54","21","0","0","0","3","3","0","0","0","0","2","2","0","0","0","0","5","3","2","0","0","0","57","38","19","8","8","0","-2"
"145725","Illinois Institute of Technology","2011","Total full-time Instruction/research/public service, Tenured total","188","154","34","0","0","0","7","7","0","0","0","0","2","2","0","0","0","0","11","7","4","0","0","0","154","124","30","14","14","0","-2"
"145725","Illinois Institute of Technology","2011","Total full-time Instruction/research/public service, Non-tenured on tenure track, Assistant professors","85","58","27","0","0","0","3","1","2","2","0","2","0","0","0","0","0","0","20","9","11","0","0","0","51","42","9","9","6","3","-2"
"145725","Illinois Institute of Technology","2011","Total full-time Instruction/research/public service, Non-tenured on tenure track total","85","58","27","0","0","0","3","1","2","2","0","2","0","0","0","0","0","0","20","9","11","0","0","0","51","42","9","9","6","3","-2"
"145725","Illinois Institute of Technology","2011","Total full-time Instruction/research/public service, Non-tenured not on tenure track, Professors","24","16","8","0","0","0","0","0","0","0","0","0","0","0","0","0","0","0","4","1","3","0","0","0","19","14","5","1","1","0","-2"
"145725","Illinois Institute of Technology","2011","Total full-time Instruction/research/public service, Non-tenured not on tenure track, Associate professors","30","25","5","0","0","0","0","0","0","0","0","0","1","1","0","0","0","0","5","4","1","0","0","0","23","19","4","1","1","0","-2"
"145725","Illinois Institute of Technology","2011","Total full-time Instruction/research/public servicey, Non-tenured not on tenure track, Assistant professors","61","46","15","0","0","0","2","2","0","0","0","0","1","0","1","0","0","0","18","13","5","0","0","0","33","26","7","7","5","2","-2"
"145725","Illinois Institute of Technology","2011","Total full-time Instruction/research/public service, Non-tenured not on tenure track, Instructors","7","4","3","0","0","0","0","0","0","0","0","0","0","0","0","0","0","0","3","2","1","0","0","0","3","1","2","1","1","0","-2"
"145725","Illinois Institute of Technology","2011","Total full-time Instruction/research/public service, Non-tenured not on tenure track, Lecturers","4","3","1","0","0","0","0","0","0","0","0","0","0","0","0","0","0","0","2","2","0","0","0","0","1","1","0","1","0","1","-2"
"145725","Illinois Institute of Technology","2011","Total full-time Instruction/research/public service, Non-tenured not on tenure track, No academic rank","8","5","3","0","0","0","0","0","0","0","0","0","1","0","1","0","0","0","2","1","1","0","0","0","2","1","1","3","3","0","-2"
"145725","Illinois Institute of Technology","2011","Total full-time Instruction/research/public service, Non-tenured not on tenure track total","134","99","35","0","0","0","2","2","0","0","0","0","3","1","2","0","0","0","34","23","11","0","0","0","81","62","19","14","11","3","-2"
"146339","Judson University","2011","Total full-time Instruction/research/public service, Tenured, Professors","26","19","7","0","0","0","4","1","3","1","1","0","0","0","0","0","0","0","21","17","4","0","0","0","0","0","0","0","0","0","-2"
"146339","Judson University","2011","Total full-time Instruction/research/public service, Tenured, Associate professors","14","10","4","0","0","0","1","1","0","0","0","0","0","0","0","0","0","0","13","9","4","0","0","0","0","0","0","0","0","0","-2"
"146339","Judson University","2011","Total full-time Instruction/research/public service, Tenured total","40","29","11","0","0","0","5","2","3","1","1","0","0","0","0","0","0","0","34","26","8","0","0","0","0","0","0","0","0","0","-2"
"146339","Judson University","2011","Total full-time Instruction/research/public service, Non-tenured on tenure track, Professors","2","1","1","0","0","0","0","0","0","0","0","0","0","0","0","0","0","0","2","1","1","0","0","0","0","0","0","0","0","0","-2"
"146339","Judson University","2011","Total full-time Instruction/research/public service, Non-tenured on tenure track, Associate professors","7","5","2","0","0","0","0","0","0","1","0","1","0","0","0","0","0","0","6","5","1","0","0","0","0","0","0","0","0","0","-2"
"146339","Judson University","2011","Total full-time Instruction/research/public service, Non-tenured on tenure track, Assistant professors","13","6","7","0","0","0","2","0","2","0","0","0","0","0","0","0","0","0","11","6","5","0","0","0","0","0","0","0","0","0","-2"
"146339","Judson University","2011","Total full-time Instruction/research/public service, Non-tenured on tenure track total","22","12","10","0","0","0","2","0","2","1","0","1","0","0","0","0","0","0","19","12","7","0","0","0","0","0","0","0","0","0","-2"
"146339","Judson University","2011","Total full-time Instruction/research/public servicey, Non-tenured not on tenure track, Assistant professors","6","1","5","0","0","0","0","0","0","0","0","0","0","0","0","0","0","0","6","1","5","0","0","0","0","0","0","0","0","0","-2"
"146339","Judson University","2011","Total full-time Instruction/research/public service, Non-tenured not on tenure track total","6","1","5","0","0","0","0","0","0","0","0","0","0","0","0","0","0","0","6","1","5","0","0","0","0","0","0","0","0","0","-2"
"146612","Lewis University","2011","Total full-time Instruction/research/public service, Tenured, Professors","63","39","24","0","0","0","2","2","0","5","4","1","0","0","0","0","0","0","56","33","23","0","0","0","0","0","0","0","0","0","-2"
"146612","Lewis University","2011","Total full-time Instruction/research/public service, Tenured, Associate professors","26","8","18","0","0","0","1","0","1","0","0","0","0","0","0","0","0","0","25","8","17","0","0","0","0","0","0","0","0","0","-2"
"146612","Lewis University","2011","Total full-time Instruction/research/public service, Tenured, Assistant professors","1","1","0","0","0","0","1","1","0","0","0","0","0","0","0","0","0","0","0","0","0","0","0","0","0","0","0","0","0","0","-2"
"146612","Lewis University","2011","Total full-time Instruction/research/public service, Tenured total","90","48","42","0","0","0","4","3","1","5","4","1","0","0","0","0","0","0","81","41","40","0","0","0","0","0","0","0","0","0","-2"
"146612","Lewis University","2011","Total full-time Instruction/research/public service, Non-tenured on tenure track, Associate professors","10","6","4","0","0","0","1","1","0","1","0","1","0","0","0","0","0","0","8","5","3","0","0","0","0","0","0","0","0","0","-2"
"146612","Lewis University","2011","Total full-time Instruction/research/public service, Non-tenured on tenure track, Assistant professors","29","18","11","0","0","0","1","1","0","1","0","1","1","1","0","0","0","0","22","15","7","0","0","0","0","0","0","4","1","3","-2"
"146612","Lewis University","2011","Total full-time Instruction/research/public service, Non-tenured on tenure track total","39","24","15","0","0","0","2","2","0","2","0","2","1","1","0","0","0","0","30","20","10","0","0","0","0","0","0","4","1","3","-2"
"146612","Lewis University","2011","Total full-time Instruction/research/public service, Non-tenured not on tenure track, Professors","1","1","0","0","0","0","0","0","0","0","0","0","0","0","0","0","0","0","1","1","0","0","0","0","0","0","0","0","0","0","-2"
"146612","Lewis University","2011","Total full-time Instruction/research/public service, Non-tenured not on tenure track, Associate professors","10","5","5","0","0","0","0","0","0","0","0","0","1","1","0","0","0","0","9","4","5","0","0","0","0","0","0","0","0","0","-2"
"146612","Lewis University","2011","Total full-time Instruction/research/public servicey, Non-tenured not on tenure track, Assistant professors","48","19","29","0","0","0","1","0","1","2","0","2","0","0","0","0","0","0","43","17","26","0","0","0","0","0","0","2","2","0","-2"
"146612","Lewis University","2011","Total full-time Instruction/research/public service, Non-tenured not on tenure track, Instructors","19","5","14","0","0","0","1","0","1","1","0","1","0","0","0","0","0","0","17","5","12","0","0","0","0","0","0","0","0","0","-2"
"146612","Lewis University","2011","Total full-time Instruction/research/public service, Non-tenured not on tenure track total","78","30","48","0","0","0","2","0","2","3","0","3","1","1","0","0","0","0","70","27","43","0","0","0","0","0","0","2","2","0","-2"
"146719","Loyola University Chicago","2011","Total full-time Instruction/research/public service, Tenured, Professors","233","169","64","0","0","0","14","12","2","3","2","1","9","6","3","1","0","1","205","149","56","1","0","1","0","0","0","0","0","0","-2"
"146719","Loyola University Chicago","2011","Total full-time Instruction/research/public service, Tenured, Associate professors","185","99","86","1","1","0","8","5","3","10","3","7","7","2","5","0","0","0","156","87","69","2","1","1","0","0","0","1","0","1","-2"
"146719","Loyola University Chicago","2011","Total full-time Instruction/research/public service, Tenured, Assistant professors","22","15","7","0","0","0","2","2","0","1","0","1","2","1","1","0","0","0","15","10","5","0","0","0","0","0","0","2","2","0","-2"
"146719","Loyola University Chicago","2011","Total full-time Instruction/research/public service, Tenured total","440","283","157","1","1","0","24","19","5","14","5","9","18","9","9","1","0","1","376","246","130","3","1","2","0","0","0","3","2","1","-2"
"146719","Loyola University Chicago","2011","Total full-time Instruction/research/public service, Non-tenured on tenure track, Professors","10","7","3","0","0","0","0","0","0","0","0","0","2","2","0","0","0","0","7","5","2","0","0","0","0","0","0","1","0","1","-2"
"146719","Loyola University Chicago","2011","Total full-time Instruction/research/public service, Non-tenured on tenure track, Associate professors","10","7","3","0","0","0","1","1","0","1","0","1","0","0","0","0","0","0","7","5","2","0","0","0","0","0","0","1","1","0","-2"
"146719","Loyola University Chicago","2011","Total full-time Instruction/research/public service, Non-tenured on tenure track, Assistant professors","106","52","54","0","0","0","15","8","7","4","1","3","3","2","1","0","0","0","76","39","37","0","0","0","0","0","0","8","2","6","-2"
"146719","Loyola University Chicago","2011","Total full-time Instruction/research/public service, Non-tenured on tenure track total","126","66","60","0","0","0","16","9","7","5","1","4","5","4","1","0","0","0","90","49","41","0","0","0","0","0","0","10","3","7","-2"
"146719","Loyola University Chicago","2011","Total full-time Instruction/research/public service, Non-tenured not on tenure track, Instructors","220","91","129","0","0","0","12","6","6","12","4","8","6","3","3","0","0","0","182","73","109","2","1","1","0","0","0","6","4","2","-2"
"146719","Loyola University Chicago","2011","Total full-time Instruction/research/public service, Non-tenured not on tenure track total","220","91","129","0","0","0","12","6","6","12","4","8","6","3","3","0","0","0","182","73","109","2","1","1","0","0","0","6","4","2","-2"
"147660","North Central College","2011","Total full-time Instruction/research/public service, Tenured, Professors","38","24","14","0","0","0","3","1","2","0","0","0","1","1","0","0","0","0","34","22","12","0","0","0","0","0","0","0","0","0","-2"
"147660","North Central College","2011","Total full-time Instruction/research/public service, Tenured, Associate professors","32","17","15","0","0","0","0","0","0","2","1","1","0","0","0","0","0","0","29","15","14","0","0","0","0","0","0","1","1","0","-2"
"147660","North Central College","2011","Total full-time Instruction/research/public service, Tenured total","70","41","29","0","0","0","3","1","2","2","1","1","1","1","0","0","0","0","63","37","26","0","0","0","0","0","0","1","1","0","-2"
"147660","North Central College","2011","Total full-time Instruction/research/public service, Non-tenured on tenure track, Associate professors","3","1","2","0","0","0","2","1","1","0","0","0","0","0","0","0","0","0","1","0","1","0","0","0","0","0","0","0","0","0","-2"
"147660","North Central College","2011","Total full-time Instruction/research/public service, Non-tenured on tenure track, Assistant professors","29","13","16","0","0","0","1","0","1","0","0","0","1","0","1","0","0","0","24","12","12","0","0","0","0","0","0","3","1","2","-2"
"147660","North Central College","2011","Total full-time Instruction/research/public service, Non-tenured on tenure track total","32","14","18","0","0","0","3","1","2","0","0","0","1","0","1","0","0","0","25","12","13","0","0","0","0","0","0","3","1","2","-2"
"147660","North Central College","2011","Total full-time Instruction/research/public service, Non-tenured not on tenure track, Professors","2","1","1","0","0","0","0","0","0","0","0","0","0","0","0","0","0","0","2","1","1","0","0","0","0","0","0","0","0","0","-2"
"147660","North Central College","2011","Total full-time Instruction/research/public service, Non-tenured not on tenure track, Associate professors","4","1","3","0","0","0","0","0","0","0","0","0","0","0","0","0","0","0","4","1","3","0","0","0","0","0","0","0","0","0","-2"
"147660","North Central College","2011","Total full-time Instruction/research/public servicey, Non-tenured not on tenure track, Assistant professors","16","8","8","0","0","0","0","0","0","1","1","0","0","0","0","0","0","0","12","6","6","0","0","0","0","0","0","3","1","2","-2"
"147660","North Central College","2011","Total full-time Instruction/research/public service, Non-tenured not on tenure track, Instructors","4","1","3","0","0","0","0","0","0","0","0","0","0","0","0","0","0","0","4","1","3","0","0","0","0","0","0","0","0","0","-2"
"147660","North Central College","2011","Total full-time Instruction/research/public service, Non-tenured not on tenure track total","26","11","15","0","0","0","0","0","0","1","1","0","0","0","0","0","0","0","22","9","13","0","0","0","0","0","0","3","1","2","-2"
"148405","Rockford University","2011","Total full-time Instruction/research/public service, Tenured, Professors","23","16","7","0","0","0","3","3","0","0","0","0","0","0","0","0","0","0","20","13","7","0","0","0","0","0","0","0","0","0","-2"
"148405","Rockford University","2011","Total full-time Instruction/research/public service, Tenured, Associate professors","13","7","6","0","0","0","2","1","1","0","0","0","1","0","1","0","0","0","10","6","4","0","0","0","0","0","0","0","0","0","-2"
"148405","Rockford University","2011","Total full-time Instruction/research/public service, Tenured, Assistant professors","2","0","2","0","0","0","0","0","0","0","0","0","0","0","0","0","0","0","2","0","2","0","0","0","0","0","0","0","0","0","-2"
"148405","Rockford University","2011","Total full-time Instruction/research/public service, Tenured total","38","23","15","0","0","0","5","4","1","0","0","0","1","0","1","0","0","0","32","19","13","0","0","0","0","0","0","0","0","0","-2"
"148405","Rockford University","2011","Total full-time Instruction/research/public service, Non-tenured on tenure track, Associate professors","3","2","1","0","0","0","0","0","0","0","0","0","0","0","0","0","0","0","3","2","1","0","0","0","0","0","0","0","0","0","-2"
"148405","Rockford University","2011","Total full-time Instruction/research/public service, Non-tenured on tenure track, Assistant professors","19","12","7","0","0","0","1","1","0","0","0","0","1","1","0","0","0","0","17","10","7","0","0","0","0","0","0","0","0","0","-2"
"148405","Rockford University","2011","Total full-time Instruction/research/public service, Non-tenured on tenure track total","22","14","8","0","0","0","1","1","0","0","0","0","1","1","0","0","0","0","20","12","8","0","0","0","0","0","0","0","0","0","-2"
"148405","Rockford University","2011","Total full-time Instruction/research/public service, Non-tenured not on tenure track, Associate professors","1","1","0","0","0","0","0","0","0","0","0","0","0","0","0","0","0","0","1","1","0","0","0","0","0","0","0","0","0","0","-2"
"148405","Rockford University","2011","Total full-time Instruction/research/public servicey, Non-tenured not on tenure track, Assistant professors","10","2","8","0","0","0","0","0","0","0","0","0","0","0","0","0","0","0","10","2","8","0","0","0","0","0","0","0","0","0","-2"
"148405","Rockford University","2011","Total full-time Instruction/research/public service, Non-tenured not on tenure track total","11","3","8","0","0","0","0","0","0","0","0","0","0","0","0","0","0","0","11","3","8","0","0","0","0","0","0","0","0","0","-2"
"148584","University of St Francis","2011","Total full-time Instruction/research/public service, Tenured, Professors","15","9","6","0","0","0","1","0","1","1","0","1","0","0","0","0","0","0","13","9","4","0","0","0","0","0","0","0","0","0","-2"
"148584","University of St Francis","2011","Total full-time Instruction/research/public service, Tenured, Associate professors","13","5","8","0","0","0","0","0","0","0","0","0","0","0","0","0","0","0","13","5","8","0","0","0","0","0","0","0","0","0","-2"
"148584","University of St Francis","2011","Total full-time Instruction/research/public service, Tenured, Assistant professors","1","0","1","0","0","0","0","0","0","0","0","0","0","0","0","0","0","0","1","0","1","0","0","0","0","0","0","0","0","0","-2"
"148584","University of St Francis","2011","Total full-time Instruction/research/public service, Tenured total","29","14","15","0","0","0","1","0","1","1","0","1","0","0","0","0","0","0","27","14","13","0","0","0","0","0","0","0","0","0","-2"
"148584","University of St Francis","2011","Total full-time Instruction/research/public service, Non-tenured on tenure track, Associate professors","3","1","2","0","0","0","0","0","0","1","0","1","0","0","0","0","0","0","2","1","1","0","0","0","0","0","0","0","0","0","-2"
"148584","University of St Francis","2011","Total full-time Instruction/research/public service, Non-tenured on tenure track, Assistant professors","27","11","16","1","1","0","1","0","1","1","1","0","1","0","1","0","0","0","21","8","13","0","0","0","1","0","1","1","1","0","-2"
"148584","University of St Francis","2011","Total full-time Instruction/research/public service, Non-tenured on tenure track total","30","12","18","1","1","0","1","0","1","2","1","1","1","0","1","0","0","0","23","9","14","0","0","0","1","0","1","1","1","0","-2"
"148584","University of St Francis","2011","Total full-time Instruction/research/public service, Non-tenured not on tenure track, Professors","10","8","2","0","0","0","1","0","1","0","0","0","1","1","0","0","0","0","8","7","1","0","0","0","0","0","0","0","0","0","-2"
"148584","University of St Francis","2011","Total full-time Instruction/research/public service, Non-tenured not on tenure track, Associate professors","5","3","2","1","1","0","0","0","0","0","0","0","1","1","0","0","0","0","3","1","2","0","0","0","0","0","0","0","0","0","-2"
"148584","University of St Francis","2011","Total full-time Instruction/research/public servicey, Non-tenured not on tenure track, Assistant professors","12","2","10","0","0","0","0","0","0","0","0","0","1","0","1","0","0","0","11","2","9","0","0","0","0","0","0","0","0","0","-2"
"148584","University of St Francis","2011","Total full-time Instruction/research/public service, Non-tenured not on tenure track, Instructors","11","4","7","0","0","0","2","1","1","0","0","0","3","2","1","0","0","0","5","1","4","1","0","1","0","0","0","0","0","0","-2"
"148584","University of St Francis","2011","Total full-time Instruction/research/public service, Non-tenured not on tenure track, No academic rank","1","0","1","0","0","0","0","0","0","0","0","0","0","0","0","0","0","0","1","0","1","0","0","0","0","0","0","0","0","0","-2"
"148584","University of St Francis","2011","Total full-time Instruction/research/public service, Non-tenured not on tenure track total","39","17","22","1","1","0","3","1","2","0","0","0","6","4","2","0","0","0","28","11","17","1","0","1","0","0","0","0","0","0","-2"
"149763","Resurrection University","2011","Total full-time Instruction/research/public service, Non-tenured not on tenure track, Associate professors","2","0","2","0","0","0","0","0","0","0","0","0","0","0","0","0","0","0","2","0","2","0","0","0","0","0","0","0","0","0","-2"
"149763","Resurrection University","2011","Total full-time Instruction/research/public servicey, Non-tenured not on tenure track, Assistant professors","6","0","6","0","0","0","2","0","2","0","0","0","0","0","0","0","0","0","4","0","4","0","0","0","0","0","0","0","0","0","-2"
"149763","Resurrection University","2011","Total full-time Instruction/research/public service, Non-tenured not on tenure track, Instructors","14","0","14","0","0","0","3","0","3","2","0","2","1","0","1","0","0","0","8","0","8","0","0","0","0","0","0","0","0","0","-2"
"149763","Resurrection University","2011","Total full-time Instruction/research/public service, Non-tenured not on tenure track total","22","0","22","0","0","0","5","0","5","2","0","2","1","0","1","0","0","0","14","0","14","0","0","0","0","0","0","0","0","0","-2"
"150668","Goshen College","2011","Total full-time Instruction/research/public service, Tenured, Professors","27","16","11","0","0","0","0","0","0","0","0","0","0","0","0","0","0","0","27","16","11","0","0","0","0","0","0","0","0","0","-2"
"150668","Goshen College","2011","Total full-time Instruction/research/public service, Tenured, Associate professors","3","1","2","0","0","0","0","0","0","0","0","0","0","0","0","0","0","0","3","1","2","0","0","0","0","0","0","0","0","0","-2"
"150668","Goshen College","2011","Total full-time Instruction/research/public service, Tenured total","30","17","13","0","0","0","0","0","0","0","0","0","0","0","0","0","0","0","30","17","13","0","0","0","0","0","0","0","0","0","-2"
"150668","Goshen College","2011","Total full-time Instruction/research/public service, Non-tenured on tenure track, Professors","2","2","0","0","0","0","0","0","0","0","0","0","0","0","0","0","0","0","2","2","0","0","0","0","0","0","0","0","0","0","-2"
"150668","Goshen College","2011","Total full-time Instruction/research/public service, Non-tenured on tenure track, Associate professors","13","4","9","0","0","0","0","0","0","0","0","0","0","0","0","0","0","0","12","4","8","0","0","0","1","0","1","0","0","0","-2"
"150668","Goshen College","2011","Total full-time Instruction/research/public service, Non-tenured on tenure track, Assistant professors","8","6","2","0","0","0","0","0","0","0","0","0","0","0","0","0","0","0","7","5","2","0","0","0","0","0","0","1","1","0","-2"
"150668","Goshen College","2011","Total full-time Instruction/research/public service, Non-tenured on tenure track total","23","12","11","0","0","0","0","0","0","0","0","0","0","0","0","0","0","0","21","11","10","0","0","0","1","0","1","1","1","0","-2"
"150668","Goshen College","2011","Total full-time Instruction/research/public service, Non-tenured not on tenure track, Associate professors","7","3","4","0","0","0","0","0","0","0","0","0","0","0","0","0","0","0","7","3","4","0","0","0","0","0","0","0","0","0","-2"
"150668","Goshen College","2011","Total full-time Instruction/research/public servicey, Non-tenured not on tenure track, Assistant professors","8","1","7","0","0","0","0","0","0","2","0","2","1","0","1","0","0","0","4","1","3","0","0","0","1","0","1","0","0","0","-2"
"150668","Goshen College","2011","Total full-time Instruction/research/public service, Non-tenured not on tenure track total","15","4","11","0","0","0","0","0","0","2","0","2","1","0","1","0","0","0","11","4","7","0","0","0","1","0","1","0","0","0","-2"
"150774","Holy Cross College","2011","Total full-time Instruction/research/public service, Non-tenured not on tenure track, Associate professors","13","9","4","0","0","0","0","0","0","0","0","0","0","0","0","0","0","0","13","9","4","0","0","0","0","0","0","0","0","0","-2"
"150774","Holy Cross College","2011","Total full-time Instruction/research/public servicey, Non-tenured not on tenure track, Assistant professors","9","4","5","0","0","0","0","0","0","0","0","0","2","2","0","0","0","0","7","2","5","0","0","0","0","0","0","0","0","0","-2"
"150774","Holy Cross College","2011","Total full-time Instruction/research/public service, Non-tenured not on tenure track total","22","13","9","0","0","0","0","0","0","0","0","0","2","2","0","0","0","0","20","11","9","0","0","0","0","0","0","0","0","0","-2"
"152637","Vincennes University","2011","Total full-time Instruction/research/public service, Tenured, Professors","84","43","41","0","0","0","1","1","0","1","1","0","0","0","0","0","0","0","81","40","41","0","0","0","1","1","0","0","0","0","-2"
"152637","Vincennes University","2011","Total full-time Instruction/research/public service, Tenured, Associate professors","16","13","3","0","0","0","0","0","0","0","0","0","0","0","0","0","0","0","16","13","3","0","0","0","0","0","0","0","0","0","-2"
"152637","Vincennes University","2011","Total full-time Instruction/research/public service, Tenured, Assistant professors","2","2","0","0","0","0","0","0","0","0","0","0","0","0","0","0","0","0","2","2","0","0","0","0","0","0","0","0","0","0","-2"
"152637","Vincennes University","2011","Total full-time Instruction/research/public service, Tenured, Instructors","2","2","0","0","0","0","0","0","0","0","0","0","0","0","0","0","0","0","2","2","0","0","0","0","0","0","0","0","0","0","-2"
"152637","Vincennes University","2011","Total full-time Instruction/research/public service, Tenured total","104","60","44","0","0","0","1","1","0","1","1","0","0","0","0","0","0","0","101","57","44","0","0","0","1","1","0","0","0","0","-2"
"152637","Vincennes University","2011","Total full-time Instruction/research/public service, Non-tenured on tenure track, Professors","2","2","0","0","0","0","0","0","0","0","0","0","0","0","0","0","0","0","2","2","0","0","0","0","0","0","0","0","0","0","-2"
"152637","Vincennes University","2011","Total full-time Instruction/research/public service, Non-tenured on tenure track, Associate professors","4","3","1","0","0","0","0","0","0","1","1","0","0","0","0","0","0","0","3","2","1","0","0","0","0","0","0","0","0","0","-2"
"152637","Vincennes University","2011","Total full-time Instruction/research/public service, Non-tenured on tenure track, Assistant professors","2","2","0","0","0","0","0","0","0","1","1","0","0","0","0","0","0","0","1","1","0","0","0","0","0","0","0","0","0","0","-2"
"152637","Vincennes University","2011","Total full-time Instruction/research/public service, Non-tenured on tenure track total","8","7","1","0","0","0","0","0","0","2","2","0","0","0","0","0","0","0","6","5","1","0","0","0","0","0","0","0","0","0","-2"
"152637","Vincennes University","2011","Total full-time Instruction/research/public service, Non-tenured not on tenure track, Professors","9","3","6","0","0","0","0","0","0","0","0","0","0","0","0","0","0","0","9","3","6","0","0","0","0","0","0","0","0","0","-2"
"152637","Vincennes University","2011","Total full-time Instruction/research/public service, Non-tenured not on tenure track, Associate professors","26","11","15","0","0","0","0","0","0","1","1","0","0","0","0","0","0","0","25","10","15","0","0","0","0","0","0","0","0","0","-2"
"152637","Vincennes University","2011","Total full-time Instruction/research/public servicey, Non-tenured not on tenure track, Assistant professors","72","31","41","0","0","0","0","0","0","1","0","1","0","0","0","0","0","0","68","29","39","0","0","0","1","1","0","2","1","1","-2"
"152637","Vincennes University","2011","Total full-time Instruction/research/public service, Non-tenured not on tenure track, Instructors","24","22","2","0","0","0","0","0","0","0","0","0","0","0","0","0","0","0","24","22","2","0","0","0","0","0","0","0","0","0","-2"
"152637","Vincennes University","2011","Total full-time Instruction/research/public service, Non-tenured not on tenure track, No academic rank","27","10","17","0","0","0","0","0","0","0","0","0","0","0","0","0","0","0","26","9","17","0","0","0","0","0","0","1","1","0","-2"
"152637","Vincennes University","2011","Total full-time Instruction/research/public service, Non-tenured not on tenure track total","158","77","81","0","0","0","0","0","0","2","1","1","0","0","0","0","0","0","152","73","79","0","0","0","1","1","0","3","2","1","-2"
"152992","Briar Cliff University","2011","Total full-time Instruction/research/public service, Tenured, Professors","15","10","5","0","0","0","0","0","0","0","0","0","0","0","0","0","0","0","15","10","5","0","0","0","0","0","0","0","0","0","-2"
"152992","Briar Cliff University","2011","Total full-time Instruction/research/public service, Tenured, Associate professors","10","6","4","0","0","0","0","0","0","0","0","0","0","0","0","0","0","0","10","6","4","0","0","0","0","0","0","0","0","0","-2"
"152992","Briar Cliff University","2011","Total full-time Instruction/research/public service, Tenured, Assistant professors","3","1","2","0","0","0","0","0","0","0","0","0","0","0","0","0","0","0","3","1","2","0","0","0","0","0","0","0","0","0","-2"
"152992","Briar Cliff University","2011","Total full-time Instruction/research/public service, Tenured total","28","17","11","0","0","0","0","0","0","0","0","0","0","0","0","0","0","0","28","17","11","0","0","0","0","0","0","0","0","0","-2"
"152992","Briar Cliff University","2011","Total full-time Instruction/research/public service, Non-tenured on tenure track, Professors","1","0","1","0","0","0","0","0","0","0","0","0","0","0","0","0","0","0","1","0","1","0","0","0","0","0","0","0","0","0","-2"
"152992","Briar Cliff University","2011","Total full-time Instruction/research/public service, Non-tenured on tenure track, Associate professors","7","6","1","0","0","0","0","0","0","0","0","0","0","0","0","0","0","0","7","6","1","0","0","0","0","0","0","0","0","0","-2"
"152992","Briar Cliff University","2011","Total full-time Instruction/research/public service, Non-tenured on tenure track, Assistant professors","20","9","11","0","0","0","0","0","0","1","1","0","1","1","0","0","0","0","18","7","11","0","0","0","0","0","0","0","0","0","-2"
"152992","Briar Cliff University","2011","Total full-time Instruction/research/public service, Non-tenured on tenure track, Instructors","7","1","6","0","0","0","0","0","0","0","0","0","0","0","0","0","0","0","7","1","6","0","0","0","0","0","0","0","0","0","-2"
"152992","Briar Cliff University","2011","Total full-time Instruction/research/public service, Non-tenured on tenure track total","35","16","19","0","0","0","0","0","0","1","1","0","1","1","0","0","0","0","33","14","19","0","0","0","0","0","0","0","0","0","-2"
"154721","Bethany College","2011","Total full-time Instruction/research/public service, Tenured, Professors","9","6","3","0","0","0","0","0","0","0","0","0","0","0","0","0","0","0","9","6","3","0","0","0","0","0","0","0","0","0","-2"
"154721","Bethany College","2011","Total full-time Instruction/research/public service, Tenured, Associate professors","11","6","5","0","0","0","0","0","0","0","0","0","0","0","0","0","0","0","11","6","5","0","0","0","0","0","0","0","0","0","-2"
"154721","Bethany College","2011","Total full-time Instruction/research/public service, Tenured total","20","12","8","0","0","0","0","0","0","0","0","0","0","0","0","0","0","0","20","12","8","0","0","0","0","0","0","0","0","0","-2"
"154721","Bethany College","2011","Total full-time Instruction/research/public service, Non-tenured on tenure track, Associate professors","2","1","1","0","0","0","0","0","0","0","0","0","0","0","0","0","0","0","2","1","1","0","0","0","0","0","0","0","0","0","-2"
"154721","Bethany College","2011","Total full-time Instruction/research/public service, Non-tenured on tenure track, Assistant professors","10","6","4","0","0","0","1","0","1","1","1","0","0","0","0","0","0","0","8","5","3","0","0","0","0","0","0","0","0","0","-2"
"154721","Bethany College","2011","Total full-time Instruction/research/public service, Non-tenured on tenure track total","12","7","5","0","0","0","1","0","1","1","1","0","0","0","0","0","0","0","10","6","4","0","0","0","0","0","0","0","0","0","-2"
"154721","Bethany College","2011","Total full-time Instruction/research/public servicey, Non-tenured not on tenure track, Assistant professors","3","1","2","0","0","0","0","0","0","0","0","0","0","0","0","0","0","0","3","1","2","0","0","0","0","0","0","0","0","0","-2"
"154721","Bethany College","2011","Total full-time Instruction/research/public service, Non-tenured not on tenure track total","3","1","2","0","0","0","0","0","0","0","0","0","0","0","0","0","0","0","3","1","2","0","0","0","0","0","0","0","0","0","-2"
"155414","Kansas Wesleyan University","2011","Total full-time Instruction/research/public service, Tenured, Professors","8","3","5","0","0","0","0","0","0","0","0","0","0","0","0","0","0","0","8","3","5","0","0","0","0","0","0","0","0","0","-2"
"155414","Kansas Wesleyan University","2011","Total full-time Instruction/research/public service, Tenured, Associate professors","11","5","6","0","0","0","0","0","0","1","1","0","0","0","0","0","0","0","10","4","6","0","0","0","0","0","0","0","0","0","-2"
"155414","Kansas Wesleyan University","2011","Total full-time Instruction/research/public service, Tenured total","19","8","11","0","0","0","0","0","0","1","1","0","0","0","0","0","0","0","18","7","11","0","0","0","0","0","0","0","0","0","-2"
"155414","Kansas Wesleyan University","2011","Total full-time Instruction/research/public service, Non-tenured on tenure track, Associate professors","2","1","1","0","0","0","0","0","0","0","0","0","0","0","0","0","0","0","2","1","1","0","0","0","0","0","0","0","0","0","-2"
"155414","Kansas Wesleyan University","2011","Total full-time Instruction/research/public service, Non-tenured on tenure track, Assistant professors","12","9","3","0","0","0","1","1","0","0","0","0","0","0","0","0","0","0","10","7","3","0","0","0","0","0","0","1","1","0","-2"
"155414","Kansas Wesleyan University","2011","Total full-time Instruction/research/public service, Non-tenured on tenure track total","14","10","4","0","0","0","1","1","0","0","0","0","0","0","0","0","0","0","12","8","4","0","0","0","0","0","0","1","1","0","-2"
"155414","Kansas Wesleyan University","2011","Total full-time Instruction/research/public service, Non-tenured not on tenure track, Associate professors","3","3","0","0","0","0","0","0","0","0","0","0","0","0","0","0","0","0","3","3","0","0","0","0","0","0","0","0","0","0","-2"
"155414","Kansas Wesleyan University","2011","Total full-time Instruction/research/public servicey, Non-tenured not on tenure track, Assistant professors","7","1","6","0","0","0","0","0","0","0","0","0","0","0","0","0","0","0","7","1","6","0","0","0","0","0","0","0","0","0","-2"
"155414","Kansas Wesleyan University","2011","Total full-time Instruction/research/public service, Non-tenured not on tenure track total","10","4","6","0","0","0","0","0","0","0","0","0","0","0","0","0","0","0","10","4","6","0","0","0","0","0","0","0","0","0","-2"
"155511","McPherson College","2011","Total full-time Instruction/research/public service, Tenured, Professors","11","9","2","0","0","0","0","0","0","0","0","0","0","0","0","0","0","0","11","9","2","0","0","0","0","0","0","0","0","0","-2"
"155511","McPherson College","2011","Total full-time Instruction/research/public service, Tenured, Associate professors","7","5","2","0","0","0","1","1","0","0","0","0","0","0","0","0","0","0","6","4","2","0","0","0","0","0","0","0","0","0","-2"
"155511","McPherson College","2011","Total full-time Instruction/research/public service, Tenured, Assistant professors","2","2","0","0","0","0","0","0","0","0","0","0","0","0","0","0","0","0","2","2","0","0","0","0","0","0","0","0","0","0","-2"
"155511","McPherson College","2011","Total full-time Instruction/research/public service, Tenured total","20","16","4","0","0","0","1","1","0","0","0","0","0","0","0","0","0","0","19","15","4","0","0","0","0","0","0","0","0","0","-2"
"155511","McPherson College","2011","Total full-time Instruction/research/public service, Non-tenured on tenure track, Associate professors","2","2","0","0","0","0","0","0","0","0","0","0","0","0","0","0","0","0","2","2","0","0","0","0","0","0","0","0","0","0","-2"
"155511","McPherson College","2011","Total full-time Instruction/research/public service, Non-tenured on tenure track, Assistant professors","3","2","1","0","0","0","0","0","0","1","1","0","0","0","0","0","0","0","1","1","0","0","0","0","0","0","0","1","0","1","-2"
"155511","McPherson College","2011","Total full-time Instruction/research/public service, Non-tenured on tenure track total","5","4","1","0","0","0","0","0","0","1","1","0","0","0","0","0","0","0","3","3","0","0","0","0","0","0","0","1","0","1","-2"
"155511","McPherson College","2011","Total full-time Instruction/research/public servicey, Non-tenured not on tenure track, Assistant professors","13","9","4","0","0","0","0","0","0","1","0","1","1","1","0","0","0","0","11","8","3","0","0","0","0","0","0","0","0","0","-2"
"155511","McPherson College","2011","Total full-time Instruction/research/public service, Non-tenured not on tenure track, Instructors","1","1","0","0","0","0","0","0","0","0","0","0","0","0","0","0","0","0","1","1","0","0","0","0","0","0","0","0","0","0","-2"
"155511","McPherson College","2011","Total full-time Instruction/research/public service, Non-tenured not on tenure track total","14","10","4","0","0","0","0","0","0","1","0","1","1","1","0","0","0","0","12","9","3","0","0","0","0","0","0","0","0","0","-2"
"159656","Loyola University New Orleans","2011","Total full-time Instruction/research/public service, Tenured, Professors","93","66","27","0","0","0","0","0","0","6","4","2","3","3","0","1","1","0","78","56","22","2","1","1","2","0","2","1","1","0","-2"
"159656","Loyola University New Orleans","2011","Total full-time Instruction/research/public service, Tenured, Associate professors","56","33","23","0","0","0","0","0","0","1","1","0","0","0","0","0","0","0","50","30","20","2","1","1","3","1","2","0","0","0","-2"
"159656","Loyola University New Orleans","2011","Total full-time Instruction/research/public service, Tenured, Assistant professors","1","1","0","0","0","0","0","0","0","0","0","0","0","0","0","0","0","0","1","1","0","0","0","0","0","0","0","0","0","0","-2"
"159656","Loyola University New Orleans","2011","Total full-time Instruction/research/public service, Tenured total","150","100","50","0","0","0","0","0","0","7","5","2","3","3","0","1","1","0","129","87","42","4","2","2","5","1","4","1","1","0","-2"
"159656","Loyola University New Orleans","2011","Total full-time Instruction/research/public service, Non-tenured on tenure track, Professors","1","0","1","0","0","0","0","0","0","0","0","0","0","0","0","0","0","0","1","0","1","0","0","0","0","0","0","0","0","0","-2"
"159656","Loyola University New Orleans","2011","Total full-time Instruction/research/public service, Non-tenured on tenure track, Associate professors","15","8","7","0","0","0","0","0","0","2","1","1","2","1","1","1","1","0","9","4","5","0","0","0","0","0","0","1","1","0","-2"
"159656","Loyola University New Orleans","2011","Total full-time Instruction/research/public service, Non-tenured on tenure track, Assistant professors","63","34","29","0","0","0","1","0","1","4","1","3","4","3","1","0","0","0","50","27","23","0","0","0","2","2","0","2","1","1","-2"
"159656","Loyola University New Orleans","2011","Total full-time Instruction/research/public service, Non-tenured on tenure track, Instructors","1","0","1","0","0","0","0","0","0","0","0","0","0","0","0","0","0","0","0","0","0","0","0","0","1","0","1","0","0","0","-2"
"159656","Loyola University New Orleans","2011","Total full-time Instruction/research/public service, Non-tenured on tenure track total","80","42","38","0","0","0","1","0","1","6","2","4","6","4","2","1","1","0","60","31","29","0","0","0","3","2","1","3","2","1","-2"
"159656","Loyola University New Orleans","2011","Total full-time Instruction/research/public service, Non-tenured not on tenure track, Professors","2","0","2","0","0","0","0","0","0","1","0","1","1","0","1","0","0","0","0","0","0","0","0","0","0","0","0","0","0","0","-2"
"159656","Loyola University New Orleans","2011","Total full-time Instruction/research/public service, Non-tenured not on tenure track, Associate professors","1","0","1","0","0","0","0","0","0","0","0","0","0","0","0","0","0","0","1","0","1","0","0","0","0","0","0","0","0","0","-2"
"159656","Loyola University New Orleans","2011","Total full-time Instruction/research/public servicey, Non-tenured not on tenure track, Assistant professors","5","2","3","0","0","0","0","0","0","0","0","0","1","0","1","0","0","0","3","2","1","0","0","0","1","0","1","0","0","0","-2"
"159656","Loyola University New Orleans","2011","Total full-time Instruction/research/public service, Non-tenured not on tenure track, Instructors","1","0","1","0","0","0","0","0","0","0","0","0","0","0","0","0","0","0","0","0","0","0","0","0","1","0","1","0","0","0","-2"
"159656","Loyola University New Orleans","2011","Total full-time Instruction/research/public service, Non-tenured not on tenure track, Lecturers","86","38","48","0","0","0","0","0","0","4","0","4","4","2","2","0","0","0","73","34","39","1","0","1","3","1","2","1","1","0","-2"
"159656","Loyola University New Orleans","2011","Total full-time Instruction/research/public service, Non-tenured not on tenure track total","95","40","55","0","0","0","0","0","0","5","0","5","6","2","4","0","0","0","77","36","41","1","0","1","5","1","4","1","1","0","-2"
"162210","Washington Adventist University","2011","Total full-time Instruction/research/public service, Non-tenured not on tenure track, Professors","12","10","2","0","0","0","1","1","0","1","0","1","0","0","0","0","0","0","3","3","0","0","0","0","7","6","1","0","0","0","-2"
"162210","Washington Adventist University","2011","Total full-time Instruction/research/public service, Non-tenured not on tenure track, Associate professors","14","8","6","0","0","0","0","0","0","1","0","1","0","0","0","0","0","0","2","0","2","0","0","0","11","8","3","0","0","0","-2"
"162210","Washington Adventist University","2011","Total full-time Instruction/research/public servicey, Non-tenured not on tenure track, Assistant professors","19","6","13","0","0","0","0","0","0","4","1","3","0","0","0","0","0","0","4","2","2","0","0","0","9","3","6","2","0","2","-2"
"162210","Washington Adventist University","2011","Total full-time Instruction/research/public service, Non-tenured not on tenure track, Instructors","4","3","1","0","0","0","0","0","0","0","0","0","0","0","0","0","0","0","3","2","1","0","0","0","1","1","0","0","0","0","-2"
"162210","Washington Adventist University","2011","Total full-time Instruction/research/public service, Non-tenured not on tenure track total","49","27","22","0","0","0","1","1","0","6","1","5","0","0","0","0","0","0","12","7","5","0","0","0","28","18","10","2","0","2","-2"
"164447","American International College","2011","Total full-time Instruction/research/public service, Tenured, Professors","9","5","4","0","0","0","0","0","0","0","0","0","0","0","0","0","0","0","9","5","4","0","0","0","0","0","0","0","0","0","-2"
"164447","American International College","2011","Total full-time Instruction/research/public service, Tenured, Associate professors","11","8","3","0","0","0","0","0","0","1","1","0","0","0","0","0","0","0","10","7","3","0","0","0","0","0","0","0","0","0","-2"
"164447","American International College","2011","Total full-time Instruction/research/public service, Tenured, Assistant professors","3","3","0","0","0","0","0","0","0","0","0","0","0","0","0","0","0","0","3","3","0","0","0","0","0","0","0","0","0","0","-2"
"164447","American International College","2011","Total full-time Instruction/research/public service, Tenured total","23","16","7","0","0","0","0","0","0","1","1","0","0","0","0","0","0","0","22","15","7","0","0","0","0","0","0","0","0","0","-2"
"164447","American International College","2011","Total full-time Instruction/research/public service, Non-tenured on tenure track, Associate professors","5","0","5","0","0","0","0","0","0","0","0","0","0","0","0","0","0","0","5","0","5","0","0","0","0","0","0","0","0","0","-2"
"164447","American International College","2011","Total full-time Instruction/research/public service, Non-tenured on tenure track, Assistant professors","7","2","5","0","0","0","0","0","0","0","0","0","0","0","0","0","0","0","7","2","5","0","0","0","0","0","0","0","0","0","-2"
"164447","American International College","2011","Total full-time Instruction/research/public service, Non-tenured on tenure track, No academic rank","2","0","2","0","0","0","0","0","0","0","0","0","0","0","0","0","0","0","2","0","2","0","0","0","0","0","0","0","0","0","-2"
"164447","American International College","2011","Total full-time Instruction/research/public service, Non-tenured on tenure track total","14","2","12","0","0","0","0","0","0","0","0","0","0","0","0","0","0","0","14","2","12","0","0","0","0","0","0","0","0","0","-2"
"164447","American International College","2011","Total full-time Instruction/research/public service, Non-tenured not on tenure track, Professors","1","1","0","0","0","0","0","0","0","0","0","0","0","0","0","0","0","0","1","1","0","0","0","0","0","0","0","0","0","0","-2"
"164447","American International College","2011","Total full-time Instruction/research/public service, Non-tenured not on tenure track, Instructors","2","1","1","0","0","0","0","0","0","1","1","0","0","0","0","0","0","0","1","0","1","0","0","0","0","0","0","0","0","0","-2"
"164447","American International College","2011","Total full-time Instruction/research/public service, Non-tenured not on tenure track, No academic rank","2","0","2","0","0","0","0","0","0","0","0","0","0","0","0","0","0","0","2","0","2","0","0","0","0","0","0","0","0","0","-2"
"164447","American International College","2011","Total full-time Instruction/research/public service, Non-tenured not on tenure track total","5","2","3","0","0","0","0","0","0","1","1","0","0","0","0","0","0","0","4","1","3","0","0","0","0","0","0","0","0","0","-2"
"164632","Bay Path University","2011","Total full-time Instruction/research/public service, Non-tenured not on tenure track, Professors","11","4","7","0","0","0","0","0","0","0","0","0","0","0","0","0","0","0","11","4","7","0","0","0","0","0","0","0","0","0","-2"
"164632","Bay Path University","2011","Total full-time Instruction/research/public service, Non-tenured not on tenure track, Associate professors","11","5","6","0","0","0","1","0","1","0","0","0","0","0","0","0","0","0","10","5","5","0","0","0","0","0","0","0","0","0","-2"
"164632","Bay Path University","2011","Total full-time Instruction/research/public servicey, Non-tenured not on tenure track, Assistant professors","22","9","13","0","0","0","1","1","0","0","0","0","0","0","0","0","0","0","20","8","12","1","0","1","0","0","0","0","0","0","-2"
"164632","Bay Path University","2011","Total full-time Instruction/research/public service, Non-tenured not on tenure track, Instructors","5","0","5","0","0","0","0","0","0","0","0","0","0","0","0","0","0","0","5","0","5","0","0","0","0","0","0","0","0","0","-2"
"164632","Bay Path University","2011","Total full-time Instruction/research/public service, Non-tenured not on tenure track total","49","18","31","0","0","0","2","1","1","0","0","0","0","0","0","0","0","0","46","17","29","1","0","1","0","0","0","0","0","0","-2"
"164872","Boston Architectural College","2011","Total full-time Instruction/research/public service, Non-tenured not on tenure track, No academic rank","11","8","3","0","0","0","0","0","0","0","0","0","3","2","1","0","0","0","8","6","2","0","0","0","0","0","0","0","0","0","-2"
"164872","Boston Architectural College","2011","Total full-time Instruction/research/public service, Non-tenured not on tenure track total","11","8","3","0","0","0","0","0","0","0","0","0","3","2","1","0","0","0","8","6","2","0","0","0","0","0","0","0","0","0","-2"
"165644","Eastern Nazarene College","2011","Total full-time Instruction/research/public service, Tenured, Professors","6","5","1","0","0","0","0","0","0","0","0","0","0","0","0","0","0","0","6","5","1","0","0","0","0","0","0","0","0","0","-2"
"165644","Eastern Nazarene College","2011","Total full-time Instruction/research/public service, Tenured, Associate professors","7","5","2","0","0","0","0","0","0","0","0","0","0","0","0","0","0","0","7","5","2","0","0","0","0","0","0","0","0","0","-2"
"165644","Eastern Nazarene College","2011","Total full-time Instruction/research/public service, Tenured total","13","10","3","0","0","0","0","0","0","0","0","0","0","0","0","0","0","0","13","10","3","0","0","0","0","0","0","0","0","0","-2"
"165644","Eastern Nazarene College","2011","Total full-time Instruction/research/public service, Non-tenured on tenure track, Professors","1","0","1","0","0","0","0","0","0","0","0","0","0","0","0","0","0","0","1","0","1","0","0","0","0","0","0","0","0","0","-2"
"165644","Eastern Nazarene College","2011","Total full-time Instruction/research/public service, Non-tenured on tenure track, Associate professors","7","5","2","0","0","0","0","0","0","0","0","0","0","0","0","0","0","0","5","4","1","0","0","0","0","0","0","2","1","1","-2"
"165644","Eastern Nazarene College","2011","Total full-time Instruction/research/public service, Non-tenured on tenure track, Assistant professors","10","7","3","0","0","0","0","0","0","2","0","2","0","0","0","0","0","0","7","6","1","1","1","0","0","0","0","0","0","0","-2"
"165644","Eastern Nazarene College","2011","Total full-time Instruction/research/public service, Non-tenured on tenure track total","18","12","6","0","0","0","0","0","0","2","0","2","0","0","0","0","0","0","13","10","3","1","1","0","0","0","0","2","1","1","-2"
"165644","Eastern Nazarene College","2011","Total full-time Instruction/research/public service, Non-tenured not on tenure track, Associate professors","1","1","0","0","0","0","0","0","0","0","0","0","0","0","0","0","0","0","1","1","0","0","0","0","0","0","0","0","0","0","-2"
"165644","Eastern Nazarene College","2011","Total full-time Instruction/research/public service, Non-tenured not on tenure track, Instructors","5","2","3","0","0","0","0","0","0","0","0","0","0","0","0","0","0","0","5","2","3","0","0","0","0","0","0","0","0","0","-2"
"165644","Eastern Nazarene College","2011","Total full-time Instruction/research/public service, Non-tenured not on tenure track total","6","3","3","0","0","0","0","0","0","0","0","0","0","0","0","0","0","0","6","3","3","0","0","0","0","0","0","0","0","0","-2"
"165866","Framingham State University","2011","Total full-time Instruction/research/public service, Tenured, Professors","53","23","30","0","0","0","0","0","0","1","1","0","0","0","0","0","0","0","51","21","30","0","0","0","1","1","0","0","0","0","-2"
"165866","Framingham State University","2011","Total full-time Instruction/research/public service, Tenured, Associate professors","38","14","24","0","0","0","1","1","0","3","2","1","0","0","0","0","0","0","33","10","23","0","0","0","1","1","0","0","0","0","-2"
"165866","Framingham State University","2011","Total full-time Instruction/research/public service, Tenured, Assistant professors","11","5","6","0","0","0","1","1","0","0","0","0","0","0","0","0","0","0","10","4","6","0","0","0","0","0","0","0","0","0","-2"
"165866","Framingham State University","2011","Total full-time Instruction/research/public service, Tenured total","102","42","60","0","0","0","2","2","0","4","3","1","0","0","0","0","0","0","94","35","59","0","0","0","2","2","0","0","0","0","-2"
"165866","Framingham State University","2011","Total full-time Instruction/research/public service, Non-tenured on tenure track, Associate professors","4","1","3","0","0","0","0","0","0","0","0","0","0","0","0","0","0","0","4","1","3","0","0","0","0","0","0","0","0","0","-2"
"165866","Framingham State University","2011","Total full-time Instruction/research/public service, Non-tenured on tenure track, Assistant professors","49","20","29","0","0","0","3","1","2","2","1","1","0","0","0","0","0","0","42","18","24","0","0","0","2","0","2","0","0","0","-2"
"165866","Framingham State University","2011","Total full-time Instruction/research/public service, Non-tenured on tenure track total","53","21","32","0","0","0","3","1","2","2","1","1","0","0","0","0","0","0","46","19","27","0","0","0","2","0","2","0","0","0","-2"
"165866","Framingham State University","2011","Total full-time Instruction/research/public servicey, Non-tenured not on tenure track, Assistant professors","14","8","6","0","0","0","0","0","0","2","1","1","1","0","1","0","0","0","11","7","4","0","0","0","0","0","0","0","0","0","-2"
"165866","Framingham State University","2011","Total full-time Instruction/research/public service, Non-tenured not on tenure track, Instructors","7","2","5","0","0","0","0","0","0","0","0","0","0","0","0","0","0","0","7","2","5","0","0","0","0","0","0","0","0","0","-2"
"165866","Framingham State University","2011","Total full-time Instruction/research/public service, Non-tenured not on tenure track total","21","10","11","0","0","0","0","0","0","2","1","1","1","0","1","0","0","0","18","9","9","0","0","0","0","0","0","0","0","0","-2"
"166452","Lesley University","2011","Total full-time Instruction/research/public service, Tenured, Professors","2","0","2","0","0","0","0","0","0","0","0","0","0","0","0","0","0","0","2","0","2","0","0","0","0","0","0","0","0","0","-2"
"166452","Lesley University","2011","Total full-time Instruction/research/public service, Tenured total","2","0","2","0","0","0","0","0","0","0","0","0","0","0","0","0","0","0","2","0","2","0","0","0","0","0","0","0","0","0","-2"
"166452","Lesley University","2011","Total full-time Instruction/research/public service, Non-tenured not on tenure track, Professors","45","13","32","0","0","0","2","0","2","1","0","1","3","0","3","0","0","0","39","13","26","0","0","0","0","0","0","0","0","0","-2"
"166452","Lesley University","2011","Total full-time Instruction/research/public service, Non-tenured not on tenure track, Associate professors","50","22","28","0","0","0","2","2","0","5","1","4","6","2","4","0","0","0","37","17","20","0","0","0","0","0","0","0","0","0","-2"
"166452","Lesley University","2011","Total full-time Instruction/research/public servicey, Non-tenured not on tenure track, Assistant professors","43","14","29","0","0","0","3","0","3","1","1","0","2","0","2","0","0","0","36","12","24","1","1","0","0","0","0","0","0","0","-2"
"166452","Lesley University","2011","Total full-time Instruction/research/public service, Non-tenured not on tenure track, Instructors","9","3","6","0","0","0","0","0","0","0","0","0","0","0","0","0","0","0","9","3","6","0","0","0","0","0","0","0","0","0","-2"
"166452","Lesley University","2011","Total full-time Instruction/research/public service, Non-tenured not on tenure track total","147","52","95","0","0","0","7","2","5","7","2","5","11","2","9","0","0","0","121","45","76","1","1","0","0","0","0","0","0","0","-2"
"166638","University of Massachusetts-Boston","2011","Total full-time Instruction/research/public service, Tenured, Professors","114","70","44","1","0","1","13","11","2","5","5","0","5","2","3","0","0","0","89","51","38","0","0","0","1","1","0","0","0","0","-2"
"166638","University of Massachusetts-Boston","2011","Total full-time Instruction/research/public service, Tenured, Associate professors","159","85","74","0","0","0","18","10","8","18","7","11","8","4","4","0","0","0","109","60","49","0","0","0","4","4","0","2","0","2","-2"
"166638","University of Massachusetts-Boston","2011","Total full-time Instruction/research/public service, Tenured, Assistant professors","1","1","0","0","0","0","1","1","0","0","0","0","0","0","0","0","0","0","0","0","0","0","0","0","0","0","0","0","0","0","-2"
"166638","University of Massachusetts-Boston","2011","Total full-time Instruction/research/public service, Tenured total","274","156","118","1","0","1","32","22","10","23","12","11","13","6","7","0","0","0","198","111","87","0","0","0","5","5","0","2","0","2","-2"
"166638","University of Massachusetts-Boston","2011","Total full-time Instruction/research/public service, Non-tenured on tenure track, Professors","1","0","1","0","0","0","0","0","0","0","0","0","0","0","0","0","0","0","0","0","0","0","0","0","1","0","1","0","0","0","-2"
"166638","University of Massachusetts-Boston","2011","Total full-time Instruction/research/public service, Non-tenured on tenure track, Associate professors","9","4","5","0","0","0","1","1","0","0","0","0","0","0","0","0","0","0","8","3","5","0","0","0","0","0","0","0","0","0","-2"
"166638","University of Massachusetts-Boston","2011","Total full-time Instruction/research/public service, Non-tenured on tenure track, Assistant professors","136","58","78","0","0","0","25","17","8","2","0","2","7","3","4","0","0","0","78","25","53","0","0","0","20","11","9","4","2","2","-2"
"166638","University of Massachusetts-Boston","2011","Total full-time Instruction/research/public service, Non-tenured on tenure track total","146","62","84","0","0","0","26","18","8","2","0","2","7","3","4","0","0","0","86","28","58","0","0","0","21","11","10","4","2","2","-2"
"166638","University of Massachusetts-Boston","2011","Total full-time Instruction/research/public service, Non-tenured not on tenure track, Professors","2","0","2","0","0","0","0","0","0","0","0","0","0","0","0","0","0","0","2","0","2","0","0","0","0","0","0","0","0","0","-2"
"166638","University of Massachusetts-Boston","2011","Total full-time Instruction/research/public servicey, Non-tenured not on tenure track, Assistant professors","1","0","1","0","0","0","0","0","0","0","0","0","0","0","0","0","0","0","1","0","1","0","0","0","0","0","0","0","0","0","-2"
"166638","University of Massachusetts-Boston","2011","Total full-time Instruction/research/public service, Non-tenured not on tenure track, Instructors","1","1","0","0","0","0","0","0","0","0","0","0","0","0","0","0","0","0","1","1","0","0","0","0","0","0","0","0","0","0","-2"
"166638","University of Massachusetts-Boston","2011","Total full-time Instruction/research/public service, Non-tenured not on tenure track, Lecturers","123","53","70","0","0","0","6","4","2","7","6","1","1","1","0","0","0","0","100","39","61","0","0","0","9","3","6","0","0","0","-2"
"166638","University of Massachusetts-Boston","2011","Total full-time Instruction/research/public service, Non-tenured not on tenure track total","127","54","73","0","0","0","6","4","2","7","6","1","1","1","0","0","0","0","104","40","64","0","0","0","9","3","6","0","0","0","-2"
"167455","Pine Manor College","2011","Total full-time Instruction/research/public service, Tenured, Professors","9","2","7","0","0","0","1","1","0","0","0","0","0","0","0","0","0","0","8","1","7","0","0","0","0","0","0","0","0","0","-2"
"167455","Pine Manor College","2011","Total full-time Instruction/research/public service, Tenured, Associate professors","5","1","4","0","0","0","1","0","1","0","0","0","0","0","0","0","0","0","4","1","3","0","0","0","0","0","0","0","0","0","-2"
"167455","Pine Manor College","2011","Total full-time Instruction/research/public service, Tenured, Assistant professors","1","0","1","0","0","0","0","0","0","1","0","1","0","0","0","0","0","0","0","0","0","0","0","0","0","0","0","0","0","0","-2"
"167455","Pine Manor College","2011","Total full-time Instruction/research/public service, Tenured, Instructors","1","0","1","0","0","0","0","0","0","0","0","0","0","0","0","0","0","0","1","0","1","0","0","0","0","0","0","0","0","0","-2"
"167455","Pine Manor College","2011","Total full-time Instruction/research/public service, Tenured total","16","3","13","0","0","0","2","1","1","1","0","1","0","0","0","0","0","0","13","2","11","0","0","0","0","0","0","0","0","0","-2"
"167455","Pine Manor College","2011","Total full-time Instruction/research/public service, Non-tenured on tenure track, Associate professors","1","0","1","0","0","0","0","0","0","0","0","0","0","0","0","0","0","0","1","0","1","0","0","0","0","0","0","0","0","0","-2"
"167455","Pine Manor College","2011","Total full-time Instruction/research/public service, Non-tenured on tenure track, Assistant professors","3","1","2","0","0","0","0","0","0","0","0","0","0","0","0","0","0","0","3","1","2","0","0","0","0","0","0","0","0","0","-2"
"167455","Pine Manor College","2011","Total full-time Instruction/research/public service, Non-tenured on tenure track total","4","1","3","0","0","0","0","0","0","0","0","0","0","0","0","0","0","0","4","1","3","0","0","0","0","0","0","0","0","0","-2"
"167455","Pine Manor College","2011","Total full-time Instruction/research/public service, Non-tenured not on tenure track, Associate professors","1","1","0","0","0","0","0","0","0","0","0","0","0","0","0","0","0","0","1","1","0","0","0","0","0","0","0","0","0","0","-2"
"167455","Pine Manor College","2011","Total full-time Instruction/research/public servicey, Non-tenured not on tenure track, Assistant professors","5","0","5","0","0","0","0","0","0","1","0","1","0","0","0","0","0","0","4","0","4","0","0","0","0","0","0","0","0","0","-2"
"167455","Pine Manor College","2011","Total full-time Instruction/research/public service, Non-tenured not on tenure track total","6","1","5","0","0","0","0","0","0","1","0","1","0","0","0","0","0","0","5","1","4","0","0","0","0","0","0","0","0","0","-2"
"167729","Salem State University","2011","Total full-time Instruction/research/public service, Tenured, Professors","126","61","65","0","0","0","4","2","2","1","1","0","2","1","1","0","0","0","119","57","62","0","0","0","0","0","0","0","0","0","-2"
"167729","Salem State University","2011","Total full-time Instruction/research/public service, Tenured, Associate professors","86","46","40","0","0","0","5","3","2","3","2","1","0","0","0","0","0","0","73","39","34","0","0","0","4","1","3","1","1","0","-2"
"167729","Salem State University","2011","Total full-time Instruction/research/public service, Tenured, Assistant professors","14","5","9","0","0","0","1","1","0","0","0","0","0","0","0","0","0","0","12","3","9","0","0","0","1","1","0","0","0","0","-2"
"167729","Salem State University","2011","Total full-time Instruction/research/public service, Tenured total","226","112","114","0","0","0","10","6","4","4","3","1","2","1","1","0","0","0","204","99","105","0","0","0","5","2","3","1","1","0","-2"
"167729","Salem State University","2011","Total full-time Instruction/research/public service, Non-tenured on tenure track, Associate professors","8","4","4","0","0","0","1","1","0","0","0","0","0","0","0","0","0","0","6","3","3","0","0","0","1","0","1","0","0","0","-2"
"167729","Salem State University","2011","Total full-time Instruction/research/public service, Non-tenured on tenure track, Assistant professors","86","34","52","0","0","0","10","4","6","3","1","2","5","2","3","0","0","0","63","25","38","0","0","0","4","1","3","1","1","0","-2"
"167729","Salem State University","2011","Total full-time Instruction/research/public service, Non-tenured on tenure track, Instructors","5","0","5","0","0","0","0","0","0","0","0","0","1","0","1","0","0","0","4","0","4","0","0","0","0","0","0","0","0","0","-2"
"167729","Salem State University","2011","Total full-time Instruction/research/public service, Non-tenured on tenure track total","99","38","61","0","0","0","11","5","6","3","1","2","6","2","4","0","0","0","73","28","45","0","0","0","5","1","4","1","1","0","-2"
"167729","Salem State University","2011","Total full-time Instruction/research/public servicey, Non-tenured not on tenure track, Assistant professors","5","2","3","0","0","0","1","0","1","0","0","0","0","0","0","0","0","0","4","2","2","0","0","0","0","0","0","0","0","0","-2"
"167729","Salem State University","2011","Total full-time Instruction/research/public service, Non-tenured not on tenure track, Instructors","7","2","5","0","0","0","0","0","0","0","0","0","0","0","0","0","0","0","7","2","5","0","0","0","0","0","0","0","0","0","-2"
"167729","Salem State University","2011","Total full-time Instruction/research/public service, Non-tenured not on tenure track total","12","4","8","0","0","0","1","0","1","0","0","0","0","0","0","0","0","0","11","4","7","0","0","0","0","0","0","0","0","0","-2"
"168740","Andrews University","2011","Total full-time Instruction/research/public service, Tenured, Professors","62","52","10","0","0","0","4","4","0","5","4","1","3","3","0","0","0","0","50","41","9","0","0","0","0","0","0","0","0","0","-2"
"168740","Andrews University","2011","Total full-time Instruction/research/public service, Tenured, Associate professors","13","7","6","0","0","0","1","1","0","2","2","0","0","0","0","0","0","0","9","3","6","0","0","0","0","0","0","1","1","0","-2"
"168740","Andrews University","2011","Total full-time Instruction/research/public service, Tenured, Assistant professors","2","2","0","0","0","0","0","0","0","0","0","0","0","0","0","0","0","0","2","2","0","0","0","0","0","0","0","0","0","0","-2"
"168740","Andrews University","2011","Total full-time Instruction/research/public service, Tenured total","77","61","16","0","0","0","5","5","0","7","6","1","3","3","0","0","0","0","61","46","15","0","0","0","0","0","0","1","1","0","-2"
"168740","Andrews University","2011","Total full-time Instruction/research/public service, Non-tenured on tenure track, Professors","18","14","4","0","0","0","1","1","0","2","1","1","2","2","0","0","0","0","12","9","3","0","0","0","0","0","0","1","1","0","-2"
"168740","Andrews University","2011","Total full-time Instruction/research/public service, Non-tenured on tenure track, Associate professors","46","27","19","0","0","0","2","1","1","5","3","2","4","3","1","0","0","0","29","16","13","1","1","0","0","0","0","5","3","2","-2"
"168740","Andrews University","2011","Total full-time Instruction/research/public service, Non-tenured on tenure track, Assistant professors","27","11","16","0","0","0","2","1","1","5","1","4","1","0","1","0","0","0","18","8","10","1","1","0","0","0","0","0","0","0","-2"
"168740","Andrews University","2011","Total full-time Instruction/research/public service, Non-tenured on tenure track, Instructors","2","2","0","0","0","0","0","0","0","0","0","0","0","0","0","0","0","0","1","1","0","0","0","0","0","0","0","1","1","0","-2"
"168740","Andrews University","2011","Total full-time Instruction/research/public service, Non-tenured on tenure track total","93","54","39","0","0","0","5","3","2","12","5","7","7","5","2","0","0","0","60","34","26","2","2","0","0","0","0","7","5","2","-2"
"168740","Andrews University","2011","Total full-time Instruction/research/public service, Non-tenured not on tenure track, Professors","1","1","0","0","0","0","0","0","0","0","0","0","0","0","0","0","0","0","1","1","0","0","0","0","0","0","0","0","0","0","-2"
"168740","Andrews University","2011","Total full-time Instruction/research/public service, Non-tenured not on tenure track, Associate professors","10","5","5","0","0","0","0","0","0","0","0","0","1","1","0","0","0","0","7","4","3","0","0","0","0","0","0","2","0","2","-2"
"168740","Andrews University","2011","Total full-time Instruction/research/public servicey, Non-tenured not on tenure track, Assistant professors","36","18","18","0","0","0","1","0","1","4","1","3","2","2","0","0","0","0","25","12","13","0","0","0","0","0","0","4","3","1","-2"
"168740","Andrews University","2011","Total full-time Instruction/research/public service, Non-tenured not on tenure track, Instructors","5","2","3","0","0","0","0","0","0","0","0","0","1","1","0","0","0","0","4","1","3","0","0","0","0","0","0","0","0","0","-2"
"168740","Andrews University","2011","Total full-time Instruction/research/public service, Non-tenured not on tenure track total","52","26","26","0","0","0","1","0","1","4","1","3","4","4","0","0","0","0","37","18","19","0","0","0","0","0","0","6","3","3","-2"
"170532","Kalamazoo College","2011","Total full-time Instruction/research/public service, Tenured, Professors","33","22","11","0","0","0","2","1","1","1","1","0","1","0","1","0","0","0","28","20","8","1","0","1","0","0","0","0","0","0","-2"
"170532","Kalamazoo College","2011","Total full-time Instruction/research/public service, Tenured, Associate professors","30","12","18","0","0","0","1","0","1","2","1","1","1","0","1","0","0","0","26","11","15","0","0","0","0","0","0","0","0","0","-2"
"170532","Kalamazoo College","2011","Total full-time Instruction/research/public service, Tenured total","63","34","29","0","0","0","3","1","2","3","2","1","2","0","2","0","0","0","54","31","23","1","0","1","0","0","0","0","0","0","-2"
"170532","Kalamazoo College","2011","Total full-time Instruction/research/public service, Non-tenured on tenure track, Assistant professors","16","7","9","0","0","0","4","1","3","1","1","0","1","0","1","0","0","0","10","5","5","0","0","0","0","0","0","0","0","0","-2"
"170532","Kalamazoo College","2011","Total full-time Instruction/research/public service, Non-tenured on tenure track total","16","7","9","0","0","0","4","1","3","1","1","0","1","0","1","0","0","0","10","5","5","0","0","0","0","0","0","0","0","0","-2"
"170532","Kalamazoo College","2011","Total full-time Instruction/research/public servicey, Non-tenured not on tenure track, Assistant professors","15","3","12","0","0","0","4","0","4","0","0","0","1","1","0","0","0","0","9","2","7","1","0","1","0","0","0","0","0","0","-2"
"170532","Kalamazoo College","2011","Total full-time Instruction/research/public service, Non-tenured not on tenure track, Instructors","7","3","4","0","0","0","0","0","0","0","0","0","2","0","2","0","0","0","5","3","2","0","0","0","0","0","0","0","0","0","-2"
"170532","Kalamazoo College","2011","Total full-time Instruction/research/public service, Non-tenured not on tenure track total","22","6","16","0","0","0","4","0","4","0","0","0","3","1","2","0","0","0","14","5","9","1","0","1","0","0","0","0","0","0","-2"
"172033","Sacred Heart Major Seminary","2011","Total full-time Instruction/research/public service, Non-tenured not on tenure track, Professors","12","10","2","0","0","0","0","0","0","0","0","0","1","1","0","0","0","0","11","9","2","0","0","0","0","0","0","0","0","0","-2"
"172033","Sacred Heart Major Seminary","2011","Total full-time Instruction/research/public service, Non-tenured not on tenure track, Associate professors","4","3","1","0","0","0","0","0","0","0","0","0","0","0","0","0","0","0","4","3","1","0","0","0","0","0","0","0","0","0","-2"
"172033","Sacred Heart Major Seminary","2011","Total full-time Instruction/research/public servicey, Non-tenured not on tenure track, Assistant professors","8","7","1","0","0","0","0","0","0","0","0","0","1","1","0","0","0","0","7","6","1","0","0","0","0","0","0","0","0","0","-2"
"172033","Sacred Heart Major Seminary","2011","Total full-time Instruction/research/public service, Non-tenured not on tenure track, Instructors","2","1","1","0","0","0","0","0","0","0","0","0","0","0","0","0","0","0","2","1","1","0","0","0","0","0","0","0","0","0","-2"
"172033","Sacred Heart Major Seminary","2011","Total full-time Instruction/research/public service, Non-tenured not on tenure track total","26","21","5","0","0","0","0","0","0","0","0","0","2","2","0","0","0","0","24","19","5","0","0","0","0","0","0","0","0","0","-2"
"178721","Park University","2011","Total full-time Instruction/research/public service, Tenured, Professors","15","12","3","0","0","0","1","0","1","1","1","0","0","0","0","0","0","0","13","11","2","0","0","0","0","0","0","0","0","0","-2"
"178721","Park University","2011","Total full-time Instruction/research/public service, Tenured, Associate professors","27","14","13","0","0","0","1","0","1","0","0","0","0","0","0","0","0","0","25","13","12","0","0","0","0","0","0","1","1","0","-2"
"178721","Park University","2011","Total full-time Instruction/research/public service, Tenured total","42","26","16","0","0","0","2","0","2","1","1","0","0","0","0","0","0","0","38","24","14","0","0","0","0","0","0","1","1","0","-2"
"178721","Park University","2011","Total full-time Instruction/research/public service, Non-tenured on tenure track, Professors","2","1","1","0","0","0","0","0","0","0","0","0","0","0","0","0","0","0","2","1","1","0","0","0","0","0","0","0","0","0","-2"
"178721","Park University","2011","Total full-time Instruction/research/public service, Non-tenured on tenure track, Associate professors","14","6","8","0","0","0","1","1","0","0","0","0","0","0","0","0","0","0","13","5","8","0","0","0","0","0","0","0","0","0","-2"
"178721","Park University","2011","Total full-time Instruction/research/public service, Non-tenured on tenure track, Assistant professors","25","16","9","0","0","0","1","1","0","0","0","0","0","0","0","0","0","0","22","14","8","1","0","1","0","0","0","1","1","0","-2"
"178721","Park University","2011","Total full-time Instruction/research/public service, Non-tenured on tenure track total","41","23","18","0","0","0","2","2","0","0","0","0","0","0","0","0","0","0","37","20","17","1","0","1","0","0","0","1","1","0","-2"
"178721","Park University","2011","Total full-time Instruction/research/public service, Non-tenured not on tenure track, Professors","1","0","1","0","0","0","0","0","0","0","0","0","0","0","0","0","0","0","1","0","1","0","0","0","0","0","0","0","0","0","-2"
"178721","Park University","2011","Total full-time Instruction/research/public service, Non-tenured not on tenure track, Associate professors","3","3","0","0","0","0","0","0","0","0","0","0","0","0","0","0","0","0","3","3","0","0","0","0","0","0","0","0","0","0","-2"
"178721","Park University","2011","Total full-time Instruction/research/public servicey, Non-tenured not on tenure track, Assistant professors","27","13","14","0","0","0","0","0","0","0","0","0","2","2","0","1","0","1","23","10","13","1","1","0","0","0","0","0","0","0","-2"
"178721","Park University","2011","Total full-time Instruction/research/public service, Non-tenured not on tenure track, Instructors","9","6","3","0","0","0","1","0","1","1","0","1","0","0","0","0","0","0","7","6","1","0","0","0","0","0","0","0","0","0","-2"
"178721","Park University","2011","Total full-time Instruction/research/public service, Non-tenured not on tenure track, Lecturers","4","3","1","0","0","0","0","0","0","0","0","0","1","1","0","0","0","0","2","1","1","1","1","0","0","0","0","0","0","0","-2"
"178721","Park University","2011","Total full-time Instruction/research/public service, Non-tenured not on tenure track total","44","25","19","0","0","0","1","0","1","1","0","1","3","3","0","1","0","1","36","20","16","2","2","0","0","0","0","0","0","0","-2"
"181738","Union College","2011","Total full-time Instruction/research/public service, Tenured, Professors","14","11","3","0","0","0","1","1","0","1","0","1","0","0","0","0","0","0","12","10","2","0","0","0","0","0","0","0","0","0","-2"
"181738","Union College","2011","Total full-time Instruction/research/public service, Tenured, Associate professors","7","3","4","0","0","0","0","0","0","0","0","0","1","0","1","0","0","0","6","3","3","0","0","0","0","0","0","0","0","0","-2"
"181738","Union College","2011","Total full-time Instruction/research/public service, Tenured total","21","14","7","0","0","0","1","1","0","1","0","1","1","0","1","0","0","0","18","13","5","0","0","0","0","0","0","0","0","0","-2"
"181738","Union College","2011","Total full-time Instruction/research/public service, Non-tenured on tenure track, Professors","2","2","0","0","0","0","0","0","0","0","0","0","0","0","0","0","0","0","2","2","0","0","0","0","0","0","0","0","0","0","-2"
"181738","Union College","2011","Total full-time Instruction/research/public service, Non-tenured on tenure track, Associate professors","12","5","7","0","0","0","0","0","0","0","0","0","1","1","0","0","0","0","11","4","7","0","0","0","0","0","0","0","0","0","-2"
"181738","Union College","2011","Total full-time Instruction/research/public service, Non-tenured on tenure track total","14","7","7","0","0","0","0","0","0","0","0","0","1","1","0","0","0","0","13","6","7","0","0","0","0","0","0","0","0","0","-2"
"181738","Union College","2011","Total full-time Instruction/research/public service, Non-tenured not on tenure track, Professors","1","1","0","0","0","0","0","0","0","0","0","0","0","0","0","0","0","0","1","1","0","0","0","0","0","0","0","0","0","0","-2"
"181738","Union College","2011","Total full-time Instruction/research/public service, Non-tenured not on tenure track, Associate professors","6","2","4","0","0","0","0","0","0","0","0","0","0","0","0","0","0","0","6","2","4","0","0","0","0","0","0","0","0","0","-2"
"181738","Union College","2011","Total full-time Instruction/research/public servicey, Non-tenured not on tenure track, Assistant professors","11","5","6","0","0","0","0","0","0","0","0","0","0","0","0","0","0","0","11","5","6","0","0","0","0","0","0","0","0","0","-2"
"181738","Union College","2011","Total full-time Instruction/research/public service, Non-tenured not on tenure track, Instructors","2","1","1","0","0","0","0","0","0","0","0","0","0","0","0","0","0","0","2","1","1","0","0","0","0","0","0","0","0","0","-2"
"181738","Union College","2011","Total full-time Instruction/research/public service, Non-tenured not on tenure track, Lecturers","3","2","1","0","0","0","0","0","0","0","0","0","0","0","0","0","0","0","3","2","1","0","0","0","0","0","0","0","0","0","-2"
"181738","Union College","2011","Total full-time Instruction/research/public service, Non-tenured not on tenure track, No academic rank","1","0","1","0","0","0","0","0","0","0","0","0","0","0","0","0","0","0","1","0","1","0","0","0","0","0","0","0","0","0","-2"
"181738","Union College","2011","Total full-time Instruction/research/public service, Non-tenured not on tenure track total","24","11","13","0","0","0","0","0","0","0","0","0","0","0","0","0","0","0","24","11","13","0","0","0","0","0","0","0","0","0","-2"
"181853","York College","2011","Total full-time Instruction/research/public service, Tenured, Professors","5","4","1","0","0","0","0","0","0","0","0","0","0","0","0","0","0","0","5","4","1","0","0","0","0","0","0","0","0","0","-2"
"181853","York College","2011","Total full-time Instruction/research/public service, Tenured, Associate professors","8","5","3","0","0","0","0","0","0","0","0","0","0","0","0","0","0","0","7","4","3","0","0","0","1","1","0","0","0","0","-2"
"181853","York College","2011","Total full-time Instruction/research/public service, Tenured total","13","9","4","0","0","0","0","0","0","0","0","0","0","0","0","0","0","0","12","8","4","0","0","0","1","1","0","0","0","0","-2"
"181853","York College","2011","Total full-time Instruction/research/public service, Non-tenured on tenure track, Associate professors","5","5","0","0","0","0","0","0","0","1","1","0","0","0","0","0","0","0","4","4","0","0","0","0","0","0","0","0","0","0","-2"
"181853","York College","2011","Total full-time Instruction/research/public service, Non-tenured on tenure track, Assistant professors","4","2","2","0","0","0","0","0","0","0","0","0","0","0","0","0","0","0","4","2","2","0","0","0","0","0","0","0","0","0","-2"
"181853","York College","2011","Total full-time Instruction/research/public service, Non-tenured on tenure track total","9","7","2","0","0","0","0","0","0","1","1","0","0","0","0","0","0","0","8","6","2","0","0","0","0","0","0","0","0","0","-2"
"181853","York College","2011","Total full-time Instruction/research/public servicey, Non-tenured not on tenure track, Assistant professors","1","0","1","0","0","0","0","0","0","0","0","0","0","0","0","0","0","0","1","0","1","0","0","0","0","0","0","0","0","0","-2"
"181853","York College","2011","Total full-time Instruction/research/public service, Non-tenured not on tenure track total","1","0","1","0","0","0","0","0","0","0","0","0","0","0","0","0","0","0","1","0","1","0","0","0","0","0","0","0","0","0","-2"
"182306","Great Basin College","2011","Total full-time Instruction/research/public service, Tenured, Professors","39","20","19","0","0","0","1","1","0","1","0","1","3","2","1","0","0","0","34","17","17","0","0","0","0","0","0","0","0","0","-2"
"182306","Great Basin College","2011","Total full-time Instruction/research/public service, Tenured total","39","20","19","0","0","0","1","1","0","1","0","1","3","2","1","0","0","0","34","17","17","0","0","0","0","0","0","0","0","0","-2"
"182306","Great Basin College","2011","Total full-time Instruction/research/public service, Non-tenured on tenure track, Instructors","8","5","3","0","0","0","0","0","0","0","0","0","0","0","0","0","0","0","8","5","3","0","0","0","0","0","0","0","0","0","-2"
"182306","Great Basin College","2011","Total full-time Instruction/research/public service, Non-tenured on tenure track total","8","5","3","0","0","0","0","0","0","0","0","0","0","0","0","0","0","0","8","5","3","0","0","0","0","0","0","0","0","0","-2"
"182306","Great Basin College","2011","Total full-time Instruction/research/public service, Non-tenured not on tenure track, Instructors","17","9","8","0","0","0","0","0","0","0","0","0","0","0","0","0","0","0","17","9","8","0","0","0","0","0","0","0","0","0","-2"
"182306","Great Basin College","2011","Total full-time Instruction/research/public service, Non-tenured not on tenure track total","17","9","8","0","0","0","0","0","0","0","0","0","0","0","0","0","0","0","17","9","8","0","0","0","0","0","0","0","0","0","-2"
"182564","Western Nevada College","2011","Total full-time Instruction/research/public service, Tenured, Professors","42","24","18","0","0","0","0","0","0","0","0","0","2","2","0","0","0","0","40","22","18","0","0","0","0","0","0","0","0","0","-2"
"182564","Western Nevada College","2011","Total full-time Instruction/research/public service, Tenured total","42","24","18","0","0","0","0","0","0","0","0","0","2","2","0","0","0","0","40","22","18","0","0","0","0","0","0","0","0","0","-2"
"182564","Western Nevada College","2011","Total full-time Instruction/research/public service, Non-tenured on tenure track, Instructors","5","4","1","0","0","0","0","0","0","0","0","0","2","1","1","0","0","0","3","3","0","0","0","0","0","0","0","0","0","0","-2"
"182564","Western Nevada College","2011","Total full-time Instruction/research/public service, Non-tenured on tenure track total","5","4","1","0","0","0","0","0","0","0","0","0","2","1","1","0","0","0","3","3","0","0","0","0","0","0","0","0","0","0","-2"
"182564","Western Nevada College","2011","Total full-time Instruction/research/public service, Non-tenured not on tenure track, Instructors","2","1","1","0","0","0","0","0","0","0","0","0","0","0","0","0","0","0","2","1","1","0","0","0","0","0","0","0","0","0","-2"
"182564","Western Nevada College","2011","Total full-time Instruction/research/public service, Non-tenured not on tenure track total","2","1","1","0","0","0","0","0","0","0","0","0","0","0","0","0","0","0","2","1","1","0","0","0","0","0","0","0","0","0","-2"
"183974","Centenary University","2011","Total full-time Instruction/research/public service, Tenured, Professors","3","1","2","0","0","0","1","0","1","0","0","0","0","0","0","0","0","0","2","1","1","0","0","0","0","0","0","0","0","0","-2"
"183974","Centenary University","2011","Total full-time Instruction/research/public service, Tenured, Associate professors","5","5","0","0","0","0","0","0","0","0","0","0","0","0","0","0","0","0","5","5","0","0","0","0","0","0","0","0","0","0","-2"
"183974","Centenary University","2011","Total full-time Instruction/research/public service, Tenured total","8","6","2","0","0","0","1","0","1","0","0","0","0","0","0","0","0","0","7","6","1","0","0","0","0","0","0","0","0","0","-2"
"183974","Centenary University","2011","Total full-time Instruction/research/public service, Non-tenured on tenure track, Associate professors","1","0","1","0","0","0","0","0","0","0","0","0","0","0","0","0","0","0","1","0","1","0","0","0","0","0","0","0","0","0","-2"
"183974","Centenary University","2011","Total full-time Instruction/research/public service, Non-tenured on tenure track, Assistant professors","4","3","1","0","0","0","0","0","0","0","0","0","0","0","0","0","0","0","4","3","1","0","0","0","0","0","0","0","0","0","-2"
"183974","Centenary University","2011","Total full-time Instruction/research/public service, Non-tenured on tenure track total","5","3","2","0","0","0","0","0","0","0","0","0","0","0","0","0","0","0","5","3","2","0","0","0","0","0","0","0","0","0","-2"
"183974","Centenary University","2011","Total full-time Instruction/research/public service, Non-tenured not on tenure track, Professors","1","0","1","0","0","0","0","0","0","0","0","0","0","0","0","0","0","0","1","0","1","0","0","0","0","0","0","0","0","0","-2"
"183974","Centenary University","2011","Total full-time Instruction/research/public service, Non-tenured not on tenure track, Associate professors","16","4","12","0","0","0","0","0","0","1","0","1","0","0","0","0","0","0","15","4","11","0","0","0","0","0","0","0","0","0","-2"
"183974","Centenary University","2011","Total full-time Instruction/research/public servicey, Non-tenured not on tenure track, Assistant professors","40","18","22","0","0","0","1","0","1","2","1","1","0","0","0","0","0","0","37","17","20","0","0","0","0","0","0","0","0","0","-2"
"183974","Centenary University","2011","Total full-time Instruction/research/public service, Non-tenured not on tenure track, Instructors","5","2","3","0","0","0","0","0","0","0","0","0","0","0","0","0","0","0","5","2","3","0","0","0","0","0","0","0","0","0","-2"
"183974","Centenary University","2011","Total full-time Instruction/research/public service, Non-tenured not on tenure track total","62","24","38","0","0","0","1","0","1","3","1","2","0","0","0","0","0","0","58","23","35","0","0","0","0","0","0","0","0","0","-2"
"184348","Drew University","2011","Total full-time Instruction/research/public service, Tenured, Professors","56","29","27","0","0","0","2","2","0","2","0","2","2","1","1","0","0","0","50","26","24","0","0","0","0","0","0","0","0","0","-2"
"184348","Drew University","2011","Total full-time Instruction/research/public service, Tenured, Associate professors","52","28","24","0","0","0","3","1","2","4","2","2","4","2","2","0","0","0","39","21","18","0","0","0","0","0","0","2","2","0","-2"
"184348","Drew University","2011","Total full-time Instruction/research/public service, Tenured total","108","57","51","0","0","0","5","3","2","6","2","4","6","3","3","0","0","0","89","47","42","0","0","0","0","0","0","2","2","0","-2"
"184348","Drew University","2011","Total full-time Instruction/research/public service, Non-tenured on tenure track, Associate professors","1","0","1","0","0","0","0","0","0","0","0","0","0","0","0","0","0","0","1","0","1","0","0","0","0","0","0","0","0","0","-2"
"184348","Drew University","2011","Total full-time Instruction/research/public service, Non-tenured on tenure track, Assistant professors","40","19","21","0","0","0","7","2","5","3","2","1","4","3","1","0","0","0","22","9","13","0","0","0","1","1","0","3","2","1","-2"
"184348","Drew University","2011","Total full-time Instruction/research/public service, Non-tenured on tenure track total","41","19","22","0","0","0","7","2","5","3","2","1","4","3","1","0","0","0","23","9","14","0","0","0","1","1","0","3","2","1","-2"
"184348","Drew University","2011","Total full-time Instruction/research/public service, Non-tenured not on tenure track, Professors","1","1","0","0","0","0","0","0","0","0","0","0","0","0","0","0","0","0","1","1","0","0","0","0","0","0","0","0","0","0","-2"
"184348","Drew University","2011","Total full-time Instruction/research/public service, Non-tenured not on tenure track, Associate professors","1","0","1","0","0","0","0","0","0","0","0","0","0","0","0","0","0","0","1","0","1","0","0","0","0","0","0","0","0","0","-2"
"184348","Drew University","2011","Total full-time Instruction/research/public servicey, Non-tenured not on tenure track, Assistant professors","14","3","11","0","0","0","1","0","1","1","1","0","1","0","1","0","0","0","10","1","9","0","0","0","1","1","0","0","0","0","-2"
"184348","Drew University","2011","Total full-time Instruction/research/public service, Non-tenured not on tenure track, Instructors","4","1","3","0","0","0","0","0","0","1","1","0","0","0","0","0","0","0","1","0","1","0","0","0","2","0","2","0","0","0","-2"
"184348","Drew University","2011","Total full-time Instruction/research/public service, Non-tenured not on tenure track total","20","5","15","0","0","0","1","0","1","2","2","0","1","0","1","0","0","0","13","2","11","0","0","0","3","1","2","0","0","0","-2"
"184694","Fairleigh Dickinson University-Florham Campus","2011","Total full-time Instruction/research/public service, Tenured, Professors","32","25","7","0","0","0","5","4","1","0","0","0","1","0","1","0","0","0","26","21","5","0","0","0","0","0","0","0","0","0","-2"
"184694","Fairleigh Dickinson University-Florham Campus","2011","Total full-time Instruction/research/public service, Tenured, Associate professors","27","16","11","0","0","0","3","1","2","2","1","1","1","1","0","0","0","0","21","13","8","0","0","0","0","0","0","0","0","0","-2"
"184694","Fairleigh Dickinson University-Florham Campus","2011","Total full-time Instruction/research/public service, Tenured, Assistant professors","3","3","0","0","0","0","1","1","0","0","0","0","0","0","0","0","0","0","2","2","0","0","0","0","0","0","0","0","0","0","-2"
"184694","Fairleigh Dickinson University-Florham Campus","2011","Total full-time Instruction/research/public service, Tenured total","62","44","18","0","0","0","9","6","3","2","1","1","2","1","1","0","0","0","49","36","13","0","0","0","0","0","0","0","0","0","-2"
"184694","Fairleigh Dickinson University-Florham Campus","2011","Total full-time Instruction/research/public service, Non-tenured on tenure track, Professors","1","1","0","0","0","0","0","0","0","0","0","0","0","0","0","0","0","0","1","1","0","0","0","0","0","0","0","0","0","0","-2"
"184694","Fairleigh Dickinson University-Florham Campus","2011","Total full-time Instruction/research/public service, Non-tenured on tenure track, Associate professors","11","7","4","0","0","0","1","1","0","0","0","0","0","0","0","0","0","0","10","6","4","0","0","0","0","0","0","0","0","0","-2"
"184694","Fairleigh Dickinson University-Florham Campus","2011","Total full-time Instruction/research/public service, Non-tenured on tenure track, Assistant professors","34","15","19","0","0","0","0","0","0","0","0","0","3","1","2","0","0","0","29","12","17","0","0","0","2","2","0","0","0","0","-2"
"184694","Fairleigh Dickinson University-Florham Campus","2011","Total full-time Instruction/research/public service, Non-tenured on tenure track, Instructors","1","1","0","0","0","0","0","0","0","0","0","0","0","0","0","0","0","0","1","1","0","0","0","0","0","0","0","0","0","0","-2"
"184694","Fairleigh Dickinson University-Florham Campus","2011","Total full-time Instruction/research/public service, Non-tenured on tenure track total","47","24","23","0","0","0","1","1","0","0","0","0","3","1","2","0","0","0","41","20","21","0","0","0","2","2","0","0","0","0","-2"
"184694","Fairleigh Dickinson University-Florham Campus","2011","Total full-time Instruction/research/public service, Non-tenured not on tenure track, Lecturers","22","8","14","0","0","0","1","0","1","3","1","2","2","0","2","0","0","0","16","7","9","0","0","0","0","0","0","0","0","0","-2"
"184694","Fairleigh Dickinson University-Florham Campus","2011","Total full-time Instruction/research/public service, Non-tenured not on tenure track total","22","8","14","0","0","0","1","0","1","3","1","2","2","0","2","0","0","0","16","7","9","0","0","0","0","0","0","0","0","0","-2"
"185828","New Jersey Institute of Technology","2011","Total full-time Instruction/research/public service, Tenured, Professors","137","123","14","1","1","0","32","32","0","4","3","1","1","1","0","0","0","0","92","80","12","0","0","0","6","5","1","1","1","0","-2"
"185828","New Jersey Institute of Technology","2011","Total full-time Instruction/research/public service, Tenured, Associate professors","95","77","18","0","0","0","20","16","4","7","5","2","2","2","0","0","0","0","56","46","10","0","0","0","9","8","1","1","0","1","-2"
"185828","New Jersey Institute of Technology","2011","Total full-time Instruction/research/public service, Tenured total","232","200","32","1","1","0","52","48","4","11","8","3","3","3","0","0","0","0","148","126","22","0","0","0","15","13","2","2","1","1","-2"
"185828","New Jersey Institute of Technology","2011","Total full-time Instruction/research/public service, Non-tenured on tenure track, Associate professors","2","1","1","0","0","0","0","0","0","0","0","0","0","0","0","0","0","0","1","1","0","0","0","0","0","0","0","1","0","1","-2"
"185828","New Jersey Institute of Technology","2011","Total full-time Instruction/research/public service, Non-tenured on tenure track, Assistant professors","33","27","6","0","0","0","10","6","4","0","0","0","0","0","0","0","0","0","14","13","1","1","1","0","0","0","0","8","7","1","-2"
"185828","New Jersey Institute of Technology","2011","Total full-time Instruction/research/public service, Non-tenured on tenure track total","35","28","7","0","0","0","10","6","4","0","0","0","0","0","0","0","0","0","15","14","1","1","1","0","0","0","0","9","7","2","-2"
"185828","New Jersey Institute of Technology","2011","Total full-time Instruction/research/public service, Non-tenured not on tenure track, Instructors","6","4","2","0","0","0","0","0","0","0","0","0","0","0","0","0","0","0","6","4","2","0","0","0","0","0","0","0","0","0","-2"
"185828","New Jersey Institute of Technology","2011","Total full-time Instruction/research/public service, Non-tenured not on tenure track, Lecturers","94","65","29","0","0","0","11","9","2","4","3","1","3","2","1","0","0","0","65","40","25","1","1","0","7","7","0","3","3","0","-2"
"185828","New Jersey Institute of Technology","2011","Total full-time Instruction/research/public service, Non-tenured not on tenure track, No academic rank","22","20","2","0","0","0","2","2","0","1","1","0","0","0","0","0","0","0","11","10","1","0","0","0","3","3","0","5","4","1","-2"
"185828","New Jersey Institute of Technology","2011","Total full-time Instruction/research/public service, Non-tenured not on tenure track total","122","89","33","0","0","0","13","11","2","5","4","1","3","2","1","0","0","0","82","54","28","1","1","0","10","10","0","8","7","1","-2"
"186201","Ramapo College of New Jersey","2011","Total full-time Instruction/research/public service, Tenured, Professors","69","39","30","0","0","0","4","4","0","3","2","1","3","0","3","0","0","0","59","33","26","0","0","0","0","0","0","0","0","0","-2"
"186201","Ramapo College of New Jersey","2011","Total full-time Instruction/research/public service, Tenured, Associate professors","58","28","30","0","0","0","4","2","2","4","3","1","5","1","4","0","0","0","41","20","21","3","2","1","1","0","1","0","0","0","-2"
"186201","Ramapo College of New Jersey","2011","Total full-time Instruction/research/public service, Tenured, Assistant professors","10","8","2","0","0","0","0","0","0","2","2","0","3","2","1","0","0","0","3","2","1","1","1","0","0","0","0","1","1","0","-2"
"186201","Ramapo College of New Jersey","2011","Total full-time Instruction/research/public service, Tenured total","137","75","62","0","0","0","8","6","2","9","7","2","11","3","8","0","0","0","103","55","48","4","3","1","1","0","1","1","1","0","-2"
"186201","Ramapo College of New Jersey","2011","Total full-time Instruction/research/public service, Non-tenured on tenure track, Professors","1","0","1","0","0","0","0","0","0","1","0","1","0","0","0","0","0","0","0","0","0","0","0","0","0","0","0","0","0","0","-2"
"186201","Ramapo College of New Jersey","2011","Total full-time Instruction/research/public service, Non-tenured on tenure track, Associate professors","9","5","4","0","0","0","3","2","1","0","0","0","1","0","1","0","0","0","5","3","2","0","0","0","0","0","0","0","0","0","-2"
"186201","Ramapo College of New Jersey","2011","Total full-time Instruction/research/public service, Non-tenured on tenure track, Assistant professors","59","26","33","0","0","0","6","3","3","3","1","2","3","1","2","0","0","0","40","20","20","2","0","2","0","0","0","5","1","4","-2"
"186201","Ramapo College of New Jersey","2011","Total full-time Instruction/research/public service, Non-tenured on tenure track, Instructors","2","0","2","0","0","0","0","0","0","0","0","0","1","0","1","0","0","0","1","0","1","0","0","0","0","0","0","0","0","0","-2"
"186201","Ramapo College of New Jersey","2011","Total full-time Instruction/research/public service, Non-tenured on tenure track total","71","31","40","0","0","0","9","5","4","4","1","3","5","1","4","0","0","0","46","23","23","2","0","2","0","0","0","5","1","4","-2"
"186201","Ramapo College of New Jersey","2011","Total full-time Instruction/research/public servicey, Non-tenured not on tenure track, Assistant professors","8","4","4","0","0","0","0","0","0","0","0","0","2","0","2","0","0","0","6","4","2","0","0","0","0","0","0","0","0","0","-2"
"186201","Ramapo College of New Jersey","2011","Total full-time Instruction/research/public service, Non-tenured not on tenure track total","8","4","4","0","0","0","0","0","0","0","0","0","2","0","2","0","0","0","6","4","2","0","0","0","0","0","0","0","0","0","-2"
"186283","Rider University","2011","Total full-time Instruction/research/public service, Tenured, Professors","92","55","37","0","0","0","6","4","2","3","2","1","1","0","1","0","0","0","82","49","33","0","0","0","0","0","0","0","0","0","-2"
"186283","Rider University","2011","Total full-time Instruction/research/public service, Tenured, Associate professors","86","47","39","0","0","0","13","8","5","2","0","2","2","2","0","0","0","0","69","37","32","0","0","0","0","0","0","0","0","0","-2"
"186283","Rider University","2011","Total full-time Instruction/research/public service, Tenured total","178","102","76","0","0","0","19","12","7","5","2","3","3","2","1","0","0","0","151","86","65","0","0","0","0","0","0","0","0","0","-2"
"186283","Rider University","2011","Total full-time Instruction/research/public service, Non-tenured on tenure track, Professors","1","1","0","0","0","0","0","0","0","0","0","0","0","0","0","0","0","0","1","1","0","0","0","0","0","0","0","0","0","0","-2"
"186283","Rider University","2011","Total full-time Instruction/research/public service, Non-tenured on tenure track, Associate professors","3","2","1","0","0","0","0","0","0","0","0","0","0","0","0","0","0","0","3","2","1","0","0","0","0","0","0","0","0","0","-2"
"186283","Rider University","2011","Total full-time Instruction/research/public service, Non-tenured on tenure track, Assistant professors","48","21","27","0","0","0","4","1","3","1","0","1","2","0","2","0","0","0","37","18","19","0","0","0","0","0","0","4","2","2","-2"
"186283","Rider University","2011","Total full-time Instruction/research/public service, Non-tenured on tenure track total","52","24","28","0","0","0","4","1","3","1","0","1","2","0","2","0","0","0","41","21","20","0","0","0","0","0","0","4","2","2","-2"
"186283","Rider University","2011","Total full-time Instruction/research/public service, Non-tenured not on tenure track, Professors","3","3","0","0","0","0","1","1","0","0","0","0","0","0","0","0","0","0","2","2","0","0","0","0","0","0","0","0","0","0","-2"
"186283","Rider University","2011","Total full-time Instruction/research/public servicey, Non-tenured not on tenure track, Assistant professors","4","3","1","0","0","0","0","0","0","0","0","0","0","0","0","0","0","0","4","3","1","0","0","0","0","0","0","0","0","0","-2"
"186283","Rider University","2011","Total full-time Instruction/research/public service, Non-tenured not on tenure track, Instructors","1","1","0","0","0","0","0","0","0","0","0","0","0","0","0","0","0","0","1","1","0","0","0","0","0","0","0","0","0","0","-2"
"186283","Rider University","2011","Total full-time Instruction/research/public service, Non-tenured not on tenure track, Lecturers","1","1","0","0","0","0","0","0","0","0","0","0","0","0","0","0","0","0","1","1","0","0","0","0","0","0","0","0","0","0","-2"
"186283","Rider University","2011","Total full-time Instruction/research/public service, Non-tenured not on tenure track total","9","8","1","0","0","0","1","1","0","0","0","0","0","0","0","0","0","0","8","7","1","0","0","0","0","0","0","0","0","0","-2"
"186371","Rutgers University-Camden","2011","Total full-time Instruction/research/public service, Tenured, Professors","94","72","22","0","0","0","11","11","0","0","0","0","2","1","1","0","0","0","76","55","21","0","0","0","1","1","0","4","4","0","-2"
"186371","Rutgers University-Camden","2011","Total full-time Instruction/research/public service, Tenured, Associate professors","81","43","38","1","0","1","13","12","1","3","1","2","2","2","0","0","0","0","55","27","28","1","1","0","1","0","1","5","0","5","-2"
"186371","Rutgers University-Camden","2011","Total full-time Instruction/research/public service, Tenured total","175","115","60","1","0","1","24","23","1","3","1","2","4","3","1","0","0","0","131","82","49","1","1","0","2","1","1","9","4","5","-2"
"186371","Rutgers University-Camden","2011","Total full-time Instruction/research/public service, Non-tenured on tenure track, Professors","3","2","1","0","0","0","0","0","0","0","0","0","0","0","0","0","0","0","1","1","0","0","0","0","2","1","1","0","0","0","-2"
"186371","Rutgers University-Camden","2011","Total full-time Instruction/research/public service, Non-tenured on tenure track, Associate professors","4","3","1","0","0","0","0","0","0","0","0","0","0","0","0","0","0","0","0","0","0","0","0","0","2","1","1","2","2","0","-2"
"186371","Rutgers University-Camden","2011","Total full-time Instruction/research/public service, Non-tenured on tenure track, Assistant professors","53","32","21","0","0","0","3","3","0","4","3","1","2","2","0","0","0","0","26","13","13","0","0","0","16","9","7","2","2","0","-2"
"186371","Rutgers University-Camden","2011","Total full-time Instruction/research/public service, Non-tenured on tenure track total","60","37","23","0","0","0","3","3","0","4","3","1","2","2","0","0","0","0","27","14","13","0","0","0","20","11","9","4","4","0","-2"
"186371","Rutgers University-Camden","2011","Total full-time Instruction/research/public service, Non-tenured not on tenure track, Professors","10","4","6","0","0","0","0","0","0","0","0","0","0","0","0","0","0","0","10","4","6","0","0","0","0","0","0","0","0","0","-2"
"186371","Rutgers University-Camden","2011","Total full-time Instruction/research/public service, Non-tenured not on tenure track, Associate professors","8","2","6","0","0","0","0","0","0","0","0","0","1","0","1","0","0","0","7","2","5","0","0","0","0","0","0","0","0","0","-2"
"186371","Rutgers University-Camden","2011","Total full-time Instruction/research/public servicey, Non-tenured not on tenure track, Assistant professors","7","4","3","0","0","0","0","0","0","1","0","1","0","0","0","0","0","0","4","2","2","0","0","0","2","2","0","0","0","0","-2"
"186371","Rutgers University-Camden","2011","Total full-time Instruction/research/public service, Non-tenured not on tenure track, Instructors","19","7","12","0","0","0","2","1","1","1","0","1","0","0","0","0","0","0","15","6","9","0","0","0","1","0","1","0","0","0","-2"
"186371","Rutgers University-Camden","2011","Total full-time Instruction/research/public service, Non-tenured not on tenure track, Lecturers","2","1","1","0","0","0","1","0","1","0","0","0","0","0","0","0","0","0","0","0","0","0","0","0","1","1","0","0","0","0","-2"
"186371","Rutgers University-Camden","2011","Total full-time Instruction/research/public service, Non-tenured not on tenure track, No academic rank","2","1","1","0","0","0","0","0","0","0","0","0","0","0","0","0","0","0","0","0","0","0","0","0","2","1","1","0","0","0","-2"
"186371","Rutgers University-Camden","2011","Total full-time Instruction/research/public service, Non-tenured not on tenure track total","48","19","29","0","0","0","3","1","2","2","0","2","1","0","1","0","0","0","36","14","22","0","0","0","6","4","2","0","0","0","-2"
"186584","Seton Hall University","2011","Total full-time Instruction/research/public service, Tenured, Professors","107","67","40","0","0","0","8","5","3","6","5","1","4","3","1","0","0","0","88","53","35","0","0","0","0","0","0","1","1","0","-2"
"186584","Seton Hall University","2011","Total full-time Instruction/research/public service, Tenured, Associate professors","130","74","56","0","0","0","14","9","5","6","3","3","3","2","1","0","0","0","104","58","46","0","0","0","1","0","1","2","2","0","-2"
"186584","Seton Hall University","2011","Total full-time Instruction/research/public service, Tenured, Assistant professors","4","3","1","0","0","0","0","0","0","0","0","0","0","0","0","0","0","0","4","3","1","0","0","0","0","0","0","0","0","0","-2"
"186584","Seton Hall University","2011","Total full-time Instruction/research/public service, Tenured total","241","144","97","0","0","0","22","14","8","12","8","4","7","5","2","0","0","0","196","114","82","0","0","0","1","0","1","3","3","0","-2"
"186584","Seton Hall University","2011","Total full-time Instruction/research/public service, Non-tenured on tenure track, Associate professors","16","6","10","0","0","0","0","0","0","2","1","1","0","0","0","0","0","0","13","4","9","0","0","0","1","1","0","0","0","0","-2"
"186584","Seton Hall University","2011","Total full-time Instruction/research/public service, Non-tenured on tenure track, Assistant professors","65","30","35","0","0","0","5","1","4","3","0","3","2","2","0","0","0","0","46","22","24","0","0","0","2","1","1","7","4","3","-2"
"186584","Seton Hall University","2011","Total full-time Instruction/research/public service, Non-tenured on tenure track total","81","36","45","0","0","0","5","1","4","5","1","4","2","2","0","0","0","0","59","26","33","0","0","0","3","2","1","7","4","3","-2"
"186584","Seton Hall University","2011","Total full-time Instruction/research/public service, Non-tenured not on tenure track, Professors","5","3","2","0","0","0","0","0","0","0","0","0","0","0","0","0","0","0","5","3","2","0","0","0","0","0","0","0","0","0","-2"
"186584","Seton Hall University","2011","Total full-time Instruction/research/public service, Non-tenured not on tenure track, Associate professors","20","8","12","0","0","0","3","2","1","0","0","0","1","0","1","0","0","0","14","4","10","0","0","0","0","0","0","2","2","0","-2"
"186584","Seton Hall University","2011","Total full-time Instruction/research/public servicey, Non-tenured not on tenure track, Assistant professors","38","15","23","0","0","0","1","1","0","2","1","1","1","0","1","0","0","0","34","13","21","0","0","0","0","0","0","0","0","0","-2"
"186584","Seton Hall University","2011","Total full-time Instruction/research/public service, Non-tenured not on tenure track, Instructors","20","9","11","0","0","0","0","0","0","1","0","1","1","0","1","0","0","0","17","8","9","0","0","0","1","1","0","0","0","0","-2"
"186584","Seton Hall University","2011","Total full-time Instruction/research/public service, Non-tenured not on tenure track, No academic rank","51","19","32","1","1","0","2","0","2","2","0","2","2","1","1","0","0","0","43","17","26","0","0","0","0","0","0","1","0","1","-2"
"186584","Seton Hall University","2011","Total full-time Instruction/research/public service, Non-tenured not on tenure track total","134","54","80","1","1","0","6","3","3","5","1","4","5","1","4","0","0","0","113","45","68","0","0","0","1","1","0","3","2","1","-2"
"188429","Adelphi University","2011","Total full-time Instruction/research/public service, Tenured, Professors","76","55","21","0","0","0","6","3","3","3","2","1","2","1","1","0","0","0","65","49","16","0","0","0","0","0","0","0","0","0","-2"
"188429","Adelphi University","2011","Total full-time Instruction/research/public service, Tenured, Associate professors","103","45","58","0","0","0","7","4","3","8","2","6","3","2","1","0","0","0","85","37","48","0","0","0","0","0","0","0","0","0","-2"
"188429","Adelphi University","2011","Total full-time Instruction/research/public service, Tenured, Assistant professors","3","2","1","0","0","0","0","0","0","0","0","0","0","0","0","0","0","0","3","2","1","0","0","0","0","0","0","0","0","0","-2"
"188429","Adelphi University","2011","Total full-time Instruction/research/public service, Tenured total","182","102","80","0","0","0","13","7","6","11","4","7","5","3","2","0","0","0","153","88","65","0","0","0","0","0","0","0","0","0","-2"
"188429","Adelphi University","2011","Total full-time Instruction/research/public service, Non-tenured on tenure track, Associate professors","14","4","10","0","0","0","1","0","1","1","0","1","2","2","0","0","0","0","10","2","8","0","0","0","0","0","0","0","0","0","-2"
"188429","Adelphi University","2011","Total full-time Instruction/research/public service, Non-tenured on tenure track, Assistant professors","90","35","55","0","0","0","15","3","12","6","1","5","3","0","3","0","0","0","66","31","35","0","0","0","0","0","0","0","0","0","-2"
"188429","Adelphi University","2011","Total full-time Instruction/research/public service, Non-tenured on tenure track, Lecturers","5","4","1","0","0","0","0","0","0","0","0","0","0","0","0","0","0","0","5","4","1","0","0","0","0","0","0","0","0","0","-2"
"188429","Adelphi University","2011","Total full-time Instruction/research/public service, Non-tenured on tenure track total","109","43","66","0","0","0","16","3","13","7","1","6","5","2","3","0","0","0","81","37","44","0","0","0","0","0","0","0","0","0","-2"
"188429","Adelphi University","2011","Total full-time Instruction/research/public service, Non-tenured not on tenure track, No academic rank","25","5","20","0","0","0","0","0","0","2","1","1","1","0","1","0","0","0","22","4","18","0","0","0","0","0","0","0","0","0","-2"
"188429","Adelphi University","2011","Total full-time Instruction/research/public service, Non-tenured not on tenure track total","25","5","20","0","0","0","0","0","0","2","1","1","1","0","1","0","0","0","22","4","18","0","0","0","0","0","0","0","0","0","-2"
"188854","American Musical and Dramatic Academy","2011","Total full-time Instruction/research/public service, Non-tenured not on tenure track, Instructors","5","3","2","0","0","0","0","0","0","0","0","0","0","0","0","0","0","0","5","3","2","0","0","0","0","0","0","0","0","0","-2"
"188854","American Musical and Dramatic Academy","2011","Total full-time Instruction/research/public service, Non-tenured not on tenure track total","5","3","2","0","0","0","0","0","0","0","0","0","0","0","0","0","0","0","5","3","2","0","0","0","0","0","0","0","0","0","-2"
"190248","Concordia College","2011","Total full-time Instruction/research/public service, Tenured, Associate professors","1","1","0","0","0","0","0","0","0","0","0","0","0","0","0","0","0","0","1","1","0","0","0","0","0","0","0","0","0","0","-2"
"190248","Concordia College","2011","Total full-time Instruction/research/public service, Tenured total","1","1","0","0","0","0","0","0","0","0","0","0","0","0","0","0","0","0","1","1","0","0","0","0","0","0","0","0","0","0","-2"
"190248","Concordia College","2011","Total full-time Instruction/research/public service, Non-tenured not on tenure track, Professors","10","4","6","0","0","0","1","1","0","1","0","1","0","0","0","0","0","0","8","3","5","0","0","0","0","0","0","0","0","0","-2"
"190248","Concordia College","2011","Total full-time Instruction/research/public service, Non-tenured not on tenure track, Associate professors","13","7","6","0","0","0","0","0","0","0","0","0","0","0","0","0","0","0","13","7","6","0","0","0","0","0","0","0","0","0","-2"
"190248","Concordia College","2011","Total full-time Instruction/research/public servicey, Non-tenured not on tenure track, Assistant professors","10","2","8","0","0","0","1","0","1","0","0","0","0","0","0","0","0","0","9","2","7","0","0","0","0","0","0","0","0","0","-2"
"190248","Concordia College","2011","Total full-time Instruction/research/public service, Non-tenured not on tenure track, Instructors","5","1","4","0","0","0","0","0","0","0","0","0","0","0","0","0","0","0","5","1","4","0","0","0","0","0","0","0","0","0","-2"
"190248","Concordia College","2011","Total full-time Instruction/research/public service, Non-tenured not on tenure track total","38","14","24","0","0","0","2","1","1","1","0","1","0","0","0","0","0","0","35","13","22","0","0","0","0","0","0","0","0","0","-2"
"190503","Culinary Institute of America","2011","Total full-time Instruction/research/public service, Non-tenured not on tenure track, Professors","15","11","4","0","0","0","1","0","1","0","0","0","1","0","1","0","0","0","13","11","2","0","0","0","0","0","0","0","0","0","-2"
"190503","Culinary Institute of America","2011","Total full-time Instruction/research/public service, Non-tenured not on tenure track, Associate professors","50","38","12","0","0","0","0","0","0","1","0","1","1","1","0","0","0","0","45","37","8","0","0","0","3","0","3","0","0","0","-2"
"190503","Culinary Institute of America","2011","Total full-time Instruction/research/public servicey, Non-tenured not on tenure track, Assistant professors","40","29","11","0","0","0","0","0","0","1","1","0","2","1","1","0","0","0","34","24","10","0","0","0","3","3","0","0","0","0","-2"
"190503","Culinary Institute of America","2011","Total full-time Instruction/research/public service, Non-tenured not on tenure track, Lecturers","50","39","11","0","0","0","3","2","1","1","1","0","0","0","0","1","1","0","30","24","6","2","2","0","13","9","4","0","0","0","-2"
"190503","Culinary Institute of America","2011","Total full-time Instruction/research/public service, Non-tenured not on tenure track total","155","117","38","0","0","0","4","2","2","3","2","1","4","2","2","1","1","0","122","96","26","2","2","0","19","12","7","0","0","0","-2"
"190512","CUNY Bernard M Baruch College","2011","Total full-time Instruction/research/public service, Tenured, Professors","183","130","53","0","0","0","23","19","4","5","3","2","10","4","6","0","0","0","145","104","41","0","0","0","0","0","0","0","0","0","-2"
"190512","CUNY Bernard M Baruch College","2011","Total full-time Instruction/research/public service, Tenured, Associate professors","139","80","59","0","0","0","17","14","3","12","5","7","6","2","4","0","0","0","99","55","44","0","0","0","0","0","0","5","4","1","-2"
"190512","CUNY Bernard M Baruch College","2011","Total full-time Instruction/research/public service, Tenured, Assistant professors","8","5","3","0","0","0","1","1","0","0","0","0","0","0","0","0","0","0","7","4","3","0","0","0","0","0","0","0","0","0","-2"
"190512","CUNY Bernard M Baruch College","2011","Total full-time Instruction/research/public service, Tenured, Lecturers","15","8","7","0","0","0","1","1","0","3","1","2","0","0","0","0","0","0","11","6","5","0","0","0","0","0","0","0","0","0","-2"
"190512","CUNY Bernard M Baruch College","2011","Total full-time Instruction/research/public service, Tenured total","345","223","122","0","0","0","42","35","7","20","9","11","16","6","10","0","0","0","262","169","93","0","0","0","0","0","0","5","4","1","-2"
"190512","CUNY Bernard M Baruch College","2011","Total full-time Instruction/research/public service, Non-tenured on tenure track, Professors","1","1","0","0","0","0","0","0","0","0","0","0","0","0","0","0","0","0","1","1","0","0","0","0","0","0","0","0","0","0","-2"
"190512","CUNY Bernard M Baruch College","2011","Total full-time Instruction/research/public service, Non-tenured on tenure track, Associate professors","4","3","1","0","0","0","1","0","1","0","0","0","0","0","0","0","0","0","0","0","0","0","0","0","0","0","0","3","3","0","-2"
"190512","CUNY Bernard M Baruch College","2011","Total full-time Instruction/research/public service, Non-tenured on tenure track, Assistant professors","78","39","39","0","0","0","11","5","6","1","0","1","3","2","1","0","0","0","39","19","20","0","0","0","0","0","0","24","13","11","-2"
"190512","CUNY Bernard M Baruch College","2011","Total full-time Instruction/research/public service, Non-tenured on tenure track, Lecturers","29","15","14","0","0","0","5","2","3","2","0","2","3","1","2","0","0","0","19","12","7","0","0","0","0","0","0","0","0","0","-2"
"190512","CUNY Bernard M Baruch College","2011","Total full-time Instruction/research/public service, Non-tenured on tenure track total","112","58","54","0","0","0","17","7","10","3","0","3","6","3","3","0","0","0","59","32","27","0","0","0","0","0","0","27","16","11","-2"
"190512","CUNY Bernard M Baruch College","2011","Total full-time Instruction/research/public service, Non-tenured not on tenure track, Professors","10","7","3","0","0","0","1","1","0","2","0","2","0","0","0","0","0","0","7","6","1","0","0","0","0","0","0","0","0","0","-2"
"190512","CUNY Bernard M Baruch College","2011","Total full-time Instruction/research/public service, Non-tenured not on tenure track, Associate professors","1","1","0","0","0","0","0","0","0","0","0","0","0","0","0","0","0","0","0","0","0","0","0","0","0","0","0","1","1","0","-2"
"190512","CUNY Bernard M Baruch College","2011","Total full-time Instruction/research/public servicey, Non-tenured not on tenure track, Assistant professors","2","0","2","0","0","0","0","0","0","1","0","1","0","0","0","0","0","0","1","0","1","0","0","0","0","0","0","0","0","0","-2"
"190512","CUNY Bernard M Baruch College","2011","Total full-time Instruction/research/public service, Non-tenured not on tenure track, Instructors","1","1","0","0","0","0","0","0","0","0","0","0","0","0","0","0","0","0","0","0","0","0","0","0","0","0","0","1","1","0","-2"
"190512","CUNY Bernard M Baruch College","2011","Total full-time Instruction/research/public service, Non-tenured not on tenure track, Lecturers","2","2","0","0","0","0","0","0","0","0","0","0","0","0","0","0","0","0","2","2","0","0","0","0","0","0","0","0","0","0","-2"
"190512","CUNY Bernard M Baruch College","2011","Total full-time Instruction/research/public service, Non-tenured not on tenure track total","16","11","5","0","0","0","1","1","0","3","0","3","0","0","0","0","0","0","10","8","2","0","0","0","0","0","0","2","2","0","-2"
"190549","CUNY Brooklyn College","2011","Total full-time Instruction/research/public service, Tenured, Professors","201","134","67","0","0","0","10","9","1","10","7","3","9","5","4","0","0","0","172","113","59","0","0","0","0","0","0","0","0","0","-2"
"190549","CUNY Brooklyn College","2011","Total full-time Instruction/research/public service, Tenured, Associate professors","133","72","61","1","0","1","13","10","3","8","6","2","8","3","5","0","0","0","99","50","49","0","0","0","0","0","0","4","3","1","-2"
"190549","CUNY Brooklyn College","2011","Total full-time Instruction/research/public service, Tenured, Assistant professors","31","14","17","0","0","0","7","3","4","3","1","2","3","0","3","0","0","0","16","8","8","0","0","0","0","0","0","2","2","0","-2"
"190549","CUNY Brooklyn College","2011","Total full-time Instruction/research/public service, Tenured, Lecturers","6","6","0","0","0","0","0","0","0","2","2","0","2","2","0","0","0","0","2","2","0","0","0","0","0","0","0","0","0","0","-2"
"190549","CUNY Brooklyn College","2011","Total full-time Instruction/research/public service, Tenured total","371","226","145","1","0","1","30","22","8","23","16","7","22","10","12","0","0","0","289","173","116","0","0","0","0","0","0","6","5","1","-2"
"190549","CUNY Brooklyn College","2011","Total full-time Instruction/research/public service, Non-tenured on tenure track, Professors","1","1","0","0","0","0","0","0","0","0","0","0","0","0","0","0","0","0","1","1","0","0","0","0","0","0","0","0","0","0","-2"
"190549","CUNY Brooklyn College","2011","Total full-time Instruction/research/public service, Non-tenured on tenure track, Associate professors","9","7","2","0","0","0","1","1","0","1","1","0","0","0","0","0","0","0","7","5","2","0","0","0","0","0","0","0","0","0","-2"
"190549","CUNY Brooklyn College","2011","Total full-time Instruction/research/public service, Non-tenured on tenure track, Assistant professors","99","39","60","0","0","0","14","6","8","9","4","5","8","2","6","1","1","0","59","22","37","0","0","0","0","0","0","8","4","4","-2"
"190549","CUNY Brooklyn College","2011","Total full-time Instruction/research/public service, Non-tenured on tenure track, Lecturers","24","12","12","0","0","0","1","0","1","0","0","0","0","0","0","0","0","0","23","12","11","0","0","0","0","0","0","0","0","0","-2"
"190549","CUNY Brooklyn College","2011","Total full-time Instruction/research/public service, Non-tenured on tenure track total","133","59","74","0","0","0","16","7","9","10","5","5","8","2","6","1","1","0","90","40","50","0","0","0","0","0","0","8","4","4","-2"
"190549","CUNY Brooklyn College","2011","Total full-time Instruction/research/public service, Non-tenured not on tenure track, Professors","7","5","2","0","0","0","0","0","0","0","0","0","1","0","1","0","0","0","4","3","1","0","0","0","0","0","0","2","2","0","-2"
"190549","CUNY Brooklyn College","2011","Total full-time Instruction/research/public servicey, Non-tenured not on tenure track, Assistant professors","11","3","8","0","0","0","1","0","1","0","0","0","2","0","2","0","0","0","7","3","4","0","0","0","0","0","0","1","0","1","-2"
"190549","CUNY Brooklyn College","2011","Total full-time Instruction/research/public service, Non-tenured not on tenure track, Instructors","8","3","5","0","0","0","1","1","0","1","0","1","2","1","1","0","0","0","4","1","3","0","0","0","0","0","0","0","0","0","-2"
"190549","CUNY Brooklyn College","2011","Total full-time Instruction/research/public service, Non-tenured not on tenure track, Lecturers","5","2","3","0","0","0","0","0","0","1","0","1","1","1","0","0","0","0","3","1","2","0","0","0","0","0","0","0","0","0","-2"
"190549","CUNY Brooklyn College","2011","Total full-time Instruction/research/public service, Non-tenured not on tenure track total","31","13","18","0","0","0","2","1","1","2","0","2","6","2","4","0","0","0","18","8","10","0","0","0","0","0","0","3","2","1","-2"
"190646","CUNY Medgar Evers College","2011","Total full-time Instruction/research/public service, Tenured, Professors","51","34","17","0","0","0","11","8","3","27","18","9","1","1","0","0","0","0","12","7","5","0","0","0","0","0","0","0","0","0","-2"
"190646","CUNY Medgar Evers College","2011","Total full-time Instruction/research/public service, Tenured, Associate professors","18","8","10","0","0","0","2","0","2","10","5","5","2","1","1","0","0","0","4","2","2","0","0","0","0","0","0","0","0","0","-2"
"190646","CUNY Medgar Evers College","2011","Total full-time Instruction/research/public service, Tenured, Assistant professors","17","5","12","0","0","0","0","0","0","12","2","10","0","0","0","0","0","0","5","3","2","0","0","0","0","0","0","0","0","0","-2"
"190646","CUNY Medgar Evers College","2011","Total full-time Instruction/research/public service, Tenured, Lecturers","22","16","6","0","0","0","0","0","0","22","16","6","0","0","0","0","0","0","0","0","0","0","0","0","0","0","0","0","0","0","-2"
"190646","CUNY Medgar Evers College","2011","Total full-time Instruction/research/public service, Tenured total","108","63","45","0","0","0","13","8","5","71","41","30","3","2","1","0","0","0","21","12","9","0","0","0","0","0","0","0","0","0","-2"
"190646","CUNY Medgar Evers College","2011","Total full-time Instruction/research/public service, Non-tenured on tenure track, Professors","2","1","1","0","0","0","0","0","0","2","1","1","0","0","0","0","0","0","0","0","0","0","0","0","0","0","0","0","0","0","-2"
"190646","CUNY Medgar Evers College","2011","Total full-time Instruction/research/public service, Non-tenured on tenure track, Associate professors","6","3","3","0","0","0","1","0","1","4","3","1","1","0","1","0","0","0","0","0","0","0","0","0","0","0","0","0","0","0","-2"
"190646","CUNY Medgar Evers College","2011","Total full-time Instruction/research/public service, Non-tenured on tenure track, Assistant professors","34","13","21","0","0","0","2","1","1","22","6","16","0","0","0","0","0","0","8","6","2","0","0","0","0","0","0","2","0","2","-2"
"190646","CUNY Medgar Evers College","2011","Total full-time Instruction/research/public service, Non-tenured on tenure track, Lecturers","12","7","5","0","0","0","1","0","1","8","6","2","1","0","1","0","0","0","1","1","0","0","0","0","0","0","0","1","0","1","-2"
"190646","CUNY Medgar Evers College","2011","Total full-time Instruction/research/public service, Non-tenured on tenure track total","54","24","30","0","0","0","4","1","3","36","16","20","2","0","2","0","0","0","9","7","2","0","0","0","0","0","0","3","0","3","-2"
"190646","CUNY Medgar Evers College","2011","Total full-time Instruction/research/public service, Non-tenured not on tenure track, Professors","4","2","2","0","0","0","0","0","0","4","2","2","0","0","0","0","0","0","0","0","0","0","0","0","0","0","0","0","0","0","-2"
"190646","CUNY Medgar Evers College","2011","Total full-time Instruction/research/public servicey, Non-tenured not on tenure track, Assistant professors","1","0","1","0","0","0","0","0","0","1","0","1","0","0","0","0","0","0","0","0","0","0","0","0","0","0","0","0","0","0","-2"
"190646","CUNY Medgar Evers College","2011","Total full-time Instruction/research/public service, Non-tenured not on tenure track, Instructors","7","3","4","0","0","0","0","0","0","6","2","4","1","1","0","0","0","0","0","0","0","0","0","0","0","0","0","0","0","0","-2"
"190646","CUNY Medgar Evers College","2011","Total full-time Instruction/research/public service, Non-tenured not on tenure track, Lecturers","3","1","2","0","0","0","0","0","0","3","1","2","0","0","0","0","0","0","0","0","0","0","0","0","0","0","0","0","0","0","-2"
"190646","CUNY Medgar Evers College","2011","Total full-time Instruction/research/public service, Non-tenured not on tenure track total","15","6","9","0","0","0","0","0","0","14","5","9","1","1","0","0","0","0","0","0","0","0","0","0","0","0","0","0","0","0","-2"
"191126","Fashion Institute of Technology","2011","Total full-time Instruction/research/public service, Tenured, Professors","41","19","22","0","0","0","1","1","0","1","0","1","1","1","0","0","0","0","34","14","20","0","0","0","4","3","1","0","0","0","-2"
"191126","Fashion Institute of Technology","2011","Total full-time Instruction/research/public service, Tenured, Associate professors","59","27","32","0","0","0","4","2","2","3","1","2","3","1","2","0","0","0","46","21","25","1","1","0","2","1","1","0","0","0","-2"
"191126","Fashion Institute of Technology","2011","Total full-time Instruction/research/public service, Tenured, Assistant professors","121","61","60","0","0","0","4","4","0","13","7","6","8","3","5","0","0","0","89","42","47","0","0","0","7","5","2","0","0","0","-2"
"191126","Fashion Institute of Technology","2011","Total full-time Instruction/research/public service, Tenured total","221","107","114","0","0","0","9","7","2","17","8","9","12","5","7","0","0","0","169","77","92","1","1","0","13","9","4","0","0","0","-2"
"191126","Fashion Institute of Technology","2011","Total full-time Instruction/research/public service, Non-tenured on tenure track, Assistant professors","12","5","7","0","0","0","0","0","0","0","0","0","0","0","0","0","0","0","8","3","5","1","1","0","3","1","2","0","0","0","-2"
"191126","Fashion Institute of Technology","2011","Total full-time Instruction/research/public service, Non-tenured on tenure track, Instructors","6","3","3","0","0","0","1","0","1","0","0","0","1","0","1","0","0","0","4","3","1","0","0","0","0","0","0","0","0","0","-2"
"191126","Fashion Institute of Technology","2011","Total full-time Instruction/research/public service, Non-tenured on tenure track total","18","8","10","0","0","0","1","0","1","0","0","0","1","0","1","0","0","0","12","6","6","1","1","0","3","1","2","0","0","0","-2"
"191241","Fordham University","2011","Total full-time Instruction/research/public service, Tenured, Professors","206","143","63","0","0","0","13","11","2","4","3","1","8","4","4","0","0","0","180","124","56","0","0","0","0","0","0","1","1","0","-2"
"191241","Fordham University","2011","Total full-time Instruction/research/public service, Tenured, Associate professors","180","104","76","0","0","0","18","10","8","5","4","1","12","9","3","0","0","0","144","81","63","0","0","0","0","0","0","1","0","1","-2"
"191241","Fordham University","2011","Total full-time Instruction/research/public service, Tenured, Assistant professors","17","15","2","0","0","0","1","1","0","0","0","0","1","1","0","0","0","0","15","13","2","0","0","0","0","0","0","0","0","0","-2"
"191241","Fordham University","2011","Total full-time Instruction/research/public service, Tenured total","403","262","141","0","0","0","32","22","10","9","7","2","21","14","7","0","0","0","339","218","121","0","0","0","0","0","0","2","1","1","-2"
"191241","Fordham University","2011","Total full-time Instruction/research/public service, Non-tenured on tenure track, Associate professors","21","12","9","0","0","0","1","1","0","3","3","0","2","1","1","0","0","0","13","6","7","0","0","0","1","0","1","1","1","0","-2"
"191241","Fordham University","2011","Total full-time Instruction/research/public service, Non-tenured on tenure track, Assistant professors","128","55","73","0","0","0","16","5","11","5","2","3","7","2","5","0","0","0","84","40","44","0","0","0","0","0","0","16","6","10","-2"
"191241","Fordham University","2011","Total full-time Instruction/research/public service, Non-tenured on tenure track, Instructors","4","4","0","0","0","0","0","0","0","0","0","0","0","0","0","0","0","0","1","1","0","0","0","0","0","0","0","3","3","0","-2"
"191241","Fordham University","2011","Total full-time Instruction/research/public service, Non-tenured on tenure track total","153","71","82","0","0","0","17","6","11","8","5","3","9","3","6","0","0","0","98","47","51","0","0","0","1","0","1","20","10","10","-2"
"191241","Fordham University","2011","Total full-time Instruction/research/public service, Non-tenured not on tenure track, Professors","11","9","2","0","0","0","0","0","0","0","0","0","1","1","0","0","0","0","10","8","2","0","0","0","0","0","0","0","0","0","-2"
"191241","Fordham University","2011","Total full-time Instruction/research/public service, Non-tenured not on tenure track, Associate professors","1","0","1","0","0","0","0","0","0","0","0","0","0","0","0","0","0","0","1","0","1","0","0","0","0","0","0","0","0","0","-2"
"191241","Fordham University","2011","Total full-time Instruction/research/public servicey, Non-tenured not on tenure track, Assistant professors","17","12","5","0","0","0","4","2","2","0","0","0","0","0","0","0","0","0","12","9","3","0","0","0","0","0","0","1","1","0","-2"
"191241","Fordham University","2011","Total full-time Instruction/research/public service, Non-tenured not on tenure track, Instructors","3","2","1","0","0","0","0","0","0","0","0","0","0","0","0","0","0","0","3","2","1","0","0","0","0","0","0","0","0","0","-2"
"191241","Fordham University","2011","Total full-time Instruction/research/public service, Non-tenured not on tenure track total","32","23","9","0","0","0","4","2","2","0","0","0","1","1","0","0","0","0","26","19","7","0","0","0","0","0","0","1","1","0","-2"
"191931","Iona College","2011","Total full-time Instruction/research/public service, Tenured, Professors","49","37","12","0","0","0","1","1","0","2","0","2","0","0","0","0","0","0","46","36","10","0","0","0","0","0","0","0","0","0","-2"
"191931","Iona College","2011","Total full-time Instruction/research/public service, Tenured, Associate professors","61","37","24","0","0","0","7","4","3","2","1","1","1","0","1","0","0","0","51","32","19","0","0","0","0","0","0","0","0","0","-2"
"191931","Iona College","2011","Total full-time Instruction/research/public service, Tenured, Assistant professors","3","2","1","0","0","0","0","0","0","0","0","0","0","0","0","0","0","0","3","2","1","0","0","0","0","0","0","0","0","0","-2"
"191931","Iona College","2011","Total full-time Instruction/research/public service, Tenured total","113","76","37","0","0","0","8","5","3","4","1","3","1","0","1","0","0","0","100","70","30","0","0","0","0","0","0","0","0","0","-2"
"191931","Iona College","2011","Total full-time Instruction/research/public service, Non-tenured on tenure track, Associate professors","7","5","2","0","0","0","0","0","0","1","1","0","1","0","1","0","0","0","5","4","1","0","0","0","0","0","0","0","0","0","-2"
"191931","Iona College","2011","Total full-time Instruction/research/public service, Non-tenured on tenure track, Assistant professors","37","16","21","0","0","0","2","0","2","2","0","2","0","0","0","0","0","0","28","13","15","0","0","0","0","0","0","5","3","2","-2"
"191931","Iona College","2011","Total full-time Instruction/research/public service, Non-tenured on tenure track, Instructors","1","1","0","0","0","0","0","0","0","0","0","0","0","0","0","0","0","0","1","1","0","0","0","0","0","0","0","0","0","0","-2"
"191931","Iona College","2011","Total full-time Instruction/research/public service, Non-tenured on tenure track total","45","22","23","0","0","0","2","0","2","3","1","2","1","0","1","0","0","0","34","18","16","0","0","0","0","0","0","5","3","2","-2"
"191931","Iona College","2011","Total full-time Instruction/research/public servicey, Non-tenured not on tenure track, Assistant professors","10","3","7","0","0","0","2","1","1","0","0","0","0","0","0","0","0","0","6","1","5","0","0","0","0","0","0","2","1","1","-2"
"191931","Iona College","2011","Total full-time Instruction/research/public service, Non-tenured not on tenure track, Lecturers","8","6","2","0","0","0","0","0","0","0","0","0","0","0","0","0","0","0","8","6","2","0","0","0","0","0","0","0","0","0","-2"
"191931","Iona College","2011","Total full-time Instruction/research/public service, Non-tenured not on tenure track total","18","9","9","0","0","0","2","1","1","0","0","0","0","0","0","0","0","0","14","7","7","0","0","0","0","0","0","2","1","1","-2"
"192703","Manhattan College","2011","Total full-time Instruction/research/public service, Tenured, Professors","56","40","16","0","0","0","1","1","0","1","0","1","1","1","0","0","0","0","53","38","15","0","0","0","0","0","0","0","0","0","-2"
"192703","Manhattan College","2011","Total full-time Instruction/research/public service, Tenured, Associate professors","54","37","17","0","0","0","3","3","0","0","0","0","2","1","1","0","0","0","49","33","16","0","0","0","0","0","0","0","0","0","-2"
"192703","Manhattan College","2011","Total full-time Instruction/research/public service, Tenured, Assistant professors","13","6","7","0","0","0","2","1","1","2","1","1","1","0","1","0","0","0","8","4","4","0","0","0","0","0","0","0","0","0","-2"
"192703","Manhattan College","2011","Total full-time Instruction/research/public service, Tenured total","123","83","40","0","0","0","6","5","1","3","1","2","4","2","2","0","0","0","110","75","35","0","0","0","0","0","0","0","0","0","-2"
"192703","Manhattan College","2011","Total full-time Instruction/research/public service, Non-tenured on tenure track, Professors","2","2","0","0","0","0","0","0","0","0","0","0","0","0","0","0","0","0","1","1","0","0","0","0","1","1","0","0","0","0","-2"
"192703","Manhattan College","2011","Total full-time Instruction/research/public service, Non-tenured on tenure track, Associate professors","2","2","0","0","0","0","0","0","0","0","0","0","0","0","0","0","0","0","2","2","0","0","0","0","0","0","0","0","0","0","-2"
"192703","Manhattan College","2011","Total full-time Instruction/research/public service, Non-tenured on tenure track, Assistant professors","45","23","22","2","0","2","1","1","0","1","1","0","2","1","1","0","0","0","32","17","15","0","0","0","2","0","2","5","3","2","-2"
"192703","Manhattan College","2011","Total full-time Instruction/research/public service, Non-tenured on tenure track, Instructors","2","0","2","0","0","0","0","0","0","0","0","0","0","0","0","0","0","0","0","0","0","1","0","1","0","0","0","1","0","1","-2"
"192703","Manhattan College","2011","Total full-time Instruction/research/public service, Non-tenured on tenure track total","51","27","24","2","0","2","1","1","0","1","1","0","2","1","1","0","0","0","35","20","15","1","0","1","3","1","2","6","3","3","-2"
"192703","Manhattan College","2011","Total full-time Instruction/research/public service, Non-tenured not on tenure track, Professors","1","0","1","0","0","0","0","0","0","0","0","0","0","0","0","0","0","0","0","0","0","0","0","0","0","0","0","1","0","1","-2"
"192703","Manhattan College","2011","Total full-time Instruction/research/public service, Non-tenured not on tenure track, Associate professors","1","1","0","0","0","0","0","0","0","0","0","0","0","0","0","0","0","0","1","1","0","0","0","0","0","0","0","0","0","0","-2"
"192703","Manhattan College","2011","Total full-time Instruction/research/public servicey, Non-tenured not on tenure track, Assistant professors","18","10","8","0","0","0","2","2","0","1","0","1","0","0","0","0","0","0","14","8","6","0","0","0","1","0","1","0","0","0","-2"
"192703","Manhattan College","2011","Total full-time Instruction/research/public service, Non-tenured not on tenure track, Instructors","8","4","4","0","0","0","0","0","0","0","0","0","2","1","1","0","0","0","6","3","3","0","0","0","0","0","0","0","0","0","-2"
"192703","Manhattan College","2011","Total full-time Instruction/research/public service, Non-tenured not on tenure track, Lecturers","2","2","0","0","0","0","0","0","0","0","0","0","0","0","0","0","0","0","2","2","0","0","0","0","0","0","0","0","0","0","-2"
"192703","Manhattan College","2011","Total full-time Instruction/research/public service, Non-tenured not on tenure track total","30","17","13","0","0","0","2","2","0","1","0","1","2","1","1","0","0","0","23","14","9","0","0","0","1","0","1","1","0","1","-2"
"192864","Marymount Manhattan College","2011","Total full-time Instruction/research/public service, Tenured, Professors","17","9","8","0","0","0","1","1","0","0","0","0","0","0","0","0","0","0","16","8","8","0","0","0","0","0","0","0","0","0","-2"
"192864","Marymount Manhattan College","2011","Total full-time Instruction/research/public service, Tenured, Associate professors","34","16","18","0","0","0","2","1","1","1","0","1","1","1","0","0","0","0","29","13","16","0","0","0","0","0","0","1","1","0","-2"
"192864","Marymount Manhattan College","2011","Total full-time Instruction/research/public service, Tenured total","51","25","26","0","0","0","3","2","1","1","0","1","1","1","0","0","0","0","45","21","24","0","0","0","0","0","0","1","1","0","-2"
"192864","Marymount Manhattan College","2011","Total full-time Instruction/research/public service, Non-tenured on tenure track, Associate professors","1","0","1","0","0","0","0","0","0","0","0","0","0","0","0","0","0","0","1","0","1","0","0","0","0","0","0","0","0","0","-2"
"192864","Marymount Manhattan College","2011","Total full-time Instruction/research/public service, Non-tenured on tenure track, Assistant professors","43","12","31","0","0","0","4","3","1","4","1","3","2","1","1","0","0","0","33","7","26","0","0","0","0","0","0","0","0","0","-2"
"192864","Marymount Manhattan College","2011","Total full-time Instruction/research/public service, Non-tenured on tenure track total","44","12","32","0","0","0","4","3","1","4","1","3","2","1","1","0","0","0","34","7","27","0","0","0","0","0","0","0","0","0","-2"
"192864","Marymount Manhattan College","2011","Total full-time Instruction/research/public servicey, Non-tenured not on tenure track, Assistant professors","2","2","0","0","0","0","0","0","0","0","0","0","1","1","0","0","0","0","1","1","0","0","0","0","0","0","0","0","0","0","-2"
"192864","Marymount Manhattan College","2011","Total full-time Instruction/research/public service, Non-tenured not on tenure track, Instructors","5","1","4","0","0","0","0","0","0","0","0","0","0","0","0","0","0","0","5","1","4","0","0","0","0","0","0","0","0","0","-2"
"192864","Marymount Manhattan College","2011","Total full-time Instruction/research/public service, Non-tenured not on tenure track total","7","3","4","0","0","0","0","0","0","0","0","0","1","1","0","0","0","0","6","2","4","0","0","0","0","0","0","0","0","0","-2"
"193292","Molloy College","2011","Total full-time Instruction/research/public service, Tenured, Professors","34","8","26","0","0","0","0","0","0","1","0","1","1","0","1","0","0","0","32","8","24","0","0","0","0","0","0","0","0","0","-2"
"193292","Molloy College","2011","Total full-time Instruction/research/public service, Tenured, Associate professors","40","16","24","0","0","0","1","0","1","3","0","3","1","0","1","0","0","0","35","16","19","0","0","0","0","0","0","0","0","0","-2"
"193292","Molloy College","2011","Total full-time Instruction/research/public service, Tenured, Assistant professors","37","5","32","0","0","0","3","1","2","3","0","3","0","0","0","0","0","0","31","4","27","0","0","0","0","0","0","0","0","0","-2"
"193292","Molloy College","2011","Total full-time Instruction/research/public service, Tenured total","111","29","82","0","0","0","4","1","3","7","0","7","2","0","2","0","0","0","98","28","70","0","0","0","0","0","0","0","0","0","-2"
"193292","Molloy College","2011","Total full-time Instruction/research/public service, Non-tenured on tenure track, Professors","3","2","1","0","0","0","0","0","0","0","0","0","0","0","0","0","0","0","3","2","1","0","0","0","0","0","0","0","0","0","-2"
"193292","Molloy College","2011","Total full-time Instruction/research/public service, Non-tenured on tenure track, Associate professors","8","3","5","0","0","0","0","0","0","0","0","0","1","0","1","0","0","0","7","3","4","0","0","0","0","0","0","0","0","0","-2"
"193292","Molloy College","2011","Total full-time Instruction/research/public service, Non-tenured on tenure track, Assistant professors","39","8","31","0","0","0","2","1","1","2","0","2","2","1","1","0","0","0","32","6","26","1","0","1","0","0","0","0","0","0","-2"
"193292","Molloy College","2011","Total full-time Instruction/research/public service, Non-tenured on tenure track, Instructors","12","4","8","0","0","0","1","1","0","2","0","2","0","0","0","0","0","0","9","3","6","0","0","0","0","0","0","0","0","0","-2"
"193292","Molloy College","2011","Total full-time Instruction/research/public service, Non-tenured on tenure track total","62","17","45","0","0","0","3","2","1","4","0","4","3","1","2","0","0","0","51","14","37","1","0","1","0","0","0","0","0","0","-2"
"193292","Molloy College","2011","Total full-time Instruction/research/public service, Non-tenured not on tenure track, No academic rank","1","0","1","0","0","0","0","0","0","0","0","0","0","0","0","0","0","0","1","0","1","0","0","0","0","0","0","0","0","0","-2"
"193292","Molloy College","2011","Total full-time Instruction/research/public service, Non-tenured not on tenure track total","1","0","1","0","0","0","0","0","0","0","0","0","0","0","0","0","0","0","1","0","1","0","0","0","0","0","0","0","0","0","-2"
"193353","Mount Saint Mary College","2011","Total full-time Instruction/research/public service, Tenured, Professors","26","14","12","0","0","0","1","0","1","1","1","0","0","0","0","0","0","0","24","13","11","0","0","0","0","0","0","0","0","0","-2"
"193353","Mount Saint Mary College","2011","Total full-time Instruction/research/public service, Tenured, Associate professors","22","7","15","0","0","0","1","0","1","0","0","0","0","0","0","0","0","0","20","6","14","0","0","0","0","0","0","1","1","0","-2"
"193353","Mount Saint Mary College","2011","Total full-time Instruction/research/public service, Tenured total","48","21","27","0","0","0","2","0","2","1","1","0","0","0","0","0","0","0","44","19","25","0","0","0","0","0","0","1","1","0","-2"
"193353","Mount Saint Mary College","2011","Total full-time Instruction/research/public service, Non-tenured on tenure track, Associate professors","2","1","1","0","0","0","0","0","0","0","0","0","0","0","0","0","0","0","2","1","1","0","0","0","0","0","0","0","0","0","-2"
"193353","Mount Saint Mary College","2011","Total full-time Instruction/research/public service, Non-tenured on tenure track, Assistant professors","28","13","15","0","0","0","0","0","0","2","0","2","1","1","0","0","0","0","21","11","10","1","0","1","0","0","0","3","1","2","-2"
"193353","Mount Saint Mary College","2011","Total full-time Instruction/research/public service, Non-tenured on tenure track, Instructors","9","1","8","0","0","0","0","0","0","0","0","0","0","0","0","0","0","0","8","0","8","1","1","0","0","0","0","0","0","0","-2"
"193353","Mount Saint Mary College","2011","Total full-time Instruction/research/public service, Non-tenured on tenure track total","39","15","24","0","0","0","0","0","0","2","0","2","1","1","0","0","0","0","31","12","19","2","1","1","0","0","0","3","1","2","-2"
"194091","New York Institute of Technology","2011","Total full-time Instruction/research/public service, Tenured, Professors","65","56","9","0","0","0","9","8","1","4","3","1","1","1","0","0","0","0","51","44","7","0","0","0","0","0","0","0","0","0","-2"
"194091","New York Institute of Technology","2011","Total full-time Instruction/research/public service, Tenured, Associate professors","89","55","34","0","0","0","16","9","7","0","0","0","1","1","0","0","0","0","72","45","27","0","0","0","0","0","0","0","0","0","-2"
"194091","New York Institute of Technology","2011","Total full-time Instruction/research/public service, Tenured, Assistant professors","7","5","2","0","0","0","1","1","0","0","0","0","1","1","0","0","0","0","5","3","2","0","0","0","0","0","0","0","0","0","-2"
"194091","New York Institute of Technology","2011","Total full-time Instruction/research/public service, Tenured total","161","116","45","0","0","0","26","18","8","4","3","1","3","3","0","0","0","0","128","92","36","0","0","0","0","0","0","0","0","0","-2"
"194091","New York Institute of Technology","2011","Total full-time Instruction/research/public service, Non-tenured on tenure track, Associate professors","4","1","3","1","1","0","1","0","1","0","0","0","0","0","0","0","0","0","2","0","2","0","0","0","0","0","0","0","0","0","-2"
"194091","New York Institute of Technology","2011","Total full-time Instruction/research/public service, Non-tenured on tenure track, Assistant professors","51","18","33","0","0","0","14","7","7","1","0","1","2","1","1","0","0","0","33","10","23","1","0","1","0","0","0","0","0","0","-2"
"194091","New York Institute of Technology","2011","Total full-time Instruction/research/public service, Non-tenured on tenure track, Instructors","3","0","3","0","0","0","0","0","0","0","0","0","0","0","0","0","0","0","3","0","3","0","0","0","0","0","0","0","0","0","-2"
"194091","New York Institute of Technology","2011","Total full-time Instruction/research/public service, Non-tenured on tenure track total","58","19","39","1","1","0","15","7","8","1","0","1","2","1","1","0","0","0","38","10","28","1","0","1","0","0","0","0","0","0","-2"
"194091","New York Institute of Technology","2011","Total full-time Instruction/research/public service, Non-tenured not on tenure track, Professors","6","6","0","0","0","0","1","1","0","0","0","0","0","0","0","0","0","0","5","5","0","0","0","0","0","0","0","0","0","0","-2"
"194091","New York Institute of Technology","2011","Total full-time Instruction/research/public service, Non-tenured not on tenure track, Associate professors","12","9","3","0","0","0","0","0","0","0","0","0","0","0","0","0","0","0","12","9","3","0","0","0","0","0","0","0","0","0","-2"
"194091","New York Institute of Technology","2011","Total full-time Instruction/research/public servicey, Non-tenured not on tenure track, Assistant professors","34","19","15","1","1","0","6","3","3","1","0","1","2","1","1","0","0","0","24","14","10","0","0","0","0","0","0","0","0","0","-2"
"194091","New York Institute of Technology","2011","Total full-time Instruction/research/public service, Non-tenured not on tenure track, Instructors","2","2","0","0","0","0","1","1","0","0","0","0","0","0","0","0","0","0","1","1","0","0","0","0","0","0","0","0","0","0","-2"
"194091","New York Institute of Technology","2011","Total full-time Instruction/research/public service, Non-tenured not on tenure track total","54","36","18","1","1","0","8","5","3","1","0","1","2","1","1","0","0","0","42","29","13","0","0","0","0","0","0","0","0","0","-2"
"195243","St. Thomas Aquinas College","2011","Total full-time Instruction/research/public service, Tenured, Professors","29","15","14","0","0","0","2","0","2","0","0","0","1","1","0","0","0","0","26","14","12","0","0","0","0","0","0","0","0","0","-2"
"195243","St. Thomas Aquinas College","2011","Total full-time Instruction/research/public service, Tenured, Associate professors","13","9","4","0","0","0","1","1","0","0","0","0","1","1","0","0","0","0","11","7","4","0","0","0","0","0","0","0","0","0","-2"
"195243","St. Thomas Aquinas College","2011","Total full-time Instruction/research/public service, Tenured, Assistant professors","3","3","0","0","0","0","0","0","0","1","1","0","0","0","0","0","0","0","2","2","0","0","0","0","0","0","0","0","0","0","-2"
"195243","St. Thomas Aquinas College","2011","Total full-time Instruction/research/public service, Tenured total","45","27","18","0","0","0","3","1","2","1","1","0","2","2","0","0","0","0","39","23","16","0","0","0","0","0","0","0","0","0","-2"
"195243","St. Thomas Aquinas College","2011","Total full-time Instruction/research/public service, Non-tenured on tenure track, Associate professors","2","1","1","0","0","0","0","0","0","0","0","0","0","0","0","0","0","0","2","1","1","0","0","0","0","0","0","0","0","0","-2"
"195243","St. Thomas Aquinas College","2011","Total full-time Instruction/research/public service, Non-tenured on tenure track, Assistant professors","10","5","5","0","0","0","0","0","0","0","0","0","0","0","0","0","0","0","10","5","5","0","0","0","0","0","0","0","0","0","-2"
"195243","St. Thomas Aquinas College","2011","Total full-time Instruction/research/public service, Non-tenured on tenure track total","12","6","6","0","0","0","0","0","0","0","0","0","0","0","0","0","0","0","12","6","6","0","0","0","0","0","0","0","0","0","-2"
"195243","St. Thomas Aquinas College","2011","Total full-time Instruction/research/public servicey, Non-tenured not on tenure track, Assistant professors","3","3","0","0","0","0","0","0","0","0","0","0","0","0","0","0","0","0","3","3","0","0","0","0","0","0","0","0","0","0","-2"
"195243","St. Thomas Aquinas College","2011","Total full-time Instruction/research/public service, Non-tenured not on tenure track, Instructors","3","0","3","0","0","0","0","0","0","0","0","0","0","0","0","0","0","0","3","0","3","0","0","0","0","0","0","0","0","0","-2"
"195243","St. Thomas Aquinas College","2011","Total full-time Instruction/research/public service, Non-tenured not on tenure track total","6","3","3","0","0","0","0","0","0","0","0","0","0","0","0","0","0","0","6","3","3","0","0","0","0","0","0","0","0","0","-2"
"196024","SUNY College of Technology at Delhi","2011","Total full-time Instruction/research/public service, Tenured, Professors","27","17","10","0","0","0","0","0","0","0","0","0","0","0","0","0","0","0","27","17","10","0","0","0","0","0","0","0","0","0","-2"
"196024","SUNY College of Technology at Delhi","2011","Total full-time Instruction/research/public service, Tenured, Associate professors","18","13","5","0","0","0","0","0","0","0","0","0","1","1","0","0","0","0","17","12","5","0","0","0","0","0","0","0","0","0","-2"
"196024","SUNY College of Technology at Delhi","2011","Total full-time Instruction/research/public service, Tenured, Assistant professors","11","7","4","0","0","0","0","0","0","2","0","2","0","0","0","0","0","0","9","7","2","0","0","0","0","0","0","0","0","0","-2"
"196024","SUNY College of Technology at Delhi","2011","Total full-time Instruction/research/public service, Tenured, Instructors","4","3","1","0","0","0","0","0","0","0","0","0","0","0","0","0","0","0","4","3","1","0","0","0","0","0","0","0","0","0","-2"
"196024","SUNY College of Technology at Delhi","2011","Total full-time Instruction/research/public service, Tenured total","60","40","20","0","0","0","0","0","0","2","0","2","1","1","0","0","0","0","57","39","18","0","0","0","0","0","0","0","0","0","-2"
"196024","SUNY College of Technology at Delhi","2011","Total full-time Instruction/research/public service, Non-tenured on tenure track, Associate professors","5","4","1","0","0","0","1","1","0","0","0","0","0","0","0","0","0","0","4","3","1","0","0","0","0","0","0","0","0","0","-2"
"196024","SUNY College of Technology at Delhi","2011","Total full-time Instruction/research/public service, Non-tenured on tenure track, Assistant professors","28","13","15","0","0","0","2","1","1","1","1","0","0","0","0","0","0","0","25","11","14","0","0","0","0","0","0","0","0","0","-2"
"196024","SUNY College of Technology at Delhi","2011","Total full-time Instruction/research/public service, Non-tenured on tenure track, Instructors","23","12","11","0","0","0","0","0","0","0","0","0","0","0","0","0","0","0","23","12","11","0","0","0","0","0","0","0","0","0","-2"
"196024","SUNY College of Technology at Delhi","2011","Total full-time Instruction/research/public service, Non-tenured on tenure track total","56","29","27","0","0","0","3","2","1","1","1","0","0","0","0","0","0","0","52","26","26","0","0","0","0","0","0","0","0","0","-2"
"196024","SUNY College of Technology at Delhi","2011","Total full-time Instruction/research/public service, Non-tenured not on tenure track, Instructors","3","3","0","0","0","0","1","1","0","0","0","0","0","0","0","0","0","0","2","2","0","0","0","0","0","0","0","0","0","0","-2"
"196024","SUNY College of Technology at Delhi","2011","Total full-time Instruction/research/public service, Non-tenured not on tenure track total","3","3","0","0","0","0","1","1","0","0","0","0","0","0","0","0","0","0","2","2","0","0","0","0","0","0","0","0","0","0","-2"
"196042","Farmingdale State College","2011","Total full-time Instruction/research/public service, Tenured, Professors","69","41","28","0","0","0","4","3","1","2","2","0","3","1","2","0","0","0","60","35","25","0","0","0","0","0","0","0","0","0","-2"
"196042","Farmingdale State College","2011","Total full-time Instruction/research/public service, Tenured, Associate professors","35","17","18","0","0","0","2","0","2","1","0","1","2","1","1","0","0","0","30","16","14","0","0","0","0","0","0","0","0","0","-2"
"196042","Farmingdale State College","2011","Total full-time Instruction/research/public service, Tenured, Assistant professors","9","6","3","0","0","0","0","0","0","1","0","1","0","0","0","0","0","0","8","6","2","0","0","0","0","0","0","0","0","0","-2"
"196042","Farmingdale State College","2011","Total full-time Instruction/research/public service, Tenured total","113","64","49","0","0","0","6","3","3","4","2","2","5","2","3","0","0","0","98","57","41","0","0","0","0","0","0","0","0","0","-2"
"196042","Farmingdale State College","2011","Total full-time Instruction/research/public service, Non-tenured on tenure track, Professors","1","1","0","0","0","0","0","0","0","0","0","0","0","0","0","0","0","0","1","1","0","0","0","0","0","0","0","0","0","0","-2"
"196042","Farmingdale State College","2011","Total full-time Instruction/research/public service, Non-tenured on tenure track, Associate professors","9","4","5","0","0","0","1","1","0","0","0","0","0","0","0","0","0","0","7","2","5","0","0","0","0","0","0","1","1","0","-2"
"196042","Farmingdale State College","2011","Total full-time Instruction/research/public service, Non-tenured on tenure track, Assistant professors","68","31","37","0","0","0","8","7","1","8","2","6","3","3","0","0","0","0","47","18","29","0","0","0","0","0","0","2","1","1","-2"
"196042","Farmingdale State College","2011","Total full-time Instruction/research/public service, Non-tenured on tenure track total","78","36","42","0","0","0","9","8","1","8","2","6","3","3","0","0","0","0","55","21","34","0","0","0","0","0","0","3","2","1","-2"
"196042","Farmingdale State College","2011","Total full-time Instruction/research/public service, Non-tenured not on tenure track, Professors","1","1","0","0","0","0","1","1","0","0","0","0","0","0","0","0","0","0","0","0","0","0","0","0","0","0","0","0","0","0","-2"
"196042","Farmingdale State College","2011","Total full-time Instruction/research/public servicey, Non-tenured not on tenure track, Assistant professors","9","6","3","0","0","0","2","1","1","0","0","0","0","0","0","0","0","0","7","5","2","0","0","0","0","0","0","0","0","0","-2"
"196042","Farmingdale State College","2011","Total full-time Instruction/research/public service, Non-tenured not on tenure track, Lecturers","6","2","4","0","0","0","1","1","0","1","0","1","1","0","1","0","0","0","3","1","2","0","0","0","0","0","0","0","0","0","-2"
"196042","Farmingdale State College","2011","Total full-time Instruction/research/public service, Non-tenured not on tenure track total","16","9","7","0","0","0","4","3","1","1","0","1","1","0","1","0","0","0","10","6","4","0","0","0","0","0","0","0","0","0","-2"
"196176","State University of New York at New Paltz","2011","Total full-time Instruction/research/public service, Tenured, Professors","49","29","20","0","0","0","6","5","1","2","2","0","2","1","1","0","0","0","39","21","18","0","0","0","0","0","0","0","0","0","-2"
"196176","State University of New York at New Paltz","2011","Total full-time Instruction/research/public service, Tenured, Associate professors","96","53","43","0","0","0","9","6","3","4","3","1","3","1","2","0","0","0","80","43","37","0","0","0","0","0","0","0","0","0","-2"
"196176","State University of New York at New Paltz","2011","Total full-time Instruction/research/public service, Tenured, Assistant professors","8","4","4","0","0","0","0","0","0","1","1","0","0","0","0","0","0","0","7","3","4","0","0","0","0","0","0","0","0","0","-2"
"196176","State University of New York at New Paltz","2011","Total full-time Instruction/research/public service, Tenured, Instructors","1","0","1","0","0","0","0","0","0","0","0","0","0","0","0","0","0","0","1","0","1","0","0","0","0","0","0","0","0","0","-2"
"196176","State University of New York at New Paltz","2011","Total full-time Instruction/research/public service, Tenured total","154","86","68","0","0","0","15","11","4","7","6","1","5","2","3","0","0","0","127","67","60","0","0","0","0","0","0","0","0","0","-2"
"196176","State University of New York at New Paltz","2011","Total full-time Instruction/research/public service, Non-tenured on tenure track, Associate professors","13","5","8","0","0","0","3","1","2","1","1","0","1","0","1","0","0","0","8","3","5","0","0","0","0","0","0","0","0","0","-2"
"196176","State University of New York at New Paltz","2011","Total full-time Instruction/research/public service, Non-tenured on tenure track, Assistant professors","90","40","50","0","0","0","3","3","0","4","3","1","5","4","1","0","0","0","71","30","41","2","0","2","0","0","0","5","0","5","-2"
"196176","State University of New York at New Paltz","2011","Total full-time Instruction/research/public service, Non-tenured on tenure track, Instructors","4","0","4","0","0","0","0","0","0","0","0","0","1","0","1","0","0","0","3","0","3","0","0","0","0","0","0","0","0","0","-2"
"196176","State University of New York at New Paltz","2011","Total full-time Instruction/research/public service, Non-tenured on tenure track total","107","45","62","0","0","0","6","4","2","5","4","1","7","4","3","0","0","0","82","33","49","2","0","2","0","0","0","5","0","5","-2"
"196176","State University of New York at New Paltz","2011","Total full-time Instruction/research/public servicey, Non-tenured not on tenure track, Assistant professors","1","1","0","0","0","0","0","0","0","0","0","0","0","0","0","0","0","0","0","0","0","0","0","0","0","0","0","1","1","0","-2"
"196176","State University of New York at New Paltz","2011","Total full-time Instruction/research/public service, Non-tenured not on tenure track, Lecturers","51","21","30","0","0","0","1","1","0","0","0","0","3","0","3","0","0","0","41","19","22","0","0","0","0","0","0","6","1","5","-2"
"196176","State University of New York at New Paltz","2011","Total full-time Instruction/research/public service, Non-tenured not on tenure track total","52","22","30","0","0","0","1","1","0","0","0","0","3","0","3","0","0","0","41","19","22","0","0","0","0","0","0","7","2","5","-2"
"197230","Wells College","2011","Total full-time Instruction/research/public service, Tenured, Professors","16","10","6","1","1","0","0","0","0","1","1","0","2","1","1","1","1","0","11","6","5","0","0","0","0","0","0","0","0","0","-2"
"197230","Wells College","2011","Total full-time Instruction/research/public service, Tenured, Associate professors","10","2","8","0","0","0","0","0","0","0","0","0","0","0","0","0","0","0","10","2","8","0","0","0","0","0","0","0","0","0","-2"
"197230","Wells College","2011","Total full-time Instruction/research/public service, Tenured total","26","12","14","1","1","0","0","0","0","1","1","0","2","1","1","1","1","0","21","8","13","0","0","0","0","0","0","0","0","0","-2"
"197230","Wells College","2011","Total full-time Instruction/research/public service, Non-tenured on tenure track, Assistant professors","7","3","4","0","0","0","0","0","0","0","0","0","0","0","0","1","0","1","5","3","2","0","0","0","0","0","0","1","0","1","-2"
"197230","Wells College","2011","Total full-time Instruction/research/public service, Non-tenured on tenure track total","7","3","4","0","0","0","0","0","0","0","0","0","0","0","0","1","0","1","5","3","2","0","0","0","0","0","0","1","0","1","-2"
"197230","Wells College","2011","Total full-time Instruction/research/public servicey, Non-tenured not on tenure track, Assistant professors","2","1","1","0","0","0","0","0","0","0","0","0","0","0","0","0","0","0","2","1","1","0","0","0","0","0","0","0","0","0","-2"
"197230","Wells College","2011","Total full-time Instruction/research/public service, Non-tenured not on tenure track, Lecturers","2","1","1","0","0","0","0","0","0","0","0","0","0","0","0","0","0","0","2","1","1","0","0","0","0","0","0","0","0","0","-2"
"197230","Wells College","2011","Total full-time Instruction/research/public service, Non-tenured not on tenure track total","4","2","2","0","0","0","0","0","0","0","0","0","0","0","0","0","0","0","4","2","2","0","0","0","0","0","0","0","0","0","-2"
"199607","Salem College","2011","Total full-time Instruction/research/public service, Tenured, Professors","4","2","2","0","0","0","0","0","0","0","0","0","0","0","0","0","0","0","4","2","2","0","0","0","0","0","0","0","0","0","-2"
"199607","Salem College","2011","Total full-time Instruction/research/public service, Tenured, Associate professors","17","5","12","0","0","0","2","2","0","0","0","0","0","0","0","0","0","0","15","3","12","0","0","0","0","0","0","0","0","0","-2"
"199607","Salem College","2011","Total full-time Instruction/research/public service, Tenured, Assistant professors","1","1","0","0","0","0","0","0","0","0","0","0","0","0","0","0","0","0","1","1","0","0","0","0","0","0","0","0","0","0","-2"
"199607","Salem College","2011","Total full-time Instruction/research/public service, Tenured total","22","8","14","0","0","0","2","2","0","0","0","0","0","0","0","0","0","0","20","6","14","0","0","0","0","0","0","0","0","0","-2"
"199607","Salem College","2011","Total full-time Instruction/research/public service, Non-tenured on tenure track, Professors","1","1","0","0","0","0","0","0","0","0","0","0","0","0","0","0","0","0","1","1","0","0","0","0","0","0","0","0","0","0","-2"
"199607","Salem College","2011","Total full-time Instruction/research/public service, Non-tenured on tenure track, Associate professors","1","0","1","0","0","0","0","0","0","0","0","0","0","0","0","0","0","0","1","0","1","0","0","0","0","0","0","0","0","0","-2"
"199607","Salem College","2011","Total full-time Instruction/research/public service, Non-tenured on tenure track, Assistant professors","11","3","8","0","0","0","0","0","0","3","0","3","2","0","2","0","0","0","6","3","3","0","0","0","0","0","0","0","0","0","-2"
"199607","Salem College","2011","Total full-time Instruction/research/public service, Non-tenured on tenure track total","13","4","9","0","0","0","0","0","0","3","0","3","2","0","2","0","0","0","8","4","4","0","0","0","0","0","0","0","0","0","-2"
"199607","Salem College","2011","Total full-time Instruction/research/public service, Non-tenured not on tenure track, Associate professors","2","1","1","0","0","0","0","0","0","0","0","0","0","0","0","0","0","0","2","1","1","0","0","0","0","0","0","0","0","0","-2"
"199607","Salem College","2011","Total full-time Instruction/research/public servicey, Non-tenured not on tenure track, Assistant professors","17","4","13","0","0","0","1","0","1","0","0","0","0","0","0","0","0","0","16","4","12","0","0","0","0","0","0","0","0","0","-2"
"199607","Salem College","2011","Total full-time Instruction/research/public service, Non-tenured not on tenure track, Instructors","4","0","4","0","0","0","0","0","0","2","0","2","0","0","0","0","0","0","2","0","2","0","0","0","0","0","0","0","0","0","-2"
"199607","Salem College","2011","Total full-time Instruction/research/public service, Non-tenured not on tenure track total","23","5","18","0","0","0","1","0","1","2","0","2","0","0","0","0","0","0","20","5","15","0","0","0","0","0","0","0","0","0","-2"
"205027","Pontifical College Josephinum","2011","Total full-time Instruction/research/public service, Non-tenured not on tenure track, Professors","3","2","1","0","0","0","0","0","0","0","0","0","0","0","0","0","0","0","3","2","1","0","0","0","0","0","0","0","0","0","-2"
"205027","Pontifical College Josephinum","2011","Total full-time Instruction/research/public service, Non-tenured not on tenure track, Associate professors","4","4","0","0","0","0","0","0","0","0","0","0","0","0","0","0","0","0","4","4","0","0","0","0","0","0","0","0","0","0","-2"
"205027","Pontifical College Josephinum","2011","Total full-time Instruction/research/public servicey, Non-tenured not on tenure track, Assistant professors","12","10","2","0","0","0","0","0","0","0","0","0","0","0","0","0","0","0","12","10","2","0","0","0","0","0","0","0","0","0","-2"
"205027","Pontifical College Josephinum","2011","Total full-time Instruction/research/public service, Non-tenured not on tenure track, Instructors","2","1","1","0","0","0","0","0","0","1","1","0","0","0","0","0","0","0","1","0","1","0","0","0","0","0","0","0","0","0","-2"
"205027","Pontifical College Josephinum","2011","Total full-time Instruction/research/public service, Non-tenured not on tenure track, Lecturers","1","1","0","0","0","0","0","0","0","0","0","0","0","0","0","0","0","0","1","1","0","0","0","0","0","0","0","0","0","0","-2"
"205027","Pontifical College Josephinum","2011","Total full-time Instruction/research/public service, Non-tenured not on tenure track total","22","18","4","0","0","0","0","0","0","1","1","0","0","0","0","0","0","0","21","17","4","0","0","0","0","0","0","0","0","0","-2"
"206862","Southern Nazarene University","2011","Total full-time Instruction/research/public service, Non-tenured not on tenure track, Professors","34","25","9","1","1","0","1","1","0","0","0","0","0","0","0","0","0","0","32","23","9","0","0","0","0","0","0","0","0","0","-2"
"206862","Southern Nazarene University","2011","Total full-time Instruction/research/public service, Non-tenured not on tenure track, Associate professors","12","4","8","0","0","0","1","0","1","0","0","0","0","0","0","0","0","0","11","4","7","0","0","0","0","0","0","0","0","0","-2"
"206862","Southern Nazarene University","2011","Total full-time Instruction/research/public servicey, Non-tenured not on tenure track, Assistant professors","20","8","12","0","0","0","0","0","0","0","0","0","0","0","0","0","0","0","20","8","12","0","0","0","0","0","0","0","0","0","-2"
"206862","Southern Nazarene University","2011","Total full-time Instruction/research/public service, Non-tenured not on tenure track, No academic rank","2","1","1","0","0","0","0","0","0","0","0","0","0","0","0","0","0","0","2","1","1","0","0","0","0","0","0","0","0","0","-2"
"206862","Southern Nazarene University","2011","Total full-time Instruction/research/public service, Non-tenured not on tenure track total","68","38","30","1","1","0","2","1","1","0","0","0","0","0","0","0","0","0","65","36","29","0","0","0","0","0","0","0","0","0","-2"
"207157","Randall University","2011","Total full-time Instruction/research/public service, Non-tenured not on tenure track, No academic rank","15","8","7","2","0","2","0","0","0","0","0","0","0","0","0","0","0","0","11","7","4","1","1","0","1","0","1","0","0","0","-2"
"207157","Randall University","2011","Total full-time Instruction/research/public service, Non-tenured not on tenure track total","15","8","7","2","0","2","0","0","0","0","0","0","0","0","0","0","0","0","11","7","4","1","1","0","1","0","1","0","0","0","-2"
"207397","Oklahoma State University-Oklahoma City","2011","Total full-time Instruction/research/public service, Tenured, Professors","6","3","3","0","0","0","0","0","0","0","0","0","1","1","0","0","0","0","5","2","3","0","0","0","0","0","0","0","0","0","-2"
"207397","Oklahoma State University-Oklahoma City","2011","Total full-time Instruction/research/public service, Tenured, Associate professors","38","15","23","1","0","1","0","0","0","1","0","1","0","0","0","0","0","0","36","15","21","0","0","0","0","0","0","0","0","0","-2"
"207397","Oklahoma State University-Oklahoma City","2011","Total full-time Instruction/research/public service, Tenured, Instructors","1","1","0","0","0","0","0","0","0","0","0","0","0","0","0","0","0","0","1","1","0","0","0","0","0","0","0","0","0","0","-2"
"207397","Oklahoma State University-Oklahoma City","2011","Total full-time Instruction/research/public service, Tenured total","45","19","26","1","0","1","0","0","0","1","0","1","1","1","0","0","0","0","42","18","24","0","0","0","0","0","0","0","0","0","-2"
"207397","Oklahoma State University-Oklahoma City","2011","Total full-time Instruction/research/public service, Non-tenured on tenure track, Associate professors","1","0","1","0","0","0","0","0","0","0","0","0","0","0","0","0","0","0","1","0","1","0","0","0","0","0","0","0","0","0","-2"
"207397","Oklahoma State University-Oklahoma City","2011","Total full-time Instruction/research/public service, Non-tenured on tenure track, Assistant professors","22","12","10","0","0","0","1","0","1","1","1","0","2","1","1","0","0","0","18","10","8","0","0","0","0","0","0","0","0","0","-2"
"207397","Oklahoma State University-Oklahoma City","2011","Total full-time Instruction/research/public service, Non-tenured on tenure track, Instructors","11","5","6","1","0","1","0","0","0","1","1","0","0","0","0","0","0","0","8","3","5","0","0","0","0","0","0","1","1","0","-2"
"207397","Oklahoma State University-Oklahoma City","2011","Total full-time Instruction/research/public service, Non-tenured on tenure track total","34","17","17","1","0","1","1","0","1","2","2","0","2","1","1","0","0","0","27","13","14","0","0","0","0","0","0","1","1","0","-2"
"209065","Linfield University-McMinnville Campus","2011","Total full-time Instruction/research/public service, Tenured, Professors","42","28","14","0","0","0","1","1","0","0","0","0","0","0","0","0","0","0","39","26","13","0","0","0","2","1","1","0","0","0","-2"
"209065","Linfield University-McMinnville Campus","2011","Total full-time Instruction/research/public service, Tenured, Associate professors","40","18","22","0","0","0","1","0","1","1","1","0","3","1","2","0","0","0","34","15","19","0","0","0","1","1","0","0","0","0","-2"
"209065","Linfield University-McMinnville Campus","2011","Total full-time Instruction/research/public service, Tenured, Assistant professors","2","1","1","0","0","0","0","0","0","0","0","0","0","0","0","0","0","0","2","1","1","0","0","0","0","0","0","0","0","0","-2"
"209065","Linfield University-McMinnville Campus","2011","Total full-time Instruction/research/public service, Tenured total","84","47","37","0","0","0","2","1","1","1","1","0","3","1","2","0","0","0","75","42","33","0","0","0","3","2","1","0","0","0","-2"
"209065","Linfield University-McMinnville Campus","2011","Total full-time Instruction/research/public service, Non-tenured on tenure track, Professors","1","0","1","0","0","0","0","0","0","0","0","0","0","0","0","0","0","0","1","0","1","0","0","0","0","0","0","0","0","0","-2"
"209065","Linfield University-McMinnville Campus","2011","Total full-time Instruction/research/public service, Non-tenured on tenure track, Assistant professors","29","15","14","0","0","0","1","0","1","1","1","0","0","0","0","0","0","0","18","9","9","5","5","0","4","0","4","0","0","0","-2"
"209065","Linfield University-McMinnville Campus","2011","Total full-time Instruction/research/public service, Non-tenured on tenure track total","30","15","15","0","0","0","1","0","1","1","1","0","0","0","0","0","0","0","19","9","10","5","5","0","4","0","4","0","0","0","-2"
"209065","Linfield University-McMinnville Campus","2011","Total full-time Instruction/research/public service, Non-tenured not on tenure track, Associate professors","2","0","2","1","0","1","0","0","0","0","0","0","0","0","0","0","0","0","1","0","1","0","0","0","0","0","0","0","0","0","-2"
"209065","Linfield University-McMinnville Campus","2011","Total full-time Instruction/research/public servicey, Non-tenured not on tenure track, Assistant professors","2","1","1","0","0","0","0","0","0","0","0","0","0","0","0","0","0","0","2","1","1","0","0","0","0","0","0","0","0","0","-2"
"209065","Linfield University-McMinnville Campus","2011","Total full-time Instruction/research/public service, Non-tenured not on tenure track total","4","1","3","1","0","1","0","0","0","0","0","0","0","0","0","0","0","0","3","1","2","0","0","0","0","0","0","0","0","0","-2"
"209287","Multnomah University","2011","Total full-time Instruction/research/public service, Non-tenured not on tenure track, Professors","10","10","0","0","0","0","1","1","0","0","0","0","0","0","0","0","0","0","9","9","0","0","0","0","0","0","0","0","0","0","-2"
"209287","Multnomah University","2011","Total full-time Instruction/research/public service, Non-tenured not on tenure track, Associate professors","5","3","2","0","0","0","1","1","0","0","0","0","0","0","0","0","0","0","4","2","2","0","0","0","0","0","0","0","0","0","-2"
"209287","Multnomah University","2011","Total full-time Instruction/research/public servicey, Non-tenured not on tenure track, Assistant professors","14","7","7","0","0","0","1","0","1","0","0","0","0","0","0","0","0","0","12","6","6","1","1","0","0","0","0","0","0","0","-2"
"209287","Multnomah University","2011","Total full-time Instruction/research/public service, Non-tenured not on tenure track, Instructors","3","2","1","0","0","0","0","0","0","0","0","0","0","0","0","0","0","0","3","2","1","0","0","0","0","0","0","0","0","0","-2"
"209287","Multnomah University","2011","Total full-time Instruction/research/public service, Non-tenured not on tenure track total","32","22","10","0","0","0","3","2","1","0","0","0","0","0","0","0","0","0","28","19","9","1","1","0","0","0","0","0","0","0","-2"
"209490","Oregon Health & Science University","2011","Total full-time Instruction/research/public service, Tenured, Professors","87","67","20","1","1","0","3","2","1","0","0","0","2","2","0","0","0","0","81","62","19","0","0","0","0","0","0","0","0","0","-2"
"209490","Oregon Health & Science University","2011","Total full-time Instruction/research/public service, Tenured, Associate professors","24","13","11","0","0","0","3","3","0","0","0","0","0","0","0","0","0","0","20","10","10","1","0","1","0","0","0","0","0","0","-2"
"209490","Oregon Health & Science University","2011","Total full-time Instruction/research/public service, Tenured, Assistant professors","1","0","1","0","0","0","0","0","0","0","0","0","0","0","0","0","0","0","0","0","0","0","0","0","0","0","0","1","0","1","-2"
"209490","Oregon Health & Science University","2011","Total full-time Instruction/research/public service, Tenured, No academic rank","1","1","0","0","0","0","0","0","0","0","0","0","0","0","0","0","0","0","1","1","0","0","0","0","0","0","0","0","0","0","-2"
"209490","Oregon Health & Science University","2011","Total full-time Instruction/research/public service, Tenured total","113","81","32","1","1","0","6","5","1","0","0","0","2","2","0","0","0","0","102","73","29","1","0","1","0","0","0","1","0","1","-2"
"209490","Oregon Health & Science University","2011","Total full-time Instruction/research/public service, Non-tenured on tenure track, Professors","4","3","1","0","0","0","1","1","0","0","0","0","0","0","0","0","0","0","3","2","1","0","0","0","0","0","0","0","0","0","-2"
"209490","Oregon Health & Science University","2011","Total full-time Instruction/research/public service, Non-tenured on tenure track, Associate professors","15","10","5","0","0","0","3","3","0","0","0","0","0","0","0","0","0","0","11","7","4","0","0","0","0","0","0","1","0","1","-2"
"209490","Oregon Health & Science University","2011","Total full-time Instruction/research/public service, Non-tenured on tenure track, Assistant professors","18","9","9","0","0","0","2","2","0","0","0","0","0","0","0","0","0","0","14","7","7","1","0","1","0","0","0","1","0","1","-2"
"209490","Oregon Health & Science University","2011","Total full-time Instruction/research/public service, Non-tenured on tenure track, Instructors","1","0","1","0","0","0","0","0","0","0","0","0","0","0","0","0","0","0","0","0","0","1","0","1","0","0","0","0","0","0","-2"
"209490","Oregon Health & Science University","2011","Total full-time Instruction/research/public service, Non-tenured on tenure track, No academic rank","1","1","0","0","0","0","0","0","0","0","0","0","0","0","0","0","0","0","1","1","0","0","0","0","0","0","0","0","0","0","-2"
"209490","Oregon Health & Science University","2011","Total full-time Instruction/research/public service, Non-tenured on tenure track total","39","23","16","0","0","0","6","6","0","0","0","0","0","0","0","0","0","0","29","17","12","2","0","2","0","0","0","2","0","2","-2"
"209490","Oregon Health & Science University","2011","Total full-time Instruction/research/public service, Non-tenured not on tenure track, Professors","93","72","21","0","0","0","11","8","3","0","0","0","1","1","0","0","0","0","80","62","18","0","0","0","0","0","0","1","1","0","-2"
"209490","Oregon Health & Science University","2011","Total full-time Instruction/research/public service, Non-tenured not on tenure track, Associate professors","200","117","83","0","0","0","21","14","7","0","0","0","7","4","3","0","0","0","165","96","69","0","0","0","2","1","1","5","2","3","-2"
"209490","Oregon Health & Science University","2011","Total full-time Instruction/research/public servicey, Non-tenured not on tenure track, Assistant professors","443","222","221","2","0","2","70","41","29","6","2","4","16","10","6","1","0","1","327","156","171","0","0","0","4","2","2","17","11","6","-2"
"209490","Oregon Health & Science University","2011","Total full-time Instruction/research/public service, Non-tenured not on tenure track, Instructors","266","73","193","0","0","0","18","7","11","2","2","0","4","0","4","3","1","2","226","53","173","1","0","1","1","0","1","11","10","1","-2"
"209490","Oregon Health & Science University","2011","Total full-time Instruction/research/public service, Non-tenured not on tenure track, Lecturers","8","1","7","0","0","0","0","0","0","0","0","0","0","0","0","0","0","0","8","1","7","0","0","0","0","0","0","0","0","0","-2"
"209490","Oregon Health & Science University","2011","Total full-time Instruction/research/public service, Non-tenured not on tenure track, No academic rank","65","43","22","0","0","0","12","9","3","0","0","0","1","0","1","0","0","0","41","27","14","0","0","0","0","0","0","11","7","4","-2"
"209490","Oregon Health & Science University","2011","Total full-time Instruction/research/public service, Non-tenured not on tenure track total","1075","528","547","2","0","2","132","79","53","8","4","4","29","15","14","4","1","3","847","395","452","1","0","1","7","3","4","45","31","14","-2"
"209612","Pacific University","2011","Total full-time Instruction/research/public service, Tenured, Professors","53","33","20","0","0","0","0","0","0","1","0","1","0","0","0","0","0","0","52","33","19","0","0","0","0","0","0","0","0","0","-2"
"209612","Pacific University","2011","Total full-time Instruction/research/public service, Tenured, Associate professors","47","26","21","0","0","0","4","2","2","0","0","0","2","1","1","0","0","0","41","23","18","0","0","0","0","0","0","0","0","0","-2"
"209612","Pacific University","2011","Total full-time Instruction/research/public service, Tenured total","100","59","41","0","0","0","4","2","2","1","0","1","2","1","1","0","0","0","93","56","37","0","0","0","0","0","0","0","0","0","-2"
"209612","Pacific University","2011","Total full-time Instruction/research/public service, Non-tenured on tenure track, Associate professors","4","4","0","0","0","0","1","1","0","0","0","0","0","0","0","0","0","0","3","3","0","0","0","0","0","0","0","0","0","0","-2"
"209612","Pacific University","2011","Total full-time Instruction/research/public service, Non-tenured on tenure track, Assistant professors","56","21","35","0","0","0","7","2","5","0","0","0","3","1","2","0","0","0","44","16","28","1","1","0","0","0","0","1","1","0","-2"
"209612","Pacific University","2011","Total full-time Instruction/research/public service, Non-tenured on tenure track total","60","25","35","0","0","0","8","3","5","0","0","0","3","1","2","0","0","0","47","19","28","1","1","0","0","0","0","1","1","0","-2"
"209612","Pacific University","2011","Total full-time Instruction/research/public service, Non-tenured not on tenure track, Professors","1","1","0","0","0","0","0","0","0","0","0","0","0","0","0","0","0","0","1","1","0","0","0","0","0","0","0","0","0","0","-2"
"209612","Pacific University","2011","Total full-time Instruction/research/public service, Non-tenured not on tenure track, Associate professors","3","1","2","0","0","0","0","0","0","0","0","0","0","0","0","0","0","0","3","1","2","0","0","0","0","0","0","0","0","0","-2"
"209612","Pacific University","2011","Total full-time Instruction/research/public servicey, Non-tenured not on tenure track, Assistant professors","46","19","27","0","0","0","4","1","3","2","1","1","1","0","1","0","0","0","36","14","22","3","3","0","0","0","0","0","0","0","-2"
"209612","Pacific University","2011","Total full-time Instruction/research/public service, Non-tenured not on tenure track, Instructors","9","4","5","0","0","0","0","0","0","0","0","0","1","1","0","1","0","1","6","3","3","0","0","0","0","0","0","1","0","1","-2"
"209612","Pacific University","2011","Total full-time Instruction/research/public service, Non-tenured not on tenure track total","59","25","34","0","0","0","4","1","3","2","1","1","2","1","1","1","0","1","46","19","27","3","3","0","0","0","0","1","0","1","-2"
"209807","Portland State University","2011","Total full-time Instruction/research/public service, Tenured, Professors","208","145","63","3","2","1","16","11","5","5","4","1","3","2","1","0","0","0","156","108","48","0","0","0","21","14","7","4","4","0","-2"
"209807","Portland State University","2011","Total full-time Instruction/research/public service, Tenured, Associate professors","147","90","57","3","1","2","10","8","2","3","2","1","9","8","1","0","0","0","106","62","44","2","0","2","10","6","4","4","3","1","-2"
"209807","Portland State University","2011","Total full-time Instruction/research/public service, Tenured, Assistant professors","2","2","0","0","0","0","0","0","0","0","0","0","0","0","0","0","0","0","2","2","0","0","0","0","0","0","0","0","0","0","-2"
"209807","Portland State University","2011","Total full-time Instruction/research/public service, Tenured total","357","237","120","6","3","3","26","19","7","8","6","2","12","10","2","0","0","0","264","172","92","2","0","2","31","20","11","8","7","1","-2"
"209807","Portland State University","2011","Total full-time Instruction/research/public service, Non-tenured on tenure track, Professors","2","1","1","0","0","0","1","0","1","0","0","0","0","0","0","0","0","0","1","1","0","0","0","0","0","0","0","0","0","0","-2"
"209807","Portland State University","2011","Total full-time Instruction/research/public service, Non-tenured on tenure track, Associate professors","24","13","11","0","0","0","1","1","0","2","1","1","1","1","0","0","0","0","17","7","10","0","0","0","1","1","0","2","2","0","-2"
"209807","Portland State University","2011","Total full-time Instruction/research/public service, Non-tenured on tenure track, Assistant professors","153","67","86","1","0","1","6","2","4","2","0","2","10","4","6","0","0","0","100","46","54","5","2","3","9","6","3","20","7","13","-2"
"209807","Portland State University","2011","Total full-time Instruction/research/public service, Non-tenured on tenure track total","179","81","98","1","0","1","8","3","5","4","1","3","11","5","6","0","0","0","118","54","64","5","2","3","10","7","3","22","9","13","-2"
"209807","Portland State University","2011","Total full-time Instruction/research/public service, Non-tenured not on tenure track, Professors","6","4","2","0","0","0","0","0","0","0","0","0","0","0","0","0","0","0","6","4","2","0","0","0","0","0","0","0","0","0","-2"
"209807","Portland State University","2011","Total full-time Instruction/research/public service, Non-tenured not on tenure track, Associate professors","9","3","6","0","0","0","1","0","1","1","1","0","0","0","0","0","0","0","7","2","5","0","0","0","0","0","0","0","0","0","-2"
"209807","Portland State University","2011","Total full-time Instruction/research/public servicey, Non-tenured not on tenure track, Assistant professors","64","25","39","0","0","0","2","1","1","0","0","0","3","2","1","0","0","0","45","14","31","1","0","1","5","4","1","8","4","4","-2"
"209807","Portland State University","2011","Total full-time Instruction/research/public service, Non-tenured not on tenure track, Instructors","138","44","94","1","0","1","2","0","2","2","0","2","4","1","3","0","0","0","117","38","79","3","0","3","5","3","2","4","2","2","-2"
"209807","Portland State University","2011","Total full-time Instruction/research/public service, Non-tenured not on tenure track, No academic rank","96","52","44","0","0","0","6","4","2","0","0","0","3","1","2","0","0","0","59","31","28","2","1","1","6","3","3","20","12","8","-2"
"209807","Portland State University","2011","Total full-time Instruction/research/public service, Non-tenured not on tenure track total","313","128","185","1","0","1","11","5","6","3","1","2","10","4","6","0","0","0","234","89","145","6","1","5","16","10","6","32","18","14","-2"
"210429","Western Oregon University","2011","Total full-time Instruction/research/public service, Tenured, Professors","66","43","23","0","0","0","2","1","1","1","1","0","3","2","1","0","0","0","59","38","21","0","0","0","1","1","0","0","0","0","-2"
"210429","Western Oregon University","2011","Total full-time Instruction/research/public service, Tenured, Associate professors","47","21","26","0","0","0","0","0","0","1","0","1","2","0","2","0","0","0","42","19","23","0","0","0","1","1","0","1","1","0","-2"
"210429","Western Oregon University","2011","Total full-time Instruction/research/public service, Tenured total","113","64","49","0","0","0","2","1","1","2","1","1","5","2","3","0","0","0","101","57","44","0","0","0","2","2","0","1","1","0","-2"
"210429","Western Oregon University","2011","Total full-time Instruction/research/public service, Non-tenured on tenure track, Associate professors","1","1","0","0","0","0","0","0","0","0","0","0","0","0","0","0","0","0","0","0","0","0","0","0","1","1","0","0","0","0","-2"
"210429","Western Oregon University","2011","Total full-time Instruction/research/public service, Non-tenured on tenure track, Assistant professors","34","14","20","0","0","0","0","0","0","0","0","0","3","2","1","0","0","0","26","11","15","0","0","0","0","0","0","5","1","4","-2"
"210429","Western Oregon University","2011","Total full-time Instruction/research/public service, Non-tenured on tenure track total","35","15","20","0","0","0","0","0","0","0","0","0","3","2","1","0","0","0","26","11","15","0","0","0","1","1","0","5","1","4","-2"
"210429","Western Oregon University","2011","Total full-time Instruction/research/public servicey, Non-tenured not on tenure track, Assistant professors","21","10","11","0","0","0","1","1","0","1","0","1","1","1","0","0","0","0","18","8","10","0","0","0","0","0","0","0","0","0","-2"
"210429","Western Oregon University","2011","Total full-time Instruction/research/public service, Non-tenured not on tenure track, Instructors","38","20","18","1","0","1","0","0","0","1","0","1","3","1","2","1","1","0","31","18","13","1","0","1","0","0","0","0","0","0","-2"
"210429","Western Oregon University","2011","Total full-time Instruction/research/public service, Non-tenured not on tenure track, Lecturers","2","0","2","0","0","0","0","0","0","0","0","0","0","0","0","0","0","0","2","0","2","0","0","0","0","0","0","0","0","0","-2"
"210429","Western Oregon University","2011","Total full-time Instruction/research/public service, Non-tenured not on tenure track, No academic rank","28","8","20","0","0","0","1","0","1","0","0","0","0","0","0","0","0","0","27","8","19","0","0","0","0","0","0","0","0","0","-2"
"210429","Western Oregon University","2011","Total full-time Instruction/research/public service, Non-tenured not on tenure track total","89","38","51","1","0","1","2","1","1","2","0","2","4","2","2","1","1","0","78","34","44","1","0","1","0","0","0","0","0","0","-2"
"210571","Albright College","2011","Total full-time Instruction/research/public service, Tenured, Professors","29","18","11","1","1","0","2","2","0","0","0","0","2","2","0","0","0","0","24","13","11","0","0","0","0","0","0","0","0","0","-2"
"210571","Albright College","2011","Total full-time Instruction/research/public service, Tenured, Associate professors","37","23","14","0","0","0","0","0","0","2","0","2","1","0","1","0","0","0","34","23","11","0","0","0","0","0","0","0","0","0","-2"
"210571","Albright College","2011","Total full-time Instruction/research/public service, Tenured total","66","41","25","1","1","0","2","2","0","2","0","2","3","2","1","0","0","0","58","36","22","0","0","0","0","0","0","0","0","0","-2"
"210571","Albright College","2011","Total full-time Instruction/research/public service, Non-tenured on tenure track, Associate professors","2","1","1","0","0","0","0","0","0","0","0","0","0","0","0","0","0","0","2","1","1","0","0","0","0","0","0","0","0","0","-2"
"210571","Albright College","2011","Total full-time Instruction/research/public service, Non-tenured on tenure track, Assistant professors","17","10","7","0","0","0","0","0","0","0","0","0","0","0","0","0","0","0","16","10","6","0","0","0","1","0","1","0","0","0","-2"
"210571","Albright College","2011","Total full-time Instruction/research/public service, Non-tenured on tenure track total","19","11","8","0","0","0","0","0","0","0","0","0","0","0","0","0","0","0","18","11","7","0","0","0","1","0","1","0","0","0","-2"
"210571","Albright College","2011","Total full-time Instruction/research/public service, Non-tenured not on tenure track, Associate professors","1","1","0","0","0","0","0","0","0","0","0","0","0","0","0","0","0","0","1","1","0","0","0","0","0","0","0","0","0","0","-2"
"210571","Albright College","2011","Total full-time Instruction/research/public servicey, Non-tenured not on tenure track, Assistant professors","13","5","8","0","0","0","0","0","0","0","0","0","1","1","0","0","0","0","12","4","8","0","0","0","0","0","0","0","0","0","-2"
"210571","Albright College","2011","Total full-time Instruction/research/public service, Non-tenured not on tenure track, Instructors","21","5","16","0","0","0","1","0","1","1","1","0","1","0","1","0","0","0","18","4","14","0","0","0","0","0","0","0","0","0","-2"
"210571","Albright College","2011","Total full-time Instruction/research/public service, Non-tenured not on tenure track total","35","11","24","0","0","0","1","0","1","1","1","0","2","1","1","0","0","0","31","9","22","0","0","0","0","0","0","0","0","0","-2"
"212133","Eastern University","2011","Total full-time Instruction/research/public service, Tenured, Professors","39","22","17","0","0","0","2","1","1","3","1","2","1","0","1","0","0","0","33","20","13","0","0","0","0","0","0","0","0","0","-2"
"212133","Eastern University","2011","Total full-time Instruction/research/public service, Tenured, Associate professors","29","18","11","0","0","0","1","0","1","5","2","3","3","2","1","0","0","0","20","14","6","0","0","0","0","0","0","0","0","0","-2"
"212133","Eastern University","2011","Total full-time Instruction/research/public service, Tenured total","68","40","28","0","0","0","3","1","2","8","3","5","4","2","2","0","0","0","53","34","19","0","0","0","0","0","0","0","0","0","-2"
"212133","Eastern University","2011","Total full-time Instruction/research/public service, Non-tenured on tenure track, Professors","1","1","0","0","0","0","0","0","0","0","0","0","0","0","0","0","0","0","1","1","0","0","0","0","0","0","0","0","0","0","-2"
"212133","Eastern University","2011","Total full-time Instruction/research/public service, Non-tenured on tenure track, Associate professors","21","15","6","0","0","0","1","1","0","6","3","3","0","0","0","0","0","0","14","11","3","0","0","0","0","0","0","0","0","0","-2"
"212133","Eastern University","2011","Total full-time Instruction/research/public service, Non-tenured on tenure track, Assistant professors","15","9","6","0","0","0","2","2","0","1","0","1","0","0","0","0","0","0","10","6","4","0","0","0","2","1","1","0","0","0","-2"
"212133","Eastern University","2011","Total full-time Instruction/research/public service, Non-tenured on tenure track total","37","25","12","0","0","0","3","3","0","7","3","4","0","0","0","0","0","0","25","18","7","0","0","0","2","1","1","0","0","0","-2"
"212133","Eastern University","2011","Total full-time Instruction/research/public servicey, Non-tenured not on tenure track, Assistant professors","5","3","2","0","0","0","0","0","0","0","0","0","0","0","0","0","0","0","5","3","2","0","0","0","0","0","0","0","0","0","-2"
"212133","Eastern University","2011","Total full-time Instruction/research/public service, Non-tenured not on tenure track, Lecturers","35","13","22","0","0","0","1","0","1","4","0","4","3","0","3","0","0","0","27","13","14","0","0","0","0","0","0","0","0","0","-2"
"212133","Eastern University","2011","Total full-time Instruction/research/public service, Non-tenured not on tenure track total","40","16","24","0","0","0","1","0","1","4","0","4","3","0","3","0","0","0","32","16","16","0","0","0","0","0","0","0","0","0","-2"
"213367","La Salle University","2011","Total full-time Instruction/research/public service, Tenured, Professors","53","38","15","0","0","0","1","1","0","1","1","0","1","1","0","0","0","0","49","34","15","1","1","0","0","0","0","0","0","0","-2"
"213367","La Salle University","2011","Total full-time Instruction/research/public service, Tenured, Associate professors","73","36","37","0","0","0","5","2","3","1","0","1","3","2","1","0","0","0","64","32","32","0","0","0","0","0","0","0","0","0","-2"
"213367","La Salle University","2011","Total full-time Instruction/research/public service, Tenured, Assistant professors","14","9","5","0","0","0","1","1","0","0","0","0","0","0","0","0","0","0","13","8","5","0","0","0","0","0","0","0","0","0","-2"
"213367","La Salle University","2011","Total full-time Instruction/research/public service, Tenured total","140","83","57","0","0","0","7","4","3","2","1","1","4","3","1","0","0","0","126","74","52","1","1","0","0","0","0","0","0","0","-2"
"213367","La Salle University","2011","Total full-time Instruction/research/public service, Non-tenured on tenure track, Associate professors","2","0","2","0","0","0","0","0","0","0","0","0","0","0","0","0","0","0","2","0","2","0","0","0","0","0","0","0","0","0","-2"
"213367","La Salle University","2011","Total full-time Instruction/research/public service, Non-tenured on tenure track, Assistant professors","39","15","24","0","0","0","1","0","1","2","0","2","1","0","1","0","0","0","34","14","20","0","0","0","0","0","0","1","1","0","-2"
"213367","La Salle University","2011","Total full-time Instruction/research/public service, Non-tenured on tenure track total","41","15","26","0","0","0","1","0","1","2","0","2","1","0","1","0","0","0","36","14","22","0","0","0","0","0","0","1","1","0","-2"
"213367","La Salle University","2011","Total full-time Instruction/research/public service, Non-tenured not on tenure track, Professors","1","1","0","0","0","0","0","0","0","0","0","0","0","0","0","0","0","0","1","1","0","0","0","0","0","0","0","0","0","0","-2"
"213367","La Salle University","2011","Total full-time Instruction/research/public service, Non-tenured not on tenure track, Associate professors","1","1","0","0","0","0","0","0","0","0","0","0","0","0","0","0","0","0","1","1","0","0","0","0","0","0","0","0","0","0","-2"
"213367","La Salle University","2011","Total full-time Instruction/research/public servicey, Non-tenured not on tenure track, Assistant professors","37","8","29","0","0","0","0","0","0","0","0","0","0","0","0","0","0","0","37","8","29","0","0","0","0","0","0","0","0","0","-2"
"213367","La Salle University","2011","Total full-time Instruction/research/public service, Non-tenured not on tenure track, Instructors","14","4","10","0","0","0","0","0","0","2","0","2","1","1","0","0","0","0","11","3","8","0","0","0","0","0","0","0","0","0","-2"
"213367","La Salle University","2011","Total full-time Instruction/research/public service, Non-tenured not on tenure track total","53","14","39","0","0","0","0","0","0","2","0","2","1","1","0","0","0","0","50","13","37","0","0","0","0","0","0","0","0","0","-2"
"213774","Manor College","2011","Total full-time Instruction/research/public service, Non-tenured not on tenure track, Professors","8","1","7","0","0","0","0","0","0","0","0","0","0","0","0","0","0","0","8","1","7","0","0","0","0","0","0","0","0","0","-2"
"213774","Manor College","2011","Total full-time Instruction/research/public service, Non-tenured not on tenure track, Associate professors","10","4","6","0","0","0","0","0","0","0","0","0","0","0","0","0","0","0","10","4","6","0","0","0","0","0","0","0","0","0","-2"
"213774","Manor College","2011","Total full-time Instruction/research/public servicey, Non-tenured not on tenure track, Assistant professors","4","0","4","0","0","0","0","0","0","1","0","1","0","0","0","0","0","0","3","0","3","0","0","0","0","0","0","0","0","0","-2"
"213774","Manor College","2011","Total full-time Instruction/research/public service, Non-tenured not on tenure track, Instructors","2","0","2","0","0","0","0","0","0","0","0","0","0","0","0","0","0","0","2","0","2","0","0","0","0","0","0","0","0","0","-2"
"213774","Manor College","2011","Total full-time Instruction/research/public service, Non-tenured not on tenure track total","24","5","19","0","0","0","0","0","0","1","0","1","0","0","0","0","0","0","23","5","18","0","0","0","0","0","0","0","0","0","-2"
"216542","University of Valley Forge","2011","Total full-time Instruction/research/public service, Non-tenured not on tenure track, Professors","11","10","1","0","0","0","0","0","0","0","0","0","0","0","0","1","0","1","10","10","0","0","0","0","0","0","0","0","0","0","-2"
"216542","University of Valley Forge","2011","Total full-time Instruction/research/public service, Non-tenured not on tenure track, Associate professors","6","4","2","0","0","0","0","0","0","0","0","0","0","0","0","0","0","0","6","4","2","0","0","0","0","0","0","0","0","0","-2"
"216542","University of Valley Forge","2011","Total full-time Instruction/research/public servicey, Non-tenured not on tenure track, Assistant professors","16","7","9","0","0","0","0","0","0","2","1","1","0","0","0","0","0","0","14","6","8","0","0","0","0","0","0","0","0","0","-2"
"216542","University of Valley Forge","2011","Total full-time Instruction/research/public service, Non-tenured not on tenure track total","33","21","12","0","0","0","0","0","0","2","1","1","0","0","0","1","0","1","30","20","10","0","0","0","0","0","0","0","0","0","-2"
"217420","Rhode Island College","2011","Total full-time Instruction/research/public service, Tenured, Professors","118","67","51","0","0","0","6","4","2","3","2","1","1","1","0","0","0","0","108","60","48","0","0","0","0","0","0","0","0","0","-2"
"217420","Rhode Island College","2011","Total full-time Instruction/research/public service, Tenured, Associate professors","102","44","58","1","0","1","8","4","4","3","1","2","4","2","2","0","0","0","86","37","49","0","0","0","0","0","0","0","0","0","-2"
"217420","Rhode Island College","2011","Total full-time Instruction/research/public service, Tenured, Assistant professors","13","5","8","0","0","0","0","0","0","0","0","0","0","0","0","0","0","0","13","5","8","0","0","0","0","0","0","0","0","0","-2"
"217420","Rhode Island College","2011","Total full-time Instruction/research/public service, Tenured total","233","116","117","1","0","1","14","8","6","6","3","3","5","3","2","0","0","0","207","102","105","0","0","0","0","0","0","0","0","0","-2"
"217420","Rhode Island College","2011","Total full-time Instruction/research/public service, Non-tenured on tenure track, Professors","1","1","0","0","0","0","0","0","0","0","0","0","0","0","0","0","0","0","1","1","0","0","0","0","0","0","0","0","0","0","-2"
"217420","Rhode Island College","2011","Total full-time Instruction/research/public service, Non-tenured on tenure track, Associate professors","3","1","2","0","0","0","0","0","0","0","0","0","0","0","0","0","0","0","3","1","2","0","0","0","0","0","0","0","0","0","-2"
"217420","Rhode Island College","2011","Total full-time Instruction/research/public service, Non-tenured on tenure track, Assistant professors","82","24","58","0","0","0","9","5","4","1","1","0","2","2","0","0","0","0","70","16","54","0","0","0","0","0","0","0","0","0","-2"
"217420","Rhode Island College","2011","Total full-time Instruction/research/public service, Non-tenured on tenure track, Instructors","4","0","4","0","0","0","0","0","0","0","0","0","0","0","0","0","0","0","4","0","4","0","0","0","0","0","0","0","0","0","-2"
"217420","Rhode Island College","2011","Total full-time Instruction/research/public service, Non-tenured on tenure track total","90","26","64","0","0","0","9","5","4","1","1","0","2","2","0","0","0","0","78","18","60","0","0","0","0","0","0","0","0","0","-2"
"217420","Rhode Island College","2011","Total full-time Instruction/research/public service, Non-tenured not on tenure track, Associate professors","3","1","2","0","0","0","0","0","0","0","0","0","0","0","0","0","0","0","3","1","2","0","0","0","0","0","0","0","0","0","-2"
"217420","Rhode Island College","2011","Total full-time Instruction/research/public servicey, Non-tenured not on tenure track, Assistant professors","22","3","19","0","0","0","1","0","1","0","0","0","1","1","0","0","0","0","20","2","18","0","0","0","0","0","0","0","0","0","-2"
"217420","Rhode Island College","2011","Total full-time Instruction/research/public service, Non-tenured not on tenure track total","25","4","21","0","0","0","1","0","1","0","0","0","1","1","0","0","0","0","23","3","20","0","0","0","0","0","0","0","0","0","-2"
"221661","Southern Adventist University","2011","Total full-time Instruction/research/public service, Non-tenured not on tenure track, Professors","71","52","19","0","0","0","0","0","0","3","2","1","2","2","0","0","0","0","66","48","18","0","0","0","0","0","0","0","0","0","-2"
"221661","Southern Adventist University","2011","Total full-time Instruction/research/public service, Non-tenured not on tenure track, Associate professors","55","27","28","0","0","0","1","0","1","2","0","2","4","2","2","0","0","0","48","25","23","0","0","0","0","0","0","0","0","0","-2"
"221661","Southern Adventist University","2011","Total full-time Instruction/research/public servicey, Non-tenured not on tenure track, Assistant professors","30","10","20","0","0","0","0","0","0","1","1","0","2","1","1","0","0","0","26","7","19","0","0","0","0","0","0","1","1","0","-2"
"221661","Southern Adventist University","2011","Total full-time Instruction/research/public service, Non-tenured not on tenure track, Instructors","5","1","4","0","0","0","0","0","0","0","0","0","1","0","1","0","0","0","4","1","3","0","0","0","0","0","0","0","0","0","-2"
"221661","Southern Adventist University","2011","Total full-time Instruction/research/public service, Non-tenured not on tenure track total","161","90","71","0","0","0","1","0","1","6","3","3","9","5","4","0","0","0","144","81","63","0","0","0","0","0","0","1","1","0","-2"
"222178","Abilene Christian University","2011","Total full-time Instruction/research/public service, Tenured, Professors","62","54","8","0","0","0","0","0","0","1","1","0","2","1","1","0","0","0","59","52","7","0","0","0","0","0","0","0","0","0","-2"
"222178","Abilene Christian University","2011","Total full-time Instruction/research/public service, Tenured, Associate professors","60","39","21","0","0","0","1","0","1","1","1","0","2","1","1","0","0","0","53","35","18","3","2","1","0","0","0","0","0","0","-2"
"222178","Abilene Christian University","2011","Total full-time Instruction/research/public service, Tenured, Assistant professors","9","5","4","0","0","0","0","0","0","1","1","0","0","0","0","0","0","0","8","4","4","0","0","0","0","0","0","0","0","0","-2"
"222178","Abilene Christian University","2011","Total full-time Instruction/research/public service, Tenured total","131","98","33","0","0","0","1","0","1","3","3","0","4","2","2","0","0","0","120","91","29","3","2","1","0","0","0","0","0","0","-2"
"222178","Abilene Christian University","2011","Total full-time Instruction/research/public service, Non-tenured on tenure track, Associate professors","10","10","0","1","1","0","0","0","0","1","1","0","0","0","0","0","0","0","8","8","0","0","0","0","0","0","0","0","0","0","-2"
"222178","Abilene Christian University","2011","Total full-time Instruction/research/public service, Non-tenured on tenure track, Assistant professors","60","35","25","0","0","0","1","1","0","3","1","2","1","0","1","0","0","0","51","30","21","2","1","1","0","0","0","2","2","0","-2"
"222178","Abilene Christian University","2011","Total full-time Instruction/research/public service, Non-tenured on tenure track, Instructors","1","1","0","0","0","0","0","0","0","0","0","0","0","0","0","0","0","0","1","1","0","0","0","0","0","0","0","0","0","0","-2"
"222178","Abilene Christian University","2011","Total full-time Instruction/research/public service, Non-tenured on tenure track total","71","46","25","1","1","0","1","1","0","4","2","2","1","0","1","0","0","0","60","39","21","2","1","1","0","0","0","2","2","0","-2"
"222178","Abilene Christian University","2011","Total full-time Instruction/research/public service, Non-tenured not on tenure track, Professors","1","1","0","0","0","0","0","0","0","0","0","0","0","0","0","0","0","0","1","1","0","0","0","0","0","0","0","0","0","0","-2"
"222178","Abilene Christian University","2011","Total full-time Instruction/research/public service, Non-tenured not on tenure track, Associate professors","1","1","0","0","0","0","0","0","0","0","0","0","0","0","0","0","0","0","1","1","0","0","0","0","0","0","0","0","0","0","-2"
"222178","Abilene Christian University","2011","Total full-time Instruction/research/public servicey, Non-tenured not on tenure track, Assistant professors","8","5","3","0","0","0","0","0","0","0","0","0","0","0","0","0","0","0","8","5","3","0","0","0","0","0","0","0","0","0","-2"
"222178","Abilene Christian University","2011","Total full-time Instruction/research/public service, Non-tenured not on tenure track, Instructors","34","15","19","0","0","0","0","0","0","0","0","0","2","2","0","0","0","0","32","13","19","0","0","0","0","0","0","0","0","0","-2"
"222178","Abilene Christian University","2011","Total full-time Instruction/research/public service, Non-tenured not on tenure track total","44","22","22","0","0","0","0","0","0","0","0","0","2","2","0","0","0","0","42","20","22","0","0","0","0","0","0","0","0","0","-2"
"222983","Austin College","2011","Total full-time Instruction/research/public service, Tenured, Professors","27","20","7","0","0","0","0","0","0","0","0","0","0","0","0","0","0","0","27","20","7","0","0","0","0","0","0","0","0","0","-2"
"222983","Austin College","2011","Total full-time Instruction/research/public service, Tenured, Associate professors","42","28","14","1","1","0","0","0","0","1","0","1","4","1","3","0","0","0","35","25","10","0","0","0","0","0","0","1","1","0","-2"
"222983","Austin College","2011","Total full-time Instruction/research/public service, Tenured total","69","48","21","1","1","0","0","0","0","1","0","1","4","1","3","0","0","0","62","45","17","0","0","0","0","0","0","1","1","0","-2"
"222983","Austin College","2011","Total full-time Instruction/research/public service, Non-tenured on tenure track, Assistant professors","18","12","6","0","0","0","1","0","1","0","0","0","0","0","0","0","0","0","17","12","5","0","0","0","0","0","0","0","0","0","-2"
"222983","Austin College","2011","Total full-time Instruction/research/public service, Non-tenured on tenure track, Instructors","1","0","1","0","0","0","0","0","0","0","0","0","0","0","0","0","0","0","1","0","1","0","0","0","0","0","0","0","0","0","-2"
"222983","Austin College","2011","Total full-time Instruction/research/public service, Non-tenured on tenure track total","19","12","7","0","0","0","1","0","1","0","0","0","0","0","0","0","0","0","18","12","6","0","0","0","0","0","0","0","0","0","-2"
"223232","Baylor University","2011","Total full-time Instruction/research/public service, Tenured, Professors","223","192","31","1","1","0","4","4","0","4","3","1","4","4","0","1","1","0","197","167","30","6","6","0","3","3","0","3","3","0","-2"
"223232","Baylor University","2011","Total full-time Instruction/research/public service, Tenured, Associate professors","189","131","58","0","0","0","11","8","3","3","1","2","7","6","1","0","0","0","161","112","49","4","2","2","1","1","0","2","1","1","-2"
"223232","Baylor University","2011","Total full-time Instruction/research/public service, Tenured, Assistant professors","2","0","2","0","0","0","0","0","0","0","0","0","0","0","0","0","0","0","2","0","2","0","0","0","0","0","0","0","0","0","-2"
"223232","Baylor University","2011","Total full-time Instruction/research/public service, Tenured, Instructors","1","0","1","0","0","0","0","0","0","0","0","0","0","0","0","0","0","0","1","0","1","0","0","0","0","0","0","0","0","0","-2"
"223232","Baylor University","2011","Total full-time Instruction/research/public service, Tenured total","415","323","92","1","1","0","15","12","3","7","4","3","11","10","1","1","1","0","361","279","82","10","8","2","4","4","0","5","4","1","-2"
"223232","Baylor University","2011","Total full-time Instruction/research/public service, Non-tenured on tenure track, Professors","4","2","2","0","0","0","0","0","0","0","0","0","0","0","0","0","0","0","4","2","2","0","0","0","0","0","0","0","0","0","-2"
"223232","Baylor University","2011","Total full-time Instruction/research/public service, Non-tenured on tenure track, Associate professors","21","11","10","0","0","0","2","2","0","1","0","1","1","1","0","0","0","0","17","8","9","0","0","0","0","0","0","0","0","0","-2"
"223232","Baylor University","2011","Total full-time Instruction/research/public service, Non-tenured on tenure track, Assistant professors","161","95","66","0","0","0","12","9","3","3","0","3","5","1","4","0","0","0","126","73","53","1","1","0","2","1","1","12","10","2","-2"
"223232","Baylor University","2011","Total full-time Instruction/research/public service, Non-tenured on tenure track total","186","108","78","0","0","0","14","11","3","4","0","4","6","2","4","0","0","0","147","83","64","1","1","0","2","1","1","12","10","2","-2"
"223232","Baylor University","2011","Total full-time Instruction/research/public service, Non-tenured not on tenure track, Professors","5","4","1","0","0","0","0","0","0","0","0","0","0","0","0","0","0","0","4","4","0","0","0","0","1","0","1","0","0","0","-2"
"223232","Baylor University","2011","Total full-time Instruction/research/public service, Non-tenured not on tenure track, Associate professors","2","1","1","0","0","0","0","0","0","0","0","0","0","0","0","0","0","0","2","1","1","0","0","0","0","0","0","0","0","0","-2"
"223232","Baylor University","2011","Total full-time Instruction/research/public servicey, Non-tenured not on tenure track, Assistant professors","2","0","2","0","0","0","0","0","0","0","0","0","0","0","0","0","0","0","2","0","2","0","0","0","0","0","0","0","0","0","-2"
"223232","Baylor University","2011","Total full-time Instruction/research/public service, Non-tenured not on tenure track, Lecturers","286","120","166","1","0","1","4","1","3","3","1","2","9","5","4","0","0","0","255","103","152","2","1","1","3","2","1","9","7","2","-2"
"223232","Baylor University","2011","Total full-time Instruction/research/public service, Non-tenured not on tenure track total","295","125","170","1","0","1","4","1","3","3","1","2","9","5","4","0","0","0","263","108","155","2","1","1","4","2","2","9","7","2","-2"
"224226","Dallas Baptist University","2011","Total full-time Instruction/research/public service, Tenured, Professors","1","0","1","0","0","0","0","0","0","0","0","0","0","0","0","0","0","0","1","0","1","0","0","0","0","0","0","0","0","0","-2"
"224226","Dallas Baptist University","2011","Total full-time Instruction/research/public service, Tenured total","1","0","1","0","0","0","0","0","0","0","0","0","0","0","0","0","0","0","1","0","1","0","0","0","0","0","0","0","0","0","-2"
"224226","Dallas Baptist University","2011","Total full-time Instruction/research/public service, Non-tenured not on tenure track, Professors","52","33","19","0","0","0","3","3","0","0","0","0","2","2","0","0","0","0","47","28","19","0","0","0","0","0","0","0","0","0","-2"
"224226","Dallas Baptist University","2011","Total full-time Instruction/research/public service, Non-tenured not on tenure track, Associate professors","12","8","4","0","0","0","0","0","0","0","0","0","1","1","0","0","0","0","11","7","4","0","0","0","0","0","0","0","0","0","-2"
"224226","Dallas Baptist University","2011","Total full-time Instruction/research/public servicey, Non-tenured not on tenure track, Assistant professors","53","30","23","0","0","0","4","3","1","3","1","2","2","1","1","0","0","0","44","25","19","0","0","0","0","0","0","0","0","0","-2"
"224226","Dallas Baptist University","2011","Total full-time Instruction/research/public service, Non-tenured not on tenure track total","117","71","46","0","0","0","7","6","1","3","1","2","5","4","1","0","0","0","102","60","42","0","0","0","0","0","0","0","0","0","-2"
"224244","Dallas Christian College","2011","Total full-time Instruction/research/public service, Non-tenured not on tenure track, Professors","4","3","1","0","0","0","0","0","0","0","0","0","0","0","0","0","0","0","4","3","1","0","0","0","0","0","0","0","0","0","-2"
"224244","Dallas Christian College","2011","Total full-time Instruction/research/public service, Non-tenured not on tenure track, Associate professors","5","4","1","0","0","0","0","0","0","0","0","0","0","0","0","0","0","0","5","4","1","0","0","0","0","0","0","0","0","0","-2"
"224244","Dallas Christian College","2011","Total full-time Instruction/research/public service, Non-tenured not on tenure track total","9","7","2","0","0","0","0","0","0","0","0","0","0","0","0","0","0","0","9","7","2","0","0","0","0","0","0","0","0","0","-2"
"224323","University of Dallas","2011","Total full-time Instruction/research/public service, Tenured, Professors","23","19","4","0","0","0","1","1","0","0","0","0","0","0","0","0","0","0","22","18","4","0","0","0","0","0","0","0","0","0","-2"
"224323","University of Dallas","2011","Total full-time Instruction/research/public service, Tenured, Associate professors","36","27","9","0","0","0","0","0","0","0","0","0","1","1","0","0","0","0","33","25","8","0","0","0","2","1","1","0","0","0","-2"
"224323","University of Dallas","2011","Total full-time Instruction/research/public service, Tenured, Assistant professors","7","7","0","0","0","0","1","1","0","0","0","0","0","0","0","0","0","0","5","5","0","0","0","0","0","0","0","1","1","0","-2"
"224323","University of Dallas","2011","Total full-time Instruction/research/public service, Tenured total","66","53","13","0","0","0","2","2","0","0","0","0","1","1","0","0","0","0","60","48","12","0","0","0","2","1","1","1","1","0","-2"
"224323","University of Dallas","2011","Total full-time Instruction/research/public service, Non-tenured on tenure track, Associate professors","3","2","1","0","0","0","0","0","0","0","0","0","0","0","0","0","0","0","3","2","1","0","0","0","0","0","0","0","0","0","-2"
"224323","University of Dallas","2011","Total full-time Instruction/research/public service, Non-tenured on tenure track, Assistant professors","32","18","14","0","0","0","1","0","1","0","0","0","1","1","0","0","0","0","29","17","12","0","0","0","0","0","0","1","0","1","-2"
"224323","University of Dallas","2011","Total full-time Instruction/research/public service, Non-tenured on tenure track total","35","20","15","0","0","0","1","0","1","0","0","0","1","1","0","0","0","0","32","19","13","0","0","0","0","0","0","1","0","1","-2"
"224323","University of Dallas","2011","Total full-time Instruction/research/public service, Non-tenured not on tenure track, Professors","1","1","0","0","0","0","0","0","0","0","0","0","0","0","0","0","0","0","1","1","0","0","0","0","0","0","0","0","0","0","-2"
"224323","University of Dallas","2011","Total full-time Instruction/research/public servicey, Non-tenured not on tenure track, Assistant professors","11","6","5","0","0","0","0","0","0","0","0","0","0","0","0","0","0","0","11","6","5","0","0","0","0","0","0","0","0","0","-2"
"224323","University of Dallas","2011","Total full-time Instruction/research/public service, Non-tenured not on tenure track, Instructors","14","5","9","0","0","0","0","0","0","0","0","0","1","0","1","0","0","0","9","4","5","0","0","0","0","0","0","4","1","3","-2"
"224323","University of Dallas","2011","Total full-time Instruction/research/public service, Non-tenured not on tenure track total","26","12","14","0","0","0","0","0","0","0","0","0","1","0","1","0","0","0","21","11","10","0","0","0","0","0","0","4","1","3","-2"
"224545","Texas A&M University-Texarkana","2011","Total full-time Instruction/research/public service, Tenured, Professors","22","11","11","0","0","0","2","2","0","2","1","1","0","0","0","0","0","0","18","8","10","0","0","0","0","0","0","0","0","0","-2"
"224545","Texas A&M University-Texarkana","2011","Total full-time Instruction/research/public service, Tenured, Associate professors","11","6","5","0","0","0","1","1","0","0","0","0","1","0","1","0","0","0","9","5","4","0","0","0","0","0","0","0","0","0","-2"
"224545","Texas A&M University-Texarkana","2011","Total full-time Instruction/research/public service, Tenured, Assistant professors","1","1","0","0","0","0","0","0","0","0","0","0","0","0","0","0","0","0","1","1","0","0","0","0","0","0","0","0","0","0","-2"
"224545","Texas A&M University-Texarkana","2011","Total full-time Instruction/research/public service, Tenured total","34","18","16","0","0","0","3","3","0","2","1","1","1","0","1","0","0","0","28","14","14","0","0","0","0","0","0","0","0","0","-2"
"224545","Texas A&M University-Texarkana","2011","Total full-time Instruction/research/public service, Non-tenured on tenure track, Professors","1","1","0","0","0","0","0","0","0","0","0","0","0","0","0","0","0","0","1","1","0","0","0","0","0","0","0","0","0","0","-2"
"224545","Texas A&M University-Texarkana","2011","Total full-time Instruction/research/public service, Non-tenured on tenure track, Associate professors","7","6","1","0","0","0","1","1","0","1","1","0","0","0","0","0","0","0","5","4","1","0","0","0","0","0","0","0","0","0","-2"
"224545","Texas A&M University-Texarkana","2011","Total full-time Instruction/research/public service, Non-tenured on tenure track, Assistant professors","4","3","1","0","0","0","0","0","0","0","0","0","0","0","0","0","0","0","3","2","1","0","0","0","0","0","0","1","1","0","-2"
"224545","Texas A&M University-Texarkana","2011","Total full-time Instruction/research/public service, Non-tenured on tenure track total","12","10","2","0","0","0","1","1","0","1","1","0","0","0","0","0","0","0","9","7","2","0","0","0","0","0","0","1","1","0","-2"
"224545","Texas A&M University-Texarkana","2011","Total full-time Instruction/research/public service, Non-tenured not on tenure track, Professors","1","1","0","0","0","0","0","0","0","0","0","0","0","0","0","0","0","0","1","1","0","0","0","0","0","0","0","0","0","0","-2"
"224545","Texas A&M University-Texarkana","2011","Total full-time Instruction/research/public service, Non-tenured not on tenure track, Associate professors","2","1","1","0","0","0","0","0","0","0","0","0","1","1","0","0","0","0","0","0","0","0","0","0","1","0","1","0","0","0","-2"
"224545","Texas A&M University-Texarkana","2011","Total full-time Instruction/research/public servicey, Non-tenured not on tenure track, Assistant professors","11","6","5","0","0","0","0","0","0","0","0","0","1","1","0","0","0","0","10","5","5","0","0","0","0","0","0","0","0","0","-2"
"224545","Texas A&M University-Texarkana","2011","Total full-time Instruction/research/public service, Non-tenured not on tenure track, Instructors","9","4","5","0","0","0","0","0","0","0","0","0","0","0","0","0","0","0","9","4","5","0","0","0","0","0","0","0","0","0","-2"
"224545","Texas A&M University-Texarkana","2011","Total full-time Instruction/research/public service, Non-tenured not on tenure track total","23","12","11","0","0","0","0","0","0","0","0","0","2","2","0","0","0","0","20","10","10","0","0","0","1","0","1","0","0","0","-2"
"224554","Texas A & M University-Commerce","2011","Total full-time Instruction/research/public service, Tenured, Professors","52","41","11","1","1","0","7","6","1","4","3","1","0","0","0","0","0","0","40","31","9","0","0","0","0","0","0","0","0","0","-2"
"224554","Texas A & M University-Commerce","2011","Total full-time Instruction/research/public service, Tenured, Associate professors","25","12","13","0","0","0","0","0","0","3","1","2","1","0","1","0","0","0","20","11","9","1","0","1","0","0","0","0","0","0","-2"
"224554","Texas A & M University-Commerce","2011","Total full-time Instruction/research/public service, Tenured, Assistant professors","11","9","2","0","0","0","1","1","0","0","0","0","0","0","0","0","0","0","10","8","2","0","0","0","0","0","0","0","0","0","-2"
"224554","Texas A & M University-Commerce","2011","Total full-time Instruction/research/public service, Tenured, Instructors","1","0","1","0","0","0","0","0","0","0","0","0","0","0","0","0","0","0","1","0","1","0","0","0","0","0","0","0","0","0","-2"
"224554","Texas A & M University-Commerce","2011","Total full-time Instruction/research/public service, Tenured total","89","62","27","1","1","0","8","7","1","7","4","3","1","0","1","0","0","0","71","50","21","1","0","1","0","0","0","0","0","0","-2"
"224554","Texas A & M University-Commerce","2011","Total full-time Instruction/research/public service, Non-tenured on tenure track, Professors","7","5","2","0","0","0","0","0","0","0","0","0","1","1","0","0","0","0","6","4","2","0","0","0","0","0","0","0","0","0","-2"
"224554","Texas A & M University-Commerce","2011","Total full-time Instruction/research/public service, Non-tenured on tenure track, Associate professors","28","18","10","0","0","0","2","1","1","0","0","0","1","0","1","0","0","0","24","16","8","0","0","0","0","0","0","1","1","0","-2"
"224554","Texas A & M University-Commerce","2011","Total full-time Instruction/research/public service, Non-tenured on tenure track, Assistant professors","72","43","29","0","0","0","3","1","2","3","1","2","3","2","1","0","0","0","62","38","24","0","0","0","1","1","0","0","0","0","-2"
"224554","Texas A & M University-Commerce","2011","Total full-time Instruction/research/public service, Non-tenured on tenure track, Instructors","1","1","0","0","0","0","0","0","0","0","0","0","0","0","0","0","0","0","1","1","0","0","0","0","0","0","0","0","0","0","-2"
"224554","Texas A & M University-Commerce","2011","Total full-time Instruction/research/public service, Non-tenured on tenure track total","108","67","41","0","0","0","5","2","3","3","1","2","5","3","2","0","0","0","93","59","34","0","0","0","1","1","0","1","1","0","-2"
"224554","Texas A & M University-Commerce","2011","Total full-time Instruction/research/public service, Non-tenured not on tenure track, Professors","1","1","0","0","0","0","0","0","0","0","0","0","0","0","0","0","0","0","1","1","0","0","0","0","0","0","0","0","0","0","-2"
"224554","Texas A & M University-Commerce","2011","Total full-time Instruction/research/public servicey, Non-tenured not on tenure track, Assistant professors","34","18","16","0","0","0","6","4","2","4","2","2","4","3","1","0","0","0","17","7","10","0","0","0","0","0","0","3","2","1","-2"
"224554","Texas A & M University-Commerce","2011","Total full-time Instruction/research/public service, Non-tenured not on tenure track, Instructors","53","18","35","0","0","0","2","0","2","5","2","3","2","1","1","0","0","0","40","11","29","0","0","0","0","0","0","4","4","0","-2"
"224554","Texas A & M University-Commerce","2011","Total full-time Instruction/research/public service, Non-tenured not on tenure track, No academic rank","2","2","0","0","0","0","0","0","0","0","0","0","0","0","0","0","0","0","0","0","0","0","0","0","0","0","0","2","2","0","-2"
"224554","Texas A & M University-Commerce","2011","Total full-time Instruction/research/public service, Non-tenured not on tenure track total","90","39","51","0","0","0","8","4","4","9","4","5","6","4","2","0","0","0","58","19","39","0","0","0","0","0","0","9","8","1","-2"
"225247","Hardin-Simmons University","2011","Total full-time Instruction/research/public service, Tenured, Professors","61","47","14","0","0","0","0","0","0","0","0","0","1","1","0","0","0","0","60","46","14","0","0","0","0","0","0","0","0","0","-2"
"225247","Hardin-Simmons University","2011","Total full-time Instruction/research/public service, Tenured, Associate professors","35","18","17","0","0","0","0","0","0","0","0","0","0","0","0","0","0","0","35","18","17","0","0","0","0","0","0","0","0","0","-2"
"225247","Hardin-Simmons University","2011","Total full-time Instruction/research/public service, Tenured, Assistant professors","2","0","2","0","0","0","0","0","0","0","0","0","0","0","0","0","0","0","2","0","2","0","0","0","0","0","0","0","0","0","-2"
"225247","Hardin-Simmons University","2011","Total full-time Instruction/research/public service, Tenured total","98","65","33","0","0","0","0","0","0","0","0","0","1","1","0","0","0","0","97","64","33","0","0","0","0","0","0","0","0","0","-2"
"225247","Hardin-Simmons University","2011","Total full-time Instruction/research/public service, Non-tenured on tenure track, Associate professors","4","4","0","0","0","0","0","0","0","0","0","0","0","0","0","0","0","0","4","4","0","0","0","0","0","0","0","0","0","0","-2"
"225247","Hardin-Simmons University","2011","Total full-time Instruction/research/public service, Non-tenured on tenure track, Assistant professors","27","17","10","0","0","0","1","1","0","2","1","1","0","0","0","0","0","0","24","15","9","0","0","0","0","0","0","0","0","0","-2"
"225247","Hardin-Simmons University","2011","Total full-time Instruction/research/public service, Non-tenured on tenure track, Instructors","2","1","1","0","0","0","0","0","0","0","0","0","0","0","0","0","0","0","2","1","1","0","0","0","0","0","0","0","0","0","-2"
"225247","Hardin-Simmons University","2011","Total full-time Instruction/research/public service, Non-tenured on tenure track total","33","22","11","0","0","0","1","1","0","2","1","1","0","0","0","0","0","0","30","20","10","0","0","0","0","0","0","0","0","0","-2"
"225247","Hardin-Simmons University","2011","Total full-time Instruction/research/public servicey, Non-tenured not on tenure track, Assistant professors","4","3","1","0","0","0","1","0","1","0","0","0","0","0","0","0","0","0","3","3","0","0","0","0","0","0","0","0","0","0","-2"
"225247","Hardin-Simmons University","2011","Total full-time Instruction/research/public service, Non-tenured not on tenure track, Instructors","2","1","1","0","0","0","0","0","0","0","0","0","0","0","0","0","0","0","2","1","1","0","0","0","0","0","0","0","0","0","-2"
"225247","Hardin-Simmons University","2011","Total full-time Instruction/research/public service, Non-tenured not on tenure track total","6","4","2","0","0","0","1","0","1","0","0","0","0","0","0","0","0","0","5","4","1","0","0","0","0","0","0","0","0","0","-2"
"226091","Lamar University","2011","Total full-time Instruction/research/public service, Tenured, Professors","96","71","25","0","0","0","21","19","2","0","0","0","0","0","0","0","0","0","75","52","23","0","0","0","0","0","0","0","0","0","-2"
"226091","Lamar University","2011","Total full-time Instruction/research/public service, Tenured, Associate professors","91","56","35","0","0","0","13","9","4","6","2","4","2","0","2","0","0","0","70","45","25","0","0","0","0","0","0","0","0","0","-2"
"226091","Lamar University","2011","Total full-time Instruction/research/public service, Tenured, Assistant professors","18","5","13","0","0","0","1","0","1","0","0","0","1","1","0","0","0","0","16","4","12","0","0","0","0","0","0","0","0","0","-2"
"226091","Lamar University","2011","Total full-time Instruction/research/public service, Tenured total","205","132","73","0","0","0","35","28","7","6","2","4","3","1","2","0","0","0","161","101","60","0","0","0","0","0","0","0","0","0","-2"
"226091","Lamar University","2011","Total full-time Instruction/research/public service, Non-tenured on tenure track, Associate professors","14","8","6","0","0","0","3","2","1","0","0","0","1","1","0","0","0","0","10","5","5","0","0","0","0","0","0","0","0","0","-2"
"226091","Lamar University","2011","Total full-time Instruction/research/public service, Non-tenured on tenure track, Assistant professors","59","30","29","0","0","0","14","7","7","4","3","1","4","2","2","0","0","0","37","18","19","0","0","0","0","0","0","0","0","0","-2"
"226091","Lamar University","2011","Total full-time Instruction/research/public service, Non-tenured on tenure track total","73","38","35","0","0","0","17","9","8","4","3","1","5","3","2","0","0","0","47","23","24","0","0","0","0","0","0","0","0","0","-2"
"226091","Lamar University","2011","Total full-time Instruction/research/public service, Non-tenured not on tenure track, Professors","1","1","0","0","0","0","0","0","0","0","0","0","0","0","0","0","0","0","1","1","0","0","0","0","0","0","0","0","0","0","-2"
"226091","Lamar University","2011","Total full-time Instruction/research/public service, Non-tenured not on tenure track, Associate professors","1","1","0","0","0","0","0","0","0","0","0","0","0","0","0","0","0","0","1","1","0","0","0","0","0","0","0","0","0","0","-2"
"226091","Lamar University","2011","Total full-time Instruction/research/public servicey, Non-tenured not on tenure track, Assistant professors","8","4","4","0","0","0","2","2","0","1","0","1","2","1","1","0","0","0","3","1","2","0","0","0","0","0","0","0","0","0","-2"
"226091","Lamar University","2011","Total full-time Instruction/research/public service, Non-tenured not on tenure track, Instructors","94","30","64","0","0","0","8","4","4","5","1","4","6","1","5","0","0","0","75","24","51","0","0","0","0","0","0","0","0","0","-2"
"226091","Lamar University","2011","Total full-time Instruction/research/public service, Non-tenured not on tenure track, No academic rank","10","5","5","0","0","0","1","0","1","0","0","0","1","1","0","0","0","0","8","4","4","0","0","0","0","0","0","0","0","0","-2"
"226091","Lamar University","2011","Total full-time Instruction/research/public service, Non-tenured not on tenure track total","114","41","73","0","0","0","11","6","5","6","1","5","9","3","6","0","0","0","88","31","57","0","0","0","0","0","0","0","0","0","-2"
"226383","Lubbock Christian University","2011","Total full-time Instruction/research/public service, Tenured, Professors","25","14","11","0","0","0","0","0","0","0","0","0","0","0","0","0","0","0","25","14","11","0","0","0","0","0","0","0","0","0","-2"
"226383","Lubbock Christian University","2011","Total full-time Instruction/research/public service, Tenured, Associate professors","25","15","10","0","0","0","0","0","0","0","0","0","1","1","0","0","0","0","24","14","10","0","0","0","0","0","0","0","0","0","-2"
"226383","Lubbock Christian University","2011","Total full-time Instruction/research/public service, Tenured, Assistant professors","5","1","4","0","0","0","0","0","0","0","0","0","0","0","0","0","0","0","5","1","4","0","0","0","0","0","0","0","0","0","-2"
"226383","Lubbock Christian University","2011","Total full-time Instruction/research/public service, Tenured total","55","30","25","0","0","0","0","0","0","0","0","0","1","1","0","0","0","0","54","29","25","0","0","0","0","0","0","0","0","0","-2"
"226383","Lubbock Christian University","2011","Total full-time Instruction/research/public service, Non-tenured on tenure track, Professors","3","2","1","0","0","0","0","0","0","0","0","0","1","1","0","0","0","0","2","1","1","0","0","0","0","0","0","0","0","0","-2"
"226383","Lubbock Christian University","2011","Total full-time Instruction/research/public service, Non-tenured on tenure track, Associate professors","4","4","0","0","0","0","0","0","0","0","0","0","0","0","0","0","0","0","4","4","0","0","0","0","0","0","0","0","0","0","-2"
"226383","Lubbock Christian University","2011","Total full-time Instruction/research/public service, Non-tenured on tenure track, Assistant professors","21","13","8","0","0","0","0","0","0","0","0","0","1","0","1","0","0","0","20","13","7","0","0","0","0","0","0","0","0","0","-2"
"226383","Lubbock Christian University","2011","Total full-time Instruction/research/public service, Non-tenured on tenure track, Instructors","3","3","0","0","0","0","0","0","0","0","0","0","0","0","0","0","0","0","3","3","0","0","0","0","0","0","0","0","0","0","-2"
"226383","Lubbock Christian University","2011","Total full-time Instruction/research/public service, Non-tenured on tenure track total","31","22","9","0","0","0","0","0","0","0","0","0","2","1","1","0","0","0","29","21","8","0","0","0","0","0","0","0","0","0","-2"
"226383","Lubbock Christian University","2011","Total full-time Instruction/research/public service, Non-tenured not on tenure track, Lecturers","3","0","3","0","0","0","0","0","0","0","0","0","0","0","0","0","0","0","3","0","3","0","0","0","0","0","0","0","0","0","-2"
"226383","Lubbock Christian University","2011","Total full-time Instruction/research/public service, Non-tenured not on tenure track total","3","0","3","0","0","0","0","0","0","0","0","0","0","0","0","0","0","0","3","0","3","0","0","0","0","0","0","0","0","0","-2"
"226471","University of Mary Hardin-Baylor","2011","Total full-time Instruction/research/public service, Tenured, Professors","36","21","15","0","0","0","1","1","0","0","0","0","1","1","0","0","0","0","33","18","15","1","1","0","0","0","0","0","0","0","-2"
"226471","University of Mary Hardin-Baylor","2011","Total full-time Instruction/research/public service, Tenured, Associate professors","9","2","7","0","0","0","0","0","0","0","0","0","0","0","0","0","0","0","9","2","7","0","0","0","0","0","0","0","0","0","-2"
"226471","University of Mary Hardin-Baylor","2011","Total full-time Instruction/research/public service, Tenured total","45","23","22","0","0","0","1","1","0","0","0","0","1","1","0","0","0","0","42","20","22","1","1","0","0","0","0","0","0","0","-2"
"226471","University of Mary Hardin-Baylor","2011","Total full-time Instruction/research/public service, Non-tenured on tenure track, Professors","6","2","4","0","0","0","0","0","0","0","0","0","0","0","0","0","0","0","6","2","4","0","0","0","0","0","0","0","0","0","-2"
"226471","University of Mary Hardin-Baylor","2011","Total full-time Instruction/research/public service, Non-tenured on tenure track, Associate professors","12","7","5","0","0","0","1","1","0","1","0","1","0","0","0","0","0","0","10","6","4","0","0","0","0","0","0","0","0","0","-2"
"226471","University of Mary Hardin-Baylor","2011","Total full-time Instruction/research/public service, Non-tenured on tenure track, Assistant professors","35","16","19","0","0","0","3","1","2","3","1","2","0","0","0","0","0","0","29","14","15","0","0","0","0","0","0","0","0","0","-2"
"226471","University of Mary Hardin-Baylor","2011","Total full-time Instruction/research/public service, Non-tenured on tenure track total","53","25","28","0","0","0","4","2","2","4","1","3","0","0","0","0","0","0","45","22","23","0","0","0","0","0","0","0","0","0","-2"
"226471","University of Mary Hardin-Baylor","2011","Total full-time Instruction/research/public service, Non-tenured not on tenure track, Associate professors","7","3","4","0","0","0","0","0","0","0","0","0","0","0","0","0","0","0","7","3","4","0","0","0","0","0","0","0","0","0","-2"
"226471","University of Mary Hardin-Baylor","2011","Total full-time Instruction/research/public servicey, Non-tenured not on tenure track, Assistant professors","29","7","22","0","0","0","0","0","0","3","0","3","1","0","1","0","0","0","25","7","18","0","0","0","0","0","0","0","0","0","-2"
"226471","University of Mary Hardin-Baylor","2011","Total full-time Instruction/research/public service, Non-tenured not on tenure track, Instructors","7","3","4","0","0","0","0","0","0","1","0","1","0","0","0","0","0","0","6","3","3","0","0","0","0","0","0","0","0","0","-2"
"226471","University of Mary Hardin-Baylor","2011","Total full-time Instruction/research/public service, Non-tenured not on tenure track total","43","13","30","0","0","0","0","0","0","4","0","4","1","0","1","0","0","0","38","13","25","0","0","0","0","0","0","0","0","0","-2"
"226833","Midwestern State University","2011","Total full-time Instruction/research/public service, Tenured, Professors","48","36","12","2","0","2","1","1","0","0","0","0","4","3","1","0","0","0","41","32","9","0","0","0","0","0","0","0","0","0","-2"
"226833","Midwestern State University","2011","Total full-time Instruction/research/public service, Tenured, Associate professors","41","28","13","0","0","0","4","4","0","1","0","1","2","1","1","0","0","0","34","23","11","0","0","0","0","0","0","0","0","0","-2"
"226833","Midwestern State University","2011","Total full-time Instruction/research/public service, Tenured, Assistant professors","11","7","4","0","0","0","0","0","0","0","0","0","1","0","1","0","0","0","9","7","2","0","0","0","0","0","0","1","0","1","-2"
"226833","Midwestern State University","2011","Total full-time Instruction/research/public service, Tenured, No academic rank","18","13","5","0","0","0","0","0","0","0","0","0","0","0","0","0","0","0","18","13","5","0","0","0","0","0","0","0","0","0","-2"
"226833","Midwestern State University","2011","Total full-time Instruction/research/public service, Tenured total","118","84","34","2","0","2","5","5","0","1","0","1","7","4","3","0","0","0","102","75","27","0","0","0","0","0","0","1","0","1","-2"
"226833","Midwestern State University","2011","Total full-time Instruction/research/public service, Non-tenured on tenure track, Professors","1","1","0","0","0","0","1","1","0","0","0","0","0","0","0","0","0","0","0","0","0","0","0","0","0","0","0","0","0","0","-2"
"226833","Midwestern State University","2011","Total full-time Instruction/research/public service, Non-tenured on tenure track, Associate professors","2","1","1","0","0","0","0","0","0","0","0","0","1","1","0","0","0","0","1","0","1","0","0","0","0","0","0","0","0","0","-2"
"226833","Midwestern State University","2011","Total full-time Instruction/research/public service, Non-tenured on tenure track, Assistant professors","43","16","27","1","0","1","2","1","1","1","0","1","2","1","1","0","0","0","33","12","21","0","0","0","0","0","0","4","2","2","-2"
"226833","Midwestern State University","2011","Total full-time Instruction/research/public service, Non-tenured on tenure track, No academic rank","8","1","7","0","0","0","0","0","0","0","0","0","1","0","1","0","0","0","7","1","6","0","0","0","0","0","0","0","0","0","-2"
"226833","Midwestern State University","2011","Total full-time Instruction/research/public service, Non-tenured on tenure track total","54","19","35","1","0","1","3","2","1","1","0","1","4","2","2","0","0","0","41","13","28","0","0","0","0","0","0","4","2","2","-2"
"226833","Midwestern State University","2011","Total full-time Instruction/research/public service, Non-tenured not on tenure track, Professors","3","2","1","0","0","0","0","0","0","0","0","0","0","0","0","0","0","0","3","2","1","0","0","0","0","0","0","0","0","0","-2"
"226833","Midwestern State University","2011","Total full-time Instruction/research/public servicey, Non-tenured not on tenure track, Assistant professors","23","7","16","0","0","0","0","0","0","0","0","0","0","0","0","0","0","0","23","7","16","0","0","0","0","0","0","0","0","0","-2"
"226833","Midwestern State University","2011","Total full-time Instruction/research/public service, Non-tenured not on tenure track, Instructors","17","6","11","0","0","0","0","0","0","0","0","0","1","0","1","0","0","0","15","5","10","0","0","0","1","1","0","0","0","0","-2"
"226833","Midwestern State University","2011","Total full-time Instruction/research/public service, Non-tenured not on tenure track, No academic rank","16","5","11","0","0","0","0","0","0","0","0","0","1","0","1","0","0","0","15","5","10","0","0","0","0","0","0","0","0","0","-2"
"226833","Midwestern State University","2011","Total full-time Instruction/research/public service, Non-tenured not on tenure track total","59","20","39","0","0","0","0","0","0","0","0","0","2","0","2","0","0","0","56","19","37","0","0","0","1","1","0","0","0","0","-2"
"227429","Paul Quinn College","2011","Total full-time Instruction/research/public service, Non-tenured not on tenure track, Professors","10","7","3","0","0","0","0","0","0","9","6","3","0","0","0","0","0","0","0","0","0","0","0","0","1","1","0","0","0","0","-2"
"227429","Paul Quinn College","2011","Total full-time Instruction/research/public service, Non-tenured not on tenure track total","10","7","3","0","0","0","0","0","0","9","6","3","0","0","0","0","0","0","0","0","0","0","0","0","1","1","0","0","0","0","-2"
"227881","Sam Houston State University","2011","Total full-time Instruction/research/public service, Tenured, Professors","135","100","35","1","1","0","7","6","1","1","1","0","3","1","2","0","0","0","122","90","32","0","0","0","0","0","0","1","1","0","-2"
"227881","Sam Houston State University","2011","Total full-time Instruction/research/public service, Tenured, Associate professors","142","82","60","0","0","0","12","7","5","3","2","1","7","5","2","0","0","0","120","68","52","0","0","0","0","0","0","0","0","0","-2"
"227881","Sam Houston State University","2011","Total full-time Instruction/research/public service, Tenured, Assistant professors","6","3","3","0","0","0","1","1","0","0","0","0","1","1","0","0","0","0","4","1","3","0","0","0","0","0","0","0","0","0","-2"
"227881","Sam Houston State University","2011","Total full-time Instruction/research/public service, Tenured, Instructors","1","0","1","0","0","0","0","0","0","0","0","0","0","0","0","0","0","0","1","0","1","0","0","0","0","0","0","0","0","0","-2"
"227881","Sam Houston State University","2011","Total full-time Instruction/research/public service, Tenured total","284","185","99","1","1","0","20","14","6","4","3","1","11","7","4","0","0","0","247","159","88","0","0","0","0","0","0","1","1","0","-2"
"227881","Sam Houston State University","2011","Total full-time Instruction/research/public service, Non-tenured on tenure track, Professors","3","3","0","0","0","0","0","0","0","0","0","0","0","0","0","0","0","0","2","2","0","0","0","0","0","0","0","1","1","0","-2"
"227881","Sam Houston State University","2011","Total full-time Instruction/research/public service, Non-tenured on tenure track, Associate professors","10","5","5","0","0","0","0","0","0","0","0","0","0","0","0","0","0","0","10","5","5","0","0","0","0","0","0","0","0","0","-2"
"227881","Sam Houston State University","2011","Total full-time Instruction/research/public service, Non-tenured on tenure track, Assistant professors","166","87","79","1","0","1","18","6","12","5","1","4","12","7","5","0","0","0","126","70","56","0","0","0","0","0","0","4","3","1","-2"
"227881","Sam Houston State University","2011","Total full-time Instruction/research/public service, Non-tenured on tenure track total","179","95","84","1","0","1","18","6","12","5","1","4","12","7","5","0","0","0","138","77","61","0","0","0","0","0","0","5","4","1","-2"
"227881","Sam Houston State University","2011","Total full-time Instruction/research/public service, Non-tenured not on tenure track, Lecturers","138","58","80","1","1","0","3","0","3","5","3","2","12","9","3","0","0","0","115","44","71","1","0","1","0","0","0","1","1","0","-2"
"227881","Sam Houston State University","2011","Total full-time Instruction/research/public service, Non-tenured not on tenure track total","138","58","80","1","1","0","3","0","3","5","3","2","12","9","3","0","0","0","115","44","71","1","0","1","0","0","0","1","1","0","-2"
"228325","Southwestern Assemblies of God University","2011","Total full-time Instruction/research/public service, Tenured, Professors","6","4","2","0","0","0","0","0","0","0","0","0","0","0","0","0","0","0","6","4","2","0","0","0","0","0","0","0","0","0","-2"
"228325","Southwestern Assemblies of God University","2011","Total full-time Instruction/research/public service, Tenured, Associate professors","1","0","1","0","0","0","0","0","0","0","0","0","0","0","0","0","0","0","1","0","1","0","0","0","0","0","0","0","0","0","-2"
"228325","Southwestern Assemblies of God University","2011","Total full-time Instruction/research/public service, Tenured, Assistant professors","2","0","2","0","0","0","0","0","0","0","0","0","0","0","0","0","0","0","2","0","2","0","0","0","0","0","0","0","0","0","-2"
"228325","Southwestern Assemblies of God University","2011","Total full-time Instruction/research/public service, Tenured total","9","4","5","0","0","0","0","0","0","0","0","0","0","0","0","0","0","0","9","4","5","0","0","0","0","0","0","0","0","0","-2"
"228325","Southwestern Assemblies of God University","2011","Total full-time Instruction/research/public service, Non-tenured not on tenure track, Professors","11","11","0","0","0","0","0","0","0","0","0","0","0","0","0","0","0","0","11","11","0","0","0","0","0","0","0","0","0","0","-2"
"228325","Southwestern Assemblies of God University","2011","Total full-time Instruction/research/public service, Non-tenured not on tenure track, Associate professors","10","5","5","0","0","0","1","0","1","0","0","0","0","0","0","0","0","0","9","5","4","0","0","0","0","0","0","0","0","0","-2"
"228325","Southwestern Assemblies of God University","2011","Total full-time Instruction/research/public servicey, Non-tenured not on tenure track, Assistant professors","12","9","3","0","0","0","0","0","0","1","0","1","0","0","0","0","0","0","11","9","2","0","0","0","0","0","0","0","0","0","-2"
"228325","Southwestern Assemblies of God University","2011","Total full-time Instruction/research/public service, Non-tenured not on tenure track, Instructors","19","12","7","0","0","0","2","1","1","1","1","0","0","0","0","0","0","0","16","10","6","0","0","0","0","0","0","0","0","0","-2"
"228325","Southwestern Assemblies of God University","2011","Total full-time Instruction/research/public service, Non-tenured not on tenure track, Lecturers","2","0","2","0","0","0","0","0","0","0","0","0","0","0","0","0","0","0","2","0","2","0","0","0","0","0","0","0","0","0","-2"
"228325","Southwestern Assemblies of God University","2011","Total full-time Instruction/research/public service, Non-tenured not on tenure track total","54","37","17","0","0","0","3","1","2","2","1","1","0","0","0","0","0","0","49","35","14","0","0","0","0","0","0","0","0","0","-2"
"228343","Southwestern University","2011","Total full-time Instruction/research/public service, Tenured, Professors","40","27","13","0","0","0","1","1","0","0","0","0","3","2","1","0","0","0","36","24","12","0","0","0","0","0","0","0","0","0","-2"
"228343","Southwestern University","2011","Total full-time Instruction/research/public service, Tenured, Associate professors","49","22","27","0","0","0","2","0","2","1","0","1","3","2","1","0","0","0","42","19","23","0","0","0","1","1","0","0","0","0","-2"
"228343","Southwestern University","2011","Total full-time Instruction/research/public service, Tenured total","89","49","40","0","0","0","3","1","2","1","0","1","6","4","2","0","0","0","78","43","35","0","0","0","1","1","0","0","0","0","-2"
"228343","Southwestern University","2011","Total full-time Instruction/research/public service, Non-tenured on tenure track, Assistant professors","25","10","15","2","2","0","1","0","1","2","1","1","4","2","2","0","0","0","16","5","11","0","0","0","0","0","0","0","0","0","-2"
"228343","Southwestern University","2011","Total full-time Instruction/research/public service, Non-tenured on tenure track total","25","10","15","2","2","0","1","0","1","2","1","1","4","2","2","0","0","0","16","5","11","0","0","0","0","0","0","0","0","0","-2"
"228343","Southwestern University","2011","Total full-time Instruction/research/public service, Non-tenured not on tenure track, No academic rank","8","5","3","0","0","0","0","0","0","0","0","0","0","0","0","0","0","0","8","5","3","0","0","0","0","0","0","0","0","0","-2"
"228343","Southwestern University","2011","Total full-time Instruction/research/public service, Non-tenured not on tenure track total","8","5","3","0","0","0","0","0","0","0","0","0","0","0","0","0","0","0","8","5","3","0","0","0","0","0","0","0","0","0","-2"
"228431","Stephen F Austin State University","2011","Total full-time Instruction/research/public service, Tenured, Professors","100","74","26","1","1","0","0","0","0","1","1","0","1","1","0","0","0","0","96","70","26","0","0","0","1","1","0","0","0","0","-2"
"228431","Stephen F Austin State University","2011","Total full-time Instruction/research/public service, Tenured, Associate professors","99","58","41","0","0","0","0","0","0","3","3","0","5","1","4","0","0","0","87","53","34","4","1","3","0","0","0","0","0","0","-2"
"228431","Stephen F Austin State University","2011","Total full-time Instruction/research/public service, Tenured, Assistant professors","15","8","7","0","0","0","0","0","0","0","0","0","1","1","0","0","0","0","13","7","6","1","0","1","0","0","0","0","0","0","-2"
"228431","Stephen F Austin State University","2011","Total full-time Instruction/research/public service, Tenured, Instructors","1","1","0","0","0","0","0","0","0","0","0","0","0","0","0","0","0","0","1","1","0","0","0","0","0","0","0","0","0","0","-2"
"228431","Stephen F Austin State University","2011","Total full-time Instruction/research/public service, Tenured, No academic rank","15","5","10","0","0","0","0","0","0","1","1","0","0","0","0","0","0","0","14","4","10","0","0","0","0","0","0","0","0","0","-2"
"228431","Stephen F Austin State University","2011","Total full-time Instruction/research/public service, Tenured total","230","146","84","1","1","0","0","0","0","5","5","0","7","3","4","0","0","0","211","135","76","5","1","4","1","1","0","0","0","0","-2"
"228431","Stephen F Austin State University","2011","Total full-time Instruction/research/public service, Non-tenured on tenure track, Professors","1","1","0","0","0","0","1","1","0","0","0","0","0","0","0","0","0","0","0","0","0","0","0","0","0","0","0","0","0","0","-2"
"228431","Stephen F Austin State University","2011","Total full-time Instruction/research/public service, Non-tenured on tenure track, Associate professors","3","2","1","0","0","0","0","0","0","0","0","0","1","0","1","0","0","0","2","2","0","0","0","0","0","0","0","0","0","0","-2"
"228431","Stephen F Austin State University","2011","Total full-time Instruction/research/public service, Non-tenured on tenure track, Assistant professors","91","51","40","0","0","0","2","1","1","4","3","1","6","4","2","0","0","0","76","42","34","1","0","1","0","0","0","2","1","1","-2"
"228431","Stephen F Austin State University","2011","Total full-time Instruction/research/public service, Non-tenured on tenure track, Instructors","13","3","10","2","0","2","0","0","0","0","0","0","1","1","0","0","0","0","8","1","7","2","1","1","0","0","0","0","0","0","-2"
"228431","Stephen F Austin State University","2011","Total full-time Instruction/research/public service, Non-tenured on tenure track, Lecturers","1","0","1","0","0","0","0","0","0","0","0","0","0","0","0","0","0","0","0","0","0","1","0","1","0","0","0","0","0","0","-2"
"228431","Stephen F Austin State University","2011","Total full-time Instruction/research/public service, Non-tenured on tenure track, No academic rank","4","2","2","0","0","0","0","0","0","0","0","0","0","0","0","0","0","0","3","1","2","0","0","0","1","1","0","0","0","0","-2"
"228431","Stephen F Austin State University","2011","Total full-time Instruction/research/public service, Non-tenured on tenure track total","113","59","54","2","0","2","3","2","1","4","3","1","8","5","3","0","0","0","89","46","43","4","1","3","1","1","0","2","1","1","-2"
"228431","Stephen F Austin State University","2011","Total full-time Instruction/research/public service, Non-tenured not on tenure track, Professors","2","2","0","0","0","0","0","0","0","0","0","0","0","0","0","0","0","0","2","2","0","0","0","0","0","0","0","0","0","0","-2"
"228431","Stephen F Austin State University","2011","Total full-time Instruction/research/public servicey, Non-tenured not on tenure track, Assistant professors","6","2","4","0","0","0","0","0","0","0","0","0","0","0","0","0","0","0","5","2","3","0","0","0","1","0","1","0","0","0","-2"
"228431","Stephen F Austin State University","2011","Total full-time Instruction/research/public service, Non-tenured not on tenure track, Instructors","11","5","6","0","0","0","0","0","0","0","0","0","0","0","0","0","0","0","10","4","6","0","0","0","1","1","0","0","0","0","-2"
"228431","Stephen F Austin State University","2011","Total full-time Instruction/research/public service, Non-tenured not on tenure track, Lecturers","31","7","24","1","0","1","0","0","0","0","0","0","0","0","0","0","0","0","29","6","23","1","1","0","0","0","0","0","0","0","-2"
"228431","Stephen F Austin State University","2011","Total full-time Instruction/research/public service, Non-tenured not on tenure track, No academic rank","113","42","71","0","0","0","0","0","0","4","0","4","1","1","0","0","0","0","94","33","61","1","1","0","13","7","6","0","0","0","-2"
"228431","Stephen F Austin State University","2011","Total full-time Instruction/research/public service, Non-tenured not on tenure track total","163","58","105","1","0","1","0","0","0","4","0","4","1","1","0","0","0","0","140","47","93","2","2","0","15","8","7","0","0","0","-2"
"228529","Tarleton State University","2011","Total full-time Instruction/research/public service, Tenured, Professors","62","48","14","2","2","0","2","2","0","0","0","0","0","0","0","0","0","0","58","44","14","0","0","0","0","0","0","0","0","0","-2"
"228529","Tarleton State University","2011","Total full-time Instruction/research/public service, Tenured, Associate professors","67","43","24","1","1","0","3","3","0","0","0","0","3","3","0","0","0","0","60","36","24","0","0","0","0","0","0","0","0","0","-2"
"228529","Tarleton State University","2011","Total full-time Instruction/research/public service, Tenured, Assistant professors","3","3","0","0","0","0","0","0","0","0","0","0","0","0","0","0","0","0","3","3","0","0","0","0","0","0","0","0","0","0","-2"
"228529","Tarleton State University","2011","Total full-time Instruction/research/public service, Tenured total","132","94","38","3","3","0","5","5","0","0","0","0","3","3","0","0","0","0","121","83","38","0","0","0","0","0","0","0","0","0","-2"
"228529","Tarleton State University","2011","Total full-time Instruction/research/public service, Non-tenured on tenure track, Associate professors","11","5","6","0","0","0","0","0","0","0","0","0","1","1","0","0","0","0","10","4","6","0","0","0","0","0","0","0","0","0","-2"
"228529","Tarleton State University","2011","Total full-time Instruction/research/public service, Non-tenured on tenure track, Assistant professors","76","49","27","0","0","0","5","3","2","2","1","1","3","0","3","1","1","0","63","43","20","1","1","0","0","0","0","1","0","1","-2"
"228529","Tarleton State University","2011","Total full-time Instruction/research/public service, Non-tenured on tenure track total","87","54","33","0","0","0","5","3","2","2","1","1","4","1","3","1","1","0","73","47","26","1","1","0","0","0","0","1","0","1","-2"
"228529","Tarleton State University","2011","Total full-time Instruction/research/public service, Non-tenured not on tenure track, Associate professors","4","1","3","0","0","0","0","0","0","1","0","1","0","0","0","0","0","0","3","1","2","0","0","0","0","0","0","0","0","0","-2"
"228529","Tarleton State University","2011","Total full-time Instruction/research/public servicey, Non-tenured not on tenure track, Assistant professors","66","24","42","0","0","0","2","0","2","3","3","0","2","0","2","0","0","0","59","21","38","0","0","0","0","0","0","0","0","0","-2"
"228529","Tarleton State University","2011","Total full-time Instruction/research/public service, Non-tenured not on tenure track, Instructors","70","26","44","0","0","0","1","0","1","1","1","0","5","2","3","0","0","0","61","22","39","2","1","1","0","0","0","0","0","0","-2"
"228529","Tarleton State University","2011","Total full-time Instruction/research/public service, Non-tenured not on tenure track, Lecturers","15","9","6","0","0","0","0","0","0","1","1","0","0","0","0","0","0","0","13","8","5","1","0","1","0","0","0","0","0","0","-2"
"228529","Tarleton State University","2011","Total full-time Instruction/research/public service, Non-tenured not on tenure track, No academic rank","1","1","0","0","0","0","0","0","0","0","0","0","0","0","0","0","0","0","1","1","0","0","0","0","0","0","0","0","0","0","-2"
"228529","Tarleton State University","2011","Total full-time Instruction/research/public service, Non-tenured not on tenure track total","156","61","95","0","0","0","3","0","3","6","5","1","7","2","5","0","0","0","137","53","84","3","1","2","0","0","0","0","0","0","-2"
"228653","The University of Texas Medical Branch at Galveston","2011","Total full-time Instruction/research/public service, Tenured, Professors","205","153","52","0","0","0","34","22","12","6","5","1","10","8","2","0","0","0","153","116","37","1","1","0","0","0","0","1","1","0","-2"
"228653","The University of Texas Medical Branch at Galveston","2011","Total full-time Instruction/research/public service, Tenured, Associate professors","51","31","20","0","0","0","12","8","4","1","1","0","4","3","1","0","0","0","33","18","15","0","0","0","0","0","0","1","1","0","-2"
"228653","The University of Texas Medical Branch at Galveston","2011","Total full-time Instruction/research/public service, Tenured, Assistant professors","5","4","1","0","0","0","1","1","0","0","0","0","0","0","0","0","0","0","3","2","1","0","0","0","0","0","0","1","1","0","-2"
"228653","The University of Texas Medical Branch at Galveston","2011","Total full-time Instruction/research/public service, Tenured total","261","188","73","0","0","0","47","31","16","7","6","1","14","11","3","0","0","0","189","136","53","1","1","0","0","0","0","3","3","0","-2"
"228653","The University of Texas Medical Branch at Galveston","2011","Total full-time Instruction/research/public service, Non-tenured on tenure track, Professors","7","5","2","0","0","0","0","0","0","0","0","0","0","0","0","0","0","0","7","5","2","0","0","0","0","0","0","0","0","0","-2"
"228653","The University of Texas Medical Branch at Galveston","2011","Total full-time Instruction/research/public service, Non-tenured on tenure track, Associate professors","27","17","10","0","0","0","6","3","3","2","0","2","0","0","0","0","0","0","13","9","4","0","0","0","0","0","0","6","5","1","-2"
"228653","The University of Texas Medical Branch at Galveston","2011","Total full-time Instruction/research/public service, Non-tenured on tenure track, Assistant professors","95","52","43","0","0","0","24","14","10","4","1","3","3","1","2","0","0","0","32","14","18","3","1","2","0","0","0","29","21","8","-2"
"228653","The University of Texas Medical Branch at Galveston","2011","Total full-time Instruction/research/public service, Non-tenured on tenure track total","129","74","55","0","0","0","30","17","13","6","1","5","3","1","2","0","0","0","52","28","24","3","1","2","0","0","0","35","26","9","-2"
"228653","The University of Texas Medical Branch at Galveston","2011","Total full-time Instruction/research/public service, Non-tenured not on tenure track, Professors","42","31","11","0","0","0","8","6","2","1","0","1","3","3","0","1","1","0","28","20","8","0","0","0","0","0","0","1","1","0","-2"
"228653","The University of Texas Medical Branch at Galveston","2011","Total full-time Instruction/research/public service, Non-tenured not on tenure track, Associate professors","94","60","34","0","0","0","15","10","5","7","4","3","7","5","2","0","0","0","61","37","24","0","0","0","0","0","0","4","4","0","-2"
"228653","The University of Texas Medical Branch at Galveston","2011","Total full-time Instruction/research/public servicey, Non-tenured not on tenure track, Assistant professors","231","110","121","1","1","0","39","15","24","13","9","4","13","4","9","0","0","0","118","51","67","6","3","3","0","0","0","41","27","14","-2"
"228653","The University of Texas Medical Branch at Galveston","2011","Total full-time Instruction/research/public service, Non-tenured not on tenure track, Instructors","49","22","27","0","0","0","9","4","5","1","0","1","4","1","3","0","0","0","22","8","14","0","0","0","0","0","0","13","9","4","-2"
"228653","The University of Texas Medical Branch at Galveston","2011","Total full-time Instruction/research/public service, Non-tenured not on tenure track total","416","223","193","1","1","0","71","35","36","22","13","9","27","13","14","1","1","0","229","116","113","6","3","3","0","0","0","59","41","18","-2"
"228787","The University of Texas at Dallas","2011","Total full-time Instruction/research/public service, Tenured, Professors","202","174","28","1","1","0","48","44","4","1","1","0","7","7","0","0","0","0","139","116","23","3","3","0","0","0","0","3","2","1","-2"
"228787","The University of Texas at Dallas","2011","Total full-time Instruction/research/public service, Tenured, Associate professors","108","86","22","0","0","0","31","28","3","5","3","2","1","1","0","0","0","0","63","49","14","1","1","0","1","1","0","6","3","3","-2"
"228787","The University of Texas at Dallas","2011","Total full-time Instruction/research/public service, Tenured total","310","260","50","1","1","0","79","72","7","6","4","2","8","8","0","0","0","0","202","165","37","4","4","0","1","1","0","9","5","4","-2"
"228787","The University of Texas at Dallas","2011","Total full-time Instruction/research/public service, Non-tenured on tenure track, Professors","1","1","0","0","0","0","0","0","0","0","0","0","0","0","0","0","0","0","1","1","0","0","0","0","0","0","0","0","0","0","-2"
"228787","The University of Texas at Dallas","2011","Total full-time Instruction/research/public service, Non-tenured on tenure track, Associate professors","11","7","4","0","0","0","0","0","0","0","0","0","1","1","0","0","0","0","8","4","4","1","1","0","0","0","0","1","1","0","-2"
"228787","The University of Texas at Dallas","2011","Total full-time Instruction/research/public service, Non-tenured on tenure track, Assistant professors","113","69","44","0","0","0","24","12","12","4","3","1","2","2","0","0","0","0","62","37","25","1","1","0","0","0","0","20","14","6","-2"
"228787","The University of Texas at Dallas","2011","Total full-time Instruction/research/public service, Non-tenured on tenure track total","125","77","48","0","0","0","24","12","12","4","3","1","3","3","0","0","0","0","71","42","29","2","2","0","0","0","0","21","15","6","-2"
"228787","The University of Texas at Dallas","2011","Total full-time Instruction/research/public service, Non-tenured not on tenure track, Lecturers","202","124","78","0","0","0","27","16","11","3","2","1","7","6","1","0","0","0","152","89","63","1","0","1","1","1","0","11","10","1","-2"
"228787","The University of Texas at Dallas","2011","Total full-time Instruction/research/public service, Non-tenured not on tenure track total","202","124","78","0","0","0","27","16","11","3","2","1","7","6","1","0","0","0","152","89","63","1","0","1","1","1","0","11","10","1","-2"
"228802","The University of Texas at Tyler","2011","Total full-time Instruction/research/public service, Tenured, Professors","50","32","18","1","1","0","8","7","1","0","0","0","0","0","0","0","0","0","41","24","17","0","0","0","0","0","0","0","0","0","-2"
"228802","The University of Texas at Tyler","2011","Total full-time Instruction/research/public service, Tenured, Associate professors","59","38","21","1","0","1","5","5","0","2","1","1","0","0","0","0","0","0","51","32","19","0","0","0","0","0","0","0","0","0","-2"
"228802","The University of Texas at Tyler","2011","Total full-time Instruction/research/public service, Tenured total","109","70","39","2","1","1","13","12","1","2","1","1","0","0","0","0","0","0","92","56","36","0","0","0","0","0","0","0","0","0","-2"
"228802","The University of Texas at Tyler","2011","Total full-time Instruction/research/public service, Non-tenured on tenure track, Associate professors","7","5","2","0","0","0","1","0","1","0","0","0","1","1","0","0","0","0","5","4","1","0","0","0","0","0","0","0","0","0","-2"
"228802","The University of Texas at Tyler","2011","Total full-time Instruction/research/public service, Non-tenured on tenure track, Assistant professors","57","31","26","0","0","0","3","3","0","6","3","3","3","3","0","0","0","0","41","20","21","0","0","0","0","0","0","4","2","2","-2"
"228802","The University of Texas at Tyler","2011","Total full-time Instruction/research/public service, Non-tenured on tenure track total","64","36","28","0","0","0","4","3","1","6","3","3","4","4","0","0","0","0","46","24","22","0","0","0","0","0","0","4","2","2","-2"
"228802","The University of Texas at Tyler","2011","Total full-time Instruction/research/public service, Non-tenured not on tenure track, Professors","3","2","1","0","0","0","0","0","0","0","0","0","0","0","0","0","0","0","3","2","1","0","0","0","0","0","0","0","0","0","-2"
"228802","The University of Texas at Tyler","2011","Total full-time Instruction/research/public service, Non-tenured not on tenure track, Associate professors","2","1","1","0","0","0","0","0","0","0","0","0","0","0","0","0","0","0","2","1","1","0","0","0","0","0","0","0","0","0","-2"
"228802","The University of Texas at Tyler","2011","Total full-time Instruction/research/public servicey, Non-tenured not on tenure track, Assistant professors","14","1","13","0","0","0","0","0","0","1","0","1","1","0","1","0","0","0","12","1","11","0","0","0","0","0","0","0","0","0","-2"
"228802","The University of Texas at Tyler","2011","Total full-time Instruction/research/public service, Non-tenured not on tenure track, Instructors","41","0","41","0","0","0","0","0","0","1","0","1","1","0","1","0","0","0","39","0","39","0","0","0","0","0","0","0","0","0","-2"
"228802","The University of Texas at Tyler","2011","Total full-time Instruction/research/public service, Non-tenured not on tenure track, Lecturers","37","13","24","0","0","0","0","0","0","1","0","1","0","0","0","0","0","0","35","13","22","0","0","0","0","0","0","1","0","1","-2"
"228802","The University of Texas at Tyler","2011","Total full-time Instruction/research/public service, Non-tenured not on tenure track, No academic rank","6","0","6","0","0","0","0","0","0","0","0","0","0","0","0","0","0","0","6","0","6","0","0","0","0","0","0","0","0","0","-2"
"228802","The University of Texas at Tyler","2011","Total full-time Instruction/research/public service, Non-tenured not on tenure track total","103","17","86","0","0","0","0","0","0","3","0","3","2","0","2","0","0","0","97","17","80","0","0","0","0","0","0","1","0","1","-2"
"229267","Trinity University","2011","Total full-time Instruction/research/public service, Tenured, Professors","86","63","23","0","0","0","4","3","1","0","0","0","2","2","0","0","0","0","80","58","22","0","0","0","0","0","0","0","0","0","-2"
"229267","Trinity University","2011","Total full-time Instruction/research/public service, Tenured, Associate professors","80","46","34","0","0","0","5","3","2","5","3","2","8","6","2","0","0","0","60","33","27","0","0","0","2","1","1","0","0","0","-2"
"229267","Trinity University","2011","Total full-time Instruction/research/public service, Tenured total","166","109","57","0","0","0","9","6","3","5","3","2","10","8","2","0","0","0","140","91","49","0","0","0","2","1","1","0","0","0","-2"
"229267","Trinity University","2011","Total full-time Instruction/research/public service, Non-tenured on tenure track, Associate professors","3","1","2","0","0","0","0","0","0","0","0","0","1","1","0","0","0","0","2","0","2","0","0","0","0","0","0","0","0","0","-2"
"229267","Trinity University","2011","Total full-time Instruction/research/public service, Non-tenured on tenure track, Assistant professors","55","28","27","1","0","1","4","3","1","1","0","1","8","3","5","0","0","0","34","17","17","0","0","0","0","0","0","7","5","2","-2"
"229267","Trinity University","2011","Total full-time Instruction/research/public service, Non-tenured on tenure track total","58","29","29","1","0","1","4","3","1","1","0","1","9","4","5","0","0","0","36","17","19","0","0","0","0","0","0","7","5","2","-2"
"229267","Trinity University","2011","Total full-time Instruction/research/public service, Non-tenured not on tenure track, Associate professors","1","1","0","0","0","0","0","0","0","0","0","0","0","0","0","0","0","0","1","1","0","0","0","0","0","0","0","0","0","0","-2"
"229267","Trinity University","2011","Total full-time Instruction/research/public servicey, Non-tenured not on tenure track, Assistant professors","8","5","3","0","0","0","0","0","0","0","0","0","0","0","0","0","0","0","7","5","2","0","0","0","0","0","0","1","0","1","-2"
"229267","Trinity University","2011","Total full-time Instruction/research/public service, Non-tenured not on tenure track, Instructors","12","5","7","0","0","0","1","1","0","1","0","1","3","1","2","0","0","0","7","3","4","0","0","0","0","0","0","0","0","0","-2"
"229267","Trinity University","2011","Total full-time Instruction/research/public service, Non-tenured not on tenure track total","21","11","10","0","0","0","1","1","0","1","0","1","3","1","2","0","0","0","15","9","6","0","0","0","0","0","0","1","0","1","-2"
"232706","Marymount University","2011","Total full-time Instruction/research/public service, Tenured, Professors","47","14","33","0","0","0","0","0","0","1","1","0","1","0","1","0","0","0","42","12","30","0","0","0","2","1","1","1","0","1","-2"
"232706","Marymount University","2011","Total full-time Instruction/research/public service, Tenured, Associate professors","25","5","20","0","0","0","2","0","2","0","0","0","0","0","0","0","0","0","21","5","16","0","0","0","1","0","1","1","0","1","-2"
"232706","Marymount University","2011","Total full-time Instruction/research/public service, Tenured total","72","19","53","0","0","0","2","0","2","1","1","0","1","0","1","0","0","0","63","17","46","0","0","0","3","1","2","2","0","2","-2"
"232706","Marymount University","2011","Total full-time Instruction/research/public service, Non-tenured on tenure track, Associate professors","12","3","9","0","0","0","1","0","1","0","0","0","0","0","0","0","0","0","6","2","4","0","0","0","4","1","3","1","0","1","-2"
"232706","Marymount University","2011","Total full-time Instruction/research/public service, Non-tenured on tenure track, Assistant professors","42","15","27","0","0","0","1","0","1","1","1","0","1","1","0","0","0","0","28","10","18","1","0","1","5","1","4","5","2","3","-2"
"232706","Marymount University","2011","Total full-time Instruction/research/public service, Non-tenured on tenure track total","54","18","36","0","0","0","2","0","2","1","1","0","1","1","0","0","0","0","34","12","22","1","0","1","9","2","7","6","2","4","-2"
"232706","Marymount University","2011","Total full-time Instruction/research/public service, Non-tenured not on tenure track, Professors","1","1","0","0","0","0","0","0","0","0","0","0","0","0","0","0","0","0","1","1","0","0","0","0","0","0","0","0","0","0","-2"
"232706","Marymount University","2011","Total full-time Instruction/research/public service, Non-tenured not on tenure track, Associate professors","1","1","0","0","0","0","0","0","0","0","0","0","0","0","0","0","0","0","1","1","0","0","0","0","0","0","0","0","0","0","-2"
"232706","Marymount University","2011","Total full-time Instruction/research/public servicey, Non-tenured not on tenure track, Assistant professors","21","4","17","0","0","0","0","0","0","0","0","0","1","0","1","0","0","0","15","3","12","0","0","0","5","1","4","0","0","0","-2"
"232706","Marymount University","2011","Total full-time Instruction/research/public service, Non-tenured not on tenure track total","23","6","17","0","0","0","0","0","0","0","0","0","1","0","1","0","0","0","17","5","12","0","0","0","5","1","4","0","0","0","-2"
"234827","Central Washington University","2011","Total full-time Instruction/research/public service, Tenured, Professors","137","91","46","5","2","3","11","10","1","2","1","1","5","3","2","1","1","0","111","74","37","0","0","0","0","0","0","2","0","2","-2"
"234827","Central Washington University","2011","Total full-time Instruction/research/public service, Tenured, Associate professors","85","47","38","0","0","0","2","0","2","0","0","0","5","3","2","1","1","0","76","42","34","0","0","0","0","0","0","1","1","0","-2"
"234827","Central Washington University","2011","Total full-time Instruction/research/public service, Tenured total","222","138","84","5","2","3","13","10","3","2","1","1","10","6","4","2","2","0","187","116","71","0","0","0","0","0","0","3","1","2","-2"
"234827","Central Washington University","2011","Total full-time Instruction/research/public service, Non-tenured on tenure track, Associate professors","11","7","4","0","0","0","0","0","0","1","1","0","0","0","0","0","0","0","10","6","4","0","0","0","0","0","0","0","0","0","-2"
"234827","Central Washington University","2011","Total full-time Instruction/research/public service, Non-tenured on tenure track, Assistant professors","115","67","48","1","1","0","6","2","4","3","2","1","5","2","3","1","1","0","86","49","37","0","0","0","1","1","0","12","9","3","-2"
"234827","Central Washington University","2011","Total full-time Instruction/research/public service, Non-tenured on tenure track total","126","74","52","1","1","0","6","2","4","4","3","1","5","2","3","1","1","0","96","55","41","0","0","0","1","1","0","12","9","3","-2"
"234827","Central Washington University","2011","Total full-time Instruction/research/public service, Non-tenured not on tenure track, Lecturers","79","38","41","1","1","0","2","1","1","0","0","0","0","0","0","0","0","0","72","34","38","0","0","0","3","1","2","1","1","0","-2"
"234827","Central Washington University","2011","Total full-time Instruction/research/public service, Non-tenured not on tenure track total","79","38","41","1","1","0","2","1","1","0","0","0","0","0","0","0","0","0","72","34","38","0","0","0","3","1","2","1","1","0","-2"
"235097","Eastern Washington University","2011","Total full-time Instruction/research/public service, Tenured, Professors","141","95","46","1","1","0","9","7","2","1","1","0","3","3","0","1","1","0","126","82","44","0","0","0","0","0","0","0","0","0","-2"
"235097","Eastern Washington University","2011","Total full-time Instruction/research/public service, Tenured, Associate professors","77","44","33","2","1","1","2","1","1","2","1","1","2","1","1","1","1","0","68","39","29","0","0","0","0","0","0","0","0","0","-2"
"235097","Eastern Washington University","2011","Total full-time Instruction/research/public service, Tenured total","218","139","79","3","2","1","11","8","3","3","2","1","5","4","1","2","2","0","194","121","73","0","0","0","0","0","0","0","0","0","-2"
"235097","Eastern Washington University","2011","Total full-time Instruction/research/public service, Non-tenured on tenure track, Assistant professors","76","36","40","0","0","0","8","3","5","1","1","0","5","3","2","0","0","0","59","27","32","0","0","0","0","0","0","3","2","1","-2"
"235097","Eastern Washington University","2011","Total full-time Instruction/research/public service, Non-tenured on tenure track total","76","36","40","0","0","0","8","3","5","1","1","0","5","3","2","0","0","0","59","27","32","0","0","0","0","0","0","3","2","1","-2"
"235097","Eastern Washington University","2011","Total full-time Instruction/research/public service, Non-tenured not on tenure track, No academic rank","114","51","63","1","1","0","2","0","2","6","3","3","3","1","2","1","1","0","101","45","56","0","0","0","0","0","0","0","0","0","-2"
"235097","Eastern Washington University","2011","Total full-time Instruction/research/public service, Non-tenured not on tenure track total","114","51","63","1","1","0","2","0","2","6","3","3","3","1","2","1","1","0","101","45","56","0","0","0","0","0","0","0","0","0","-2"
"235237","Pierce College District","2011","Total full-time Instruction/research/public service, Tenured, No academic rank","61","29","32","2","1","1","3","1","2","0","0","0","2","1","1","0","0","0","51","25","26","3","1","2","0","0","0","0","0","0","-2"
"235237","Pierce College District","2011","Total full-time Instruction/research/public service, Tenured total","61","29","32","2","1","1","3","1","2","0","0","0","2","1","1","0","0","0","51","25","26","3","1","2","0","0","0","0","0","0","-2"
"235237","Pierce College District","2011","Total full-time Instruction/research/public service, Non-tenured on tenure track, No academic rank","8","2","6","0","0","0","0","0","0","0","0","0","0","0","0","0","0","0","7","2","5","1","0","1","0","0","0","0","0","0","-2"
"235237","Pierce College District","2011","Total full-time Instruction/research/public service, Non-tenured on tenure track total","8","2","6","0","0","0","0","0","0","0","0","0","0","0","0","0","0","0","7","2","5","1","0","1","0","0","0","0","0","0","-2"
"235237","Pierce College District","2011","Total full-time Instruction/research/public service, Non-tenured not on tenure track, No academic rank","8","4","4","0","0","0","0","0","0","0","0","0","0","0","0","0","0","0","8","4","4","0","0","0","0","0","0","0","0","0","-2"
"235237","Pierce College District","2011","Total full-time Instruction/research/public service, Non-tenured not on tenure track total","8","4","4","0","0","0","0","0","0","0","0","0","0","0","0","0","0","0","8","4","4","0","0","0","0","0","0","0","0","0","-2"
"236452","Saint Martin's University","2011","Total full-time Instruction/research/public service, Tenured, Professors","19","12","7","0","0","0","4","3","1","1","1","0","1","0","1","0","0","0","13","8","5","0","0","0","0","0","0","0","0","0","-2"
"236452","Saint Martin's University","2011","Total full-time Instruction/research/public service, Tenured, Associate professors","35","20","15","0","0","0","1","1","0","1","1","0","1","1","0","0","0","0","32","17","15","0","0","0","0","0","0","0","0","0","-2"
"236452","Saint Martin's University","2011","Total full-time Instruction/research/public service, Tenured total","54","32","22","0","0","0","5","4","1","2","2","0","2","1","1","0","0","0","45","25","20","0","0","0","0","0","0","0","0","0","-2"
"236452","Saint Martin's University","2011","Total full-time Instruction/research/public service, Non-tenured on tenure track, Assistant professors","11","7","4","0","0","0","0","0","0","0","0","0","0","0","0","0","0","0","11","7","4","0","0","0","0","0","0","0","0","0","-2"
"236452","Saint Martin's University","2011","Total full-time Instruction/research/public service, Non-tenured on tenure track total","11","7","4","0","0","0","0","0","0","0","0","0","0","0","0","0","0","0","11","7","4","0","0","0","0","0","0","0","0","0","-2"
"236452","Saint Martin's University","2011","Total full-time Instruction/research/public service, Non-tenured not on tenure track, Associate professors","1","1","0","0","0","0","0","0","0","0","0","0","0","0","0","0","0","0","1","1","0","0","0","0","0","0","0","0","0","0","-2"
"236452","Saint Martin's University","2011","Total full-time Instruction/research/public servicey, Non-tenured not on tenure track, Assistant professors","1","1","0","0","0","0","0","0","0","0","0","0","0","0","0","0","0","0","1","1","0","0","0","0","0","0","0","0","0","0","-2"
"236452","Saint Martin's University","2011","Total full-time Instruction/research/public service, Non-tenured not on tenure track, Instructors","4","4","0","0","0","0","0","0","0","0","0","0","0","0","0","0","0","0","4","4","0","0","0","0","0","0","0","0","0","0","-2"
"236452","Saint Martin's University","2011","Total full-time Instruction/research/public service, Non-tenured not on tenure track total","6","6","0","0","0","0","0","0","0","0","0","0","0","0","0","0","0","0","6","6","0","0","0","0","0","0","0","0","0","0","-2"
"236638","Skagit Valley College","2011","Total full-time Instruction/research/public service, Tenured, No academic rank","90","36","54","2","2","0","1","0","1","0","0","0","4","2","2","0","0","0","81","30","51","0","0","0","2","2","0","0","0","0","-2"
"236638","Skagit Valley College","2011","Total full-time Instruction/research/public service, Tenured total","90","36","54","2","2","0","1","0","1","0","0","0","4","2","2","0","0","0","81","30","51","0","0","0","2","2","0","0","0","0","-2"
"236638","Skagit Valley College","2011","Total full-time Instruction/research/public service, Non-tenured on tenure track, No academic rank","7","1","6","0","0","0","0","0","0","0","0","0","0","0","0","0","0","0","7","1","6","0","0","0","0","0","0","0","0","0","-2"
"236638","Skagit Valley College","2011","Total full-time Instruction/research/public service, Non-tenured on tenure track total","7","1","6","0","0","0","0","0","0","0","0","0","0","0","0","0","0","0","7","1","6","0","0","0","0","0","0","0","0","0","-2"
"236638","Skagit Valley College","2011","Total full-time Instruction/research/public service, Non-tenured not on tenure track, No academic rank","8","3","5","0","0","0","0","0","0","0","0","0","0","0","0","0","0","0","7","3","4","0","0","0","1","0","1","0","0","0","-2"
"236638","Skagit Valley College","2011","Total full-time Instruction/research/public service, Non-tenured not on tenure track total","8","3","5","0","0","0","0","0","0","0","0","0","0","0","0","0","0","0","7","3","4","0","0","0","1","0","1","0","0","0","-2"
"236887","Walla Walla Community College","2011","Total full-time Instruction/research/public service, Tenured, No academic rank","71","38","33","3","2","1","2","1","1","1","0","1","1","1","0","0","0","0","64","34","30","0","0","0","0","0","0","0","0","0","-2"
"236887","Walla Walla Community College","2011","Total full-time Instruction/research/public service, Tenured total","71","38","33","3","2","1","2","1","1","1","0","1","1","1","0","0","0","0","64","34","30","0","0","0","0","0","0","0","0","0","-2"
"236887","Walla Walla Community College","2011","Total full-time Instruction/research/public service, Non-tenured on tenure track, No academic rank","11","6","5","0","0","0","0","0","0","1","0","1","0","0","0","0","0","0","10","6","4","0","0","0","0","0","0","0","0","0","-2"
"236887","Walla Walla Community College","2011","Total full-time Instruction/research/public service, Non-tenured on tenure track total","11","6","5","0","0","0","0","0","0","1","0","1","0","0","0","0","0","0","10","6","4","0","0","0","0","0","0","0","0","0","-2"
"236887","Walla Walla Community College","2011","Total full-time Instruction/research/public service, Non-tenured not on tenure track, No academic rank","36","24","12","0","0","0","0","0","0","0","0","0","1","1","0","0","0","0","34","23","11","0","0","0","1","0","1","0","0","0","-2"
"236887","Walla Walla Community College","2011","Total full-time Instruction/research/public service, Non-tenured not on tenure track total","36","24","12","0","0","0","0","0","0","0","0","0","1","1","0","0","0","0","34","23","11","0","0","0","1","0","1","0","0","0","-2"
"236896","Walla Walla University","2011","Total full-time Instruction/research/public service, Tenured, Professors","53","35","18","1","1","0","0","0","0","1","1","0","0","0","0","0","0","0","51","33","18","0","0","0","0","0","0","0","0","0","-2"
"236896","Walla Walla University","2011","Total full-time Instruction/research/public service, Tenured, Associate professors","22","14","8","0","0","0","2","2","0","0","0","0","1","0","1","0","0","0","19","12","7","0","0","0","0","0","0","0","0","0","-2"
"236896","Walla Walla University","2011","Total full-time Instruction/research/public service, Tenured, Assistant professors","10","6","4","0","0","0","0","0","0","0","0","0","0","0","0","0","0","0","10","6","4","0","0","0","0","0","0","0","0","0","-2"
"236896","Walla Walla University","2011","Total full-time Instruction/research/public service, Tenured total","85","55","30","1","1","0","2","2","0","1","1","0","1","0","1","0","0","0","80","51","29","0","0","0","0","0","0","0","0","0","-2"
"236896","Walla Walla University","2011","Total full-time Instruction/research/public service, Non-tenured on tenure track, Professors","1","1","0","0","0","0","0","0","0","0","0","0","0","0","0","0","0","0","1","1","0","0","0","0","0","0","0","0","0","0","-2"
"236896","Walla Walla University","2011","Total full-time Instruction/research/public service, Non-tenured on tenure track, Associate professors","5","2","3","0","0","0","0","0","0","0","0","0","0","0","0","0","0","0","5","2","3","0","0","0","0","0","0","0","0","0","-2"
"236896","Walla Walla University","2011","Total full-time Instruction/research/public service, Non-tenured on tenure track, Assistant professors","13","5","8","0","0","0","0","0","0","0","0","0","0","0","0","0","0","0","13","5","8","0","0","0","0","0","0","0","0","0","-2"
"236896","Walla Walla University","2011","Total full-time Instruction/research/public service, Non-tenured on tenure track, Instructors","2","0","2","0","0","0","0","0","0","0","0","0","0","0","0","0","0","0","2","0","2","0","0","0","0","0","0","0","0","0","-2"
"236896","Walla Walla University","2011","Total full-time Instruction/research/public service, Non-tenured on tenure track total","21","8","13","0","0","0","0","0","0","0","0","0","0","0","0","0","0","0","21","8","13","0","0","0","0","0","0","0","0","0","-2"
"236896","Walla Walla University","2011","Total full-time Instruction/research/public service, Non-tenured not on tenure track, Professors","2","2","0","0","0","0","0","0","0","0","0","0","0","0","0","0","0","0","2","2","0","0","0","0","0","0","0","0","0","0","-2"
"236896","Walla Walla University","2011","Total full-time Instruction/research/public service, Non-tenured not on tenure track, Associate professors","3","1","2","0","0","0","0","0","0","0","0","0","0","0","0","0","0","0","3","1","2","0","0","0","0","0","0","0","0","0","-2"
"236896","Walla Walla University","2011","Total full-time Instruction/research/public servicey, Non-tenured not on tenure track, Assistant professors","3","0","3","0","0","0","0","0","0","0","0","0","0","0","0","0","0","0","3","0","3","0","0","0","0","0","0","0","0","0","-2"
"236896","Walla Walla University","2011","Total full-time Instruction/research/public service, Non-tenured not on tenure track, Instructors","5","4","1","0","0","0","0","0","0","0","0","0","0","0","0","0","0","0","5","4","1","0","0","0","0","0","0","0","0","0","-2"
"236896","Walla Walla University","2011","Total full-time Instruction/research/public service, Non-tenured not on tenure track total","13","7","6","0","0","0","0","0","0","0","0","0","0","0","0","0","0","0","13","7","6","0","0","0","0","0","0","0","0","0","-2"
"238430","Cardinal Stritch University","2011","Total full-time Instruction/research/public service, Tenured, Professors","11","6","5","0","0","0","1","1","0","0","0","0","1","0","1","1","0","1","7","4","3","0","0","0","1","1","0","0","0","0","-2"
"238430","Cardinal Stritch University","2011","Total full-time Instruction/research/public service, Tenured, Associate professors","18","5","13","0","0","0","3","0","3","0","0","0","0","0","0","0","0","0","15","5","10","0","0","0","0","0","0","0","0","0","-2"
"238430","Cardinal Stritch University","2011","Total full-time Instruction/research/public service, Tenured, Assistant professors","24","9","15","0","0","0","0","0","0","1","1","0","1","1","0","0","0","0","22","7","15","0","0","0","0","0","0","0","0","0","-2"
"238430","Cardinal Stritch University","2011","Total full-time Instruction/research/public service, Tenured total","53","20","33","0","0","0","4","1","3","1","1","0","2","1","1","1","0","1","44","16","28","0","0","0","1","1","0","0","0","0","-2"
"238430","Cardinal Stritch University","2011","Total full-time Instruction/research/public service, Non-tenured on tenure track, Associate professors","5","4","1","0","0","0","0","0","0","0","0","0","0","0","0","0","0","0","5","4","1","0","0","0","0","0","0","0","0","0","-2"
"238430","Cardinal Stritch University","2011","Total full-time Instruction/research/public service, Non-tenured on tenure track, Assistant professors","22","7","15","0","0","0","0","0","0","1","1","0","1","1","0","0","0","0","20","5","15","0","0","0","0","0","0","0","0","0","-2"
"238430","Cardinal Stritch University","2011","Total full-time Instruction/research/public service, Non-tenured on tenure track, Instructors","2","1","1","0","0","0","0","0","0","1","0","1","0","0","0","0","0","0","1","1","0","0","0","0","0","0","0","0","0","0","-2"
"238430","Cardinal Stritch University","2011","Total full-time Instruction/research/public service, Non-tenured on tenure track total","29","12","17","0","0","0","0","0","0","2","1","1","1","1","0","0","0","0","26","10","16","0","0","0","0","0","0","0","0","0","-2"
"238430","Cardinal Stritch University","2011","Total full-time Instruction/research/public service, Non-tenured not on tenure track, Associate professors","2","0","2","0","0","0","0","0","0","0","0","0","0","0","0","0","0","0","2","0","2","0","0","0","0","0","0","0","0","0","-2"
"238430","Cardinal Stritch University","2011","Total full-time Instruction/research/public servicey, Non-tenured not on tenure track, Assistant professors","12","3","9","0","0","0","0","0","0","0","0","0","0","0","0","0","0","0","12","3","9","0","0","0","0","0","0","0","0","0","-2"
"238430","Cardinal Stritch University","2011","Total full-time Instruction/research/public service, Non-tenured not on tenure track, Instructors","9","3","6","0","0","0","0","0","0","0","0","0","1","1","0","0","0","0","8","2","6","0","0","0","0","0","0","0","0","0","-2"
"238430","Cardinal Stritch University","2011","Total full-time Instruction/research/public service, Non-tenured not on tenure track total","23","6","17","0","0","0","0","0","0","0","0","0","1","1","0","0","0","0","22","5","17","0","0","0","0","0","0","0","0","0","-2"
"239309","Milwaukee Institute of Art & Design","2011","Total full-time Instruction/research/public service, Non-tenured not on tenure track, Professors","20","12","8","0","0","0","1","1","0","1","1","0","0","0","0","0","0","0","18","10","8","0","0","0","0","0","0","0","0","0","-2"
"239309","Milwaukee Institute of Art & Design","2011","Total full-time Instruction/research/public service, Non-tenured not on tenure track, Associate professors","13","5","8","0","0","0","1","0","1","0","0","0","1","0","1","0","0","0","10","4","6","1","1","0","0","0","0","0","0","0","-2"
"239309","Milwaukee Institute of Art & Design","2011","Total full-time Instruction/research/public servicey, Non-tenured not on tenure track, Assistant professors","1","1","0","0","0","0","0","0","0","0","0","0","0","0","0","0","0","0","1","1","0","0","0","0","0","0","0","0","0","0","-2"
"239309","Milwaukee Institute of Art & Design","2011","Total full-time Instruction/research/public service, Non-tenured not on tenure track, No academic rank","7","4","3","0","0","0","0","0","0","0","0","0","0","0","0","0","0","0","7","4","3","0","0","0","0","0","0","0","0","0","-2"
"239309","Milwaukee Institute of Art & Design","2011","Total full-time Instruction/research/public service, Non-tenured not on tenure track total","41","22","19","0","0","0","2","1","1","1","1","0","1","0","1","0","0","0","36","19","17","1","1","0","0","0","0","0","0","0","-2"
"240374","University of Wisconsin-Parkside","2011","Total full-time Instruction/research/public service, Tenured, Professors","24","16","8","0","0","0","6","4","2","1","1","0","0","0","0","0","0","0","17","11","6","0","0","0","0","0","0","0","0","0","-2"
"240374","University of Wisconsin-Parkside","2011","Total full-time Instruction/research/public service, Tenured, Associate professors","49","28","21","0","0","0","8","2","6","3","2","1","2","1","1","0","0","0","35","22","13","0","0","0","1","1","0","0","0","0","-2"
"240374","University of Wisconsin-Parkside","2011","Total full-time Instruction/research/public service, Tenured, Assistant professors","1","1","0","0","0","0","1","1","0","0","0","0","0","0","0","0","0","0","0","0","0","0","0","0","0","0","0","0","0","0","-2"
"240374","University of Wisconsin-Parkside","2011","Total full-time Instruction/research/public service, Tenured total","74","45","29","0","0","0","15","7","8","4","3","1","2","1","1","0","0","0","52","33","19","0","0","0","1","1","0","0","0","0","-2"
"240374","University of Wisconsin-Parkside","2011","Total full-time Instruction/research/public service, Non-tenured on tenure track, Associate professors","4","1","3","0","0","0","1","0","1","0","0","0","0","0","0","0","0","0","3","1","2","0","0","0","0","0","0","0","0","0","-2"
"240374","University of Wisconsin-Parkside","2011","Total full-time Instruction/research/public service, Non-tenured on tenure track, Assistant professors","33","16","17","0","0","0","3","2","1","3","2","1","5","1","4","0","0","0","17","7","10","0","0","0","3","2","1","2","2","0","-2"
"240374","University of Wisconsin-Parkside","2011","Total full-time Instruction/research/public service, Non-tenured on tenure track total","37","17","20","0","0","0","4","2","2","3","2","1","5","1","4","0","0","0","20","8","12","0","0","0","3","2","1","2","2","0","-2"
"240374","University of Wisconsin-Parkside","2011","Total full-time Instruction/research/public servicey, Non-tenured not on tenure track, Assistant professors","11","6","5","0","0","0","0","0","0","0","0","0","0","0","0","0","0","0","2","1","1","0","0","0","7","3","4","2","2","0","-2"
"240374","University of Wisconsin-Parkside","2011","Total full-time Instruction/research/public service, Non-tenured not on tenure track, Lecturers","58","22","36","0","0","0","2","1","1","3","2","1","3","0","3","0","0","0","42","18","24","0","0","0","7","0","7","1","1","0","-2"
"240374","University of Wisconsin-Parkside","2011","Total full-time Instruction/research/public service, Non-tenured not on tenure track, No academic rank","1","0","1","0","0","0","0","0","0","0","0","0","0","0","0","0","0","0","1","0","1","0","0","0","0","0","0","0","0","0","-2"
"240374","University of Wisconsin-Parkside","2011","Total full-time Instruction/research/public service, Non-tenured not on tenure track total","70","28","42","0","0","0","2","1","1","3","2","1","3","0","3","0","0","0","45","19","26","0","0","0","14","3","11","3","3","0","-2"
"243823","Parker University","2011","Total full-time Instruction/research/public service, Non-tenured not on tenure track, Professors","18","16","2","0","0","0","2","2","0","0","0","0","0","0","0","0","0","0","16","14","2","0","0","0","0","0","0","0","0","0","-2"
"243823","Parker University","2011","Total full-time Instruction/research/public service, Non-tenured not on tenure track, Associate professors","29","18","11","0","0","0","4","3","1","2","2","0","0","0","0","0","0","0","23","13","10","0","0","0","0","0","0","0","0","0","-2"
"243823","Parker University","2011","Total full-time Instruction/research/public servicey, Non-tenured not on tenure track, Assistant professors","10","7","3","0","0","0","0","0","0","0","0","0","2","1","1","0","0","0","8","6","2","0","0","0","0","0","0","0","0","0","-2"
"243823","Parker University","2011","Total full-time Instruction/research/public service, Non-tenured not on tenure track, Instructors","3","1","2","0","0","0","0","0","0","0","0","0","0","0","0","0","0","0","3","1","2","0","0","0","0","0","0","0","0","0","-2"
"243823","Parker University","2011","Total full-time Instruction/research/public service, Non-tenured not on tenure track total","60","42","18","0","0","0","6","5","1","2","2","0","2","1","1","0","0","0","50","34","16","0","0","0","0","0","0","0","0","0","-2"
"244233","City College-Fort Lauderdale","2011","Total full-time Instruction/research/public service, Non-tenured not on tenure track, Instructors","6","1","5","0","0","0","0","0","0","3","0","3","1","1","0","2","0","2","0","0","0","0","0","0","0","0","0","0","0","0","-2"
"244233","City College-Fort Lauderdale","2011","Total full-time Instruction/research/public service, Non-tenured not on tenure track total","6","1","5","0","0","0","0","0","0","3","0","3","1","1","0","2","0","2","0","0","0","0","0","0","0","0","0","0","0","0","-2"
"245838","Antioch University-Los Angeles","2011","Total full-time Instruction/research/public service, Non-tenured not on tenure track, Professors","25","13","12","0","0","0","3","2","1","2","0","2","1","1","0","0","0","0","19","10","9","0","0","0","0","0","0","0","0","0","-2"
"245838","Antioch University-Los Angeles","2011","Total full-time Instruction/research/public service, Non-tenured not on tenure track total","25","13","12","0","0","0","3","2","1","2","0","2","1","1","0","0","0","0","19","10","9","0","0","0","0","0","0","0","0","0","-2"
"247834","Collin County Community College District","2011","Total full-time Instruction/research/public service, Non-tenured not on tenure track, No academic rank","358","151","207","3","1","2","13","1","12","22","10","12","13","1","12","0","0","0","304","135","169","3","3","0","0","0","0","0","0","0","-2"
"247834","Collin County Community College District","2011","Total full-time Instruction/research/public service, Non-tenured not on tenure track total","358","151","207","3","1","2","13","1","12","22","10","12","13","1","12","0","0","0","304","135","169","3","3","0","0","0","0","0","0","0","-2"
"262086","Brandman University","2011","Total full-time Instruction/research/public service, Non-tenured not on tenure track, Professors","5","1","4","0","0","0","0","0","0","1","0","1","0","0","0","0","0","0","4","1","3","0","0","0","0","0","0","0","0","0","-2"
"262086","Brandman University","2011","Total full-time Instruction/research/public service, Non-tenured not on tenure track, Associate professors","15","5","10","0","0","0","0","0","0","1","0","1","0","0","0","1","1","0","12","4","8","0","0","0","1","0","1","0","0","0","-2"
"262086","Brandman University","2011","Total full-time Instruction/research/public servicey, Non-tenured not on tenure track, Assistant professors","48","21","27","0","0","0","2","1","1","4","4","0","0","0","0","1","1","0","35","12","23","0","0","0","6","3","3","0","0","0","-2"
"262086","Brandman University","2011","Total full-time Instruction/research/public service, Non-tenured not on tenure track, Lecturers","1","1","0","0","0","0","0","0","0","0","0","0","0","0","0","1","1","0","0","0","0","0","0","0","0","0","0","0","0","0","-2"
"262086","Brandman University","2011","Total full-time Instruction/research/public service, Non-tenured not on tenure track, No academic rank","2","1","1","0","0","0","0","0","0","0","0","0","0","0","0","0","0","0","2","1","1","0","0","0","0","0","0","0","0","0","-2"
"262086","Brandman University","2011","Total full-time Instruction/research/public service, Non-tenured not on tenure track total","71","29","42","0","0","0","2","1","1","6","4","2","0","0","0","3","3","0","53","18","35","0","0","0","7","3","4","0","0","0","-2"
"262129","New College of Florida","2011","Total full-time Instruction/research/public service, Tenured, Professors","26","18","8","0","0","0","0","0","0","1","1","0","1","1","0","0","0","0","24","16","8","0","0","0","0","0","0","0","0","0","-2"
"262129","New College of Florida","2011","Total full-time Instruction/research/public service, Tenured, Associate professors","19","4","15","0","0","0","0","0","0","1","0","1","2","0","2","0","0","0","16","4","12","0","0","0","0","0","0","0","0","0","-2"
"262129","New College of Florida","2011","Total full-time Instruction/research/public service, Tenured total","45","22","23","0","0","0","0","0","0","2","1","1","3","1","2","0","0","0","40","20","20","0","0","0","0","0","0","0","0","0","-2"
"262129","New College of Florida","2011","Total full-time Instruction/research/public service, Non-tenured on tenure track, Assistant professors","15","10","5","0","0","0","2","1","1","0","0","0","0","0","0","0","0","0","11","8","3","0","0","0","0","0","0","2","1","1","-2"
"262129","New College of Florida","2011","Total full-time Instruction/research/public service, Non-tenured on tenure track total","15","10","5","0","0","0","2","1","1","0","0","0","0","0","0","0","0","0","11","8","3","0","0","0","0","0","0","2","1","1","-2"
"262129","New College of Florida","2011","Total full-time Instruction/research/public servicey, Non-tenured not on tenure track, Assistant professors","11","6","5","0","0","0","0","0","0","0","0","0","2","2","0","0","0","0","9","4","5","0","0","0","0","0","0","0","0","0","-2"
"262129","New College of Florida","2011","Total full-time Instruction/research/public service, Non-tenured not on tenure track, Instructors","1","0","1","0","0","0","0","0","0","0","0","0","0","0","0","0","0","0","1","0","1","0","0","0","0","0","0","0","0","0","-2"
"262129","New College of Florida","2011","Total full-time Instruction/research/public service, Non-tenured not on tenure track, No academic rank","2","1","1","0","0","0","0","0","0","0","0","0","0","0","0","0","0","0","1","1","0","0","0","0","0","0","0","1","0","1","-2"
"262129","New College of Florida","2011","Total full-time Instruction/research/public service, Non-tenured not on tenure track total","14","7","7","0","0","0","0","0","0","0","0","0","2","2","0","0","0","0","11","5","6","0","0","0","0","0","0","1","0","1","-2"
"377564","University of Washington-Tacoma Campus","2011","Total full-time Instruction/research/public service, Tenured, Professors","28","15","13","0","0","0","5","3","2","0","0","0","1","1","0","0","0","0","21","10","11","0","0","0","1","1","0","0","0","0","-2"
"377564","University of Washington-Tacoma Campus","2011","Total full-time Instruction/research/public service, Tenured, Associate professors","42","19","23","0","0","0","5","3","2","4","2","2","4","3","1","0","0","0","27","10","17","1","0","1","1","1","0","0","0","0","-2"
"377564","University of Washington-Tacoma Campus","2011","Total full-time Instruction/research/public service, Tenured total","70","34","36","0","0","0","10","6","4","4","2","2","5","4","1","0","0","0","48","20","28","1","0","1","2","2","0","0","0","0","-2"
"377564","University of Washington-Tacoma Campus","2011","Total full-time Instruction/research/public service, Non-tenured on tenure track, Assistant professors","35","15","20","0","0","0","3","1","2","1","0","1","1","0","1","0","0","0","19","10","9","0","0","0","6","2","4","5","2","3","-2"
"377564","University of Washington-Tacoma Campus","2011","Total full-time Instruction/research/public service, Non-tenured on tenure track total","35","15","20","0","0","0","3","1","2","1","0","1","1","0","1","0","0","0","19","10","9","0","0","0","6","2","4","5","2","3","-2"
"377564","University of Washington-Tacoma Campus","2011","Total full-time Instruction/research/public service, Non-tenured not on tenure track, Professors","4","3","1","0","0","0","1","1","0","0","0","0","0","0","0","0","0","0","3","2","1","0","0","0","0","0","0","0","0","0","-2"
"377564","University of Washington-Tacoma Campus","2011","Total full-time Instruction/research/public service, Non-tenured not on tenure track, Associate professors","3","0","3","0","0","0","0","0","0","1","0","1","0","0","0","0","0","0","2","0","2","0","0","0","0","0","0","0","0","0","-2"
"377564","University of Washington-Tacoma Campus","2011","Total full-time Instruction/research/public service, Non-tenured not on tenure track, Lecturers","43","20","23","0","0","0","0","0","0","0","0","0","0","0","0","1","0","1","27","14","13","2","1","1","12","4","8","1","1","0","-2"
"377564","University of Washington-Tacoma Campus","2011","Total full-time Instruction/research/public service, Non-tenured not on tenure track total","50","23","27","0","0","0","1","1","0","1","0","1","0","0","0","1","0","1","32","16","16","2","1","1","12","4","8","1","1","0","-2"
"385619","Everglades University","2011","Total full-time Instruction/research/public service, Non-tenured not on tenure track, Instructors","79","50","29","1","0","1","2","0","2","3","3","0","9","7","2","0","0","0","63","40","23","1","0","1","0","0","0","0","0","0","-2"
"385619","Everglades University","2011","Total full-time Instruction/research/public service, Non-tenured not on tenure track total","79","50","29","1","0","1","2","0","2","3","3","0","9","7","2","0","0","0","63","40","23","1","0","1","0","0","0","0","0","0","-2"
"386472","Herzing University-Orlando","2011","Total full-time Instruction/research/public service, Non-tenured not on tenure track, Professors","3","1","2","0","0","0","0","0","0","1","0","1","1","0","1","0","0","0","1","1","0","0","0","0","0","0","0","0","0","0","-2"
"386472","Herzing University-Orlando","2011","Total full-time Instruction/research/public service, Non-tenured not on tenure track, Associate professors","11","3","8","0","0","0","0","0","0","4","0","4","0","0","0","1","0","1","6","3","3","0","0","0","0","0","0","0","0","0","-2"
"386472","Herzing University-Orlando","2011","Total full-time Instruction/research/public servicey, Non-tenured not on tenure track, Assistant professors","7","2","5","0","0","0","0","0","0","1","0","1","0","0","0","0","0","0","6","2","4","0","0","0","0","0","0","0","0","0","-2"
"386472","Herzing University-Orlando","2011","Total full-time Instruction/research/public service, Non-tenured not on tenure track, Instructors","1","0","1","0","0","0","0","0","0","1","0","1","0","0","0","0","0","0","0","0","0","0","0","0","0","0","0","0","0","0","-2"
"386472","Herzing University-Orlando","2011","Total full-time Instruction/research/public service, Non-tenured not on tenure track total","22","6","16","0","0","0","0","0","0","7","0","7","1","0","1","1","0","1","13","6","7","0","0","0","0","0","0","0","0","0","-2"
"388520","College of Biblical Studies-Houston","2011","Total full-time Instruction/research/public service, Non-tenured not on tenure track, Professors","2","2","0","0","0","0","0","0","0","0","0","0","1","1","0","0","0","0","1","1","0","0","0","0","0","0","0","0","0","0","-2"
"388520","College of Biblical Studies-Houston","2011","Total full-time Instruction/research/public service, Non-tenured not on tenure track, Associate professors","6","6","0","0","0","0","0","0","0","2","2","0","0","0","0","0","0","0","4","4","0","0","0","0","0","0","0","0","0","0","-2"
"388520","College of Biblical Studies-Houston","2011","Total full-time Instruction/research/public servicey, Non-tenured not on tenure track, Assistant professors","4","3","1","0","0","0","0","0","0","1","1","0","2","2","0","0","0","0","1","0","1","0","0","0","0","0","0","0","0","0","-2"
"388520","College of Biblical Studies-Houston","2011","Total full-time Instruction/research/public service, Non-tenured not on tenure track total","12","11","1","0","0","0","0","0","0","3","3","0","3","3","0","0","0","0","6","5","1","0","0","0","0","0","0","0","0","0","-2"
"418126","New York College of Health Professions","2011","Total full-time Instruction/research/public service, Non-tenured not on tenure track, Instructors","7","5","2","0","0","0","4","2","2","1","1","0","0","0","0","0","0","0","2","2","0","0","0","0","0","0","0","0","0","0","-2"
"418126","New York College of Health Professions","2011","Total full-time Instruction/research/public service, Non-tenured not on tenure track total","7","5","2","0","0","0","4","2","2","1","1","0","0","0","0","0","0","0","2","2","0","0","0","0","0","0","0","0","0","0","-2"
"426314","Embry-Riddle Aeronautical University-Worldwide","2011","Total full-time Instruction/research/public service, Tenured, Professors","6","6","0","0","0","0","0","0","0","0","0","0","0","0","0","0","0","0","6","6","0","0","0","0","0","0","0","0","0","0","-2"
"426314","Embry-Riddle Aeronautical University-Worldwide","2011","Total full-time Instruction/research/public service, Tenured, Associate professors","1","0","1","0","0","0","0","0","0","0","0","0","0","0","0","0","0","0","1","0","1","0","0","0","0","0","0","0","0","0","-2"
"426314","Embry-Riddle Aeronautical University-Worldwide","2011","Total full-time Instruction/research/public service, Tenured total","7","6","1","0","0","0","0","0","0","0","0","0","0","0","0","0","0","0","7","6","1","0","0","0","0","0","0","0","0","0","-2"
"426314","Embry-Riddle Aeronautical University-Worldwide","2011","Total full-time Instruction/research/public service, Non-tenured on tenure track, Associate professors","2","2","0","0","0","0","0","0","0","0","0","0","0","0","0","0","0","0","2","2","0","0","0","0","0","0","0","0","0","0","-2"
"426314","Embry-Riddle Aeronautical University-Worldwide","2011","Total full-time Instruction/research/public service, Non-tenured on tenure track, Assistant professors","7","5","2","0","0","0","0","0","0","1","1","0","0","0","0","0","0","0","6","4","2","0","0","0","0","0","0","0","0","0","-2"
"426314","Embry-Riddle Aeronautical University-Worldwide","2011","Total full-time Instruction/research/public service, Non-tenured on tenure track total","9","7","2","0","0","0","0","0","0","1","1","0","0","0","0","0","0","0","8","6","2","0","0","0","0","0","0","0","0","0","-2"
"426314","Embry-Riddle Aeronautical University-Worldwide","2011","Total full-time Instruction/research/public service, Non-tenured not on tenure track, Professors","2","2","0","0","0","0","0","0","0","0","0","0","0","0","0","0","0","0","2","2","0","0","0","0","0","0","0","0","0","0","-2"
"426314","Embry-Riddle Aeronautical University-Worldwide","2011","Total full-time Instruction/research/public service, Non-tenured not on tenure track, Associate professors","20","18","2","0","0","0","1","1","0","0","0","0","0","0","0","0","0","0","19","17","2","0","0","0","0","0","0","0","0","0","-2"
"426314","Embry-Riddle Aeronautical University-Worldwide","2011","Total full-time Instruction/research/public servicey, Non-tenured not on tenure track, Assistant professors","37","25","12","0","0","0","0","0","0","0","0","0","0","0","0","1","1","0","35","24","11","1","0","1","0","0","0","0","0","0","-2"
"426314","Embry-Riddle Aeronautical University-Worldwide","2011","Total full-time Instruction/research/public service, Non-tenured not on tenure track, Instructors","37","26","11","0","0","0","0","0","0","3","3","0","1","0","1","0","0","0","32","23","9","0","0","0","1","0","1","0","0","0","-2"
"426314","Embry-Riddle Aeronautical University-Worldwide","2011","Total full-time Instruction/research/public service, Non-tenured not on tenure track total","96","71","25","0","0","0","1","1","0","3","3","0","1","0","1","1","1","0","88","66","22","1","0","1","1","0","1","0","0","0","-2"
"433660","Florida Gulf Coast University","2011","Total full-time Instruction/research/public service, Tenured, Professors","6","3","3","0","0","0","0","0","0","0","0","0","1","0","1","0","0","0","5","3","2","0","0","0","0","0","0","0","0","0","-2"
"433660","Florida Gulf Coast University","2011","Total full-time Instruction/research/public service, Tenured, Associate professors","4","2","2","0","0","0","0","0","0","1","1","0","0","0","0","0","0","0","3","1","2","0","0","0","0","0","0","0","0","0","-2"
"433660","Florida Gulf Coast University","2011","Total full-time Instruction/research/public service, Tenured total","10","5","5","0","0","0","0","0","0","1","1","0","1","0","1","0","0","0","8","4","4","0","0","0","0","0","0","0","0","0","-2"
"433660","Florida Gulf Coast University","2011","Total full-time Instruction/research/public service, Non-tenured not on tenure track, Professors","58","40","18","1","1","0","0","0","0","1","0","1","4","3","1","0","0","0","50","34","16","0","0","0","0","0","0","2","2","0","-2"
"433660","Florida Gulf Coast University","2011","Total full-time Instruction/research/public service, Non-tenured not on tenure track, Associate professors","95","56","39","1","0","1","3","0","3","5","5","0","7","4","3","0","0","0","71","39","32","1","1","0","0","0","0","7","7","0","-2"
"433660","Florida Gulf Coast University","2011","Total full-time Instruction/research/public servicey, Non-tenured not on tenure track, Assistant professors","132","70","62","2","2","0","12","9","3","6","1","5","8","3","5","0","0","0","103","55","48","1","0","1","0","0","0","0","0","0","-2"
"433660","Florida Gulf Coast University","2011","Total full-time Instruction/research/public service, Non-tenured not on tenure track, Instructors","99","44","55","0","0","0","2","1","1","3","2","1","4","1","3","0","0","0","89","39","50","1","1","0","0","0","0","0","0","0","-2"
"433660","Florida Gulf Coast University","2011","Total full-time Instruction/research/public service, Non-tenured not on tenure track total","384","210","174","4","3","1","17","10","7","15","8","7","23","11","12","0","0","0","313","167","146","3","2","1","0","0","0","9","9","0","-2"
"439288","Johnson & Wales University-Denver","2011","Total full-time Instruction/research/public service, Non-tenured not on tenure track, Professors","1","1","0","0","0","0","0","0","0","0","0","0","0","0","0","0","0","0","1","1","0","0","0","0","0","0","0","0","0","0","-2"
"439288","Johnson & Wales University-Denver","2011","Total full-time Instruction/research/public service, Non-tenured not on tenure track, Associate professors","14","8","6","0","0","0","0","0","0","0","0","0","1","0","1","0","0","0","13","8","5","0","0","0","0","0","0","0","0","0","-2"
"439288","Johnson & Wales University-Denver","2011","Total full-time Instruction/research/public servicey, Non-tenured not on tenure track, Assistant professors","26","15","11","0","0","0","0","0","0","0","0","0","1","1","0","0","0","0","25","14","11","0","0","0","0","0","0","0","0","0","-2"
"439288","Johnson & Wales University-Denver","2011","Total full-time Instruction/research/public service, Non-tenured not on tenure track, Instructors","13","10","3","0","0","0","0","0","0","0","0","0","0","0","0","0","0","0","13","10","3","0","0","0","0","0","0","0","0","0","-2"
"439288","Johnson & Wales University-Denver","2011","Total full-time Instruction/research/public service, Non-tenured not on tenure track total","54","34","20","0","0","0","0","0","0","0","0","0","2","1","1","0","0","0","52","33","19","0","0","0","0","0","0","0","0","0","-2"
"446233","Ecclesia College","2011","Total full-time Instruction/research/public service, Non-tenured not on tenure track, No academic rank","5","2","3","0","0","0","0","0","0","0","0","0","0","0","0","0","0","0","5","2","3","0","0","0","0","0","0","0","0","0","-2"
"446233","Ecclesia College","2011","Total full-time Instruction/research/public service, Non-tenured not on tenure track total","5","2","3","0","0","0","0","0","0","0","0","0","0","0","0","0","0","0","5","2","3","0","0","0","0","0","0","0","0","0","-2"
"447689","Georgia Gwinnett College","2011","Total full-time Instruction/research/public service, Non-tenured not on tenure track, Professors","15","11","4","0","0","0","4","3","1","1","1","0","0","0","0","0","0","0","10","7","3","0","0","0","0","0","0","0","0","0","-2"
"447689","Georgia Gwinnett College","2011","Total full-time Instruction/research/public service, Non-tenured not on tenure track, Associate professors","55","32","23","0","0","0","6","4","2","12","6","6","1","0","1","0","0","0","33","20","13","0","0","0","2","1","1","1","1","0","-2"
"447689","Georgia Gwinnett College","2011","Total full-time Instruction/research/public servicey, Non-tenured not on tenure track, Assistant professors","220","106","114","2","1","1","19","9","10","22","8","14","10","6","4","0","0","0","134","65","69","0","0","0","13","6","7","20","11","9","-2"
"447689","Georgia Gwinnett College","2011","Total full-time Instruction/research/public service, Non-tenured not on tenure track, Instructors","18","4","14","0","0","0","1","0","1","3","0","3","1","0","1","0","0","0","13","4","9","0","0","0","0","0","0","0","0","0","-2"
"447689","Georgia Gwinnett College","2011","Total full-time Instruction/research/public service, Non-tenured not on tenure track total","308","153","155","2","1","1","30","16","14","38","15","23","12","6","6","0","0","0","190","96","94","0","0","0","15","7","8","21","12","9","-2"
"448761","CollegeAmerica-Fort Collins","2011","Total full-time Instruction/research/public service, Non-tenured not on tenure track, Instructors","7","3","4","0","0","0","0","0","0","2","2","0","1","1","0","0","0","0","4","0","4","0","0","0","0","0","0","0","0","0","-2"
"448761","CollegeAmerica-Fort Collins","2011","Total full-time Instruction/research/public service, Non-tenured not on tenure track total","7","3","4","0","0","0","0","0","0","2","2","0","1","1","0","0","0","0","4","0","4","0","0","0","0","0","0","0","0","0","-2"
"448840","University of South Florida-St Petersburg","2011","Total full-time Instruction/research/public service, Tenured, Professors","16","14","2","0","0","0","0","0","0","0","0","0","1","1","0","0","0","0","15","13","2","0","0","0","0","0","0","0","0","0","-2"
"448840","University of South Florida-St Petersburg","2011","Total full-time Instruction/research/public service, Tenured, Associate professors","42","23","19","0","0","0","3","1","2","2","1","1","5","3","2","0","0","0","31","17","14","0","0","0","1","1","0","0","0","0","-2"
"448840","University of South Florida-St Petersburg","2011","Total full-time Instruction/research/public service, Tenured total","58","37","21","0","0","0","3","1","2","2","1","1","6","4","2","0","0","0","46","30","16","0","0","0","1","1","0","0","0","0","-2"
"448840","University of South Florida-St Petersburg","2011","Total full-time Instruction/research/public service, Non-tenured on tenure track, Associate professors","2","0","2","0","0","0","0","0","0","0","0","0","1","0","1","0","0","0","1","0","1","0","0","0","0","0","0","0","0","0","-2"
"448840","University of South Florida-St Petersburg","2011","Total full-time Instruction/research/public service, Non-tenured on tenure track, Assistant professors","20","11","9","0","0","0","3","1","2","1","1","0","1","1","0","0","0","0","9","5","4","0","0","0","0","0","0","6","3","3","-2"
"448840","University of South Florida-St Petersburg","2011","Total full-time Instruction/research/public service, Non-tenured on tenure track, Instructors","2","0","2","0","0","0","0","0","0","0","0","0","1","0","1","0","0","0","1","0","1","0","0","0","0","0","0","0","0","0","-2"
"448840","University of South Florida-St Petersburg","2011","Total full-time Instruction/research/public service, Non-tenured on tenure track, Lecturers","1","1","0","0","0","0","0","0","0","0","0","0","0","0","0","0","0","0","1","1","0","0","0","0","0","0","0","0","0","0","-2"
"448840","University of South Florida-St Petersburg","2011","Total full-time Instruction/research/public service, Non-tenured on tenure track total","25","12","13","0","0","0","3","1","2","1","1","0","3","1","2","0","0","0","12","6","6","0","0","0","0","0","0","6","3","3","-2"
"448840","University of South Florida-St Petersburg","2011","Total full-time Instruction/research/public servicey, Non-tenured not on tenure track, Assistant professors","7","3","4","0","0","0","1","0","1","0","0","0","0","0","0","0","0","0","5","2","3","0","0","0","0","0","0","1","1","0","-2"
"448840","University of South Florida-St Petersburg","2011","Total full-time Instruction/research/public service, Non-tenured not on tenure track, Instructors","15","5","10","0","0","0","1","0","1","1","0","1","0","0","0","0","0","0","12","5","7","0","0","0","0","0","0","1","0","1","-2"
"448840","University of South Florida-St Petersburg","2011","Total full-time Instruction/research/public service, Non-tenured not on tenure track, Lecturers","2","1","1","0","0","0","0","0","0","1","0","1","0","0","0","0","0","0","1","1","0","0","0","0","0","0","0","0","0","0","-2"
"448840","University of South Florida-St Petersburg","2011","Total full-time Instruction/research/public service, Non-tenured not on tenure track total","24","9","15","0","0","0","2","0","2","2","0","2","0","0","0","0","0","0","18","8","10","0","0","0","0","0","0","2","1","1","-2"
"451671","University of South Florida-Sarasota-Manatee","2011","Total full-time Instruction/research/public service, Tenured, Professors","4","3","1","0","0","0","0","0","0","0","0","0","0","0","0","0","0","0","4","3","1","0","0","0","0","0","0","0","0","0","-2"
"451671","University of South Florida-Sarasota-Manatee","2011","Total full-time Instruction/research/public service, Tenured, Associate professors","9","3","6","0","0","0","1","1","0","0","0","0","0","0","0","0","0","0","8","2","6","0","0","0","0","0","0","0","0","0","-2"
"451671","University of South Florida-Sarasota-Manatee","2011","Total full-time Instruction/research/public service, Tenured total","13","6","7","0","0","0","1","1","0","0","0","0","0","0","0","0","0","0","12","5","7","0","0","0","0","0","0","0","0","0","-2"
"451671","University of South Florida-Sarasota-Manatee","2011","Total full-time Instruction/research/public service, Non-tenured on tenure track, Professors","2","2","0","0","0","0","0","0","0","0","0","0","0","0","0","0","0","0","2","2","0","0","0","0","0","0","0","0","0","0","-2"
"451671","University of South Florida-Sarasota-Manatee","2011","Total full-time Instruction/research/public service, Non-tenured on tenure track, Associate professors","1","0","1","0","0","0","0","0","0","0","0","0","0","0","0","0","0","0","1","0","1","0","0","0","0","0","0","0","0","0","-2"
"451671","University of South Florida-Sarasota-Manatee","2011","Total full-time Instruction/research/public service, Non-tenured on tenure track, Assistant professors","20","9","11","0","0","0","2","1","1","2","1","1","0","0","0","0","0","0","15","7","8","0","0","0","1","0","1","0","0","0","-2"
"451671","University of South Florida-Sarasota-Manatee","2011","Total full-time Instruction/research/public service, Non-tenured on tenure track, Instructors","1","0","1","0","0","0","0","0","0","0","0","0","0","0","0","0","0","0","1","0","1","0","0","0","0","0","0","0","0","0","-2"
"451671","University of South Florida-Sarasota-Manatee","2011","Total full-time Instruction/research/public service, Non-tenured on tenure track total","24","11","13","0","0","0","2","1","1","2","1","1","0","0","0","0","0","0","19","9","10","0","0","0","1","0","1","0","0","0","-2"
"451671","University of South Florida-Sarasota-Manatee","2011","Total full-time Instruction/research/public service, Non-tenured not on tenure track, Instructors","20","9","11","0","0","0","1","0","1","1","0","1","0","0","0","0","0","0","18","9","9","0","0","0","0","0","0","0","0","0","-2"
"451671","University of South Florida-Sarasota-Manatee","2011","Total full-time Instruction/research/public service, Non-tenured not on tenure track total","20","9","11","0","0","0","1","0","1","1","0","1","0","0","0","0","0","0","18","9","9","0","0","0","0","0","0","0","0","0","-2"
"455664","The Chicago School of Professional Psychology at Los Angeles","2011","Total full-time Instruction/research/public service, Non-tenured not on tenure track, Associate professors","9","7","2","0","0","0","1","1","0","1","0","1","1","1","0","0","0","0","6","5","1","0","0","0","0","0","0","0","0","0","-2"
"455664","The Chicago School of Professional Psychology at Los Angeles","2011","Total full-time Instruction/research/public servicey, Non-tenured not on tenure track, Assistant professors","10","5","5","0","0","0","1","1","0","2","0","2","0","0","0","0","0","0","6","4","2","1","0","1","0","0","0","0","0","0","-2"
"455664","The Chicago School of Professional Psychology at Los Angeles","2011","Total full-time Instruction/research/public service, Non-tenured not on tenure track total","19","12","7","0","0","0","2","2","0","3","0","3","1","1","0","0","0","0","12","9","3","1","0","1","0","0","0","0","0","0","-2"
"459824","Touro University Nevada","2011","Total full-time Instruction/research/public service, Non-tenured not on tenure track, Professors","4","4","0","0","0","0","1","1","0","0","0","0","0","0","0","0","0","0","2","2","0","0","0","0","0","0","0","1","1","0","-2"
"459824","Touro University Nevada","2011","Total full-time Instruction/research/public service, Non-tenured not on tenure track, Associate professors","15","8","7","0","0","0","4","2","2","0","0","0","0","0","0","2","1","1","9","5","4","0","0","0","0","0","0","0","0","0","-2"
"459824","Touro University Nevada","2011","Total full-time Instruction/research/public servicey, Non-tenured not on tenure track, Assistant professors","38","17","21","0","0","0","1","0","1","1","0","1","0","0","0","0","0","0","35","17","18","0","0","0","1","0","1","0","0","0","-2"
"459824","Touro University Nevada","2011","Total full-time Instruction/research/public service, Non-tenured not on tenure track, Instructors","3","1","2","0","0","0","0","0","0","0","0","0","0","0","0","0","0","0","3","1","2","0","0","0","0","0","0","0","0","0","-2"
"459824","Touro University Nevada","2011","Total full-time Instruction/research/public service, Non-tenured not on tenure track total","60","30","30","0","0","0","6","3","3","1","0","1","0","0","0","2","1","1","49","25","24","0","0","0","1","0","1","1","1","0","-2"
"459842","Herzing University-Kenosha","2011","Total full-time Instruction/research/public service, Non-tenured not on tenure track, Associate professors","5","3","2","0","0","0","0","0","0","2","1","1","0","0","0","0","0","0","3","2","1","0","0","0","0","0","0","0","0","0","-2"
"459842","Herzing University-Kenosha","2011","Total full-time Instruction/research/public servicey, Non-tenured not on tenure track, Assistant professors","1","0","1","0","0","0","0","0","0","0","0","0","0","0","0","0","0","0","1","0","1","0","0","0","0","0","0","0","0","0","-2"
"459842","Herzing University-Kenosha","2011","Total full-time Instruction/research/public service, Non-tenured not on tenure track, Instructors","5","1","4","0","0","0","0","0","0","0","0","0","2","1","1","0","0","0","2","0","2","0","0","0","1","0","1","0","0","0","-2"
"459842","Herzing University-Kenosha","2011","Total full-time Instruction/research/public service, Non-tenured not on tenure track total","11","4","7","0","0","0","0","0","0","2","1","1","2","1","1","0","0","0","6","2","4","0","0","0","1","0","1","0","0","0","-2"
"460899","Stevens-Henager College","2011","Total full-time Instruction/research/public service, Non-tenured not on tenure track, Instructors","12","4","8","0","0","0","0","0","0","0","0","0","0","0","0","0","0","0","12","4","8","0","0","0","0","0","0","0","0","0","-2"
"460899","Stevens-Henager College","2011","Total full-time Instruction/research/public service, Non-tenured not on tenure track total","12","4","8","0","0","0","0","0","0","0","0","0","0","0","0","0","0","0","12","4","8","0","0","0","0","0","0","0","0","0","-2"
"461795","North American University","2011","Total full-time Instruction/research/public service, Non-tenured not on tenure track, Associate professors","1","1","0","0","0","0","0","0","0","0","0","0","0","0","0","0","0","0","0","0","0","0","0","0","0","0","0","1","1","0","-2"
"461795","North American University","2011","Total full-time Instruction/research/public servicey, Non-tenured not on tenure track, Assistant professors","6","5","1","0","0","0","0","0","0","0","0","0","0","0","0","0","0","0","5","5","0","0","0","0","0","0","0","1","0","1","-2"
"461795","North American University","2011","Total full-time Instruction/research/public service, Non-tenured not on tenure track, Instructors","2","1","1","0","0","0","0","0","0","0","0","0","0","0","0","0","0","0","2","1","1","0","0","0","0","0","0","0","0","0","-2"
"461795","North American University","2011","Total full-time Instruction/research/public service, Non-tenured not on tenure track total","9","7","2","0","0","0","0","0","0","0","0","0","0","0","0","0","0","0","7","6","1","0","0","0","0","0","0","2","1","1","-2"
