"unitid","institution name","year","S2015_IS.Instructional staff category","S2015_IS_RV.Grand total","S2015_IS_RV.Grand total men","S2015_IS_RV.Grand total women","S2015_IS_RV.American Indian or Alaska Native total","S2015_IS_RV.American Indian or Alaska Native men","S2015_IS_RV.American Indian or Alaska Native women","S2015_IS_RV.Asian total","S2015_IS_RV.Asian men","S2015_IS_RV.Asian women","S2015_IS_RV.Black or African American total","S2015_IS_RV.Black or African American men","S2015_IS_RV.Black or African American women","S2015_IS_RV.Hispanic or Latino total","S2015_IS_RV.Hispanic or Latino men","S2015_IS_RV.Hispanic or Latino women","S2015_IS_RV.Native Hawaiian or Other Pacific Islander total","S2015_IS_RV.Native Hawaiian or Other Pacific Islander men","S2015_IS_RV.Native Hawaiian or Other Pacific Islander women","S2015_IS_RV.White total","S2015_IS_RV.White men","S2015_IS_RV.White women","S2015_IS_RV.Two or more races total","S2015_IS_RV.Two or more races men","S2015_IS_RV.Two or more races women","S2015_IS_RV.Race/ethnicity unknown total","S2015_IS_RV.Race/ethnicity unknown men","S2015_IS_RV.Race/ethnicity unknown women","S2015_IS_RV.Nonresident alien total","S2015_IS_RV.Nonresident alien men","S2015_IS_RV.Nonresident alien women","IDX_HR"
"105899","Arizona Christian University","2015","Not on tenure track/No tenure system system total","13","8","5","0","0","0","0","0","0","0","0","0","1","1","0","0","0","0","12","7","5","0","0","0","0","0","0","0","0","0","-2"
"105899","Arizona Christian University","2015","Not on tenure/no tenure system, professors","2","1","1","0","0","0","0","0","0","0","0","0","0","0","0","0","0","0","2","1","1","0","0","0","0","0","0","0","0","0","-2"
"105899","Arizona Christian University","2015","Not on tenure/no tenure system, associate professors","4","2","2","0","0","0","0","0","0","0","0","0","1","1","0","0","0","0","3","1","2","0","0","0","0","0","0","0","0","0","-2"
"105899","Arizona Christian University","2015","Not on tenure/no tenure system, assistant professors","5","3","2","0","0","0","0","0","0","0","0","0","0","0","0","0","0","0","5","3","2","0","0","0","0","0","0","0","0","0","-2"
"105899","Arizona Christian University","2015","Not on tenure/no tenure system, instructors","2","2","0","0","0","0","0","0","0","0","0","0","0","0","0","0","0","0","2","2","0","0","0","0","0","0","0","0","0","0","-2"
"110097","Biola University","2015","Tenured total","105","85","20","0","0","0","8","5","3","1","0","1","6","4","2","1","1","0","88","75","13","0","0","0","0","0","0","1","0","1","-2"
"110097","Biola University","2015","Tenured, professors","64","54","10","0","0","0","2","1","1","0","0","0","4","3","1","1","1","0","56","49","7","0","0","0","0","0","0","1","0","1","-2"
"110097","Biola University","2015","Tenured, associate professors","40","30","10","0","0","0","6","4","2","1","0","1","2","1","1","0","0","0","31","25","6","0","0","0","0","0","0","0","0","0","-2"
"110097","Biola University","2015","Tenured, assistant professors","1","1","0","0","0","0","0","0","0","0","0","0","0","0","0","0","0","0","1","1","0","0","0","0","0","0","0","0","0","0","-2"
"110097","Biola University","2015","On-Tenure track total","92","59","33","0","0","0","16","7","9","4","3","1","6","3","3","0","0","0","62","45","17","0","0","0","3","1","2","1","0","1","-2"
"110097","Biola University","2015","On-tenure track, professors","8","6","2","0","0","0","1","0","1","0","0","0","1","1","0","0","0","0","6","5","1","0","0","0","0","0","0","0","0","0","-2"
"110097","Biola University","2015","On-tenure track, associate professors","50","34","16","0","0","0","8","5","3","2","2","0","3","1","2","0","0","0","35","25","10","0","0","0","2","1","1","0","0","0","-2"
"110097","Biola University","2015","On-tenure track, assistant professors","34","19","15","0","0","0","7","2","5","2","1","1","2","1","1","0","0","0","21","15","6","0","0","0","1","0","1","1","0","1","-2"
"110097","Biola University","2015","Not on tenure track/No tenure system system total","69","33","36","1","0","1","4","1","3","2","2","0","6","2","4","1","1","0","53","27","26","0","0","0","1","0","1","1","0","1","-2"
"110097","Biola University","2015","Not on tenure/no tenure system, professors","1","1","0","0","0","0","0","0","0","0","0","0","0","0","0","0","0","0","1","1","0","0","0","0","0","0","0","0","0","0","-2"
"110097","Biola University","2015","Not on tenure/no tenure system, associate professors","28","13","15","1","0","1","1","1","0","0","0","0","2","0","2","0","0","0","24","12","12","0","0","0","0","0","0","0","0","0","-2"
"110097","Biola University","2015","Not on tenure/no tenure system, assistant professors","28","14","14","0","0","0","1","0","1","2","2","0","3","1","2","1","1","0","20","10","10","0","0","0","1","0","1","0","0","0","-2"
"110097","Biola University","2015","Not on tenure/no tenure system, instructors","12","5","7","0","0","0","2","0","2","0","0","0","1","1","0","0","0","0","8","4","4","0","0","0","0","0","0","1","0","1","-2"
"110316","California Institute of Integral Studies","2015","Not on tenure track/No tenure system system total","66","31","35","0","0","0","9","6","3","2","0","2","5","1","4","0","0","0","46","22","24","1","0","1","1","1","0","2","1","1","110316"
"110316","California Institute of Integral Studies","2015","Not on tenure/no tenure system, professors","30","17","13","0","0","0","1","1","0","0","0","0","1","0","1","0","0","0","27","15","12","0","0","0","0","0","0","1","1","0","110316"
"110316","California Institute of Integral Studies","2015","Not on tenure/no tenure system, associate professors","19","8","11","0","0","0","3","1","2","1","0","1","2","1","1","0","0","0","10","5","5","1","0","1","1","1","0","1","0","1","110316"
"110316","California Institute of Integral Studies","2015","Not on tenure/no tenure system, assistant professors","9","2","7","0","0","0","1","0","1","1","0","1","1","0","1","0","0","0","6","2","4","0","0","0","0","0","0","0","0","0","110316"
"110316","California Institute of Integral Studies","2015","Not on tenure/no tenure system, lecturers","8","4","4","0","0","0","4","4","0","0","0","0","1","0","1","0","0","0","3","0","3","0","0","0","0","0","0","0","0","0","110316"
"110422","California Polytechnic State University-San Luis Obispo","2015","Tenured total","449","319","130","1","1","0","44","28","16","8","5","3","30","22","8","1","1","0","336","240","96","6","5","1","22","17","5","1","0","1","-2"
"110422","California Polytechnic State University-San Luis Obispo","2015","Tenured, professors","276","214","62","1","1","0","27","21","6","5","4","1","17","12","5","1","1","0","204","157","47","4","3","1","17","15","2","0","0","0","-2"
"110422","California Polytechnic State University-San Luis Obispo","2015","Tenured, associate professors","170","103","67","0","0","0","17","7","10","3","1","2","13","10","3","0","0","0","129","81","48","2","2","0","5","2","3","1","0","1","-2"
"110422","California Polytechnic State University-San Luis Obispo","2015","Tenured, no academic rank","3","2","1","0","0","0","0","0","0","0","0","0","0","0","0","0","0","0","3","2","1","0","0","0","0","0","0","0","0","0","-2"
"110422","California Polytechnic State University-San Luis Obispo","2015","On-Tenure track total","187","107","80","2","1","1","15","9","6","2","1","1","7","3","4","0","0","0","133","70","63","1","0","1","11","8","3","16","15","1","-2"
"110422","California Polytechnic State University-San Luis Obispo","2015","On-tenure track, professors","1","1","0","0","0","0","0","0","0","0","0","0","0","0","0","0","0","0","1","1","0","0","0","0","0","0","0","0","0","0","-2"
"110422","California Polytechnic State University-San Luis Obispo","2015","On-tenure track, associate professors","23","17","6","0","0","0","2","2","0","0","0","0","2","1","1","0","0","0","13","9","4","0","0","0","3","2","1","3","3","0","-2"
"110422","California Polytechnic State University-San Luis Obispo","2015","On-tenure track, assistant professors","163","89","74","2","1","1","13","7","6","2","1","1","5","2","3","0","0","0","119","60","59","1","0","1","8","6","2","13","12","1","-2"
"110422","California Polytechnic State University-San Luis Obispo","2015","Not on tenure track/No tenure system system total","187","111","76","0","0","0","3","0","3","0","0","0","3","2","1","0","0","0","157","94","63","1","1","0","13","9","4","10","5","5","-2"
"110422","California Polytechnic State University-San Luis Obispo","2015","Not on tenure/no tenure system, lecturers","187","111","76","0","0","0","3","0","3","0","0","0","3","2","1","0","0","0","157","94","63","1","1","0","13","9","4","10","5","5","-2"
"111188","California State University Maritime Academy","2015","Tenured total","25","20","5","0","0","0","2","0","2","1","1","0","2","1","1","0","0","0","20","18","2","0","0","0","0","0","0","0","0","0","-2"
"111188","California State University Maritime Academy","2015","Tenured, professors","18","14","4","0","0","0","2","0","2","0","0","0","1","1","0","0","0","0","15","13","2","0","0","0","0","0","0","0","0","0","-2"
"111188","California State University Maritime Academy","2015","Tenured, associate professors","6","5","1","0","0","0","0","0","0","1","1","0","1","0","1","0","0","0","4","4","0","0","0","0","0","0","0","0","0","0","-2"
"111188","California State University Maritime Academy","2015","Tenured, assistant professors","1","1","0","0","0","0","0","0","0","0","0","0","0","0","0","0","0","0","1","1","0","0","0","0","0","0","0","0","0","0","-2"
"111188","California State University Maritime Academy","2015","On-Tenure track total","26","19","7","0","0","0","4","4","0","0","0","0","1","1","0","0","0","0","20","13","7","0","0","0","1","1","0","0","0","0","-2"
"111188","California State University Maritime Academy","2015","On-tenure track, professors","1","0","1","0","0","0","0","0","0","0","0","0","0","0","0","0","0","0","1","0","1","0","0","0","0","0","0","0","0","0","-2"
"111188","California State University Maritime Academy","2015","On-tenure track, associate professors","5","4","1","0","0","0","0","0","0","0","0","0","0","0","0","0","0","0","5","4","1","0","0","0","0","0","0","0","0","0","-2"
"111188","California State University Maritime Academy","2015","On-tenure track, assistant professors","20","15","5","0","0","0","4","4","0","0","0","0","1","1","0","0","0","0","14","9","5","0","0","0","1","1","0","0","0","0","-2"
"111188","California State University Maritime Academy","2015","Not on tenure track/No tenure system system total","15","11","4","0","0","0","1","0","1","1","1","0","0","0","0","0","0","0","13","10","3","0","0","0","0","0","0","0","0","0","-2"
"111188","California State University Maritime Academy","2015","Not on tenure/no tenure system, lecturers","15","11","4","0","0","0","1","0","1","1","1","0","0","0","0","0","0","0","13","10","3","0","0","0","0","0","0","0","0","0","-2"
"111948","Chapman University","2015","Tenured total","202","136","66","1","1","0","14","7","7","6","4","2","7","3","4","0","0","0","155","108","47","2","1","1","15","12","3","2","0","2","-2"
"111948","Chapman University","2015","Tenured, professors","112","81","31","0","0","0","8","4","4","3","3","0","2","2","0","0","0","0","87","64","23","0","0","0","11","8","3","1","0","1","-2"
"111948","Chapman University","2015","Tenured, associate professors","90","55","35","1","1","0","6","3","3","3","1","2","5","1","4","0","0","0","68","44","24","2","1","1","4","4","0","1","0","1","-2"
"111948","Chapman University","2015","On-Tenure track total","85","43","42","0","0","0","5","1","4","0","0","0","0","0","0","0","0","0","24","11","13","0","0","0","45","24","21","11","7","4","-2"
"111948","Chapman University","2015","On-tenure track, associate professors","10","8","2","0","0","0","0","0","0","0","0","0","0","0","0","0","0","0","3","2","1","0","0","0","7","6","1","0","0","0","-2"
"111948","Chapman University","2015","On-tenure track, assistant professors","75","35","40","0","0","0","5","1","4","0","0","0","0","0","0","0","0","0","21","9","12","0","0","0","38","18","20","11","7","4","-2"
"111948","Chapman University","2015","Not on tenure track/No tenure system system total","130","68","62","0","0","0","6","2","4","3","1","2","5","2","3","0","0","0","70","41","29","0","0","0","43","22","21","3","0","3","-2"
"111948","Chapman University","2015","Not on tenure/no tenure system, professors","18","12","6","0","0","0","0","0","0","0","0","0","0","0","0","0","0","0","14","9","5","0","0","0","4","3","1","0","0","0","-2"
"111948","Chapman University","2015","Not on tenure/no tenure system, associate professors","26","17","9","0","0","0","0","0","0","1","1","0","1","0","1","0","0","0","19","12","7","0","0","0","5","4","1","0","0","0","-2"
"111948","Chapman University","2015","Not on tenure/no tenure system, assistant professors","57","28","29","0","0","0","2","1","1","1","0","1","2","0","2","0","0","0","23","14","9","0","0","0","27","13","14","2","0","2","-2"
"111948","Chapman University","2015","Not on tenure/no tenure system, instructors","29","11","18","0","0","0","4","1","3","1","0","1","2","2","0","0","0","0","14","6","8","0","0","0","7","2","5","1","0","1","-2"
"112260","Claremont McKenna College","2015","Tenured total","106","76","30","0","0","0","10","5","5","2","1","1","4","4","0","0","0","0","86","65","21","1","0","1","1","1","0","2","0","2","-2"
"112260","Claremont McKenna College","2015","Tenured, professors","61","46","15","0","0","0","4","3","1","2","1","1","3","3","0","0","0","0","51","39","12","0","0","0","0","0","0","1","0","1","-2"
"112260","Claremont McKenna College","2015","Tenured, associate professors","44","29","15","0","0","0","6","2","4","0","0","0","1","1","0","0","0","0","34","25","9","1","0","1","1","1","0","1","0","1","-2"
"112260","Claremont McKenna College","2015","Tenured, lecturers","1","1","0","0","0","0","0","0","0","0","0","0","0","0","0","0","0","0","1","1","0","0","0","0","0","0","0","0","0","0","-2"
"112260","Claremont McKenna College","2015","On-Tenure track total","27","15","12","0","0","0","4","2","2","0","0","0","1","0","1","0","0","0","19","11","8","0","0","0","0","0","0","3","2","1","-2"
"112260","Claremont McKenna College","2015","On-tenure track, associate professors","1","0","1","0","0","0","0","0","0","0","0","0","0","0","0","0","0","0","1","0","1","0","0","0","0","0","0","0","0","0","-2"
"112260","Claremont McKenna College","2015","On-tenure track, assistant professors","26","15","11","0","0","0","4","2","2","0","0","0","1","0","1","0","0","0","18","11","7","0","0","0","0","0","0","3","2","1","-2"
"112260","Claremont McKenna College","2015","Not on tenure track/No tenure system system total","35","26","9","0","0","0","4","3","1","0","0","0","4","2","2","0","0","0","23","17","6","0","0","0","3","3","0","1","1","0","-2"
"112260","Claremont McKenna College","2015","Not on tenure/no tenure system, professors","1","1","0","0","0","0","0","0","0","0","0","0","0","0","0","0","0","0","1","1","0","0","0","0","0","0","0","0","0","0","-2"
"112260","Claremont McKenna College","2015","Not on tenure/no tenure system, associate professors","4","2","2","0","0","0","0","0","0","0","0","0","1","0","1","0","0","0","3","2","1","0","0","0","0","0","0","0","0","0","-2"
"112260","Claremont McKenna College","2015","Not on tenure/no tenure system, assistant professors","29","23","6","0","0","0","4","3","1","0","0","0","2","2","0","0","0","0","19","14","5","0","0","0","3","3","0","1","1","0","-2"
"112260","Claremont McKenna College","2015","Not on tenure/no tenure system, instructors","1","0","1","0","0","0","0","0","0","0","0","0","1","0","1","0","0","0","0","0","0","0","0","0","0","0","0","0","0","0","-2"
"115083","Golden Gate University-San Francisco","2015","Tenured total","33","23","10","0","0","0","5","3","2","2","2","0","0","0","0","0","0","0","26","18","8","0","0","0","0","0","0","0","0","0","-2"
"115083","Golden Gate University-San Francisco","2015","Tenured, professors","33","23","10","0","0","0","5","3","2","2","2","0","0","0","0","0","0","0","26","18","8","0","0","0","0","0","0","0","0","0","-2"
"115083","Golden Gate University-San Francisco","2015","On-Tenure track total","6","1","5","0","0","0","1","0","1","1","0","1","1","0","1","0","0","0","3","1","2","0","0","0","0","0","0","0","0","0","-2"
"115083","Golden Gate University-San Francisco","2015","On-tenure track, professors","6","1","5","0","0","0","1","0","1","1","0","1","1","0","1","0","0","0","3","1","2","0","0","0","0","0","0","0","0","0","-2"
"115083","Golden Gate University-San Francisco","2015","Not on tenure track/No tenure system system total","30","17","13","0","0","0","1","1","0","3","2","1","0","0","0","0","0","0","26","14","12","0","0","0","0","0","0","0","0","0","-2"
"115083","Golden Gate University-San Francisco","2015","Not on tenure/no tenure system, professors","5","3","2","0","0","0","1","1","0","0","0","0","0","0","0","0","0","0","4","2","2","0","0","0","0","0","0","0","0","0","-2"
"115083","Golden Gate University-San Francisco","2015","Not on tenure/no tenure system, associate professors","8","6","2","0","0","0","0","0","0","0","0","0","0","0","0","0","0","0","8","6","2","0","0","0","0","0","0","0","0","0","-2"
"115083","Golden Gate University-San Francisco","2015","Not on tenure/no tenure system, assistant professors","8","4","4","0","0","0","0","0","0","0","0","0","0","0","0","0","0","0","8","4","4","0","0","0","0","0","0","0","0","0","-2"
"115083","Golden Gate University-San Francisco","2015","Not on tenure/no tenure system, instructors","5","2","3","0","0","0","0","0","0","2","1","1","0","0","0","0","0","0","3","1","2","0","0","0","0","0","0","0","0","0","-2"
"115083","Golden Gate University-San Francisco","2015","Not on tenure/no tenure system, no academic rank","4","2","2","0","0","0","0","0","0","1","1","0","0","0","0","0","0","0","3","1","2","0","0","0","0","0","0","0","0","0","-2"
"115409","Harvey Mudd College","2015","Tenured total","66","42","24","0","0","0","9","4","5","2","1","1","3","2","1","0","0","0","52","35","17","0","0","0","0","0","0","0","0","0","-2"
"115409","Harvey Mudd College","2015","Tenured, professors","49","37","12","0","0","0","6","4","2","1","1","0","3","2","1","0","0","0","39","30","9","0","0","0","0","0","0","0","0","0","-2"
"115409","Harvey Mudd College","2015","Tenured, associate professors","17","5","12","0","0","0","3","0","3","1","0","1","0","0","0","0","0","0","13","5","8","0","0","0","0","0","0","0","0","0","-2"
"115409","Harvey Mudd College","2015","On-Tenure track total","20","11","9","0","0","0","2","2","0","0","0","0","1","1","0","0","0","0","15","7","8","1","0","1","0","0","0","1","1","0","-2"
"115409","Harvey Mudd College","2015","On-tenure track, associate professors","3","2","1","0","0","0","0","0","0","0","0","0","0","0","0","0","0","0","3","2","1","0","0","0","0","0","0","0","0","0","-2"
"115409","Harvey Mudd College","2015","On-tenure track, assistant professors","17","9","8","0","0","0","2","2","0","0","0","0","1","1","0","0","0","0","12","5","7","1","0","1","0","0","0","1","1","0","-2"
"115409","Harvey Mudd College","2015","Not on tenure track/No tenure system system total","10","4","6","0","0","0","4","2","2","0","0","0","1","1","0","1","0","1","4","1","3","0","0","0","0","0","0","0","0","0","-2"
"115409","Harvey Mudd College","2015","Not on tenure/no tenure system, professors","2","2","0","0","0","0","2","2","0","0","0","0","0","0","0","0","0","0","0","0","0","0","0","0","0","0","0","0","0","0","-2"
"115409","Harvey Mudd College","2015","Not on tenure/no tenure system, assistant professors","8","2","6","0","0","0","2","0","2","0","0","0","1","1","0","1","0","1","4","1","3","0","0","0","0","0","0","0","0","0","-2"
"117168","Laguna College of Art and Design","2015","Not on tenure track/No tenure system system total","19","15","4","0","0","0","1","1","0","0","0","0","0","0","0","0","0","0","18","14","4","0","0","0","0","0","0","0","0","0","-2"
"117168","Laguna College of Art and Design","2015","Not on tenure/no tenure system, professors","5","3","2","0","0","0","0","0","0","0","0","0","0","0","0","0","0","0","5","3","2","0","0","0","0","0","0","0","0","0","-2"
"117168","Laguna College of Art and Design","2015","Not on tenure/no tenure system, associate professors","8","7","1","0","0","0","1","1","0","0","0","0","0","0","0","0","0","0","7","6","1","0","0","0","0","0","0","0","0","0","-2"
"117168","Laguna College of Art and Design","2015","Not on tenure/no tenure system, assistant professors","6","5","1","0","0","0","0","0","0","0","0","0","0","0","0","0","0","0","6","5","1","0","0","0","0","0","0","0","0","0","-2"
"117575","Southern California Seminary","2015","Not on tenure track/No tenure system system total","7","5","2","0","0","0","2","2","0","1","0","1","0","0","0","0","0","0","4","3","1","0","0","0","0","0","0","0","0","0","-2"
"117575","Southern California Seminary","2015","Not on tenure/no tenure system, professors","7","5","2","0","0","0","2","2","0","1","0","1","0","0","0","0","0","0","4","3","1","0","0","0","0","0","0","0","0","0","-2"
"117946","Loyola Marymount University","2015","Tenured total","362","219","143","1","0","1","35","23","12","16","13","3","42","19","23","0","0","0","245","150","95","5","2","3","18","12","6","0","0","0","-2"
"117946","Loyola Marymount University","2015","Tenured, professors","217","149","68","0","0","0","17","13","4","10","7","3","22","9","13","0","0","0","151","109","42","2","1","1","15","10","5","0","0","0","-2"
"117946","Loyola Marymount University","2015","Tenured, associate professors","139","65","74","1","0","1","17","9","8","6","6","0","19","9","10","0","0","0","91","39","52","2","0","2","3","2","1","0","0","0","-2"
"117946","Loyola Marymount University","2015","Tenured, assistant professors","6","5","1","0","0","0","1","1","0","0","0","0","1","1","0","0","0","0","3","2","1","1","1","0","0","0","0","0","0","0","-2"
"117946","Loyola Marymount University","2015","On-Tenure track total","71","34","37","0","0","0","11","3","8","7","2","5","8","3","5","0","0","0","39","24","15","0","0","0","2","1","1","4","1","3","-2"
"117946","Loyola Marymount University","2015","On-tenure track, associate professors","6","3","3","0","0","0","1","1","0","1","0","1","1","0","1","0","0","0","3","2","1","0","0","0","0","0","0","0","0","0","-2"
"117946","Loyola Marymount University","2015","On-tenure track, assistant professors","65","31","34","0","0","0","10","2","8","6","2","4","7","3","4","0","0","0","36","22","14","0","0","0","2","1","1","4","1","3","-2"
"117946","Loyola Marymount University","2015","Not on tenure track/No tenure system system total","128","57","71","0","0","0","16","3","13","8","4","4","12","6","6","0","0","0","85","40","45","3","2","1","3","2","1","1","0","1","-2"
"117946","Loyola Marymount University","2015","Not on tenure/no tenure system, professors","6","5","1","0","0","0","1","1","0","0","0","0","0","0","0","0","0","0","5","4","1","0","0","0","0","0","0","0","0","0","-2"
"117946","Loyola Marymount University","2015","Not on tenure/no tenure system, associate professors","33","9","24","0","0","0","3","0","3","1","0","1","3","1","2","0","0","0","25","7","18","0","0","0","1","1","0","0","0","0","-2"
"117946","Loyola Marymount University","2015","Not on tenure/no tenure system, assistant professors","73","34","39","0","0","0","11","2","9","6","4","2","6","2","4","0","0","0","44","23","21","3","2","1","2","1","1","1","0","1","-2"
"117946","Loyola Marymount University","2015","Not on tenure/no tenure system, instructors","15","9","6","0","0","0","1","0","1","0","0","0","3","3","0","0","0","0","11","6","5","0","0","0","0","0","0","0","0","0","-2"
"117946","Loyola Marymount University","2015","Not on tenure/no tenure system, no academic rank","1","0","1","0","0","0","0","0","0","1","0","1","0","0","0","0","0","0","0","0","0","0","0","0","0","0","0","0","0","0","-2"
"120403","Otis College of Art and Design","2015","Not on tenure track/No tenure system system total","57","25","32","0","0","0","4","1","3","2","0","2","5","3","2","0","0","0","44","21","23","0","0","0","2","0","2","0","0","0","-2"
"120403","Otis College of Art and Design","2015","Not on tenure/no tenure system, professors","21","11","10","0","0","0","3","0","3","0","0","0","0","0","0","0","0","0","18","11","7","0","0","0","0","0","0","0","0","0","-2"
"120403","Otis College of Art and Design","2015","Not on tenure/no tenure system, associate professors","27","10","17","0","0","0","0","0","0","1","0","1","3","3","0","0","0","0","21","7","14","0","0","0","2","0","2","0","0","0","-2"
"120403","Otis College of Art and Design","2015","Not on tenure/no tenure system, assistant professors","9","4","5","0","0","0","1","1","0","1","0","1","2","0","2","0","0","0","5","3","2","0","0","0","0","0","0","0","0","0","-2"
"120698","Palo Alto University","2015","Tenured total","14","7","7","0","0","0","2","0","2","1","1","0","2","1","1","0","0","0","9","5","4","0","0","0","0","0","0","0","0","0","-2"
"120698","Palo Alto University","2015","Tenured, professors","9","6","3","0","0","0","0","0","0","1","1","0","1","1","0","0","0","0","7","4","3","0","0","0","0","0","0","0","0","0","-2"
"120698","Palo Alto University","2015","Tenured, associate professors","5","1","4","0","0","0","2","0","2","0","0","0","1","0","1","0","0","0","2","1","1","0","0","0","0","0","0","0","0","0","-2"
"120698","Palo Alto University","2015","On-Tenure track total","8","3","5","0","0","0","0","0","0","1","1","0","0","0","0","0","0","0","7","2","5","0","0","0","0","0","0","0","0","0","-2"
"120698","Palo Alto University","2015","On-tenure track, associate professors","1","1","0","0","0","0","0","0","0","0","0","0","0","0","0","0","0","0","1","1","0","0","0","0","0","0","0","0","0","0","-2"
"120698","Palo Alto University","2015","On-tenure track, assistant professors","7","2","5","0","0","0","0","0","0","1","1","0","0","0","0","0","0","0","6","1","5","0","0","0","0","0","0","0","0","0","-2"
"120698","Palo Alto University","2015","Not on tenure track/No tenure system system total","13","5","8","0","0","0","0","0","0","1","0","1","0","0","0","0","0","0","10","4","6","1","0","1","0","0","0","1","1","0","-2"
"120698","Palo Alto University","2015","Not on tenure/no tenure system, professors","3","1","2","0","0","0","0","0","0","0","0","0","0","0","0","0","0","0","3","1","2","0","0","0","0","0","0","0","0","0","-2"
"120698","Palo Alto University","2015","Not on tenure/no tenure system, associate professors","4","3","1","0","0","0","0","0","0","0","0","0","0","0","0","0","0","0","3","2","1","0","0","0","0","0","0","1","1","0","-2"
"120698","Palo Alto University","2015","Not on tenure/no tenure system, assistant professors","6","1","5","0","0","0","0","0","0","1","0","1","0","0","0","0","0","0","4","1","3","1","0","1","0","0","0","0","0","0","-2"
"120883","University of the Pacific","2015","Tenured total","253","152","101","0","0","0","36","23","13","5","3","2","9","6","3","0","0","0","192","116","76","1","0","1","0","0","0","10","4","6","-2"
"120883","University of the Pacific","2015","Tenured, professors","118","83","35","0","0","0","18","14","4","3","3","0","7","5","2","0","0","0","84","58","26","0","0","0","0","0","0","6","3","3","-2"
"120883","University of the Pacific","2015","Tenured, associate professors","130","66","64","0","0","0","18","9","9","2","0","2","2","1","1","0","0","0","104","55","49","0","0","0","0","0","0","4","1","3","-2"
"120883","University of the Pacific","2015","Tenured, assistant professors","5","3","2","0","0","0","0","0","0","0","0","0","0","0","0","0","0","0","4","3","1","1","0","1","0","0","0","0","0","0","-2"
"120883","University of the Pacific","2015","On-Tenure track total","76","40","36","0","0","0","21","6","15","0","0","0","4","1","3","0","0","0","46","31","15","1","0","1","0","0","0","4","2","2","-2"
"120883","University of the Pacific","2015","On-tenure track, professors","3","2","1","0","0","0","0","0","0","0","0","0","0","0","0","0","0","0","3","2","1","0","0","0","0","0","0","0","0","0","-2"
"120883","University of the Pacific","2015","On-tenure track, associate professors","6","4","2","0","0","0","1","0","1","0","0","0","0","0","0","0","0","0","5","4","1","0","0","0","0","0","0","0","0","0","-2"
"120883","University of the Pacific","2015","On-tenure track, assistant professors","63","33","30","0","0","0","17","6","11","0","0","0","4","1","3","0","0","0","37","24","13","1","0","1","0","0","0","4","2","2","-2"
"120883","University of the Pacific","2015","On-tenure track, instructors","3","0","3","0","0","0","3","0","3","0","0","0","0","0","0","0","0","0","0","0","0","0","0","0","0","0","0","0","0","0","-2"
"120883","University of the Pacific","2015","On-tenure track, lecturers","1","1","0","0","0","0","0","0","0","0","0","0","0","0","0","0","0","0","1","1","0","0","0","0","0","0","0","0","0","0","-2"
"120883","University of the Pacific","2015","Not on tenure track/No tenure system system total","100","47","53","0","0","0","15","7","8","2","0","2","6","2","4","0","0","0","74","36","38","0","0","0","0","0","0","3","2","1","-2"
"120883","University of the Pacific","2015","Not on tenure/no tenure system, professors","6","5","1","0","0","0","1","0","1","0","0","0","0","0","0","0","0","0","5","5","0","0","0","0","0","0","0","0","0","0","-2"
"120883","University of the Pacific","2015","Not on tenure/no tenure system, associate professors","13","7","6","0","0","0","1","1","0","0","0","0","1","0","1","0","0","0","11","6","5","0","0","0","0","0","0","0","0","0","-2"
"120883","University of the Pacific","2015","Not on tenure/no tenure system, assistant professors","46","20","26","0","0","0","9","4","5","2","0","2","4","2","2","0","0","0","29","13","16","0","0","0","0","0","0","2","1","1","-2"
"120883","University of the Pacific","2015","Not on tenure/no tenure system, instructors","13","4","9","0","0","0","1","0","1","0","0","0","0","0","0","0","0","0","12","4","8","0","0","0","0","0","0","0","0","0","-2"
"120883","University of the Pacific","2015","Not on tenure/no tenure system, lecturers","22","11","11","0","0","0","3","2","1","0","0","0","1","0","1","0","0","0","17","8","9","0","0","0","0","0","0","1","1","0","-2"
"121309","Point Loma Nazarene University","2015","Tenured total","72","50","22","0","0","0","4","2","2","2","2","0","4","1","3","0","0","0","62","45","17","0","0","0","0","0","0","0","0","0","-2"
"121309","Point Loma Nazarene University","2015","Tenured, professors","72","50","22","0","0","0","4","2","2","2","2","0","4","1","3","0","0","0","62","45","17","0","0","0","0","0","0","0","0","0","-2"
"121309","Point Loma Nazarene University","2015","On-Tenure track total","62","25","37","1","0","1","6","2","4","2","0","2","3","1","2","0","0","0","50","22","28","0","0","0","0","0","0","0","0","0","-2"
"121309","Point Loma Nazarene University","2015","On-tenure track, professors","6","2","4","0","0","0","0","0","0","1","0","1","1","0","1","0","0","0","4","2","2","0","0","0","0","0","0","0","0","0","-2"
"121309","Point Loma Nazarene University","2015","On-tenure track, associate professors","32","15","17","0","0","0","4","1","3","1","0","1","2","1","1","0","0","0","25","13","12","0","0","0","0","0","0","0","0","0","-2"
"121309","Point Loma Nazarene University","2015","On-tenure track, assistant professors","24","8","16","1","0","1","2","1","1","0","0","0","0","0","0","0","0","0","21","7","14","0","0","0","0","0","0","0","0","0","-2"
"121309","Point Loma Nazarene University","2015","Not on tenure track/No tenure system system total","2","1","1","0","0","0","0","0","0","0","0","0","0","0","0","0","0","0","2","1","1","0","0","0","0","0","0","0","0","0","-2"
"121309","Point Loma Nazarene University","2015","Not on tenure/no tenure system, professors","1","0","1","0","0","0","0","0","0","0","0","0","0","0","0","0","0","0","1","0","1","0","0","0","0","0","0","0","0","0","-2"
"121309","Point Loma Nazarene University","2015","Not on tenure/no tenure system, assistant professors","1","1","0","0","0","0","0","0","0","0","0","0","0","0","0","0","0","0","1","1","0","0","0","0","0","0","0","0","0","0","-2"
"121345","Pomona College","2015","Tenured total","149","87","62","0","0","0","21","8","13","4","3","1","18","12","6","0","0","0","86","50","36","3","3","0","17","11","6","0","0","0","-2"
"121345","Pomona College","2015","Tenured, professors","75","45","30","0","0","0","11","3","8","2","1","1","10","6","4","0","0","0","45","29","16","1","1","0","6","5","1","0","0","0","-2"
"121345","Pomona College","2015","Tenured, associate professors","74","42","32","0","0","0","10","5","5","2","2","0","8","6","2","0","0","0","41","21","20","2","2","0","11","6","5","0","0","0","-2"
"121345","Pomona College","2015","On-Tenure track total","29","17","12","0","0","0","5","3","2","3","1","2","0","0","0","0","0","0","13","9","4","0","0","0","5","2","3","3","2","1","-2"
"121345","Pomona College","2015","On-tenure track, assistant professors","29","17","12","0","0","0","5","3","2","3","1","2","0","0","0","0","0","0","13","9","4","0","0","0","5","2","3","3","2","1","-2"
"121345","Pomona College","2015","Not on tenure track/No tenure system system total","3","0","3","0","0","0","1","0","1","0","0","0","2","0","2","0","0","0","0","0","0","0","0","0","0","0","0","0","0","0","-2"
"121345","Pomona College","2015","Not on tenure/no tenure system, professors","3","0","3","0","0","0","1","0","1","0","0","0","2","0","2","0","0","0","0","0","0","0","0","0","0","0","0","0","0","0","-2"
"122296","Samuel Merritt University","2015","Not on tenure track/No tenure system system total","140","39","101","0","0","0","11","3","8","7","0","7","6","1","5","0","0","0","112","35","77","4","0","4","0","0","0","0","0","0","-2"
"122296","Samuel Merritt University","2015","Not on tenure/no tenure system, professors","19","12","7","0","0","0","2","1","1","0","0","0","1","1","0","0","0","0","16","10","6","0","0","0","0","0","0","0","0","0","-2"
"122296","Samuel Merritt University","2015","Not on tenure/no tenure system, associate professors","23","3","20","0","0","0","2","0","2","1","0","1","1","0","1","0","0","0","18","3","15","1","0","1","0","0","0","0","0","0","-2"
"122296","Samuel Merritt University","2015","Not on tenure/no tenure system, assistant professors","79","21","58","0","0","0","7","2","5","3","0","3","3","0","3","0","0","0","64","19","45","2","0","2","0","0","0","0","0","0","-2"
"122296","Samuel Merritt University","2015","Not on tenure/no tenure system, instructors","19","3","16","0","0","0","0","0","0","3","0","3","1","0","1","0","0","0","14","3","11","1","0","1","0","0","0","0","0","0","-2"
"122436","University of San Diego","2015","Tenured total","264","154","110","1","0","1","22","11","11","7","6","1","18","7","11","0","0","0","213","128","85","2","2","0","0","0","0","1","0","1","-2"
"122436","University of San Diego","2015","Tenured, professors","156","99","57","0","0","0","10","5","5","3","3","0","7","4","3","0","0","0","134","86","48","1","1","0","0","0","0","1","0","1","-2"
"122436","University of San Diego","2015","Tenured, associate professors","107","55","52","1","0","1","12","6","6","4","3","1","11","3","8","0","0","0","78","42","36","1","1","0","0","0","0","0","0","0","-2"
"122436","University of San Diego","2015","Tenured, assistant professors","1","0","1","0","0","0","0","0","0","0","0","0","0","0","0","0","0","0","1","0","1","0","0","0","0","0","0","0","0","0","-2"
"122436","University of San Diego","2015","On-Tenure track total","100","43","57","0","0","0","13","4","9","4","2","2","11","7","4","0","0","0","64","27","37","2","0","2","0","0","0","6","3","3","-2"
"122436","University of San Diego","2015","On-tenure track, professors","1","1","0","0","0","0","0","0","0","0","0","0","0","0","0","0","0","0","1","1","0","0","0","0","0","0","0","0","0","0","-2"
"122436","University of San Diego","2015","On-tenure track, associate professors","24","6","18","0","0","0","2","0","2","0","0","0","1","1","0","0","0","0","20","4","16","0","0","0","0","0","0","1","1","0","-2"
"122436","University of San Diego","2015","On-tenure track, assistant professors","74","35","39","0","0","0","11","4","7","4","2","2","10","6","4","0","0","0","42","21","21","2","0","2","0","0","0","5","2","3","-2"
"122436","University of San Diego","2015","On-tenure track, instructors","1","1","0","0","0","0","0","0","0","0","0","0","0","0","0","0","0","0","1","1","0","0","0","0","0","0","0","0","0","0","-2"
"122436","University of San Diego","2015","Not on tenure track/No tenure system system total","63","30","33","1","1","0","5","3","2","1","1","0","3","1","2","0","0","0","52","23","29","0","0","0","0","0","0","1","1","0","-2"
"122436","University of San Diego","2015","Not on tenure/no tenure system, professors","17","7","10","0","0","0","0","0","0","0","0","0","2","1","1","0","0","0","14","5","9","0","0","0","0","0","0","1","1","0","-2"
"122436","University of San Diego","2015","Not on tenure/no tenure system, associate professors","7","4","3","1","1","0","0","0","0","1","1","0","0","0","0","0","0","0","5","2","3","0","0","0","0","0","0","0","0","0","-2"
"122436","University of San Diego","2015","Not on tenure/no tenure system, assistant professors","20","10","10","0","0","0","3","2","1","0","0","0","0","0","0","0","0","0","17","8","9","0","0","0","0","0","0","0","0","0","-2"
"122436","University of San Diego","2015","Not on tenure/no tenure system, instructors","19","9","10","0","0","0","2","1","1","0","0","0","1","0","1","0","0","0","16","8","8","0","0","0","0","0","0","0","0","0","-2"
"122454","San Francisco Art Institute","2015","Tenured total","16","10","6","0","0","0","1","1","0","1","1","0","1","1","0","0","0","0","13","7","6","0","0","0","0","0","0","0","0","0","-2"
"122454","San Francisco Art Institute","2015","Tenured, professors","4","3","1","0","0","0","1","1","0","0","0","0","1","1","0","0","0","0","2","1","1","0","0","0","0","0","0","0","0","0","-2"
"122454","San Francisco Art Institute","2015","Tenured, associate professors","12","7","5","0","0","0","0","0","0","1","1","0","0","0","0","0","0","0","11","6","5","0","0","0","0","0","0","0","0","0","-2"
"122454","San Francisco Art Institute","2015","On-Tenure track total","7","2","5","0","0","0","2","0","2","0","0","0","1","0","1","0","0","0","3","1","2","0","0","0","0","0","0","1","1","0","-2"
"122454","San Francisco Art Institute","2015","On-tenure track, assistant professors","7","2","5","0","0","0","2","0","2","0","0","0","1","0","1","0","0","0","3","1","2","0","0","0","0","0","0","1","1","0","-2"
"122454","San Francisco Art Institute","2015","Not on tenure track/No tenure system system total","1","0","1","0","0","0","0","0","0","1","0","1","0","0","0","0","0","0","0","0","0","0","0","0","0","0","0","0","0","0","-2"
"122454","San Francisco Art Institute","2015","Not on tenure/no tenure system, no academic rank","1","0","1","0","0","0","0","0","0","1","0","1","0","0","0","0","0","0","0","0","0","0","0","0","0","0","0","0","0","0","-2"
"122612","University of San Francisco","2015","Tenured total","238","129","109","0","0","0","31","15","16","11","3","8","23","16","7","1","1","0","144","81","63","8","6","2","19","7","12","1","0","1","-2"
"122612","University of San Francisco","2015","Tenured, professors","133","84","49","0","0","0","12","7","5","3","1","2","11","9","2","1","1","0","88","55","33","7","5","2","11","6","5","0","0","0","-2"
"122612","University of San Francisco","2015","Tenured, associate professors","104","44","60","0","0","0","19","8","11","8","2","6","12","7","5","0","0","0","56","26","30","1","1","0","7","0","7","1","0","1","-2"
"122612","University of San Francisco","2015","Tenured, assistant professors","1","1","0","0","0","0","0","0","0","0","0","0","0","0","0","0","0","0","0","0","0","0","0","0","1","1","0","0","0","0","-2"
"122612","University of San Francisco","2015","On-Tenure track total","113","51","62","2","0","2","14","8","6","9","6","3","13","5","8","0","0","0","58","23","35","1","0","1","7","4","3","9","5","4","-2"
"122612","University of San Francisco","2015","On-tenure track, professors","2","1","1","0","0","0","0","0","0","0","0","0","0","0","0","0","0","0","2","1","1","0","0","0","0","0","0","0","0","0","-2"
"122612","University of San Francisco","2015","On-tenure track, associate professors","17","11","6","0","0","0","3","1","2","2","2","0","3","3","0","0","0","0","7","3","4","0","0","0","1","1","0","1","1","0","-2"
"122612","University of San Francisco","2015","On-tenure track, assistant professors","94","39","55","2","0","2","11","7","4","7","4","3","10","2","8","0","0","0","49","19","30","1","0","1","6","3","3","8","4","4","-2"
"122612","University of San Francisco","2015","Not on tenure track/No tenure system system total","142","65","77","0","0","0","22","9","13","4","0","4","15","5","10","0","0","0","81","43","38","10","4","6","6","3","3","4","1","3","-2"
"122612","University of San Francisco","2015","Not on tenure/no tenure system, professors","8","7","1","0","0","0","0","0","0","0","0","0","0","0","0","0","0","0","7","6","1","1","1","0","0","0","0","0","0","0","-2"
"122612","University of San Francisco","2015","Not on tenure/no tenure system, associate professors","19","8","11","0","0","0","2","1","1","2","0","2","2","1","1","0","0","0","10","5","5","0","0","0","2","1","1","1","0","1","-2"
"122612","University of San Francisco","2015","Not on tenure/no tenure system, assistant professors","93","40","53","0","0","0","17","7","10","2","0","2","11","4","7","0","0","0","50","24","26","6","2","4","4","2","2","3","1","2","-2"
"122612","University of San Francisco","2015","Not on tenure/no tenure system, instructors","22","10","12","0","0","0","3","1","2","0","0","0","2","0","2","0","0","0","14","8","6","3","1","2","0","0","0","0","0","0","-2"
"122728","William Jessup University","2015","Tenured total","3","1","2","0","0","0","0","0","0","0","0","0","0","0","0","0","0","0","3","1","2","0","0","0","0","0","0","0","0","0","-2"
"122728","William Jessup University","2015","Tenured, professors","3","1","2","0","0","0","0","0","0","0","0","0","0","0","0","0","0","0","3","1","2","0","0","0","0","0","0","0","0","0","-2"
"122728","William Jessup University","2015","On-Tenure track total","33","24","9","1","1","0","1","1","0","2","1","1","4","3","1","0","0","0","25","18","7","0","0","0","0","0","0","0","0","0","-2"
"122728","William Jessup University","2015","On-tenure track, professors","4","4","0","0","0","0","0","0","0","0","0","0","0","0","0","0","0","0","4","4","0","0","0","0","0","0","0","0","0","0","-2"
"122728","William Jessup University","2015","On-tenure track, associate professors","15","10","5","1","1","0","1","1","0","1","0","1","3","3","0","0","0","0","9","5","4","0","0","0","0","0","0","0","0","0","-2"
"122728","William Jessup University","2015","On-tenure track, assistant professors","14","10","4","0","0","0","0","0","0","1","1","0","1","0","1","0","0","0","12","9","3","0","0","0","0","0","0","0","0","0","-2"
"122931","Santa Clara University","2015","Tenured total","293","183","110","0","0","0","37","21","16","7","3","4","21","13","8","0","0","0","225","144","81","1","1","0","2","1","1","0","0","0","-2"
"122931","Santa Clara University","2015","Tenured, professors","153","102","51","0","0","0","15","12","3","2","2","0","8","7","1","0","0","0","127","80","47","1","1","0","0","0","0","0","0","0","-2"
"122931","Santa Clara University","2015","Tenured, associate professors","140","81","59","0","0","0","22","9","13","5","1","4","13","6","7","0","0","0","98","64","34","0","0","0","2","1","1","0","0","0","-2"
"122931","Santa Clara University","2015","On-Tenure track total","91","52","39","0","0","0","25","15","10","3","3","0","9","5","4","1","1","0","45","23","22","2","1","1","0","0","0","6","4","2","-2"
"122931","Santa Clara University","2015","On-tenure track, associate professors","3","3","0","0","0","0","1","1","0","0","0","0","0","0","0","0","0","0","2","2","0","0","0","0","0","0","0","0","0","0","-2"
"122931","Santa Clara University","2015","On-tenure track, assistant professors","88","49","39","0","0","0","24","14","10","3","3","0","9","5","4","1","1","0","43","21","22","2","1","1","0","0","0","6","4","2","-2"
"122931","Santa Clara University","2015","Not on tenure track/No tenure system system total","152","57","95","0","0","0","16","6","10","5","2","3","14","3","11","0","0","0","111","45","66","2","0","2","4","1","3","0","0","0","-2"
"122931","Santa Clara University","2015","Not on tenure/no tenure system, lecturers","147","52","95","0","0","0","16","6","10","5","2","3","14","3","11","0","0","0","106","40","66","2","0","2","4","1","3","0","0","0","-2"
"122931","Santa Clara University","2015","Not on tenure/no tenure system, no academic rank","5","5","0","0","0","0","0","0","0","0","0","0","0","0","0","0","0","0","5","5","0","0","0","0","0","0","0","0","0","0","-2"
"123299","Shasta College","2015","Tenured total","78","46","32","1","1","0","2","2","0","2","0","2","3","2","1","0","0","0","70","41","29","0","0","0","0","0","0","0","0","0","-2"
"123299","Shasta College","2015","Tenured, instructors","78","46","32","1","1","0","2","2","0","2","0","2","3","2","1","0","0","0","70","41","29","0","0","0","0","0","0","0","0","0","-2"
"123299","Shasta College","2015","On-Tenure track total","39","20","19","0","0","0","0","0","0","0","0","0","3","2","1","1","1","0","32","16","16","0","0","0","3","1","2","0","0","0","-2"
"123299","Shasta College","2015","On-tenure track, instructors","39","20","19","0","0","0","0","0","0","0","0","0","3","2","1","1","1","0","32","16","16","0","0","0","3","1","2","0","0","0","-2"
"123299","Shasta College","2015","Not on tenure track/No tenure system system total","13","7","6","0","0","0","1","1","0","1","1","0","2","1","1","0","0","0","9","4","5","0","0","0","0","0","0","0","0","0","-2"
"123299","Shasta College","2015","Not on tenure/no tenure system, instructors","13","7","6","0","0","0","1","1","0","1","1","0","2","1","1","0","0","0","9","4","5","0","0","0","0","0","0","0","0","0","-2"
"123457","Simpson University","2015","Not on tenure track/No tenure system system total","51","31","20","1","1","0","2","1","1","0","0","0","1","1","0","0","0","0","43","24","19","4","4","0","0","0","0","0","0","0","-2"
"123457","Simpson University","2015","Not on tenure/no tenure system, professors","6","6","0","0","0","0","0","0","0","0","0","0","0","0","0","0","0","0","5","5","0","1","1","0","0","0","0","0","0","0","-2"
"123457","Simpson University","2015","Not on tenure/no tenure system, associate professors","14","9","5","1","1","0","0","0","0","0","0","0","0","0","0","0","0","0","12","7","5","1","1","0","0","0","0","0","0","0","-2"
"123457","Simpson University","2015","Not on tenure/no tenure system, assistant professors","27","14","13","0","0","0","2","1","1","0","0","0","1","1","0","0","0","0","23","11","12","1","1","0","0","0","0","0","0","0","-2"
"123457","Simpson University","2015","Not on tenure/no tenure system, instructors","4","2","2","0","0","0","0","0","0","0","0","0","0","0","0","0","0","0","3","1","2","1","1","0","0","0","0","0","0","0","-2"
"124292","Thomas Aquinas College","2015","Not on tenure track/No tenure system system total","33","29","4","0","0","0","0","0","0","0","0","0","2","2","0","0","0","0","27","24","3","1","1","0","3","2","1","0","0","0","-2"
"124292","Thomas Aquinas College","2015","Not on tenure/no tenure system, professors","15","13","2","0","0","0","0","0","0","0","0","0","1","1","0","0","0","0","14","12","2","0","0","0","0","0","0","0","0","0","-2"
"124292","Thomas Aquinas College","2015","Not on tenure/no tenure system, associate professors","10","10","0","0","0","0","0","0","0","0","0","0","1","1","0","0","0","0","8","8","0","1","1","0","0","0","0","0","0","0","-2"
"124292","Thomas Aquinas College","2015","Not on tenure/no tenure system, assistant professors","8","6","2","0","0","0","0","0","0","0","0","0","0","0","0","0","0","0","5","4","1","0","0","0","3","2","1","0","0","0","-2"
"125727","Westmont College","2015","Tenured total","60","41","19","0","0","0","3","2","1","0","0","0","3","1","2","0","0","0","54","38","16","0","0","0","0","0","0","0","0","0","-2"
"125727","Westmont College","2015","Tenured, professors","43","33","10","0","0","0","2","2","0","0","0","0","2","1","1","0","0","0","39","30","9","0","0","0","0","0","0","0","0","0","-2"
"125727","Westmont College","2015","Tenured, associate professors","16","7","9","0","0","0","1","0","1","0","0","0","1","0","1","0","0","0","14","7","7","0","0","0","0","0","0","0","0","0","-2"
"125727","Westmont College","2015","Tenured, assistant professors","1","1","0","0","0","0","0","0","0","0","0","0","0","0","0","0","0","0","1","1","0","0","0","0","0","0","0","0","0","0","-2"
"125727","Westmont College","2015","On-Tenure track total","17","7","10","1","0","1","4","3","1","0","0","0","0","0","0","0","0","0","11","4","7","1","0","1","0","0","0","0","0","0","-2"
"125727","Westmont College","2015","On-tenure track, professors","1","1","0","0","0","0","0","0","0","0","0","0","0","0","0","0","0","0","1","1","0","0","0","0","0","0","0","0","0","0","-2"
"125727","Westmont College","2015","On-tenure track, associate professors","3","1","2","0","0","0","1","0","1","0","0","0","0","0","0","0","0","0","2","1","1","0","0","0","0","0","0","0","0","0","-2"
"125727","Westmont College","2015","On-tenure track, assistant professors","13","5","8","1","0","1","3","3","0","0","0","0","0","0","0","0","0","0","8","2","6","1","0","1","0","0","0","0","0","0","-2"
"125727","Westmont College","2015","Not on tenure track/No tenure system system total","16","8","8","1","0","1","0","0","0","0","0","0","2","2","0","0","0","0","13","6","7","0","0","0","0","0","0","0","0","0","-2"
"125727","Westmont College","2015","Not on tenure/no tenure system, professors","1","1","0","0","0","0","0","0","0","0","0","0","1","1","0","0","0","0","0","0","0","0","0","0","0","0","0","0","0","0","-2"
"125727","Westmont College","2015","Not on tenure/no tenure system, associate professors","4","2","2","0","0","0","0","0","0","0","0","0","0","0","0","0","0","0","4","2","2","0","0","0","0","0","0","0","0","0","-2"
"125727","Westmont College","2015","Not on tenure/no tenure system, assistant professors","5","2","3","0","0","0","0","0","0","0","0","0","0","0","0","0","0","0","5","2","3","0","0","0","0","0","0","0","0","0","-2"
"125727","Westmont College","2015","Not on tenure/no tenure system, instructors","5","2","3","1","0","1","0","0","0","0","0","0","1","1","0","0","0","0","3","1","2","0","0","0","0","0","0","0","0","0","-2"
"125727","Westmont College","2015","Not on tenure/no tenure system, no academic rank","1","1","0","0","0","0","0","0","0","0","0","0","0","0","0","0","0","0","1","1","0","0","0","0","0","0","0","0","0","0","-2"
"126580","University of Colorado Colorado Springs","2015","Tenured total","159","96","63","1","0","1","9","6","3","2","0","2","10","6","4","0","0","0","133","83","50","0","0","0","4","1","3","0","0","0","-2"
"126580","University of Colorado Colorado Springs","2015","Tenured, professors","79","62","17","0","0","0","5","5","0","0","0","0","3","2","1","0","0","0","70","54","16","0","0","0","1","1","0","0","0","0","-2"
"126580","University of Colorado Colorado Springs","2015","Tenured, associate professors","80","34","46","1","0","1","4","1","3","2","0","2","7","4","3","0","0","0","63","29","34","0","0","0","3","0","3","0","0","0","-2"
"126580","University of Colorado Colorado Springs","2015","On-Tenure track total","80","40","40","0","0","0","12","6","6","1","1","0","0","0","0","0","0","0","63","30","33","0","0","0","4","3","1","0","0","0","-2"
"126580","University of Colorado Colorado Springs","2015","On-tenure track, assistant professors","80","40","40","0","0","0","12","6","6","1","1","0","0","0","0","0","0","0","63","30","33","0","0","0","4","3","1","0","0","0","-2"
"126580","University of Colorado Colorado Springs","2015","Not on tenure track/No tenure system system total","167","58","109","2","0","2","4","1","3","2","0","2","8","4","4","0","0","0","143","51","92","0","0","0","8","2","6","0","0","0","-2"
"126580","University of Colorado Colorado Springs","2015","Not on tenure/no tenure system, instructors","164","57","107","2","0","2","4","1","3","2","0","2","8","4","4","0","0","0","140","50","90","0","0","0","8","2","6","0","0","0","-2"
"126580","University of Colorado Colorado Springs","2015","Not on tenure/no tenure system, no academic rank","3","1","2","0","0","0","0","0","0","0","0","0","0","0","0","0","0","0","3","1","2","0","0","0","0","0","0","0","0","0","-2"
"127200","Front Range Community College","2015","Tenured total","194","84","110","1","0","1","4","2","2","3","1","2","8","3","5","0","0","0","177","78","99","0","0","0","1","0","1","0","0","0","-2"
"127200","Front Range Community College","2015","Tenured, professors","194","84","110","1","0","1","4","2","2","3","1","2","8","3","5","0","0","0","177","78","99","0","0","0","1","0","1","0","0","0","-2"
"127200","Front Range Community College","2015","On-Tenure track total","35","13","22","0","0","0","3","1","2","0","0","0","2","0","2","0","0","0","30","12","18","0","0","0","0","0","0","0","0","0","-2"
"127200","Front Range Community College","2015","On-tenure track, professors","35","13","22","0","0","0","3","1","2","0","0","0","2","0","2","0","0","0","30","12","18","0","0","0","0","0","0","0","0","0","-2"
"127200","Front Range Community College","2015","Not on tenure track/No tenure system system total","12","6","6","0","0","0","1","0","1","0","0","0","2","2","0","0","0","0","9","4","5","0","0","0","0","0","0","0","0","0","-2"
"127200","Front Range Community College","2015","Not on tenure/no tenure system, professors","12","6","6","0","0","0","1","0","1","0","0","0","2","2","0","0","0","0","9","4","5","0","0","0","0","0","0","0","0","0","-2"
"127556","Colorado Mesa University","2015","Tenured total","82","51","31","0","0","0","2","2","0","0","0","0","1","1","0","0","0","0","66","40","26","0","0","0","11","7","4","2","1","1","-2"
"127556","Colorado Mesa University","2015","Tenured, professors","57","33","24","0","0","0","1","1","0","0","0","0","1","1","0","0","0","0","44","24","20","0","0","0","10","7","3","1","0","1","-2"
"127556","Colorado Mesa University","2015","Tenured, associate professors","22","16","6","0","0","0","1","1","0","0","0","0","0","0","0","0","0","0","19","14","5","0","0","0","1","0","1","1","1","0","-2"
"127556","Colorado Mesa University","2015","Tenured, assistant professors","1","1","0","0","0","0","0","0","0","0","0","0","0","0","0","0","0","0","1","1","0","0","0","0","0","0","0","0","0","0","-2"
"127556","Colorado Mesa University","2015","Tenured, instructors","2","1","1","0","0","0","0","0","0","0","0","0","0","0","0","0","0","0","2","1","1","0","0","0","0","0","0","0","0","0","-2"
"127556","Colorado Mesa University","2015","On-Tenure track total","92","49","43","0","0","0","1","1","0","0","0","0","2","1","1","0","0","0","71","35","36","1","0","1","10","9","1","7","3","4","-2"
"127556","Colorado Mesa University","2015","On-tenure track, professors","2","2","0","0","0","0","0","0","0","0","0","0","0","0","0","0","0","0","1","1","0","0","0","0","1","1","0","0","0","0","-2"
"127556","Colorado Mesa University","2015","On-tenure track, associate professors","5","3","2","0","0","0","0","0","0","0","0","0","0","0","0","0","0","0","4","2","2","0","0","0","1","1","0","0","0","0","-2"
"127556","Colorado Mesa University","2015","On-tenure track, assistant professors","84","43","41","0","0","0","1","1","0","0","0","0","2","1","1","0","0","0","65","31","34","1","0","1","8","7","1","7","3","4","-2"
"127556","Colorado Mesa University","2015","On-tenure track, instructors","1","1","0","0","0","0","0","0","0","0","0","0","0","0","0","0","0","0","1","1","0","0","0","0","0","0","0","0","0","0","-2"
"127556","Colorado Mesa University","2015","Not on tenure track/No tenure system system total","92","45","47","0","0","0","0","0","0","0","0","0","2","1","1","0","0","0","75","37","38","0","0","0","12","7","5","3","0","3","-2"
"127556","Colorado Mesa University","2015","Not on tenure/no tenure system, associate professors","1","0","1","0","0","0","0","0","0","0","0","0","0","0","0","0","0","0","1","0","1","0","0","0","0","0","0","0","0","0","-2"
"127556","Colorado Mesa University","2015","Not on tenure/no tenure system, assistant professors","1","0","1","0","0","0","0","0","0","0","0","0","0","0","0","0","0","0","1","0","1","0","0","0","0","0","0","0","0","0","-2"
"127556","Colorado Mesa University","2015","Not on tenure/no tenure system, instructors","80","43","37","0","0","0","0","0","0","0","0","0","2","1","1","0","0","0","65","36","29","0","0","0","10","6","4","3","0","3","-2"
"127556","Colorado Mesa University","2015","Not on tenure/no tenure system, lecturers","9","1","8","0","0","0","0","0","0","0","0","0","0","0","0","0","0","0","7","0","7","0","0","0","2","1","1","0","0","0","-2"
"127556","Colorado Mesa University","2015","Not on tenure/no tenure system, no academic rank","1","1","0","0","0","0","0","0","0","0","0","0","0","0","0","0","0","0","1","1","0","0","0","0","0","0","0","0","0","0","-2"
"127820","Pikes Peak Community College","2015","Not on tenure track/No tenure system system total","168","62","106","0","0","0","5","3","2","5","1","4","4","3","1","0","0","0","132","48","84","0","0","0","22","7","15","0","0","0","-2"
"127820","Pikes Peak Community College","2015","Not on tenure/no tenure system, no academic rank","168","62","106","0","0","0","5","3","2","5","1","4","4","3","1","0","0","0","132","48","84","0","0","0","22","7","15","0","0","0","-2"
"127909","Red Rocks Community College","2015","Not on tenure track/No tenure system system total","101","41","60","0","0","0","1","1","0","0","0","0","1","0","1","0","0","0","92","38","54","4","1","3","2","0","2","1","1","0","-2"
"127909","Red Rocks Community College","2015","Not on tenure/no tenure system, instructors","101","41","60","0","0","0","1","1","0","0","0","0","1","0","1","0","0","0","92","38","54","4","1","3","2","0","2","1","1","0","-2"
"127918","Regis University","2015","Tenured total","66","34","32","0","0","0","1","1","0","1","1","0","7","2","5","0","0","0","57","30","27","0","0","0","0","0","0","0","0","0","-2"
"127918","Regis University","2015","Tenured, professors","22","15","7","0","0","0","1","1","0","0","0","0","2","1","1","0","0","0","19","13","6","0","0","0","0","0","0","0","0","0","-2"
"127918","Regis University","2015","Tenured, associate professors","44","19","25","0","0","0","0","0","0","1","1","0","5","1","4","0","0","0","38","17","21","0","0","0","0","0","0","0","0","0","-2"
"127918","Regis University","2015","On-Tenure track total","30","14","16","0","0","0","3","1","2","1","1","0","2","0","2","0","0","0","24","12","12","0","0","0","0","0","0","0","0","0","-2"
"127918","Regis University","2015","On-tenure track, associate professors","1","1","0","0","0","0","0","0","0","0","0","0","0","0","0","0","0","0","1","1","0","0","0","0","0","0","0","0","0","0","-2"
"127918","Regis University","2015","On-tenure track, assistant professors","29","13","16","0","0","0","3","1","2","1","1","0","2","0","2","0","0","0","23","11","12","0","0","0","0","0","0","0","0","0","-2"
"127918","Regis University","2015","Not on tenure track/No tenure system system total","184","65","119","0","0","0","5","1","4","6","3","3","6","4","2","0","0","0","164","56","108","2","0","2","1","1","0","0","0","0","-2"
"127918","Regis University","2015","Not on tenure/no tenure system, professors","37","15","22","0","0","0","1","1","0","2","1","1","1","1","0","0","0","0","32","12","20","1","0","1","0","0","0","0","0","0","-2"
"127918","Regis University","2015","Not on tenure/no tenure system, associate professors","63","17","46","0","0","0","2","0","2","3","2","1","1","1","0","0","0","0","57","14","43","0","0","0","0","0","0","0","0","0","-2"
"127918","Regis University","2015","Not on tenure/no tenure system, assistant professors","54","24","30","0","0","0","1","0","1","0","0","0","2","1","1","0","0","0","51","23","28","0","0","0","0","0","0","0","0","0","-2"
"127918","Regis University","2015","Not on tenure/no tenure system, instructors","25","9","16","0","0","0","1","0","1","1","0","1","1","1","0","0","0","0","21","7","14","0","0","0","1","1","0","0","0","0","-2"
"127918","Regis University","2015","Not on tenure/no tenure system, no academic rank","5","0","5","0","0","0","0","0","0","0","0","0","1","0","1","0","0","0","3","0","3","1","0","1","0","0","0","0","0","0","-2"
"128391","Western Colorado University","2015","Tenured total","54","35","19","0","0","0","1","0","1","0","0","0","1","0","1","0","0","0","49","33","16","0","0","0","3","2","1","0","0","0","-2"
"128391","Western Colorado University","2015","Tenured, professors","41","27","14","0","0","0","1","0","1","0","0","0","1","0","1","0","0","0","38","27","11","0","0","0","1","0","1","0","0","0","-2"
"128391","Western Colorado University","2015","Tenured, associate professors","13","8","5","0","0","0","0","0","0","0","0","0","0","0","0","0","0","0","11","6","5","0","0","0","2","2","0","0","0","0","-2"
"128391","Western Colorado University","2015","On-Tenure track total","27","17","10","0","0","0","0","0","0","0","0","0","1","1","0","0","0","0","24","16","8","0","0","0","2","0","2","0","0","0","-2"
"128391","Western Colorado University","2015","On-tenure track, assistant professors","27","17","10","0","0","0","0","0","0","0","0","0","1","1","0","0","0","0","24","16","8","0","0","0","2","0","2","0","0","0","-2"
"128391","Western Colorado University","2015","Not on tenure track/No tenure system system total","36","18","18","0","0","0","2","0","2","0","0","0","1","1","0","0","0","0","33","17","16","0","0","0","0","0","0","0","0","0","-2"
"128391","Western Colorado University","2015","Not on tenure/no tenure system, lecturers","36","18","18","0","0","0","2","0","2","0","0","0","1","1","0","0","0","0","33","17","16","0","0","0","0","0","0","0","0","0","-2"
"128498","Albertus Magnus College","2015","Tenured total","9","5","4","0","0","0","0","0","0","0","0","0","0","0","0","0","0","0","2","0","2","0","0","0","7","5","2","0","0","0","-2"
"128498","Albertus Magnus College","2015","Tenured, professors","8","4","4","0","0","0","0","0","0","0","0","0","0","0","0","0","0","0","2","0","2","0","0","0","6","4","2","0","0","0","-2"
"128498","Albertus Magnus College","2015","Tenured, associate professors","1","1","0","0","0","0","0","0","0","0","0","0","0","0","0","0","0","0","0","0","0","0","0","0","1","1","0","0","0","0","-2"
"128498","Albertus Magnus College","2015","Not on tenure track/No tenure system system total","35","20","15","0","0","0","0","0","0","0","0","0","0","0","0","0","0","0","10","6","4","0","0","0","25","14","11","0","0","0","-2"
"128498","Albertus Magnus College","2015","Not on tenure/no tenure system, professors","4","3","1","0","0","0","0","0","0","0","0","0","0","0","0","0","0","0","1","1","0","0","0","0","3","2","1","0","0","0","-2"
"128498","Albertus Magnus College","2015","Not on tenure/no tenure system, associate professors","18","9","9","0","0","0","0","0","0","0","0","0","0","0","0","0","0","0","4","3","1","0","0","0","14","6","8","0","0","0","-2"
"128498","Albertus Magnus College","2015","Not on tenure/no tenure system, assistant professors","10","7","3","0","0","0","0","0","0","0","0","0","0","0","0","0","0","0","3","2","1","0","0","0","7","5","2","0","0","0","-2"
"128498","Albertus Magnus College","2015","Not on tenure/no tenure system, instructors","1","0","1","0","0","0","0","0","0","0","0","0","0","0","0","0","0","0","1","0","1","0","0","0","0","0","0","0","0","0","-2"
"128498","Albertus Magnus College","2015","Not on tenure/no tenure system, lecturers","2","1","1","0","0","0","0","0","0","0","0","0","0","0","0","0","0","0","1","0","1","0","0","0","1","1","0","0","0","0","-2"
"128771","Central Connecticut State University","2015","Tenured total","313","188","125","2","2","0","23","16","7","19","11","8","17","12","5","0","0","0","249","145","104","3","2","1","0","0","0","0","0","0","-2"
"128771","Central Connecticut State University","2015","Tenured, professors","191","120","71","2","2","0","16","10","6","13","8","5","13","10","3","0","0","0","145","89","56","2","1","1","0","0","0","0","0","0","-2"
"128771","Central Connecticut State University","2015","Tenured, associate professors","113","64","49","0","0","0","7","6","1","5","3","2","4","2","2","0","0","0","96","52","44","1","1","0","0","0","0","0","0","0","-2"
"128771","Central Connecticut State University","2015","Tenured, assistant professors","9","4","5","0","0","0","0","0","0","1","0","1","0","0","0","0","0","0","8","4","4","0","0","0","0","0","0","0","0","0","-2"
"128771","Central Connecticut State University","2015","On-Tenure track total","105","61","44","0","0","0","13","9","4","5","2","3","6","1","5","0","0","0","57","31","26","2","2","0","0","0","0","22","16","6","-2"
"128771","Central Connecticut State University","2015","On-tenure track, associate professors","23","17","6","0","0","0","7","6","1","1","1","0","0","0","0","0","0","0","8","5","3","0","0","0","0","0","0","7","5","2","-2"
"128771","Central Connecticut State University","2015","On-tenure track, assistant professors","78","40","38","0","0","0","6","3","3","4","1","3","6","1","5","0","0","0","47","24","23","2","2","0","0","0","0","13","9","4","-2"
"128771","Central Connecticut State University","2015","On-tenure track, instructors","4","4","0","0","0","0","0","0","0","0","0","0","0","0","0","0","0","0","2","2","0","0","0","0","0","0","0","2","2","0","-2"
"128771","Central Connecticut State University","2015","Not on tenure track/No tenure system system total","32","12","20","0","0","0","1","1","0","0","0","0","1","1","0","0","0","0","28","9","19","1","1","0","0","0","0","1","0","1","-2"
"128771","Central Connecticut State University","2015","Not on tenure/no tenure system, associate professors","3","1","2","0","0","0","0","0","0","0","0","0","0","0","0","0","0","0","3","1","2","0","0","0","0","0","0","0","0","0","-2"
"128771","Central Connecticut State University","2015","Not on tenure/no tenure system, assistant professors","22","10","12","0","0","0","1","1","0","0","0","0","1","1","0","0","0","0","18","7","11","1","1","0","0","0","0","1","0","1","-2"
"128771","Central Connecticut State University","2015","Not on tenure/no tenure system, instructors","7","1","6","0","0","0","0","0","0","0","0","0","0","0","0","0","0","0","7","1","6","0","0","0","0","0","0","0","0","0","-2"
"129154","Goodwin University","2015","Not on tenure track/No tenure system system total","90","22","68","2","0","2","1","0","1","8","1","7","5","1","4","0","0","0","74","20","54","0","0","0","0","0","0","0","0","0","-2"
"129154","Goodwin University","2015","Not on tenure/no tenure system, associate professors","24","5","19","2","0","2","1","0","1","0","0","0","0","0","0","0","0","0","21","5","16","0","0","0","0","0","0","0","0","0","-2"
"129154","Goodwin University","2015","Not on tenure/no tenure system, assistant professors","41","16","25","0","0","0","0","0","0","7","1","6","4","1","3","0","0","0","30","14","16","0","0","0","0","0","0","0","0","0","-2"
"129154","Goodwin University","2015","Not on tenure/no tenure system, instructors","25","1","24","0","0","0","0","0","0","1","0","1","1","0","1","0","0","0","23","1","22","0","0","0","0","0","0","0","0","0","-2"
"129774","Mitchell College","2015","Tenured total","3","2","1","0","0","0","0","0","0","0","0","0","0","0","0","0","0","0","3","2","1","0","0","0","0","0","0","0","0","0","-2"
"129774","Mitchell College","2015","Tenured, associate professors","2","1","1","0","0","0","0","0","0","0","0","0","0","0","0","0","0","0","2","1","1","0","0","0","0","0","0","0","0","0","-2"
"129774","Mitchell College","2015","Tenured, assistant professors","1","1","0","0","0","0","0","0","0","0","0","0","0","0","0","0","0","0","1","1","0","0","0","0","0","0","0","0","0","0","-2"
"129774","Mitchell College","2015","Not on tenure track/No tenure system system total","20","10","10","0","0","0","0","0","0","0","0","0","0","0","0","0","0","0","20","10","10","0","0","0","0","0","0","0","0","0","-2"
"129774","Mitchell College","2015","Not on tenure/no tenure system, professors","3","1","2","0","0","0","0","0","0","0","0","0","0","0","0","0","0","0","3","1","2","0","0","0","0","0","0","0","0","0","-2"
"129774","Mitchell College","2015","Not on tenure/no tenure system, associate professors","8","3","5","0","0","0","0","0","0","0","0","0","0","0","0","0","0","0","8","3","5","0","0","0","0","0","0","0","0","0","-2"
"129774","Mitchell College","2015","Not on tenure/no tenure system, assistant professors","8","5","3","0","0","0","0","0","0","0","0","0","0","0","0","0","0","0","8","5","3","0","0","0","0","0","0","0","0","0","-2"
"129774","Mitchell College","2015","Not on tenure/no tenure system, instructors","1","1","0","0","0","0","0","0","0","0","0","0","0","0","0","0","0","0","1","1","0","0","0","0","0","0","0","0","0","0","-2"
"132657","Lynn University","2015","Not on tenure track/No tenure system system total","102","58","44","2","1","1","1","0","1","0","0","0","2","2","0","0","0","0","77","46","31","0","0","0","19","8","11","1","1","0","-2"
"132657","Lynn University","2015","Not on tenure/no tenure system, professors","21","11","10","1","0","1","0","0","0","0","0","0","1","1","0","0","0","0","17","9","8","0","0","0","2","1","1","0","0","0","-2"
"132657","Lynn University","2015","Not on tenure/no tenure system, associate professors","25","15","10","0","0","0","0","0","0","0","0","0","0","0","0","0","0","0","22","13","9","0","0","0","2","1","1","1","1","0","-2"
"132657","Lynn University","2015","Not on tenure/no tenure system, assistant professors","48","25","23","1","1","0","1","0","1","0","0","0","0","0","0","0","0","0","34","20","14","0","0","0","12","4","8","0","0","0","-2"
"132657","Lynn University","2015","Not on tenure/no tenure system, instructors","5","4","1","0","0","0","0","0","0","0","0","0","0","0","0","0","0","0","3","3","0","0","0","0","2","1","1","0","0","0","-2"
"132657","Lynn University","2015","Not on tenure/no tenure system, no academic rank","3","3","0","0","0","0","0","0","0","0","0","0","1","1","0","0","0","0","1","1","0","0","0","0","1","1","0","0","0","0","-2"
"132693","Eastern Florida State College","2015","Tenured total","195","80","115","0","0","0","10","6","4","17","7","10","4","1","3","0","0","0","159","63","96","5","3","2","0","0","0","0","0","0","-2"
"132693","Eastern Florida State College","2015","Tenured, professors","48","24","24","0","0","0","5","3","2","2","1","1","2","1","1","0","0","0","36","16","20","3","3","0","0","0","0","0","0","0","-2"
"132693","Eastern Florida State College","2015","Tenured, associate professors","47","17","30","0","0","0","2","1","1","5","2","3","1","0","1","0","0","0","39","14","25","0","0","0","0","0","0","0","0","0","-2"
"132693","Eastern Florida State College","2015","Tenured, assistant professors","52","18","34","0","0","0","2","1","1","4","2","2","1","0","1","0","0","0","44","15","29","1","0","1","0","0","0","0","0","0","-2"
"132693","Eastern Florida State College","2015","Tenured, instructors","48","21","27","0","0","0","1","1","0","6","2","4","0","0","0","0","0","0","40","18","22","1","0","1","0","0","0","0","0","0","-2"
"132693","Eastern Florida State College","2015","On-Tenure track total","55","20","35","0","0","0","1","0","1","2","1","1","3","0","3","0","0","0","46","17","29","2","1","1","1","1","0","0","0","0","-2"
"132693","Eastern Florida State College","2015","On-tenure track, associate professors","1","1","0","0","0","0","0","0","0","0","0","0","0","0","0","0","0","0","1","1","0","0","0","0","0","0","0","0","0","0","-2"
"132693","Eastern Florida State College","2015","On-tenure track, assistant professors","1","1","0","0","0","0","0","0","0","0","0","0","0","0","0","0","0","0","1","1","0","0","0","0","0","0","0","0","0","0","-2"
"132693","Eastern Florida State College","2015","On-tenure track, instructors","53","18","35","0","0","0","1","0","1","2","1","1","3","0","3","0","0","0","44","15","29","2","1","1","1","1","0","0","0","0","-2"
"132693","Eastern Florida State College","2015","Not on tenure track/No tenure system system total","5","3","2","1","1","0","0","0","0","0","0","0","0","0","0","0","0","0","4","2","2","0","0","0","0","0","0","0","0","0","-2"
"132693","Eastern Florida State College","2015","Not on tenure/no tenure system, instructors","5","3","2","1","1","0","0","0","0","0","0","0","0","0","0","0","0","0","4","2","2","0","0","0","0","0","0","0","0","0","-2"
"132879","Johnson University Florida","2015","Not on tenure track/No tenure system system total","15","8","7","0","0","0","1","0","1","0","0","0","0","0","0","0","0","0","14","8","6","0","0","0","0","0","0","0","0","0","-2"
"132879","Johnson University Florida","2015","Not on tenure/no tenure system, professors","10","6","4","0","0","0","1","0","1","0","0","0","0","0","0","0","0","0","9","6","3","0","0","0","0","0","0","0","0","0","-2"
"132879","Johnson University Florida","2015","Not on tenure/no tenure system, associate professors","2","1","1","0","0","0","0","0","0","0","0","0","0","0","0","0","0","0","2","1","1","0","0","0","0","0","0","0","0","0","-2"
"132879","Johnson University Florida","2015","Not on tenure/no tenure system, assistant professors","3","1","2","0","0","0","0","0","0","0","0","0","0","0","0","0","0","0","3","1","2","0","0","0","0","0","0","0","0","0","-2"
"133386","Daytona State College","2015","Tenured total","239","122","117","1","0","1","7","6","1","19","9","10","9","6","3","0","0","0","201","99","102","0","0","0","0","0","0","2","2","0","-2"
"133386","Daytona State College","2015","Tenured, professors","122","60","62","1","0","1","6","5","1","8","2","6","5","3","2","0","0","0","101","49","52","0","0","0","0","0","0","1","1","0","-2"
"133386","Daytona State College","2015","Tenured, associate professors","87","44","43","0","0","0","1","1","0","8","6","2","3","2","1","0","0","0","74","34","40","0","0","0","0","0","0","1","1","0","-2"
"133386","Daytona State College","2015","Tenured, assistant professors","29","17","12","0","0","0","0","0","0","3","1","2","1","1","0","0","0","0","25","15","10","0","0","0","0","0","0","0","0","0","-2"
"133386","Daytona State College","2015","Tenured, instructors","1","1","0","0","0","0","0","0","0","0","0","0","0","0","0","0","0","0","1","1","0","0","0","0","0","0","0","0","0","0","-2"
"133386","Daytona State College","2015","On-Tenure track total","42","14","28","0","0","0","0","0","0","4","0","4","3","0","3","0","0","0","34","14","20","0","0","0","0","0","0","1","0","1","-2"
"133386","Daytona State College","2015","On-tenure track, associate professors","10","3","7","0","0","0","0","0","0","1","0","1","0","0","0","0","0","0","8","3","5","0","0","0","0","0","0","1","0","1","-2"
"133386","Daytona State College","2015","On-tenure track, assistant professors","23","4","19","0","0","0","0","0","0","3","0","3","3","0","3","0","0","0","17","4","13","0","0","0","0","0","0","0","0","0","-2"
"133386","Daytona State College","2015","On-tenure track, instructors","9","7","2","0","0","0","0","0","0","0","0","0","0","0","0","0","0","0","9","7","2","0","0","0","0","0","0","0","0","0","-2"
"134130","University of Florida","2015","Tenured total","1533","1138","395","0","0","0","189","150","39","45","26","19","86","65","21","0","0","0","1194","882","312","16","13","3","2","2","0","1","0","1","-2"
"134130","University of Florida","2015","Tenured, professors","971","767","204","0","0","0","115","99","16","19","12","7","43","37","6","0","0","0","784","611","173","8","6","2","2","2","0","0","0","0","-2"
"134130","University of Florida","2015","Tenured, associate professors","558","367","191","0","0","0","74","51","23","26","14","12","43","28","15","0","0","0","406","267","139","8","7","1","0","0","0","1","0","1","-2"
"134130","University of Florida","2015","Tenured, assistant professors","4","4","0","0","0","0","0","0","0","0","0","0","0","0","0","0","0","0","4","4","0","0","0","0","0","0","0","0","0","0","-2"
"134130","University of Florida","2015","On-Tenure track total","448","265","183","0","0","0","72","43","29","14","4","10","31","23","8","0","0","0","276","156","120","9","6","3","3","1","2","43","32","11","-2"
"134130","University of Florida","2015","On-tenure track, professors","34","25","9","0","0","0","7","4","3","0","0","0","0","0","0","0","0","0","23","17","6","0","0","0","0","0","0","4","4","0","-2"
"134130","University of Florida","2015","On-tenure track, associate professors","71","48","23","0","0","0","12","9","3","5","2","3","7","5","2","0","0","0","40","25","15","1","1","0","1","1","0","5","5","0","-2"
"134130","University of Florida","2015","On-tenure track, assistant professors","343","192","151","0","0","0","53","30","23","9","2","7","24","18","6","0","0","0","213","114","99","8","5","3","2","0","2","34","23","11","-2"
"134130","University of Florida","2015","Not on tenure track/No tenure system system total","490","218","272","1","0","1","40","15","25","31","13","18","33","13","20","2","2","0","349","154","195","3","2","1","7","5","2","24","14","10","-2"
"134130","University of Florida","2015","Not on tenure/no tenure system, professors","14","7","7","0","0","0","2","1","1","2","0","2","1","0","1","0","0","0","8","5","3","0","0","0","0","0","0","1","1","0","-2"
"134130","University of Florida","2015","Not on tenure/no tenure system, associate professors","12","10","2","0","0","0","2","1","1","0","0","0","0","0","0","1","1","0","7","6","1","0","0","0","1","1","0","1","1","0","-2"
"134130","University of Florida","2015","Not on tenure/no tenure system, assistant professors","33","17","16","0","0","0","1","1","0","1","1","0","2","1","1","0","0","0","20","7","13","1","1","0","1","1","0","7","5","2","-2"
"134130","University of Florida","2015","Not on tenure/no tenure system, lecturers","295","122","173","1","0","1","23","5","18","21","8","13","24","11","13","1","1","0","209","88","121","1","1","0","5","3","2","10","5","5","-2"
"134130","University of Florida","2015","Not on tenure/no tenure system, no academic rank","136","62","74","0","0","0","12","7","5","7","4","3","6","1","5","0","0","0","105","48","57","1","0","1","0","0","0","5","2","3","-2"
"135188","Lake-Sumter State College","2015","Tenured total","19","5","14","0","0","0","0","0","0","1","0","1","0","0","0","0","0","0","18","5","13","0","0","0","0","0","0","0","0","0","-2"
"135188","Lake-Sumter State College","2015","Tenured, professors","4","1","3","0","0","0","0","0","0","0","0","0","0","0","0","0","0","0","4","1","3","0","0","0","0","0","0","0","0","0","-2"
"135188","Lake-Sumter State College","2015","Tenured, associate professors","6","2","4","0","0","0","0","0","0","0","0","0","0","0","0","0","0","0","6","2","4","0","0","0","0","0","0","0","0","0","-2"
"135188","Lake-Sumter State College","2015","Tenured, assistant professors","5","2","3","0","0","0","0","0","0","1","0","1","0","0","0","0","0","0","4","2","2","0","0","0","0","0","0","0","0","0","-2"
"135188","Lake-Sumter State College","2015","Tenured, instructors","4","0","4","0","0","0","0","0","0","0","0","0","0","0","0","0","0","0","4","0","4","0","0","0","0","0","0","0","0","0","-2"
"135188","Lake-Sumter State College","2015","On-Tenure track total","57","20","37","2","1","1","0","0","0","5","2","3","1","1","0","0","0","0","46","15","31","0","0","0","3","1","2","0","0","0","-2"
"135188","Lake-Sumter State College","2015","On-tenure track, assistant professors","7","1","6","0","0","0","0","0","0","1","0","1","0","0","0","0","0","0","6","1","5","0","0","0","0","0","0","0","0","0","-2"
"135188","Lake-Sumter State College","2015","On-tenure track, instructors","47","18","29","2","1","1","0","0","0","4","2","2","1","1","0","0","0","0","37","13","24","0","0","0","3","1","2","0","0","0","-2"
"135188","Lake-Sumter State College","2015","On-tenure track, no academic rank","3","1","2","0","0","0","0","0","0","0","0","0","0","0","0","0","0","0","3","1","2","0","0","0","0","0","0","0","0","0","-2"
"135188","Lake-Sumter State College","2015","Not on tenure track/No tenure system system total","8","4","4","0","0","0","0","0","0","1","0","1","0","0","0","0","0","0","7","4","3","0","0","0","0","0","0","0","0","0","-2"
"135188","Lake-Sumter State College","2015","Not on tenure/no tenure system, instructors","5","2","3","0","0","0","0","0","0","1","0","1","0","0","0","0","0","0","4","2","2","0","0","0","0","0","0","0","0","0","-2"
"135188","Lake-Sumter State College","2015","Not on tenure/no tenure system, no academic rank","3","2","1","0","0","0","0","0","0","0","0","0","0","0","0","0","0","0","3","2","1","0","0","0","0","0","0","0","0","0","-2"
"135391","State College of Florida-Manatee-Sarasota","2015","Tenured total","99","40","59","0","0","0","3","3","0","6","4","2","5","2","3","0","0","0","83","31","52","0","0","0","2","0","2","0","0","0","-2"
"135391","State College of Florida-Manatee-Sarasota","2015","Tenured, professors","42","17","25","0","0","0","2","2","0","2","1","1","0","0","0","0","0","0","37","14","23","0","0","0","1","0","1","0","0","0","-2"
"135391","State College of Florida-Manatee-Sarasota","2015","Tenured, associate professors","26","14","12","0","0","0","1","1","0","3","2","1","3","1","2","0","0","0","19","10","9","0","0","0","0","0","0","0","0","0","-2"
"135391","State College of Florida-Manatee-Sarasota","2015","Tenured, assistant professors","28","9","19","0","0","0","0","0","0","1","1","0","2","1","1","0","0","0","24","7","17","0","0","0","1","0","1","0","0","0","-2"
"135391","State College of Florida-Manatee-Sarasota","2015","Tenured, instructors","3","0","3","0","0","0","0","0","0","0","0","0","0","0","0","0","0","0","3","0","3","0","0","0","0","0","0","0","0","0","-2"
"135391","State College of Florida-Manatee-Sarasota","2015","On-Tenure track total","24","9","15","0","0","0","0","0","0","0","0","0","2","2","0","0","0","0","21","7","14","0","0","0","1","0","1","0","0","0","-2"
"135391","State College of Florida-Manatee-Sarasota","2015","On-tenure track, assistant professors","17","5","12","0","0","0","0","0","0","0","0","0","0","0","0","0","0","0","16","5","11","0","0","0","1","0","1","0","0","0","-2"
"135391","State College of Florida-Manatee-Sarasota","2015","On-tenure track, instructors","7","4","3","0","0","0","0","0","0","0","0","0","2","2","0","0","0","0","5","2","3","0","0","0","0","0","0","0","0","0","-2"
"135391","State College of Florida-Manatee-Sarasota","2015","Not on tenure track/No tenure system system total","9","4","5","0","0","0","0","0","0","0","0","0","0","0","0","0","0","0","9","4","5","0","0","0","0","0","0","0","0","0","-2"
"135391","State College of Florida-Manatee-Sarasota","2015","Not on tenure/no tenure system, assistant professors","1","0","1","0","0","0","0","0","0","0","0","0","0","0","0","0","0","0","1","0","1","0","0","0","0","0","0","0","0","0","-2"
"135391","State College of Florida-Manatee-Sarasota","2015","Not on tenure/no tenure system, lecturers","4","4","0","0","0","0","0","0","0","0","0","0","0","0","0","0","0","0","4","4","0","0","0","0","0","0","0","0","0","0","-2"
"135391","State College of Florida-Manatee-Sarasota","2015","Not on tenure/no tenure system, no academic rank","4","0","4","0","0","0","0","0","0","0","0","0","0","0","0","0","0","0","4","0","4","0","0","0","0","0","0","0","0","0","-2"
"136330","Palm Beach Atlantic University","2015","Not on tenure track/No tenure system system total","173","92","81","0","0","0","4","1","3","10","3","7","8","4","4","0","0","0","139","81","58","0","0","0","4","0","4","8","3","5","-2"
"136330","Palm Beach Atlantic University","2015","Not on tenure/no tenure system, professors","42","29","13","0","0","0","1","1","0","1","1","0","1","0","1","0","0","0","38","27","11","0","0","0","1","0","1","0","0","0","-2"
"136330","Palm Beach Atlantic University","2015","Not on tenure/no tenure system, associate professors","60","35","25","0","0","0","2","0","2","2","1","1","3","2","1","0","0","0","49","30","19","0","0","0","1","0","1","3","2","1","-2"
"136330","Palm Beach Atlantic University","2015","Not on tenure/no tenure system, assistant professors","65","27","38","0","0","0","1","0","1","7","1","6","4","2","2","0","0","0","46","23","23","0","0","0","2","0","2","5","1","4","-2"
"136330","Palm Beach Atlantic University","2015","Not on tenure/no tenure system, instructors","6","1","5","0","0","0","0","0","0","0","0","0","0","0","0","0","0","0","6","1","5","0","0","0","0","0","0","0","0","0","-2"
"136400","Pasco-Hernando State College","2015","Tenured total","95","30","65","0","0","0","0","0","0","6","3","3","5","4","1","1","0","1","83","23","60","0","0","0","0","0","0","0","0","0","-2"
"136400","Pasco-Hernando State College","2015","Tenured, professors","28","8","20","0","0","0","0","0","0","0","0","0","1","1","0","0","0","0","27","7","20","0","0","0","0","0","0","0","0","0","-2"
"136400","Pasco-Hernando State College","2015","Tenured, associate professors","24","4","20","0","0","0","0","0","0","2","1","1","2","1","1","0","0","0","20","2","18","0","0","0","0","0","0","0","0","0","-2"
"136400","Pasco-Hernando State College","2015","Tenured, assistant professors","33","13","20","0","0","0","0","0","0","4","2","2","1","1","0","1","0","1","27","10","17","0","0","0","0","0","0","0","0","0","-2"
"136400","Pasco-Hernando State College","2015","Tenured, instructors","10","5","5","0","0","0","0","0","0","0","0","0","1","1","0","0","0","0","9","4","5","0","0","0","0","0","0","0","0","0","-2"
"136400","Pasco-Hernando State College","2015","On-Tenure track total","50","18","32","0","0","0","1","0","1","6","2","4","3","1","2","0","0","0","38","14","24","2","1","1","0","0","0","0","0","0","-2"
"136400","Pasco-Hernando State College","2015","On-tenure track, professors","4","2","2","0","0","0","0","0","0","1","0","1","0","0","0","0","0","0","3","2","1","0","0","0","0","0","0","0","0","0","-2"
"136400","Pasco-Hernando State College","2015","On-tenure track, associate professors","3","1","2","0","0","0","0","0","0","0","0","0","0","0","0","0","0","0","3","1","2","0","0","0","0","0","0","0","0","0","-2"
"136400","Pasco-Hernando State College","2015","On-tenure track, assistant professors","4","3","1","0","0","0","0","0","0","0","0","0","1","1","0","0","0","0","3","2","1","0","0","0","0","0","0","0","0","0","-2"
"136400","Pasco-Hernando State College","2015","On-tenure track, instructors","39","12","27","0","0","0","1","0","1","5","2","3","2","0","2","0","0","0","29","9","20","2","1","1","0","0","0","0","0","0","-2"
"136400","Pasco-Hernando State College","2015","Not on tenure track/No tenure system system total","10","5","5","0","0","0","0","0","0","1","1","0","1","0","1","0","0","0","8","4","4","0","0","0","0","0","0","0","0","0","-2"
"136400","Pasco-Hernando State College","2015","Not on tenure/no tenure system, instructors","3","0","3","0","0","0","0","0","0","0","0","0","0","0","0","0","0","0","3","0","3","0","0","0","0","0","0","0","0","0","-2"
"136400","Pasco-Hernando State College","2015","Not on tenure/no tenure system, no academic rank","7","5","2","0","0","0","0","0","0","1","1","0","1","0","1","0","0","0","5","4","1","0","0","0","0","0","0","0","0","0","-2"
"136774","Ringling College of Art and Design","2015","Not on tenure track/No tenure system system total","96","67","29","0","0","0","2","1","1","1","1","0","2","1","1","0","0","0","88","64","24","0","0","0","3","0","3","0","0","0","-2"
"136774","Ringling College of Art and Design","2015","Not on tenure/no tenure system, no academic rank","96","67","29","0","0","0","2","1","1","1","1","0","2","1","1","0","0","0","88","64","24","0","0","0","3","0","3","0","0","0","-2"
"136950","Rollins College","2015","Tenured total","131","80","51","0","0","0","5","2","3","4","4","0","7","4","3","0","0","0","109","65","44","1","1","0","5","4","1","0","0","0","-2"
"136950","Rollins College","2015","Tenured, professors","73","51","22","0","0","0","2","1","1","0","0","0","4","2","2","0","0","0","65","46","19","0","0","0","2","2","0","0","0","0","-2"
"136950","Rollins College","2015","Tenured, associate professors","58","29","29","0","0","0","3","1","2","4","4","0","3","2","1","0","0","0","44","19","25","1","1","0","3","2","1","0","0","0","-2"
"136950","Rollins College","2015","On-Tenure track total","43","18","25","0","0","0","3","1","2","2","2","0","2","0","2","0","0","0","33","13","20","0","0","0","3","2","1","0","0","0","-2"
"136950","Rollins College","2015","On-tenure track, associate professors","3","0","3","0","0","0","0","0","0","0","0","0","0","0","0","0","0","0","3","0","3","0","0","0","0","0","0","0","0","0","-2"
"136950","Rollins College","2015","On-tenure track, assistant professors","40","18","22","0","0","0","3","1","2","2","2","0","2","0","2","0","0","0","30","13","17","0","0","0","3","2","1","0","0","0","-2"
"136950","Rollins College","2015","Not on tenure track/No tenure system system total","58","31","27","0","0","0","2","1","1","1","1","0","4","2","2","0","0","0","49","25","24","0","0","0","2","2","0","0","0","0","-2"
"136950","Rollins College","2015","Not on tenure/no tenure system, professors","1","1","0","0","0","0","0","0","0","0","0","0","0","0","0","0","0","0","1","1","0","0","0","0","0","0","0","0","0","0","-2"
"136950","Rollins College","2015","Not on tenure/no tenure system, associate professors","1","1","0","0","0","0","0","0","0","0","0","0","0","0","0","0","0","0","1","1","0","0","0","0","0","0","0","0","0","0","-2"
"136950","Rollins College","2015","Not on tenure/no tenure system, assistant professors","22","14","8","0","0","0","0","0","0","0","0","0","1","1","0","0","0","0","19","11","8","0","0","0","2","2","0","0","0","0","-2"
"136950","Rollins College","2015","Not on tenure/no tenure system, lecturers","34","15","19","0","0","0","2","1","1","1","1","0","3","1","2","0","0","0","28","12","16","0","0","0","0","0","0","0","0","0","-2"
"137032","Saint Leo University","2015","Tenured total","52","35","17","1","0","1","2","2","0","1","1","0","2","1","1","0","0","0","46","31","15","0","0","0","0","0","0","0","0","0","-2"
"137032","Saint Leo University","2015","Tenured, professors","23","17","6","1","0","1","0","0","0","1","1","0","1","1","0","0","0","0","20","15","5","0","0","0","0","0","0","0","0","0","-2"
"137032","Saint Leo University","2015","Tenured, associate professors","25","15","10","0","0","0","1","1","0","0","0","0","1","0","1","0","0","0","23","14","9","0","0","0","0","0","0","0","0","0","-2"
"137032","Saint Leo University","2015","Tenured, assistant professors","4","3","1","0","0","0","1","1","0","0","0","0","0","0","0","0","0","0","3","2","1","0","0","0","0","0","0","0","0","0","-2"
"137032","Saint Leo University","2015","On-Tenure track total","59","29","30","0","0","0","1","1","0","8","3","5","0","0","0","0","0","0","48","23","25","0","0","0","2","2","0","0","0","0","-2"
"137032","Saint Leo University","2015","On-tenure track, professors","2","0","2","0","0","0","0","0","0","0","0","0","0","0","0","0","0","0","2","0","2","0","0","0","0","0","0","0","0","0","-2"
"137032","Saint Leo University","2015","On-tenure track, associate professors","19","9","10","0","0","0","0","0","0","2","0","2","0","0","0","0","0","0","16","8","8","0","0","0","1","1","0","0","0","0","-2"
"137032","Saint Leo University","2015","On-tenure track, assistant professors","38","20","18","0","0","0","1","1","0","6","3","3","0","0","0","0","0","0","30","15","15","0","0","0","1","1","0","0","0","0","-2"
"137032","Saint Leo University","2015","Not on tenure track/No tenure system system total","75","39","36","0","0","0","2","1","1","17","8","9","4","3","1","0","0","0","51","26","25","0","0","0","1","1","0","0","0","0","-2"
"137032","Saint Leo University","2015","Not on tenure/no tenure system, professors","4","3","1","0","0","0","0","0","0","0","0","0","0","0","0","0","0","0","4","3","1","0","0","0","0","0","0","0","0","0","-2"
"137032","Saint Leo University","2015","Not on tenure/no tenure system, associate professors","12","5","7","0","0","0","0","0","0","3","1","2","0","0","0","0","0","0","9","4","5","0","0","0","0","0","0","0","0","0","-2"
"137032","Saint Leo University","2015","Not on tenure/no tenure system, assistant professors","31","21","10","0","0","0","2","1","1","12","7","5","2","2","0","0","0","0","14","10","4","0","0","0","1","1","0","0","0","0","-2"
"137032","Saint Leo University","2015","Not on tenure/no tenure system, instructors","27","10","17","0","0","0","0","0","0","2","0","2","2","1","1","0","0","0","23","9","14","0","0","0","0","0","0","0","0","0","-2"
"137032","Saint Leo University","2015","Not on tenure/no tenure system, lecturers","1","0","1","0","0","0","0","0","0","0","0","0","0","0","0","0","0","0","1","0","1","0","0","0","0","0","0","0","0","0","-2"
"137078","St Petersburg College","2015","Tenured total","256","114","142","0","0","0","7","5","2","22","10","12","16","5","11","0","0","0","203","90","113","8","4","4","0","0","0","0","0","0","-2"
"137078","St Petersburg College","2015","Tenured, no academic rank","256","114","142","0","0","0","7","5","2","22","10","12","16","5","11","0","0","0","203","90","113","8","4","4","0","0","0","0","0","0","-2"
"137078","St Petersburg College","2015","On-Tenure track total","122","51","71","0","0","0","3","2","1","13","6","7","4","1","3","0","0","0","100","42","58","2","0","2","0","0","0","0","0","0","-2"
"137078","St Petersburg College","2015","On-tenure track, no academic rank","122","51","71","0","0","0","3","2","1","13","6","7","4","1","3","0","0","0","100","42","58","2","0","2","0","0","0","0","0","0","-2"
"137078","St Petersburg College","2015","Not on tenure track/No tenure system system total","3","1","2","0","0","0","0","0","0","0","0","0","0","0","0","0","0","0","3","1","2","0","0","0","0","0","0","0","0","0","-2"
"137078","St Petersburg College","2015","Not on tenure/no tenure system, no academic rank","3","1","2","0","0","0","0","0","0","0","0","0","0","0","0","0","0","0","3","1","2","0","0","0","0","0","0","0","0","0","-2"
"137096","Santa Fe College","2015","Tenured total","169","76","93","0","0","0","4","3","1","10","4","6","12","3","9","0","0","0","139","62","77","1","1","0","3","3","0","0","0","0","-2"
"137096","Santa Fe College","2015","Tenured, no academic rank","169","76","93","0","0","0","4","3","1","10","4","6","12","3","9","0","0","0","139","62","77","1","1","0","3","3","0","0","0","0","-2"
"137096","Santa Fe College","2015","On-Tenure track total","76","32","44","0","0","0","3","1","2","9","3","6","2","1","1","0","0","0","58","26","32","2","0","2","2","1","1","0","0","0","-2"
"137096","Santa Fe College","2015","On-tenure track, no academic rank","76","32","44","0","0","0","3","1","2","9","3","6","2","1","1","0","0","0","58","26","32","2","0","2","2","1","1","0","0","0","-2"
"137546","Stetson University","2015","Tenured total","164","98","66","0","0","0","2","0","2","9","3","6","5","3","2","0","0","0","138","85","53","6","4","2","2","1","1","2","2","0","-2"
"137546","Stetson University","2015","Tenured, professors","112","63","49","0","0","0","2","0","2","6","2","4","3","1","2","0","0","0","97","57","40","2","2","0","1","0","1","1","1","0","-2"
"137546","Stetson University","2015","Tenured, associate professors","52","35","17","0","0","0","0","0","0","3","1","2","2","2","0","0","0","0","41","28","13","4","2","2","1","1","0","1","1","0","-2"
"137546","Stetson University","2015","On-Tenure track total","59","28","31","0","0","0","3","1","2","2","0","2","7","2","5","0","0","0","44","23","21","1","0","1","0","0","0","2","2","0","-2"
"137546","Stetson University","2015","On-tenure track, professors","3","2","1","0","0","0","1","1","0","0","0","0","0","0","0","0","0","0","2","1","1","0","0","0","0","0","0","0","0","0","-2"
"137546","Stetson University","2015","On-tenure track, associate professors","9","3","6","0","0","0","1","0","1","1","0","1","1","0","1","0","0","0","6","3","3","0","0","0","0","0","0","0","0","0","-2"
"137546","Stetson University","2015","On-tenure track, assistant professors","47","23","24","0","0","0","1","0","1","1","0","1","6","2","4","0","0","0","36","19","17","1","0","1","0","0","0","2","2","0","-2"
"137546","Stetson University","2015","Not on tenure track/No tenure system system total","41","19","22","1","1","0","2","1","1","2","1","1","3","1","2","0","0","0","28","12","16","1","0","1","0","0","0","4","3","1","-2"
"137546","Stetson University","2015","Not on tenure/no tenure system, instructors","3","1","2","0","0","0","0","0","0","0","0","0","0","0","0","0","0","0","2","1","1","1","0","1","0","0","0","0","0","0","-2"
"137546","Stetson University","2015","Not on tenure/no tenure system, no academic rank","38","18","20","1","1","0","2","1","1","2","1","1","3","1","2","0","0","0","26","11","15","0","0","0","0","0","0","4","3","1","-2"
"137564","Southeastern University","2015","Not on tenure track/No tenure system system total","126","78","48","0","0","0","4","1","3","10","8","2","3","1","2","1","0","1","106","66","40","2","2","0","0","0","0","0","0","0","-2"
"137564","Southeastern University","2015","Not on tenure/no tenure system, professors","33","28","5","0","0","0","0","0","0","0","0","0","1","0","1","0","0","0","32","28","4","0","0","0","0","0","0","0","0","0","-2"
"137564","Southeastern University","2015","Not on tenure/no tenure system, associate professors","44","27","17","0","0","0","4","1","3","6","6","0","0","0","0","0","0","0","33","19","14","1","1","0","0","0","0","0","0","0","-2"
"137564","Southeastern University","2015","Not on tenure/no tenure system, assistant professors","36","17","19","0","0","0","0","0","0","3","1","2","1","1","0","1","0","1","30","14","16","1","1","0","0","0","0","0","0","0","-2"
"137564","Southeastern University","2015","Not on tenure/no tenure system, instructors","11","6","5","0","0","0","0","0","0","1","1","0","1","0","1","0","0","0","9","5","4","0","0","0","0","0","0","0","0","0","-2"
"137564","Southeastern University","2015","Not on tenure/no tenure system, lecturers","2","0","2","0","0","0","0","0","0","0","0","0","0","0","0","0","0","0","2","0","2","0","0","0","0","0","0","0","0","0","-2"
"137962","Trinity College of Florida","2015","Not on tenure track/No tenure system system total","8","4","4","0","0","0","0","0","0","0","0","0","0","0","0","0","0","0","8","4","4","0","0","0","0","0","0","0","0","0","-2"
"137962","Trinity College of Florida","2015","Not on tenure/no tenure system, professors","8","4","4","0","0","0","0","0","0","0","0","0","0","0","0","0","0","0","8","4","4","0","0","0","0","0","0","0","0","0","-2"
"139700","Georgia Highlands College","2015","Tenured total","64","32","32","0","0","0","1","1","0","2","1","1","0","0","0","0","0","0","61","30","31","0","0","0","0","0","0","0","0","0","-2"
"139700","Georgia Highlands College","2015","Tenured, professors","18","11","7","0","0","0","1","1","0","0","0","0","0","0","0","0","0","0","17","10","7","0","0","0","0","0","0","0","0","0","-2"
"139700","Georgia Highlands College","2015","Tenured, associate professors","38","17","21","0","0","0","0","0","0","1","0","1","0","0","0","0","0","0","37","17","20","0","0","0","0","0","0","0","0","0","-2"
"139700","Georgia Highlands College","2015","Tenured, assistant professors","8","4","4","0","0","0","0","0","0","1","1","0","0","0","0","0","0","0","7","3","4","0","0","0","0","0","0","0","0","0","-2"
"139700","Georgia Highlands College","2015","On-Tenure track total","31","14","17","0","0","0","1","1","0","3","1","2","0","0","0","0","0","0","27","12","15","0","0","0","0","0","0","0","0","0","-2"
"139700","Georgia Highlands College","2015","On-tenure track, associate professors","2","2","0","0","0","0","0","0","0","0","0","0","0","0","0","0","0","0","2","2","0","0","0","0","0","0","0","0","0","0","-2"
"139700","Georgia Highlands College","2015","On-tenure track, assistant professors","29","12","17","0","0","0","1","1","0","3","1","2","0","0","0","0","0","0","25","10","15","0","0","0","0","0","0","0","0","0","-2"
"139700","Georgia Highlands College","2015","Not on tenure track/No tenure system system total","29","7","22","0","0","0","1","1","0","3","2","1","0","0","0","0","0","0","24","4","20","0","0","0","1","0","1","0","0","0","-2"
"139700","Georgia Highlands College","2015","Not on tenure/no tenure system, instructors","29","7","22","0","0","0","1","1","0","3","2","1","0","0","0","0","0","0","24","4","20","0","0","0","1","0","1","0","0","0","-2"
"140252","Life University","2015","Not on tenure track/No tenure system system total","133","70","63","0","0","0","14","6","8","19","6","13","4","2","2","0","0","0","96","56","40","0","0","0","0","0","0","0","0","0","-2"
"140252","Life University","2015","Not on tenure/no tenure system, professors","29","21","8","0","0","0","4","2","2","1","1","0","0","0","0","0","0","0","24","18","6","0","0","0","0","0","0","0","0","0","-2"
"140252","Life University","2015","Not on tenure/no tenure system, associate professors","33","21","12","0","0","0","5","2","3","3","0","3","1","1","0","0","0","0","24","18","6","0","0","0","0","0","0","0","0","0","-2"
"140252","Life University","2015","Not on tenure/no tenure system, assistant professors","70","27","43","0","0","0","5","2","3","15","5","10","3","1","2","0","0","0","47","19","28","0","0","0","0","0","0","0","0","0","-2"
"140252","Life University","2015","Not on tenure/no tenure system, instructors","1","1","0","0","0","0","0","0","0","0","0","0","0","0","0","0","0","0","1","1","0","0","0","0","0","0","0","0","0","0","-2"
"141565","University of Hawaii at Hilo","2015","Tenured total","144","84","60","1","1","0","44","25","19","1","1","0","3","3","0","10","3","7","83","50","33","0","0","0","0","0","0","2","1","1","-2"
"141565","University of Hawaii at Hilo","2015","Tenured, professors","63","41","22","1","1","0","16","11","5","1","1","0","1","1","0","2","1","1","42","26","16","0","0","0","0","0","0","0","0","0","-2"
"141565","University of Hawaii at Hilo","2015","Tenured, associate professors","81","43","38","0","0","0","28","14","14","0","0","0","2","2","0","8","2","6","41","24","17","0","0","0","0","0","0","2","1","1","-2"
"141565","University of Hawaii at Hilo","2015","On-Tenure track total","36","19","17","0","0","0","7","4","3","0","0","0","1","1","0","3","1","2","21","11","10","1","1","0","0","0","0","3","1","2","-2"
"141565","University of Hawaii at Hilo","2015","On-tenure track, associate professors","4","1","3","0","0","0","2","1","1","0","0","0","0","0","0","0","0","0","2","0","2","0","0","0","0","0","0","0","0","0","-2"
"141565","University of Hawaii at Hilo","2015","On-tenure track, assistant professors","32","18","14","0","0","0","5","3","2","0","0","0","1","1","0","3","1","2","19","11","8","1","1","0","0","0","0","3","1","2","-2"
"141565","University of Hawaii at Hilo","2015","Not on tenure track/No tenure system system total","32","9","23","0","0","0","1","0","1","0","0","0","1","0","1","1","0","1","25","7","18","3","2","1","0","0","0","1","0","1","-2"
"141565","University of Hawaii at Hilo","2015","Not on tenure/no tenure system, assistant professors","1","0","1","0","0","0","0","0","0","0","0","0","0","0","0","0","0","0","1","0","1","0","0","0","0","0","0","0","0","0","-2"
"141565","University of Hawaii at Hilo","2015","Not on tenure/no tenure system, instructors","31","9","22","0","0","0","1","0","1","0","0","0","1","0","1","1","0","1","24","7","17","3","2","1","0","0","0","1","0","1","-2"
"141839","University of Hawaii Maui College","2015","Tenured total","53","19","34","0","0","0","9","2","7","1","1","0","0","0","0","7","5","2","35","10","25","0","0","0","0","0","0","1","1","0","-2"
"141839","University of Hawaii Maui College","2015","Tenured, professors","14","4","10","0","0","0","1","0","1","1","1","0","0","0","0","0","0","0","12","3","9","0","0","0","0","0","0","0","0","0","-2"
"141839","University of Hawaii Maui College","2015","Tenured, associate professors","13","3","10","0","0","0","4","0","4","0","0","0","0","0","0","3","2","1","6","1","5","0","0","0","0","0","0","0","0","0","-2"
"141839","University of Hawaii Maui College","2015","Tenured, assistant professors","26","12","14","0","0","0","4","2","2","0","0","0","0","0","0","4","3","1","17","6","11","0","0","0","0","0","0","1","1","0","-2"
"141839","University of Hawaii Maui College","2015","On-Tenure track total","33","18","15","0","0","0","5","4","1","0","0","0","1","1","0","4","2","2","19","9","10","2","0","2","0","0","0","2","2","0","-2"
"141839","University of Hawaii Maui College","2015","On-tenure track, assistant professors","4","2","2","0","0","0","1","1","0","0","0","0","0","0","0","1","1","0","2","0","2","0","0","0","0","0","0","0","0","0","-2"
"141839","University of Hawaii Maui College","2015","On-tenure track, instructors","29","16","13","0","0","0","4","3","1","0","0","0","1","1","0","3","1","2","17","9","8","2","0","2","0","0","0","2","2","0","-2"
"141839","University of Hawaii Maui College","2015","Not on tenure track/No tenure system system total","3","1","2","0","0","0","1","0","1","0","0","0","0","0","0","2","1","1","0","0","0","0","0","0","0","0","0","0","0","0","-2"
"141839","University of Hawaii Maui College","2015","Not on tenure/no tenure system, assistant professors","1","1","0","0","0","0","0","0","0","0","0","0","0","0","0","1","1","0","0","0","0","0","0","0","0","0","0","0","0","0","-2"
"141839","University of Hawaii Maui College","2015","Not on tenure/no tenure system, instructors","2","0","2","0","0","0","1","0","1","0","0","0","0","0","0","1","0","1","0","0","0","0","0","0","0","0","0","0","0","0","-2"
"142559","College of Southern Idaho","2015","Not on tenure track/No tenure system system total","148","68","80","1","0","1","2","0","2","0","0","0","4","1","3","0","0","0","140","67","73","1","0","1","0","0","0","0","0","0","-2"
"142559","College of Southern Idaho","2015","Not on tenure/no tenure system, professors","57","26","31","0","0","0","0","0","0","0","0","0","3","1","2","0","0","0","53","25","28","1","0","1","0","0","0","0","0","0","-2"
"142559","College of Southern Idaho","2015","Not on tenure/no tenure system, associate professors","23","11","12","0","0","0","0","0","0","0","0","0","1","0","1","0","0","0","22","11","11","0","0","0","0","0","0","0","0","0","-2"
"142559","College of Southern Idaho","2015","Not on tenure/no tenure system, assistant professors","35","15","20","1","0","1","1","0","1","0","0","0","0","0","0","0","0","0","33","15","18","0","0","0","0","0","0","0","0","0","-2"
"142559","College of Southern Idaho","2015","Not on tenure/no tenure system, instructors","33","16","17","0","0","0","1","0","1","0","0","0","0","0","0","0","0","0","32","16","16","0","0","0","0","0","0","0","0","0","-2"
"144281","Columbia College Chicago","2015","Tenured total","202","111","91","0","0","0","6","3","3","20","8","12","10","6","4","0","0","0","162","92","70","2","1","1","2","1","1","0","0","0","-2"
"144281","Columbia College Chicago","2015","Tenured, professors","38","23","15","0","0","0","1","0","1","4","2","2","1","1","0","0","0","0","31","19","12","0","0","0","1","1","0","0","0","0","-2"
"144281","Columbia College Chicago","2015","Tenured, associate professors","164","88","76","0","0","0","5","3","2","16","6","10","9","5","4","0","0","0","131","73","58","2","1","1","1","0","1","0","0","0","-2"
"144281","Columbia College Chicago","2015","On-Tenure track total","42","18","24","0","0","0","4","1","3","2","0","2","0","0","0","0","0","0","36","17","19","0","0","0","0","0","0","0","0","0","-2"
"144281","Columbia College Chicago","2015","On-tenure track, assistant professors","42","18","24","0","0","0","4","1","3","2","0","2","0","0","0","0","0","0","36","17","19","0","0","0","0","0","0","0","0","0","-2"
"144281","Columbia College Chicago","2015","Not on tenure track/No tenure system system total","80","44","36","0","0","0","2","1","1","7","4","3","3","2","1","0","0","0","67","36","31","0","0","0","1","1","0","0","0","0","-2"
"144281","Columbia College Chicago","2015","Not on tenure/no tenure system, assistant professors","3","2","1","0","0","0","0","0","0","1","0","1","0","0","0","0","0","0","2","2","0","0","0","0","0","0","0","0","0","0","-2"
"144281","Columbia College Chicago","2015","Not on tenure/no tenure system, lecturers","77","42","35","0","0","0","2","1","1","6","4","2","3","2","1","0","0","0","65","34","31","0","0","0","1","1","0","0","0","0","-2"
"144740","DePaul University","2015","Tenured total","543","309","234","1","1","0","35","18","17","42","24","18","31","12","19","0","0","0","360","210","150","5","2","3","32","18","14","37","24","13","-2"
"144740","DePaul University","2015","Tenured, professors","197","122","75","0","0","0","11","8","3","9","4","5","11","4","7","0","0","0","142","91","51","3","2","1","13","6","7","8","7","1","-2"
"144740","DePaul University","2015","Tenured, associate professors","344","185","159","1","1","0","24","10","14","33","20","13","20","8","12","0","0","0","217","118","99","2","0","2","18","11","7","29","17","12","-2"
"144740","DePaul University","2015","Tenured, assistant professors","2","2","0","0","0","0","0","0","0","0","0","0","0","0","0","0","0","0","1","1","0","0","0","0","1","1","0","0","0","0","-2"
"144740","DePaul University","2015","On-Tenure track total","179","85","94","1","0","1","9","3","6","15","3","12","13","7","6","0","0","0","92","47","45","2","1","1","24","13","11","23","11","12","-2"
"144740","DePaul University","2015","On-tenure track, professors","1","1","0","0","0","0","0","0","0","0","0","0","0","0","0","0","0","0","1","1","0","0","0","0","0","0","0","0","0","0","-2"
"144740","DePaul University","2015","On-tenure track, associate professors","14","6","8","0","0","0","1","1","0","3","0","3","1","1","0","0","0","0","8","3","5","0","0","0","1","1","0","0","0","0","-2"
"144740","DePaul University","2015","On-tenure track, assistant professors","164","78","86","1","0","1","8","2","6","12","3","9","12","6","6","0","0","0","83","43","40","2","1","1","23","12","11","23","11","12","-2"
"144740","DePaul University","2015","Not on tenure track/No tenure system system total","194","100","94","1","1","0","11","6","5","9","2","7","4","3","1","0","0","0","141","70","71","3","3","0","18","9","9","7","6","1","-2"
"144740","DePaul University","2015","Not on tenure/no tenure system, associate professors","2","1","1","0","0","0","0","0","0","0","0","0","0","0","0","0","0","0","2","1","1","0","0","0","0","0","0","0","0","0","-2"
"144740","DePaul University","2015","Not on tenure/no tenure system, assistant professors","12","3","9","0","0","0","0","0","0","2","0","2","0","0","0","0","0","0","9","3","6","0","0","0","1","0","1","0","0","0","-2"
"144740","DePaul University","2015","Not on tenure/no tenure system, instructors","180","96","84","1","1","0","11","6","5","7","2","5","4","3","1","0","0","0","130","66","64","3","3","0","17","9","8","7","6","1","-2"
"144883","East-West University","2015","Not on tenure track/No tenure system system total","13","7","6","0","0","0","5","2","3","0","0","0","0","0","0","0","0","0","8","5","3","0","0","0","0","0","0","0","0","0","-2"
"144883","East-West University","2015","Not on tenure/no tenure system, associate professors","7","2","5","0","0","0","4","1","3","0","0","0","0","0","0","0","0","0","3","1","2","0","0","0","0","0","0","0","0","0","-2"
"144883","East-West University","2015","Not on tenure/no tenure system, assistant professors","6","5","1","0","0","0","1","1","0","0","0","0","0","0","0","0","0","0","5","4","1","0","0","0","0","0","0","0","0","0","-2"
"144962","Elmhurst University","2015","Tenured total","84","41","43","0","0","0","6","5","1","3","1","2","3","1","2","0","0","0","71","33","38","0","0","0","0","0","0","1","1","0","-2"
"144962","Elmhurst University","2015","Tenured, professors","44","25","19","0","0","0","4","4","0","1","1","0","2","1","1","0","0","0","37","19","18","0","0","0","0","0","0","0","0","0","-2"
"144962","Elmhurst University","2015","Tenured, associate professors","38","14","24","0","0","0","2","1","1","2","0","2","1","0","1","0","0","0","32","12","20","0","0","0","0","0","0","1","1","0","-2"
"144962","Elmhurst University","2015","Tenured, assistant professors","2","2","0","0","0","0","0","0","0","0","0","0","0","0","0","0","0","0","2","2","0","0","0","0","0","0","0","0","0","0","-2"
"144962","Elmhurst University","2015","On-Tenure track total","23","5","18","0","0","0","1","0","1","0","0","0","0","0","0","0","0","0","22","5","17","0","0","0","0","0","0","0","0","0","-2"
"144962","Elmhurst University","2015","On-tenure track, associate professors","4","0","4","0","0","0","0","0","0","0","0","0","0","0","0","0","0","0","4","0","4","0","0","0","0","0","0","0","0","0","-2"
"144962","Elmhurst University","2015","On-tenure track, assistant professors","19","5","14","0","0","0","1","0","1","0","0","0","0","0","0","0","0","0","18","5","13","0","0","0","0","0","0","0","0","0","-2"
"144962","Elmhurst University","2015","Not on tenure track/No tenure system system total","37","11","26","0","0","0","0","0","0","2","0","2","1","0","1","0","0","0","34","11","23","0","0","0","0","0","0","0","0","0","-2"
"144962","Elmhurst University","2015","Not on tenure/no tenure system, professors","1","0","1","0","0","0","0","0","0","0","0","0","0","0","0","0","0","0","1","0","1","0","0","0","0","0","0","0","0","0","-2"
"144962","Elmhurst University","2015","Not on tenure/no tenure system, associate professors","10","2","8","0","0","0","0","0","0","2","0","2","0","0","0","0","0","0","8","2","6","0","0","0","0","0","0","0","0","0","-2"
"144962","Elmhurst University","2015","Not on tenure/no tenure system, assistant professors","18","7","11","0","0","0","0","0","0","0","0","0","0","0","0","0","0","0","18","7","11","0","0","0","0","0","0","0","0","0","-2"
"144962","Elmhurst University","2015","Not on tenure/no tenure system, instructors","1","0","1","0","0","0","0","0","0","0","0","0","0","0","0","0","0","0","1","0","1","0","0","0","0","0","0","0","0","0","-2"
"144962","Elmhurst University","2015","Not on tenure/no tenure system, lecturers","7","2","5","0","0","0","0","0","0","0","0","0","1","0","1","0","0","0","6","2","4","0","0","0","0","0","0","0","0","0","-2"
"145336","Governors State University","2015","Tenured total","91","39","52","1","0","1","14","8","6","22","10","12","4","2","2","0","0","0","47","19","28","2","0","2","0","0","0","1","0","1","-2"
"145336","Governors State University","2015","Tenured, professors","29","11","18","0","0","0","6","2","4","3","1","2","2","1","1","0","0","0","17","7","10","1","0","1","0","0","0","0","0","0","-2"
"145336","Governors State University","2015","Tenured, associate professors","60","27","33","1","0","1","8","6","2","19","9","10","2","1","1","0","0","0","28","11","17","1","0","1","0","0","0","1","0","1","-2"
"145336","Governors State University","2015","Tenured, no academic rank","2","1","1","0","0","0","0","0","0","0","0","0","0","0","0","0","0","0","2","1","1","0","0","0","0","0","0","0","0","0","-2"
"145336","Governors State University","2015","On-Tenure track total","70","24","46","0","0","0","11","3","8","14","3","11","3","0","3","0","0","0","34","14","20","1","1","0","1","1","0","6","2","4","-2"
"145336","Governors State University","2015","On-tenure track, assistant professors","66","24","42","0","0","0","11","3","8","12","3","9","3","0","3","0","0","0","32","14","18","1","1","0","1","1","0","6","2","4","-2"
"145336","Governors State University","2015","On-tenure track, instructors","4","0","4","0","0","0","0","0","0","2","0","2","0","0","0","0","0","0","2","0","2","0","0","0","0","0","0","0","0","0","-2"
"145336","Governors State University","2015","Not on tenure track/No tenure system system total","61","23","38","0","0","0","2","2","0","11","2","9","1","0","1","1","0","1","44","17","27","1","1","0","1","1","0","0","0","0","-2"
"145336","Governors State University","2015","Not on tenure/no tenure system, lecturers","53","21","32","0","0","0","1","1","0","10","2","8","1","0","1","0","0","0","40","17","23","1","1","0","0","0","0","0","0","0","-2"
"145336","Governors State University","2015","Not on tenure/no tenure system, no academic rank","8","2","6","0","0","0","1","1","0","1","0","1","0","0","0","1","0","1","4","0","4","0","0","0","1","1","0","0","0","0","-2"
"145619","Benedictine University","2015","Tenured total","76","40","36","0","0","0","5","3","2","3","1","2","1","1","0","0","0","0","65","34","31","0","0","0","2","1","1","0","0","0","-2"
"145619","Benedictine University","2015","Tenured, professors","43","25","18","0","0","0","3","1","2","2","1","1","0","0","0","0","0","0","37","23","14","0","0","0","1","0","1","0","0","0","-2"
"145619","Benedictine University","2015","Tenured, associate professors","33","15","18","0","0","0","2","2","0","1","0","1","1","1","0","0","0","0","28","11","17","0","0","0","1","1","0","0","0","0","-2"
"145619","Benedictine University","2015","On-Tenure track total","34","13","21","0","0","0","3","0","3","1","0","1","1","1","0","0","0","0","29","12","17","0","0","0","0","0","0","0","0","0","-2"
"145619","Benedictine University","2015","On-tenure track, professors","1","1","0","0","0","0","0","0","0","0","0","0","0","0","0","0","0","0","1","1","0","0","0","0","0","0","0","0","0","0","-2"
"145619","Benedictine University","2015","On-tenure track, associate professors","3","0","3","0","0","0","0","0","0","0","0","0","0","0","0","0","0","0","3","0","3","0","0","0","0","0","0","0","0","0","-2"
"145619","Benedictine University","2015","On-tenure track, assistant professors","30","12","18","0","0","0","3","0","3","1","0","1","1","1","0","0","0","0","25","11","14","0","0","0","0","0","0","0","0","0","-2"
"145619","Benedictine University","2015","Not on tenure track/No tenure system system total","50","21","29","0","0","0","2","2","0","2","1","1","2","1","1","0","0","0","44","17","27","0","0","0","0","0","0","0","0","0","-2"
"145619","Benedictine University","2015","Not on tenure/no tenure system, professors","3","2","1","0","0","0","1","1","0","0","0","0","0","0","0","0","0","0","2","1","1","0","0","0","0","0","0","0","0","0","-2"
"145619","Benedictine University","2015","Not on tenure/no tenure system, associate professors","4","1","3","0","0","0","0","0","0","2","1","1","0","0","0","0","0","0","2","0","2","0","0","0","0","0","0","0","0","0","-2"
"145619","Benedictine University","2015","Not on tenure/no tenure system, assistant professors","25","11","14","0","0","0","1","1","0","0","0","0","1","1","0","0","0","0","23","9","14","0","0","0","0","0","0","0","0","0","-2"
"145619","Benedictine University","2015","Not on tenure/no tenure system, instructors","18","7","11","0","0","0","0","0","0","0","0","0","1","0","1","0","0","0","17","7","10","0","0","0","0","0","0","0","0","0","-2"
"145725","Illinois Institute of Technology","2015","Tenured total","215","175","40","0","0","0","46","37","9","5","3","2","4","4","0","1","1","0","130","105","25","0","0","0","10","8","2","19","17","2","-2"
"145725","Illinois Institute of Technology","2015","Tenured, professors","141","116","25","0","0","0","31","26","5","2","1","1","0","0","0","0","0","0","90","74","16","0","0","0","8","6","2","10","9","1","-2"
"145725","Illinois Institute of Technology","2015","Tenured, associate professors","73","58","15","0","0","0","15","11","4","2","1","1","4","4","0","1","1","0","40","31","9","0","0","0","2","2","0","9","8","1","-2"
"145725","Illinois Institute of Technology","2015","Tenured, assistant professors","1","1","0","0","0","0","0","0","0","1","1","0","0","0","0","0","0","0","0","0","0","0","0","0","0","0","0","0","0","0","-2"
"145725","Illinois Institute of Technology","2015","On-Tenure track total","72","45","27","0","0","0","9","7","2","3","1","2","1","1","0","1","0","1","26","16","10","0","0","0","17","11","6","15","9","6","-2"
"145725","Illinois Institute of Technology","2015","On-tenure track, associate professors","4","4","0","0","0","0","0","0","0","0","0","0","0","0","0","0","0","0","3","3","0","0","0","0","1","1","0","0","0","0","-2"
"145725","Illinois Institute of Technology","2015","On-tenure track, assistant professors","67","41","26","0","0","0","9","7","2","3","1","2","1","1","0","1","0","1","23","13","10","0","0","0","16","10","6","14","9","5","-2"
"145725","Illinois Institute of Technology","2015","On-tenure track, lecturers","1","0","1","0","0","0","0","0","0","0","0","0","0","0","0","0","0","0","0","0","0","0","0","0","0","0","0","1","0","1","-2"
"145725","Illinois Institute of Technology","2015","Not on tenure track/No tenure system system total","123","83","40","0","0","0","7","5","2","2","1","1","3","0","3","0","0","0","83","62","21","0","0","0","19","8","11","9","7","2","-2"
"145725","Illinois Institute of Technology","2015","Not on tenure/no tenure system, professors","33","21","12","0","0","0","3","2","1","0","0","0","1","0","1","0","0","0","27","18","9","0","0","0","2","1","1","0","0","0","-2"
"145725","Illinois Institute of Technology","2015","Not on tenure/no tenure system, associate professors","20","16","4","0","0","0","0","0","0","0","0","0","1","0","1","0","0","0","16","15","1","0","0","0","2","0","2","1","1","0","-2"
"145725","Illinois Institute of Technology","2015","Not on tenure/no tenure system, assistant professors","24","14","10","0","0","0","1","1","0","0","0","0","1","0","1","0","0","0","13","8","5","0","0","0","3","1","2","6","4","2","-2"
"145725","Illinois Institute of Technology","2015","Not on tenure/no tenure system, instructors","6","2","4","0","0","0","0","0","0","0","0","0","0","0","0","0","0","0","4","2","2","0","0","0","2","0","2","0","0","0","-2"
"145725","Illinois Institute of Technology","2015","Not on tenure/no tenure system, lecturers","40","30","10","0","0","0","3","2","1","2","1","1","0","0","0","0","0","0","23","19","4","0","0","0","10","6","4","2","2","0","-2"
"146339","Judson University","2015","Tenured total","37","25","12","0","0","0","4","1","3","1","1","0","0","0","0","0","0","0","32","23","9","0","0","0","0","0","0","0","0","0","-2"
"146339","Judson University","2015","Tenured, professors","31","21","10","0","0","0","4","1","3","1","1","0","0","0","0","0","0","0","26","19","7","0","0","0","0","0","0","0","0","0","-2"
"146339","Judson University","2015","Tenured, associate professors","6","4","2","0","0","0","0","0","0","0","0","0","0","0","0","0","0","0","6","4","2","0","0","0","0","0","0","0","0","0","-2"
"146339","Judson University","2015","On-Tenure track total","6","3","3","0","0","0","1","0","1","0","0","0","0","0","0","0","0","0","5","3","2","0","0","0","0","0","0","0","0","0","-2"
"146339","Judson University","2015","On-tenure track, professors","1","0","1","0","0","0","0","0","0","0","0","0","0","0","0","0","0","0","1","0","1","0","0","0","0","0","0","0","0","0","-2"
"146339","Judson University","2015","On-tenure track, assistant professors","5","3","2","0","0","0","1","0","1","0","0","0","0","0","0","0","0","0","4","3","1","0","0","0","0","0","0","0","0","0","-2"
"146339","Judson University","2015","Not on tenure track/No tenure system system total","15","4","11","0","0","0","1","0","1","1","0","1","0","0","0","0","0","0","13","4","9","0","0","0","0","0","0","0","0","0","-2"
"146339","Judson University","2015","Not on tenure/no tenure system, professors","2","1","1","0","0","0","0","0","0","1","0","1","0","0","0","0","0","0","1","1","0","0","0","0","0","0","0","0","0","0","-2"
"146339","Judson University","2015","Not on tenure/no tenure system, associate professors","10","2","8","0","0","0","1","0","1","0","0","0","0","0","0","0","0","0","9","2","7","0","0","0","0","0","0","0","0","0","-2"
"146339","Judson University","2015","Not on tenure/no tenure system, assistant professors","3","1","2","0","0","0","0","0","0","0","0","0","0","0","0","0","0","0","3","1","2","0","0","0","0","0","0","0","0","0","-2"
"146612","Lewis University","2015","Tenured total","88","51","37","0","0","0","4","3","1","4","2","2","0","0","0","0","0","0","79","46","33","0","0","0","0","0","0","1","0","1","-2"
"146612","Lewis University","2015","Tenured, professors","60","36","24","0","0","0","4","3","1","3","2","1","0","0","0","0","0","0","53","31","22","0","0","0","0","0","0","0","0","0","-2"
"146612","Lewis University","2015","Tenured, associate professors","27","14","13","0","0","0","0","0","0","1","0","1","0","0","0","0","0","0","25","14","11","0","0","0","0","0","0","1","0","1","-2"
"146612","Lewis University","2015","Tenured, assistant professors","1","1","0","0","0","0","0","0","0","0","0","0","0","0","0","0","0","0","1","1","0","0","0","0","0","0","0","0","0","0","-2"
"146612","Lewis University","2015","On-Tenure track total","40","19","21","0","0","0","5","3","2","2","2","0","4","1","3","0","0","0","27","12","15","0","0","0","0","0","0","2","1","1","-2"
"146612","Lewis University","2015","On-tenure track, associate professors","9","4","5","0","0","0","1","1","0","1","1","0","1","0","1","0","0","0","6","2","4","0","0","0","0","0","0","0","0","0","-2"
"146612","Lewis University","2015","On-tenure track, assistant professors","31","15","16","0","0","0","4","2","2","1","1","0","3","1","2","0","0","0","21","10","11","0","0","0","0","0","0","2","1","1","-2"
"146612","Lewis University","2015","Not on tenure track/No tenure system system total","97","41","56","0","0","0","3","0","3","5","0","5","1","1","0","0","0","0","86","39","47","0","0","0","0","0","0","2","1","1","-2"
"146612","Lewis University","2015","Not on tenure/no tenure system, professors","2","2","0","0","0","0","0","0","0","0","0","0","1","1","0","0","0","0","1","1","0","0","0","0","0","0","0","0","0","0","-2"
"146612","Lewis University","2015","Not on tenure/no tenure system, associate professors","14","6","8","0","0","0","0","0","0","2","0","2","0","0","0","0","0","0","11","5","6","0","0","0","0","0","0","1","1","0","-2"
"146612","Lewis University","2015","Not on tenure/no tenure system, assistant professors","66","30","36","0","0","0","3","0","3","2","0","2","0","0","0","0","0","0","60","30","30","0","0","0","0","0","0","1","0","1","-2"
"146612","Lewis University","2015","Not on tenure/no tenure system, instructors","15","3","12","0","0","0","0","0","0","1","0","1","0","0","0","0","0","0","14","3","11","0","0","0","0","0","0","0","0","0","-2"
"146719","Loyola University Chicago","2015","Tenured total","427","263","164","0","0","0","29","21","8","13","4","9","20","11","9","0","0","0","359","225","134","4","1","3","2","1","1","0","0","0","-2"
"146719","Loyola University Chicago","2015","Tenured, professors","225","154","71","0","0","0","12","10","2","2","1","1","12","9","3","0","0","0","196","133","63","2","0","2","1","1","0","0","0","0","-2"
"146719","Loyola University Chicago","2015","Tenured, associate professors","194","102","92","0","0","0","16","10","6","10","3","7","7","1","6","0","0","0","158","87","71","2","1","1","1","0","1","0","0","0","-2"
"146719","Loyola University Chicago","2015","Tenured, assistant professors","8","7","1","0","0","0","1","1","0","1","0","1","1","1","0","0","0","0","5","5","0","0","0","0","0","0","0","0","0","0","-2"
"146719","Loyola University Chicago","2015","On-Tenure track total","139","71","68","0","0","0","16","6","10","7","4","3","5","2","3","0","0","0","99","51","48","0","0","0","1","0","1","11","8","3","-2"
"146719","Loyola University Chicago","2015","On-tenure track, professors","3","2","1","0","0","0","1","0","1","0","0","0","1","1","0","0","0","0","0","0","0","0","0","0","0","0","0","1","1","0","-2"
"146719","Loyola University Chicago","2015","On-tenure track, associate professors","2","1","1","0","0","0","0","0","0","0","0","0","0","0","0","0","0","0","2","1","1","0","0","0","0","0","0","0","0","0","-2"
"146719","Loyola University Chicago","2015","On-tenure track, assistant professors","134","68","66","0","0","0","15","6","9","7","4","3","4","1","3","0","0","0","97","50","47","0","0","0","1","0","1","10","7","3","-2"
"146719","Loyola University Chicago","2015","Not on tenure track/No tenure system system total","296","121","175","0","0","0","12","4","8","14","2","12","13","7","6","0","0","0","248","104","144","3","1","2","1","1","0","5","2","3","-2"
"146719","Loyola University Chicago","2015","Not on tenure/no tenure system, professors","18","4","14","0","0","0","1","1","0","1","0","1","0","0","0","0","0","0","15","3","12","1","0","1","0","0","0","0","0","0","-2"
"146719","Loyola University Chicago","2015","Not on tenure/no tenure system, associate professors","7","4","3","0","0","0","0","0","0","0","0","0","0","0","0","0","0","0","7","4","3","0","0","0","0","0","0","0","0","0","-2"
"146719","Loyola University Chicago","2015","Not on tenure/no tenure system, assistant professors","39","11","28","0","0","0","4","1","3","2","0","2","0","0","0","0","0","0","31","10","21","0","0","0","0","0","0","2","0","2","-2"
"146719","Loyola University Chicago","2015","Not on tenure/no tenure system, instructors","232","102","130","0","0","0","7","2","5","11","2","9","13","7","6","0","0","0","195","87","108","2","1","1","1","1","0","3","2","1","-2"
"147660","North Central College","2015","Tenured total","76","45","31","0","0","0","4","2","2","2","1","1","0","0","0","0","0","0","69","41","28","0","0","0","0","0","0","1","1","0","-2"
"147660","North Central College","2015","Tenured, professors","43","24","19","0","0","0","2","1","1","1","1","0","0","0","0","0","0","0","40","22","18","0","0","0","0","0","0","0","0","0","-2"
"147660","North Central College","2015","Tenured, associate professors","33","21","12","0","0","0","2","1","1","1","0","1","0","0","0","0","0","0","29","19","10","0","0","0","0","0","0","1","1","0","-2"
"147660","North Central College","2015","On-Tenure track total","41","14","27","0","0","0","3","1","2","2","1","1","3","0","3","0","0","0","25","10","15","1","0","1","2","1","1","5","1","4","-2"
"147660","North Central College","2015","On-tenure track, associate professors","1","1","0","0","0","0","0","0","0","0","0","0","0","0","0","0","0","0","0","0","0","0","0","0","1","1","0","0","0","0","-2"
"147660","North Central College","2015","On-tenure track, assistant professors","40","13","27","0","0","0","3","1","2","2","1","1","3","0","3","0","0","0","25","10","15","1","0","1","1","0","1","5","1","4","-2"
"147660","North Central College","2015","Not on tenure track/No tenure system system total","25","7","18","0","0","0","0","0","0","0","0","0","0","0","0","0","0","0","24","7","17","0","0","0","0","0","0","1","0","1","-2"
"147660","North Central College","2015","Not on tenure/no tenure system, professors","3","2","1","0","0","0","0","0","0","0","0","0","0","0","0","0","0","0","3","2","1","0","0","0","0","0","0","0","0","0","-2"
"147660","North Central College","2015","Not on tenure/no tenure system, associate professors","3","0","3","0","0","0","0","0","0","0","0","0","0","0","0","0","0","0","3","0","3","0","0","0","0","0","0","0","0","0","-2"
"147660","North Central College","2015","Not on tenure/no tenure system, assistant professors","14","5","9","0","0","0","0","0","0","0","0","0","0","0","0","0","0","0","13","5","8","0","0","0","0","0","0","1","0","1","-2"
"147660","North Central College","2015","Not on tenure/no tenure system, instructors","5","0","5","0","0","0","0","0","0","0","0","0","0","0","0","0","0","0","5","0","5","0","0","0","0","0","0","0","0","0","-2"
"148405","Rockford University","2015","Tenured total","33","21","12","0","0","0","0","0","0","0","0","0","1","1","0","0","0","0","31","19","12","1","1","0","0","0","0","0","0","0","-2"
"148405","Rockford University","2015","Tenured, professors","15","9","6","0","0","0","0","0","0","0","0","0","0","0","0","0","0","0","14","8","6","1","1","0","0","0","0","0","0","0","-2"
"148405","Rockford University","2015","Tenured, associate professors","10","6","4","0","0","0","0","0","0","0","0","0","0","0","0","0","0","0","10","6","4","0","0","0","0","0","0","0","0","0","-2"
"148405","Rockford University","2015","Tenured, assistant professors","8","6","2","0","0","0","0","0","0","0","0","0","1","1","0","0","0","0","7","5","2","0","0","0","0","0","0","0","0","0","-2"
"148405","Rockford University","2015","On-Tenure track total","34","15","19","0","0","0","2","0","2","0","0","0","3","2","1","0","0","0","29","13","16","0","0","0","0","0","0","0","0","0","-2"
"148405","Rockford University","2015","On-tenure track, associate professors","6","3","3","0","0","0","1","0","1","0","0","0","1","1","0","0","0","0","4","2","2","0","0","0","0","0","0","0","0","0","-2"
"148405","Rockford University","2015","On-tenure track, assistant professors","28","12","16","0","0","0","1","0","1","0","0","0","2","1","1","0","0","0","25","11","14","0","0","0","0","0","0","0","0","0","-2"
"148405","Rockford University","2015","Not on tenure track/No tenure system system total","9","3","6","0","0","0","0","0","0","0","0","0","0","0","0","0","0","0","9","3","6","0","0","0","0","0","0","0","0","0","-2"
"148405","Rockford University","2015","Not on tenure/no tenure system, associate professors","3","2","1","0","0","0","0","0","0","0","0","0","0","0","0","0","0","0","3","2","1","0","0","0","0","0","0","0","0","0","-2"
"148405","Rockford University","2015","Not on tenure/no tenure system, assistant professors","6","1","5","0","0","0","0","0","0","0","0","0","0","0","0","0","0","0","6","1","5","0","0","0","0","0","0","0","0","0","-2"
"148584","University of St Francis","2015","Tenured total","43","18","25","0","0","0","2","0","2","3","1","2","0","0","0","0","0","0","38","17","21","0","0","0","0","0","0","0","0","0","-2"
"148584","University of St Francis","2015","Tenured, professors","22","8","14","0","0","0","1","0","1","2","0","2","0","0","0","0","0","0","19","8","11","0","0","0","0","0","0","0","0","0","-2"
"148584","University of St Francis","2015","Tenured, associate professors","20","10","10","0","0","0","1","0","1","1","1","0","0","0","0","0","0","0","18","9","9","0","0","0","0","0","0","0","0","0","-2"
"148584","University of St Francis","2015","Tenured, assistant professors","1","0","1","0","0","0","0","0","0","0","0","0","0","0","0","0","0","0","1","0","1","0","0","0","0","0","0","0","0","0","-2"
"148584","University of St Francis","2015","On-Tenure track total","27","7","20","0","0","0","1","0","1","5","0","5","1","0","1","0","0","0","18","6","12","0","0","0","0","0","0","2","1","1","-2"
"148584","University of St Francis","2015","On-tenure track, associate professors","2","0","2","0","0","0","0","0","0","1","0","1","0","0","0","0","0","0","0","0","0","0","0","0","0","0","0","1","0","1","-2"
"148584","University of St Francis","2015","On-tenure track, assistant professors","25","7","18","0","0","0","1","0","1","4","0","4","1","0","1","0","0","0","18","6","12","0","0","0","0","0","0","1","1","0","-2"
"148584","University of St Francis","2015","Not on tenure track/No tenure system system total","30","11","19","0","0","0","1","1","0","1","0","1","1","1","0","0","0","0","27","9","18","0","0","0","0","0","0","0","0","0","-2"
"148584","University of St Francis","2015","Not on tenure/no tenure system, professors","6","5","1","0","0","0","0","0","0","0","0","0","1","1","0","0","0","0","5","4","1","0","0","0","0","0","0","0","0","0","-2"
"148584","University of St Francis","2015","Not on tenure/no tenure system, associate professors","1","0","1","0","0","0","0","0","0","0","0","0","0","0","0","0","0","0","1","0","1","0","0","0","0","0","0","0","0","0","-2"
"148584","University of St Francis","2015","Not on tenure/no tenure system, assistant professors","7","0","7","0","0","0","0","0","0","0","0","0","0","0","0","0","0","0","7","0","7","0","0","0","0","0","0","0","0","0","-2"
"148584","University of St Francis","2015","Not on tenure/no tenure system, instructors","16","6","10","0","0","0","1","1","0","1","0","1","0","0","0","0","0","0","14","5","9","0","0","0","0","0","0","0","0","0","-2"
"149763","Resurrection University","2015","Not on tenure track/No tenure system system total","50","6","44","0","0","0","2","1","1","9","0","9","0","0","0","3","0","3","35","5","30","1","0","1","0","0","0","0","0","0","-2"
"149763","Resurrection University","2015","Not on tenure/no tenure system, professors","2","0","2","0","0","0","0","0","0","0","0","0","0","0","0","0","0","0","2","0","2","0","0","0","0","0","0","0","0","0","-2"
"149763","Resurrection University","2015","Not on tenure/no tenure system, associate professors","5","1","4","0","0","0","0","0","0","0","0","0","0","0","0","0","0","0","5","1","4","0","0","0","0","0","0","0","0","0","-2"
"149763","Resurrection University","2015","Not on tenure/no tenure system, assistant professors","22","0","22","0","0","0","1","0","1","5","0","5","0","0","0","3","0","3","13","0","13","0","0","0","0","0","0","0","0","0","-2"
"149763","Resurrection University","2015","Not on tenure/no tenure system, instructors","21","5","16","0","0","0","1","1","0","4","0","4","0","0","0","0","0","0","15","4","11","1","0","1","0","0","0","0","0","0","-2"
"150668","Goshen College","2015","Tenured total","36","19","17","0","0","0","0","0","0","0","0","0","0","0","0","0","0","0","36","19","17","0","0","0","0","0","0","0","0","0","-2"
"150668","Goshen College","2015","Tenured, professors","30","15","15","0","0","0","0","0","0","0","0","0","0","0","0","0","0","0","30","15","15","0","0","0","0","0","0","0","0","0","-2"
"150668","Goshen College","2015","Tenured, associate professors","6","4","2","0","0","0","0","0","0","0","0","0","0","0","0","0","0","0","6","4","2","0","0","0","0","0","0","0","0","0","-2"
"150668","Goshen College","2015","On-Tenure track total","13","9","4","0","0","0","1","1","0","0","0","0","1","1","0","0","0","0","10","6","4","1","1","0","0","0","0","0","0","0","-2"
"150668","Goshen College","2015","On-tenure track, professors","2","2","0","0","0","0","0","0","0","0","0","0","0","0","0","0","0","0","2","2","0","0","0","0","0","0","0","0","0","0","-2"
"150668","Goshen College","2015","On-tenure track, associate professors","8","6","2","0","0","0","1","1","0","0","0","0","1","1","0","0","0","0","5","3","2","1","1","0","0","0","0","0","0","0","-2"
"150668","Goshen College","2015","On-tenure track, assistant professors","3","1","2","0","0","0","0","0","0","0","0","0","0","0","0","0","0","0","3","1","2","0","0","0","0","0","0","0","0","0","-2"
"150668","Goshen College","2015","Not on tenure track/No tenure system system total","18","5","13","0","0","0","0","0","0","1","0","1","1","0","1","0","0","0","15","5","10","1","0","1","0","0","0","0","0","0","-2"
"150668","Goshen College","2015","Not on tenure/no tenure system, professors","1","0","1","0","0","0","0","0","0","0","0","0","0","0","0","0","0","0","1","0","1","0","0","0","0","0","0","0","0","0","-2"
"150668","Goshen College","2015","Not on tenure/no tenure system, associate professors","13","5","8","0","0","0","0","0","0","0","0","0","0","0","0","0","0","0","12","5","7","1","0","1","0","0","0","0","0","0","-2"
"150668","Goshen College","2015","Not on tenure/no tenure system, assistant professors","4","0","4","0","0","0","0","0","0","1","0","1","1","0","1","0","0","0","2","0","2","0","0","0","0","0","0","0","0","0","-2"
"150774","Holy Cross College","2015","Tenured total","3","2","1","0","0","0","0","0","0","0","0","0","0","0","0","0","0","0","3","2","1","0","0","0","0","0","0","0","0","0","-2"
"150774","Holy Cross College","2015","Tenured, professors","2","1","1","0","0","0","0","0","0","0","0","0","0","0","0","0","0","0","2","1","1","0","0","0","0","0","0","0","0","0","-2"
"150774","Holy Cross College","2015","Tenured, associate professors","1","1","0","0","0","0","0","0","0","0","0","0","0","0","0","0","0","0","1","1","0","0","0","0","0","0","0","0","0","0","-2"
"150774","Holy Cross College","2015","On-Tenure track total","15","11","4","0","0","0","1","1","0","0","0","0","2","2","0","1","1","0","10","6","4","0","0","0","0","0","0","1","1","0","-2"
"150774","Holy Cross College","2015","On-tenure track, associate professors","9","6","3","0","0","0","1","1","0","0","0","0","0","0","0","0","0","0","7","4","3","0","0","0","0","0","0","1","1","0","-2"
"150774","Holy Cross College","2015","On-tenure track, assistant professors","6","5","1","0","0","0","0","0","0","0","0","0","2","2","0","1","1","0","3","2","1","0","0","0","0","0","0","0","0","0","-2"
"150774","Holy Cross College","2015","Not on tenure track/No tenure system system total","6","2","4","0","0","0","0","0","0","0","0","0","0","0","0","0","0","0","6","2","4","0","0","0","0","0","0","0","0","0","-2"
"150774","Holy Cross College","2015","Not on tenure/no tenure system, associate professors","2","1","1","0","0","0","0","0","0","0","0","0","0","0","0","0","0","0","2","1","1","0","0","0","0","0","0","0","0","0","-2"
"150774","Holy Cross College","2015","Not on tenure/no tenure system, assistant professors","3","0","3","0","0","0","0","0","0","0","0","0","0","0","0","0","0","0","3","0","3","0","0","0","0","0","0","0","0","0","-2"
"150774","Holy Cross College","2015","Not on tenure/no tenure system, instructors","1","1","0","0","0","0","0","0","0","0","0","0","0","0","0","0","0","0","1","1","0","0","0","0","0","0","0","0","0","0","-2"
"152637","Vincennes University","2015","Tenured total","52","29","23","0","0","0","1","1","0","1","1","0","0","0","0","0","0","0","50","27","23","0","0","0","0","0","0","0","0","0","-2"
"152637","Vincennes University","2015","Tenured, professors","37","16","21","0","0","0","1","1","0","1","1","0","0","0","0","0","0","0","35","14","21","0","0","0","0","0","0","0","0","0","-2"
"152637","Vincennes University","2015","Tenured, associate professors","13","11","2","0","0","0","0","0","0","0","0","0","0","0","0","0","0","0","13","11","2","0","0","0","0","0","0","0","0","0","-2"
"152637","Vincennes University","2015","Tenured, assistant professors","1","1","0","0","0","0","0","0","0","0","0","0","0","0","0","0","0","0","1","1","0","0","0","0","0","0","0","0","0","0","-2"
"152637","Vincennes University","2015","Tenured, instructors","1","1","0","0","0","0","0","0","0","0","0","0","0","0","0","0","0","0","1","1","0","0","0","0","0","0","0","0","0","0","-2"
"152637","Vincennes University","2015","On-Tenure track total","29","13","16","1","0","1","0","0","0","1","1","0","0","0","0","0","0","0","26","12","14","0","0","0","0","0","0","1","0","1","-2"
"152637","Vincennes University","2015","On-tenure track, professors","3","1","2","0","0","0","0","0","0","0","0","0","0","0","0","0","0","0","3","1","2","0","0","0","0","0","0","0","0","0","-2"
"152637","Vincennes University","2015","On-tenure track, associate professors","16","7","9","1","0","1","0","0","0","0","0","0","0","0","0","0","0","0","15","7","8","0","0","0","0","0","0","0","0","0","-2"
"152637","Vincennes University","2015","On-tenure track, assistant professors","10","5","5","0","0","0","0","0","0","1","1","0","0","0","0","0","0","0","8","4","4","0","0","0","0","0","0","1","0","1","-2"
"152637","Vincennes University","2015","Not on tenure track/No tenure system system total","138","70","68","1","0","1","0","0","0","3","2","1","2","1","1","0","0","0","130","65","65","0","0","0","0","0","0","2","2","0","-2"
"152637","Vincennes University","2015","Not on tenure/no tenure system, professors","4","0","4","0","0","0","0","0","0","0","0","0","0","0","0","0","0","0","4","0","4","0","0","0","0","0","0","0","0","0","-2"
"152637","Vincennes University","2015","Not on tenure/no tenure system, associate professors","29","13","16","1","0","1","0","0","0","1","1","0","0","0","0","0","0","0","26","11","15","0","0","0","0","0","0","1","1","0","-2"
"152637","Vincennes University","2015","Not on tenure/no tenure system, assistant professors","76","31","45","0","0","0","0","0","0","2","1","1","2","1","1","0","0","0","71","28","43","0","0","0","0","0","0","1","1","0","-2"
"152637","Vincennes University","2015","Not on tenure/no tenure system, instructors","27","25","2","0","0","0","0","0","0","0","0","0","0","0","0","0","0","0","27","25","2","0","0","0","0","0","0","0","0","0","-2"
"152637","Vincennes University","2015","Not on tenure/no tenure system, no academic rank","2","1","1","0","0","0","0","0","0","0","0","0","0","0","0","0","0","0","2","1","1","0","0","0","0","0","0","0","0","0","-2"
"152992","Briar Cliff University","2015","Tenured total","25","16","9","1","1","0","0","0","0","0","0","0","0","0","0","0","0","0","24","15","9","0","0","0","0","0","0","0","0","0","-2"
"152992","Briar Cliff University","2015","Tenured, professors","13","8","5","0","0","0","0","0","0","0","0","0","0","0","0","0","0","0","13","8","5","0","0","0","0","0","0","0","0","0","-2"
"152992","Briar Cliff University","2015","Tenured, associate professors","10","7","3","0","0","0","0","0","0","0","0","0","0","0","0","0","0","0","10","7","3","0","0","0","0","0","0","0","0","0","-2"
"152992","Briar Cliff University","2015","Tenured, assistant professors","2","1","1","1","1","0","0","0","0","0","0","0","0","0","0","0","0","0","1","0","1","0","0","0","0","0","0","0","0","0","-2"
"152992","Briar Cliff University","2015","On-Tenure track total","37","18","19","0","0","0","1","1","0","0","0","0","1","1","0","0","0","0","35","16","19","0","0","0","0","0","0","0","0","0","-2"
"152992","Briar Cliff University","2015","On-tenure track, professors","3","3","0","0","0","0","0","0","0","0","0","0","0","0","0","0","0","0","3","3","0","0","0","0","0","0","0","0","0","0","-2"
"152992","Briar Cliff University","2015","On-tenure track, associate professors","8","4","4","0","0","0","0","0","0","0","0","0","0","0","0","0","0","0","8","4","4","0","0","0","0","0","0","0","0","0","-2"
"152992","Briar Cliff University","2015","On-tenure track, assistant professors","21","11","10","0","0","0","1","1","0","0","0","0","1","1","0","0","0","0","19","9","10","0","0","0","0","0","0","0","0","0","-2"
"152992","Briar Cliff University","2015","On-tenure track, instructors","5","0","5","0","0","0","0","0","0","0","0","0","0","0","0","0","0","0","5","0","5","0","0","0","0","0","0","0","0","0","-2"
"154721","Bethany College","2015","Tenured total","14","9","5","0","0","0","0","0","0","0","0","0","0","0","0","0","0","0","14","9","5","0","0","0","0","0","0","0","0","0","-2"
"154721","Bethany College","2015","Tenured, professors","6","3","3","0","0","0","0","0","0","0","0","0","0","0","0","0","0","0","6","3","3","0","0","0","0","0","0","0","0","0","-2"
"154721","Bethany College","2015","Tenured, associate professors","8","6","2","0","0","0","0","0","0","0","0","0","0","0","0","0","0","0","8","6","2","0","0","0","0","0","0","0","0","0","-2"
"154721","Bethany College","2015","On-Tenure track total","18","9","9","0","0","0","1","0","1","0","0","0","0","0","0","0","0","0","17","9","8","0","0","0","0","0","0","0","0","0","-2"
"154721","Bethany College","2015","On-tenure track, associate professors","1","1","0","0","0","0","0","0","0","0","0","0","0","0","0","0","0","0","1","1","0","0","0","0","0","0","0","0","0","0","-2"
"154721","Bethany College","2015","On-tenure track, assistant professors","17","8","9","0","0","0","1","0","1","0","0","0","0","0","0","0","0","0","16","8","8","0","0","0","0","0","0","0","0","0","-2"
"154721","Bethany College","2015","Not on tenure track/No tenure system system total","10","4","6","0","0","0","0","0","0","0","0","0","1","1","0","0","0","0","8","2","6","0","0","0","1","1","0","0","0","0","-2"
"154721","Bethany College","2015","Not on tenure/no tenure system, assistant professors","8","2","6","0","0","0","0","0","0","0","0","0","1","1","0","0","0","0","7","1","6","0","0","0","0","0","0","0","0","0","-2"
"154721","Bethany College","2015","Not on tenure/no tenure system, no academic rank","2","2","0","0","0","0","0","0","0","0","0","0","0","0","0","0","0","0","1","1","0","0","0","0","1","1","0","0","0","0","-2"
"155414","Kansas Wesleyan University","2015","Tenured total","19","12","7","0","0","0","1","1","0","0","0","0","0","0","0","0","0","0","18","11","7","0","0","0","0","0","0","0","0","0","-2"
"155414","Kansas Wesleyan University","2015","Tenured, professors","7","4","3","0","0","0","0","0","0","0","0","0","0","0","0","0","0","0","7","4","3","0","0","0","0","0","0","0","0","0","-2"
"155414","Kansas Wesleyan University","2015","Tenured, associate professors","12","8","4","0","0","0","1","1","0","0","0","0","0","0","0","0","0","0","11","7","4","0","0","0","0","0","0","0","0","0","-2"
"155414","Kansas Wesleyan University","2015","On-Tenure track total","10","6","4","0","0","0","0","0","0","1","1","0","0","0","0","0","0","0","9","5","4","0","0","0","0","0","0","0","0","0","-2"
"155414","Kansas Wesleyan University","2015","On-tenure track, associate professors","4","1","3","0","0","0","0","0","0","0","0","0","0","0","0","0","0","0","4","1","3","0","0","0","0","0","0","0","0","0","-2"
"155414","Kansas Wesleyan University","2015","On-tenure track, assistant professors","6","5","1","0","0","0","0","0","0","1","1","0","0","0","0","0","0","0","5","4","1","0","0","0","0","0","0","0","0","0","-2"
"155414","Kansas Wesleyan University","2015","Not on tenure track/No tenure system system total","8","2","6","0","0","0","0","0","0","0","0","0","0","0","0","0","0","0","8","2","6","0","0","0","0","0","0","0","0","0","-2"
"155414","Kansas Wesleyan University","2015","Not on tenure/no tenure system, associate professors","1","1","0","0","0","0","0","0","0","0","0","0","0","0","0","0","0","0","1","1","0","0","0","0","0","0","0","0","0","0","-2"
"155414","Kansas Wesleyan University","2015","Not on tenure/no tenure system, assistant professors","7","1","6","0","0","0","0","0","0","0","0","0","0","0","0","0","0","0","7","1","6","0","0","0","0","0","0","0","0","0","-2"
"155511","McPherson College","2015","Tenured total","20","15","5","0","0","0","1","1","0","1","1","0","0","0","0","0","0","0","18","13","5","0","0","0","0","0","0","0","0","0","-2"
"155511","McPherson College","2015","Tenured, professors","8","6","2","0","0","0","0","0","0","0","0","0","0","0","0","0","0","0","8","6","2","0","0","0","0","0","0","0","0","0","-2"
"155511","McPherson College","2015","Tenured, associate professors","12","9","3","0","0","0","1","1","0","1","1","0","0","0","0","0","0","0","10","7","3","0","0","0","0","0","0","0","0","0","-2"
"155511","McPherson College","2015","On-Tenure track total","16","10","6","0","0","0","1","0","1","1","0","1","1","0","1","0","0","0","13","10","3","0","0","0","0","0","0","0","0","0","-2"
"155511","McPherson College","2015","On-tenure track, associate professors","3","3","0","0","0","0","0","0","0","0","0","0","0","0","0","0","0","0","3","3","0","0","0","0","0","0","0","0","0","0","-2"
"155511","McPherson College","2015","On-tenure track, assistant professors","13","7","6","0","0","0","1","0","1","1","0","1","1","0","1","0","0","0","10","7","3","0","0","0","0","0","0","0","0","0","-2"
"155511","McPherson College","2015","Not on tenure track/No tenure system system total","6","4","2","0","0","0","0","0","0","0","0","0","0","0","0","0","0","0","6","4","2","0","0","0","0","0","0","0","0","0","-2"
"155511","McPherson College","2015","Not on tenure/no tenure system, associate professors","2","1","1","0","0","0","0","0","0","0","0","0","0","0","0","0","0","0","2","1","1","0","0","0","0","0","0","0","0","0","-2"
"155511","McPherson College","2015","Not on tenure/no tenure system, assistant professors","4","3","1","0","0","0","0","0","0","0","0","0","0","0","0","0","0","0","4","3","1","0","0","0","0","0","0","0","0","0","-2"
"159656","Loyola University New Orleans","2015","Tenured total","125","80","45","0","0","0","0","0","0","8","6","2","10","6","4","0","0","0","102","65","37","3","2","1","1","1","0","1","0","1","-2"
"159656","Loyola University New Orleans","2015","Tenured, professors","81","56","25","0","0","0","0","0","0","6","5","1","7","5","2","0","0","0","66","45","21","2","1","1","0","0","0","0","0","0","-2"
"159656","Loyola University New Orleans","2015","Tenured, associate professors","44","24","20","0","0","0","0","0","0","2","1","1","3","1","2","0","0","0","36","20","16","1","1","0","1","1","0","1","0","1","-2"
"159656","Loyola University New Orleans","2015","On-Tenure track total","71","35","36","0","0","0","6","4","2","5","1","4","5","3","2","0","0","0","50","24","26","1","1","0","3","1","2","1","1","0","-2"
"159656","Loyola University New Orleans","2015","On-tenure track, professors","2","1","1","0","0","0","0","0","0","0","0","0","0","0","0","0","0","0","2","1","1","0","0","0","0","0","0","0","0","0","-2"
"159656","Loyola University New Orleans","2015","On-tenure track, associate professors","22","7","15","0","0","0","2","1","1","2","0","2","1","0","1","0","0","0","16","6","10","0","0","0","1","0","1","0","0","0","-2"
"159656","Loyola University New Orleans","2015","On-tenure track, assistant professors","47","27","20","0","0","0","4","3","1","3","1","2","4","3","1","0","0","0","32","17","15","1","1","0","2","1","1","1","1","0","-2"
"159656","Loyola University New Orleans","2015","Not on tenure track/No tenure system system total","81","33","48","0","0","0","1","1","0","2","1","1","4","1","3","1","1","0","67","29","38","0","0","0","5","0","5","1","0","1","-2"
"159656","Loyola University New Orleans","2015","Not on tenure/no tenure system, lecturers","81","33","48","0","0","0","1","1","0","2","1","1","4","1","3","1","1","0","67","29","38","0","0","0","5","0","5","1","0","1","-2"
"162210","Washington Adventist University","2015","Not on tenure track/No tenure system system total","44","23","21","0","0","0","4","3","1","16","5","11","1","1","0","0","0","0","23","14","9","0","0","0","0","0","0","0","0","0","-2"
"162210","Washington Adventist University","2015","Not on tenure/no tenure system, professors","17","12","5","0","0","0","2","2","0","5","3","2","0","0","0","0","0","0","10","7","3","0","0","0","0","0","0","0","0","0","-2"
"162210","Washington Adventist University","2015","Not on tenure/no tenure system, associate professors","15","5","10","0","0","0","1","1","0","6","1","5","0","0","0","0","0","0","8","3","5","0","0","0","0","0","0","0","0","0","-2"
"162210","Washington Adventist University","2015","Not on tenure/no tenure system, assistant professors","10","5","5","0","0","0","1","0","1","4","1","3","1","1","0","0","0","0","4","3","1","0","0","0","0","0","0","0","0","0","-2"
"162210","Washington Adventist University","2015","Not on tenure/no tenure system, instructors","2","1","1","0","0","0","0","0","0","1","0","1","0","0","0","0","0","0","1","1","0","0","0","0","0","0","0","0","0","0","-2"
"164447","American International College","2015","Tenured total","34","18","16","0","0","0","0","0","0","1","0","1","0","0","0","0","0","0","32","17","15","1","1","0","0","0","0","0","0","0","-2"
"164447","American International College","2015","Tenured, professors","14","5","9","0","0","0","0","0","0","0","0","0","0","0","0","0","0","0","14","5","9","0","0","0","0","0","0","0","0","0","-2"
"164447","American International College","2015","Tenured, associate professors","19","12","7","0","0","0","0","0","0","1","0","1","0","0","0","0","0","0","17","11","6","1","1","0","0","0","0","0","0","0","-2"
"164447","American International College","2015","Tenured, assistant professors","1","1","0","0","0","0","0","0","0","0","0","0","0","0","0","0","0","0","1","1","0","0","0","0","0","0","0","0","0","0","-2"
"164447","American International College","2015","On-Tenure track total","25","6","19","0","0","0","3","0","3","1","0","1","3","2","1","0","0","0","17","4","13","1","0","1","0","0","0","0","0","0","-2"
"164447","American International College","2015","On-tenure track, assistant professors","25","6","19","0","0","0","3","0","3","1","0","1","3","2","1","0","0","0","17","4","13","1","0","1","0","0","0","0","0","0","-2"
"164447","American International College","2015","Not on tenure track/No tenure system system total","14","7","7","0","0","0","0","0","0","0","0","0","0","0","0","0","0","0","13","7","6","1","0","1","0","0","0","0","0","0","-2"
"164447","American International College","2015","Not on tenure/no tenure system, associate professors","1","1","0","0","0","0","0","0","0","0","0","0","0","0","0","0","0","0","1","1","0","0","0","0","0","0","0","0","0","0","-2"
"164447","American International College","2015","Not on tenure/no tenure system, assistant professors","8","3","5","0","0","0","0","0","0","0","0","0","0","0","0","0","0","0","7","3","4","1","0","1","0","0","0","0","0","0","-2"
"164447","American International College","2015","Not on tenure/no tenure system, instructors","3","2","1","0","0","0","0","0","0","0","0","0","0","0","0","0","0","0","3","2","1","0","0","0","0","0","0","0","0","0","-2"
"164447","American International College","2015","Not on tenure/no tenure system, no academic rank","2","1","1","0","0","0","0","0","0","0","0","0","0","0","0","0","0","0","2","1","1","0","0","0","0","0","0","0","0","0","-2"
"164632","Bay Path University","2015","Not on tenure track/No tenure system system total","54","17","37","0","0","0","3","2","1","0","0","0","1","1","0","0","0","0","49","14","35","1","0","1","0","0","0","0","0","0","-2"
"164632","Bay Path University","2015","Not on tenure/no tenure system, professors","10","4","6","0","0","0","0","0","0","0","0","0","0","0","0","0","0","0","10","4","6","0","0","0","0","0","0","0","0","0","-2"
"164632","Bay Path University","2015","Not on tenure/no tenure system, associate professors","15","7","8","0","0","0","2","1","1","0","0","0","0","0","0","0","0","0","13","6","7","0","0","0","0","0","0","0","0","0","-2"
"164632","Bay Path University","2015","Not on tenure/no tenure system, assistant professors","27","5","22","0","0","0","1","1","0","0","0","0","1","1","0","0","0","0","24","3","21","1","0","1","0","0","0","0","0","0","-2"
"164632","Bay Path University","2015","Not on tenure/no tenure system, instructors","2","1","1","0","0","0","0","0","0","0","0","0","0","0","0","0","0","0","2","1","1","0","0","0","0","0","0","0","0","0","-2"
"165644","Eastern Nazarene College","2015","Tenured total","11","6","5","0","0","0","0","0","0","0","0","0","0","0","0","0","0","0","11","6","5","0","0","0","0","0","0","0","0","0","-2"
"165644","Eastern Nazarene College","2015","Tenured, professors","4","2","2","0","0","0","0","0","0","0","0","0","0","0","0","0","0","0","4","2","2","0","0","0","0","0","0","0","0","0","-2"
"165644","Eastern Nazarene College","2015","Tenured, associate professors","7","4","3","0","0","0","0","0","0","0","0","0","0","0","0","0","0","0","7","4","3","0","0","0","0","0","0","0","0","0","-2"
"165644","Eastern Nazarene College","2015","On-Tenure track total","12","9","3","0","0","0","0","0","0","3","2","1","1","0","1","0","0","0","6","5","1","1","1","0","0","0","0","1","1","0","-2"
"165644","Eastern Nazarene College","2015","On-tenure track, associate professors","7","6","1","0","0","0","0","0","0","2","1","1","0","0","0","0","0","0","4","4","0","0","0","0","0","0","0","1","1","0","-2"
"165644","Eastern Nazarene College","2015","On-tenure track, assistant professors","5","3","2","0","0","0","0","0","0","1","1","0","1","0","1","0","0","0","2","1","1","1","1","0","0","0","0","0","0","0","-2"
"165644","Eastern Nazarene College","2015","Not on tenure track/No tenure system system total","14","8","6","0","0","0","0","0","0","0","0","0","0","0","0","0","0","0","13","7","6","1","1","0","0","0","0","0","0","0","-2"
"165644","Eastern Nazarene College","2015","Not on tenure/no tenure system, associate professors","1","1","0","0","0","0","0","0","0","0","0","0","0","0","0","0","0","0","1","1","0","0","0","0","0","0","0","0","0","0","-2"
"165644","Eastern Nazarene College","2015","Not on tenure/no tenure system, assistant professors","7","5","2","0","0","0","0","0","0","0","0","0","0","0","0","0","0","0","6","4","2","1","1","0","0","0","0","0","0","0","-2"
"165644","Eastern Nazarene College","2015","Not on tenure/no tenure system, instructors","5","1","4","0","0","0","0","0","0","0","0","0","0","0","0","0","0","0","5","1","4","0","0","0","0","0","0","0","0","0","-2"
"165644","Eastern Nazarene College","2015","Not on tenure/no tenure system, lecturers","1","1","0","0","0","0","0","0","0","0","0","0","0","0","0","0","0","0","1","1","0","0","0","0","0","0","0","0","0","0","-2"
"165866","Framingham State University","2015","Tenured total","101","36","65","0","0","0","5","4","1","2","1","1","1","0","1","0","0","0","90","30","60","2","1","1","1","0","1","0","0","0","-2"
"165866","Framingham State University","2015","Tenured, professors","53","17","36","0","0","0","2","2","0","1","1","0","1","0","1","0","0","0","47","13","34","1","1","0","1","0","1","0","0","0","-2"
"165866","Framingham State University","2015","Tenured, associate professors","44","18","26","0","0","0","3","2","1","1","0","1","0","0","0","0","0","0","39","16","23","1","0","1","0","0","0","0","0","0","-2"
"165866","Framingham State University","2015","Tenured, assistant professors","4","1","3","0","0","0","0","0","0","0","0","0","0","0","0","0","0","0","4","1","3","0","0","0","0","0","0","0","0","0","-2"
"165866","Framingham State University","2015","On-Tenure track total","70","38","32","0","0","0","11","4","7","3","2","1","2","0","2","0","0","0","50","28","22","1","1","0","0","0","0","3","3","0","-2"
"165866","Framingham State University","2015","On-tenure track, professors","1","1","0","0","0","0","0","0","0","0","0","0","0","0","0","0","0","0","1","1","0","0","0","0","0","0","0","0","0","0","-2"
"165866","Framingham State University","2015","On-tenure track, associate professors","2","1","1","0","0","0","0","0","0","0","0","0","0","0","0","0","0","0","2","1","1","0","0","0","0","0","0","0","0","0","-2"
"165866","Framingham State University","2015","On-tenure track, assistant professors","66","36","30","0","0","0","11","4","7","3","2","1","2","0","2","0","0","0","46","26","20","1","1","0","0","0","0","3","3","0","-2"
"165866","Framingham State University","2015","On-tenure track, instructors","1","0","1","0","0","0","0","0","0","0","0","0","0","0","0","0","0","0","1","0","1","0","0","0","0","0","0","0","0","0","-2"
"165866","Framingham State University","2015","Not on tenure track/No tenure system system total","23","9","14","0","0","0","0","0","0","1","0","1","1","0","1","0","0","0","21","9","12","0","0","0","0","0","0","0","0","0","-2"
"165866","Framingham State University","2015","Not on tenure/no tenure system, assistant professors","13","5","8","0","0","0","0","0","0","1","0","1","1","0","1","0","0","0","11","5","6","0","0","0","0","0","0","0","0","0","-2"
"165866","Framingham State University","2015","Not on tenure/no tenure system, instructors","10","4","6","0","0","0","0","0","0","0","0","0","0","0","0","0","0","0","10","4","6","0","0","0","0","0","0","0","0","0","-2"
"166452","Lesley University","2015","Not on tenure track/No tenure system system total","144","49","95","0","0","0","13","5","8","6","3","3","11","3","8","1","1","0","112","36","76","1","1","0","0","0","0","0","0","0","-2"
"166452","Lesley University","2015","Not on tenure/no tenure system, professors","34","12","22","0","0","0","2","1","1","2","1","1","1","0","1","0","0","0","29","10","19","0","0","0","0","0","0","0","0","0","-2"
"166452","Lesley University","2015","Not on tenure/no tenure system, associate professors","48","18","30","0","0","0","3","1","2","3","1","2","5","1","4","0","0","0","36","14","22","1","1","0","0","0","0","0","0","0","-2"
"166452","Lesley University","2015","Not on tenure/no tenure system, assistant professors","55","18","37","0","0","0","6","3","3","1","1","0","5","2","3","1","1","0","42","11","31","0","0","0","0","0","0","0","0","0","-2"
"166452","Lesley University","2015","Not on tenure/no tenure system, instructors","7","1","6","0","0","0","2","0","2","0","0","0","0","0","0","0","0","0","5","1","4","0","0","0","0","0","0","0","0","0","-2"
"166638","University of Massachusetts-Boston","2015","Tenured total","317","177","140","0","0","0","51","33","18","23","11","12","14","6","8","0","0","0","207","113","94","0","0","0","19","13","6","3","1","2","-2"
"166638","University of Massachusetts-Boston","2015","Tenured, professors","112","66","46","0","0","0","17","13","4","5","5","0","4","1","3","0","0","0","82","44","38","0","0","0","4","3","1","0","0","0","-2"
"166638","University of Massachusetts-Boston","2015","Tenured, associate professors","205","111","94","0","0","0","34","20","14","18","6","12","10","5","5","0","0","0","125","69","56","0","0","0","15","10","5","3","1","2","-2"
"166638","University of Massachusetts-Boston","2015","On-Tenure track total","179","77","102","1","1","0","21","12","9","7","2","5","10","4","6","0","0","0","81","31","50","0","0","0","29","10","19","30","17","13","-2"
"166638","University of Massachusetts-Boston","2015","On-tenure track, associate professors","13","7","6","0","0","0","4","3","1","1","1","0","1","1","0","0","0","0","4","0","4","0","0","0","2","1","1","1","1","0","-2"
"166638","University of Massachusetts-Boston","2015","On-tenure track, assistant professors","166","70","96","1","1","0","17","9","8","6","1","5","9","3","6","0","0","0","77","31","46","0","0","0","27","9","18","29","16","13","-2"
"166638","University of Massachusetts-Boston","2015","Not on tenure track/No tenure system system total","203","86","117","0","0","0","11","6","5","6","4","2","7","5","2","0","0","0","143","58","85","0","0","0","27","9","18","9","4","5","-2"
"166638","University of Massachusetts-Boston","2015","Not on tenure/no tenure system, lecturers","177","79","98","0","0","0","10","5","5","6","4","2","6","4","2","0","0","0","127","54","73","0","0","0","21","8","13","7","4","3","-2"
"166638","University of Massachusetts-Boston","2015","Not on tenure/no tenure system, no academic rank","26","7","19","0","0","0","1","1","0","0","0","0","1","1","0","0","0","0","16","4","12","0","0","0","6","1","5","2","0","2","-2"
"167455","Pine Manor College","2015","Tenured total","11","4","7","0","0","0","1","0","1","0","0","0","1","0","1","0","0","0","9","4","5","0","0","0","0","0","0","0","0","0","-2"
"167455","Pine Manor College","2015","Tenured, professors","9","2","7","0","0","0","1","0","1","0","0","0","1","0","1","0","0","0","7","2","5","0","0","0","0","0","0","0","0","0","-2"
"167455","Pine Manor College","2015","Tenured, assistant professors","1","1","0","0","0","0","0","0","0","0","0","0","0","0","0","0","0","0","1","1","0","0","0","0","0","0","0","0","0","0","-2"
"167455","Pine Manor College","2015","Tenured, instructors","1","1","0","0","0","0","0","0","0","0","0","0","0","0","0","0","0","0","1","1","0","0","0","0","0","0","0","0","0","0","-2"
"167455","Pine Manor College","2015","On-Tenure track total","4","0","4","0","0","0","0","0","0","0","0","0","0","0","0","0","0","0","4","0","4","0","0","0","0","0","0","0","0","0","-2"
"167455","Pine Manor College","2015","On-tenure track, associate professors","1","0","1","0","0","0","0","0","0","0","0","0","0","0","0","0","0","0","1","0","1","0","0","0","0","0","0","0","0","0","-2"
"167455","Pine Manor College","2015","On-tenure track, assistant professors","3","0","3","0","0","0","0","0","0","0","0","0","0","0","0","0","0","0","3","0","3","0","0","0","0","0","0","0","0","0","-2"
"167455","Pine Manor College","2015","Not on tenure track/No tenure system system total","8","0","8","0","0","0","0","0","0","0","0","0","0","0","0","0","0","0","8","0","8","0","0","0","0","0","0","0","0","0","-2"
"167455","Pine Manor College","2015","Not on tenure/no tenure system, associate professors","5","0","5","0","0","0","0","0","0","0","0","0","0","0","0","0","0","0","5","0","5","0","0","0","0","0","0","0","0","0","-2"
"167455","Pine Manor College","2015","Not on tenure/no tenure system, assistant professors","3","0","3","0","0","0","0","0","0","0","0","0","0","0","0","0","0","0","3","0","3","0","0","0","0","0","0","0","0","0","-2"
"167729","Salem State University","2015","Tenured total","251","124","127","0","0","0","16","10","6","7","4","3","7","4","3","0","0","0","216","103","113","0","0","0","5","3","2","0","0","0","-2"
"167729","Salem State University","2015","Tenured, professors","130","71","59","0","0","0","5","2","3","1","1","0","2","1","1","0","0","0","121","67","54","0","0","0","1","0","1","0","0","0","-2"
"167729","Salem State University","2015","Tenured, associate professors","108","47","61","0","0","0","10","7","3","6","3","3","5","3","2","0","0","0","84","32","52","0","0","0","3","2","1","0","0","0","-2"
"167729","Salem State University","2015","Tenured, assistant professors","13","6","7","0","0","0","1","1","0","0","0","0","0","0","0","0","0","0","11","4","7","0","0","0","1","1","0","0","0","0","-2"
"167729","Salem State University","2015","On-Tenure track total","83","33","50","0","0","0","14","3","11","9","4","5","8","5","3","0","0","0","50","19","31","0","0","0","1","1","0","1","1","0","-2"
"167729","Salem State University","2015","On-tenure track, professors","2","2","0","0","0","0","0","0","0","1","1","0","1","1","0","0","0","0","0","0","0","0","0","0","0","0","0","0","0","0","-2"
"167729","Salem State University","2015","On-tenure track, associate professors","8","5","3","0","0","0","0","0","0","1","0","1","2","2","0","0","0","0","4","2","2","0","0","0","1","1","0","0","0","0","-2"
"167729","Salem State University","2015","On-tenure track, assistant professors","70","26","44","0","0","0","14","3","11","7","3","4","5","2","3","0","0","0","43","17","26","0","0","0","0","0","0","1","1","0","-2"
"167729","Salem State University","2015","On-tenure track, instructors","3","0","3","0","0","0","0","0","0","0","0","0","0","0","0","0","0","0","3","0","3","0","0","0","0","0","0","0","0","0","-2"
"167729","Salem State University","2015","Not on tenure track/No tenure system system total","17","5","12","0","0","0","0","0","0","1","0","1","0","0","0","0","0","0","13","4","9","0","0","0","3","1","2","0","0","0","-2"
"167729","Salem State University","2015","Not on tenure/no tenure system, assistant professors","11","3","8","0","0","0","0","0","0","0","0","0","0","0","0","0","0","0","8","2","6","0","0","0","3","1","2","0","0","0","-2"
"167729","Salem State University","2015","Not on tenure/no tenure system, instructors","6","2","4","0","0","0","0","0","0","1","0","1","0","0","0","0","0","0","5","2","3","0","0","0","0","0","0","0","0","0","-2"
"168740","Andrews University","2015","Tenured total","65","46","19","0","0","0","7","6","1","7","5","2","2","1","1","0","0","0","49","34","15","0","0","0","0","0","0","0","0","0","-2"
"168740","Andrews University","2015","Tenured, professors","50","37","13","0","0","0","7","6","1","3","2","1","2","1","1","0","0","0","38","28","10","0","0","0","0","0","0","0","0","0","-2"
"168740","Andrews University","2015","Tenured, associate professors","12","7","5","0","0","0","0","0","0","4","3","1","0","0","0","0","0","0","8","4","4","0","0","0","0","0","0","0","0","0","-2"
"168740","Andrews University","2015","Tenured, assistant professors","3","2","1","0","0","0","0","0","0","0","0","0","0","0","0","0","0","0","3","2","1","0","0","0","0","0","0","0","0","0","-2"
"168740","Andrews University","2015","On-Tenure track total","152","82","70","0","0","0","7","4","3","18","4","14","15","10","5","0","0","0","98","57","41","3","3","0","6","1","5","5","3","2","-2"
"168740","Andrews University","2015","On-tenure track, professors","21","18","3","0","0","0","1","1","0","2","1","1","2","2","0","0","0","0","13","13","0","0","0","0","2","0","2","1","1","0","-2"
"168740","Andrews University","2015","On-tenure track, associate professors","56","28","28","0","0","0","3","1","2","7","2","5","6","4","2","0","0","0","35","19","16","2","2","0","2","0","2","1","0","1","-2"
"168740","Andrews University","2015","On-tenure track, assistant professors","73","36","37","0","0","0","3","2","1","8","1","7","6","4","2","0","0","0","50","25","25","1","1","0","2","1","1","3","2","1","-2"
"168740","Andrews University","2015","On-tenure track, instructors","2","0","2","0","0","0","0","0","0","1","0","1","1","0","1","0","0","0","0","0","0","0","0","0","0","0","0","0","0","0","-2"
"168740","Andrews University","2015","Not on tenure track/No tenure system system total","16","7","9","0","0","0","1","1","0","2","0","2","4","4","0","0","0","0","8","2","6","0","0","0","0","0","0","1","0","1","-2"
"168740","Andrews University","2015","Not on tenure/no tenure system, associate professors","6","4","2","0","0","0","0","0","0","0","0","0","2","2","0","0","0","0","4","2","2","0","0","0","0","0","0","0","0","0","-2"
"168740","Andrews University","2015","Not on tenure/no tenure system, assistant professors","5","0","5","0","0","0","0","0","0","2","0","2","0","0","0","0","0","0","2","0","2","0","0","0","0","0","0","1","0","1","-2"
"168740","Andrews University","2015","Not on tenure/no tenure system, instructors","5","3","2","0","0","0","1","1","0","0","0","0","2","2","0","0","0","0","2","0","2","0","0","0","0","0","0","0","0","0","-2"
"170532","Kalamazoo College","2015","Tenured total","65","34","31","0","0","0","4","0","4","3","2","1","2","0","2","0","0","0","56","32","24","0","0","0","0","0","0","0","0","0","-2"
"170532","Kalamazoo College","2015","Tenured, professors","37","22","15","0","0","0","2","0","2","0","0","0","2","0","2","0","0","0","33","22","11","0","0","0","0","0","0","0","0","0","-2"
"170532","Kalamazoo College","2015","Tenured, associate professors","28","12","16","0","0","0","2","0","2","3","2","1","0","0","0","0","0","0","23","10","13","0","0","0","0","0","0","0","0","0","-2"
"170532","Kalamazoo College","2015","On-Tenure track total","21","9","12","0","0","0","2","0","2","3","2","1","3","1","2","0","0","0","11","5","6","2","1","1","0","0","0","0","0","0","-2"
"170532","Kalamazoo College","2015","On-tenure track, assistant professors","21","9","12","0","0","0","2","0","2","3","2","1","3","1","2","0","0","0","11","5","6","2","1","1","0","0","0","0","0","0","-2"
"170532","Kalamazoo College","2015","Not on tenure track/No tenure system system total","25","9","16","1","0","1","0","0","0","0","0","0","0","0","0","0","0","0","20","6","14","1","1","0","1","0","1","2","2","0","-2"
"170532","Kalamazoo College","2015","Not on tenure/no tenure system, assistant professors","13","4","9","1","0","1","0","0","0","0","0","0","0","0","0","0","0","0","10","3","7","1","1","0","1","0","1","0","0","0","-2"
"170532","Kalamazoo College","2015","Not on tenure/no tenure system, instructors","12","5","7","0","0","0","0","0","0","0","0","0","0","0","0","0","0","0","10","3","7","0","0","0","0","0","0","2","2","0","-2"
"172033","Sacred Heart Major Seminary","2015","Not on tenure track/No tenure system system total","16","12","4","0","0","0","0","0","0","0","0","0","2","2","0","0","0","0","14","10","4","0","0","0","0","0","0","0","0","0","-2"
"172033","Sacred Heart Major Seminary","2015","Not on tenure/no tenure system, professors","10","8","2","0","0","0","0","0","0","0","0","0","1","1","0","0","0","0","9","7","2","0","0","0","0","0","0","0","0","0","-2"
"172033","Sacred Heart Major Seminary","2015","Not on tenure/no tenure system, associate professors","3","2","1","0","0","0","0","0","0","0","0","0","1","1","0","0","0","0","2","1","1","0","0","0","0","0","0","0","0","0","-2"
"172033","Sacred Heart Major Seminary","2015","Not on tenure/no tenure system, assistant professors","2","1","1","0","0","0","0","0","0","0","0","0","0","0","0","0","0","0","2","1","1","0","0","0","0","0","0","0","0","0","-2"
"172033","Sacred Heart Major Seminary","2015","Not on tenure/no tenure system, instructors","1","1","0","0","0","0","0","0","0","0","0","0","0","0","0","0","0","0","1","1","0","0","0","0","0","0","0","0","0","0","-2"
"178721","Park University","2015","Tenured total","46","28","18","0","0","0","2","0","2","1","1","0","0","0","0","0","0","0","42","27","15","1","0","1","0","0","0","0","0","0","-2"
"178721","Park University","2015","Tenured, professors","20","15","5","0","0","0","2","0","2","1","1","0","0","0","0","0","0","0","17","14","3","0","0","0","0","0","0","0","0","0","-2"
"178721","Park University","2015","Tenured, associate professors","26","13","13","0","0","0","0","0","0","0","0","0","0","0","0","0","0","0","25","13","12","1","0","1","0","0","0","0","0","0","-2"
"178721","Park University","2015","On-Tenure track total","32","17","15","0","0","0","2","1","1","1","1","0","0","0","0","0","0","0","27","14","13","0","0","0","0","0","0","2","1","1","-2"
"178721","Park University","2015","On-tenure track, associate professors","12","8","4","0","0","0","1","0","1","1","1","0","0","0","0","0","0","0","10","7","3","0","0","0","0","0","0","0","0","0","-2"
"178721","Park University","2015","On-tenure track, assistant professors","20","9","11","0","0","0","1","1","0","0","0","0","0","0","0","0","0","0","17","7","10","0","0","0","0","0","0","2","1","1","-2"
"178721","Park University","2015","Not on tenure track/No tenure system system total","25","8","17","1","0","1","0","0","0","0","0","0","0","0","0","0","0","0","20","7","13","1","0","1","1","0","1","2","1","1","-2"
"178721","Park University","2015","Not on tenure/no tenure system, professors","1","0","1","0","0","0","0","0","0","0","0","0","0","0","0","0","0","0","1","0","1","0","0","0","0","0","0","0","0","0","-2"
"178721","Park University","2015","Not on tenure/no tenure system, associate professors","1","1","0","0","0","0","0","0","0","0","0","0","0","0","0","0","0","0","1","1","0","0","0","0","0","0","0","0","0","0","-2"
"178721","Park University","2015","Not on tenure/no tenure system, assistant professors","11","4","7","1","0","1","0","0","0","0","0","0","0","0","0","0","0","0","8","3","5","1","0","1","0","0","0","1","1","0","-2"
"178721","Park University","2015","Not on tenure/no tenure system, instructors","5","2","3","0","0","0","0","0","0","0","0","0","0","0","0","0","0","0","4","2","2","0","0","0","0","0","0","1","0","1","-2"
"178721","Park University","2015","Not on tenure/no tenure system, lecturers","7","1","6","0","0","0","0","0","0","0","0","0","0","0","0","0","0","0","6","1","5","0","0","0","1","0","1","0","0","0","-2"
"181738","Union College","2015","Tenured total","16","8","8","0","0","0","0","0","0","1","0","1","0","0","0","0","0","0","15","8","7","0","0","0","0","0","0","0","0","0","-2"
"181738","Union College","2015","Tenured, professors","9","5","4","0","0","0","0","0","0","1","0","1","0","0","0","0","0","0","8","5","3","0","0","0","0","0","0","0","0","0","-2"
"181738","Union College","2015","Tenured, associate professors","7","3","4","0","0","0","0","0","0","0","0","0","0","0","0","0","0","0","7","3","4","0","0","0","0","0","0","0","0","0","-2"
"181738","Union College","2015","On-Tenure track total","42","20","22","0","0","0","1","1","0","3","2","1","0","0","0","0","0","0","37","16","21","0","0","0","0","0","0","1","1","0","-2"
"181738","Union College","2015","On-tenure track, professors","6","6","0","0","0","0","0","0","0","1","1","0","0","0","0","0","0","0","5","5","0","0","0","0","0","0","0","0","0","0","-2"
"181738","Union College","2015","On-tenure track, associate professors","14","5","9","0","0","0","1","1","0","0","0","0","0","0","0","0","0","0","12","3","9","0","0","0","0","0","0","1","1","0","-2"
"181738","Union College","2015","On-tenure track, assistant professors","20","8","12","0","0","0","0","0","0","2","1","1","0","0","0","0","0","0","18","7","11","0","0","0","0","0","0","0","0","0","-2"
"181738","Union College","2015","On-tenure track, instructors","2","1","1","0","0","0","0","0","0","0","0","0","0","0","0","0","0","0","2","1","1","0","0","0","0","0","0","0","0","0","-2"
"181738","Union College","2015","Not on tenure track/No tenure system system total","3","1","2","0","0","0","0","0","0","0","0","0","0","0","0","0","0","0","3","1","2","0","0","0","0","0","0","0","0","0","-2"
"181738","Union College","2015","Not on tenure/no tenure system, no academic rank","3","1","2","0","0","0","0","0","0","0","0","0","0","0","0","0","0","0","3","1","2","0","0","0","0","0","0","0","0","0","-2"
"181853","York College","2015","Tenured total","9","7","2","0","0","0","0","0","0","0","0","0","1","1","0","0","0","0","8","6","2","0","0","0","0","0","0","0","0","0","-2"
"181853","York College","2015","Tenured, professors","4","4","0","0","0","0","0","0","0","0","0","0","0","0","0","0","0","0","4","4","0","0","0","0","0","0","0","0","0","0","-2"
"181853","York College","2015","Tenured, associate professors","5","3","2","0","0","0","0","0","0","0","0","0","1","1","0","0","0","0","4","2","2","0","0","0","0","0","0","0","0","0","-2"
"181853","York College","2015","On-Tenure track total","16","9","7","0","0","0","0","0","0","1","1","0","0","0","0","0","0","0","15","8","7","0","0","0","0","0","0","0","0","0","-2"
"181853","York College","2015","On-tenure track, associate professors","9","8","1","0","0","0","0","0","0","1","1","0","0","0","0","0","0","0","8","7","1","0","0","0","0","0","0","0","0","0","-2"
"181853","York College","2015","On-tenure track, assistant professors","7","1","6","0","0","0","0","0","0","0","0","0","0","0","0","0","0","0","7","1","6","0","0","0","0","0","0","0","0","0","-2"
"181853","York College","2015","Not on tenure track/No tenure system system total","1","1","0","0","0","0","0","0","0","0","0","0","0","0","0","0","0","0","1","1","0","0","0","0","0","0","0","0","0","0","-2"
"181853","York College","2015","Not on tenure/no tenure system, professors","1","1","0","0","0","0","0","0","0","0","0","0","0","0","0","0","0","0","1","1","0","0","0","0","0","0","0","0","0","0","-2"
"182306","Great Basin College","2015","Tenured total","34","17","17","0","0","0","2","1","1","1","0","1","3","2","1","0","0","0","28","14","14","0","0","0","0","0","0","0","0","0","-2"
"182306","Great Basin College","2015","Tenured, professors","34","17","17","0","0","0","2","1","1","1","0","1","3","2","1","0","0","0","28","14","14","0","0","0","0","0","0","0","0","0","-2"
"182306","Great Basin College","2015","On-Tenure track total","15","11","4","0","0","0","1","1","0","1","1","0","2","0","2","0","0","0","11","9","2","0","0","0","0","0","0","0","0","0","-2"
"182306","Great Basin College","2015","On-tenure track, instructors","15","11","4","0","0","0","1","1","0","1","1","0","2","0","2","0","0","0","11","9","2","0","0","0","0","0","0","0","0","0","-2"
"182306","Great Basin College","2015","Not on tenure track/No tenure system system total","19","14","5","0","0","0","0","0","0","0","0","0","0","0","0","0","0","0","19","14","5","0","0","0","0","0","0","0","0","0","-2"
"182306","Great Basin College","2015","Not on tenure/no tenure system, instructors","19","14","5","0","0","0","0","0","0","0","0","0","0","0","0","0","0","0","19","14","5","0","0","0","0","0","0","0","0","0","-2"
"182564","Western Nevada College","2015","Tenured total","32","19","13","0","0","0","0","0","0","0","0","0","1","1","0","0","0","0","31","18","13","0","0","0","0","0","0","0","0","0","-2"
"182564","Western Nevada College","2015","Tenured, professors","32","19","13","0","0","0","0","0","0","0","0","0","1","1","0","0","0","0","31","18","13","0","0","0","0","0","0","0","0","0","-2"
"182564","Western Nevada College","2015","On-Tenure track total","9","1","8","0","0","0","0","0","0","0","0","0","0","0","0","0","0","0","9","1","8","0","0","0","0","0","0","0","0","0","-2"
"182564","Western Nevada College","2015","On-tenure track, instructors","9","1","8","0","0","0","0","0","0","0","0","0","0","0","0","0","0","0","9","1","8","0","0","0","0","0","0","0","0","0","-2"
"182564","Western Nevada College","2015","Not on tenure track/No tenure system system total","10","9","1","0","0","0","0","0","0","0","0","0","0","0","0","0","0","0","10","9","1","0","0","0","0","0","0","0","0","0","-2"
"182564","Western Nevada College","2015","Not on tenure/no tenure system, instructors","10","9","1","0","0","0","0","0","0","0","0","0","0","0","0","0","0","0","10","9","1","0","0","0","0","0","0","0","0","0","-2"
"183974","Centenary University","2015","Tenured total","12","7","5","0","0","0","1","0","1","0","0","0","0","0","0","0","0","0","11","7","4","0","0","0","0","0","0","0","0","0","-2"
"183974","Centenary University","2015","Tenured, professors","6","4","2","0","0","0","1","0","1","0","0","0","0","0","0","0","0","0","5","4","1","0","0","0","0","0","0","0","0","0","-2"
"183974","Centenary University","2015","Tenured, associate professors","5","3","2","0","0","0","0","0","0","0","0","0","0","0","0","0","0","0","5","3","2","0","0","0","0","0","0","0","0","0","-2"
"183974","Centenary University","2015","Tenured, assistant professors","1","0","1","0","0","0","0","0","0","0","0","0","0","0","0","0","0","0","1","0","1","0","0","0","0","0","0","0","0","0","-2"
"183974","Centenary University","2015","On-Tenure track total","13","9","4","0","0","0","1","1","0","1","1","0","0","0","0","0","0","0","5","1","4","6","6","0","0","0","0","0","0","0","-2"
"183974","Centenary University","2015","On-tenure track, associate professors","2","0","2","0","0","0","0","0","0","0","0","0","0","0","0","0","0","0","2","0","2","0","0","0","0","0","0","0","0","0","-2"
"183974","Centenary University","2015","On-tenure track, assistant professors","11","9","2","0","0","0","1","1","0","1","1","0","0","0","0","0","0","0","3","1","2","6","6","0","0","0","0","0","0","0","-2"
"183974","Centenary University","2015","Not on tenure track/No tenure system system total","51","20","31","0","0","0","3","1","2","1","0","1","0","0","0","0","0","0","47","19","28","0","0","0","0","0","0","0","0","0","-2"
"183974","Centenary University","2015","Not on tenure/no tenure system, professors","3","0","3","0","0","0","0","0","0","0","0","0","0","0","0","0","0","0","3","0","3","0","0","0","0","0","0","0","0","0","-2"
"183974","Centenary University","2015","Not on tenure/no tenure system, associate professors","17","4","13","0","0","0","1","0","1","1","0","1","0","0","0","0","0","0","15","4","11","0","0","0","0","0","0","0","0","0","-2"
"183974","Centenary University","2015","Not on tenure/no tenure system, assistant professors","31","16","15","0","0","0","2","1","1","0","0","0","0","0","0","0","0","0","29","15","14","0","0","0","0","0","0","0","0","0","-2"
"184348","Drew University","2015","Tenured total","106","59","47","0","0","0","5","1","4","8","4","4","7","4","3","0","0","0","71","41","30","0","0","0","10","5","5","5","4","1","-2"
"184348","Drew University","2015","Tenured, professors","56","28","28","0","0","0","2","1","1","1","0","1","3","1","2","0","0","0","43","23","20","0","0","0","7","3","4","0","0","0","-2"
"184348","Drew University","2015","Tenured, associate professors","49","31","18","0","0","0","3","0","3","6","4","2","4","3","1","0","0","0","28","18","10","0","0","0","3","2","1","5","4","1","-2"
"184348","Drew University","2015","Tenured, assistant professors","1","0","1","0","0","0","0","0","0","1","0","1","0","0","0","0","0","0","0","0","0","0","0","0","0","0","0","0","0","0","-2"
"184348","Drew University","2015","On-Tenure track total","17","7","10","0","0","0","3","1","2","0","0","0","1","1","0","0","0","0","12","4","8","0","0","0","0","0","0","1","1","0","-2"
"184348","Drew University","2015","On-tenure track, associate professors","2","1","1","0","0","0","0","0","0","0","0","0","0","0","0","0","0","0","1","0","1","0","0","0","0","0","0","1","1","0","-2"
"184348","Drew University","2015","On-tenure track, assistant professors","15","6","9","0","0","0","3","1","2","0","0","0","1","1","0","0","0","0","11","4","7","0","0","0","0","0","0","0","0","0","-2"
"184348","Drew University","2015","Not on tenure track/No tenure system system total","23","8","15","0","0","0","1","0","1","0","0","0","1","0","1","0","0","0","17","7","10","0","0","0","2","0","2","2","1","1","-2"
"184348","Drew University","2015","Not on tenure/no tenure system, associate professors","2","0","2","0","0","0","0","0","0","0","0","0","0","0","0","0","0","0","2","0","2","0","0","0","0","0","0","0","0","0","-2"
"184348","Drew University","2015","Not on tenure/no tenure system, assistant professors","19","7","12","0","0","0","1","0","1","0","0","0","1","0","1","0","0","0","13","6","7","0","0","0","2","0","2","2","1","1","-2"
"184348","Drew University","2015","Not on tenure/no tenure system, instructors","2","1","1","0","0","0","0","0","0","0","0","0","0","0","0","0","0","0","2","1","1","0","0","0","0","0","0","0","0","0","-2"
"184694","Fairleigh Dickinson University-Florham Campus","2015","Tenured total","68","43","25","0","0","0","10","7","3","2","1","1","2","1","1","0","0","0","54","34","20","0","0","0","0","0","0","0","0","0","-2"
"184694","Fairleigh Dickinson University-Florham Campus","2015","Tenured, professors","34","23","11","0","0","0","5","4","1","0","0","0","1","0","1","0","0","0","28","19","9","0","0","0","0","0","0","0","0","0","-2"
"184694","Fairleigh Dickinson University-Florham Campus","2015","Tenured, associate professors","30","17","13","0","0","0","4","2","2","2","1","1","1","1","0","0","0","0","23","13","10","0","0","0","0","0","0","0","0","0","-2"
"184694","Fairleigh Dickinson University-Florham Campus","2015","Tenured, assistant professors","4","3","1","0","0","0","1","1","0","0","0","0","0","0","0","0","0","0","3","2","1","0","0","0","0","0","0","0","0","0","-2"
"184694","Fairleigh Dickinson University-Florham Campus","2015","On-Tenure track total","39","21","18","0","0","0","8","4","4","2","2","0","1","1","0","0","0","0","28","14","14","0","0","0","0","0","0","0","0","0","-2"
"184694","Fairleigh Dickinson University-Florham Campus","2015","On-tenure track, professors","4","1","3","0","0","0","1","1","0","0","0","0","0","0","0","0","0","0","3","0","3","0","0","0","0","0","0","0","0","0","-2"
"184694","Fairleigh Dickinson University-Florham Campus","2015","On-tenure track, associate professors","9","8","1","0","0","0","2","2","0","0","0","0","0","0","0","0","0","0","7","6","1","0","0","0","0","0","0","0","0","0","-2"
"184694","Fairleigh Dickinson University-Florham Campus","2015","On-tenure track, assistant professors","26","12","14","0","0","0","5","1","4","2","2","0","1","1","0","0","0","0","18","8","10","0","0","0","0","0","0","0","0","0","-2"
"184694","Fairleigh Dickinson University-Florham Campus","2015","Not on tenure track/No tenure system system total","34","9","25","0","0","0","4","0","4","4","1","3","1","0","1","0","0","0","25","8","17","0","0","0","0","0","0","0","0","0","-2"
"184694","Fairleigh Dickinson University-Florham Campus","2015","Not on tenure/no tenure system, assistant professors","12","1","11","0","0","0","3","0","3","0","0","0","0","0","0","0","0","0","9","1","8","0","0","0","0","0","0","0","0","0","-2"
"184694","Fairleigh Dickinson University-Florham Campus","2015","Not on tenure/no tenure system, lecturers","22","8","14","0","0","0","1","0","1","4","1","3","1","0","1","0","0","0","16","7","9","0","0","0","0","0","0","0","0","0","-2"
"185828","New Jersey Institute of Technology","2015","Tenured total","223","193","30","0","0","0","58","50","8","11","8","3","5","4","1","0","0","0","145","127","18","0","0","0","2","2","0","2","2","0","-2"
"185828","New Jersey Institute of Technology","2015","Tenured, professors","130","117","13","0","0","0","35","34","1","6","5","1","1","1","0","0","0","0","85","74","11","0","0","0","2","2","0","1","1","0","-2"
"185828","New Jersey Institute of Technology","2015","Tenured, associate professors","93","76","17","0","0","0","23","16","7","5","3","2","4","3","1","0","0","0","60","53","7","0","0","0","0","0","0","1","1","0","-2"
"185828","New Jersey Institute of Technology","2015","On-Tenure track total","57","40","17","0","0","0","19","14","5","1","1","0","4","2","2","0","0","0","23","16","7","0","0","0","0","0","0","10","7","3","-2"
"185828","New Jersey Institute of Technology","2015","On-tenure track, associate professors","7","5","2","0","0","0","3","2","1","0","0","0","0","0","0","0","0","0","3","3","0","0","0","0","0","0","0","1","0","1","-2"
"185828","New Jersey Institute of Technology","2015","On-tenure track, assistant professors","50","35","15","0","0","0","16","12","4","1","1","0","4","2","2","0","0","0","20","13","7","0","0","0","0","0","0","9","7","2","-2"
"185828","New Jersey Institute of Technology","2015","Not on tenure track/No tenure system system total","132","97","35","0","0","0","14","10","4","5","4","1","6","6","0","0","0","0","90","60","30","0","0","0","7","7","0","10","10","0","-2"
"185828","New Jersey Institute of Technology","2015","Not on tenure/no tenure system, lecturers","111","78","33","0","0","0","8","6","2","4","3","1","5","5","0","0","0","0","83","53","30","0","0","0","5","5","0","6","6","0","-2"
"185828","New Jersey Institute of Technology","2015","Not on tenure/no tenure system, no academic rank","21","19","2","0","0","0","6","4","2","1","1","0","1","1","0","0","0","0","7","7","0","0","0","0","2","2","0","4","4","0","-2"
"186201","Ramapo College of New Jersey","2015","Tenured total","176","90","86","0","0","0","16","12","4","11","7","4","15","3","12","0","0","0","125","65","60","9","3","6","0","0","0","0","0","0","-2"
"186201","Ramapo College of New Jersey","2015","Tenured, professors","70","37","33","0","0","0","7","5","2","4","2","2","4","1","3","0","0","0","53","28","25","2","1","1","0","0","0","0","0","0","-2"
"186201","Ramapo College of New Jersey","2015","Tenured, associate professors","84","42","42","0","0","0","8","6","2","2","2","0","10","2","8","0","0","0","60","32","28","4","0","4","0","0","0","0","0","0","-2"
"186201","Ramapo College of New Jersey","2015","Tenured, assistant professors","21","11","10","0","0","0","1","1","0","5","3","2","1","0","1","0","0","0","11","5","6","3","2","1","0","0","0","0","0","0","-2"
"186201","Ramapo College of New Jersey","2015","Tenured, instructors","1","0","1","0","0","0","0","0","0","0","0","0","0","0","0","0","0","0","1","0","1","0","0","0","0","0","0","0","0","0","-2"
"186201","Ramapo College of New Jersey","2015","On-Tenure track total","27","10","17","0","0","0","7","2","5","2","0","2","2","2","0","0","0","0","14","6","8","0","0","0","0","0","0","2","0","2","-2"
"186201","Ramapo College of New Jersey","2015","On-tenure track, associate professors","2","0","2","0","0","0","0","0","0","1","0","1","0","0","0","0","0","0","1","0","1","0","0","0","0","0","0","0","0","0","-2"
"186201","Ramapo College of New Jersey","2015","On-tenure track, assistant professors","24","10","14","0","0","0","7","2","5","1","0","1","2","2","0","0","0","0","12","6","6","0","0","0","0","0","0","2","0","2","-2"
"186201","Ramapo College of New Jersey","2015","On-tenure track, instructors","1","0","1","0","0","0","0","0","0","0","0","0","0","0","0","0","0","0","1","0","1","0","0","0","0","0","0","0","0","0","-2"
"186201","Ramapo College of New Jersey","2015","Not on tenure track/No tenure system system total","12","5","7","0","0","0","0","0","0","0","0","0","0","0","0","0","0","0","12","5","7","0","0","0","0","0","0","0","0","0","-2"
"186201","Ramapo College of New Jersey","2015","Not on tenure/no tenure system, assistant professors","10","5","5","0","0","0","0","0","0","0","0","0","0","0","0","0","0","0","10","5","5","0","0","0","0","0","0","0","0","0","-2"
"186201","Ramapo College of New Jersey","2015","Not on tenure/no tenure system, instructors","2","0","2","0","0","0","0","0","0","0","0","0","0","0","0","0","0","0","2","0","2","0","0","0","0","0","0","0","0","0","-2"
"186283","Rider University","2015","Tenured total","190","104","86","0","0","0","22","11","11","5","2","3","3","2","1","0","0","0","160","89","71","0","0","0","0","0","0","0","0","0","-2"
"186283","Rider University","2015","Tenured, professors","103","57","46","0","0","0","8","4","4","3","2","1","2","1","1","0","0","0","90","50","40","0","0","0","0","0","0","0","0","0","-2"
"186283","Rider University","2015","Tenured, associate professors","87","47","40","0","0","0","14","7","7","2","0","2","1","1","0","0","0","0","70","39","31","0","0","0","0","0","0","0","0","0","-2"
"186283","Rider University","2015","On-Tenure track total","55","22","33","0","0","0","3","1","2","3","0","3","1","0","1","0","0","0","42","19","23","0","0","0","0","0","0","6","2","4","-2"
"186283","Rider University","2015","On-tenure track, associate professors","8","3","5","0","0","0","1","1","0","0","0","0","0","0","0","0","0","0","6","2","4","0","0","0","0","0","0","1","0","1","-2"
"186283","Rider University","2015","On-tenure track, assistant professors","47","19","28","0","0","0","2","0","2","3","0","3","1","0","1","0","0","0","36","17","19","0","0","0","0","0","0","5","2","3","-2"
"186283","Rider University","2015","Not on tenure track/No tenure system system total","6","2","4","0","0","0","0","0","0","0","0","0","0","0","0","0","0","0","6","2","4","0","0","0","0","0","0","0","0","0","-2"
"186283","Rider University","2015","Not on tenure/no tenure system, professors","1","1","0","0","0","0","0","0","0","0","0","0","0","0","0","0","0","0","1","1","0","0","0","0","0","0","0","0","0","0","-2"
"186283","Rider University","2015","Not on tenure/no tenure system, assistant professors","5","1","4","0","0","0","0","0","0","0","0","0","0","0","0","0","0","0","5","1","4","0","0","0","0","0","0","0","0","0","-2"
"186371","Rutgers University-Camden","2015","Tenured total","151","99","52","0","0","0","24","22","2","4","2","2","3","1","2","0","0","0","105","66","39","0","0","0","6","3","3","9","5","4","-2"
"186371","Rutgers University-Camden","2015","Tenured, professors","93","63","30","0","0","0","11","11","0","2","0","2","2","1","1","0","0","0","71","46","25","0","0","0","4","2","2","3","3","0","-2"
"186371","Rutgers University-Camden","2015","Tenured, associate professors","58","36","22","0","0","0","13","11","2","2","2","0","1","0","1","0","0","0","34","20","14","0","0","0","2","1","1","6","2","4","-2"
"186371","Rutgers University-Camden","2015","On-Tenure track total","84","40","44","0","0","0","4","3","1","6","1","5","3","3","0","0","0","0","31","14","17","0","0","0","24","10","14","16","9","7","-2"
"186371","Rutgers University-Camden","2015","On-tenure track, associate professors","7","1","6","0","0","0","0","0","0","1","0","1","0","0","0","0","0","0","3","1","2","0","0","0","2","0","2","1","0","1","-2"
"186371","Rutgers University-Camden","2015","On-tenure track, assistant professors","77","39","38","0","0","0","4","3","1","5","1","4","3","3","0","0","0","0","28","13","15","0","0","0","22","10","12","15","9","6","-2"
"186371","Rutgers University-Camden","2015","Not on tenure track/No tenure system system total","57","25","32","0","0","0","3","2","1","1","1","0","1","1","0","0","0","0","39","13","26","1","1","0","11","6","5","1","1","0","-2"
"186371","Rutgers University-Camden","2015","Not on tenure/no tenure system, professors","10","3","7","0","0","0","0","0","0","0","0","0","0","0","0","0","0","0","9","3","6","0","0","0","1","0","1","0","0","0","-2"
"186371","Rutgers University-Camden","2015","Not on tenure/no tenure system, associate professors","8","4","4","0","0","0","1","1","0","0","0","0","0","0","0","0","0","0","6","2","4","0","0","0","1","1","0","0","0","0","-2"
"186371","Rutgers University-Camden","2015","Not on tenure/no tenure system, assistant professors","13","5","8","0","0","0","1","1","0","0","0","0","0","0","0","0","0","0","11","4","7","0","0","0","1","0","1","0","0","0","-2"
"186371","Rutgers University-Camden","2015","Not on tenure/no tenure system, instructors","25","12","13","0","0","0","1","0","1","0","0","0","1","1","0","0","0","0","13","4","9","1","1","0","8","5","3","1","1","0","-2"
"186371","Rutgers University-Camden","2015","Not on tenure/no tenure system, no academic rank","1","1","0","0","0","0","0","0","0","1","1","0","0","0","0","0","0","0","0","0","0","0","0","0","0","0","0","0","0","0","-2"
"186584","Seton Hall University","2015","Tenured total","242","143","99","0","0","0","24","14","10","9","6","3","10","7","3","0","0","0","195","114","81","0","0","0","3","1","2","1","1","0","-2"
"186584","Seton Hall University","2015","Tenured, professors","107","64","43","0","0","0","9","6","3","5","4","1","5","3","2","0","0","0","88","51","37","0","0","0","0","0","0","0","0","0","-2"
"186584","Seton Hall University","2015","Tenured, associate professors","131","76","55","0","0","0","15","8","7","4","2","2","5","4","1","0","0","0","103","60","43","0","0","0","3","1","2","1","1","0","-2"
"186584","Seton Hall University","2015","Tenured, assistant professors","4","3","1","0","0","0","0","0","0","0","0","0","0","0","0","0","0","0","4","3","1","0","0","0","0","0","0","0","0","0","-2"
"186584","Seton Hall University","2015","On-Tenure track total","62","25","37","0","0","0","4","0","4","5","1","4","2","1","1","0","0","0","41","16","25","0","0","0","7","5","2","3","2","1","-2"
"186584","Seton Hall University","2015","On-tenure track, professors","3","1","2","0","0","0","0","0","0","0","0","0","0","0","0","0","0","0","3","1","2","0","0","0","0","0","0","0","0","0","-2"
"186584","Seton Hall University","2015","On-tenure track, associate professors","12","6","6","0","0","0","0","0","0","1","0","1","0","0","0","0","0","0","9","4","5","0","0","0","2","2","0","0","0","0","-2"
"186584","Seton Hall University","2015","On-tenure track, assistant professors","47","18","29","0","0","0","4","0","4","4","1","3","2","1","1","0","0","0","29","11","18","0","0","0","5","3","2","3","2","1","-2"
"186584","Seton Hall University","2015","Not on tenure track/No tenure system system total","163","67","96","0","0","0","12","4","8","7","0","7","7","3","4","0","0","0","130","56","74","1","1","0","4","2","2","2","1","1","-2"
"186584","Seton Hall University","2015","Not on tenure/no tenure system, professors","5","3","2","0","0","0","1","1","0","0","0","0","0","0","0","0","0","0","4","2","2","0","0","0","0","0","0","0","0","0","-2"
"186584","Seton Hall University","2015","Not on tenure/no tenure system, associate professors","27","12","15","0","0","0","3","2","1","2","0","2","1","1","0","0","0","0","20","8","12","0","0","0","0","0","0","1","1","0","-2"
"186584","Seton Hall University","2015","Not on tenure/no tenure system, assistant professors","45","14","31","0","0","0","4","1","3","0","0","0","2","1","1","0","0","0","37","12","25","0","0","0","1","0","1","1","0","1","-2"
"186584","Seton Hall University","2015","Not on tenure/no tenure system, instructors","41","19","22","0","0","0","2","0","2","3","0","3","2","0","2","0","0","0","32","17","15","0","0","0","2","2","0","0","0","0","-2"
"186584","Seton Hall University","2015","Not on tenure/no tenure system, lecturers","1","0","1","0","0","0","0","0","0","0","0","0","0","0","0","0","0","0","1","0","1","0","0","0","0","0","0","0","0","0","-2"
"186584","Seton Hall University","2015","Not on tenure/no tenure system, no academic rank","44","19","25","0","0","0","2","0","2","2","0","2","2","1","1","0","0","0","36","17","19","1","1","0","1","0","1","0","0","0","-2"
"188429","Adelphi University","2015","Tenured total","210","103","107","0","0","0","28","11","17","14","4","10","9","5","4","0","0","0","159","83","76","0","0","0","0","0","0","0","0","0","-2"
"188429","Adelphi University","2015","Tenured, professors","81","49","32","0","0","0","11","5","6","5","2","3","2","1","1","0","0","0","63","41","22","0","0","0","0","0","0","0","0","0","-2"
"188429","Adelphi University","2015","Tenured, associate professors","127","53","74","0","0","0","17","6","11","9","2","7","7","4","3","0","0","0","94","41","53","0","0","0","0","0","0","0","0","0","-2"
"188429","Adelphi University","2015","Tenured, assistant professors","2","1","1","0","0","0","0","0","0","0","0","0","0","0","0","0","0","0","2","1","1","0","0","0","0","0","0","0","0","0","-2"
"188429","Adelphi University","2015","On-Tenure track total","68","34","34","0","0","0","12","4","8","1","0","1","5","1","4","0","0","0","47","28","19","2","1","1","1","0","1","0","0","0","-2"
"188429","Adelphi University","2015","On-tenure track, associate professors","4","2","2","0","0","0","0","0","0","0","0","0","0","0","0","0","0","0","3","1","2","1","1","0","0","0","0","0","0","0","-2"
"188429","Adelphi University","2015","On-tenure track, assistant professors","64","32","32","0","0","0","12","4","8","1","0","1","5","1","4","0","0","0","44","27","17","1","0","1","1","0","1","0","0","0","-2"
"188429","Adelphi University","2015","Not on tenure track/No tenure system system total","39","10","29","0","0","0","0","0","0","2","1","1","2","1","1","0","0","0","34","8","26","1","0","1","0","0","0","0","0","0","-2"
"188429","Adelphi University","2015","Not on tenure/no tenure system, lecturers","4","1","3","0","0","0","0","0","0","0","0","0","0","0","0","0","0","0","4","1","3","0","0","0","0","0","0","0","0","0","-2"
"188429","Adelphi University","2015","Not on tenure/no tenure system, no academic rank","35","9","26","0","0","0","0","0","0","2","1","1","2","1","1","0","0","0","30","7","23","1","0","1","0","0","0","0","0","0","-2"
"190248","Concordia College","2015","Not on tenure track/No tenure system system total","49","16","33","0","0","0","3","1","2","2","0","2","1","0","1","0","0","0","43","15","28","0","0","0","0","0","0","0","0","0","-2"
"190248","Concordia College","2015","Not on tenure/no tenure system, professors","8","4","4","0","0","0","1","1","0","1","0","1","0","0","0","0","0","0","6","3","3","0","0","0","0","0","0","0","0","0","-2"
"190248","Concordia College","2015","Not on tenure/no tenure system, associate professors","12","4","8","0","0","0","1","0","1","0","0","0","0","0","0","0","0","0","11","4","7","0","0","0","0","0","0","0","0","0","-2"
"190248","Concordia College","2015","Not on tenure/no tenure system, assistant professors","21","7","14","0","0","0","1","0","1","0","0","0","0","0","0","0","0","0","20","7","13","0","0","0","0","0","0","0","0","0","-2"
"190248","Concordia College","2015","Not on tenure/no tenure system, instructors","8","1","7","0","0","0","0","0","0","1","0","1","1","0","1","0","0","0","6","1","5","0","0","0","0","0","0","0","0","0","-2"
"190503","Culinary Institute of America","2015","Not on tenure track/No tenure system system total","141","105","36","1","1","0","3","1","2","3","2","1","3","2","1","1","1","0","120","90","30","5","5","0","4","2","2","1","1","0","-2"
"190503","Culinary Institute of America","2015","Not on tenure/no tenure system, professors","31","24","7","0","0","0","1","0","1","1","1","0","0","0","0","1","1","0","25","20","5","1","1","0","2","1","1","0","0","0","-2"
"190503","Culinary Institute of America","2015","Not on tenure/no tenure system, associate professors","57","38","19","1","1","0","1","0","1","1","0","1","2","2","0","0","0","0","52","35","17","0","0","0","0","0","0","0","0","0","-2"
"190503","Culinary Institute of America","2015","Not on tenure/no tenure system, assistant professors","28","26","2","0","0","0","1","1","0","1","1","0","0","0","0","0","0","0","24","22","2","1","1","0","1","1","0","0","0","0","-2"
"190503","Culinary Institute of America","2015","Not on tenure/no tenure system, instructors","25","17","8","0","0","0","0","0","0","0","0","0","1","0","1","0","0","0","19","13","6","3","3","0","1","0","1","1","1","0","-2"
"190512","CUNY Bernard M Baruch College","2015","Tenured total","363","233","130","0","0","0","45","34","11","22","8","14","15","6","9","0","0","0","262","169","93","1","1","0","0","0","0","18","15","3","-2"
"190512","CUNY Bernard M Baruch College","2015","Tenured, professors","186","126","60","0","0","0","24","19","5","6","3","3","8","3","5","0","0","0","144","97","47","0","0","0","0","0","0","4","4","0","-2"
"190512","CUNY Bernard M Baruch College","2015","Tenured, associate professors","144","88","56","0","0","0","18","13","5","12","5","7","6","2","4","0","0","0","93","56","37","1","1","0","0","0","0","14","11","3","-2"
"190512","CUNY Bernard M Baruch College","2015","Tenured, assistant professors","6","4","2","0","0","0","1","1","0","0","0","0","0","0","0","0","0","0","5","3","2","0","0","0","0","0","0","0","0","0","-2"
"190512","CUNY Bernard M Baruch College","2015","Tenured, lecturers","27","15","12","0","0","0","2","1","1","4","0","4","1","1","0","0","0","0","20","13","7","0","0","0","0","0","0","0","0","0","-2"
"190512","CUNY Bernard M Baruch College","2015","On-Tenure track total","125","65","60","0","0","0","15","8","7","4","3","1","5","1","4","0","0","0","61","31","30","0","0","0","0","0","0","40","22","18","-2"
"190512","CUNY Bernard M Baruch College","2015","On-tenure track, associate professors","3","2","1","0","0","0","1","0","1","0","0","0","0","0","0","0","0","0","1","1","0","0","0","0","0","0","0","1","1","0","-2"
"190512","CUNY Bernard M Baruch College","2015","On-tenure track, assistant professors","111","56","55","0","0","0","13","8","5","4","3","1","2","1","1","0","0","0","54","24","30","0","0","0","0","0","0","38","20","18","-2"
"190512","CUNY Bernard M Baruch College","2015","On-tenure track, lecturers","11","7","4","0","0","0","1","0","1","0","0","0","3","0","3","0","0","0","6","6","0","0","0","0","0","0","0","1","1","0","-2"
"190512","CUNY Bernard M Baruch College","2015","Not on tenure track/No tenure system system total","22","15","7","0","0","0","1","1","0","2","0","2","1","1","0","0","0","0","17","13","4","0","0","0","0","0","0","1","0","1","-2"
"190512","CUNY Bernard M Baruch College","2015","Not on tenure/no tenure system, professors","17","12","5","0","0","0","0","0","0","2","0","2","1","1","0","0","0","0","13","11","2","0","0","0","0","0","0","1","0","1","-2"
"190512","CUNY Bernard M Baruch College","2015","Not on tenure/no tenure system, associate professors","1","1","0","0","0","0","1","1","0","0","0","0","0","0","0","0","0","0","0","0","0","0","0","0","0","0","0","0","0","0","-2"
"190512","CUNY Bernard M Baruch College","2015","Not on tenure/no tenure system, assistant professors","1","0","1","0","0","0","0","0","0","0","0","0","0","0","0","0","0","0","1","0","1","0","0","0","0","0","0","0","0","0","-2"
"190512","CUNY Bernard M Baruch College","2015","Not on tenure/no tenure system, instructors","1","0","1","0","0","0","0","0","0","0","0","0","0","0","0","0","0","0","1","0","1","0","0","0","0","0","0","0","0","0","-2"
"190512","CUNY Bernard M Baruch College","2015","Not on tenure/no tenure system, lecturers","2","2","0","0","0","0","0","0","0","0","0","0","0","0","0","0","0","0","2","2","0","0","0","0","0","0","0","0","0","0","-2"
"190549","CUNY Brooklyn College","2015","Tenured total","399","230","169","1","0","1","43","26","17","24","14","10","24","9","15","0","0","0","296","173","123","1","1","0","0","0","0","10","7","3","-2"
"190549","CUNY Brooklyn College","2015","Tenured, professors","198","129","69","1","0","1","13","12","1","9","5","4","10","5","5","0","0","0","163","105","58","0","0","0","0","0","0","2","2","0","-2"
"190549","CUNY Brooklyn College","2015","Tenured, associate professors","150","74","76","0","0","0","24","11","13","11","8","3","11","3","8","0","0","0","98","48","50","1","1","0","0","0","0","5","3","2","-2"
"190549","CUNY Brooklyn College","2015","Tenured, assistant professors","27","13","14","0","0","0","5","3","2","3","0","3","2","0","2","0","0","0","14","8","6","0","0","0","0","0","0","3","2","1","-2"
"190549","CUNY Brooklyn College","2015","Tenured, lecturers","24","14","10","0","0","0","1","0","1","1","1","0","1","1","0","0","0","0","21","12","9","0","0","0","0","0","0","0","0","0","-2"
"190549","CUNY Brooklyn College","2015","On-Tenure track total","119","55","64","0","0","0","15","5","10","7","6","1","9","4","5","1","1","0","73","33","40","2","0","2","0","0","0","12","6","6","-2"
"190549","CUNY Brooklyn College","2015","On-tenure track, professors","1","1","0","0","0","0","0","0","0","0","0","0","0","0","0","0","0","0","1","1","0","0","0","0","0","0","0","0","0","0","-2"
"190549","CUNY Brooklyn College","2015","On-tenure track, associate professors","6","3","3","0","0","0","0","0","0","1","1","0","0","0","0","0","0","0","5","2","3","0","0","0","0","0","0","0","0","0","-2"
"190549","CUNY Brooklyn College","2015","On-tenure track, assistant professors","105","48","57","0","0","0","15","5","10","5","4","1","9","4","5","1","1","0","62","28","34","1","0","1","0","0","0","12","6","6","-2"
"190549","CUNY Brooklyn College","2015","On-tenure track, lecturers","7","3","4","0","0","0","0","0","0","1","1","0","0","0","0","0","0","0","5","2","3","1","0","1","0","0","0","0","0","0","-2"
"190549","CUNY Brooklyn College","2015","Not on tenure track/No tenure system system total","19","6","13","0","0","0","1","0","1","4","0","4","0","0","0","0","0","0","14","6","8","0","0","0","0","0","0","0","0","0","-2"
"190549","CUNY Brooklyn College","2015","Not on tenure/no tenure system, professors","4","2","2","0","0","0","0","0","0","0","0","0","0","0","0","0","0","0","4","2","2","0","0","0","0","0","0","0","0","0","-2"
"190549","CUNY Brooklyn College","2015","Not on tenure/no tenure system, associate professors","1","0","1","0","0","0","0","0","0","0","0","0","0","0","0","0","0","0","1","0","1","0","0","0","0","0","0","0","0","0","-2"
"190549","CUNY Brooklyn College","2015","Not on tenure/no tenure system, assistant professors","4","0","4","0","0","0","0","0","0","1","0","1","0","0","0","0","0","0","3","0","3","0","0","0","0","0","0","0","0","0","-2"
"190549","CUNY Brooklyn College","2015","Not on tenure/no tenure system, instructors","3","0","3","0","0","0","1","0","1","1","0","1","0","0","0","0","0","0","1","0","1","0","0","0","0","0","0","0","0","0","-2"
"190549","CUNY Brooklyn College","2015","Not on tenure/no tenure system, lecturers","7","4","3","0","0","0","0","0","0","2","0","2","0","0","0","0","0","0","5","4","1","0","0","0","0","0","0","0","0","0","-2"
"190646","CUNY Medgar Evers College","2015","Tenured total","119","70","49","0","0","0","13","7","6","74","44","30","4","2","2","0","0","0","24","15","9","2","2","0","0","0","0","2","0","2","-2"
"190646","CUNY Medgar Evers College","2015","Tenured, professors","48","30","18","0","0","0","10","6","4","25","15","10","1","1","0","0","0","0","11","7","4","1","1","0","0","0","0","0","0","0","-2"
"190646","CUNY Medgar Evers College","2015","Tenured, associate professors","26","14","12","0","0","0","0","0","0","15","8","7","1","0","1","0","0","0","9","6","3","0","0","0","0","0","0","1","0","1","-2"
"190646","CUNY Medgar Evers College","2015","Tenured, assistant professors","15","7","8","0","0","0","1","1","0","9","3","6","1","1","0","0","0","0","3","1","2","1","1","0","0","0","0","0","0","0","-2"
"190646","CUNY Medgar Evers College","2015","Tenured, lecturers","30","19","11","0","0","0","2","0","2","25","18","7","1","0","1","0","0","0","1","1","0","0","0","0","0","0","0","1","0","1","-2"
"190646","CUNY Medgar Evers College","2015","On-Tenure track total","42","16","26","0","0","0","4","1","3","25","9","16","2","2","0","0","0","0","8","4","4","1","0","1","0","0","0","2","0","2","-2"
"190646","CUNY Medgar Evers College","2015","On-tenure track, professors","1","1","0","0","0","0","0","0","0","1","1","0","0","0","0","0","0","0","0","0","0","0","0","0","0","0","0","0","0","0","-2"
"190646","CUNY Medgar Evers College","2015","On-tenure track, associate professors","12","7","5","0","0","0","3","1","2","6","5","1","0","0","0","0","0","0","2","1","1","1","0","1","0","0","0","0","0","0","-2"
"190646","CUNY Medgar Evers College","2015","On-tenure track, assistant professors","28","8","20","0","0","0","1","0","1","17","3","14","2","2","0","0","0","0","6","3","3","0","0","0","0","0","0","2","0","2","-2"
"190646","CUNY Medgar Evers College","2015","On-tenure track, lecturers","1","0","1","0","0","0","0","0","0","1","0","1","0","0","0","0","0","0","0","0","0","0","0","0","0","0","0","0","0","0","-2"
"190646","CUNY Medgar Evers College","2015","Not on tenure track/No tenure system system total","18","9","9","0","0","0","1","1","0","13","5","8","0","0","0","0","0","0","3","2","1","0","0","0","0","0","0","1","1","0","-2"
"190646","CUNY Medgar Evers College","2015","Not on tenure/no tenure system, professors","3","1","2","0","0","0","0","0","0","1","0","1","0","0","0","0","0","0","2","1","1","0","0","0","0","0","0","0","0","0","-2"
"190646","CUNY Medgar Evers College","2015","Not on tenure/no tenure system, assistant professors","4","3","1","0","0","0","0","0","0","3","2","1","0","0","0","0","0","0","0","0","0","0","0","0","0","0","0","1","1","0","-2"
"190646","CUNY Medgar Evers College","2015","Not on tenure/no tenure system, instructors","3","3","0","0","0","0","1","1","0","1","1","0","0","0","0","0","0","0","1","1","0","0","0","0","0","0","0","0","0","0","-2"
"190646","CUNY Medgar Evers College","2015","Not on tenure/no tenure system, lecturers","8","2","6","0","0","0","0","0","0","8","2","6","0","0","0","0","0","0","0","0","0","0","0","0","0","0","0","0","0","0","-2"
"191126","Fashion Institute of Technology","2015","Tenured total","197","91","106","0","0","0","7","5","2","7","3","4","7","3","4","0","0","0","90","36","54","0","0","0","86","44","42","0","0","0","-2"
"191126","Fashion Institute of Technology","2015","Tenured, professors","51","20","31","0","0","0","2","1","1","1","0","1","0","0","0","0","0","0","23","7","16","0","0","0","25","12","13","0","0","0","-2"
"191126","Fashion Institute of Technology","2015","Tenured, associate professors","67","37","30","0","0","0","4","4","0","1","1","0","3","1","2","0","0","0","32","14","18","0","0","0","27","17","10","0","0","0","-2"
"191126","Fashion Institute of Technology","2015","Tenured, assistant professors","79","34","45","0","0","0","1","0","1","5","2","3","4","2","2","0","0","0","35","15","20","0","0","0","34","15","19","0","0","0","-2"
"191126","Fashion Institute of Technology","2015","On-Tenure track total","32","10","22","1","0","1","3","0","3","2","0","2","0","0","0","0","0","0","16","5","11","0","0","0","10","5","5","0","0","0","-2"
"191126","Fashion Institute of Technology","2015","On-tenure track, professors","2","1","1","0","0","0","0","0","0","0","0","0","0","0","0","0","0","0","2","1","1","0","0","0","0","0","0","0","0","0","-2"
"191126","Fashion Institute of Technology","2015","On-tenure track, associate professors","5","1","4","0","0","0","0","0","0","0","0","0","0","0","0","0","0","0","3","1","2","0","0","0","2","0","2","0","0","0","-2"
"191126","Fashion Institute of Technology","2015","On-tenure track, assistant professors","23","7","16","1","0","1","3","0","3","1","0","1","0","0","0","0","0","0","10","2","8","0","0","0","8","5","3","0","0","0","-2"
"191126","Fashion Institute of Technology","2015","On-tenure track, instructors","2","1","1","0","0","0","0","0","0","1","0","1","0","0","0","0","0","0","1","1","0","0","0","0","0","0","0","0","0","0","-2"
"191241","Fordham University","2015","Tenured total","457","284","173","0","0","0","29","19","10","17","10","7","20","11","9","0","0","0","338","219","119","1","0","1","0","0","0","52","25","27","-2"
"191241","Fordham University","2015","Tenured, professors","234","157","77","0","0","0","16","13","3","6","4","2","8","4","4","0","0","0","192","130","62","0","0","0","0","0","0","12","6","6","-2"
"191241","Fordham University","2015","Tenured, associate professors","201","113","88","0","0","0","12","5","7","10","6","4","12","7","5","0","0","0","129","76","53","1","0","1","0","0","0","37","19","18","-2"
"191241","Fordham University","2015","Tenured, assistant professors","22","14","8","0","0","0","1","1","0","1","0","1","0","0","0","0","0","0","17","13","4","0","0","0","0","0","0","3","0","3","-2"
"191241","Fordham University","2015","On-Tenure track total","113","53","60","1","0","1","8","5","3","6","3","3","4","3","1","0","0","0","54","26","28","0","0","0","1","0","1","39","16","23","-2"
"191241","Fordham University","2015","On-tenure track, associate professors","9","6","3","0","0","0","0","0","0","1","1","0","1","1","0","0","0","0","2","1","1","0","0","0","0","0","0","5","3","2","-2"
"191241","Fordham University","2015","On-tenure track, assistant professors","104","47","57","1","0","1","8","5","3","5","2","3","3","2","1","0","0","0","52","25","27","0","0","0","1","0","1","34","13","21","-2"
"191241","Fordham University","2015","Not on tenure track/No tenure system system total","65","32","33","0","0","0","2","2","0","4","0","4","2","0","2","0","0","0","49","26","23","0","0","0","0","0","0","8","4","4","-2"
"191241","Fordham University","2015","Not on tenure/no tenure system, professors","13","9","4","0","0","0","1","1","0","1","0","1","0","0","0","0","0","0","10","7","3","0","0","0","0","0","0","1","1","0","-2"
"191241","Fordham University","2015","Not on tenure/no tenure system, associate professors","24","10","14","0","0","0","1","1","0","2","0","2","1","0","1","0","0","0","20","9","11","0","0","0","0","0","0","0","0","0","-2"
"191241","Fordham University","2015","Not on tenure/no tenure system, assistant professors","25","13","12","0","0","0","0","0","0","0","0","0","1","0","1","0","0","0","17","10","7","0","0","0","0","0","0","7","3","4","-2"
"191241","Fordham University","2015","Not on tenure/no tenure system, instructors","3","0","3","0","0","0","0","0","0","1","0","1","0","0","0","0","0","0","2","0","2","0","0","0","0","0","0","0","0","0","-2"
"191931","Iona College","2015","Tenured total","105","71","34","0","0","0","9","4","5","4","1","3","1","0","1","0","0","0","89","65","24","0","0","0","0","0","0","2","1","1","-2"
"191931","Iona College","2015","Tenured, professors","46","36","10","0","0","0","2","1","1","2","0","2","0","0","0","0","0","0","41","34","7","0","0","0","0","0","0","1","1","0","-2"
"191931","Iona College","2015","Tenured, associate professors","57","34","23","0","0","0","7","3","4","2","1","1","1","0","1","0","0","0","46","30","16","0","0","0","0","0","0","1","0","1","-2"
"191931","Iona College","2015","Tenured, assistant professors","2","1","1","0","0","0","0","0","0","0","0","0","0","0","0","0","0","0","2","1","1","0","0","0","0","0","0","0","0","0","-2"
"191931","Iona College","2015","On-Tenure track total","47","21","26","0","0","0","8","2","6","3","1","2","1","1","0","0","0","0","32","14","18","0","0","0","2","2","0","1","1","0","-2"
"191931","Iona College","2015","On-tenure track, associate professors","5","5","0","0","0","0","1","1","0","0","0","0","0","0","0","0","0","0","3","3","0","0","0","0","0","0","0","1","1","0","-2"
"191931","Iona College","2015","On-tenure track, assistant professors","42","16","26","0","0","0","7","1","6","3","1","2","1","1","0","0","0","0","29","11","18","0","0","0","2","2","0","0","0","0","-2"
"191931","Iona College","2015","Not on tenure track/No tenure system system total","19","13","6","0","0","0","0","0","0","1","0","1","0","0","0","0","0","0","18","13","5","0","0","0","0","0","0","0","0","0","-2"
"191931","Iona College","2015","Not on tenure/no tenure system, assistant professors","5","4","1","0","0","0","0","0","0","0","0","0","0","0","0","0","0","0","5","4","1","0","0","0","0","0","0","0","0","0","-2"
"191931","Iona College","2015","Not on tenure/no tenure system, instructors","4","4","0","0","0","0","0","0","0","0","0","0","0","0","0","0","0","0","4","4","0","0","0","0","0","0","0","0","0","0","-2"
"191931","Iona College","2015","Not on tenure/no tenure system, lecturers","10","5","5","0","0","0","0","0","0","1","0","1","0","0","0","0","0","0","9","5","4","0","0","0","0","0","0","0","0","0","-2"
"192703","Manhattan College","2015","Tenured total","126","76","50","0","0","0","6","4","2","2","1","1","6","3","3","0","0","0","111","68","43","0","0","0","0","0","0","1","0","1","-2"
"192703","Manhattan College","2015","Tenured, professors","59","37","22","0","0","0","2","1","1","0","0","0","1","1","0","0","0","0","56","35","21","0","0","0","0","0","0","0","0","0","-2"
"192703","Manhattan College","2015","Tenured, associate professors","56","33","23","0","0","0","4","3","1","1","1","0","4","2","2","0","0","0","46","27","19","0","0","0","0","0","0","1","0","1","-2"
"192703","Manhattan College","2015","Tenured, assistant professors","11","6","5","0","0","0","0","0","0","1","0","1","1","0","1","0","0","0","9","6","3","0","0","0","0","0","0","0","0","0","-2"
"192703","Manhattan College","2015","On-Tenure track total","68","37","31","0","0","0","7","3","4","3","1","2","2","2","0","0","0","0","40","21","19","0","0","0","10","6","4","6","4","2","-2"
"192703","Manhattan College","2015","On-tenure track, professors","3","2","1","0","0","0","0","0","0","0","0","0","0","0","0","0","0","0","3","2","1","0","0","0","0","0","0","0","0","0","-2"
"192703","Manhattan College","2015","On-tenure track, associate professors","4","4","0","0","0","0","0","0","0","0","0","0","1","1","0","0","0","0","2","2","0","0","0","0","1","1","0","0","0","0","-2"
"192703","Manhattan College","2015","On-tenure track, assistant professors","61","31","30","0","0","0","7","3","4","3","1","2","1","1","0","0","0","0","35","17","18","0","0","0","9","5","4","6","4","2","-2"
"192703","Manhattan College","2015","Not on tenure track/No tenure system system total","26","15","11","0","0","0","0","0","0","2","2","0","0","0","0","0","0","0","23","13","10","0","0","0","0","0","0","1","0","1","-2"
"192703","Manhattan College","2015","Not on tenure/no tenure system, professors","2","2","0","0","0","0","0","0","0","0","0","0","0","0","0","0","0","0","2","2","0","0","0","0","0","0","0","0","0","0","-2"
"192703","Manhattan College","2015","Not on tenure/no tenure system, associate professors","1","0","1","0","0","0","0","0","0","0","0","0","0","0","0","0","0","0","1","0","1","0","0","0","0","0","0","0","0","0","-2"
"192703","Manhattan College","2015","Not on tenure/no tenure system, assistant professors","17","9","8","0","0","0","0","0","0","2","2","0","0","0","0","0","0","0","14","7","7","0","0","0","0","0","0","1","0","1","-2"
"192703","Manhattan College","2015","Not on tenure/no tenure system, instructors","5","3","2","0","0","0","0","0","0","0","0","0","0","0","0","0","0","0","5","3","2","0","0","0","0","0","0","0","0","0","-2"
"192703","Manhattan College","2015","Not on tenure/no tenure system, lecturers","1","1","0","0","0","0","0","0","0","0","0","0","0","0","0","0","0","0","1","1","0","0","0","0","0","0","0","0","0","0","-2"
"192864","Marymount Manhattan College","2015","Tenured total","59","26","33","0","0","0","3","1","2","0","0","0","1","1","0","0","0","0","53","24","29","0","0","0","2","0","2","0","0","0","-2"
"192864","Marymount Manhattan College","2015","Tenured, professors","19","9","10","0","0","0","1","0","1","0","0","0","0","0","0","0","0","0","18","9","9","0","0","0","0","0","0","0","0","0","-2"
"192864","Marymount Manhattan College","2015","Tenured, associate professors","40","17","23","0","0","0","2","1","1","0","0","0","1","1","0","0","0","0","35","15","20","0","0","0","2","0","2","0","0","0","-2"
"192864","Marymount Manhattan College","2015","On-Tenure track total","31","9","22","0","0","0","4","3","1","0","0","0","0","0","0","0","0","0","3","0","3","1","1","0","23","5","18","0","0","0","-2"
"192864","Marymount Manhattan College","2015","On-tenure track, assistant professors","31","9","22","0","0","0","4","3","1","0","0","0","0","0","0","0","0","0","3","0","3","1","1","0","23","5","18","0","0","0","-2"
"192864","Marymount Manhattan College","2015","Not on tenure track/No tenure system system total","4","1","3","0","0","0","0","0","0","0","0","0","0","0","0","0","0","0","2","1","1","0","0","0","2","0","2","0","0","0","-2"
"192864","Marymount Manhattan College","2015","Not on tenure/no tenure system, instructors","4","1","3","0","0","0","0","0","0","0","0","0","0","0","0","0","0","0","2","1","1","0","0","0","2","0","2","0","0","0","-2"
"193292","Molloy College","2015","Tenured total","121","31","90","0","0","0","4","1","3","9","0","9","5","2","3","0","0","0","102","28","74","1","0","1","0","0","0","0","0","0","-2"
"193292","Molloy College","2015","Tenured, professors","55","16","39","0","0","0","0","0","0","2","0","2","4","2","2","0","0","0","49","14","35","0","0","0","0","0","0","0","0","0","-2"
"193292","Molloy College","2015","Tenured, associate professors","39","10","29","0","0","0","3","1","2","5","0","5","0","0","0","0","0","0","30","9","21","1","0","1","0","0","0","0","0","0","-2"
"193292","Molloy College","2015","Tenured, assistant professors","27","5","22","0","0","0","1","0","1","2","0","2","1","0","1","0","0","0","23","5","18","0","0","0","0","0","0","0","0","0","-2"
"193292","Molloy College","2015","On-Tenure track total","65","13","52","0","0","0","5","0","5","5","1","4","3","2","1","0","0","0","50","9","41","2","1","1","0","0","0","0","0","0","-2"
"193292","Molloy College","2015","On-tenure track, professors","1","0","1","0","0","0","0","0","0","0","0","0","0","0","0","0","0","0","1","0","1","0","0","0","0","0","0","0","0","0","-2"
"193292","Molloy College","2015","On-tenure track, associate professors","11","2","9","0","0","0","1","0","1","0","0","0","1","1","0","0","0","0","9","1","8","0","0","0","0","0","0","0","0","0","-2"
"193292","Molloy College","2015","On-tenure track, assistant professors","45","10","35","0","0","0","3","0","3","5","1","4","1","1","0","0","0","0","34","7","27","2","1","1","0","0","0","0","0","0","-2"
"193292","Molloy College","2015","On-tenure track, instructors","8","1","7","0","0","0","1","0","1","0","0","0","1","0","1","0","0","0","6","1","5","0","0","0","0","0","0","0","0","0","-2"
"193353","Mount Saint Mary College","2015","Tenured total","54","25","29","0","0","0","2","0","2","2","0","2","1","1","0","0","0","0","48","23","25","0","0","0","0","0","0","1","1","0","-2"
"193353","Mount Saint Mary College","2015","Tenured, professors","25","13","12","0","0","0","1","0","1","0","0","0","0","0","0","0","0","0","24","13","11","0","0","0","0","0","0","0","0","0","-2"
"193353","Mount Saint Mary College","2015","Tenured, associate professors","29","12","17","0","0","0","1","0","1","2","0","2","1","1","0","0","0","0","24","10","14","0","0","0","0","0","0","1","1","0","-2"
"193353","Mount Saint Mary College","2015","On-Tenure track total","28","7","21","0","0","0","0","0","0","1","0","1","0","0","0","0","0","0","24","6","18","0","0","0","0","0","0","3","1","2","-2"
"193353","Mount Saint Mary College","2015","On-tenure track, associate professors","1","0","1","0","0","0","0","0","0","0","0","0","0","0","0","0","0","0","1","0","1","0","0","0","0","0","0","0","0","0","-2"
"193353","Mount Saint Mary College","2015","On-tenure track, assistant professors","21","6","15","0","0","0","0","0","0","0","0","0","0","0","0","0","0","0","18","5","13","0","0","0","0","0","0","3","1","2","-2"
"193353","Mount Saint Mary College","2015","On-tenure track, instructors","6","1","5","0","0","0","0","0","0","1","0","1","0","0","0","0","0","0","5","1","4","0","0","0","0","0","0","0","0","0","-2"
"193353","Mount Saint Mary College","2015","Not on tenure track/No tenure system system total","3","3","0","0","0","0","0","0","0","0","0","0","1","1","0","0","0","0","2","2","0","0","0","0","0","0","0","0","0","0","-2"
"193353","Mount Saint Mary College","2015","Not on tenure/no tenure system, assistant professors","3","3","0","0","0","0","0","0","0","0","0","0","1","1","0","0","0","0","2","2","0","0","0","0","0","0","0","0","0","0","-2"
"194091","New York Institute of Technology","2015","Tenured total","162","107","55","1","1","0","29","18","11","4","3","1","2","2","0","0","0","0","126","83","43","0","0","0","0","0","0","0","0","0","-2"
"194091","New York Institute of Technology","2015","Tenured, professors","66","55","11","1","1","0","11","9","2","4","3","1","1","1","0","0","0","0","49","41","8","0","0","0","0","0","0","0","0","0","-2"
"194091","New York Institute of Technology","2015","Tenured, associate professors","86","49","37","0","0","0","17","8","9","0","0","0","0","0","0","0","0","0","69","41","28","0","0","0","0","0","0","0","0","0","-2"
"194091","New York Institute of Technology","2015","Tenured, assistant professors","10","3","7","0","0","0","1","1","0","0","0","0","1","1","0","0","0","0","8","1","7","0","0","0","0","0","0","0","0","0","-2"
"194091","New York Institute of Technology","2015","On-Tenure track total","61","32","29","0","0","0","16","9","7","1","0","1","1","1","0","1","1","0","42","21","21","0","0","0","0","0","0","0","0","0","-2"
"194091","New York Institute of Technology","2015","On-tenure track, associate professors","8","4","4","0","0","0","0","0","0","0","0","0","0","0","0","0","0","0","8","4","4","0","0","0","0","0","0","0","0","0","-2"
"194091","New York Institute of Technology","2015","On-tenure track, assistant professors","53","28","25","0","0","0","16","9","7","1","0","1","1","1","0","1","1","0","34","17","17","0","0","0","0","0","0","0","0","0","-2"
"194091","New York Institute of Technology","2015","Not on tenure track/No tenure system system total","78","47","31","1","1","0","13","8","5","3","1","2","4","2","2","0","0","0","57","35","22","0","0","0","0","0","0","0","0","0","-2"
"194091","New York Institute of Technology","2015","Not on tenure/no tenure system, professors","7","6","1","0","0","0","0","0","0","0","0","0","0","0","0","0","0","0","7","6","1","0","0","0","0","0","0","0","0","0","-2"
"194091","New York Institute of Technology","2015","Not on tenure/no tenure system, associate professors","17","16","1","0","0","0","3","3","0","1","1","0","0","0","0","0","0","0","13","12","1","0","0","0","0","0","0","0","0","0","-2"
"194091","New York Institute of Technology","2015","Not on tenure/no tenure system, assistant professors","48","22","26","1","1","0","7","3","4","2","0","2","4","2","2","0","0","0","34","16","18","0","0","0","0","0","0","0","0","0","-2"
"194091","New York Institute of Technology","2015","Not on tenure/no tenure system, instructors","6","3","3","0","0","0","3","2","1","0","0","0","0","0","0","0","0","0","3","1","2","0","0","0","0","0","0","0","0","0","-2"
"195243","St. Thomas Aquinas College","2015","Tenured total","33","19","14","0","0","0","1","0","1","1","1","0","1","1","0","0","0","0","30","17","13","0","0","0","0","0","0","0","0","0","-2"
"195243","St. Thomas Aquinas College","2015","Tenured, professors","23","10","13","0","0","0","1","0","1","0","0","0","1","1","0","0","0","0","21","9","12","0","0","0","0","0","0","0","0","0","-2"
"195243","St. Thomas Aquinas College","2015","Tenured, associate professors","8","8","0","0","0","0","0","0","0","0","0","0","0","0","0","0","0","0","8","8","0","0","0","0","0","0","0","0","0","0","-2"
"195243","St. Thomas Aquinas College","2015","Tenured, assistant professors","2","1","1","0","0","0","0","0","0","1","1","0","0","0","0","0","0","0","1","0","1","0","0","0","0","0","0","0","0","0","-2"
"195243","St. Thomas Aquinas College","2015","On-Tenure track total","17","3","14","0","0","0","0","0","0","0","0","0","0","0","0","0","0","0","17","3","14","0","0","0","0","0","0","0","0","0","-2"
"195243","St. Thomas Aquinas College","2015","On-tenure track, assistant professors","17","3","14","0","0","0","0","0","0","0","0","0","0","0","0","0","0","0","17","3","14","0","0","0","0","0","0","0","0","0","-2"
"195243","St. Thomas Aquinas College","2015","Not on tenure track/No tenure system system total","5","2","3","0","0","0","0","0","0","0","0","0","0","0","0","0","0","0","5","2","3","0","0","0","0","0","0","0","0","0","-2"
"195243","St. Thomas Aquinas College","2015","Not on tenure/no tenure system, assistant professors","1","1","0","0","0","0","0","0","0","0","0","0","0","0","0","0","0","0","1","1","0","0","0","0","0","0","0","0","0","0","-2"
"195243","St. Thomas Aquinas College","2015","Not on tenure/no tenure system, instructors","4","1","3","0","0","0","0","0","0","0","0","0","0","0","0","0","0","0","4","1","3","0","0","0","0","0","0","0","0","0","-2"
"196024","SUNY College of Technology at Delhi","2015","Tenured total","57","35","22","0","0","0","2","1","1","2","0","2","1","1","0","0","0","0","52","33","19","0","0","0","0","0","0","0","0","0","-2"
"196024","SUNY College of Technology at Delhi","2015","Tenured, professors","25","17","8","0","0","0","0","0","0","0","0","0","0","0","0","0","0","0","25","17","8","0","0","0","0","0","0","0","0","0","-2"
"196024","SUNY College of Technology at Delhi","2015","Tenured, associate professors","16","9","7","0","0","0","1","0","1","0","0","0","1","1","0","0","0","0","14","8","6","0","0","0","0","0","0","0","0","0","-2"
"196024","SUNY College of Technology at Delhi","2015","Tenured, assistant professors","10","4","6","0","0","0","0","0","0","2","0","2","0","0","0","0","0","0","8","4","4","0","0","0","0","0","0","0","0","0","-2"
"196024","SUNY College of Technology at Delhi","2015","Tenured, instructors","6","5","1","0","0","0","1","1","0","0","0","0","0","0","0","0","0","0","5","4","1","0","0","0","0","0","0","0","0","0","-2"
"196024","SUNY College of Technology at Delhi","2015","On-Tenure track total","73","33","40","0","0","0","2","1","1","2","2","0","1","1","0","0","0","0","68","29","39","0","0","0","0","0","0","0","0","0","-2"
"196024","SUNY College of Technology at Delhi","2015","On-tenure track, associate professors","10","4","6","0","0","0","0","0","0","1","1","0","0","0","0","0","0","0","9","3","6","0","0","0","0","0","0","0","0","0","-2"
"196024","SUNY College of Technology at Delhi","2015","On-tenure track, assistant professors","47","20","27","0","0","0","2","1","1","1","1","0","1","1","0","0","0","0","43","17","26","0","0","0","0","0","0","0","0","0","-2"
"196024","SUNY College of Technology at Delhi","2015","On-tenure track, instructors","16","9","7","0","0","0","0","0","0","0","0","0","0","0","0","0","0","0","16","9","7","0","0","0","0","0","0","0","0","0","-2"
"196024","SUNY College of Technology at Delhi","2015","Not on tenure track/No tenure system system total","19","8","11","0","0","0","1","0","1","0","0","0","0","0","0","0","0","0","18","8","10","0","0","0","0","0","0","0","0","0","-2"
"196024","SUNY College of Technology at Delhi","2015","Not on tenure/no tenure system, associate professors","1","0","1","0","0","0","0","0","0","0","0","0","0","0","0","0","0","0","1","0","1","0","0","0","0","0","0","0","0","0","-2"
"196024","SUNY College of Technology at Delhi","2015","Not on tenure/no tenure system, instructors","18","8","10","0","0","0","1","0","1","0","0","0","0","0","0","0","0","0","17","8","9","0","0","0","0","0","0","0","0","0","-2"
"196042","Farmingdale State College","2015","Tenured total","100","55","45","0","0","0","6","5","1","4","2","2","5","3","2","0","0","0","85","45","40","0","0","0","0","0","0","0","0","0","-2"
"196042","Farmingdale State College","2015","Tenured, professors","51","30","21","0","0","0","5","4","1","1","1","0","2","1","1","0","0","0","43","24","19","0","0","0","0","0","0","0","0","0","-2"
"196042","Farmingdale State College","2015","Tenured, associate professors","38","18","20","0","0","0","1","1","0","1","1","0","2","1","1","0","0","0","34","15","19","0","0","0","0","0","0","0","0","0","-2"
"196042","Farmingdale State College","2015","Tenured, assistant professors","11","7","4","0","0","0","0","0","0","2","0","2","1","1","0","0","0","0","8","6","2","0","0","0","0","0","0","0","0","0","-2"
"196042","Farmingdale State College","2015","On-Tenure track total","83","42","41","0","0","0","20","12","8","4","1","3","4","3","1","0","0","0","51","22","29","1","1","0","0","0","0","3","3","0","-2"
"196042","Farmingdale State College","2015","On-tenure track, professors","2","1","1","0","0","0","1","0","1","0","0","0","0","0","0","0","0","0","1","1","0","0","0","0","0","0","0","0","0","0","-2"
"196042","Farmingdale State College","2015","On-tenure track, associate professors","12","4","8","0","0","0","3","2","1","0","0","0","0","0","0","0","0","0","8","1","7","0","0","0","0","0","0","1","1","0","-2"
"196042","Farmingdale State College","2015","On-tenure track, assistant professors","69","37","32","0","0","0","16","10","6","4","1","3","4","3","1","0","0","0","42","20","22","1","1","0","0","0","0","2","2","0","-2"
"196042","Farmingdale State College","2015","Not on tenure track/No tenure system system total","28","13","15","0","0","0","2","2","0","3","1","2","0","0","0","0","0","0","23","10","13","0","0","0","0","0","0","0","0","0","-2"
"196042","Farmingdale State College","2015","Not on tenure/no tenure system, assistant professors","22","10","12","0","0","0","2","2","0","2","1","1","0","0","0","0","0","0","18","7","11","0","0","0","0","0","0","0","0","0","-2"
"196042","Farmingdale State College","2015","Not on tenure/no tenure system, lecturers","6","3","3","0","0","0","0","0","0","1","0","1","0","0","0","0","0","0","5","3","2","0","0","0","0","0","0","0","0","0","-2"
"196176","State University of New York at New Paltz","2015","Tenured total","192","112","80","0","0","0","18","12","6","8","8","0","8","5","3","0","0","0","158","87","71","0","0","0","0","0","0","0","0","0","-2"
"196176","State University of New York at New Paltz","2015","Tenured, professors","48","31","17","0","0","0","8","6","2","2","2","0","1","1","0","0","0","0","37","22","15","0","0","0","0","0","0","0","0","0","-2"
"196176","State University of New York at New Paltz","2015","Tenured, associate professors","136","78","58","0","0","0","10","6","4","5","5","0","7","4","3","0","0","0","114","63","51","0","0","0","0","0","0","0","0","0","-2"
"196176","State University of New York at New Paltz","2015","Tenured, assistant professors","5","3","2","0","0","0","0","0","0","1","1","0","0","0","0","0","0","0","4","2","2","0","0","0","0","0","0","0","0","0","-2"
"196176","State University of New York at New Paltz","2015","Tenured, instructors","3","0","3","0","0","0","0","0","0","0","0","0","0","0","0","0","0","0","3","0","3","0","0","0","0","0","0","0","0","0","-2"
"196176","State University of New York at New Paltz","2015","On-Tenure track total","100","37","63","0","0","0","10","7","3","4","2","2","7","3","4","0","0","0","68","21","47","2","0","2","0","0","0","9","4","5","-2"
"196176","State University of New York at New Paltz","2015","On-tenure track, associate professors","9","2","7","0","0","0","1","1","0","0","0","0","1","1","0","0","0","0","7","0","7","0","0","0","0","0","0","0","0","0","-2"
"196176","State University of New York at New Paltz","2015","On-tenure track, assistant professors","85","35","50","0","0","0","9","6","3","4","2","2","5","2","3","0","0","0","56","21","35","2","0","2","0","0","0","9","4","5","-2"
"196176","State University of New York at New Paltz","2015","On-tenure track, instructors","6","0","6","0","0","0","0","0","0","0","0","0","1","0","1","0","0","0","5","0","5","0","0","0","0","0","0","0","0","0","-2"
"196176","State University of New York at New Paltz","2015","Not on tenure track/No tenure system system total","68","27","41","0","0","0","4","3","1","2","0","2","4","1","3","0","0","0","54","20","34","0","0","0","0","0","0","4","3","1","-2"
"196176","State University of New York at New Paltz","2015","Not on tenure/no tenure system, associate professors","1","1","0","0","0","0","0","0","0","0","0","0","0","0","0","0","0","0","1","1","0","0","0","0","0","0","0","0","0","0","-2"
"196176","State University of New York at New Paltz","2015","Not on tenure/no tenure system, assistant professors","7","3","4","0","0","0","1","1","0","1","0","1","0","0","0","0","0","0","3","1","2","0","0","0","0","0","0","2","1","1","-2"
"196176","State University of New York at New Paltz","2015","Not on tenure/no tenure system, lecturers","60","23","37","0","0","0","3","2","1","1","0","1","4","1","3","0","0","0","50","18","32","0","0","0","0","0","0","2","2","0","-2"
"197230","Wells College","2015","Tenured total","24","11","13","0","0","0","0","0","0","1","1","0","1","0","1","2","1","1","19","8","11","0","0","0","1","1","0","0","0","0","-2"
"197230","Wells College","2015","Tenured, professors","16","8","8","0","0","0","0","0","0","1","1","0","1","0","1","1","1","0","12","5","7","0","0","0","1","1","0","0","0","0","-2"
"197230","Wells College","2015","Tenured, associate professors","8","3","5","0","0","0","0","0","0","0","0","0","0","0","0","1","0","1","7","3","4","0","0","0","0","0","0","0","0","0","-2"
"197230","Wells College","2015","On-Tenure track total","8","2","6","0","0","0","0","0","0","0","0","0","1","1","0","1","1","0","6","0","6","0","0","0","0","0","0","0","0","0","-2"
"197230","Wells College","2015","On-tenure track, assistant professors","8","2","6","0","0","0","0","0","0","0","0","0","1","1","0","1","1","0","6","0","6","0","0","0","0","0","0","0","0","0","-2"
"197230","Wells College","2015","Not on tenure track/No tenure system system total","4","2","2","0","0","0","0","0","0","0","0","0","1","0","1","0","0","0","2","2","0","0","0","0","0","0","0","1","0","1","-2"
"197230","Wells College","2015","Not on tenure/no tenure system, assistant professors","2","1","1","0","0","0","0","0","0","0","0","0","0","0","0","0","0","0","1","1","0","0","0","0","0","0","0","1","0","1","-2"
"197230","Wells College","2015","Not on tenure/no tenure system, instructors","1","0","1","0","0","0","0","0","0","0","0","0","1","0","1","0","0","0","0","0","0","0","0","0","0","0","0","0","0","0","-2"
"197230","Wells College","2015","Not on tenure/no tenure system, lecturers","1","1","0","0","0","0","0","0","0","0","0","0","0","0","0","0","0","0","1","1","0","0","0","0","0","0","0","0","0","0","-2"
"199607","Salem College","2015","Tenured total","22","8","14","0","0","0","1","1","0","0","0","0","0","0","0","0","0","0","21","7","14","0","0","0","0","0","0","0","0","0","-2"
"199607","Salem College","2015","Tenured, professors","7","1","6","0","0","0","0","0","0","0","0","0","0","0","0","0","0","0","7","1","6","0","0","0","0","0","0","0","0","0","-2"
"199607","Salem College","2015","Tenured, associate professors","14","6","8","0","0","0","1","1","0","0","0","0","0","0","0","0","0","0","13","5","8","0","0","0","0","0","0","0","0","0","-2"
"199607","Salem College","2015","Tenured, assistant professors","1","1","0","0","0","0","0","0","0","0","0","0","0","0","0","0","0","0","1","1","0","0","0","0","0","0","0","0","0","0","-2"
"199607","Salem College","2015","On-Tenure track total","18","2","16","0","0","0","0","0","0","2","0","2","2","0","2","0","0","0","14","2","12","0","0","0","0","0","0","0","0","0","-2"
"199607","Salem College","2015","On-tenure track, associate professors","2","0","2","0","0","0","0","0","0","0","0","0","0","0","0","0","0","0","2","0","2","0","0","0","0","0","0","0","0","0","-2"
"199607","Salem College","2015","On-tenure track, assistant professors","16","2","14","0","0","0","0","0","0","2","0","2","2","0","2","0","0","0","12","2","10","0","0","0","0","0","0","0","0","0","-2"
"199607","Salem College","2015","Not on tenure track/No tenure system system total","23","4","19","0","0","0","1","0","1","3","0","3","0","0","0","0","0","0","19","4","15","0","0","0","0","0","0","0","0","0","-2"
"199607","Salem College","2015","Not on tenure/no tenure system, associate professors","3","1","2","0","0","0","0","0","0","0","0","0","0","0","0","0","0","0","3","1","2","0","0","0","0","0","0","0","0","0","-2"
"199607","Salem College","2015","Not on tenure/no tenure system, assistant professors","17","3","14","0","0","0","1","0","1","2","0","2","0","0","0","0","0","0","14","3","11","0","0","0","0","0","0","0","0","0","-2"
"199607","Salem College","2015","Not on tenure/no tenure system, instructors","2","0","2","0","0","0","0","0","0","1","0","1","0","0","0","0","0","0","1","0","1","0","0","0","0","0","0","0","0","0","-2"
"199607","Salem College","2015","Not on tenure/no tenure system, no academic rank","1","0","1","0","0","0","0","0","0","0","0","0","0","0","0","0","0","0","1","0","1","0","0","0","0","0","0","0","0","0","-2"
"205027","Pontifical College Josephinum","2015","Not on tenure track/No tenure system system total","24","20","4","0","0","0","0","0","0","0","0","0","1","1","0","0","0","0","23","19","4","0","0","0","0","0","0","0","0","0","-2"
"205027","Pontifical College Josephinum","2015","Not on tenure/no tenure system, professors","7","6","1","0","0","0","0","0","0","0","0","0","0","0","0","0","0","0","7","6","1","0","0","0","0","0","0","0","0","0","-2"
"205027","Pontifical College Josephinum","2015","Not on tenure/no tenure system, associate professors","7","7","0","0","0","0","0","0","0","0","0","0","1","1","0","0","0","0","6","6","0","0","0","0","0","0","0","0","0","0","-2"
"205027","Pontifical College Josephinum","2015","Not on tenure/no tenure system, assistant professors","9","7","2","0","0","0","0","0","0","0","0","0","0","0","0","0","0","0","9","7","2","0","0","0","0","0","0","0","0","0","-2"
"205027","Pontifical College Josephinum","2015","Not on tenure/no tenure system, instructors","1","0","1","0","0","0","0","0","0","0","0","0","0","0","0","0","0","0","1","0","1","0","0","0","0","0","0","0","0","0","-2"
"206862","Southern Nazarene University","2015","Not on tenure track/No tenure system system total","72","36","36","3","2","1","1","1","0","0","0","0","0","0","0","0","0","0","68","33","35","0","0","0","0","0","0","0","0","0","-2"
"206862","Southern Nazarene University","2015","Not on tenure/no tenure system, professors","32","17","15","2","1","1","1","1","0","0","0","0","0","0","0","0","0","0","29","15","14","0","0","0","0","0","0","0","0","0","-2"
"206862","Southern Nazarene University","2015","Not on tenure/no tenure system, associate professors","14","7","7","0","0","0","0","0","0","0","0","0","0","0","0","0","0","0","14","7","7","0","0","0","0","0","0","0","0","0","-2"
"206862","Southern Nazarene University","2015","Not on tenure/no tenure system, assistant professors","23","9","14","1","1","0","0","0","0","0","0","0","0","0","0","0","0","0","22","8","14","0","0","0","0","0","0","0","0","0","-2"
"206862","Southern Nazarene University","2015","Not on tenure/no tenure system, instructors","2","2","0","0","0","0","0","0","0","0","0","0","0","0","0","0","0","0","2","2","0","0","0","0","0","0","0","0","0","0","-2"
"206862","Southern Nazarene University","2015","Not on tenure/no tenure system, no academic rank","1","1","0","0","0","0","0","0","0","0","0","0","0","0","0","0","0","0","1","1","0","0","0","0","0","0","0","0","0","0","-2"
"207157","Randall University","2015","Not on tenure track/No tenure system system total","23","13","10","3","2","1","0","0","0","1","1","0","1","1","0","0","0","0","10","5","5","6","3","3","2","1","1","0","0","0","-2"
"207157","Randall University","2015","Not on tenure/no tenure system, no academic rank","23","13","10","3","2","1","0","0","0","1","1","0","1","1","0","0","0","0","10","5","5","6","3","3","2","1","1","0","0","0","-2"
"207397","Oklahoma State University-Oklahoma City","2015","Tenured total","45","19","26","1","0","1","0","0","0","1","1","0","2","1","1","0","0","0","41","17","24","0","0","0","0","0","0","0","0","0","-2"
"207397","Oklahoma State University-Oklahoma City","2015","Tenured, professors","10","6","4","0","0","0","0","0","0","0","0","0","1","1","0","0","0","0","9","5","4","0","0","0","0","0","0","0","0","0","-2"
"207397","Oklahoma State University-Oklahoma City","2015","Tenured, associate professors","33","11","22","1","0","1","0","0","0","1","1","0","1","0","1","0","0","0","30","10","20","0","0","0","0","0","0","0","0","0","-2"
"207397","Oklahoma State University-Oklahoma City","2015","Tenured, instructors","2","2","0","0","0","0","0","0","0","0","0","0","0","0","0","0","0","0","2","2","0","0","0","0","0","0","0","0","0","0","-2"
"207397","Oklahoma State University-Oklahoma City","2015","On-Tenure track total","34","11","23","0","0","0","1","0","1","2","0","2","1","1","0","0","0","0","28","9","19","1","0","1","0","0","0","1","1","0","-2"
"207397","Oklahoma State University-Oklahoma City","2015","On-tenure track, assistant professors","8","3","5","0","0","0","0","0","0","0","0","0","1","1","0","0","0","0","6","1","5","0","0","0","0","0","0","1","1","0","-2"
"207397","Oklahoma State University-Oklahoma City","2015","On-tenure track, instructors","26","8","18","0","0","0","1","0","1","2","0","2","0","0","0","0","0","0","22","8","14","1","0","1","0","0","0","0","0","0","-2"
"207397","Oklahoma State University-Oklahoma City","2015","Not on tenure track/No tenure system system total","6","1","5","0","0","0","0","0","0","0","0","0","0","0","0","0","0","0","6","1","5","0","0","0","0","0","0","0","0","0","-2"
"207397","Oklahoma State University-Oklahoma City","2015","Not on tenure/no tenure system, lecturers","3","1","2","0","0","0","0","0","0","0","0","0","0","0","0","0","0","0","3","1","2","0","0","0","0","0","0","0","0","0","-2"
"207397","Oklahoma State University-Oklahoma City","2015","Not on tenure/no tenure system, no academic rank","3","0","3","0","0","0","0","0","0","0","0","0","0","0","0","0","0","0","3","0","3","0","0","0","0","0","0","0","0","0","-2"
"209065","Linfield University-McMinnville Campus","2015","Tenured total","99","50","49","1","0","1","4","2","2","1","1","0","3","1","2","0","0","0","90","46","44","0","0","0","0","0","0","0","0","0","209065"
"209065","Linfield University-McMinnville Campus","2015","Tenured, professors","57","31","26","1","0","1","2","1","1","1","1","0","1","1","0","0","0","0","52","28","24","0","0","0","0","0","0","0","0","0","209065"
"209065","Linfield University-McMinnville Campus","2015","Tenured, associate professors","37","16","21","0","0","0","1","0","1","0","0","0","2","0","2","0","0","0","34","16","18","0","0","0","0","0","0","0","0","0","209065"
"209065","Linfield University-McMinnville Campus","2015","Tenured, assistant professors","5","3","2","0","0","0","1","1","0","0","0","0","0","0","0","0","0","0","4","2","2","0","0","0","0","0","0","0","0","0","209065"
"209065","Linfield University-McMinnville Campus","2015","On-Tenure track total","33","11","22","0","0","0","3","1","2","1","0","1","2","0","2","0","0","0","27","10","17","0","0","0","0","0","0","0","0","0","209065"
"209065","Linfield University-McMinnville Campus","2015","On-tenure track, professors","2","0","2","0","0","0","0","0","0","0","0","0","0","0","0","0","0","0","2","0","2","0","0","0","0","0","0","0","0","0","209065"
"209065","Linfield University-McMinnville Campus","2015","On-tenure track, associate professors","2","1","1","0","0","0","0","0","0","0","0","0","0","0","0","0","0","0","2","1","1","0","0","0","0","0","0","0","0","0","209065"
"209065","Linfield University-McMinnville Campus","2015","On-tenure track, assistant professors","29","10","19","0","0","0","3","1","2","1","0","1","2","0","2","0","0","0","23","9","14","0","0","0","0","0","0","0","0","0","209065"
"209065","Linfield University-McMinnville Campus","2015","Not on tenure track/No tenure system system total","26","8","18","1","0","1","1","0","1","0","0","0","1","0","1","0","0","0","19","7","12","1","0","1","3","1","2","0","0","0","209065"
"209065","Linfield University-McMinnville Campus","2015","Not on tenure/no tenure system, professors","5","0","5","0","0","0","0","0","0","0","0","0","1","0","1","0","0","0","2","0","2","1","0","1","1","0","1","0","0","0","209065"
"209065","Linfield University-McMinnville Campus","2015","Not on tenure/no tenure system, associate professors","2","1","1","1","0","1","0","0","0","0","0","0","0","0","0","0","0","0","1","1","0","0","0","0","0","0","0","0","0","0","209065"
"209065","Linfield University-McMinnville Campus","2015","Not on tenure/no tenure system, assistant professors","19","7","12","0","0","0","1","0","1","0","0","0","0","0","0","0","0","0","16","6","10","0","0","0","2","1","1","0","0","0","209065"
"209287","Multnomah University","2015","Tenured total","3","3","0","0","0","0","0","0","0","0","0","0","0","0","0","0","0","0","3","3","0","0","0","0","0","0","0","0","0","0","-2"
"209287","Multnomah University","2015","Tenured, professors","3","3","0","0","0","0","0","0","0","0","0","0","0","0","0","0","0","0","3","3","0","0","0","0","0","0","0","0","0","0","-2"
"209287","Multnomah University","2015","Not on tenure track/No tenure system system total","24","16","8","0","0","0","1","0","1","1","0","1","0","0","0","0","0","0","22","16","6","0","0","0","0","0","0","0","0","0","-2"
"209287","Multnomah University","2015","Not on tenure/no tenure system, professors","5","5","0","0","0","0","0","0","0","0","0","0","0","0","0","0","0","0","5","5","0","0","0","0","0","0","0","0","0","0","-2"
"209287","Multnomah University","2015","Not on tenure/no tenure system, associate professors","4","3","1","0","0","0","0","0","0","0","0","0","0","0","0","0","0","0","4","3","1","0","0","0","0","0","0","0","0","0","-2"
"209287","Multnomah University","2015","Not on tenure/no tenure system, assistant professors","15","8","7","0","0","0","1","0","1","1","0","1","0","0","0","0","0","0","13","8","5","0","0","0","0","0","0","0","0","0","-2"
"209490","Oregon Health & Science University","2015","Tenured total","96","62","34","0","0","0","11","7","4","0","0","0","1","1","0","0","0","0","77","50","27","0","0","0","6","3","3","1","1","0","-2"
"209490","Oregon Health & Science University","2015","Tenured, professors","67","48","19","0","0","0","7","4","3","0","0","0","1","1","0","0","0","0","54","40","14","0","0","0","5","3","2","0","0","0","-2"
"209490","Oregon Health & Science University","2015","Tenured, associate professors","28","13","15","0","0","0","4","3","1","0","0","0","0","0","0","0","0","0","23","10","13","0","0","0","1","0","1","0","0","0","-2"
"209490","Oregon Health & Science University","2015","Tenured, assistant professors","1","1","0","0","0","0","0","0","0","0","0","0","0","0","0","0","0","0","0","0","0","0","0","0","0","0","0","1","1","0","-2"
"209490","Oregon Health & Science University","2015","On-Tenure track total","46","21","25","0","0","0","6","3","3","2","1","1","2","0","2","0","0","0","27","11","16","0","0","0","5","3","2","4","3","1","-2"
"209490","Oregon Health & Science University","2015","On-tenure track, professors","3","1","2","0","0","0","0","0","0","0","0","0","0","0","0","0","0","0","3","1","2","0","0","0","0","0","0","0","0","0","-2"
"209490","Oregon Health & Science University","2015","On-tenure track, associate professors","14","9","5","0","0","0","5","3","2","1","1","0","0","0","0","0","0","0","6","4","2","0","0","0","2","1","1","0","0","0","-2"
"209490","Oregon Health & Science University","2015","On-tenure track, assistant professors","26","11","15","0","0","0","1","0","1","1","0","1","2","0","2","0","0","0","16","6","10","0","0","0","2","2","0","4","3","1","-2"
"209490","Oregon Health & Science University","2015","On-tenure track, instructors","3","0","3","0","0","0","0","0","0","0","0","0","0","0","0","0","0","0","2","0","2","0","0","0","1","0","1","0","0","0","-2"
"209490","Oregon Health & Science University","2015","Not on tenure track/No tenure system system total","1304","591","713","2","0","2","153","83","70","15","9","6","42","23","19","2","0","2","925","398","527","12","5","7","127","58","69","26","15","11","-2"
"209490","Oregon Health & Science University","2015","Not on tenure/no tenure system, professors","117","87","30","0","0","0","14","11","3","0","0","0","3","3","0","0","0","0","96","69","27","0","0","0","4","4","0","0","0","0","-2"
"209490","Oregon Health & Science University","2015","Not on tenure/no tenure system, associate professors","242","137","105","1","0","1","31","17","14","2","2","0","12","11","1","0","0","0","178","96","82","1","1","0","15","9","6","2","1","1","-2"
"209490","Oregon Health & Science University","2015","Not on tenure/no tenure system, assistant professors","563","254","309","1","0","1","79","42","37","8","5","3","13","4","9","0","0","0","368","163","205","7","2","5","75","32","43","12","6","6","-2"
"209490","Oregon Health & Science University","2015","Not on tenure/no tenure system, instructors","375","113","262","0","0","0","29","13","16","5","2","3","14","5","9","2","0","2","277","70","207","3","2","1","33","13","20","12","8","4","-2"
"209490","Oregon Health & Science University","2015","Not on tenure/no tenure system, lecturers","7","0","7","0","0","0","0","0","0","0","0","0","0","0","0","0","0","0","6","0","6","1","0","1","0","0","0","0","0","0","-2"
"209612","Pacific University","2015","Tenured total","125","69","56","0","0","0","8","2","6","0","0","0","3","1","2","0","0","0","113","65","48","1","1","0","0","0","0","0","0","0","-2"
"209612","Pacific University","2015","Tenured, professors","62","39","23","0","0","0","1","0","1","0","0","0","1","0","1","0","0","0","60","39","21","0","0","0","0","0","0","0","0","0","-2"
"209612","Pacific University","2015","Tenured, associate professors","63","30","33","0","0","0","7","2","5","0","0","0","2","1","1","0","0","0","53","26","27","1","1","0","0","0","0","0","0","0","-2"
"209612","Pacific University","2015","On-Tenure track total","67","22","45","1","0","1","11","3","8","1","0","1","4","1","3","1","1","0","45","15","30","2","1","1","1","0","1","1","1","0","-2"
"209612","Pacific University","2015","On-tenure track, associate professors","7","2","5","0","0","0","1","1","0","1","0","1","0","0","0","0","0","0","5","1","4","0","0","0","0","0","0","0","0","0","-2"
"209612","Pacific University","2015","On-tenure track, assistant professors","60","20","40","1","0","1","10","2","8","0","0","0","4","1","3","1","1","0","40","14","26","2","1","1","1","0","1","1","1","0","-2"
"209612","Pacific University","2015","Not on tenure track/No tenure system system total","94","42","52","0","0","0","6","2","4","1","0","1","4","2","2","0","0","0","81","36","45","2","2","0","0","0","0","0","0","0","-2"
"209612","Pacific University","2015","Not on tenure/no tenure system, professors","3","3","0","0","0","0","0","0","0","0","0","0","0","0","0","0","0","0","3","3","0","0","0","0","0","0","0","0","0","0","-2"
"209612","Pacific University","2015","Not on tenure/no tenure system, associate professors","14","6","8","0","0","0","2","0","2","0","0","0","0","0","0","0","0","0","11","5","6","1","1","0","0","0","0","0","0","0","-2"
"209612","Pacific University","2015","Not on tenure/no tenure system, assistant professors","63","26","37","0","0","0","4","2","2","1","0","1","2","0","2","0","0","0","55","23","32","1","1","0","0","0","0","0","0","0","-2"
"209612","Pacific University","2015","Not on tenure/no tenure system, instructors","14","7","7","0","0","0","0","0","0","0","0","0","2","2","0","0","0","0","12","5","7","0","0","0","0","0","0","0","0","0","-2"
"209807","Portland State University","2015","Tenured total","403","258","145","5","2","3","42","28","14","7","6","1","20","14","6","0","0","0","291","185","106","5","3","2","33","20","13","0","0","0","-2"
"209807","Portland State University","2015","Tenured, professors","234","166","68","3","1","2","26","20","6","3","3","0","8","5","3","0","0","0","172","123","49","1","1","0","21","13","8","0","0","0","-2"
"209807","Portland State University","2015","Tenured, associate professors","168","91","77","2","1","1","16","8","8","4","3","1","12","9","3","0","0","0","118","61","57","4","2","2","12","7","5","0","0","0","-2"
"209807","Portland State University","2015","Tenured, assistant professors","1","1","0","0","0","0","0","0","0","0","0","0","0","0","0","0","0","0","1","1","0","0","0","0","0","0","0","0","0","0","-2"
"209807","Portland State University","2015","On-Tenure track total","174","87","87","0","0","0","17","9","8","4","3","1","17","5","12","0","0","0","112","55","57","3","2","1","21","13","8","0","0","0","-2"
"209807","Portland State University","2015","On-tenure track, professors","2","0","2","0","0","0","1","0","1","0","0","0","0","0","0","0","0","0","1","0","1","0","0","0","0","0","0","0","0","0","-2"
"209807","Portland State University","2015","On-tenure track, associate professors","12","10","2","0","0","0","2","2","0","1","0","1","0","0","0","0","0","0","8","7","1","0","0","0","1","1","0","0","0","0","-2"
"209807","Portland State University","2015","On-tenure track, assistant professors","160","77","83","0","0","0","14","7","7","3","3","0","17","5","12","0","0","0","103","48","55","3","2","1","20","12","8","0","0","0","-2"
"209807","Portland State University","2015","Not on tenure track/No tenure system system total","260","107","153","2","0","2","11","5","6","9","3","6","12","4","8","0","0","0","201","81","120","7","2","5","18","12","6","0","0","0","-2"
"209807","Portland State University","2015","Not on tenure/no tenure system, professors","5","3","2","0","0","0","1","1","0","0","0","0","0","0","0","0","0","0","4","2","2","0","0","0","0","0","0","0","0","0","-2"
"209807","Portland State University","2015","Not on tenure/no tenure system, associate professors","23","10","13","0","0","0","1","1","0","1","1","0","0","0","0","0","0","0","21","8","13","0","0","0","0","0","0","0","0","0","-2"
"209807","Portland State University","2015","Not on tenure/no tenure system, assistant professors","67","30","37","0","0","0","3","1","2","3","0","3","6","0","6","0","0","0","46","22","24","2","0","2","7","7","0","0","0","0","-2"
"209807","Portland State University","2015","Not on tenure/no tenure system, instructors","158","59","99","2","0","2","5","1","4","5","2","3","5","3","2","0","0","0","126","47","79","5","2","3","10","4","6","0","0","0","-2"
"209807","Portland State University","2015","Not on tenure/no tenure system, no academic rank","7","5","2","0","0","0","1","1","0","0","0","0","1","1","0","0","0","0","4","2","2","0","0","0","1","1","0","0","0","0","-2"
"210429","Western Oregon University","2015","Tenured total","135","72","63","0","0","0","4","1","3","4","2","2","4","1","3","0","0","0","117","65","52","0","0","0","2","2","0","4","1","3","-2"
"210429","Western Oregon University","2015","Tenured, professors","93","54","39","0","0","0","3","1","2","2","1","1","3","1","2","0","0","0","83","49","34","0","0","0","2","2","0","0","0","0","-2"
"210429","Western Oregon University","2015","Tenured, associate professors","42","18","24","0","0","0","1","0","1","2","1","1","1","0","1","0","0","0","34","16","18","0","0","0","0","0","0","4","1","3","-2"
"210429","Western Oregon University","2015","On-Tenure track total","29","9","20","0","0","0","0","0","0","0","0","0","2","2","0","0","0","0","23","6","17","0","0","0","1","0","1","3","1","2","-2"
"210429","Western Oregon University","2015","On-tenure track, associate professors","1","0","1","0","0","0","0","0","0","0","0","0","0","0","0","0","0","0","1","0","1","0","0","0","0","0","0","0","0","0","-2"
"210429","Western Oregon University","2015","On-tenure track, assistant professors","28","9","19","0","0","0","0","0","0","0","0","0","2","2","0","0","0","0","22","6","16","0","0","0","1","0","1","3","1","2","-2"
"210429","Western Oregon University","2015","Not on tenure track/No tenure system system total","109","54","55","0","0","0","6","2","4","0","0","0","8","2","6","1","1","0","87","44","43","2","0","2","4","4","0","1","1","0","-2"
"210429","Western Oregon University","2015","Not on tenure/no tenure system, assistant professors","37","19","18","0","0","0","3","0","3","0","0","0","2","1","1","0","0","0","28","14","14","0","0","0","3","3","0","1","1","0","-2"
"210429","Western Oregon University","2015","Not on tenure/no tenure system, instructors","63","34","29","0","0","0","3","2","1","0","0","0","6","1","5","1","1","0","51","29","22","1","0","1","1","1","0","0","0","0","-2"
"210429","Western Oregon University","2015","Not on tenure/no tenure system, lecturers","9","1","8","0","0","0","0","0","0","0","0","0","0","0","0","0","0","0","8","1","7","1","0","1","0","0","0","0","0","0","-2"
"210571","Albright College","2015","Tenured total","62","37","25","1","1","0","2","1","1","3","0","3","3","2","1","0","0","0","51","31","20","0","0","0","2","2","0","0","0","0","-2"
"210571","Albright College","2015","Tenured, professors","23","15","8","1","1","0","1","1","0","0","0","0","2","2","0","0","0","0","17","9","8","0","0","0","2","2","0","0","0","0","-2"
"210571","Albright College","2015","Tenured, associate professors","39","22","17","0","0","0","1","0","1","3","0","3","1","0","1","0","0","0","34","22","12","0","0","0","0","0","0","0","0","0","-2"
"210571","Albright College","2015","On-Tenure track total","20","12","8","0","0","0","2","1","1","0","0","0","0","0","0","0","0","0","18","11","7","0","0","0","0","0","0","0","0","0","-2"
"210571","Albright College","2015","On-tenure track, assistant professors","20","12","8","0","0","0","2","1","1","0","0","0","0","0","0","0","0","0","18","11","7","0","0","0","0","0","0","0","0","0","-2"
"210571","Albright College","2015","Not on tenure track/No tenure system system total","33","8","25","0","0","0","2","0","2","0","0","0","1","0","1","0","0","0","27","8","19","0","0","0","2","0","2","1","0","1","-2"
"210571","Albright College","2015","Not on tenure/no tenure system, associate professors","3","2","1","0","0","0","0","0","0","0","0","0","0","0","0","0","0","0","3","2","1","0","0","0","0","0","0","0","0","0","-2"
"210571","Albright College","2015","Not on tenure/no tenure system, assistant professors","9","2","7","0","0","0","0","0","0","0","0","0","0","0","0","0","0","0","9","2","7","0","0","0","0","0","0","0","0","0","-2"
"210571","Albright College","2015","Not on tenure/no tenure system, instructors","21","4","17","0","0","0","2","0","2","0","0","0","1","0","1","0","0","0","15","4","11","0","0","0","2","0","2","1","0","1","-2"
"212133","Eastern University","2015","Tenured total","63","33","30","0","0","0","3","1","2","8","3","5","4","2","2","0","0","0","48","27","21","0","0","0","0","0","0","0","0","0","-2"
"212133","Eastern University","2015","Tenured, professors","35","17","18","0","0","0","2","0","2","4","1","3","1","0","1","0","0","0","28","16","12","0","0","0","0","0","0","0","0","0","-2"
"212133","Eastern University","2015","Tenured, associate professors","28","16","12","0","0","0","1","1","0","4","2","2","3","2","1","0","0","0","20","11","9","0","0","0","0","0","0","0","0","0","-2"
"212133","Eastern University","2015","On-Tenure track total","33","16","17","0","0","0","2","2","0","3","2","1","0","0","0","0","0","0","28","12","16","0","0","0","0","0","0","0","0","0","-2"
"212133","Eastern University","2015","On-tenure track, professors","5","3","2","0","0","0","1","1","0","0","0","0","0","0","0","0","0","0","4","2","2","0","0","0","0","0","0","0","0","0","-2"
"212133","Eastern University","2015","On-tenure track, associate professors","16","9","7","0","0","0","1","1","0","3","2","1","0","0","0","0","0","0","12","6","6","0","0","0","0","0","0","0","0","0","-2"
"212133","Eastern University","2015","On-tenure track, assistant professors","12","4","8","0","0","0","0","0","0","0","0","0","0","0","0","0","0","0","12","4","8","0","0","0","0","0","0","0","0","0","-2"
"212133","Eastern University","2015","Not on tenure track/No tenure system system total","50","22","28","0","0","0","0","0","0","5","0","5","2","1","1","0","0","0","42","21","21","1","0","1","0","0","0","0","0","0","-2"
"212133","Eastern University","2015","Not on tenure/no tenure system, assistant professors","6","2","4","0","0","0","0","0","0","2","0","2","0","0","0","0","0","0","4","2","2","0","0","0","0","0","0","0","0","0","-2"
"212133","Eastern University","2015","Not on tenure/no tenure system, lecturers","31","12","19","0","0","0","0","0","0","3","0","3","1","0","1","0","0","0","26","12","14","1","0","1","0","0","0","0","0","0","-2"
"212133","Eastern University","2015","Not on tenure/no tenure system, no academic rank","13","8","5","0","0","0","0","0","0","0","0","0","1","1","0","0","0","0","12","7","5","0","0","0","0","0","0","0","0","0","-2"
"213367","La Salle University","2015","Tenured total","135","69","66","0","0","0","8","4","4","3","1","2","4","3","1","0","0","0","118","59","59","1","1","0","0","0","0","1","1","0","-2"
"213367","La Salle University","2015","Tenured, professors","47","30","17","0","0","0","2","1","1","1","1","0","1","1","0","0","0","0","42","26","16","1","1","0","0","0","0","0","0","0","-2"
"213367","La Salle University","2015","Tenured, associate professors","80","35","45","0","0","0","6","3","3","2","0","2","3","2","1","0","0","0","68","29","39","0","0","0","0","0","0","1","1","0","-2"
"213367","La Salle University","2015","Tenured, assistant professors","8","4","4","0","0","0","0","0","0","0","0","0","0","0","0","0","0","0","8","4","4","0","0","0","0","0","0","0","0","0","-2"
"213367","La Salle University","2015","On-Tenure track total","55","24","31","0","0","0","1","0","1","3","1","2","3","1","2","0","0","0","44","18","26","1","1","0","0","0","0","3","3","0","-2"
"213367","La Salle University","2015","On-tenure track, professors","1","1","0","0","0","0","0","0","0","0","0","0","0","0","0","0","0","0","1","1","0","0","0","0","0","0","0","0","0","0","-2"
"213367","La Salle University","2015","On-tenure track, associate professors","5","1","4","0","0","0","0","0","0","0","0","0","1","1","0","0","0","0","4","0","4","0","0","0","0","0","0","0","0","0","-2"
"213367","La Salle University","2015","On-tenure track, assistant professors","49","22","27","0","0","0","1","0","1","3","1","2","2","0","2","0","0","0","39","17","22","1","1","0","0","0","0","3","3","0","-2"
"213367","La Salle University","2015","Not on tenure track/No tenure system system total","47","11","36","0","0","0","0","0","0","2","0","2","0","0","0","0","0","0","45","11","34","0","0","0","0","0","0","0","0","0","-2"
"213367","La Salle University","2015","Not on tenure/no tenure system, professors","1","1","0","0","0","0","0","0","0","0","0","0","0","0","0","0","0","0","1","1","0","0","0","0","0","0","0","0","0","0","-2"
"213367","La Salle University","2015","Not on tenure/no tenure system, associate professors","3","1","2","0","0","0","0","0","0","0","0","0","0","0","0","0","0","0","3","1","2","0","0","0","0","0","0","0","0","0","-2"
"213367","La Salle University","2015","Not on tenure/no tenure system, assistant professors","28","5","23","0","0","0","0","0","0","1","0","1","0","0","0","0","0","0","27","5","22","0","0","0","0","0","0","0","0","0","-2"
"213367","La Salle University","2015","Not on tenure/no tenure system, instructors","15","4","11","0","0","0","0","0","0","1","0","1","0","0","0","0","0","0","14","4","10","0","0","0","0","0","0","0","0","0","-2"
"213774","Manor College","2015","Not on tenure track/No tenure system system total","26","7","19","0","0","0","1","1","0","1","0","1","0","0","0","0","0","0","24","6","18","0","0","0","0","0","0","0","0","0","-2"
"213774","Manor College","2015","Not on tenure/no tenure system, professors","14","4","10","0","0","0","1","1","0","1","0","1","0","0","0","0","0","0","12","3","9","0","0","0","0","0","0","0","0","0","-2"
"213774","Manor College","2015","Not on tenure/no tenure system, associate professors","4","1","3","0","0","0","0","0","0","0","0","0","0","0","0","0","0","0","4","1","3","0","0","0","0","0","0","0","0","0","-2"
"213774","Manor College","2015","Not on tenure/no tenure system, assistant professors","5","2","3","0","0","0","0","0","0","0","0","0","0","0","0","0","0","0","5","2","3","0","0","0","0","0","0","0","0","0","-2"
"213774","Manor College","2015","Not on tenure/no tenure system, instructors","3","0","3","0","0","0","0","0","0","0","0","0","0","0","0","0","0","0","3","0","3","0","0","0","0","0","0","0","0","0","-2"
"216542","University of Valley Forge","2015","Not on tenure track/No tenure system system total","31","21","10","0","0","0","1","1","0","3","2","1","0","0","0","1","0","1","26","18","8","0","0","0","0","0","0","0","0","0","-2"
"216542","University of Valley Forge","2015","Not on tenure/no tenure system, professors","11","10","1","0","0","0","0","0","0","0","0","0","0","0","0","1","0","1","10","10","0","0","0","0","0","0","0","0","0","0","-2"
"216542","University of Valley Forge","2015","Not on tenure/no tenure system, associate professors","8","4","4","0","0","0","0","0","0","3","2","1","0","0","0","0","0","0","5","2","3","0","0","0","0","0","0","0","0","0","-2"
"216542","University of Valley Forge","2015","Not on tenure/no tenure system, assistant professors","12","7","5","0","0","0","1","1","0","0","0","0","0","0","0","0","0","0","11","6","5","0","0","0","0","0","0","0","0","0","-2"
"217420","Rhode Island College","2015","Tenured total","243","117","126","1","0","1","21","11","10","5","3","2","6","4","2","0","0","0","208","97","111","2","2","0","0","0","0","0","0","0","-2"
"217420","Rhode Island College","2015","Tenured, professors","117","67","50","1","0","1","8","5","3","3","3","0","2","1","1","0","0","0","103","58","45","0","0","0","0","0","0","0","0","0","-2"
"217420","Rhode Island College","2015","Tenured, associate professors","118","46","72","0","0","0","12","5","7","2","0","2","4","3","1","0","0","0","98","36","62","2","2","0","0","0","0","0","0","0","-2"
"217420","Rhode Island College","2015","Tenured, assistant professors","8","4","4","0","0","0","1","1","0","0","0","0","0","0","0","0","0","0","7","3","4","0","0","0","0","0","0","0","0","0","-2"
"217420","Rhode Island College","2015","On-Tenure track total","64","21","43","0","0","0","5","1","4","1","1","0","2","1","1","0","0","0","51","17","34","3","1","2","2","0","2","0","0","0","-2"
"217420","Rhode Island College","2015","On-tenure track, associate professors","1","0","1","0","0","0","0","0","0","0","0","0","0","0","0","0","0","0","1","0","1","0","0","0","0","0","0","0","0","0","-2"
"217420","Rhode Island College","2015","On-tenure track, assistant professors","63","21","42","0","0","0","5","1","4","1","1","0","2","1","1","0","0","0","50","17","33","3","1","2","2","0","2","0","0","0","-2"
"217420","Rhode Island College","2015","Not on tenure track/No tenure system system total","31","4","27","0","0","0","1","0","1","0","0","0","1","0","1","0","0","0","29","4","25","0","0","0","0","0","0","0","0","0","-2"
"217420","Rhode Island College","2015","Not on tenure/no tenure system, associate professors","2","1","1","0","0","0","0","0","0","0","0","0","0","0","0","0","0","0","2","1","1","0","0","0","0","0","0","0","0","0","-2"
"217420","Rhode Island College","2015","Not on tenure/no tenure system, assistant professors","29","3","26","0","0","0","1","0","1","0","0","0","1","0","1","0","0","0","27","3","24","0","0","0","0","0","0","0","0","0","-2"
"221661","Southern Adventist University","2015","Not on tenure track/No tenure system system total","142","74","68","0","0","0","1","0","1","9","2","7","8","5","3","0","0","0","123","66","57","0","0","0","1","1","0","0","0","0","-2"
"221661","Southern Adventist University","2015","Not on tenure/no tenure system, professors","66","44","22","0","0","0","0","0","0","4","2","2","2","2","0","0","0","0","60","40","20","0","0","0","0","0","0","0","0","0","-2"
"221661","Southern Adventist University","2015","Not on tenure/no tenure system, associate professors","55","22","33","0","0","0","1","0","1","2","0","2","4","1","3","0","0","0","48","21","27","0","0","0","0","0","0","0","0","0","-2"
"221661","Southern Adventist University","2015","Not on tenure/no tenure system, assistant professors","20","8","12","0","0","0","0","0","0","2","0","2","2","2","0","0","0","0","15","5","10","0","0","0","1","1","0","0","0","0","-2"
"221661","Southern Adventist University","2015","Not on tenure/no tenure system, instructors","1","0","1","0","0","0","0","0","0","1","0","1","0","0","0","0","0","0","0","0","0","0","0","0","0","0","0","0","0","0","-2"
"222178","Abilene Christian University","2015","Tenured total","142","111","31","1","1","0","2","1","1","5","4","1","4","2","2","0","0","0","126","100","26","3","2","1","0","0","0","1","1","0","-2"
"222178","Abilene Christian University","2015","Tenured, professors","74","63","11","1","1","0","0","0","0","1","1","0","2","1","1","0","0","0","70","60","10","0","0","0","0","0","0","0","0","0","-2"
"222178","Abilene Christian University","2015","Tenured, associate professors","65","45","20","0","0","0","2","1","1","4","3","1","2","1","1","0","0","0","53","37","16","3","2","1","0","0","0","1","1","0","-2"
"222178","Abilene Christian University","2015","Tenured, assistant professors","3","3","0","0","0","0","0","0","0","0","0","0","0","0","0","0","0","0","3","3","0","0","0","0","0","0","0","0","0","0","-2"
"222178","Abilene Christian University","2015","On-Tenure track total","55","33","22","0","0","0","2","1","1","1","0","1","5","4","1","0","0","0","46","28","18","1","0","1","0","0","0","0","0","0","-2"
"222178","Abilene Christian University","2015","On-tenure track, professors","2","2","0","0","0","0","0","0","0","0","0","0","0","0","0","0","0","0","2","2","0","0","0","0","0","0","0","0","0","0","-2"
"222178","Abilene Christian University","2015","On-tenure track, associate professors","7","4","3","0","0","0","0","0","0","0","0","0","0","0","0","0","0","0","7","4","3","0","0","0","0","0","0","0","0","0","-2"
"222178","Abilene Christian University","2015","On-tenure track, assistant professors","46","27","19","0","0","0","2","1","1","1","0","1","5","4","1","0","0","0","37","22","15","1","0","1","0","0","0","0","0","0","-2"
"222178","Abilene Christian University","2015","Not on tenure track/No tenure system system total","56","19","37","0","0","0","0","0","0","1","1","0","2","0","2","0","0","0","53","18","35","0","0","0","0","0","0","0","0","0","-2"
"222178","Abilene Christian University","2015","Not on tenure/no tenure system, professors","1","0","1","0","0","0","0","0","0","0","0","0","0","0","0","0","0","0","1","0","1","0","0","0","0","0","0","0","0","0","-2"
"222178","Abilene Christian University","2015","Not on tenure/no tenure system, associate professors","2","2","0","0","0","0","0","0","0","1","1","0","0","0","0","0","0","0","1","1","0","0","0","0","0","0","0","0","0","0","-2"
"222178","Abilene Christian University","2015","Not on tenure/no tenure system, assistant professors","10","2","8","0","0","0","0","0","0","0","0","0","0","0","0","0","0","0","10","2","8","0","0","0","0","0","0","0","0","0","-2"
"222178","Abilene Christian University","2015","Not on tenure/no tenure system, instructors","43","15","28","0","0","0","0","0","0","0","0","0","2","0","2","0","0","0","41","15","26","0","0","0","0","0","0","0","0","0","-2"
"222983","Austin College","2015","Tenured total","71","51","20","1","1","0","0","0","0","1","0","1","5","2","3","0","0","0","63","47","16","0","0","0","0","0","0","1","1","0","-2"
"222983","Austin College","2015","Tenured, professors","31","23","8","1","1","0","0","0","0","1","0","1","1","0","1","0","0","0","28","22","6","0","0","0","0","0","0","0","0","0","-2"
"222983","Austin College","2015","Tenured, associate professors","40","28","12","0","0","0","0","0","0","0","0","0","4","2","2","0","0","0","35","25","10","0","0","0","0","0","0","1","1","0","-2"
"222983","Austin College","2015","On-Tenure track total","22","15","7","0","0","0","4","2","2","0","0","0","0","0","0","0","0","0","18","13","5","0","0","0","0","0","0","0","0","0","-2"
"222983","Austin College","2015","On-tenure track, assistant professors","22","15","7","0","0","0","4","2","2","0","0","0","0","0","0","0","0","0","18","13","5","0","0","0","0","0","0","0","0","0","-2"
"222983","Austin College","2015","Not on tenure track/No tenure system system total","27","10","17","0","0","0","2","1","1","1","0","1","1","0","1","0","0","0","23","9","14","0","0","0","0","0","0","0","0","0","-2"
"222983","Austin College","2015","Not on tenure/no tenure system, professors","2","1","1","0","0","0","0","0","0","0","0","0","0","0","0","0","0","0","2","1","1","0","0","0","0","0","0","0","0","0","-2"
"222983","Austin College","2015","Not on tenure/no tenure system, assistant professors","1","0","1","0","0","0","0","0","0","1","0","1","0","0","0","0","0","0","0","0","0","0","0","0","0","0","0","0","0","0","-2"
"222983","Austin College","2015","Not on tenure/no tenure system, instructors","24","9","15","0","0","0","2","1","1","0","0","0","1","0","1","0","0","0","21","8","13","0","0","0","0","0","0","0","0","0","-2"
"223232","Baylor University","2015","Tenured total","487","364","123","1","1","0","19","16","3","9","4","5","15","12","3","1","1","0","418","310","108","11","9","2","1","1","0","12","10","2","-2"
"223232","Baylor University","2015","Tenured, professors","276","228","48","1","1","0","6","5","1","4","3","1","6","5","1","1","1","0","246","203","43","10","8","2","0","0","0","2","2","0","-2"
"223232","Baylor University","2015","Tenured, associate professors","209","136","73","0","0","0","13","11","2","5","1","4","9","7","2","0","0","0","170","107","63","1","1","0","1","1","0","10","8","2","-2"
"223232","Baylor University","2015","Tenured, assistant professors","1","0","1","0","0","0","0","0","0","0","0","0","0","0","0","0","0","0","1","0","1","0","0","0","0","0","0","0","0","0","-2"
"223232","Baylor University","2015","Tenured, instructors","1","0","1","0","0","0","0","0","0","0","0","0","0","0","0","0","0","0","1","0","1","0","0","0","0","0","0","0","0","0","-2"
"223232","Baylor University","2015","On-Tenure track total","167","97","70","0","0","0","15","12","3","7","3","4","8","6","2","0","0","0","130","71","59","2","0","2","0","0","0","5","5","0","-2"
"223232","Baylor University","2015","On-tenure track, professors","2","0","2","0","0","0","0","0","0","0","0","0","0","0","0","0","0","0","2","0","2","0","0","0","0","0","0","0","0","0","-2"
"223232","Baylor University","2015","On-tenure track, associate professors","13","6","7","0","0","0","2","2","0","1","0","1","0","0","0","0","0","0","10","4","6","0","0","0","0","0","0","0","0","0","-2"
"223232","Baylor University","2015","On-tenure track, assistant professors","152","91","61","0","0","0","13","10","3","6","3","3","8","6","2","0","0","0","118","67","51","2","0","2","0","0","0","5","5","0","-2"
"223232","Baylor University","2015","Not on tenure track/No tenure system system total","342","142","200","1","1","0","7","2","5","3","0","3","10","2","8","0","0","0","304","128","176","3","1","2","2","2","0","12","6","6","-2"
"223232","Baylor University","2015","Not on tenure/no tenure system, professors","6","3","3","0","0","0","0","0","0","0","0","0","0","0","0","0","0","0","6","3","3","0","0","0","0","0","0","0","0","0","-2"
"223232","Baylor University","2015","Not on tenure/no tenure system, associate professors","25","6","19","0","0","0","1","0","1","0","0","0","0","0","0","0","0","0","23","5","18","0","0","0","0","0","0","1","1","0","-2"
"223232","Baylor University","2015","Not on tenure/no tenure system, assistant professors","6","2","4","1","1","0","0","0","0","0","0","0","0","0","0","0","0","0","5","1","4","0","0","0","0","0","0","0","0","0","-2"
"223232","Baylor University","2015","Not on tenure/no tenure system, lecturers","305","131","174","0","0","0","6","2","4","3","0","3","10","2","8","0","0","0","270","119","151","3","1","2","2","2","0","11","5","6","-2"
"224226","Dallas Baptist University","2015","Not on tenure track/No tenure system system total","118","72","46","0","0","0","6","5","1","2","1","1","5","4","1","0","0","0","105","62","43","0","0","0","0","0","0","0","0","0","-2"
"224226","Dallas Baptist University","2015","Not on tenure/no tenure system, professors","56","32","24","0","0","0","2","2","0","0","0","0","4","4","0","0","0","0","50","26","24","0","0","0","0","0","0","0","0","0","-2"
"224226","Dallas Baptist University","2015","Not on tenure/no tenure system, associate professors","15","9","6","0","0","0","1","0","1","2","1","1","0","0","0","0","0","0","12","8","4","0","0","0","0","0","0","0","0","0","-2"
"224226","Dallas Baptist University","2015","Not on tenure/no tenure system, assistant professors","47","31","16","0","0","0","3","3","0","0","0","0","1","0","1","0","0","0","43","28","15","0","0","0","0","0","0","0","0","0","-2"
"224244","Dallas Christian College","2015","Not on tenure track/No tenure system system total","10","5","5","0","0","0","0","0","0","1","0","1","0","0","0","0","0","0","9","5","4","0","0","0","0","0","0","0","0","0","-2"
"224244","Dallas Christian College","2015","Not on tenure/no tenure system, professors","8","4","4","0","0","0","0","0","0","1","0","1","0","0","0","0","0","0","7","4","3","0","0","0","0","0","0","0","0","0","-2"
"224244","Dallas Christian College","2015","Not on tenure/no tenure system, associate professors","2","1","1","0","0","0","0","0","0","0","0","0","0","0","0","0","0","0","2","1","1","0","0","0","0","0","0","0","0","0","-2"
"224323","University of Dallas","2015","Tenured total","78","60","18","0","0","0","1","1","0","0","0","0","4","3","1","0","0","0","68","54","14","1","0","1","2","1","1","2","1","1","-2"
"224323","University of Dallas","2015","Tenured, professors","22","17","5","0","0","0","1","1","0","0","0","0","0","0","0","0","0","0","21","16","5","0","0","0","0","0","0","0","0","0","-2"
"224323","University of Dallas","2015","Tenured, associate professors","49","37","12","0","0","0","0","0","0","0","0","0","4","3","1","0","0","0","42","33","9","0","0","0","2","1","1","1","0","1","-2"
"224323","University of Dallas","2015","Tenured, assistant professors","7","6","1","0","0","0","0","0","0","0","0","0","0","0","0","0","0","0","5","5","0","1","0","1","0","0","0","1","1","0","-2"
"224323","University of Dallas","2015","On-Tenure track total","32","12","20","0","0","0","0","0","0","1","1","0","3","1","2","0","0","0","27","10","17","0","0","0","0","0","0","1","0","1","-2"
"224323","University of Dallas","2015","On-tenure track, associate professors","2","0","2","0","0","0","0","0","0","0","0","0","0","0","0","0","0","0","2","0","2","0","0","0","0","0","0","0","0","0","-2"
"224323","University of Dallas","2015","On-tenure track, assistant professors","30","12","18","0","0","0","0","0","0","1","1","0","3","1","2","0","0","0","25","10","15","0","0","0","0","0","0","1","0","1","-2"
"224323","University of Dallas","2015","Not on tenure track/No tenure system system total","33","16","17","0","0","0","1","0","1","0","0","0","3","1","2","0","0","0","25","15","10","0","0","0","0","0","0","4","0","4","-2"
"224323","University of Dallas","2015","Not on tenure/no tenure system, professors","1","1","0","0","0","0","0","0","0","0","0","0","0","0","0","0","0","0","1","1","0","0","0","0","0","0","0","0","0","0","-2"
"224323","University of Dallas","2015","Not on tenure/no tenure system, assistant professors","17","9","8","0","0","0","1","0","1","0","0","0","1","1","0","0","0","0","14","8","6","0","0","0","0","0","0","1","0","1","-2"
"224323","University of Dallas","2015","Not on tenure/no tenure system, instructors","15","6","9","0","0","0","0","0","0","0","0","0","2","0","2","0","0","0","10","6","4","0","0","0","0","0","0","3","0","3","-2"
"224545","Texas A&M University-Texarkana","2015","Tenured total","24","13","11","0","0","0","1","1","0","1","1","0","1","0","1","0","0","0","21","11","10","0","0","0","0","0","0","0","0","0","-2"
"224545","Texas A&M University-Texarkana","2015","Tenured, professors","16","9","7","0","0","0","1","1","0","1","1","0","0","0","0","0","0","0","14","7","7","0","0","0","0","0","0","0","0","0","-2"
"224545","Texas A&M University-Texarkana","2015","Tenured, associate professors","8","4","4","0","0","0","0","0","0","0","0","0","1","0","1","0","0","0","7","4","3","0","0","0","0","0","0","0","0","0","-2"
"224545","Texas A&M University-Texarkana","2015","On-Tenure track total","10","7","3","0","0","0","1","1","0","0","0","0","0","0","0","0","0","0","9","6","3","0","0","0","0","0","0","0","0","0","-2"
"224545","Texas A&M University-Texarkana","2015","On-tenure track, professors","2","2","0","0","0","0","0","0","0","0","0","0","0","0","0","0","0","0","2","2","0","0","0","0","0","0","0","0","0","0","-2"
"224545","Texas A&M University-Texarkana","2015","On-tenure track, associate professors","7","5","2","0","0","0","1","1","0","0","0","0","0","0","0","0","0","0","6","4","2","0","0","0","0","0","0","0","0","0","-2"
"224545","Texas A&M University-Texarkana","2015","On-tenure track, assistant professors","1","0","1","0","0","0","0","0","0","0","0","0","0","0","0","0","0","0","1","0","1","0","0","0","0","0","0","0","0","0","-2"
"224545","Texas A&M University-Texarkana","2015","Not on tenure track/No tenure system system total","44","21","23","0","0","0","2","2","0","1","1","0","2","1","1","0","0","0","28","11","17","1","0","1","7","3","4","3","3","0","-2"
"224545","Texas A&M University-Texarkana","2015","Not on tenure/no tenure system, professors","5","2","3","0","0","0","0","0","0","0","0","0","0","0","0","0","0","0","4","2","2","1","0","1","0","0","0","0","0","0","-2"
"224545","Texas A&M University-Texarkana","2015","Not on tenure/no tenure system, associate professors","9","4","5","0","0","0","2","2","0","0","0","0","1","0","1","0","0","0","5","1","4","0","0","0","1","1","0","0","0","0","-2"
"224545","Texas A&M University-Texarkana","2015","Not on tenure/no tenure system, assistant professors","22","13","9","0","0","0","0","0","0","1","1","0","1","1","0","0","0","0","14","7","7","0","0","0","4","2","2","2","2","0","-2"
"224545","Texas A&M University-Texarkana","2015","Not on tenure/no tenure system, instructors","7","1","6","0","0","0","0","0","0","0","0","0","0","0","0","0","0","0","5","1","4","0","0","0","2","0","2","0","0","0","-2"
"224545","Texas A&M University-Texarkana","2015","Not on tenure/no tenure system, lecturers","1","1","0","0","0","0","0","0","0","0","0","0","0","0","0","0","0","0","0","0","0","0","0","0","0","0","0","1","1","0","-2"
"224554","Texas A & M University-Commerce","2015","Tenured total","115","78","37","1","1","0","14","12","2","8","5","3","5","3","2","0","0","0","85","56","29","1","0","1","1","1","0","0","0","0","-2"
"224554","Texas A & M University-Commerce","2015","Tenured, professors","55","39","16","1","1","0","9","8","1","5","4","1","3","2","1","0","0","0","37","24","13","0","0","0","0","0","0","0","0","0","-2"
"224554","Texas A & M University-Commerce","2015","Tenured, associate professors","58","38","20","0","0","0","5","4","1","3","1","2","2","1","1","0","0","0","46","31","15","1","0","1","1","1","0","0","0","0","-2"
"224554","Texas A & M University-Commerce","2015","Tenured, assistant professors","1","1","0","0","0","0","0","0","0","0","0","0","0","0","0","0","0","0","1","1","0","0","0","0","0","0","0","0","0","0","-2"
"224554","Texas A & M University-Commerce","2015","Tenured, instructors","1","0","1","0","0","0","0","0","0","0","0","0","0","0","0","0","0","0","1","0","1","0","0","0","0","0","0","0","0","0","-2"
"224554","Texas A & M University-Commerce","2015","On-Tenure track total","112","61","51","0","0","0","22","13","9","13","7","6","14","7","7","1","0","1","60","33","27","1","0","1","1","1","0","0","0","0","-2"
"224554","Texas A & M University-Commerce","2015","On-tenure track, professors","1","0","1","0","0","0","0","0","0","1","0","1","0","0","0","0","0","0","0","0","0","0","0","0","0","0","0","0","0","0","-2"
"224554","Texas A & M University-Commerce","2015","On-tenure track, associate professors","2","1","1","0","0","0","0","0","0","2","1","1","0","0","0","0","0","0","0","0","0","0","0","0","0","0","0","0","0","0","-2"
"224554","Texas A & M University-Commerce","2015","On-tenure track, assistant professors","109","60","49","0","0","0","22","13","9","10","6","4","14","7","7","1","0","1","60","33","27","1","0","1","1","1","0","0","0","0","-2"
"224554","Texas A & M University-Commerce","2015","Not on tenure track/No tenure system system total","96","35","61","0","0","0","5","1","4","5","3","2","3","0","3","0","0","0","81","30","51","1","0","1","1","1","0","0","0","0","-2"
"224554","Texas A & M University-Commerce","2015","Not on tenure/no tenure system, assistant professors","15","6","9","0","0","0","1","1","0","1","1","0","2","0","2","0","0","0","11","4","7","0","0","0","0","0","0","0","0","0","-2"
"224554","Texas A & M University-Commerce","2015","Not on tenure/no tenure system, instructors","68","22","46","0","0","0","4","0","4","3","1","2","1","0","1","0","0","0","58","20","38","1","0","1","1","1","0","0","0","0","-2"
"224554","Texas A & M University-Commerce","2015","Not on tenure/no tenure system, lecturers","13","7","6","0","0","0","0","0","0","1","1","0","0","0","0","0","0","0","12","6","6","0","0","0","0","0","0","0","0","0","-2"
"225247","Hardin-Simmons University","2015","Tenured total","105","68","37","0","0","0","1","1","0","0","0","0","1","1","0","0","0","0","103","66","37","0","0","0","0","0","0","0","0","0","-2"
"225247","Hardin-Simmons University","2015","Tenured, professors","62","46","16","0","0","0","0","0","0","0","0","0","1","1","0","0","0","0","61","45","16","0","0","0","0","0","0","0","0","0","-2"
"225247","Hardin-Simmons University","2015","Tenured, associate professors","38","19","19","0","0","0","0","0","0","0","0","0","0","0","0","0","0","0","38","19","19","0","0","0","0","0","0","0","0","0","-2"
"225247","Hardin-Simmons University","2015","Tenured, assistant professors","5","3","2","0","0","0","1","1","0","0","0","0","0","0","0","0","0","0","4","2","2","0","0","0","0","0","0","0","0","0","-2"
"225247","Hardin-Simmons University","2015","On-Tenure track total","18","9","9","0","0","0","0","0","0","0","0","0","0","0","0","0","0","0","18","9","9","0","0","0","0","0","0","0","0","0","-2"
"225247","Hardin-Simmons University","2015","On-tenure track, associate professors","4","3","1","0","0","0","0","0","0","0","0","0","0","0","0","0","0","0","4","3","1","0","0","0","0","0","0","0","0","0","-2"
"225247","Hardin-Simmons University","2015","On-tenure track, assistant professors","12","5","7","0","0","0","0","0","0","0","0","0","0","0","0","0","0","0","12","5","7","0","0","0","0","0","0","0","0","0","-2"
"225247","Hardin-Simmons University","2015","On-tenure track, instructors","2","1","1","0","0","0","0","0","0","0","0","0","0","0","0","0","0","0","2","1","1","0","0","0","0","0","0","0","0","0","-2"
"225247","Hardin-Simmons University","2015","Not on tenure track/No tenure system system total","11","6","5","0","0","0","0","0","0","0","0","0","0","0","0","0","0","0","11","6","5","0","0","0","0","0","0","0","0","0","-2"
"225247","Hardin-Simmons University","2015","Not on tenure/no tenure system, professors","3","2","1","0","0","0","0","0","0","0","0","0","0","0","0","0","0","0","3","2","1","0","0","0","0","0","0","0","0","0","-2"
"225247","Hardin-Simmons University","2015","Not on tenure/no tenure system, associate professors","1","0","1","0","0","0","0","0","0","0","0","0","0","0","0","0","0","0","1","0","1","0","0","0","0","0","0","0","0","0","-2"
"225247","Hardin-Simmons University","2015","Not on tenure/no tenure system, assistant professors","4","2","2","0","0","0","0","0","0","0","0","0","0","0","0","0","0","0","4","2","2","0","0","0","0","0","0","0","0","0","-2"
"225247","Hardin-Simmons University","2015","Not on tenure/no tenure system, instructors","3","2","1","0","0","0","0","0","0","0","0","0","0","0","0","0","0","0","3","2","1","0","0","0","0","0","0","0","0","0","-2"
"226091","Lamar University","2015","Tenured total","225","145","80","0","0","0","44","33","11","6","2","4","8","6","2","0","0","0","167","104","63","0","0","0","0","0","0","0","0","0","-2"
"226091","Lamar University","2015","Tenured, professors","105","77","28","0","0","0","23","20","3","0","0","0","1","1","0","0","0","0","81","56","25","0","0","0","0","0","0","0","0","0","-2"
"226091","Lamar University","2015","Tenured, associate professors","104","60","44","0","0","0","20","12","8","5","1","4","6","4","2","0","0","0","73","43","30","0","0","0","0","0","0","0","0","0","-2"
"226091","Lamar University","2015","Tenured, assistant professors","16","8","8","0","0","0","1","1","0","1","1","0","1","1","0","0","0","0","13","5","8","0","0","0","0","0","0","0","0","0","-2"
"226091","Lamar University","2015","On-Tenure track total","108","54","54","2","0","2","27","14","13","11","5","6","6","4","2","0","0","0","60","30","30","0","0","0","2","1","1","0","0","0","-2"
"226091","Lamar University","2015","On-tenure track, associate professors","18","7","11","0","0","0","4","2","2","1","0","1","1","1","0","0","0","0","12","4","8","0","0","0","0","0","0","0","0","0","-2"
"226091","Lamar University","2015","On-tenure track, assistant professors","89","47","42","2","0","2","23","12","11","10","5","5","5","3","2","0","0","0","47","26","21","0","0","0","2","1","1","0","0","0","-2"
"226091","Lamar University","2015","On-tenure track, instructors","1","0","1","0","0","0","0","0","0","0","0","0","0","0","0","0","0","0","1","0","1","0","0","0","0","0","0","0","0","0","-2"
"226091","Lamar University","2015","Not on tenure track/No tenure system system total","153","64","89","0","0","0","16","15","1","8","2","6","11","5","6","0","0","0","117","41","76","0","0","0","0","0","0","1","1","0","-2"
"226091","Lamar University","2015","Not on tenure/no tenure system, professors","3","3","0","0","0","0","0","0","0","0","0","0","0","0","0","0","0","0","3","3","0","0","0","0","0","0","0","0","0","0","-2"
"226091","Lamar University","2015","Not on tenure/no tenure system, associate professors","2","2","0","0","0","0","0","0","0","0","0","0","0","0","0","0","0","0","2","2","0","0","0","0","0","0","0","0","0","0","-2"
"226091","Lamar University","2015","Not on tenure/no tenure system, assistant professors","25","16","9","0","0","0","6","6","0","1","0","1","2","2","0","0","0","0","16","8","8","0","0","0","0","0","0","0","0","0","-2"
"226091","Lamar University","2015","Not on tenure/no tenure system, instructors","114","38","76","0","0","0","7","6","1","7","2","5","8","3","5","0","0","0","91","26","65","0","0","0","0","0","0","1","1","0","-2"
"226091","Lamar University","2015","Not on tenure/no tenure system, no academic rank","9","5","4","0","0","0","3","3","0","0","0","0","1","0","1","0","0","0","5","2","3","0","0","0","0","0","0","0","0","0","-2"
"226383","Lubbock Christian University","2015","Tenured total","58","33","25","0","0","0","0","0","0","0","0","0","2","2","0","0","0","0","56","31","25","0","0","0","0","0","0","0","0","0","-2"
"226383","Lubbock Christian University","2015","Tenured, professors","27","16","11","0","0","0","0","0","0","0","0","0","1","1","0","0","0","0","26","15","11","0","0","0","0","0","0","0","0","0","-2"
"226383","Lubbock Christian University","2015","Tenured, associate professors","24","15","9","0","0","0","0","0","0","0","0","0","1","1","0","0","0","0","23","14","9","0","0","0","0","0","0","0","0","0","-2"
"226383","Lubbock Christian University","2015","Tenured, assistant professors","7","2","5","0","0","0","0","0","0","0","0","0","0","0","0","0","0","0","7","2","5","0","0","0","0","0","0","0","0","0","-2"
"226383","Lubbock Christian University","2015","On-Tenure track total","35","21","14","0","0","0","0","0","0","0","0","0","2","2","0","0","0","0","33","19","14","0","0","0","0","0","0","0","0","0","-2"
"226383","Lubbock Christian University","2015","On-tenure track, professors","1","1","0","0","0","0","0","0","0","0","0","0","0","0","0","0","0","0","1","1","0","0","0","0","0","0","0","0","0","0","-2"
"226383","Lubbock Christian University","2015","On-tenure track, associate professors","9","7","2","0","0","0","0","0","0","0","0","0","0","0","0","0","0","0","9","7","2","0","0","0","0","0","0","0","0","0","-2"
"226383","Lubbock Christian University","2015","On-tenure track, assistant professors","25","13","12","0","0","0","0","0","0","0","0","0","2","2","0","0","0","0","23","11","12","0","0","0","0","0","0","0","0","0","-2"
"226383","Lubbock Christian University","2015","Not on tenure track/No tenure system system total","6","2","4","0","0","0","0","0","0","0","0","0","0","0","0","0","0","0","6","2","4","0","0","0","0","0","0","0","0","0","-2"
"226383","Lubbock Christian University","2015","Not on tenure/no tenure system, lecturers","5","1","4","0","0","0","0","0","0","0","0","0","0","0","0","0","0","0","5","1","4","0","0","0","0","0","0","0","0","0","-2"
"226383","Lubbock Christian University","2015","Not on tenure/no tenure system, no academic rank","1","1","0","0","0","0","0","0","0","0","0","0","0","0","0","0","0","0","1","1","0","0","0","0","0","0","0","0","0","0","-2"
"226471","University of Mary Hardin-Baylor","2015","Tenured total","60","30","30","0","0","0","5","3","2","0","0","0","1","1","0","0","0","0","52","25","27","0","0","0","1","1","0","1","0","1","-2"
"226471","University of Mary Hardin-Baylor","2015","Tenured, professors","44","23","21","0","0","0","2","2","0","0","0","0","1","1","0","0","0","0","39","19","20","0","0","0","1","1","0","1","0","1","-2"
"226471","University of Mary Hardin-Baylor","2015","Tenured, associate professors","16","7","9","0","0","0","3","1","2","0","0","0","0","0","0","0","0","0","13","6","7","0","0","0","0","0","0","0","0","0","-2"
"226471","University of Mary Hardin-Baylor","2015","On-Tenure track total","61","30","31","0","0","0","4","4","0","6","2","4","3","0","3","0","0","0","47","23","24","1","1","0","0","0","0","0","0","0","-2"
"226471","University of Mary Hardin-Baylor","2015","On-tenure track, professors","3","1","2","0","0","0","0","0","0","0","0","0","0","0","0","0","0","0","3","1","2","0","0","0","0","0","0","0","0","0","-2"
"226471","University of Mary Hardin-Baylor","2015","On-tenure track, associate professors","18","7","11","0","0","0","1","1","0","3","0","3","1","0","1","0","0","0","13","6","7","0","0","0","0","0","0","0","0","0","-2"
"226471","University of Mary Hardin-Baylor","2015","On-tenure track, assistant professors","40","22","18","0","0","0","3","3","0","3","2","1","2","0","2","0","0","0","31","16","15","1","1","0","0","0","0","0","0","0","-2"
"226471","University of Mary Hardin-Baylor","2015","Not on tenure track/No tenure system system total","47","16","31","0","0","0","0","0","0","1","0","1","4","2","2","1","1","0","41","13","28","0","0","0","0","0","0","0","0","0","-2"
"226471","University of Mary Hardin-Baylor","2015","Not on tenure/no tenure system, professors","1","1","0","0","0","0","0","0","0","0","0","0","0","0","0","0","0","0","1","1","0","0","0","0","0","0","0","0","0","0","-2"
"226471","University of Mary Hardin-Baylor","2015","Not on tenure/no tenure system, associate professors","4","1","3","0","0","0","0","0","0","0","0","0","0","0","0","0","0","0","4","1","3","0","0","0","0","0","0","0","0","0","-2"
"226471","University of Mary Hardin-Baylor","2015","Not on tenure/no tenure system, assistant professors","28","11","17","0","0","0","0","0","0","1","0","1","3","2","1","0","0","0","24","9","15","0","0","0","0","0","0","0","0","0","-2"
"226471","University of Mary Hardin-Baylor","2015","Not on tenure/no tenure system, instructors","14","3","11","0","0","0","0","0","0","0","0","0","1","0","1","1","1","0","12","2","10","0","0","0","0","0","0","0","0","0","-2"
"226833","Midwestern State University","2015","Tenured total","109","67","42","1","0","1","6","5","1","1","0","1","3","2","1","0","0","0","87","55","32","2","1","1","2","1","1","7","3","4","-2"
"226833","Midwestern State University","2015","Tenured, professors","38","28","10","1","0","1","2","2","0","0","0","0","3","2","1","0","0","0","31","23","8","0","0","0","0","0","0","1","1","0","-2"
"226833","Midwestern State University","2015","Tenured, associate professors","59","33","26","0","0","0","3","2","1","1","0","1","0","0","0","0","0","0","46","27","19","1","1","0","2","1","1","6","2","4","-2"
"226833","Midwestern State University","2015","Tenured, assistant professors","12","6","6","0","0","0","1","1","0","0","0","0","0","0","0","0","0","0","10","5","5","1","0","1","0","0","0","0","0","0","-2"
"226833","Midwestern State University","2015","On-Tenure track total","68","37","31","0","0","0","2","1","1","2","1","1","3","3","0","0","0","0","45","22","23","2","0","2","1","1","0","13","9","4","-2"
"226833","Midwestern State University","2015","On-tenure track, professors","1","1","0","0","0","0","0","0","0","0","0","0","0","0","0","0","0","0","1","1","0","0","0","0","0","0","0","0","0","0","-2"
"226833","Midwestern State University","2015","On-tenure track, associate professors","10","7","3","0","0","0","0","0","0","0","0","0","1","1","0","0","0","0","5","2","3","0","0","0","1","1","0","3","3","0","-2"
"226833","Midwestern State University","2015","On-tenure track, assistant professors","57","29","28","0","0","0","2","1","1","2","1","1","2","2","0","0","0","0","39","19","20","2","0","2","0","0","0","10","6","4","-2"
"226833","Midwestern State University","2015","Not on tenure track/No tenure system system total","59","10","49","0","0","0","0","0","0","1","0","1","3","0","3","0","0","0","52","8","44","1","0","1","1","1","0","1","1","0","-2"
"226833","Midwestern State University","2015","Not on tenure/no tenure system, professors","1","1","0","0","0","0","0","0","0","0","0","0","0","0","0","0","0","0","1","1","0","0","0","0","0","0","0","0","0","0","-2"
"226833","Midwestern State University","2015","Not on tenure/no tenure system, assistant professors","31","3","28","0","0","0","0","0","0","1","0","1","2","0","2","0","0","0","27","3","24","1","0","1","0","0","0","0","0","0","-2"
"226833","Midwestern State University","2015","Not on tenure/no tenure system, instructors","21","4","17","0","0","0","0","0","0","0","0","0","1","0","1","0","0","0","19","3","16","0","0","0","0","0","0","1","1","0","-2"
"226833","Midwestern State University","2015","Not on tenure/no tenure system, lecturers","5","2","3","0","0","0","0","0","0","0","0","0","0","0","0","0","0","0","4","1","3","0","0","0","1","1","0","0","0","0","-2"
"226833","Midwestern State University","2015","Not on tenure/no tenure system, no academic rank","1","0","1","0","0","0","0","0","0","0","0","0","0","0","0","0","0","0","1","0","1","0","0","0","0","0","0","0","0","0","-2"
"227429","Paul Quinn College","2015","Not on tenure track/No tenure system system total","9","5","4","0","0","0","0","0","0","6","4","2","2","1","1","0","0","0","0","0","0","1","0","1","0","0","0","0","0","0","-2"
"227429","Paul Quinn College","2015","Not on tenure/no tenure system, associate professors","9","5","4","0","0","0","0","0","0","6","4","2","2","1","1","0","0","0","0","0","0","1","0","1","0","0","0","0","0","0","-2"
"227881","Sam Houston State University","2015","Tenured total","338","215","123","1","1","0","9","4","5","7","4","3","14","8","6","0","0","0","273","176","97","1","0","1","0","0","0","33","22","11","-2"
"227881","Sam Houston State University","2015","Tenured, professors","159","110","49","1","1","0","1","1","0","3","3","0","3","2","1","0","0","0","138","94","44","0","0","0","0","0","0","13","9","4","-2"
"227881","Sam Houston State University","2015","Tenured, associate professors","173","102","71","0","0","0","7","2","5","4","1","3","10","5","5","0","0","0","131","81","50","1","0","1","0","0","0","20","13","7","-2"
"227881","Sam Houston State University","2015","Tenured, assistant professors","5","3","2","0","0","0","1","1","0","0","0","0","1","1","0","0","0","0","3","1","2","0","0","0","0","0","0","0","0","0","-2"
"227881","Sam Houston State University","2015","Tenured, instructors","1","0","1","0","0","0","0","0","0","0","0","0","0","0","0","0","0","0","1","0","1","0","0","0","0","0","0","0","0","0","-2"
"227881","Sam Houston State University","2015","On-Tenure track total","176","90","86","1","0","1","3","1","2","12","4","8","10","6","4","0","0","0","109","52","57","1","1","0","0","0","0","40","26","14","-2"
"227881","Sam Houston State University","2015","On-tenure track, associate professors","12","7","5","0","0","0","1","0","1","0","0","0","0","0","0","0","0","0","8","5","3","0","0","0","0","0","0","3","2","1","-2"
"227881","Sam Houston State University","2015","On-tenure track, assistant professors","164","83","81","1","0","1","2","1","1","12","4","8","10","6","4","0","0","0","101","47","54","1","1","0","0","0","0","37","24","13","-2"
"227881","Sam Houston State University","2015","Not on tenure track/No tenure system system total","204","86","118","1","0","1","7","1","6","9","3","6","10","7","3","0","0","0","154","64","90","2","2","0","0","0","0","21","9","12","-2"
"227881","Sam Houston State University","2015","Not on tenure/no tenure system, professors","1","0","1","0","0","0","0","0","0","0","0","0","0","0","0","0","0","0","1","0","1","0","0","0","0","0","0","0","0","0","-2"
"227881","Sam Houston State University","2015","Not on tenure/no tenure system, lecturers","203","86","117","1","0","1","7","1","6","9","3","6","10","7","3","0","0","0","153","64","89","2","2","0","0","0","0","21","9","12","-2"
"228325","Southwestern Assemblies of God University","2015","Not on tenure track/No tenure system system total","82","53","29","0","0","0","4","0","4","3","1","2","2","2","0","0","0","0","72","50","22","0","0","0","0","0","0","1","0","1","-2"
"228325","Southwestern Assemblies of God University","2015","Not on tenure/no tenure system, professors","25","21","4","0","0","0","1","0","1","0","0","0","0","0","0","0","0","0","24","21","3","0","0","0","0","0","0","0","0","0","-2"
"228325","Southwestern Assemblies of God University","2015","Not on tenure/no tenure system, associate professors","10","4","6","0","0","0","0","0","0","1","0","1","1","1","0","0","0","0","8","3","5","0","0","0","0","0","0","0","0","0","-2"
"228325","Southwestern Assemblies of God University","2015","Not on tenure/no tenure system, assistant professors","29","18","11","0","0","0","2","0","2","2","1","1","0","0","0","0","0","0","24","17","7","0","0","0","0","0","0","1","0","1","-2"
"228325","Southwestern Assemblies of God University","2015","Not on tenure/no tenure system, instructors","17","10","7","0","0","0","1","0","1","0","0","0","1","1","0","0","0","0","15","9","6","0","0","0","0","0","0","0","0","0","-2"
"228325","Southwestern Assemblies of God University","2015","Not on tenure/no tenure system, lecturers","1","0","1","0","0","0","0","0","0","0","0","0","0","0","0","0","0","0","1","0","1","0","0","0","0","0","0","0","0","0","-2"
"228343","Southwestern University","2015","Tenured total","82","45","37","1","1","0","2","1","1","2","1","1","7","4","3","0","0","0","67","36","31","0","0","0","1","1","0","2","1","1","-2"
"228343","Southwestern University","2015","Tenured, professors","41","21","20","0","0","0","1","1","0","0","0","0","2","0","2","0","0","0","37","19","18","0","0","0","1","1","0","0","0","0","-2"
"228343","Southwestern University","2015","Tenured, associate professors","41","24","17","1","1","0","1","0","1","2","1","1","5","4","1","0","0","0","30","17","13","0","0","0","0","0","0","2","1","1","-2"
"228343","Southwestern University","2015","On-Tenure track total","13","5","8","0","0","0","1","0","1","0","0","0","1","0","1","0","0","0","9","4","5","0","0","0","0","0","0","2","1","1","-2"
"228343","Southwestern University","2015","On-tenure track, assistant professors","13","5","8","0","0","0","1","0","1","0","0","0","1","0","1","0","0","0","9","4","5","0","0","0","0","0","0","2","1","1","-2"
"228343","Southwestern University","2015","Not on tenure track/No tenure system system total","17","7","10","0","0","0","0","0","0","1","0","1","3","1","2","0","0","0","13","6","7","0","0","0","0","0","0","0","0","0","-2"
"228343","Southwestern University","2015","Not on tenure/no tenure system, assistant professors","2","0","2","0","0","0","0","0","0","1","0","1","0","0","0","0","0","0","1","0","1","0","0","0","0","0","0","0","0","0","-2"
"228343","Southwestern University","2015","Not on tenure/no tenure system, instructors","15","7","8","0","0","0","0","0","0","0","0","0","3","1","2","0","0","0","12","6","6","0","0","0","0","0","0","0","0","0","-2"
"228431","Stephen F Austin State University","2015","Tenured total","271","174","97","1","0","1","1","1","0","6","5","1","12","6","6","0","0","0","243","159","84","8","3","5","0","0","0","0","0","0","-2"
"228431","Stephen F Austin State University","2015","Tenured, professors","127","90","37","0","0","0","0","0","0","2","1","1","3","0","3","0","0","0","121","89","32","1","0","1","0","0","0","0","0","0","-2"
"228431","Stephen F Austin State University","2015","Tenured, associate professors","131","77","54","0","0","0","1","1","0","4","4","0","8","5","3","0","0","0","113","65","48","5","2","3","0","0","0","0","0","0","-2"
"228431","Stephen F Austin State University","2015","Tenured, assistant professors","12","6","6","1","0","1","0","0","0","0","0","0","1","1","0","0","0","0","8","4","4","2","1","1","0","0","0","0","0","0","-2"
"228431","Stephen F Austin State University","2015","Tenured, instructors","1","1","0","0","0","0","0","0","0","0","0","0","0","0","0","0","0","0","1","1","0","0","0","0","0","0","0","0","0","0","-2"
"228431","Stephen F Austin State University","2015","On-Tenure track total","135","70","65","1","0","1","7","4","3","4","1","3","6","4","2","0","0","0","114","60","54","2","1","1","1","0","1","0","0","0","-2"
"228431","Stephen F Austin State University","2015","On-tenure track, professors","1","1","0","0","0","0","0","0","0","0","0","0","0","0","0","0","0","0","1","1","0","0","0","0","0","0","0","0","0","0","-2"
"228431","Stephen F Austin State University","2015","On-tenure track, associate professors","9","7","2","0","0","0","0","0","0","1","1","0","0","0","0","0","0","0","8","6","2","0","0","0","0","0","0","0","0","0","-2"
"228431","Stephen F Austin State University","2015","On-tenure track, assistant professors","120","61","59","1","0","1","7","4","3","3","0","3","6","4","2","0","0","0","101","52","49","1","1","0","1","0","1","0","0","0","-2"
"228431","Stephen F Austin State University","2015","On-tenure track, instructors","5","1","4","0","0","0","0","0","0","0","0","0","0","0","0","0","0","0","4","1","3","1","0","1","0","0","0","0","0","0","-2"
"228431","Stephen F Austin State University","2015","Not on tenure track/No tenure system system total","135","44","91","1","0","1","1","1","0","3","0","3","5","3","2","0","0","0","115","33","82","4","4","0","6","3","3","0","0","0","-2"
"228431","Stephen F Austin State University","2015","Not on tenure/no tenure system, professors","1","1","0","0","0","0","1","1","0","0","0","0","0","0","0","0","0","0","0","0","0","0","0","0","0","0","0","0","0","0","-2"
"228431","Stephen F Austin State University","2015","Not on tenure/no tenure system, assistant professors","3","0","3","0","0","0","0","0","0","0","0","0","0","0","0","0","0","0","3","0","3","0","0","0","0","0","0","0","0","0","-2"
"228431","Stephen F Austin State University","2015","Not on tenure/no tenure system, instructors","37","6","31","0","0","0","0","0","0","2","0","2","2","0","2","0","0","0","33","6","27","0","0","0","0","0","0","0","0","0","-2"
"228431","Stephen F Austin State University","2015","Not on tenure/no tenure system, lecturers","46","14","32","0","0","0","0","0","0","0","0","0","0","0","0","0","0","0","44","12","32","2","2","0","0","0","0","0","0","0","-2"
"228431","Stephen F Austin State University","2015","Not on tenure/no tenure system, no academic rank","48","23","25","1","0","1","0","0","0","1","0","1","3","3","0","0","0","0","35","15","20","2","2","0","6","3","3","0","0","0","-2"
"228529","Tarleton State University","2015","Tenured total","120","85","35","2","2","0","5","4","1","0","0","0","6","5","1","0","0","0","106","73","33","1","1","0","0","0","0","0","0","0","-2"
"228529","Tarleton State University","2015","Tenured, professors","64","48","16","2","2","0","3","3","0","0","0","0","2","2","0","0","0","0","57","41","16","0","0","0","0","0","0","0","0","0","-2"
"228529","Tarleton State University","2015","Tenured, associate professors","55","36","19","0","0","0","2","1","1","0","0","0","4","3","1","0","0","0","48","31","17","1","1","0","0","0","0","0","0","0","-2"
"228529","Tarleton State University","2015","Tenured, assistant professors","1","1","0","0","0","0","0","0","0","0","0","0","0","0","0","0","0","0","1","1","0","0","0","0","0","0","0","0","0","0","-2"
"228529","Tarleton State University","2015","On-Tenure track total","142","68","74","2","1","1","10","4","6","7","2","5","5","3","2","0","0","0","104","47","57","1","1","0","3","2","1","10","8","2","-2"
"228529","Tarleton State University","2015","On-tenure track, professors","1","0","1","1","0","1","0","0","0","0","0","0","0","0","0","0","0","0","0","0","0","0","0","0","0","0","0","0","0","0","-2"
"228529","Tarleton State University","2015","On-tenure track, associate professors","14","6","8","1","1","0","0","0","0","0","0","0","0","0","0","0","0","0","12","4","8","0","0","0","1","1","0","0","0","0","-2"
"228529","Tarleton State University","2015","On-tenure track, assistant professors","127","62","65","0","0","0","10","4","6","7","2","5","5","3","2","0","0","0","92","43","49","1","1","0","2","1","1","10","8","2","-2"
"228529","Tarleton State University","2015","Not on tenure track/No tenure system system total","135","50","85","1","1","0","4","2","2","2","1","1","6","1","5","0","0","0","115","41","74","2","1","1","4","2","2","1","1","0","-2"
"228529","Tarleton State University","2015","Not on tenure/no tenure system, professors","1","1","0","0","0","0","1","1","0","0","0","0","0","0","0","0","0","0","0","0","0","0","0","0","0","0","0","0","0","0","-2"
"228529","Tarleton State University","2015","Not on tenure/no tenure system, associate professors","3","0","3","0","0","0","0","0","0","1","0","1","0","0","0","0","0","0","2","0","2","0","0","0","0","0","0","0","0","0","-2"
"228529","Tarleton State University","2015","Not on tenure/no tenure system, assistant professors","51","20","31","0","0","0","1","0","1","1","1","0","4","1","3","0","0","0","41","16","25","1","1","0","3","1","2","0","0","0","-2"
"228529","Tarleton State University","2015","Not on tenure/no tenure system, instructors","80","29","51","1","1","0","2","1","1","0","0","0","2","0","2","0","0","0","72","25","47","1","0","1","1","1","0","1","1","0","-2"
"228653","The University of Texas Medical Branch at Galveston","2015","Tenured total","237","170","67","0","0","0","49","33","16","7","5","2","14","10","4","0","0","0","154","112","42","0","0","0","0","0","0","13","10","3","-2"
"228653","The University of Texas Medical Branch at Galveston","2015","Tenured, professors","191","142","49","0","0","0","41","27","14","5","4","1","12","9","3","0","0","0","131","100","31","0","0","0","0","0","0","2","2","0","-2"
"228653","The University of Texas Medical Branch at Galveston","2015","Tenured, associate professors","46","28","18","0","0","0","8","6","2","2","1","1","2","1","1","0","0","0","23","12","11","0","0","0","0","0","0","11","8","3","-2"
"228653","The University of Texas Medical Branch at Galveston","2015","On-Tenure track total","130","70","60","0","0","0","28","17","11","3","0","3","4","2","2","0","0","0","66","34","32","1","1","0","0","0","0","28","16","12","-2"
"228653","The University of Texas Medical Branch at Galveston","2015","On-tenure track, professors","4","2","2","0","0","0","0","0","0","0","0","0","0","0","0","0","0","0","4","2","2","0","0","0","0","0","0","0","0","0","-2"
"228653","The University of Texas Medical Branch at Galveston","2015","On-tenure track, associate professors","32","18","14","0","0","0","9","6","3","1","0","1","1","1","0","0","0","0","17","9","8","0","0","0","0","0","0","4","2","2","-2"
"228653","The University of Texas Medical Branch at Galveston","2015","On-tenure track, assistant professors","94","50","44","0","0","0","19","11","8","2","0","2","3","1","2","0","0","0","45","23","22","1","1","0","0","0","0","24","14","10","-2"
"228653","The University of Texas Medical Branch at Galveston","2015","Not on tenure track/No tenure system system total","134","59","75","0","0","0","17","9","8","8","2","6","12","7","5","1","1","0","83","33","50","1","0","1","0","0","0","12","7","5","-2"
"228653","The University of Texas Medical Branch at Galveston","2015","Not on tenure/no tenure system, professors","54","38","16","0","0","0","11","8","3","3","1","2","3","3","0","1","1","0","33","22","11","0","0","0","0","0","0","3","3","0","-2"
"228653","The University of Texas Medical Branch at Galveston","2015","Not on tenure/no tenure system, associate professors","24","4","20","0","0","0","4","0","4","1","0","1","3","2","1","0","0","0","15","2","13","0","0","0","0","0","0","1","0","1","-2"
"228653","The University of Texas Medical Branch at Galveston","2015","Not on tenure/no tenure system, assistant professors","53","15","38","0","0","0","2","1","1","4","1","3","6","2","4","0","0","0","34","8","26","1","0","1","0","0","0","6","3","3","-2"
"228653","The University of Texas Medical Branch at Galveston","2015","Not on tenure/no tenure system, instructors","2","1","1","0","0","0","0","0","0","0","0","0","0","0","0","0","0","0","0","0","0","0","0","0","0","0","0","2","1","1","-2"
"228653","The University of Texas Medical Branch at Galveston","2015","Not on tenure/no tenure system, lecturers","1","1","0","0","0","0","0","0","0","0","0","0","0","0","0","0","0","0","1","1","0","0","0","0","0","0","0","0","0","0","-2"
"228787","The University of Texas at Dallas","2015","Tenured total","375","299","76","0","0","0","99","81","18","7","4","3","10","9","1","1","1","0","236","186","50","5","5","0","1","1","0","16","12","4","-2"
"228787","The University of Texas at Dallas","2015","Tenured, professors","234","199","35","0","0","0","66","58","8","1","1","0","7","7","0","1","1","0","150","123","27","3","3","0","1","1","0","5","5","0","-2"
"228787","The University of Texas at Dallas","2015","Tenured, associate professors","141","100","41","0","0","0","33","23","10","6","3","3","3","2","1","0","0","0","86","63","23","2","2","0","0","0","0","11","7","4","-2"
"228787","The University of Texas at Dallas","2015","On-Tenure track total","139","101","38","0","0","0","27","19","8","6","4","2","7","5","2","0","0","0","58","38","20","0","0","0","5","3","2","36","32","4","-2"
"228787","The University of Texas at Dallas","2015","On-tenure track, associate professors","9","7","2","0","0","0","1","1","0","1","1","0","0","0","0","0","0","0","5","4","1","0","0","0","0","0","0","2","1","1","-2"
"228787","The University of Texas at Dallas","2015","On-tenure track, assistant professors","130","94","36","0","0","0","26","18","8","5","3","2","7","5","2","0","0","0","53","34","19","0","0","0","5","3","2","34","31","3","-2"
"228787","The University of Texas at Dallas","2015","Not on tenure track/No tenure system system total","298","165","133","0","0","0","45","21","24","4","3","1","10","7","3","0","0","0","217","118","99","2","2","0","10","7","3","10","7","3","-2"
"228787","The University of Texas at Dallas","2015","Not on tenure/no tenure system, lecturers","298","165","133","0","0","0","45","21","24","4","3","1","10","7","3","0","0","0","217","118","99","2","2","0","10","7","3","10","7","3","-2"
"228802","The University of Texas at Tyler","2015","Tenured total","120","79","41","1","1","0","14","12","2","3","2","1","3","3","0","0","0","0","99","61","38","0","0","0","0","0","0","0","0","0","-2"
"228802","The University of Texas at Tyler","2015","Tenured, professors","53","35","18","1","1","0","7","6","1","0","0","0","1","1","0","0","0","0","44","27","17","0","0","0","0","0","0","0","0","0","-2"
"228802","The University of Texas at Tyler","2015","Tenured, associate professors","67","44","23","0","0","0","7","6","1","3","2","1","2","2","0","0","0","0","55","34","21","0","0","0","0","0","0","0","0","0","-2"
"228802","The University of Texas at Tyler","2015","On-Tenure track total","110","48","62","0","0","0","13","5","8","10","4","6","4","3","1","0","0","0","77","31","46","0","0","0","1","1","0","5","4","1","-2"
"228802","The University of Texas at Tyler","2015","On-tenure track, professors","1","0","1","0","0","0","0","0","0","0","0","0","0","0","0","0","0","0","1","0","1","0","0","0","0","0","0","0","0","0","-2"
"228802","The University of Texas at Tyler","2015","On-tenure track, associate professors","6","4","2","0","0","0","0","0","0","1","1","0","0","0","0","0","0","0","4","2","2","0","0","0","1","1","0","0","0","0","-2"
"228802","The University of Texas at Tyler","2015","On-tenure track, assistant professors","103","44","59","0","0","0","13","5","8","9","3","6","4","3","1","0","0","0","72","29","43","0","0","0","0","0","0","5","4","1","-2"
"228802","The University of Texas at Tyler","2015","Not on tenure track/No tenure system system total","96","18","78","1","1","0","4","2","2","3","0","3","3","1","2","0","0","0","80","13","67","1","0","1","2","1","1","2","0","2","-2"
"228802","The University of Texas at Tyler","2015","Not on tenure/no tenure system, assistant professors","2","1","1","0","0","0","0","0","0","0","0","0","0","0","0","0","0","0","2","1","1","0","0","0","0","0","0","0","0","0","-2"
"228802","The University of Texas at Tyler","2015","Not on tenure/no tenure system, instructors","51","4","47","0","0","0","2","2","0","2","0","2","2","0","2","0","0","0","43","1","42","0","0","0","2","1","1","0","0","0","-2"
"228802","The University of Texas at Tyler","2015","Not on tenure/no tenure system, lecturers","43","13","30","1","1","0","2","0","2","1","0","1","1","1","0","0","0","0","35","11","24","1","0","1","0","0","0","2","0","2","-2"
"229267","Trinity University","2015","Tenured total","173","106","67","1","0","1","11","7","4","5","3","2","16","11","5","0","0","0","138","84","54","0","0","0","1","1","0","1","0","1","-2"
"229267","Trinity University","2015","Tenured, professors","84","54","30","0","0","0","4","3","1","0","0","0","2","2","0","0","0","0","77","48","29","0","0","0","1","1","0","0","0","0","-2"
"229267","Trinity University","2015","Tenured, associate professors","89","52","37","1","0","1","7","4","3","5","3","2","14","9","5","0","0","0","61","36","25","0","0","0","0","0","0","1","0","1","-2"
"229267","Trinity University","2015","On-Tenure track total","47","23","24","0","0","0","6","3","3","3","1","2","5","3","2","0","0","0","30","15","15","1","0","1","0","0","0","2","1","1","-2"
"229267","Trinity University","2015","On-tenure track, associate professors","1","0","1","0","0","0","0","0","0","0","0","0","0","0","0","0","0","0","1","0","1","0","0","0","0","0","0","0","0","0","-2"
"229267","Trinity University","2015","On-tenure track, assistant professors","46","23","23","0","0","0","6","3","3","3","1","2","5","3","2","0","0","0","29","15","14","1","0","1","0","0","0","2","1","1","-2"
"229267","Trinity University","2015","Not on tenure track/No tenure system system total","23","11","12","0","0","0","1","0","1","1","0","1","4","2","2","0","0","0","16","9","7","0","0","0","1","0","1","0","0","0","-2"
"229267","Trinity University","2015","Not on tenure/no tenure system, associate professors","2","2","0","0","0","0","0","0","0","0","0","0","0","0","0","0","0","0","2","2","0","0","0","0","0","0","0","0","0","0","-2"
"229267","Trinity University","2015","Not on tenure/no tenure system, assistant professors","11","5","6","0","0","0","0","0","0","0","0","0","1","1","0","0","0","0","9","4","5","0","0","0","1","0","1","0","0","0","-2"
"229267","Trinity University","2015","Not on tenure/no tenure system, instructors","10","4","6","0","0","0","1","0","1","1","0","1","3","1","2","0","0","0","5","3","2","0","0","0","0","0","0","0","0","0","-2"
"232706","Marymount University","2015","Tenured total","86","22","64","0","0","0","5","0","5","1","0","1","1","0","1","0","0","0","73","19","54","2","0","2","4","3","1","0","0","0","-2"
"232706","Marymount University","2015","Tenured, professors","51","11","40","0","0","0","1","0","1","1","0","1","1","0","1","0","0","0","45","9","36","1","0","1","2","2","0","0","0","0","-2"
"232706","Marymount University","2015","Tenured, associate professors","35","11","24","0","0","0","4","0","4","0","0","0","0","0","0","0","0","0","28","10","18","1","0","1","2","1","1","0","0","0","-2"
"232706","Marymount University","2015","On-Tenure track total","44","16","28","0","0","0","1","0","1","1","0","1","0","0","0","0","0","0","33","13","20","0","0","0","8","3","5","1","0","1","-2"
"232706","Marymount University","2015","On-tenure track, associate professors","3","1","2","0","0","0","0","0","0","0","0","0","0","0","0","0","0","0","0","0","0","0","0","0","3","1","2","0","0","0","-2"
"232706","Marymount University","2015","On-tenure track, assistant professors","41","15","26","0","0","0","1","0","1","1","0","1","0","0","0","0","0","0","33","13","20","0","0","0","5","2","3","1","0","1","-2"
"232706","Marymount University","2015","Not on tenure track/No tenure system system total","30","11","19","1","0","1","2","1","1","0","0","0","2","2","0","1","0","1","20","7","13","0","0","0","4","1","3","0","0","0","-2"
"232706","Marymount University","2015","Not on tenure/no tenure system, professors","2","2","0","0","0","0","0","0","0","0","0","0","0","0","0","0","0","0","2","2","0","0","0","0","0","0","0","0","0","0","-2"
"232706","Marymount University","2015","Not on tenure/no tenure system, associate professors","1","1","0","0","0","0","0","0","0","0","0","0","0","0","0","0","0","0","1","1","0","0","0","0","0","0","0","0","0","0","-2"
"232706","Marymount University","2015","Not on tenure/no tenure system, assistant professors","6","1","5","0","0","0","0","0","0","0","0","0","1","1","0","0","0","0","5","0","5","0","0","0","0","0","0","0","0","0","-2"
"232706","Marymount University","2015","Not on tenure/no tenure system, instructors","18","5","13","1","0","1","1","0","1","0","0","0","1","1","0","1","0","1","12","4","8","0","0","0","2","0","2","0","0","0","-2"
"232706","Marymount University","2015","Not on tenure/no tenure system, no academic rank","3","2","1","0","0","0","1","1","0","0","0","0","0","0","0","0","0","0","0","0","0","0","0","0","2","1","1","0","0","0","-2"
"234827","Central Washington University","2015","Tenured total","255","161","94","3","1","2","17","11","6","7","4","3","9","6","3","4","4","0","187","120","67","0","0","0","19","9","10","9","6","3","-2"
"234827","Central Washington University","2015","Tenured, professors","139","89","50","2","0","2","10","8","2","2","1","1","4","3","1","2","2","0","113","73","40","0","0","0","5","2","3","1","0","1","-2"
"234827","Central Washington University","2015","Tenured, associate professors","116","72","44","1","1","0","7","3","4","5","3","2","5","3","2","2","2","0","74","47","27","0","0","0","14","7","7","8","6","2","-2"
"234827","Central Washington University","2015","On-Tenure track total","96","43","53","0","0","0","2","0","2","2","1","1","4","0","4","0","0","0","55","22","33","0","0","0","28","18","10","5","2","3","-2"
"234827","Central Washington University","2015","On-tenure track, assistant professors","96","43","53","0","0","0","2","0","2","2","1","1","4","0","4","0","0","0","55","22","33","0","0","0","28","18","10","5","2","3","-2"
"234827","Central Washington University","2015","Not on tenure track/No tenure system system total","122","67","55","0","0","0","2","1","1","2","2","0","3","2","1","0","0","0","78","42","36","1","0","1","36","20","16","0","0","0","-2"
"234827","Central Washington University","2015","Not on tenure/no tenure system, lecturers","122","67","55","0","0","0","2","1","1","2","2","0","3","2","1","0","0","0","78","42","36","1","0","1","36","20","16","0","0","0","-2"
"235097","Eastern Washington University","2015","Tenured total","226","130","96","2","1","1","16","9","7","4","4","0","5","3","2","1","1","0","192","108","84","4","2","2","1","1","0","1","1","0","-2"
"235097","Eastern Washington University","2015","Tenured, professors","138","88","50","0","0","0","10","7","3","3","3","0","2","1","1","0","0","0","120","74","46","2","2","0","1","1","0","0","0","0","-2"
"235097","Eastern Washington University","2015","Tenured, associate professors","88","42","46","2","1","1","6","2","4","1","1","0","3","2","1","1","1","0","72","34","38","2","0","2","0","0","0","1","1","0","-2"
"235097","Eastern Washington University","2015","On-Tenure track total","104","53","51","2","0","2","5","2","3","3","3","0","5","3","2","0","0","0","78","41","37","3","1","2","2","0","2","6","3","3","-2"
"235097","Eastern Washington University","2015","On-tenure track, assistant professors","104","53","51","2","0","2","5","2","3","3","3","0","5","3","2","0","0","0","78","41","37","3","1","2","2","0","2","6","3","3","-2"
"235097","Eastern Washington University","2015","Not on tenure track/No tenure system system total","148","76","72","1","1","0","10","6","4","7","4","3","2","2","0","1","1","0","119","56","63","3","2","1","1","1","0","4","3","1","-2"
"235097","Eastern Washington University","2015","Not on tenure/no tenure system, associate professors","2","2","0","0","0","0","0","0","0","1","1","0","0","0","0","0","0","0","1","1","0","0","0","0","0","0","0","0","0","0","-2"
"235097","Eastern Washington University","2015","Not on tenure/no tenure system, no academic rank","146","74","72","1","1","0","10","6","4","6","3","3","2","2","0","1","1","0","118","55","63","3","2","1","1","1","0","4","3","1","-2"
"235237","Pierce College District","2015","Tenured total","52","20","32","1","1","0","1","0","1","0","0","0","2","1","1","0","0","0","43","16","27","5","2","3","0","0","0","0","0","0","-2"
"235237","Pierce College District","2015","Tenured, no academic rank","52","20","32","1","1","0","1","0","1","0","0","0","2","1","1","0","0","0","43","16","27","5","2","3","0","0","0","0","0","0","-2"
"235237","Pierce College District","2015","On-Tenure track total","15","5","10","0","0","0","0","0","0","0","0","0","0","0","0","0","0","0","14","5","9","1","0","1","0","0","0","0","0","0","-2"
"235237","Pierce College District","2015","On-tenure track, no academic rank","15","5","10","0","0","0","0","0","0","0","0","0","0","0","0","0","0","0","14","5","9","1","0","1","0","0","0","0","0","0","-2"
"235237","Pierce College District","2015","Not on tenure track/No tenure system system total","12","5","7","0","0","0","0","0","0","0","0","0","0","0","0","0","0","0","12","5","7","0","0","0","0","0","0","0","0","0","-2"
"235237","Pierce College District","2015","Not on tenure/no tenure system, no academic rank","12","5","7","0","0","0","0","0","0","0","0","0","0","0","0","0","0","0","12","5","7","0","0","0","0","0","0","0","0","0","-2"
"236452","Saint Martin's University","2015","Tenured total","46","26","20","0","0","0","4","3","1","2","2","0","2","1","1","0","0","0","38","20","18","0","0","0","0","0","0","0","0","0","-2"
"236452","Saint Martin's University","2015","Tenured, professors","18","11","7","0","0","0","3","2","1","1","1","0","1","0","1","0","0","0","13","8","5","0","0","0","0","0","0","0","0","0","-2"
"236452","Saint Martin's University","2015","Tenured, associate professors","27","14","13","0","0","0","1","1","0","1","1","0","1","1","0","0","0","0","24","11","13","0","0","0","0","0","0","0","0","0","-2"
"236452","Saint Martin's University","2015","Tenured, assistant professors","1","1","0","0","0","0","0","0","0","0","0","0","0","0","0","0","0","0","1","1","0","0","0","0","0","0","0","0","0","0","-2"
"236452","Saint Martin's University","2015","On-Tenure track total","23","11","12","0","0","0","3","1","2","0","0","0","0","0","0","0","0","0","19","9","10","0","0","0","1","1","0","0","0","0","-2"
"236452","Saint Martin's University","2015","On-tenure track, professors","1","1","0","0","0","0","1","1","0","0","0","0","0","0","0","0","0","0","0","0","0","0","0","0","0","0","0","0","0","0","-2"
"236452","Saint Martin's University","2015","On-tenure track, assistant professors","22","10","12","0","0","0","2","0","2","0","0","0","0","0","0","0","0","0","19","9","10","0","0","0","1","1","0","0","0","0","-2"
"236452","Saint Martin's University","2015","Not on tenure track/No tenure system system total","8","6","2","0","0","0","0","0","0","0","0","0","0","0","0","0","0","0","6","4","2","0","0","0","2","2","0","0","0","0","-2"
"236452","Saint Martin's University","2015","Not on tenure/no tenure system, associate professors","1","0","1","0","0","0","0","0","0","0","0","0","0","0","0","0","0","0","1","0","1","0","0","0","0","0","0","0","0","0","-2"
"236452","Saint Martin's University","2015","Not on tenure/no tenure system, assistant professors","2","2","0","0","0","0","0","0","0","0","0","0","0","0","0","0","0","0","1","1","0","0","0","0","1","1","0","0","0","0","-2"
"236452","Saint Martin's University","2015","Not on tenure/no tenure system, instructors","5","4","1","0","0","0","0","0","0","0","0","0","0","0","0","0","0","0","4","3","1","0","0","0","1","1","0","0","0","0","-2"
"236638","Skagit Valley College","2015","Tenured total","78","32","46","2","2","0","1","0","1","1","1","0","3","2","1","0","0","0","71","27","44","0","0","0","0","0","0","0","0","0","-2"
"236638","Skagit Valley College","2015","Tenured, no academic rank","78","32","46","2","2","0","1","0","1","1","1","0","3","2","1","0","0","0","71","27","44","0","0","0","0","0","0","0","0","0","-2"
"236638","Skagit Valley College","2015","On-Tenure track total","24","9","15","0","0","0","1","0","1","0","0","0","2","2","0","0","0","0","21","7","14","0","0","0","0","0","0","0","0","0","-2"
"236638","Skagit Valley College","2015","On-tenure track, no academic rank","24","9","15","0","0","0","1","0","1","0","0","0","2","2","0","0","0","0","21","7","14","0","0","0","0","0","0","0","0","0","-2"
"236638","Skagit Valley College","2015","Not on tenure track/No tenure system system total","3","2","1","0","0","0","0","0","0","0","0","0","0","0","0","0","0","0","3","2","1","0","0","0","0","0","0","0","0","0","-2"
"236638","Skagit Valley College","2015","Not on tenure/no tenure system, no academic rank","3","2","1","0","0","0","0","0","0","0","0","0","0","0","0","0","0","0","3","2","1","0","0","0","0","0","0","0","0","0","-2"
"236887","Walla Walla Community College","2015","Tenured total","63","34","29","4","3","1","1","0","1","1","0","1","1","1","0","0","0","0","55","30","25","1","0","1","0","0","0","0","0","0","-2"
"236887","Walla Walla Community College","2015","Tenured, no academic rank","63","34","29","4","3","1","1","0","1","1","0","1","1","1","0","0","0","0","55","30","25","1","0","1","0","0","0","0","0","0","-2"
"236887","Walla Walla Community College","2015","On-Tenure track total","19","6","13","0","0","0","0","0","0","0","0","0","0","0","0","0","0","0","19","6","13","0","0","0","0","0","0","0","0","0","-2"
"236887","Walla Walla Community College","2015","On-tenure track, no academic rank","19","6","13","0","0","0","0","0","0","0","0","0","0","0","0","0","0","0","19","6","13","0","0","0","0","0","0","0","0","0","-2"
"236887","Walla Walla Community College","2015","Not on tenure track/No tenure system system total","43","31","12","0","0","0","0","0","0","0","0","0","3","3","0","0","0","0","39","28","11","1","0","1","0","0","0","0","0","0","-2"
"236887","Walla Walla Community College","2015","Not on tenure/no tenure system, no academic rank","43","31","12","0","0","0","0","0","0","0","0","0","3","3","0","0","0","0","39","28","11","1","0","1","0","0","0","0","0","0","-2"
"236896","Walla Walla University","2015","Tenured total","75","49","26","0","0","0","1","1","0","1","1","0","2","1","1","0","0","0","20","13","7","0","0","0","51","33","18","0","0","0","-2"
"236896","Walla Walla University","2015","Tenured, professors","47","31","16","0","0","0","1","1","0","1","1","0","2","1","1","0","0","0","10","6","4","0","0","0","33","22","11","0","0","0","-2"
"236896","Walla Walla University","2015","Tenured, associate professors","19","12","7","0","0","0","0","0","0","0","0","0","0","0","0","0","0","0","7","5","2","0","0","0","12","7","5","0","0","0","-2"
"236896","Walla Walla University","2015","Tenured, assistant professors","9","6","3","0","0","0","0","0","0","0","0","0","0","0","0","0","0","0","3","2","1","0","0","0","6","4","2","0","0","0","-2"
"236896","Walla Walla University","2015","On-Tenure track total","27","13","14","0","0","0","0","0","0","2","1","1","0","0","0","0","0","0","15","8","7","0","0","0","10","4","6","0","0","0","-2"
"236896","Walla Walla University","2015","On-tenure track, professors","3","2","1","0","0","0","0","0","0","1","1","0","0","0","0","0","0","0","1","1","0","0","0","0","1","0","1","0","0","0","-2"
"236896","Walla Walla University","2015","On-tenure track, associate professors","6","1","5","0","0","0","0","0","0","1","0","1","0","0","0","0","0","0","4","1","3","0","0","0","1","0","1","0","0","0","-2"
"236896","Walla Walla University","2015","On-tenure track, assistant professors","15","8","7","0","0","0","0","0","0","0","0","0","0","0","0","0","0","0","8","4","4","0","0","0","7","4","3","0","0","0","-2"
"236896","Walla Walla University","2015","On-tenure track, instructors","3","2","1","0","0","0","0","0","0","0","0","0","0","0","0","0","0","0","2","2","0","0","0","0","1","0","1","0","0","0","-2"
"236896","Walla Walla University","2015","Not on tenure track/No tenure system system total","13","7","6","0","0","0","0","0","0","0","0","0","0","0","0","0","0","0","5","4","1","0","0","0","8","3","5","0","0","0","-2"
"236896","Walla Walla University","2015","Not on tenure/no tenure system, professors","3","2","1","0","0","0","0","0","0","0","0","0","0","0","0","0","0","0","0","0","0","0","0","0","3","2","1","0","0","0","-2"
"236896","Walla Walla University","2015","Not on tenure/no tenure system, associate professors","3","1","2","0","0","0","0","0","0","0","0","0","0","0","0","0","0","0","0","0","0","0","0","0","3","1","2","0","0","0","-2"
"236896","Walla Walla University","2015","Not on tenure/no tenure system, assistant professors","3","1","2","0","0","0","0","0","0","0","0","0","0","0","0","0","0","0","1","1","0","0","0","0","2","0","2","0","0","0","-2"
"236896","Walla Walla University","2015","Not on tenure/no tenure system, instructors","4","3","1","0","0","0","0","0","0","0","0","0","0","0","0","0","0","0","4","3","1","0","0","0","0","0","0","0","0","0","-2"
"238430","Cardinal Stritch University","2015","Tenured total","40","17","23","0","0","0","1","0","1","2","2","0","1","0","1","0","0","0","36","15","21","0","0","0","0","0","0","0","0","0","-2"
"238430","Cardinal Stritch University","2015","Tenured, professors","5","3","2","0","0","0","0","0","0","0","0","0","1","0","1","0","0","0","4","3","1","0","0","0","0","0","0","0","0","0","-2"
"238430","Cardinal Stritch University","2015","Tenured, associate professors","13","3","10","0","0","0","1","0","1","0","0","0","0","0","0","0","0","0","12","3","9","0","0","0","0","0","0","0","0","0","-2"
"238430","Cardinal Stritch University","2015","Tenured, assistant professors","22","11","11","0","0","0","0","0","0","2","2","0","0","0","0","0","0","0","20","9","11","0","0","0","0","0","0","0","0","0","-2"
"238430","Cardinal Stritch University","2015","On-Tenure track total","21","7","14","0","0","0","0","0","0","3","1","2","0","0","0","0","0","0","18","6","12","0","0","0","0","0","0","0","0","0","-2"
"238430","Cardinal Stritch University","2015","On-tenure track, assistant professors","21","7","14","0","0","0","0","0","0","3","1","2","0","0","0","0","0","0","18","6","12","0","0","0","0","0","0","0","0","0","-2"
"238430","Cardinal Stritch University","2015","Not on tenure track/No tenure system system total","26","9","17","0","0","0","0","0","0","2","1","1","1","1","0","0","0","0","22","6","16","0","0","0","1","1","0","0","0","0","-2"
"238430","Cardinal Stritch University","2015","Not on tenure/no tenure system, assistant professors","23","9","14","0","0","0","0","0","0","2","1","1","1","1","0","0","0","0","19","6","13","0","0","0","1","1","0","0","0","0","-2"
"238430","Cardinal Stritch University","2015","Not on tenure/no tenure system, instructors","3","0","3","0","0","0","0","0","0","0","0","0","0","0","0","0","0","0","3","0","3","0","0","0","0","0","0","0","0","0","-2"
"239309","Milwaukee Institute of Art & Design","2015","Not on tenure track/No tenure system system total","37","23","14","0","0","0","2","1","1","0","0","0","0","0","0","0","0","0","34","21","13","1","1","0","0","0","0","0","0","0","-2"
"239309","Milwaukee Institute of Art & Design","2015","Not on tenure/no tenure system, professors","23","13","10","0","0","0","2","1","1","0","0","0","0","0","0","0","0","0","21","12","9","0","0","0","0","0","0","0","0","0","-2"
"239309","Milwaukee Institute of Art & Design","2015","Not on tenure/no tenure system, associate professors","4","3","1","0","0","0","0","0","0","0","0","0","0","0","0","0","0","0","3","2","1","1","1","0","0","0","0","0","0","0","-2"
"239309","Milwaukee Institute of Art & Design","2015","Not on tenure/no tenure system, assistant professors","3","1","2","0","0","0","0","0","0","0","0","0","0","0","0","0","0","0","3","1","2","0","0","0","0","0","0","0","0","0","-2"
"239309","Milwaukee Institute of Art & Design","2015","Not on tenure/no tenure system, instructors","7","6","1","0","0","0","0","0","0","0","0","0","0","0","0","0","0","0","7","6","1","0","0","0","0","0","0","0","0","0","-2"
"240374","University of Wisconsin-Parkside","2015","Tenured total","70","39","31","0","0","0","18","9","9","4","4","0","6","2","4","0","0","0","41","23","18","0","0","0","0","0","0","1","1","0","-2"
"240374","University of Wisconsin-Parkside","2015","Tenured, professors","28","18","10","0","0","0","9","5","4","1","1","0","0","0","0","0","0","0","18","12","6","0","0","0","0","0","0","0","0","0","-2"
"240374","University of Wisconsin-Parkside","2015","Tenured, associate professors","41","20","21","0","0","0","9","4","5","2","2","0","6","2","4","0","0","0","23","11","12","0","0","0","0","0","0","1","1","0","-2"
"240374","University of Wisconsin-Parkside","2015","Tenured, assistant professors","1","1","0","0","0","0","0","0","0","1","1","0","0","0","0","0","0","0","0","0","0","0","0","0","0","0","0","0","0","0","-2"
"240374","University of Wisconsin-Parkside","2015","On-Tenure track total","39","19","20","0","0","0","1","1","0","1","1","0","2","1","1","0","0","0","31","14","17","0","0","0","2","2","0","2","0","2","-2"
"240374","University of Wisconsin-Parkside","2015","On-tenure track, associate professors","2","2","0","0","0","0","0","0","0","0","0","0","0","0","0","0","0","0","2","2","0","0","0","0","0","0","0","0","0","0","-2"
"240374","University of Wisconsin-Parkside","2015","On-tenure track, assistant professors","37","17","20","0","0","0","1","1","0","1","1","0","2","1","1","0","0","0","29","12","17","0","0","0","2","2","0","2","0","2","-2"
"240374","University of Wisconsin-Parkside","2015","Not on tenure track/No tenure system system total","50","24","26","1","1","0","1","1","0","2","1","1","3","1","2","0","0","0","43","20","23","0","0","0","0","0","0","0","0","0","-2"
"240374","University of Wisconsin-Parkside","2015","Not on tenure/no tenure system, associate professors","1","1","0","0","0","0","0","0","0","0","0","0","0","0","0","0","0","0","1","1","0","0","0","0","0","0","0","0","0","0","-2"
"240374","University of Wisconsin-Parkside","2015","Not on tenure/no tenure system, lecturers","49","23","26","1","1","0","1","1","0","2","1","1","3","1","2","0","0","0","42","19","23","0","0","0","0","0","0","0","0","0","-2"
"243823","Parker University","2015","Not on tenure track/No tenure system system total","61","37","24","0","0","0","9","5","4","1","1","0","4","3","1","0","0","0","47","28","19","0","0","0","0","0","0","0","0","0","-2"
"243823","Parker University","2015","Not on tenure/no tenure system, professors","15","12","3","0","0","0","3","2","1","0","0","0","0","0","0","0","0","0","12","10","2","0","0","0","0","0","0","0","0","0","-2"
"243823","Parker University","2015","Not on tenure/no tenure system, associate professors","17","10","7","0","0","0","3","2","1","0","0","0","0","0","0","0","0","0","14","8","6","0","0","0","0","0","0","0","0","0","-2"
"243823","Parker University","2015","Not on tenure/no tenure system, assistant professors","15","8","7","0","0","0","3","1","2","1","1","0","2","1","1","0","0","0","9","5","4","0","0","0","0","0","0","0","0","0","-2"
"243823","Parker University","2015","Not on tenure/no tenure system, instructors","11","7","4","0","0","0","0","0","0","0","0","0","2","2","0","0","0","0","9","5","4","0","0","0","0","0","0","0","0","0","-2"
"243823","Parker University","2015","Not on tenure/no tenure system, no academic rank","3","0","3","0","0","0","0","0","0","0","0","0","0","0","0","0","0","0","3","0","3","0","0","0","0","0","0","0","0","0","-2"
"244233","City College-Fort Lauderdale","2015","Not on tenure track/No tenure system system total","8","3","5","0","0","0","1","0","1","2","0","2","1","0","1","0","0","0","4","3","1","0","0","0","0","0","0","0","0","0","-2"
"244233","City College-Fort Lauderdale","2015","Not on tenure/no tenure system, instructors","8","3","5","0","0","0","1","0","1","2","0","2","1","0","1","0","0","0","4","3","1","0","0","0","0","0","0","0","0","0","-2"
"245838","Antioch University-Los Angeles","2015","Not on tenure track/No tenure system system total","34","18","16","0","0","0","3","1","2","2","0","2","1","1","0","0","0","0","28","16","12","0","0","0","0","0","0","0","0","0","-2"
"245838","Antioch University-Los Angeles","2015","Not on tenure/no tenure system, no academic rank","34","18","16","0","0","0","3","1","2","2","0","2","1","1","0","0","0","0","28","16","12","0","0","0","0","0","0","0","0","0","-2"
"247834","Collin County Community College District","2015","Not on tenure track/No tenure system system total","417","174","243","5","2","3","23","5","18","22","10","12","25","9","16","0","0","0","338","145","193","4","3","1","0","0","0","0","0","0","-2"
"247834","Collin County Community College District","2015","Not on tenure/no tenure system, no academic rank","417","174","243","5","2","3","23","5","18","22","10","12","25","9","16","0","0","0","338","145","193","4","3","1","0","0","0","0","0","0","-2"
"262086","Brandman University","2015","Not on tenure track/No tenure system system total","73","26","47","0","0","0","5","4","1","6","3","3","4","2","2","0","0","0","44","13","31","1","0","1","13","4","9","0","0","0","-2"
"262086","Brandman University","2015","Not on tenure/no tenure system, professors","12","7","5","0","0","0","1","1","0","1","0","1","0","0","0","0","0","0","9","6","3","0","0","0","1","0","1","0","0","0","-2"
"262086","Brandman University","2015","Not on tenure/no tenure system, associate professors","15","5","10","0","0","0","2","2","0","1","1","0","0","0","0","0","0","0","11","2","9","0","0","0","1","0","1","0","0","0","-2"
"262086","Brandman University","2015","Not on tenure/no tenure system, assistant professors","46","14","32","0","0","0","2","1","1","4","2","2","4","2","2","0","0","0","24","5","19","1","0","1","11","4","7","0","0","0","-2"
"262129","New College of Florida","2015","Tenured total","54","26","28","0","0","0","1","1","0","1","0","1","3","1","2","0","0","0","48","24","24","0","0","0","0","0","0","1","0","1","-2"
"262129","New College of Florida","2015","Tenured, professors","32","19","13","0","0","0","0","0","0","0","0","0","1","1","0","0","0","0","31","18","13","0","0","0","0","0","0","0","0","0","-2"
"262129","New College of Florida","2015","Tenured, associate professors","22","7","15","0","0","0","1","1","0","1","0","1","2","0","2","0","0","0","17","6","11","0","0","0","0","0","0","1","0","1","-2"
"262129","New College of Florida","2015","On-Tenure track total","17","9","8","0","0","0","2","1","1","2","0","2","0","0","0","0","0","0","10","8","2","0","0","0","0","0","0","3","0","3","-2"
"262129","New College of Florida","2015","On-tenure track, assistant professors","17","9","8","0","0","0","2","1","1","2","0","2","0","0","0","0","0","0","10","8","2","0","0","0","0","0","0","3","0","3","-2"
"262129","New College of Florida","2015","Not on tenure track/No tenure system system total","8","4","4","0","0","0","0","0","0","0","0","0","0","0","0","0","0","0","7","4","3","0","0","0","0","0","0","1","0","1","-2"
"262129","New College of Florida","2015","Not on tenure/no tenure system, professors","1","1","0","0","0","0","0","0","0","0","0","0","0","0","0","0","0","0","1","1","0","0","0","0","0","0","0","0","0","0","-2"
"262129","New College of Florida","2015","Not on tenure/no tenure system, assistant professors","5","3","2","0","0","0","0","0","0","0","0","0","0","0","0","0","0","0","5","3","2","0","0","0","0","0","0","0","0","0","-2"
"262129","New College of Florida","2015","Not on tenure/no tenure system, instructors","1","0","1","0","0","0","0","0","0","0","0","0","0","0","0","0","0","0","1","0","1","0","0","0","0","0","0","0","0","0","-2"
"262129","New College of Florida","2015","Not on tenure/no tenure system, no academic rank","1","0","1","0","0","0","0","0","0","0","0","0","0","0","0","0","0","0","0","0","0","0","0","0","0","0","0","1","0","1","-2"
"377564","University of Washington-Tacoma Campus","2015","Tenured total","90","51","39","0","0","0","9","8","1","4","2","2","6","4","2","0","0","0","49","23","26","1","0","1","4","4","0","17","10","7","-2"
"377564","University of Washington-Tacoma Campus","2015","Tenured, professors","31","21","10","0","0","0","6","5","1","1","1","0","1","1","0","0","0","0","17","9","8","0","0","0","3","3","0","3","2","1","-2"
"377564","University of Washington-Tacoma Campus","2015","Tenured, associate professors","59","30","29","0","0","0","3","3","0","3","1","2","5","3","2","0","0","0","32","14","18","1","0","1","1","1","0","14","8","6","-2"
"377564","University of Washington-Tacoma Campus","2015","On-Tenure track total","52","21","31","1","0","1","2","0","2","1","0","1","4","2","2","0","0","0","21","10","11","2","0","2","1","1","0","20","8","12","-2"
"377564","University of Washington-Tacoma Campus","2015","On-tenure track, associate professors","2","1","1","0","0","0","0","0","0","0","0","0","0","0","0","0","0","0","0","0","0","0","0","0","0","0","0","2","1","1","-2"
"377564","University of Washington-Tacoma Campus","2015","On-tenure track, assistant professors","50","20","30","1","0","1","2","0","2","1","0","1","4","2","2","0","0","0","21","10","11","2","0","2","1","1","0","18","7","11","-2"
"377564","University of Washington-Tacoma Campus","2015","Not on tenure track/No tenure system system total","92","36","56","0","0","0","2","0","2","1","0","1","3","0","3","1","0","1","71","32","39","4","1","3","2","0","2","8","3","5","-2"
"377564","University of Washington-Tacoma Campus","2015","Not on tenure/no tenure system, lecturers","92","36","56","0","0","0","2","0","2","1","0","1","3","0","3","1","0","1","71","32","39","4","1","3","2","0","2","8","3","5","-2"
"385619","Everglades University","2015","Not on tenure track/No tenure system system total","80","54","26","0","0","0","2","1","1","5","5","0","8","6","2","0","0","0","64","42","22","1","0","1","0","0","0","0","0","0","-2"
"385619","Everglades University","2015","Not on tenure/no tenure system, instructors","80","54","26","0","0","0","2","1","1","5","5","0","8","6","2","0","0","0","64","42","22","1","0","1","0","0","0","0","0","0","-2"
"386472","Herzing University-Orlando","2015","Not on tenure track/No tenure system system total","28","7","21","0","0","0","0","0","0","5","1","4","2","0","2","0","0","0","20","6","14","1","0","1","0","0","0","0","0","0","-2"
"386472","Herzing University-Orlando","2015","Not on tenure/no tenure system, professors","4","0","4","0","0","0","0","0","0","0","0","0","0","0","0","0","0","0","4","0","4","0","0","0","0","0","0","0","0","0","-2"
"386472","Herzing University-Orlando","2015","Not on tenure/no tenure system, associate professors","17","4","13","0","0","0","0","0","0","4","1","3","2","0","2","0","0","0","10","3","7","1","0","1","0","0","0","0","0","0","-2"
"386472","Herzing University-Orlando","2015","Not on tenure/no tenure system, assistant professors","7","3","4","0","0","0","0","0","0","1","0","1","0","0","0","0","0","0","6","3","3","0","0","0","0","0","0","0","0","0","-2"
"388520","College of Biblical Studies-Houston","2015","Not on tenure track/No tenure system system total","16","14","2","0","0","0","0","0","0","4","3","1","3","3","0","0","0","0","9","8","1","0","0","0","0","0","0","0","0","0","-2"
"388520","College of Biblical Studies-Houston","2015","Not on tenure/no tenure system, professors","13","11","2","0","0","0","0","0","0","4","3","1","1","1","0","0","0","0","8","7","1","0","0","0","0","0","0","0","0","0","-2"
"388520","College of Biblical Studies-Houston","2015","Not on tenure/no tenure system, associate professors","1","1","0","0","0","0","0","0","0","0","0","0","0","0","0","0","0","0","1","1","0","0","0","0","0","0","0","0","0","0","-2"
"388520","College of Biblical Studies-Houston","2015","Not on tenure/no tenure system, assistant professors","2","2","0","0","0","0","0","0","0","0","0","0","2","2","0","0","0","0","0","0","0","0","0","0","0","0","0","0","0","0","-2"
"418126","New York College of Health Professions","2015","Not on tenure track/No tenure system system total","13","8","5","0","0","0","6","3","3","1","1","0","0","0","0","0","0","0","6","4","2","0","0","0","0","0","0","0","0","0","-2"
"418126","New York College of Health Professions","2015","Not on tenure/no tenure system, no academic rank","13","8","5","0","0","0","6","3","3","1","1","0","0","0","0","0","0","0","6","4","2","0","0","0","0","0","0","0","0","0","-2"
"420574","Arizona State University-Polytechnic","2015","Tenured total","63","46","17","0","0","0","10","8","2","1","1","0","0","0","0","0","0","0","50","35","15","0","0","0","1","1","0","1","1","0","-2"
"420574","Arizona State University-Polytechnic","2015","Tenured, professors","26","22","4","0","0","0","3","3","0","1","1","0","0","0","0","0","0","0","22","18","4","0","0","0","0","0","0","0","0","0","-2"
"420574","Arizona State University-Polytechnic","2015","Tenured, associate professors","37","24","13","0","0","0","7","5","2","0","0","0","0","0","0","0","0","0","28","17","11","0","0","0","1","1","0","1","1","0","-2"
"420574","Arizona State University-Polytechnic","2015","On-Tenure track total","33","22","11","0","0","0","8","5","3","1","0","1","1","1","0","0","0","0","18","13","5","2","1","1","0","0","0","3","2","1","-2"
"420574","Arizona State University-Polytechnic","2015","On-tenure track, assistant professors","33","22","11","0","0","0","8","5","3","1","0","1","1","1","0","0","0","0","18","13","5","2","1","1","0","0","0","3","2","1","-2"
"420574","Arizona State University-Polytechnic","2015","Not on tenure track/No tenure system system total","98","47","51","1","1","0","6","3","3","4","2","2","8","3","5","0","0","0","76","36","40","3","2","1","0","0","0","0","0","0","-2"
"420574","Arizona State University-Polytechnic","2015","Not on tenure/no tenure system, professors","4","3","1","1","1","0","0","0","0","0","0","0","0","0","0","0","0","0","3","2","1","0","0","0","0","0","0","0","0","0","-2"
"420574","Arizona State University-Polytechnic","2015","Not on tenure/no tenure system, associate professors","4","1","3","0","0","0","0","0","0","0","0","0","2","0","2","0","0","0","1","0","1","1","1","0","0","0","0","0","0","0","-2"
"420574","Arizona State University-Polytechnic","2015","Not on tenure/no tenure system, assistant professors","6","1","5","0","0","0","0","0","0","1","0","1","1","0","1","0","0","0","3","0","3","1","1","0","0","0","0","0","0","0","-2"
"420574","Arizona State University-Polytechnic","2015","Not on tenure/no tenure system, instructors","34","12","22","0","0","0","1","0","1","2","1","1","2","0","2","0","0","0","28","11","17","1","0","1","0","0","0","0","0","0","-2"
"420574","Arizona State University-Polytechnic","2015","Not on tenure/no tenure system, lecturers","50","30","20","0","0","0","5","3","2","1","1","0","3","3","0","0","0","0","41","23","18","0","0","0","0","0","0","0","0","0","-2"
"426314","Embry-Riddle Aeronautical University-Worldwide","2015","Tenured total","6","3","3","0","0","0","0","0","0","0","0","0","0","0","0","0","0","0","6","3","3","0","0","0","0","0","0","0","0","0","-2"
"426314","Embry-Riddle Aeronautical University-Worldwide","2015","Tenured, professors","1","0","1","0","0","0","0","0","0","0","0","0","0","0","0","0","0","0","1","0","1","0","0","0","0","0","0","0","0","0","-2"
"426314","Embry-Riddle Aeronautical University-Worldwide","2015","Tenured, associate professors","4","2","2","0","0","0","0","0","0","0","0","0","0","0","0","0","0","0","4","2","2","0","0","0","0","0","0","0","0","0","-2"
"426314","Embry-Riddle Aeronautical University-Worldwide","2015","Tenured, assistant professors","1","1","0","0","0","0","0","0","0","0","0","0","0","0","0","0","0","0","1","1","0","0","0","0","0","0","0","0","0","0","-2"
"426314","Embry-Riddle Aeronautical University-Worldwide","2015","On-Tenure track total","28","17","11","0","0","0","0","0","0","3","1","2","1","1","0","0","0","0","22","13","9","0","0","0","1","1","0","1","1","0","-2"
"426314","Embry-Riddle Aeronautical University-Worldwide","2015","On-tenure track, assistant professors","28","17","11","0","0","0","0","0","0","3","1","2","1","1","0","0","0","0","22","13","9","0","0","0","1","1","0","1","1","0","-2"
"426314","Embry-Riddle Aeronautical University-Worldwide","2015","Not on tenure track/No tenure system system total","56","37","19","0","0","0","0","0","0","3","2","1","1","1","0","0","0","0","48","31","17","1","0","1","2","2","0","1","1","0","-2"
"426314","Embry-Riddle Aeronautical University-Worldwide","2015","Not on tenure/no tenure system, professors","2","2","0","0","0","0","0","0","0","0","0","0","0","0","0","0","0","0","2","2","0","0","0","0","0","0","0","0","0","0","-2"
"426314","Embry-Riddle Aeronautical University-Worldwide","2015","Not on tenure/no tenure system, associate professors","8","7","1","0","0","0","0","0","0","0","0","0","0","0","0","0","0","0","8","7","1","0","0","0","0","0","0","0","0","0","-2"
"426314","Embry-Riddle Aeronautical University-Worldwide","2015","Not on tenure/no tenure system, assistant professors","35","21","14","0","0","0","0","0","0","3","2","1","0","0","0","0","0","0","29","17","12","1","0","1","1","1","0","1","1","0","-2"
"426314","Embry-Riddle Aeronautical University-Worldwide","2015","Not on tenure/no tenure system, instructors","11","7","4","0","0","0","0","0","0","0","0","0","1","1","0","0","0","0","9","5","4","0","0","0","1","1","0","0","0","0","-2"
"433660","Florida Gulf Coast University","2015","Tenured total","8","3","5","0","0","0","0","0","0","0","0","0","1","0","1","0","0","0","7","3","4","0","0","0","0","0","0","0","0","0","-2"
"433660","Florida Gulf Coast University","2015","Tenured, professors","7","3","4","0","0","0","0","0","0","0","0","0","1","0","1","0","0","0","6","3","3","0","0","0","0","0","0","0","0","0","-2"
"433660","Florida Gulf Coast University","2015","Tenured, associate professors","1","0","1","0","0","0","0","0","0","0","0","0","0","0","0","0","0","0","1","0","1","0","0","0","0","0","0","0","0","0","-2"
"433660","Florida Gulf Coast University","2015","Not on tenure track/No tenure system system total","448","246","202","2","2","0","31","23","8","17","10","7","27","12","15","0","0","0","356","190","166","2","2","0","0","0","0","13","7","6","-2"
"433660","Florida Gulf Coast University","2015","Not on tenure/no tenure system, professors","64","44","20","0","0","0","2","2","0","1","0","1","6","4","2","0","0","0","53","36","17","1","1","0","0","0","0","1","1","0","-2"
"433660","Florida Gulf Coast University","2015","Not on tenure/no tenure system, associate professors","113","76","37","0","0","0","14","10","4","6","5","1","4","3","1","0","0","0","88","57","31","0","0","0","0","0","0","1","1","0","-2"
"433660","Florida Gulf Coast University","2015","Not on tenure/no tenure system, assistant professors","155","82","73","2","2","0","14","10","4","7","3","4","10","4","6","0","0","0","110","57","53","1","1","0","0","0","0","11","5","6","-2"
"433660","Florida Gulf Coast University","2015","Not on tenure/no tenure system, instructors","116","44","72","0","0","0","1","1","0","3","2","1","7","1","6","0","0","0","105","40","65","0","0","0","0","0","0","0","0","0","-2"
"439288","Johnson & Wales University-Denver","2015","Not on tenure track/No tenure system system total","52","30","22","0","0","0","0","0","0","1","1","0","2","1","1","0","0","0","49","28","21","0","0","0","0","0","0","0","0","0","-2"
"439288","Johnson & Wales University-Denver","2015","Not on tenure/no tenure system, professors","4","2","2","0","0","0","0","0","0","0","0","0","1","0","1","0","0","0","3","2","1","0","0","0","0","0","0","0","0","0","-2"
"439288","Johnson & Wales University-Denver","2015","Not on tenure/no tenure system, associate professors","25","14","11","0","0","0","0","0","0","1","1","0","1","1","0","0","0","0","23","12","11","0","0","0","0","0","0","0","0","0","-2"
"439288","Johnson & Wales University-Denver","2015","Not on tenure/no tenure system, assistant professors","15","8","7","0","0","0","0","0","0","0","0","0","0","0","0","0","0","0","15","8","7","0","0","0","0","0","0","0","0","0","-2"
"439288","Johnson & Wales University-Denver","2015","Not on tenure/no tenure system, instructors","8","6","2","0","0","0","0","0","0","0","0","0","0","0","0","0","0","0","8","6","2","0","0","0","0","0","0","0","0","0","-2"
"446233","Ecclesia College","2015","Not on tenure track/No tenure system system total","18","11","7","0","0","0","1","0","1","0","0","0","1","0","1","0","0","0","16","11","5","0","0","0","0","0","0","0","0","0","-2"
"446233","Ecclesia College","2015","Not on tenure/no tenure system, no academic rank","18","11","7","0","0","0","1","0","1","0","0","0","1","0","1","0","0","0","16","11","5","0","0","0","0","0","0","0","0","0","-2"
"447689","Georgia Gwinnett College","2015","Not on tenure track/No tenure system system total","418","208","210","2","1","1","42","21","21","39","16","23","15","10","5","0","0","0","280","138","142","1","1","0","17","9","8","22","12","10","-2"
"447689","Georgia Gwinnett College","2015","Not on tenure/no tenure system, professors","34","21","13","0","0","0","6","4","2","3","2","1","0","0","0","0","0","0","25","15","10","0","0","0","0","0","0","0","0","0","-2"
"447689","Georgia Gwinnett College","2015","Not on tenure/no tenure system, associate professors","99","55","44","0","0","0","18","9","9","14","5","9","2","2","0","0","0","0","59","34","25","0","0","0","3","3","0","3","2","1","-2"
"447689","Georgia Gwinnett College","2015","Not on tenure/no tenure system, assistant professors","249","124","125","2","1","1","17","8","9","19","9","10","12","8","4","0","0","0","165","81","84","1","1","0","14","6","8","19","10","9","-2"
"447689","Georgia Gwinnett College","2015","Not on tenure/no tenure system, instructors","36","8","28","0","0","0","1","0","1","3","0","3","1","0","1","0","0","0","31","8","23","0","0","0","0","0","0","0","0","0","-2"
"448761","CollegeAmerica-Fort Collins","2015","Not on tenure track/No tenure system system total","3","2","1","0","0","0","0","0","0","0","0","0","1","0","1","0","0","0","2","2","0","0","0","0","0","0","0","0","0","0","-2"
"448761","CollegeAmerica-Fort Collins","2015","Not on tenure/no tenure system, no academic rank","3","2","1","0","0","0","0","0","0","0","0","0","1","0","1","0","0","0","2","2","0","0","0","0","0","0","0","0","0","0","-2"
"448840","University of South Florida-St Petersburg","2015","Tenured total","67","40","27","0","0","0","6","3","3","1","0","1","7","4","3","0","0","0","51","32","19","1","1","0","0","0","0","1","0","1","-2"
"448840","University of South Florida-St Petersburg","2015","Tenured, professors","29","24","5","0","0","0","4","2","2","0","0","0","2","2","0","0","0","0","23","20","3","0","0","0","0","0","0","0","0","0","-2"
"448840","University of South Florida-St Petersburg","2015","Tenured, associate professors","37","16","21","0","0","0","2","1","1","1","0","1","5","2","3","0","0","0","27","12","15","1","1","0","0","0","0","1","0","1","-2"
"448840","University of South Florida-St Petersburg","2015","Tenured, instructors","1","0","1","0","0","0","0","0","0","0","0","0","0","0","0","0","0","0","1","0","1","0","0","0","0","0","0","0","0","0","-2"
"448840","University of South Florida-St Petersburg","2015","On-Tenure track total","30","11","19","0","0","0","2","1","1","1","1","0","4","2","2","0","0","0","21","6","15","0","0","0","0","0","0","2","1","1","-2"
"448840","University of South Florida-St Petersburg","2015","On-tenure track, associate professors","1","0","1","0","0","0","0","0","0","0","0","0","0","0","0","0","0","0","1","0","1","0","0","0","0","0","0","0","0","0","-2"
"448840","University of South Florida-St Petersburg","2015","On-tenure track, assistant professors","27","11","16","0","0","0","2","1","1","1","1","0","4","2","2","0","0","0","18","6","12","0","0","0","0","0","0","2","1","1","-2"
"448840","University of South Florida-St Petersburg","2015","On-tenure track, instructors","2","0","2","0","0","0","0","0","0","0","0","0","0","0","0","0","0","0","2","0","2","0","0","0","0","0","0","0","0","0","-2"
"448840","University of South Florida-St Petersburg","2015","Not on tenure track/No tenure system system total","45","19","26","0","0","0","5","2","3","2","1","1","2","1","1","0","0","0","34","14","20","0","0","0","0","0","0","2","1","1","-2"
"448840","University of South Florida-St Petersburg","2015","Not on tenure/no tenure system, assistant professors","10","3","7","0","0","0","1","0","1","0","0","0","0","0","0","0","0","0","8","3","5","0","0","0","0","0","0","1","0","1","-2"
"448840","University of South Florida-St Petersburg","2015","Not on tenure/no tenure system, instructors","27","12","15","0","0","0","4","2","2","1","0","1","1","1","0","0","0","0","20","8","12","0","0","0","0","0","0","1","1","0","-2"
"448840","University of South Florida-St Petersburg","2015","Not on tenure/no tenure system, no academic rank","8","4","4","0","0","0","0","0","0","1","1","0","1","0","1","0","0","0","6","3","3","0","0","0","0","0","0","0","0","0","-2"
"451671","University of South Florida-Sarasota-Manatee","2015","Tenured total","23","11","12","0","0","0","4","2","2","2","1","1","0","0","0","0","0","0","16","7","9","0","0","0","0","0","0","1","1","0","-2"
"451671","University of South Florida-Sarasota-Manatee","2015","Tenured, professors","5","4","1","0","0","0","1","1","0","0","0","0","0","0","0","0","0","0","4","3","1","0","0","0","0","0","0","0","0","0","-2"
"451671","University of South Florida-Sarasota-Manatee","2015","Tenured, associate professors","18","7","11","0","0","0","3","1","2","2","1","1","0","0","0","0","0","0","12","4","8","0","0","0","0","0","0","1","1","0","-2"
"451671","University of South Florida-Sarasota-Manatee","2015","On-Tenure track total","14","7","7","0","0","0","1","0","1","1","1","0","2","2","0","0","0","0","9","4","5","0","0","0","0","0","0","1","0","1","-2"
"451671","University of South Florida-Sarasota-Manatee","2015","On-tenure track, associate professors","3","2","1","0","0","0","0","0","0","1","1","0","0","0","0","0","0","0","2","1","1","0","0","0","0","0","0","0","0","0","-2"
"451671","University of South Florida-Sarasota-Manatee","2015","On-tenure track, assistant professors","11","5","6","0","0","0","1","0","1","0","0","0","2","2","0","0","0","0","7","3","4","0","0","0","0","0","0","1","0","1","-2"
"451671","University of South Florida-Sarasota-Manatee","2015","Not on tenure track/No tenure system system total","45","21","24","0","0","0","3","1","2","2","1","1","3","2","1","0","0","0","33","14","19","0","0","0","0","0","0","4","3","1","-2"
"451671","University of South Florida-Sarasota-Manatee","2015","Not on tenure/no tenure system, assistant professors","5","1","4","0","0","0","0","0","0","0","0","0","0","0","0","0","0","0","4","1","3","0","0","0","0","0","0","1","0","1","-2"
"451671","University of South Florida-Sarasota-Manatee","2015","Not on tenure/no tenure system, instructors","39","19","20","0","0","0","3","1","2","2","1","1","3","2","1","0","0","0","28","12","16","0","0","0","0","0","0","3","3","0","-2"
"451671","University of South Florida-Sarasota-Manatee","2015","Not on tenure/no tenure system, no academic rank","1","1","0","0","0","0","0","0","0","0","0","0","0","0","0","0","0","0","1","1","0","0","0","0","0","0","0","0","0","0","-2"
"455664","The Chicago School of Professional Psychology at Los Angeles","2015","Not on tenure track/No tenure system system total","23","14","9","0","0","0","0","0","0","6","1","5","1","1","0","0","0","0","13","9","4","2","2","0","1","1","0","0","0","0","-2"
"455664","The Chicago School of Professional Psychology at Los Angeles","2015","Not on tenure/no tenure system, professors","3","2","1","0","0","0","0","0","0","1","0","1","0","0","0","0","0","0","1","1","0","0","0","0","1","1","0","0","0","0","-2"
"455664","The Chicago School of Professional Psychology at Los Angeles","2015","Not on tenure/no tenure system, associate professors","10","8","2","0","0","0","0","0","0","3","1","2","1","1","0","0","0","0","6","6","0","0","0","0","0","0","0","0","0","0","-2"
"455664","The Chicago School of Professional Psychology at Los Angeles","2015","Not on tenure/no tenure system, assistant professors","10","4","6","0","0","0","0","0","0","2","0","2","0","0","0","0","0","0","6","2","4","2","2","0","0","0","0","0","0","0","-2"
"459824","Touro University Nevada","2015","Not on tenure track/No tenure system system total","72","32","40","0","0","0","9","2","7","1","0","1","0","0","0","0","0","0","61","29","32","0","0","0","0","0","0","1","1","0","-2"
"459824","Touro University Nevada","2015","Not on tenure/no tenure system, professors","7","7","0","0","0","0","1","1","0","0","0","0","0","0","0","0","0","0","5","5","0","0","0","0","0","0","0","1","1","0","-2"
"459824","Touro University Nevada","2015","Not on tenure/no tenure system, associate professors","14","3","11","0","0","0","3","0","3","0","0","0","0","0","0","0","0","0","11","3","8","0","0","0","0","0","0","0","0","0","-2"
"459824","Touro University Nevada","2015","Not on tenure/no tenure system, assistant professors","51","22","29","0","0","0","5","1","4","1","0","1","0","0","0","0","0","0","45","21","24","0","0","0","0","0","0","0","0","0","-2"
"459842","Herzing University-Kenosha","2015","Not on tenure track/No tenure system system total","16","1","15","1","0","1","1","0","1","0","0","0","0","0","0","0","0","0","13","1","12","0","0","0","1","0","1","0","0","0","-2"
"459842","Herzing University-Kenosha","2015","Not on tenure/no tenure system, professors","10","0","10","0","0","0","0","0","0","0","0","0","0","0","0","0","0","0","9","0","9","0","0","0","1","0","1","0","0","0","-2"
"459842","Herzing University-Kenosha","2015","Not on tenure/no tenure system, associate professors","4","0","4","1","0","1","1","0","1","0","0","0","0","0","0","0","0","0","2","0","2","0","0","0","0","0","0","0","0","0","-2"
"459842","Herzing University-Kenosha","2015","Not on tenure/no tenure system, assistant professors","2","1","1","0","0","0","0","0","0","0","0","0","0","0","0","0","0","0","2","1","1","0","0","0","0","0","0","0","0","0","-2"
"460899","Stevens-Henager College","2015","Not on tenure track/No tenure system system total","12","7","5","0","0","0","1","0","1","0","0","0","1","1","0","0","0","0","10","6","4","0","0","0","0","0","0","0","0","0","-2"
"460899","Stevens-Henager College","2015","Not on tenure/no tenure system, no academic rank","12","7","5","0","0","0","1","0","1","0","0","0","1","1","0","0","0","0","10","6","4","0","0","0","0","0","0","0","0","0","-2"
"461795","North American University","2015","Not on tenure track/No tenure system system total","21","13","8","0","0","0","1","1","0","1","0","1","0","0","0","0","0","0","16","11","5","0","0","0","0","0","0","3","1","2","-2"
"461795","North American University","2015","Not on tenure/no tenure system, associate professors","8","7","1","0","0","0","0","0","0","0","0","0","0","0","0","0","0","0","8","7","1","0","0","0","0","0","0","0","0","0","-2"
"461795","North American University","2015","Not on tenure/no tenure system, assistant professors","10","4","6","0","0","0","0","0","0","0","0","0","0","0","0","0","0","0","7","3","4","0","0","0","0","0","0","3","1","2","-2"
"461795","North American University","2015","Not on tenure/no tenure system, instructors","3","2","1","0","0","0","1","1","0","1","0","1","0","0","0","0","0","0","1","1","0","0","0","0","0","0","0","0","0","0","-2"
"482936","Florida Polytechnic University","2015","Not on tenure track/No tenure system system total","37","26","11","0","0","0","5","4","1","1","1","0","1","1","0","1","1","0","25","17","8","0","0","0","4","2","2","0","0","0","-2"
"482936","Florida Polytechnic University","2015","Not on tenure/no tenure system, associate professors","13","10","3","0","0","0","3","2","1","0","0","0","1","1","0","0","0","0","8","6","2","0","0","0","1","1","0","0","0","0","-2"
"482936","Florida Polytechnic University","2015","Not on tenure/no tenure system, assistant professors","23","15","8","0","0","0","2","2","0","1","1","0","0","0","0","1","1","0","16","10","6","0","0","0","3","1","2","0","0","0","-2"
"482936","Florida Polytechnic University","2015","Not on tenure/no tenure system, instructors","1","1","0","0","0","0","0","0","0","0","0","0","0","0","0","0","0","0","1","1","0","0","0","0","0","0","0","0","0","0","-2"
"483124","Arizona State University Digital Immersion","2015","Tenured total","109","68","41","0","0","0","7","3","4","5","2","3","8","4","4","0","0","0","84","57","27","1","0","1","2","1","1","2","1","1","-2"
"483124","Arizona State University Digital Immersion","2015","Tenured, professors","57","44","13","0","0","0","4","3","1","1","1","0","4","3","1","0","0","0","46","36","10","0","0","0","1","0","1","1","1","0","-2"
"483124","Arizona State University Digital Immersion","2015","Tenured, associate professors","52","24","28","0","0","0","3","0","3","4","1","3","4","1","3","0","0","0","38","21","17","1","0","1","1","1","0","1","0","1","-2"
"483124","Arizona State University Digital Immersion","2015","On-Tenure track total","37","17","20","0","0","0","6","2","4","0","0","0","1","1","0","0","0","0","22","9","13","1","0","1","2","2","0","5","3","2","-2"
"483124","Arizona State University Digital Immersion","2015","On-tenure track, associate professors","2","2","0","0","0","0","0","0","0","0","0","0","0","0","0","0","0","0","1","1","0","0","0","0","0","0","0","1","1","0","-2"
"483124","Arizona State University Digital Immersion","2015","On-tenure track, assistant professors","35","15","20","0","0","0","6","2","4","0","0","0","1","1","0","0","0","0","21","8","13","1","0","1","2","2","0","4","2","2","-2"
"483124","Arizona State University Digital Immersion","2015","Not on tenure track/No tenure system system total","293","98","195","1","0","1","14","6","8","11","1","10","22","8","14","2","1","1","239","82","157","3","0","3","0","0","0","1","0","1","-2"
"483124","Arizona State University Digital Immersion","2015","Not on tenure/no tenure system, professors","11","5","6","0","0","0","0","0","0","0","0","0","1","0","1","0","0","0","10","5","5","0","0","0","0","0","0","0","0","0","-2"
"483124","Arizona State University Digital Immersion","2015","Not on tenure/no tenure system, associate professors","25","5","20","0","0","0","0","0","0","0","0","0","1","0","1","0","0","0","23","5","18","1","0","1","0","0","0","0","0","0","-2"
"483124","Arizona State University Digital Immersion","2015","Not on tenure/no tenure system, assistant professors","17","3","14","0","0","0","0","0","0","0","0","0","1","0","1","0","0","0","16","3","13","0","0","0","0","0","0","0","0","0","-2"
"483124","Arizona State University Digital Immersion","2015","Not on tenure/no tenure system, instructors","95","31","64","1","0","1","4","1","3","4","0","4","10","4","6","0","0","0","76","26","50","0","0","0","0","0","0","0","0","0","-2"
"483124","Arizona State University Digital Immersion","2015","Not on tenure/no tenure system, lecturers","145","54","91","0","0","0","10","5","5","7","1","6","9","4","5","2","1","1","114","43","71","2","0","2","0","0","0","1","0","1","-2"
"484473","University of Florida-Online","2015","Tenured total","1","0","1","0","0","0","0","0","0","0","0","0","0","0","0","0","0","0","1","0","1","0","0","0","0","0","0","0","0","0","-2"
"484473","University of Florida-Online","2015","Tenured, professors","1","0","1","0","0","0","0","0","0","0","0","0","0","0","0","0","0","0","1","0","1","0","0","0","0","0","0","0","0","0","-2"
"484473","University of Florida-Online","2015","Not on tenure track/No tenure system system total","3","2","1","0","0","0","0","0","0","1","1","0","0","0","0","0","0","0","2","1","1","0","0","0","0","0","0","0","0","0","-2"
"484473","University of Florida-Online","2015","Not on tenure/no tenure system, lecturers","1","1","0","0","0","0","0","0","0","0","0","0","0","0","0","0","0","0","1","1","0","0","0","0","0","0","0","0","0","0","-2"
"484473","University of Florida-Online","2015","Not on tenure/no tenure system, no academic rank","2","1","1","0","0","0","0","0","0","1","1","0","0","0","0","0","0","0","1","0","1","0","0","0","0","0","0","0","0","0","-2"
