"unitid","institution name","year","S2019_IS.Instructional staff category","S2019_IS.Grand total","S2019_IS.Grand total men","S2019_IS.Grand total women","S2019_IS.American Indian or Alaska Native total","S2019_IS.American Indian or Alaska Native men","S2019_IS.American Indian or Alaska Native women","S2019_IS.Asian total","S2019_IS.Asian men","S2019_IS.Asian women","S2019_IS.Black or African American total","S2019_IS.Black or African American men","S2019_IS.Black or African American women","S2019_IS.Hispanic or Latino total","S2019_IS.Hispanic or Latino men","S2019_IS.Hispanic or Latino women","S2019_IS.Native Hawaiian or Other Pacific Islander total","S2019_IS.Native Hawaiian or Other Pacific Islander men","S2019_IS.Native Hawaiian or Other Pacific Islander women","S2019_IS.White total","S2019_IS.White men","S2019_IS.White women","S2019_IS.Two or more races total","S2019_IS.Two or more races men","S2019_IS.Two or more races women","S2019_IS.Race/ethnicity unknown total","S2019_IS.Race/ethnicity unknown men","S2019_IS.Race/ethnicity unknown women","S2019_IS.Nonresident alien total","S2019_IS.Nonresident alien men","S2019_IS.Nonresident alien women","IDX_HR"
"105899","Arizona Christian University","2019","Not on tenure track/No tenure system system total","24","16","8","0","0","0","0","0","0","0","0","0","0","0","0","0","0","0","22","14","8","2","2","0","0","0","0","0","0","0","-2"
"105899","Arizona Christian University","2019","Not on tenure/no tenure system, professors","2","1","1","0","0","0","0","0","0","0","0","0","0","0","0","0","0","0","2","1","1","0","0","0","0","0","0","0","0","0","-2"
"105899","Arizona Christian University","2019","Not on tenure/no tenure system, associate professors","8","4","4","0","0","0","0","0","0","0","0","0","0","0","0","0","0","0","7","3","4","1","1","0","0","0","0","0","0","0","-2"
"105899","Arizona Christian University","2019","Not on tenure/no tenure system, assistant professors","11","9","2","0","0","0","0","0","0","0","0","0","0","0","0","0","0","0","10","8","2","1","1","0","0","0","0","0","0","0","-2"
"105899","Arizona Christian University","2019","Not on tenure/no tenure system, instructors","3","2","1","0","0","0","0","0","0","0","0","0","0","0","0","0","0","0","3","2","1","0","0","0","0","0","0","0","0","0","-2"
"110097","Biola University","2019","Tenured total","235","152","83","1","0","1","35","16","19","8","5","3","17","9","8","2","2","0","153","112","41","0","0","0","17","8","9","2","0","2","-2"
"110097","Biola University","2019","Tenured, professors","67","61","6","0","0","0","6","5","1","0","0","0","6","4","2","1","1","0","52","49","3","0","0","0","2","2","0","0","0","0","-2"
"110097","Biola University","2019","Tenured, associate professors","136","75","61","1","0","1","22","8","14","6","4","2","10","4","6","1","1","0","88","55","33","0","0","0","7","3","4","1","0","1","-2"
"110097","Biola University","2019","Tenured, assistant professors","32","16","16","0","0","0","7","3","4","2","1","1","1","1","0","0","0","0","13","8","5","0","0","0","8","3","5","1","0","1","-2"
"110097","Biola University","2019","On-Tenure track total","41","20","21","0","0","0","3","2","1","0","0","0","1","0","1","0","0","0","37","18","19","0","0","0","0","0","0","0","0","0","-2"
"110097","Biola University","2019","On-tenure track, associate professors","6","5","1","0","0","0","0","0","0","0","0","0","1","0","1","0","0","0","5","5","0","0","0","0","0","0","0","0","0","0","-2"
"110097","Biola University","2019","On-tenure track, assistant professors","15","5","10","0","0","0","1","0","1","0","0","0","0","0","0","0","0","0","14","5","9","0","0","0","0","0","0","0","0","0","-2"
"110097","Biola University","2019","On-tenure track, instructors","20","10","10","0","0","0","2","2","0","0","0","0","0","0","0","0","0","0","18","8","10","0","0","0","0","0","0","0","0","0","-2"
"110316","California Institute of Integral Studies","2019","Not on tenure track/No tenure system system total","58","27","31","0","0","0","3","1","2","1","0","1","4","0","4","0","0","0","46","22","24","3","3","0","0","0","0","1","1","0","-2"
"110316","California Institute of Integral Studies","2019","Not on tenure/no tenure system, professors","26","17","9","0","0","0","1","1","0","0","0","0","0","0","0","0","0","0","23","14","9","2","2","0","0","0","0","0","0","0","-2"
"110316","California Institute of Integral Studies","2019","Not on tenure/no tenure system, associate professors","13","5","8","0","0","0","1","0","1","1","0","1","1","0","1","0","0","0","9","4","5","0","0","0","0","0","0","1","1","0","-2"
"110316","California Institute of Integral Studies","2019","Not on tenure/no tenure system, assistant professors","11","2","9","0","0","0","0","0","0","0","0","0","1","0","1","0","0","0","9","1","8","1","1","0","0","0","0","0","0","0","-2"
"110316","California Institute of Integral Studies","2019","Not on tenure/no tenure system, lecturers","8","3","5","0","0","0","1","0","1","0","0","0","2","0","2","0","0","0","5","3","2","0","0","0","0","0","0","0","0","0","-2"
"110422","California Polytechnic State University-San Luis Obispo","2019","Tenured total","449","306","143","2","2","0","51","33","18","7","5","2","28","21","7","0","0","0","332","224","108","5","4","1","22","16","6","2","1","1","-2"
"110422","California Polytechnic State University-San Luis Obispo","2019","Tenured, professors","326","232","94","1","1","0","38","24","14","5","4","1","19","15","4","0","0","0","241","171","70","4","4","0","17","13","4","1","0","1","-2"
"110422","California Polytechnic State University-San Luis Obispo","2019","Tenured, associate professors","119","72","47","1","1","0","13","9","4","2","1","1","9","6","3","0","0","0","87","51","36","1","0","1","5","3","2","1","1","0","-2"
"110422","California Polytechnic State University-San Luis Obispo","2019","Tenured, no academic rank","4","2","2","0","0","0","0","0","0","0","0","0","0","0","0","0","0","0","4","2","2","0","0","0","0","0","0","0","0","0","-2"
"110422","California Polytechnic State University-San Luis Obispo","2019","On-Tenure track total","227","123","104","1","0","1","22","12","10","6","3","3","7","2","5","0","0","0","151","83","68","3","1","2","14","8","6","23","14","9","-2"
"110422","California Polytechnic State University-San Luis Obispo","2019","On-tenure track, professors","4","3","1","0","0","0","1","1","0","0","0","0","1","0","1","0","0","0","2","2","0","0","0","0","0","0","0","0","0","0","-2"
"110422","California Polytechnic State University-San Luis Obispo","2019","On-tenure track, associate professors","22","17","5","0","0","0","4","4","0","0","0","0","0","0","0","0","0","0","17","12","5","0","0","0","0","0","0","1","1","0","-2"
"110422","California Polytechnic State University-San Luis Obispo","2019","On-tenure track, assistant professors","201","103","98","1","0","1","17","7","10","6","3","3","6","2","4","0","0","0","132","69","63","3","1","2","14","8","6","22","13","9","-2"
"110422","California Polytechnic State University-San Luis Obispo","2019","Not on tenure track/No tenure system system total","218","135","83","0","0","0","5","1","4","3","3","0","6","4","2","0","0","0","171","102","69","2","2","0","12","9","3","19","14","5","-2"
"110422","California Polytechnic State University-San Luis Obispo","2019","Not on tenure/no tenure system, lecturers","218","135","83","0","0","0","5","1","4","3","3","0","6","4","2","0","0","0","171","102","69","2","2","0","12","9","3","19","14","5","-2"
"111188","California State University Maritime Academy","2019","Tenured total","35","28","7","0","0","0","4","3","1","1","1","0","2","1","1","0","0","0","28","23","5","0","0","0","0","0","0","0","0","0","-2"
"111188","California State University Maritime Academy","2019","Tenured, professors","16","12","4","0","0","0","1","0","1","1","1","0","1","0","1","0","0","0","13","11","2","0","0","0","0","0","0","0","0","0","-2"
"111188","California State University Maritime Academy","2019","Tenured, associate professors","18","15","3","0","0","0","3","3","0","0","0","0","1","1","0","0","0","0","14","11","3","0","0","0","0","0","0","0","0","0","-2"
"111188","California State University Maritime Academy","2019","Tenured, assistant professors","1","1","0","0","0","0","0","0","0","0","0","0","0","0","0","0","0","0","1","1","0","0","0","0","0","0","0","0","0","0","-2"
"111188","California State University Maritime Academy","2019","On-Tenure track total","20","12","8","0","0","0","2","1","1","1","1","0","1","1","0","0","0","0","16","9","7","0","0","0","0","0","0","0","0","0","-2"
"111188","California State University Maritime Academy","2019","On-tenure track, assistant professors","20","12","8","0","0","0","2","1","1","1","1","0","1","1","0","0","0","0","16","9","7","0","0","0","0","0","0","0","0","0","-2"
"111188","California State University Maritime Academy","2019","Not on tenure track/No tenure system system total","16","11","5","0","0","0","1","0","1","0","0","0","0","0","0","0","0","0","14","10","4","0","0","0","1","1","0","0","0","0","-2"
"111188","California State University Maritime Academy","2019","Not on tenure/no tenure system, lecturers","16","11","5","0","0","0","1","0","1","0","0","0","0","0","0","0","0","0","14","10","4","0","0","0","1","1","0","0","0","0","-2"
"111948","Chapman University","2019","Tenured total","247","162","85","0","0","0","19","8","11","8","6","2","10","6","4","0","0","0","165","113","52","3","2","1","38","25","13","4","2","2","-2"
"111948","Chapman University","2019","Tenured, professors","139","104","35","0","0","0","11","5","6","3","3","0","4","3","1","0","0","0","93","72","21","2","1","1","24","18","6","2","2","0","-2"
"111948","Chapman University","2019","Tenured, associate professors","108","58","50","0","0","0","8","3","5","5","3","2","6","3","3","0","0","0","72","41","31","1","1","0","14","7","7","2","0","2","-2"
"111948","Chapman University","2019","On-Tenure track total","101","51","50","0","0","0","11","2","9","0","0","0","2","2","0","0","0","0","28","13","15","1","0","1","45","24","21","14","10","4","-2"
"111948","Chapman University","2019","On-tenure track, associate professors","8","4","4","0","0","0","0","0","0","0","0","0","0","0","0","0","0","0","2","0","2","1","0","1","5","4","1","0","0","0","-2"
"111948","Chapman University","2019","On-tenure track, assistant professors","93","47","46","0","0","0","11","2","9","0","0","0","2","2","0","0","0","0","26","13","13","0","0","0","40","20","20","14","10","4","-2"
"111948","Chapman University","2019","Not on tenure track/No tenure system system total","188","92","96","0","0","0","15","7","8","3","2","1","7","3","4","0","0","0","81","37","44","1","0","1","79","42","37","2","1","1","-2"
"111948","Chapman University","2019","Not on tenure/no tenure system, professors","21","9","12","0","0","0","1","0","1","0","0","0","1","0","1","0","0","0","17","8","9","0","0","0","2","1","1","0","0","0","-2"
"111948","Chapman University","2019","Not on tenure/no tenure system, associate professors","33","19","14","0","0","0","4","2","2","1","1","0","1","1","0","0","0","0","17","9","8","0","0","0","10","6","4","0","0","0","-2"
"111948","Chapman University","2019","Not on tenure/no tenure system, assistant professors","102","43","59","0","0","0","9","5","4","1","0","1","4","1","3","0","0","0","30","9","21","1","0","1","56","27","29","1","1","0","-2"
"111948","Chapman University","2019","Not on tenure/no tenure system, instructors","28","17","11","0","0","0","1","0","1","0","0","0","1","1","0","0","0","0","15","9","6","0","0","0","10","7","3","1","0","1","-2"
"111948","Chapman University","2019","Not on tenure/no tenure system, no academic rank","4","4","0","0","0","0","0","0","0","1","1","0","0","0","0","0","0","0","2","2","0","0","0","0","1","1","0","0","0","0","-2"
"112260","Claremont McKenna College","2019","Tenured total","113","74","39","0","0","0","12","5","7","3","2","1","4","4","0","0","0","0","86","59","27","1","0","1","4","3","1","3","1","2","-2"
"112260","Claremont McKenna College","2019","Tenured, professors","63","44","19","0","0","0","5","3","2","2","1","1","1","1","0","0","0","0","51","37","14","0","0","0","2","2","0","2","0","2","-2"
"112260","Claremont McKenna College","2019","Tenured, associate professors","50","30","20","0","0","0","7","2","5","1","1","0","3","3","0","0","0","0","35","22","13","1","0","1","2","1","1","1","1","0","-2"
"112260","Claremont McKenna College","2019","On-Tenure track total","23","12","11","0","0","0","2","0","2","1","1","0","1","1","0","0","0","0","14","7","7","3","2","1","0","0","0","2","1","1","-2"
"112260","Claremont McKenna College","2019","On-tenure track, assistant professors","23","12","11","0","0","0","2","0","2","1","1","0","1","1","0","0","0","0","14","7","7","3","2","1","0","0","0","2","1","1","-2"
"112260","Claremont McKenna College","2019","Not on tenure track/No tenure system system total","28","17","11","0","0","0","0","0","0","0","0","0","2","1","1","0","0","0","25","15","10","0","0","0","1","1","0","0","0","0","-2"
"112260","Claremont McKenna College","2019","Not on tenure/no tenure system, professors","3","2","1","0","0","0","0","0","0","0","0","0","0","0","0","0","0","0","3","2","1","0","0","0","0","0","0","0","0","0","-2"
"112260","Claremont McKenna College","2019","Not on tenure/no tenure system, associate professors","2","2","0","0","0","0","0","0","0","0","0","0","0","0","0","0","0","0","2","2","0","0","0","0","0","0","0","0","0","0","-2"
"112260","Claremont McKenna College","2019","Not on tenure/no tenure system, assistant professors","23","13","10","0","0","0","0","0","0","0","0","0","2","1","1","0","0","0","20","11","9","0","0","0","1","1","0","0","0","0","-2"
"112570","Columbia College Hollywood","2019","Not on tenure track/No tenure system system total","12","9","3","0","0","0","0","0","0","1","1","0","1","1","0","0","0","0","9","6","3","0","0","0","1","1","0","0","0","0","-2"
"112570","Columbia College Hollywood","2019","Not on tenure/no tenure system, instructors","12","9","3","0","0","0","0","0","0","1","1","0","1","1","0","0","0","0","9","6","3","0","0","0","1","1","0","0","0","0","-2"
"115083","Golden Gate University-San Francisco","2019","Tenured total","21","10","11","0","0","0","3","1","2","1","1","0","1","0","1","0","0","0","16","8","8","0","0","0","0","0","0","0","0","0","-2"
"115083","Golden Gate University-San Francisco","2019","Tenured, professors","19","9","10","0","0","0","3","1","2","1","1","0","1","0","1","0","0","0","14","7","7","0","0","0","0","0","0","0","0","0","-2"
"115083","Golden Gate University-San Francisco","2019","Tenured, associate professors","2","1","1","0","0","0","0","0","0","0","0","0","0","0","0","0","0","0","2","1","1","0","0","0","0","0","0","0","0","0","-2"
"115083","Golden Gate University-San Francisco","2019","On-Tenure track total","5","1","4","0","0","0","2","0","2","1","0","1","0","0","0","0","0","0","2","1","1","0","0","0","0","0","0","0","0","0","-2"
"115083","Golden Gate University-San Francisco","2019","On-tenure track, associate professors","5","1","4","0","0","0","2","0","2","1","0","1","0","0","0","0","0","0","2","1","1","0","0","0","0","0","0","0","0","0","-2"
"115083","Golden Gate University-San Francisco","2019","Not on tenure track/No tenure system system total","33","14","19","0","0","0","1","0","1","1","1","0","1","1","0","0","0","0","28","12","16","1","0","1","1","0","1","0","0","0","-2"
"115083","Golden Gate University-San Francisco","2019","Not on tenure/no tenure system, professors","12","4","8","0","0","0","1","0","1","0","0","0","0","0","0","0","0","0","10","4","6","1","0","1","0","0","0","0","0","0","-2"
"115083","Golden Gate University-San Francisco","2019","Not on tenure/no tenure system, associate professors","14","7","7","0","0","0","0","0","0","0","0","0","0","0","0","0","0","0","14","7","7","0","0","0","0","0","0","0","0","0","-2"
"115083","Golden Gate University-San Francisco","2019","Not on tenure/no tenure system, assistant professors","1","0","1","0","0","0","0","0","0","0","0","0","0","0","0","0","0","0","0","0","0","0","0","0","1","0","1","0","0","0","-2"
"115083","Golden Gate University-San Francisco","2019","Not on tenure/no tenure system, instructors","4","2","2","0","0","0","0","0","0","1","1","0","0","0","0","0","0","0","3","1","2","0","0","0","0","0","0","0","0","0","-2"
"115083","Golden Gate University-San Francisco","2019","Not on tenure/no tenure system, lecturers","2","1","1","0","0","0","0","0","0","0","0","0","1","1","0","0","0","0","1","0","1","0","0","0","0","0","0","0","0","0","-2"
"115409","Harvey Mudd College","2019","Tenured total","72","47","25","0","0","0","9","4","5","3","2","1","3","2","1","0","0","0","55","38","17","0","0","0","2","1","1","0","0","0","-2"
"115409","Harvey Mudd College","2019","Tenured, professors","55","40","15","0","0","0","8","4","4","1","1","0","3","2","1","0","0","0","43","33","10","0","0","0","0","0","0","0","0","0","-2"
"115409","Harvey Mudd College","2019","Tenured, associate professors","17","7","10","0","0","0","1","0","1","2","1","1","0","0","0","0","0","0","12","5","7","0","0","0","2","1","1","0","0","0","-2"
"115409","Harvey Mudd College","2019","On-Tenure track total","26","16","10","0","0","0","5","3","2","0","0","0","3","3","0","0","0","0","14","7","7","2","1","1","1","1","0","1","1","0","-2"
"115409","Harvey Mudd College","2019","On-tenure track, associate professors","2","1","1","0","0","0","0","0","0","0","0","0","0","0","0","0","0","0","2","1","1","0","0","0","0","0","0","0","0","0","-2"
"115409","Harvey Mudd College","2019","On-tenure track, assistant professors","24","15","9","0","0","0","5","3","2","0","0","0","3","3","0","0","0","0","12","6","6","2","1","1","1","1","0","1","1","0","-2"
"115409","Harvey Mudd College","2019","Not on tenure track/No tenure system system total","8","1","7","0","0","0","3","1","2","0","0","0","0","0","0","0","0","0","4","0","4","0","0","0","0","0","0","1","0","1","-2"
"115409","Harvey Mudd College","2019","Not on tenure/no tenure system, associate professors","1","1","0","0","0","0","1","1","0","0","0","0","0","0","0","0","0","0","0","0","0","0","0","0","0","0","0","0","0","0","-2"
"115409","Harvey Mudd College","2019","Not on tenure/no tenure system, instructors","7","0","7","0","0","0","2","0","2","0","0","0","0","0","0","0","0","0","4","0","4","0","0","0","0","0","0","1","0","1","-2"
"117168","Laguna College of Art and Design","2019","Not on tenure track/No tenure system system total","26","20","6","0","0","0","1","1","0","0","0","0","1","1","0","0","0","0","24","18","6","0","0","0","0","0","0","0","0","0","-2"
"117168","Laguna College of Art and Design","2019","Not on tenure/no tenure system, professors","7","4","3","0","0","0","0","0","0","0","0","0","0","0","0","0","0","0","7","4","3","0","0","0","0","0","0","0","0","0","-2"
"117168","Laguna College of Art and Design","2019","Not on tenure/no tenure system, associate professors","13","10","3","0","0","0","1","1","0","0","0","0","0","0","0","0","0","0","12","9","3","0","0","0","0","0","0","0","0","0","-2"
"117168","Laguna College of Art and Design","2019","Not on tenure/no tenure system, assistant professors","6","6","0","0","0","0","0","0","0","0","0","0","1","1","0","0","0","0","5","5","0","0","0","0","0","0","0","0","0","0","-2"
"117575","Southern California Seminary","2019","Not on tenure track/No tenure system system total","6","6","0","0","0","0","2","2","0","0","0","0","0","0","0","0","0","0","3","3","0","0","0","0","0","0","0","1","1","0","-2"
"117575","Southern California Seminary","2019","Not on tenure/no tenure system, professors","6","6","0","0","0","0","2","2","0","0","0","0","0","0","0","0","0","0","3","3","0","0","0","0","0","0","0","1","1","0","-2"
"117946","Loyola Marymount University","2019","Tenured total","351","197","154","1","0","1","45","26","19","19","11","8","38","14","24","1","1","0","225","132","93","5","2","3","17","11","6","0","0","0","-2"
"117946","Loyola Marymount University","2019","Tenured, professors","228","145","83","1","0","1","27","18","9","11","7","4","23","10","13","1","1","0","149","99","50","2","1","1","14","9","5","0","0","0","-2"
"117946","Loyola Marymount University","2019","Tenured, associate professors","118","49","69","0","0","0","16","7","9","8","4","4","15","4","11","0","0","0","74","32","42","2","0","2","3","2","1","0","0","0","-2"
"117946","Loyola Marymount University","2019","Tenured, assistant professors","5","3","2","0","0","0","2","1","1","0","0","0","0","0","0","0","0","0","2","1","1","1","1","0","0","0","0","0","0","0","-2"
"117946","Loyola Marymount University","2019","On-Tenure track total","104","48","56","0","0","0","19","5","14","7","1","6","10","3","7","1","1","0","49","28","21","4","2","2","1","1","0","13","7","6","-2"
"117946","Loyola Marymount University","2019","On-tenure track, associate professors","3","1","2","0","0","0","0","0","0","0","0","0","0","0","0","0","0","0","2","1","1","0","0","0","0","0","0","1","0","1","-2"
"117946","Loyola Marymount University","2019","On-tenure track, assistant professors","101","47","54","0","0","0","19","5","14","7","1","6","10","3","7","1","1","0","47","27","20","4","2","2","1","1","0","12","7","5","-2"
"117946","Loyola Marymount University","2019","Not on tenure track/No tenure system system total","166","75","91","0","0","0","15","6","9","10","4","6","15","8","7","0","0","0","110","49","61","4","2","2","10","5","5","2","1","1","-2"
"117946","Loyola Marymount University","2019","Not on tenure/no tenure system, professors","15","9","6","0","0","0","0","0","0","0","0","0","0","0","0","0","0","0","14","9","5","0","0","0","1","0","1","0","0","0","-2"
"117946","Loyola Marymount University","2019","Not on tenure/no tenure system, associate professors","32","9","23","0","0","0","1","0","1","1","0","1","3","2","1","0","0","0","26","6","20","0","0","0","1","1","0","0","0","0","-2"
"117946","Loyola Marymount University","2019","Not on tenure/no tenure system, assistant professors","85","44","41","0","0","0","11","5","6","8","3","5","9","5","4","0","0","0","45","25","20","4","2","2","6","3","3","2","1","1","-2"
"117946","Loyola Marymount University","2019","Not on tenure/no tenure system, instructors","33","12","21","0","0","0","2","0","2","1","1","0","3","1","2","0","0","0","25","9","16","0","0","0","2","1","1","0","0","0","-2"
"117946","Loyola Marymount University","2019","Not on tenure/no tenure system, no academic rank","1","1","0","0","0","0","1","1","0","0","0","0","0","0","0","0","0","0","0","0","0","0","0","0","0","0","0","0","0","0","-2"
"120403","Otis College of Art and Design","2019","Not on tenure track/No tenure system system total","53","23","30","1","1","0","7","3","4","1","0","1","5","3","2","0","0","0","34","15","19","2","1","1","3","0","3","0","0","0","-2"
"120403","Otis College of Art and Design","2019","Not on tenure/no tenure system, professors","16","6","10","0","0","0","3","0","3","0","0","0","0","0","0","0","0","0","12","6","6","0","0","0","1","0","1","0","0","0","-2"
"120403","Otis College of Art and Design","2019","Not on tenure/no tenure system, associate professors","18","9","9","1","1","0","0","0","0","0","0","0","3","3","0","0","0","0","12","5","7","0","0","0","2","0","2","0","0","0","-2"
"120403","Otis College of Art and Design","2019","Not on tenure/no tenure system, assistant professors","19","8","11","0","0","0","4","3","1","1","0","1","2","0","2","0","0","0","10","4","6","2","1","1","0","0","0","0","0","0","-2"
"120698","Palo Alto University","2019","Tenured total","13","6","7","0","0","0","1","0","1","0","0","0","2","1","1","0","0","0","10","5","5","0","0","0","0","0","0","0","0","0","-2"
"120698","Palo Alto University","2019","Tenured, professors","9","5","4","0","0","0","1","0","1","0","0","0","1","1","0","0","0","0","7","4","3","0","0","0","0","0","0","0","0","0","-2"
"120698","Palo Alto University","2019","Tenured, associate professors","3","1","2","0","0","0","0","0","0","0","0","0","1","0","1","0","0","0","2","1","1","0","0","0","0","0","0","0","0","0","-2"
"120698","Palo Alto University","2019","Tenured, assistant professors","1","0","1","0","0","0","0","0","0","0","0","0","0","0","0","0","0","0","1","0","1","0","0","0","0","0","0","0","0","0","-2"
"120698","Palo Alto University","2019","On-Tenure track total","6","2","4","0","0","0","0","0","0","0","0","0","0","0","0","0","0","0","6","2","4","0","0","0","0","0","0","0","0","0","-2"
"120698","Palo Alto University","2019","On-tenure track, associate professors","4","1","3","0","0","0","0","0","0","0","0","0","0","0","0","0","0","0","4","1","3","0","0","0","0","0","0","0","0","0","-2"
"120698","Palo Alto University","2019","On-tenure track, assistant professors","2","1","1","0","0","0","0","0","0","0","0","0","0","0","0","0","0","0","2","1","1","0","0","0","0","0","0","0","0","0","-2"
"120698","Palo Alto University","2019","Not on tenure track/No tenure system system total","31","9","22","0","0","0","7","1","6","1","0","1","0","0","0","0","0","0","22","8","14","1","0","1","0","0","0","0","0","0","-2"
"120698","Palo Alto University","2019","Not on tenure/no tenure system, professors","9","2","7","0","0","0","2","1","1","0","0","0","0","0","0","0","0","0","7","1","6","0","0","0","0","0","0","0","0","0","-2"
"120698","Palo Alto University","2019","Not on tenure/no tenure system, associate professors","7","3","4","0","0","0","1","0","1","1","0","1","0","0","0","0","0","0","5","3","2","0","0","0","0","0","0","0","0","0","-2"
"120698","Palo Alto University","2019","Not on tenure/no tenure system, assistant professors","3","0","3","0","0","0","1","0","1","0","0","0","0","0","0","0","0","0","2","0","2","0","0","0","0","0","0","0","0","0","-2"
"120698","Palo Alto University","2019","Not on tenure/no tenure system, no academic rank","12","4","8","0","0","0","3","0","3","0","0","0","0","0","0","0","0","0","8","4","4","1","0","1","0","0","0","0","0","0","-2"
"120883","University of the Pacific","2019","Tenured total","232","139","93","0","0","0","41","22","19","3","1","2","9","6","3","0","0","0","170","107","63","1","0","1","0","0","0","8","3","5","-2"
"120883","University of the Pacific","2019","Tenured, professors","126","85","41","0","0","0","26","20","6","1","1","0","7","5","2","0","0","0","88","58","30","0","0","0","0","0","0","4","1","3","-2"
"120883","University of the Pacific","2019","Tenured, associate professors","101","51","50","0","0","0","15","2","13","2","0","2","2","1","1","0","0","0","78","46","32","0","0","0","0","0","0","4","2","2","-2"
"120883","University of the Pacific","2019","Tenured, assistant professors","5","3","2","0","0","0","0","0","0","0","0","0","0","0","0","0","0","0","4","3","1","1","0","1","0","0","0","0","0","0","-2"
"120883","University of the Pacific","2019","On-Tenure track total","58","28","30","1","0","1","15","5","10","0","0","0","6","1","5","0","0","0","31","20","11","2","1","1","0","0","0","3","1","2","-2"
"120883","University of the Pacific","2019","On-tenure track, associate professors","2","0","2","0","0","0","1","0","1","0","0","0","1","0","1","0","0","0","0","0","0","0","0","0","0","0","0","0","0","0","-2"
"120883","University of the Pacific","2019","On-tenure track, assistant professors","56","28","28","1","0","1","14","5","9","0","0","0","5","1","4","0","0","0","31","20","11","2","1","1","0","0","0","3","1","2","-2"
"120883","University of the Pacific","2019","Not on tenure track/No tenure system system total","120","57","63","0","0","0","24","9","15","2","0","2","10","2","8","0","0","0","83","46","37","1","0","1","0","0","0","0","0","0","-2"
"120883","University of the Pacific","2019","Not on tenure/no tenure system, professors","22","8","14","0","0","0","5","2","3","0","0","0","1","0","1","0","0","0","16","6","10","0","0","0","0","0","0","0","0","0","-2"
"120883","University of the Pacific","2019","Not on tenure/no tenure system, associate professors","20","11","9","0","0","0","4","1","3","0","0","0","0","0","0","0","0","0","16","10","6","0","0","0","0","0","0","0","0","0","-2"
"120883","University of the Pacific","2019","Not on tenure/no tenure system, assistant professors","49","22","27","0","0","0","14","5","9","2","0","2","6","2","4","0","0","0","27","15","12","0","0","0","0","0","0","0","0","0","-2"
"120883","University of the Pacific","2019","Not on tenure/no tenure system, instructors","12","7","5","0","0","0","1","1","0","0","0","0","1","0","1","0","0","0","10","6","4","0","0","0","0","0","0","0","0","0","-2"
"120883","University of the Pacific","2019","Not on tenure/no tenure system, lecturers","17","9","8","0","0","0","0","0","0","0","0","0","2","0","2","0","0","0","14","9","5","1","0","1","0","0","0","0","0","0","-2"
"121309","Point Loma Nazarene University","2019","Tenured total","73","45","28","0","0","0","5","2","3","4","2","2","4","1","3","0","0","0","60","40","20","0","0","0","0","0","0","0","0","0","-2"
"121309","Point Loma Nazarene University","2019","Tenured, professors","67","42","25","0","0","0","5","2","3","4","2","2","4","1","3","0","0","0","54","37","17","0","0","0","0","0","0","0","0","0","-2"
"121309","Point Loma Nazarene University","2019","Tenured, associate professors","6","3","3","0","0","0","0","0","0","0","0","0","0","0","0","0","0","0","6","3","3","0","0","0","0","0","0","0","0","0","-2"
"121309","Point Loma Nazarene University","2019","On-Tenure track total","61","24","37","1","0","1","5","2","3","1","0","1","6","2","4","0","0","0","42","16","26","3","3","0","3","1","2","0","0","0","-2"
"121309","Point Loma Nazarene University","2019","On-tenure track, professors","10","6","4","0","0","0","1","0","1","0","0","0","0","0","0","0","0","0","8","5","3","0","0","0","1","1","0","0","0","0","-2"
"121309","Point Loma Nazarene University","2019","On-tenure track, associate professors","31","12","19","0","0","0","3","1","2","1","0","1","3","1","2","0","0","0","21","8","13","2","2","0","1","0","1","0","0","0","-2"
"121309","Point Loma Nazarene University","2019","On-tenure track, assistant professors","20","6","14","1","0","1","1","1","0","0","0","0","3","1","2","0","0","0","13","3","10","1","1","0","1","0","1","0","0","0","-2"
"121309","Point Loma Nazarene University","2019","Not on tenure track/No tenure system system total","15","6","9","0","0","0","0","0","0","0","0","0","1","0","1","1","1","0","13","5","8","0","0","0","0","0","0","0","0","0","-2"
"121309","Point Loma Nazarene University","2019","Not on tenure/no tenure system, professors","1","1","0","0","0","0","0","0","0","0","0","0","0","0","0","0","0","0","1","1","0","0","0","0","0","0","0","0","0","0","-2"
"121309","Point Loma Nazarene University","2019","Not on tenure/no tenure system, associate professors","9","3","6","0","0","0","0","0","0","0","0","0","1","0","1","1","1","0","7","2","5","0","0","0","0","0","0","0","0","0","-2"
"121309","Point Loma Nazarene University","2019","Not on tenure/no tenure system, assistant professors","5","2","3","0","0","0","0","0","0","0","0","0","0","0","0","0","0","0","5","2","3","0","0","0","0","0","0","0","0","0","-2"
"121345","Pomona College","2019","Tenured total","144","80","64","0","0","0","19","5","14","5","3","2","16","11","5","0","0","0","81","46","35","3","3","0","20","12","8","0","0","0","-2"
"121345","Pomona College","2019","Tenured, professors","86","48","38","0","0","0","13","4","9","2","1","1","12","8","4","0","0","0","51","29","22","1","1","0","7","5","2","0","0","0","-2"
"121345","Pomona College","2019","Tenured, associate professors","58","32","26","0","0","0","6","1","5","3","2","1","4","3","1","0","0","0","30","17","13","2","2","0","13","7","6","0","0","0","-2"
"121345","Pomona College","2019","On-Tenure track total","34","19","15","0","0","0","4","2","2","6","3","3","5","3","2","0","0","0","13","7","6","0","0","0","4","2","2","2","2","0","-2"
"121345","Pomona College","2019","On-tenure track, assistant professors","34","19","15","0","0","0","4","2","2","6","3","3","5","3","2","0","0","0","13","7","6","0","0","0","4","2","2","2","2","0","-2"
"121345","Pomona College","2019","Not on tenure track/No tenure system system total","2","0","2","0","0","0","0","0","0","0","0","0","2","0","2","0","0","0","0","0","0","0","0","0","0","0","0","0","0","0","-2"
"121345","Pomona College","2019","Not on tenure/no tenure system, professors","2","0","2","0","0","0","0","0","0","0","0","0","2","0","2","0","0","0","0","0","0","0","0","0","0","0","0","0","0","0","-2"
"122296","Samuel Merritt University","2019","Not on tenure track/No tenure system system total","171","42","129","0","0","0","15","3","12","10","2","8","6","2","4","0","0","0","130","33","97","6","1","5","4","1","3","0","0","0","-2"
"122296","Samuel Merritt University","2019","Not on tenure/no tenure system, professors","16","6","10","0","0","0","2","0","2","0","0","0","0","0","0","0","0","0","11","5","6","2","1","1","1","0","1","0","0","0","-2"
"122296","Samuel Merritt University","2019","Not on tenure/no tenure system, associate professors","22","4","18","0","0","0","2","0","2","0","0","0","0","0","0","0","0","0","19","4","15","0","0","0","1","0","1","0","0","0","-2"
"122296","Samuel Merritt University","2019","Not on tenure/no tenure system, assistant professors","96","21","75","0","0","0","9","1","8","7","1","6","4","1","3","0","0","0","72","18","54","4","0","4","0","0","0","0","0","0","-2"
"122296","Samuel Merritt University","2019","Not on tenure/no tenure system, instructors","37","11","26","0","0","0","2","2","0","3","1","2","2","1","1","0","0","0","28","6","22","0","0","0","2","1","1","0","0","0","-2"
"122436","University of San Diego","2019","Tenured total","283","160","123","0","0","0","31","15","16","8","5","3","25","13","12","0","0","0","214","124","90","4","2","2","1","1","0","0","0","0","-2"
"122436","University of San Diego","2019","Tenured, professors","161","100","61","0","0","0","17","9","8","4","3","1","9","5","4","0","0","0","129","81","48","2","2","0","0","0","0","0","0","0","-2"
"122436","University of San Diego","2019","Tenured, associate professors","122","60","62","0","0","0","14","6","8","4","2","2","16","8","8","0","0","0","85","43","42","2","0","2","1","1","0","0","0","0","-2"
"122436","University of San Diego","2019","On-Tenure track total","96","47","49","1","1","0","12","6","6","10","7","3","10","4","6","0","0","0","52","24","28","3","1","2","3","1","2","5","3","2","-2"
"122436","University of San Diego","2019","On-tenure track, professors","1","0","1","0","0","0","0","0","0","0","0","0","0","0","0","0","0","0","1","0","1","0","0","0","0","0","0","0","0","0","-2"
"122436","University of San Diego","2019","On-tenure track, associate professors","8","2","6","1","1","0","1","0","1","0","0","0","0","0","0","0","0","0","6","1","5","0","0","0","0","0","0","0","0","0","-2"
"122436","University of San Diego","2019","On-tenure track, assistant professors","86","44","42","0","0","0","11","6","5","10","7","3","10","4","6","0","0","0","44","22","22","3","1","2","3","1","2","5","3","2","-2"
"122436","University of San Diego","2019","On-tenure track, instructors","1","1","0","0","0","0","0","0","0","0","0","0","0","0","0","0","0","0","1","1","0","0","0","0","0","0","0","0","0","0","-2"
"122436","University of San Diego","2019","Not on tenure track/No tenure system system total","105","45","60","1","0","1","5","1","4","2","1","1","14","9","5","0","0","0","78","33","45","0","0","0","4","0","4","1","1","0","-2"
"122436","University of San Diego","2019","Not on tenure/no tenure system, professors","41","20","21","0","0","0","1","1","0","1","1","0","7","6","1","0","0","0","30","11","19","0","0","0","1","0","1","1","1","0","-2"
"122436","University of San Diego","2019","Not on tenure/no tenure system, associate professors","10","3","7","0","0","0","0","0","0","0","0","0","2","1","1","0","0","0","8","2","6","0","0","0","0","0","0","0","0","0","-2"
"122436","University of San Diego","2019","Not on tenure/no tenure system, assistant professors","36","15","21","1","0","1","3","0","3","0","0","0","2","2","0","0","0","0","28","13","15","0","0","0","2","0","2","0","0","0","-2"
"122436","University of San Diego","2019","Not on tenure/no tenure system, instructors","14","7","7","0","0","0","1","0","1","0","0","0","1","0","1","0","0","0","12","7","5","0","0","0","0","0","0","0","0","0","-2"
"122436","University of San Diego","2019","Not on tenure/no tenure system, no academic rank","4","0","4","0","0","0","0","0","0","1","0","1","2","0","2","0","0","0","0","0","0","0","0","0","1","0","1","0","0","0","-2"
"122454","San Francisco Art Institute","2019","Tenured total","13","8","5","0","0","0","1","1","0","1","1","0","2","1","1","0","0","0","9","5","4","0","0","0","0","0","0","0","0","0","-2"
"122454","San Francisco Art Institute","2019","Tenured, professors","3","2","1","0","0","0","1","1","0","0","0","0","1","1","0","0","0","0","1","0","1","0","0","0","0","0","0","0","0","0","-2"
"122454","San Francisco Art Institute","2019","Tenured, associate professors","10","6","4","0","0","0","0","0","0","1","1","0","1","0","1","0","0","0","8","5","3","0","0","0","0","0","0","0","0","0","-2"
"122454","San Francisco Art Institute","2019","On-Tenure track total","3","2","1","0","0","0","0","0","0","0","0","0","1","1","0","0","0","0","2","1","1","0","0","0","0","0","0","0","0","0","-2"
"122454","San Francisco Art Institute","2019","On-tenure track, assistant professors","3","2","1","0","0","0","0","0","0","0","0","0","1","1","0","0","0","0","2","1","1","0","0","0","0","0","0","0","0","0","-2"
"122612","University of San Francisco","2019","Tenured total","259","131","128","1","0","1","35","17","18","13","4","9","28","15","13","1","1","0","156","81","75","7","5","2","17","8","9","1","0","1","-2"
"122612","University of San Francisco","2019","Tenured, professors","133","79","54","0","0","0","14","7","7","4","2","2","14","10","4","1","1","0","87","51","36","5","4","1","8","4","4","0","0","0","-2"
"122612","University of San Francisco","2019","Tenured, associate professors","124","50","74","1","0","1","20","9","11","9","2","7","14","5","9","0","0","0","69","30","39","2","1","1","8","3","5","1","0","1","-2"
"122612","University of San Francisco","2019","Tenured, assistant professors","2","2","0","0","0","0","1","1","0","0","0","0","0","0","0","0","0","0","0","0","0","0","0","0","1","1","0","0","0","0","-2"
"122612","University of San Francisco","2019","On-Tenure track total","89","34","55","0","0","0","18","6","12","2","0","2","6","2","4","0","0","0","36","17","19","4","2","2","13","3","10","10","4","6","-2"
"122612","University of San Francisco","2019","On-tenure track, professors","1","0","1","0","0","0","0","0","0","0","0","0","0","0","0","0","0","0","1","0","1","0","0","0","0","0","0","0","0","0","-2"
"122612","University of San Francisco","2019","On-tenure track, associate professors","6","3","3","0","0","0","1","1","0","0","0","0","0","0","0","0","0","0","5","2","3","0","0","0","0","0","0","0","0","0","-2"
"122612","University of San Francisco","2019","On-tenure track, assistant professors","82","31","51","0","0","0","17","5","12","2","0","2","6","2","4","0","0","0","30","15","15","4","2","2","13","3","10","10","4","6","-2"
"122612","University of San Francisco","2019","Not on tenure track/No tenure system system total","123","53","70","0","0","0","20","7","13","3","0","3","13","5","8","0","0","0","70","34","36","7","4","3","9","3","6","1","0","1","-2"
"122612","University of San Francisco","2019","Not on tenure/no tenure system, professors","16","10","6","0","0","0","2","1","1","0","0","0","1","1","0","0","0","0","12","7","5","1","1","0","0","0","0","0","0","0","-2"
"122612","University of San Francisco","2019","Not on tenure/no tenure system, associate professors","28","11","17","0","0","0","7","2","5","2","0","2","2","0","2","0","0","0","13","7","6","1","0","1","3","2","1","0","0","0","-2"
"122612","University of San Francisco","2019","Not on tenure/no tenure system, assistant professors","65","23","42","0","0","0","9","2","7","0","0","0","10","4","6","0","0","0","37","15","22","4","2","2","5","0","5","0","0","0","-2"
"122612","University of San Francisco","2019","Not on tenure/no tenure system, instructors","14","9","5","0","0","0","2","2","0","1","0","1","0","0","0","0","0","0","8","5","3","1","1","0","1","1","0","1","0","1","-2"
"122728","William Jessup University","2019","Tenured total","11","9","2","1","1","0","0","0","0","0","0","0","0","0","0","0","0","0","10","8","2","0","0","0","0","0","0","0","0","0","-2"
"122728","William Jessup University","2019","Tenured, professors","4","3","1","1","1","0","0","0","0","0","0","0","0","0","0","0","0","0","3","2","1","0","0","0","0","0","0","0","0","0","-2"
"122728","William Jessup University","2019","Tenured, associate professors","7","6","1","0","0","0","0","0","0","0","0","0","0","0","0","0","0","0","7","6","1","0","0","0","0","0","0","0","0","0","-2"
"122728","William Jessup University","2019","On-Tenure track total","34","21","13","0","0","0","0","0","0","3","1","2","1","1","0","0","0","0","26","15","11","1","1","0","3","3","0","0","0","0","-2"
"122728","William Jessup University","2019","On-tenure track, associate professors","11","6","5","0","0","0","0","0","0","0","0","0","1","1","0","0","0","0","10","5","5","0","0","0","0","0","0","0","0","0","-2"
"122728","William Jessup University","2019","On-tenure track, assistant professors","23","15","8","0","0","0","0","0","0","3","1","2","0","0","0","0","0","0","16","10","6","1","1","0","3","3","0","0","0","0","-2"
"122728","William Jessup University","2019","Not on tenure track/No tenure system system total","4","4","0","0","0","0","1","1","0","0","0","0","0","0","0","0","0","0","2","2","0","0","0","0","1","1","0","0","0","0","-2"
"122728","William Jessup University","2019","Not on tenure/no tenure system, assistant professors","1","1","0","0","0","0","0","0","0","0","0","0","0","0","0","0","0","0","1","1","0","0","0","0","0","0","0","0","0","0","-2"
"122728","William Jessup University","2019","Not on tenure/no tenure system, no academic rank","3","3","0","0","0","0","1","1","0","0","0","0","0","0","0","0","0","0","1","1","0","0","0","0","1","1","0","0","0","0","-2"
"122931","Santa Clara University","2019","Tenured total","291","182","109","0","0","0","50","32","18","9","5","4","22","14","8","1","1","0","204","127","77","3","3","0","2","0","2","0","0","0","-2"
"122931","Santa Clara University","2019","Tenured, professors","147","92","55","0","0","0","19","15","4","3","3","0","10","8","2","0","0","0","112","64","48","2","2","0","1","0","1","0","0","0","-2"
"122931","Santa Clara University","2019","Tenured, associate professors","144","90","54","0","0","0","31","17","14","6","2","4","12","6","6","1","1","0","92","63","29","1","1","0","1","0","1","0","0","0","-2"
"122931","Santa Clara University","2019","On-Tenure track total","98","44","54","0","0","0","19","8","11","3","1","2","10","5","5","0","0","0","50","26","24","0","0","0","6","0","6","10","4","6","-2"
"122931","Santa Clara University","2019","On-tenure track, associate professors","1","1","0","0","0","0","1","1","0","0","0","0","0","0","0","0","0","0","0","0","0","0","0","0","0","0","0","0","0","0","-2"
"122931","Santa Clara University","2019","On-tenure track, assistant professors","97","43","54","0","0","0","18","7","11","3","1","2","10","5","5","0","0","0","50","26","24","0","0","0","6","0","6","10","4","6","-2"
"122931","Santa Clara University","2019","Not on tenure track/No tenure system system total","179","80","99","0","0","0","22","11","11","5","2","3","13","5","8","0","0","0","132","59","73","1","0","1","3","0","3","3","3","0","-2"
"122931","Santa Clara University","2019","Not on tenure/no tenure system, lecturers","179","80","99","0","0","0","22","11","11","5","2","3","13","5","8","0","0","0","132","59","73","1","0","1","3","0","3","3","3","0","-2"
"123299","Shasta College","2019","Tenured total","54","34","20","0","0","0","2","2","0","2","0","2","2","2","0","0","0","0","48","30","18","0","0","0","0","0","0","0","0","0","-2"
"123299","Shasta College","2019","Tenured, instructors","54","34","20","0","0","0","2","2","0","2","0","2","2","2","0","0","0","0","48","30","18","0","0","0","0","0","0","0","0","0","-2"
"123299","Shasta College","2019","On-Tenure track total","32","19","13","0","0","0","0","0","0","0","0","0","3","2","1","0","0","0","29","17","12","0","0","0","0","0","0","0","0","0","-2"
"123299","Shasta College","2019","On-tenure track, instructors","32","19","13","0","0","0","0","0","0","0","0","0","3","2","1","0","0","0","29","17","12","0","0","0","0","0","0","0","0","0","-2"
"123299","Shasta College","2019","Not on tenure track/No tenure system system total","74","33","41","0","0","0","8","5","3","2","2","0","10","4","6","0","0","0","53","22","31","0","0","0","0","0","0","1","0","1","-2"
"123299","Shasta College","2019","Not on tenure/no tenure system, instructors","74","33","41","0","0","0","8","5","3","2","2","0","10","4","6","0","0","0","53","22","31","0","0","0","0","0","0","1","0","1","-2"
"123457","Simpson University","2019","Not on tenure track/No tenure system system total","34","21","13","0","0","0","2","2","0","0","0","0","2","0","2","0","0","0","12","6","6","0","0","0","18","13","5","0","0","0","-2"
"123457","Simpson University","2019","Not on tenure/no tenure system, professors","8","6","2","0","0","0","0","0","0","0","0","0","0","0","0","0","0","0","1","0","1","0","0","0","7","6","1","0","0","0","-2"
"123457","Simpson University","2019","Not on tenure/no tenure system, associate professors","6","4","2","0","0","0","0","0","0","0","0","0","0","0","0","0","0","0","1","0","1","0","0","0","5","4","1","0","0","0","-2"
"123457","Simpson University","2019","Not on tenure/no tenure system, assistant professors","13","7","6","0","0","0","2","2","0","0","0","0","2","0","2","0","0","0","5","2","3","0","0","0","4","3","1","0","0","0","-2"
"123457","Simpson University","2019","Not on tenure/no tenure system, no academic rank","7","4","3","0","0","0","0","0","0","0","0","0","0","0","0","0","0","0","5","4","1","0","0","0","2","0","2","0","0","0","-2"
"124292","Thomas Aquinas College","2019","Not on tenure track/No tenure system system total","39","35","4","0","0","0","0","0","0","0","0","0","1","1","0","0","0","0","34","31","3","2","2","0","2","1","1","0","0","0","-2"
"124292","Thomas Aquinas College","2019","Not on tenure/no tenure system, no academic rank","39","35","4","0","0","0","0","0","0","0","0","0","1","1","0","0","0","0","34","31","3","2","2","0","2","1","1","0","0","0","-2"
"125727","Westmont College","2019","Tenured total","59","39","20","0","0","0","3","2","1","0","0","0","2","0","2","0","0","0","54","37","17","0","0","0","0","0","0","0","0","0","-2"
"125727","Westmont College","2019","Tenured, professors","47","35","12","0","0","0","2","1","1","0","0","0","1","0","1","0","0","0","44","34","10","0","0","0","0","0","0","0","0","0","-2"
"125727","Westmont College","2019","Tenured, associate professors","10","4","6","0","0","0","1","1","0","0","0","0","1","0","1","0","0","0","8","3","5","0","0","0","0","0","0","0","0","0","-2"
"125727","Westmont College","2019","Tenured, no academic rank","2","0","2","0","0","0","0","0","0","0","0","0","0","0","0","0","0","0","2","0","2","0","0","0","0","0","0","0","0","0","-2"
"125727","Westmont College","2019","On-Tenure track total","16","4","12","1","0","1","3","2","1","1","0","1","0","0","0","0","0","0","11","2","9","0","0","0","0","0","0","0","0","0","-2"
"125727","Westmont College","2019","On-tenure track, professors","2","1","1","0","0","0","0","0","0","0","0","0","0","0","0","0","0","0","2","1","1","0","0","0","0","0","0","0","0","0","-2"
"125727","Westmont College","2019","On-tenure track, associate professors","4","1","3","1","0","1","2","1","1","0","0","0","0","0","0","0","0","0","1","0","1","0","0","0","0","0","0","0","0","0","-2"
"125727","Westmont College","2019","On-tenure track, assistant professors","10","2","8","0","0","0","1","1","0","1","0","1","0","0","0","0","0","0","8","1","7","0","0","0","0","0","0","0","0","0","-2"
"125727","Westmont College","2019","Not on tenure track/No tenure system system total","10","6","4","0","0","0","2","2","0","1","0","1","0","0","0","0","0","0","7","4","3","0","0","0","0","0","0","0","0","0","-2"
"125727","Westmont College","2019","Not on tenure/no tenure system, associate professors","5","3","2","0","0","0","1","1","0","0","0","0","0","0","0","0","0","0","4","2","2","0","0","0","0","0","0","0","0","0","-2"
"125727","Westmont College","2019","Not on tenure/no tenure system, assistant professors","4","3","1","0","0","0","1","1","0","1","0","1","0","0","0","0","0","0","2","2","0","0","0","0","0","0","0","0","0","0","-2"
"125727","Westmont College","2019","Not on tenure/no tenure system, instructors","1","0","1","0","0","0","0","0","0","0","0","0","0","0","0","0","0","0","1","0","1","0","0","0","0","0","0","0","0","0","-2"
"126580","University of Colorado Colorado Springs","2019","Tenured total","153","94","59","0","0","0","14","8","6","2","1","1","10","7","3","0","0","0","120","74","46","0","0","0","7","4","3","0","0","0","-2"
"126580","University of Colorado Colorado Springs","2019","Tenured, professors","70","50","20","0","0","0","5","5","0","0","0","0","3","2","1","0","0","0","59","41","18","0","0","0","3","2","1","0","0","0","-2"
"126580","University of Colorado Colorado Springs","2019","Tenured, associate professors","83","44","39","0","0","0","9","3","6","2","1","1","7","5","2","0","0","0","61","33","28","0","0","0","4","2","2","0","0","0","-2"
"126580","University of Colorado Colorado Springs","2019","On-Tenure track total","111","53","58","1","0","1","19","13","6","5","2","3","2","0","2","0","0","0","69","33","36","2","0","2","13","5","8","0","0","0","-2"
"126580","University of Colorado Colorado Springs","2019","On-tenure track, assistant professors","111","53","58","1","0","1","19","13","6","5","2","3","2","0","2","0","0","0","69","33","36","2","0","2","13","5","8","0","0","0","-2"
"126580","University of Colorado Colorado Springs","2019","Not on tenure track/No tenure system system total","180","71","109","1","0","1","7","1","6","5","2","3","9","5","4","0","0","0","138","55","83","4","2","2","16","6","10","0","0","0","-2"
"126580","University of Colorado Colorado Springs","2019","Not on tenure/no tenure system, instructors","177","71","106","1","0","1","7","1","6","4","2","2","9","5","4","0","0","0","136","55","81","4","2","2","16","6","10","0","0","0","-2"
"126580","University of Colorado Colorado Springs","2019","Not on tenure/no tenure system, no academic rank","3","0","3","0","0","0","0","0","0","1","0","1","0","0","0","0","0","0","2","0","2","0","0","0","0","0","0","0","0","0","-2"
"127200","Front Range Community College","2019","Tenured total","183","80","103","1","0","1","8","3","5","2","1","1","9","3","6","0","0","0","162","73","89","0","0","0","1","0","1","0","0","0","-2"
"127200","Front Range Community College","2019","Tenured, professors","183","80","103","1","0","1","8","3","5","2","1","1","9","3","6","0","0","0","162","73","89","0","0","0","1","0","1","0","0","0","-2"
"127200","Front Range Community College","2019","On-Tenure track total","49","19","30","0","0","0","1","0","1","1","0","1","7","1","6","0","0","0","39","17","22","0","0","0","1","1","0","0","0","0","-2"
"127200","Front Range Community College","2019","On-tenure track, professors","49","19","30","0","0","0","1","0","1","1","0","1","7","1","6","0","0","0","39","17","22","0","0","0","1","1","0","0","0","0","-2"
"127200","Front Range Community College","2019","Not on tenure track/No tenure system system total","14","8","6","0","0","0","2","1","1","0","0","0","2","1","1","0","0","0","10","6","4","0","0","0","0","0","0","0","0","0","-2"
"127200","Front Range Community College","2019","Not on tenure/no tenure system, professors","14","8","6","0","0","0","2","1","1","0","0","0","2","1","1","0","0","0","10","6","4","0","0","0","0","0","0","0","0","0","-2"
"127556","Colorado Mesa University","2019","Tenured total","102","63","39","0","0","0","3","2","1","0","0","0","1","1","0","0","0","0","81","48","33","0","0","0","14","11","3","3","1","2","-2"
"127556","Colorado Mesa University","2019","Tenured, professors","55","36","19","0","0","0","0","0","0","0","0","0","1","1","0","0","0","0","44","29","15","0","0","0","9","6","3","1","0","1","-2"
"127556","Colorado Mesa University","2019","Tenured, associate professors","46","26","20","0","0","0","3","2","1","0","0","0","0","0","0","0","0","0","36","18","18","0","0","0","5","5","0","2","1","1","-2"
"127556","Colorado Mesa University","2019","Tenured, assistant professors","1","1","0","0","0","0","0","0","0","0","0","0","0","0","0","0","0","0","1","1","0","0","0","0","0","0","0","0","0","0","-2"
"127556","Colorado Mesa University","2019","On-Tenure track total","85","39","46","0","0","0","1","0","1","3","1","2","3","2","1","0","0","0","64","25","39","0","0","0","6","5","1","8","6","2","-2"
"127556","Colorado Mesa University","2019","On-tenure track, associate professors","6","5","1","0","0","0","0","0","0","0","0","0","0","0","0","0","0","0","3","3","0","0","0","0","2","1","1","1","1","0","-2"
"127556","Colorado Mesa University","2019","On-tenure track, assistant professors","78","33","45","0","0","0","1","0","1","3","1","2","3","2","1","0","0","0","61","22","39","0","0","0","4","4","0","6","4","2","-2"
"127556","Colorado Mesa University","2019","On-tenure track, no academic rank","1","1","0","0","0","0","0","0","0","0","0","0","0","0","0","0","0","0","0","0","0","0","0","0","0","0","0","1","1","0","-2"
"127556","Colorado Mesa University","2019","Not on tenure track/No tenure system system total","117","59","58","0","0","0","0","0","0","0","0","0","5","3","2","0","0","0","98","50","48","0","0","0","12","5","7","2","1","1","-2"
"127556","Colorado Mesa University","2019","Not on tenure/no tenure system, instructors","108","55","53","0","0","0","0","0","0","0","0","0","5","3","2","0","0","0","90","47","43","0","0","0","12","5","7","1","0","1","-2"
"127556","Colorado Mesa University","2019","Not on tenure/no tenure system, lecturers","6","1","5","0","0","0","0","0","0","0","0","0","0","0","0","0","0","0","6","1","5","0","0","0","0","0","0","0","0","0","-2"
"127556","Colorado Mesa University","2019","Not on tenure/no tenure system, no academic rank","3","3","0","0","0","0","0","0","0","0","0","0","0","0","0","0","0","0","2","2","0","0","0","0","0","0","0","1","1","0","-2"
"127820","Pikes Peak Community College","2019","Not on tenure track/No tenure system system total","188","70","118","1","1","0","5","3","2","9","2","7","9","4","5","0","0","0","160","58","102","0","0","0","4","2","2","0","0","0","-2"
"127820","Pikes Peak Community College","2019","Not on tenure/no tenure system, no academic rank","188","70","118","1","1","0","5","3","2","9","2","7","9","4","5","0","0","0","160","58","102","0","0","0","4","2","2","0","0","0","-2"
"127909","Red Rocks Community College","2019","Not on tenure track/No tenure system system total","97","38","59","0","0","0","4","3","1","1","1","0","6","4","2","0","0","0","84","30","54","1","0","1","1","0","1","0","0","0","-2"
"127909","Red Rocks Community College","2019","Not on tenure/no tenure system, instructors","97","38","59","0","0","0","4","3","1","1","1","0","6","4","2","0","0","0","84","30","54","1","0","1","1","0","1","0","0","0","-2"
"127918","Regis University","2019","Tenured total","71","41","30","0","0","0","2","1","1","4","4","0","5","2","3","0","0","0","60","34","26","0","0","0","0","0","0","0","0","0","-2"
"127918","Regis University","2019","Tenured, professors","28","14","14","0","0","0","1","1","0","0","0","0","4","2","2","0","0","0","23","11","12","0","0","0","0","0","0","0","0","0","-2"
"127918","Regis University","2019","Tenured, associate professors","43","27","16","0","0","0","1","0","1","4","4","0","1","0","1","0","0","0","37","23","14","0","0","0","0","0","0","0","0","0","-2"
"127918","Regis University","2019","On-Tenure track total","39","12","27","0","0","0","4","1","3","1","1","0","2","0","2","0","0","0","32","10","22","0","0","0","0","0","0","0","0","0","-2"
"127918","Regis University","2019","On-tenure track, professors","1","0","1","0","0","0","0","0","0","0","0","0","0","0","0","0","0","0","1","0","1","0","0","0","0","0","0","0","0","0","-2"
"127918","Regis University","2019","On-tenure track, associate professors","3","1","2","0","0","0","0","0","0","0","0","0","1","0","1","0","0","0","2","1","1","0","0","0","0","0","0","0","0","0","-2"
"127918","Regis University","2019","On-tenure track, assistant professors","35","11","24","0","0","0","4","1","3","1","1","0","1","0","1","0","0","0","29","9","20","0","0","0","0","0","0","0","0","0","-2"
"127918","Regis University","2019","Not on tenure track/No tenure system system total","220","83","137","0","0","0","6","2","4","5","2","3","10","7","3","0","0","0","196","71","125","1","0","1","2","1","1","0","0","0","-2"
"127918","Regis University","2019","Not on tenure/no tenure system, professors","44","16","28","0","0","0","2","1","1","3","1","2","1","1","0","0","0","0","37","13","24","1","0","1","0","0","0","0","0","0","-2"
"127918","Regis University","2019","Not on tenure/no tenure system, associate professors","56","24","32","0","0","0","2","0","2","1","0","1","2","2","0","0","0","0","51","22","29","0","0","0","0","0","0","0","0","0","-2"
"127918","Regis University","2019","Not on tenure/no tenure system, assistant professors","56","16","40","0","0","0","1","1","0","0","0","0","1","1","0","0","0","0","53","13","40","0","0","0","1","1","0","0","0","0","-2"
"127918","Regis University","2019","Not on tenure/no tenure system, instructors","40","15","25","0","0","0","1","0","1","1","1","0","5","2","3","0","0","0","33","12","21","0","0","0","0","0","0","0","0","0","-2"
"127918","Regis University","2019","Not on tenure/no tenure system, lecturers","22","12","10","0","0","0","0","0","0","0","0","0","1","1","0","0","0","0","20","11","9","0","0","0","1","0","1","0","0","0","-2"
"127918","Regis University","2019","Not on tenure/no tenure system, no academic rank","2","0","2","0","0","0","0","0","0","0","0","0","0","0","0","0","0","0","2","0","2","0","0","0","0","0","0","0","0","0","-2"
"128391","Western Colorado University","2019","Tenured total","56","36","20","0","0","0","0","0","0","0","0","0","1","1","0","1","0","1","51","33","18","3","2","1","0","0","0","0","0","0","-2"
"128391","Western Colorado University","2019","Tenured, professors","44","28","16","0","0","0","0","0","0","0","0","0","0","0","0","1","0","1","40","26","14","3","2","1","0","0","0","0","0","0","-2"
"128391","Western Colorado University","2019","Tenured, associate professors","12","8","4","0","0","0","0","0","0","0","0","0","1","1","0","0","0","0","11","7","4","0","0","0","0","0","0","0","0","0","-2"
"128391","Western Colorado University","2019","On-Tenure track total","28","16","12","0","0","0","0","0","0","1","1","0","2","0","2","0","0","0","23","14","9","2","1","1","0","0","0","0","0","0","-2"
"128391","Western Colorado University","2019","On-tenure track, professors","1","1","0","0","0","0","0","0","0","0","0","0","0","0","0","0","0","0","1","1","0","0","0","0","0","0","0","0","0","0","-2"
"128391","Western Colorado University","2019","On-tenure track, associate professors","2","0","2","0","0","0","0","0","0","0","0","0","1","0","1","0","0","0","0","0","0","1","0","1","0","0","0","0","0","0","-2"
"128391","Western Colorado University","2019","On-tenure track, assistant professors","25","15","10","0","0","0","0","0","0","1","1","0","1","0","1","0","0","0","22","13","9","1","1","0","0","0","0","0","0","0","-2"
"128391","Western Colorado University","2019","Not on tenure track/No tenure system system total","43","22","21","0","0","0","3","2","1","0","0","0","4","3","1","0","0","0","36","17","19","0","0","0","0","0","0","0","0","0","-2"
"128391","Western Colorado University","2019","Not on tenure/no tenure system, lecturers","43","22","21","0","0","0","3","2","1","0","0","0","4","3","1","0","0","0","36","17","19","0","0","0","0","0","0","0","0","0","-2"
"128498","Albertus Magnus College","2019","Tenured total","7","3","4","0","0","0","0","0","0","0","0","0","0","0","0","0","0","0","6","2","4","0","0","0","1","1","0","0","0","0","-2"
"128498","Albertus Magnus College","2019","Tenured, professors","6","2","4","0","0","0","0","0","0","0","0","0","0","0","0","0","0","0","6","2","4","0","0","0","0","0","0","0","0","0","-2"
"128498","Albertus Magnus College","2019","Tenured, associate professors","1","1","0","0","0","0","0","0","0","0","0","0","0","0","0","0","0","0","0","0","0","0","0","0","1","1","0","0","0","0","-2"
"128498","Albertus Magnus College","2019","Not on tenure track/No tenure system system total","45","25","20","0","0","0","1","1","0","3","1","2","0","0","0","0","0","0","29","17","12","0","0","0","12","6","6","0","0","0","-2"
"128498","Albertus Magnus College","2019","Not on tenure/no tenure system, professors","16","12","4","0","0","0","1","1","0","0","0","0","0","0","0","0","0","0","11","8","3","0","0","0","4","3","1","0","0","0","-2"
"128498","Albertus Magnus College","2019","Not on tenure/no tenure system, associate professors","7","2","5","0","0","0","0","0","0","0","0","0","0","0","0","0","0","0","6","2","4","0","0","0","1","0","1","0","0","0","-2"
"128498","Albertus Magnus College","2019","Not on tenure/no tenure system, assistant professors","20","10","10","0","0","0","0","0","0","3","1","2","0","0","0","0","0","0","12","7","5","0","0","0","5","2","3","0","0","0","-2"
"128498","Albertus Magnus College","2019","Not on tenure/no tenure system, instructors","1","0","1","0","0","0","0","0","0","0","0","0","0","0","0","0","0","0","0","0","0","0","0","0","1","0","1","0","0","0","-2"
"128498","Albertus Magnus College","2019","Not on tenure/no tenure system, no academic rank","1","1","0","0","0","0","0","0","0","0","0","0","0","0","0","0","0","0","0","0","0","0","0","0","1","1","0","0","0","0","-2"
"128771","Central Connecticut State University","2019","Tenured total","315","183","132","1","1","0","33","22","11","17","9","8","18","11","7","0","0","0","241","136","105","4","3","1","0","0","0","1","1","0","-2"
"128771","Central Connecticut State University","2019","Tenured, professors","196","120","76","1","1","0","16","10","6","13","7","6","13","10","3","0","0","0","152","92","60","1","0","1","0","0","0","0","0","0","-2"
"128771","Central Connecticut State University","2019","Tenured, associate professors","111","59","52","0","0","0","17","12","5","4","2","2","5","1","4","0","0","0","81","40","41","3","3","0","0","0","0","1","1","0","-2"
"128771","Central Connecticut State University","2019","Tenured, assistant professors","8","4","4","0","0","0","0","0","0","0","0","0","0","0","0","0","0","0","8","4","4","0","0","0","0","0","0","0","0","0","-2"
"128771","Central Connecticut State University","2019","On-Tenure track total","101","48","53","0","0","0","10","7","3","6","4","2","8","4","4","0","0","0","60","24","36","0","0","0","3","2","1","14","7","7","-2"
"128771","Central Connecticut State University","2019","On-tenure track, associate professors","22","12","10","0","0","0","4","4","0","1","1","0","1","1","0","0","0","0","12","4","8","0","0","0","1","0","1","3","2","1","-2"
"128771","Central Connecticut State University","2019","On-tenure track, assistant professors","79","36","43","0","0","0","6","3","3","5","3","2","7","3","4","0","0","0","48","20","28","0","0","0","2","2","0","11","5","6","-2"
"128771","Central Connecticut State University","2019","Not on tenure track/No tenure system system total","24","15","9","0","0","0","5","2","3","0","0","0","0","0","0","0","0","0","18","12","6","0","0","0","0","0","0","1","1","0","-2"
"128771","Central Connecticut State University","2019","Not on tenure/no tenure system, associate professors","4","3","1","0","0","0","0","0","0","0","0","0","0","0","0","0","0","0","4","3","1","0","0","0","0","0","0","0","0","0","-2"
"128771","Central Connecticut State University","2019","Not on tenure/no tenure system, assistant professors","14","10","4","0","0","0","5","2","3","0","0","0","0","0","0","0","0","0","8","7","1","0","0","0","0","0","0","1","1","0","-2"
"128771","Central Connecticut State University","2019","Not on tenure/no tenure system, instructors","6","2","4","0","0","0","0","0","0","0","0","0","0","0","0","0","0","0","6","2","4","0","0","0","0","0","0","0","0","0","-2"
"129154","Goodwin University","2019","Not on tenure track/No tenure system system total","92","29","63","1","0","1","3","2","1","12","2","10","2","1","1","0","0","0","74","24","50","0","0","0","0","0","0","0","0","0","-2"
"129154","Goodwin University","2019","Not on tenure/no tenure system, professors","2","1","1","0","0","0","1","0","1","0","0","0","0","0","0","0","0","0","1","1","0","0","0","0","0","0","0","0","0","0","-2"
"129154","Goodwin University","2019","Not on tenure/no tenure system, associate professors","24","8","16","1","0","1","0","0","0","0","0","0","0","0","0","0","0","0","23","8","15","0","0","0","0","0","0","0","0","0","-2"
"129154","Goodwin University","2019","Not on tenure/no tenure system, assistant professors","48","14","34","0","0","0","1","1","0","12","2","10","1","1","0","0","0","0","34","10","24","0","0","0","0","0","0","0","0","0","-2"
"129154","Goodwin University","2019","Not on tenure/no tenure system, instructors","18","6","12","0","0","0","1","1","0","0","0","0","1","0","1","0","0","0","16","5","11","0","0","0","0","0","0","0","0","0","-2"
"129774","Mitchell College","2019","Not on tenure track/No tenure system system total","16","7","9","0","0","0","0","0","0","0","0","0","0","0","0","0","0","0","16","7","9","0","0","0","0","0","0","0","0","0","-2"
"129774","Mitchell College","2019","Not on tenure/no tenure system, professors","2","1","1","0","0","0","0","0","0","0","0","0","0","0","0","0","0","0","2","1","1","0","0","0","0","0","0","0","0","0","-2"
"129774","Mitchell College","2019","Not on tenure/no tenure system, associate professors","6","3","3","0","0","0","0","0","0","0","0","0","0","0","0","0","0","0","6","3","3","0","0","0","0","0","0","0","0","0","-2"
"129774","Mitchell College","2019","Not on tenure/no tenure system, assistant professors","8","3","5","0","0","0","0","0","0","0","0","0","0","0","0","0","0","0","8","3","5","0","0","0","0","0","0","0","0","0","-2"
"132657","Lynn University","2019","Not on tenure track/No tenure system system total","135","79","56","1","1","0","4","3","1","2","2","0","7","4","3","0","0","0","76","42","34","2","0","2","41","26","15","2","1","1","-2"
"132657","Lynn University","2019","Not on tenure/no tenure system, professors","28","16","12","0","0","0","1","1","0","0","0","0","1","0","1","0","0","0","22","13","9","1","0","1","3","2","1","0","0","0","-2"
"132657","Lynn University","2019","Not on tenure/no tenure system, associate professors","51","32","19","1","1","0","0","0","0","1","1","0","2","1","1","0","0","0","28","17","11","1","0","1","17","11","6","1","1","0","-2"
"132657","Lynn University","2019","Not on tenure/no tenure system, assistant professors","42","20","22","0","0","0","3","2","1","0","0","0","2","1","1","0","0","0","21","8","13","0","0","0","15","9","6","1","0","1","-2"
"132657","Lynn University","2019","Not on tenure/no tenure system, instructors","11","8","3","0","0","0","0","0","0","1","1","0","2","2","0","0","0","0","2","1","1","0","0","0","6","4","2","0","0","0","-2"
"132657","Lynn University","2019","Not on tenure/no tenure system, no academic rank","3","3","0","0","0","0","0","0","0","0","0","0","0","0","0","0","0","0","3","3","0","0","0","0","0","0","0","0","0","0","-2"
"132693","Eastern Florida State College","2019","Tenured total","168","72","96","0","0","0","10","6","4","12","6","6","2","0","2","0","0","0","139","57","82","5","3","2","0","0","0","0","0","0","-2"
"132693","Eastern Florida State College","2019","Tenured, professors","51","21","30","0","0","0","6","3","3","4","2","2","2","0","2","0","0","0","36","13","23","3","3","0","0","0","0","0","0","0","-2"
"132693","Eastern Florida State College","2019","Tenured, associate professors","47","21","26","0","0","0","3","2","1","6","2","4","0","0","0","0","0","0","37","17","20","1","0","1","0","0","0","0","0","0","-2"
"132693","Eastern Florida State College","2019","Tenured, assistant professors","50","21","29","0","0","0","1","1","0","2","2","0","0","0","0","0","0","0","46","18","28","1","0","1","0","0","0","0","0","0","-2"
"132693","Eastern Florida State College","2019","Tenured, instructors","20","9","11","0","0","0","0","0","0","0","0","0","0","0","0","0","0","0","20","9","11","0","0","0","0","0","0","0","0","0","-2"
"132693","Eastern Florida State College","2019","On-Tenure track total","84","36","48","0","0","0","0","0","0","7","2","5","5","1","4","0","0","0","70","31","39","2","2","0","0","0","0","0","0","0","-2"
"132693","Eastern Florida State College","2019","On-tenure track, associate professors","1","0","1","0","0","0","0","0","0","0","0","0","0","0","0","0","0","0","1","0","1","0","0","0","0","0","0","0","0","0","-2"
"132693","Eastern Florida State College","2019","On-tenure track, instructors","83","36","47","0","0","0","0","0","0","7","2","5","5","1","4","0","0","0","69","31","38","2","2","0","0","0","0","0","0","0","-2"
"132693","Eastern Florida State College","2019","Not on tenure track/No tenure system system total","17","9","8","0","0","0","0","0","0","3","0","3","3","3","0","0","0","0","10","5","5","0","0","0","1","1","0","0","0","0","-2"
"132693","Eastern Florida State College","2019","Not on tenure/no tenure system, associate professors","1","0","1","0","0","0","0","0","0","1","0","1","0","0","0","0","0","0","0","0","0","0","0","0","0","0","0","0","0","0","-2"
"132693","Eastern Florida State College","2019","Not on tenure/no tenure system, assistant professors","4","1","3","0","0","0","0","0","0","1","0","1","0","0","0","0","0","0","2","0","2","0","0","0","1","1","0","0","0","0","-2"
"132693","Eastern Florida State College","2019","Not on tenure/no tenure system, instructors","12","8","4","0","0","0","0","0","0","1","0","1","3","3","0","0","0","0","8","5","3","0","0","0","0","0","0","0","0","0","-2"
"132879","Johnson University Florida","2019","Not on tenure track/No tenure system system total","12","6","6","0","0","0","1","0","1","0","0","0","0","0","0","0","0","0","10","6","4","1","0","1","0","0","0","0","0","0","-2"
"132879","Johnson University Florida","2019","Not on tenure/no tenure system, professors","5","1","4","0","0","0","1","0","1","0","0","0","0","0","0","0","0","0","4","1","3","0","0","0","0","0","0","0","0","0","-2"
"132879","Johnson University Florida","2019","Not on tenure/no tenure system, associate professors","5","3","2","0","0","0","0","0","0","0","0","0","0","0","0","0","0","0","4","3","1","1","0","1","0","0","0","0","0","0","-2"
"132879","Johnson University Florida","2019","Not on tenure/no tenure system, assistant professors","2","2","0","0","0","0","0","0","0","0","0","0","0","0","0","0","0","0","2","2","0","0","0","0","0","0","0","0","0","0","-2"
"133386","Daytona State College","2019","Tenured total","183","100","83","0","0","0","7","6","1","17","8","9","8","5","3","0","0","0","149","79","70","0","0","0","0","0","0","2","2","0","-2"
"133386","Daytona State College","2019","Tenured, professors","112","64","48","0","0","0","6","5","1","10","4","6","2","2","0","0","0","0","93","52","41","0","0","0","0","0","0","1","1","0","-2"
"133386","Daytona State College","2019","Tenured, associate professors","62","30","32","0","0","0","1","1","0","6","3","3","6","3","3","0","0","0","48","22","26","0","0","0","0","0","0","1","1","0","-2"
"133386","Daytona State College","2019","Tenured, assistant professors","9","6","3","0","0","0","0","0","0","1","1","0","0","0","0","0","0","0","8","5","3","0","0","0","0","0","0","0","0","0","-2"
"133386","Daytona State College","2019","On-Tenure track total","48","20","28","0","0","0","0","0","0","5","0","5","7","4","3","0","0","0","36","16","20","0","0","0","0","0","0","0","0","0","-2"
"133386","Daytona State College","2019","On-tenure track, associate professors","9","3","6","0","0","0","0","0","0","1","0","1","1","1","0","0","0","0","7","2","5","0","0","0","0","0","0","0","0","0","-2"
"133386","Daytona State College","2019","On-tenure track, assistant professors","30","8","22","0","0","0","0","0","0","4","0","4","6","3","3","0","0","0","20","5","15","0","0","0","0","0","0","0","0","0","-2"
"133386","Daytona State College","2019","On-tenure track, instructors","9","9","0","0","0","0","0","0","0","0","0","0","0","0","0","0","0","0","9","9","0","0","0","0","0","0","0","0","0","0","-2"
"134130","University of Florida","2019","Tenured total","1525","1092","433","0","0","0","207","157","50","49","27","22","85","62","23","0","0","0","1162","828","334","17","13","4","2","2","0","3","3","0","-2"
"134130","University of Florida","2019","Tenured, professors","989","754","235","0","0","0","131","106","25","24","15","9","50","37","13","0","0","0","774","588","186","6","4","2","1","1","0","3","3","0","-2"
"134130","University of Florida","2019","Tenured, associate professors","533","335","198","0","0","0","76","51","25","25","12","13","35","25","10","0","0","0","385","237","148","11","9","2","1","1","0","0","0","0","-2"
"134130","University of Florida","2019","Tenured, assistant professors","3","3","0","0","0","0","0","0","0","0","0","0","0","0","0","0","0","0","3","3","0","0","0","0","0","0","0","0","0","0","-2"
"134130","University of Florida","2019","On-Tenure track total","653","396","257","2","0","2","90","53","37","24","11","13","56","35","21","0","0","0","354","208","146","12","6","6","22","18","4","93","65","28","-2"
"134130","University of Florida","2019","On-tenure track, professors","23","20","3","0","0","0","5","4","1","1","1","0","1","1","0","0","0","0","14","12","2","1","1","0","0","0","0","1","1","0","-2"
"134130","University of Florida","2019","On-tenure track, associate professors","65","46","19","0","0","0","19","12","7","4","2","2","6","6","0","0","0","0","35","25","10","0","0","0","1","1","0","0","0","0","-2"
"134130","University of Florida","2019","On-tenure track, assistant professors","565","330","235","2","0","2","66","37","29","19","8","11","49","28","21","0","0","0","305","171","134","11","5","6","21","17","4","92","64","28","-2"
"134130","University of Florida","2019","Not on tenure track/No tenure system system total","728","299","429","2","0","2","41","10","31","47","16","31","62","20","42","1","1","0","524","226","298","10","7","3","2","2","0","39","17","22","-2"
"134130","University of Florida","2019","Not on tenure/no tenure system, professors","29","18","11","0","0","0","0","0","0","2","1","1","1","1","0","0","0","0","26","16","10","0","0","0","0","0","0","0","0","0","-2"
"134130","University of Florida","2019","Not on tenure/no tenure system, associate professors","18","7","11","0","0","0","1","0","1","0","0","0","1","1","0","0","0","0","16","6","10","0","0","0","0","0","0","0","0","0","-2"
"134130","University of Florida","2019","Not on tenure/no tenure system, assistant professors","123","43","80","0","0","0","6","1","5","10","4","6","10","1","9","0","0","0","82","29","53","2","1","1","0","0","0","13","7","6","-2"
"134130","University of Florida","2019","Not on tenure/no tenure system, lecturers","466","191","275","2","0","2","26","5","21","29","7","22","46","16","30","1","1","0","328","145","183","7","5","2","2","2","0","25","10","15","-2"
"134130","University of Florida","2019","Not on tenure/no tenure system, no academic rank","92","40","52","0","0","0","8","4","4","6","4","2","4","1","3","0","0","0","72","30","42","1","1","0","0","0","0","1","0","1","-2"
"135188","Lake-Sumter State College","2019","Tenured total","33","11","22","1","1","0","0","0","0","3","1","2","0","0","0","0","0","0","29","9","20","0","0","0","0","0","0","0","0","0","-2"
"135188","Lake-Sumter State College","2019","Tenured, professors","3","0","3","0","0","0","0","0","0","0","0","0","0","0","0","0","0","0","3","0","3","0","0","0","0","0","0","0","0","0","-2"
"135188","Lake-Sumter State College","2019","Tenured, associate professors","5","2","3","0","0","0","0","0","0","1","0","1","0","0","0","0","0","0","4","2","2","0","0","0","0","0","0","0","0","0","-2"
"135188","Lake-Sumter State College","2019","Tenured, assistant professors","8","2","6","0","0","0","0","0","0","1","0","1","0","0","0","0","0","0","7","2","5","0","0","0","0","0","0","0","0","0","-2"
"135188","Lake-Sumter State College","2019","Tenured, instructors","17","7","10","1","1","0","0","0","0","1","1","0","0","0","0","0","0","0","15","5","10","0","0","0","0","0","0","0","0","0","-2"
"135188","Lake-Sumter State College","2019","On-Tenure track total","41","18","23","0","0","0","1","1","0","3","1","2","2","2","0","1","0","1","34","14","20","0","0","0","0","0","0","0","0","0","-2"
"135188","Lake-Sumter State College","2019","On-tenure track, assistant professors","5","2","3","0","0","0","0","0","0","0","0","0","0","0","0","0","0","0","5","2","3","0","0","0","0","0","0","0","0","0","-2"
"135188","Lake-Sumter State College","2019","On-tenure track, instructors","31","13","18","0","0","0","1","1","0","3","1","2","2","2","0","1","0","1","24","9","15","0","0","0","0","0","0","0","0","0","-2"
"135188","Lake-Sumter State College","2019","On-tenure track, no academic rank","5","3","2","0","0","0","0","0","0","0","0","0","0","0","0","0","0","0","5","3","2","0","0","0","0","0","0","0","0","0","-2"
"135188","Lake-Sumter State College","2019","Not on tenure track/No tenure system system total","6","2","4","0","0","0","0","0","0","0","0","0","0","0","0","0","0","0","6","2","4","0","0","0","0","0","0","0","0","0","-2"
"135188","Lake-Sumter State College","2019","Not on tenure/no tenure system, instructors","6","2","4","0","0","0","0","0","0","0","0","0","0","0","0","0","0","0","6","2","4","0","0","0","0","0","0","0","0","0","-2"
"135391","State College of Florida-Manatee-Sarasota","2019","Tenured total","81","36","45","0","0","0","3","3","0","5","3","2","5","2","3","0","0","0","65","28","37","0","0","0","3","0","3","0","0","0","-2"
"135391","State College of Florida-Manatee-Sarasota","2019","Tenured, professors","42","23","19","0","0","0","3","3","0","1","0","1","2","0","2","0","0","0","34","20","14","0","0","0","2","0","2","0","0","0","-2"
"135391","State College of Florida-Manatee-Sarasota","2019","Tenured, associate professors","26","8","18","0","0","0","0","0","0","3","2","1","2","1","1","0","0","0","20","5","15","0","0","0","1","0","1","0","0","0","-2"
"135391","State College of Florida-Manatee-Sarasota","2019","Tenured, assistant professors","10","5","5","0","0","0","0","0","0","1","1","0","1","1","0","0","0","0","8","3","5","0","0","0","0","0","0","0","0","0","-2"
"135391","State College of Florida-Manatee-Sarasota","2019","Tenured, instructors","3","0","3","0","0","0","0","0","0","0","0","0","0","0","0","0","0","0","3","0","3","0","0","0","0","0","0","0","0","0","-2"
"135391","State College of Florida-Manatee-Sarasota","2019","On-Tenure track total","22","9","13","0","0","0","0","0","0","0","0","0","2","2","0","0","0","0","19","7","12","0","0","0","1","0","1","0","0","0","-2"
"135391","State College of Florida-Manatee-Sarasota","2019","On-tenure track, associate professors","6","1","5","0","0","0","0","0","0","0","0","0","0","0","0","0","0","0","5","1","4","0","0","0","1","0","1","0","0","0","-2"
"135391","State College of Florida-Manatee-Sarasota","2019","On-tenure track, assistant professors","8","3","5","0","0","0","0","0","0","0","0","0","1","1","0","0","0","0","7","2","5","0","0","0","0","0","0","0","0","0","-2"
"135391","State College of Florida-Manatee-Sarasota","2019","On-tenure track, instructors","8","5","3","0","0","0","0","0","0","0","0","0","1","1","0","0","0","0","7","4","3","0","0","0","0","0","0","0","0","0","-2"
"135391","State College of Florida-Manatee-Sarasota","2019","Not on tenure track/No tenure system system total","32","10","22","0","0","0","1","0","1","0","0","0","2","2","0","0","0","0","27","7","20","0","0","0","1","0","1","1","1","0","-2"
"135391","State College of Florida-Manatee-Sarasota","2019","Not on tenure/no tenure system, assistant professors","7","2","5","0","0","0","0","0","0","0","0","0","0","0","0","0","0","0","6","2","4","0","0","0","1","0","1","0","0","0","-2"
"135391","State College of Florida-Manatee-Sarasota","2019","Not on tenure/no tenure system, instructors","6","5","1","0","0","0","0","0","0","0","0","0","1","1","0","0","0","0","4","3","1","0","0","0","0","0","0","1","1","0","-2"
"135391","State College of Florida-Manatee-Sarasota","2019","Not on tenure/no tenure system, lecturers","5","3","2","0","0","0","1","0","1","0","0","0","1","1","0","0","0","0","3","2","1","0","0","0","0","0","0","0","0","0","-2"
"135391","State College of Florida-Manatee-Sarasota","2019","Not on tenure/no tenure system, no academic rank","14","0","14","0","0","0","0","0","0","0","0","0","0","0","0","0","0","0","14","0","14","0","0","0","0","0","0","0","0","0","-2"
"136330","Palm Beach Atlantic University","2019","Not on tenure track/No tenure system system total","178","97","81","0","0","0","4","1","3","10","1","9","11","8","3","0","0","0","140","82","58","0","0","0","3","1","2","10","4","6","-2"
"136330","Palm Beach Atlantic University","2019","Not on tenure/no tenure system, professors","51","38","13","0","0","0","1","1","0","2","1","1","0","0","0","0","0","0","47","35","12","0","0","0","0","0","0","1","1","0","-2"
"136330","Palm Beach Atlantic University","2019","Not on tenure/no tenure system, associate professors","62","32","30","0","0","0","3","0","3","5","0","5","3","3","0","0","0","0","45","26","19","0","0","0","2","1","1","4","2","2","-2"
"136330","Palm Beach Atlantic University","2019","Not on tenure/no tenure system, assistant professors","58","25","33","0","0","0","0","0","0","3","0","3","6","5","1","0","0","0","43","19","24","0","0","0","1","0","1","5","1","4","-2"
"136330","Palm Beach Atlantic University","2019","Not on tenure/no tenure system, instructors","7","2","5","0","0","0","0","0","0","0","0","0","2","0","2","0","0","0","5","2","3","0","0","0","0","0","0","0","0","0","-2"
"136400","Pasco-Hernando State College","2019","Tenured total","91","31","60","0","0","0","0","0","0","7","3","4","6","4","2","1","0","1","76","24","52","1","0","1","0","0","0","0","0","0","-2"
"136400","Pasco-Hernando State College","2019","Tenured, professors","30","12","18","0","0","0","0","0","0","1","0","1","1","1","0","0","0","0","28","11","17","0","0","0","0","0","0","0","0","0","-2"
"136400","Pasco-Hernando State College","2019","Tenured, associate professors","31","10","21","0","0","0","0","0","0","5","2","3","5","3","2","1","0","1","20","5","15","0","0","0","0","0","0","0","0","0","-2"
"136400","Pasco-Hernando State College","2019","Tenured, assistant professors","26","9","17","0","0","0","0","0","0","1","1","0","0","0","0","0","0","0","25","8","17","0","0","0","0","0","0","0","0","0","-2"
"136400","Pasco-Hernando State College","2019","Tenured, instructors","4","0","4","0","0","0","0","0","0","0","0","0","0","0","0","0","0","0","3","0","3","1","0","1","0","0","0","0","0","0","-2"
"136400","Pasco-Hernando State College","2019","On-Tenure track total","63","23","40","0","0","0","2","1","1","5","3","2","3","1","2","0","0","0","51","18","33","2","0","2","0","0","0","0","0","0","-2"
"136400","Pasco-Hernando State College","2019","On-tenure track, professors","4","2","2","0","0","0","1","1","0","0","0","0","0","0","0","0","0","0","3","1","2","0","0","0","0","0","0","0","0","0","-2"
"136400","Pasco-Hernando State College","2019","On-tenure track, associate professors","2","2","0","0","0","0","0","0","0","1","1","0","0","0","0","0","0","0","1","1","0","0","0","0","0","0","0","0","0","0","-2"
"136400","Pasco-Hernando State College","2019","On-tenure track, assistant professors","10","2","8","0","0","0","0","0","0","1","1","0","1","0","1","0","0","0","7","1","6","1","0","1","0","0","0","0","0","0","-2"
"136400","Pasco-Hernando State College","2019","On-tenure track, instructors","47","17","30","0","0","0","1","0","1","3","1","2","2","1","1","0","0","0","40","15","25","1","0","1","0","0","0","0","0","0","-2"
"136400","Pasco-Hernando State College","2019","Not on tenure track/No tenure system system total","6","4","2","0","0","0","0","0","0","1","1","0","0","0","0","0","0","0","5","3","2","0","0","0","0","0","0","0","0","0","-2"
"136400","Pasco-Hernando State College","2019","Not on tenure/no tenure system, no academic rank","6","4","2","0","0","0","0","0","0","1","1","0","0","0","0","0","0","0","5","3","2","0","0","0","0","0","0","0","0","0","-2"
"136774","Ringling College of Art and Design","2019","Not on tenure track/No tenure system system total","120","84","36","0","0","0","1","1","0","1","1","0","4","3","1","0","0","0","111","78","33","0","0","0","2","1","1","1","0","1","-2"
"136774","Ringling College of Art and Design","2019","Not on tenure/no tenure system, no academic rank","120","84","36","0","0","0","1","1","0","1","1","0","4","3","1","0","0","0","111","78","33","0","0","0","2","1","1","1","0","1","-2"
"136950","Rollins College","2019","Tenured total","118","64","54","0","0","0","6","2","4","4","4","0","5","1","4","0","0","0","101","55","46","1","1","0","0","0","0","1","1","0","-2"
"136950","Rollins College","2019","Tenured, professors","73","40","33","0","0","0","5","2","3","0","0","0","3","1","2","0","0","0","63","35","28","1","1","0","0","0","0","1","1","0","-2"
"136950","Rollins College","2019","Tenured, associate professors","45","24","21","0","0","0","1","0","1","4","4","0","2","0","2","0","0","0","38","20","18","0","0","0","0","0","0","0","0","0","-2"
"136950","Rollins College","2019","On-Tenure track total","58","24","34","0","0","0","2","1","1","8","4","4","2","0","2","0","0","0","42","18","24","0","0","0","0","0","0","4","1","3","-2"
"136950","Rollins College","2019","On-tenure track, professors","1","0","1","0","0","0","0","0","0","0","0","0","0","0","0","0","0","0","1","0","1","0","0","0","0","0","0","0","0","0","-2"
"136950","Rollins College","2019","On-tenure track, associate professors","7","3","4","0","0","0","0","0","0","2","1","1","0","0","0","0","0","0","5","2","3","0","0","0","0","0","0","0","0","0","-2"
"136950","Rollins College","2019","On-tenure track, assistant professors","50","21","29","0","0","0","2","1","1","6","3","3","2","0","2","0","0","0","36","16","20","0","0","0","0","0","0","4","1","3","-2"
"136950","Rollins College","2019","Not on tenure track/No tenure system system total","49","20","29","0","0","0","1","1","0","0","0","0","2","2","0","0","0","0","42","15","27","0","0","0","0","0","0","4","2","2","-2"
"136950","Rollins College","2019","Not on tenure/no tenure system, professors","1","1","0","0","0","0","0","0","0","0","0","0","0","0","0","0","0","0","0","0","0","0","0","0","0","0","0","1","1","0","-2"
"136950","Rollins College","2019","Not on tenure/no tenure system, assistant professors","12","4","8","0","0","0","0","0","0","0","0","0","1","1","0","0","0","0","10","3","7","0","0","0","0","0","0","1","0","1","-2"
"136950","Rollins College","2019","Not on tenure/no tenure system, instructors","1","0","1","0","0","0","0","0","0","0","0","0","0","0","0","0","0","0","0","0","0","0","0","0","0","0","0","1","0","1","-2"
"136950","Rollins College","2019","Not on tenure/no tenure system, lecturers","35","15","20","0","0","0","1","1","0","0","0","0","1","1","0","0","0","0","32","12","20","0","0","0","0","0","0","1","1","0","-2"
"137032","Saint Leo University","2019","Tenured total","72","44","28","0","0","0","4","4","0","6","2","4","0","0","0","0","0","0","60","36","24","2","2","0","0","0","0","0","0","0","-2"
"137032","Saint Leo University","2019","Tenured, professors","23","14","9","0","0","0","1","1","0","2","1","1","0","0","0","0","0","0","19","11","8","1","1","0","0","0","0","0","0","0","-2"
"137032","Saint Leo University","2019","Tenured, associate professors","41","27","14","0","0","0","3","3","0","4","1","3","0","0","0","0","0","0","33","22","11","1","1","0","0","0","0","0","0","0","-2"
"137032","Saint Leo University","2019","Tenured, assistant professors","8","3","5","0","0","0","0","0","0","0","0","0","0","0","0","0","0","0","8","3","5","0","0","0","0","0","0","0","0","0","-2"
"137032","Saint Leo University","2019","On-Tenure track total","51","24","27","0","0","0","3","3","0","11","3","8","3","2","1","0","0","0","31","15","16","0","0","0","3","1","2","0","0","0","-2"
"137032","Saint Leo University","2019","On-tenure track, professors","1","0","1","0","0","0","0","0","0","0","0","0","0","0","0","0","0","0","1","0","1","0","0","0","0","0","0","0","0","0","-2"
"137032","Saint Leo University","2019","On-tenure track, associate professors","14","7","7","0","0","0","0","0","0","2","1","1","1","0","1","0","0","0","10","6","4","0","0","0","1","0","1","0","0","0","-2"
"137032","Saint Leo University","2019","On-tenure track, assistant professors","36","17","19","0","0","0","3","3","0","9","2","7","2","2","0","0","0","0","20","9","11","0","0","0","2","1","1","0","0","0","-2"
"137032","Saint Leo University","2019","Not on tenure track/No tenure system system total","38","18","20","0","0","0","1","0","1","9","4","5","3","1","2","0","0","0","24","13","11","0","0","0","1","0","1","0","0","0","-2"
"137032","Saint Leo University","2019","Not on tenure/no tenure system, professors","2","2","0","0","0","0","0","0","0","0","0","0","0","0","0","0","0","0","2","2","0","0","0","0","0","0","0","0","0","0","-2"
"137032","Saint Leo University","2019","Not on tenure/no tenure system, associate professors","1","1","0","0","0","0","0","0","0","0","0","0","0","0","0","0","0","0","1","1","0","0","0","0","0","0","0","0","0","0","-2"
"137032","Saint Leo University","2019","Not on tenure/no tenure system, assistant professors","12","9","3","0","0","0","1","0","1","5","4","1","0","0","0","0","0","0","6","5","1","0","0","0","0","0","0","0","0","0","-2"
"137032","Saint Leo University","2019","Not on tenure/no tenure system, instructors","23","6","17","0","0","0","0","0","0","4","0","4","3","1","2","0","0","0","15","5","10","0","0","0","1","0","1","0","0","0","-2"
"137078","St Petersburg College","2019","Tenured total","266","121","145","0","0","0","8","5","3","25","12","13","15","4","11","0","0","0","213","98","115","5","2","3","0","0","0","0","0","0","-2"
"137078","St Petersburg College","2019","Tenured, no academic rank","266","121","145","0","0","0","8","5","3","25","12","13","15","4","11","0","0","0","213","98","115","5","2","3","0","0","0","0","0","0","-2"
"137078","St Petersburg College","2019","On-Tenure track total","74","23","51","0","0","0","3","2","1","12","2","10","7","4","3","0","0","0","52","15","37","0","0","0","0","0","0","0","0","0","-2"
"137078","St Petersburg College","2019","On-tenure track, no academic rank","74","23","51","0","0","0","3","2","1","12","2","10","7","4","3","0","0","0","52","15","37","0","0","0","0","0","0","0","0","0","-2"
"137096","Santa Fe College","2019","Tenured total","160","69","91","0","0","0","5","3","2","11","5","6","10","4","6","0","0","0","129","54","75","2","1","1","3","2","1","0","0","0","-2"
"137096","Santa Fe College","2019","Tenured, no academic rank","160","69","91","0","0","0","5","3","2","11","5","6","10","4","6","0","0","0","129","54","75","2","1","1","3","2","1","0","0","0","-2"
"137096","Santa Fe College","2019","On-Tenure track total","84","37","47","0","0","0","4","1","3","7","3","4","3","0","3","0","0","0","63","29","34","1","0","1","6","4","2","0","0","0","-2"
"137096","Santa Fe College","2019","On-tenure track, no academic rank","84","37","47","0","0","0","4","1","3","7","3","4","3","0","3","0","0","0","63","29","34","1","0","1","6","4","2","0","0","0","-2"
"137546","Stetson University","2019","Tenured total","160","88","72","0","0","0","5","2","3","8","3","5","8","4","4","0","0","0","131","73","58","3","2","1","2","1","1","3","3","0","-2"
"137546","Stetson University","2019","Tenured, professors","103","57","46","0","0","0","4","2","2","5","2","3","4","1","3","0","0","0","86","49","37","2","2","0","1","0","1","1","1","0","-2"
"137546","Stetson University","2019","Tenured, associate professors","57","31","26","0","0","0","1","0","1","3","1","2","4","3","1","0","0","0","45","24","21","1","0","1","1","1","0","2","2","0","-2"
"137546","Stetson University","2019","On-Tenure track total","54","25","29","0","0","0","3","0","3","3","1","2","2","1","1","0","0","0","36","18","18","2","0","2","2","1","1","6","4","2","-2"
"137546","Stetson University","2019","On-tenure track, associate professors","2","1","1","0","0","0","0","0","0","0","0","0","0","0","0","0","0","0","1","1","0","0","0","0","1","0","1","0","0","0","-2"
"137546","Stetson University","2019","On-tenure track, assistant professors","52","24","28","0","0","0","3","0","3","3","1","2","2","1","1","0","0","0","35","17","18","2","0","2","1","1","0","6","4","2","-2"
"137546","Stetson University","2019","Not on tenure track/No tenure system system total","56","20","36","0","0","0","2","2","0","2","1","1","5","2","3","0","0","0","43","12","31","0","0","0","2","2","0","2","1","1","-2"
"137546","Stetson University","2019","Not on tenure/no tenure system, professors","3","2","1","0","0","0","1","1","0","0","0","0","0","0","0","0","0","0","2","1","1","0","0","0","0","0","0","0","0","0","-2"
"137546","Stetson University","2019","Not on tenure/no tenure system, assistant professors","6","3","3","0","0","0","0","0","0","0","0","0","1","0","1","0","0","0","2","0","2","0","0","0","2","2","0","1","1","0","-2"
"137546","Stetson University","2019","Not on tenure/no tenure system, no academic rank","47","15","32","0","0","0","1","1","0","2","1","1","4","2","2","0","0","0","39","11","28","0","0","0","0","0","0","1","0","1","-2"
"137564","Southeastern University","2019","Not on tenure track/No tenure system system total","142","79","63","1","0","1","2","1","1","11","8","3","7","3","4","6","3","3","113","62","51","1","1","0","1","1","0","0","0","0","-2"
"137564","Southeastern University","2019","Not on tenure/no tenure system, professors","45","32","13","0","0","0","0","0","0","2","2","0","2","1","1","3","1","2","38","28","10","0","0","0","0","0","0","0","0","0","-2"
"137564","Southeastern University","2019","Not on tenure/no tenure system, associate professors","47","24","23","1","0","1","1","0","1","6","5","1","1","0","1","1","0","1","36","18","18","1","1","0","0","0","0","0","0","0","-2"
"137564","Southeastern University","2019","Not on tenure/no tenure system, assistant professors","38","20","18","0","0","0","1","1","0","3","1","2","4","2","2","1","1","0","28","14","14","0","0","0","1","1","0","0","0","0","-2"
"137564","Southeastern University","2019","Not on tenure/no tenure system, instructors","6","0","6","0","0","0","0","0","0","0","0","0","0","0","0","0","0","0","6","0","6","0","0","0","0","0","0","0","0","0","-2"
"137564","Southeastern University","2019","Not on tenure/no tenure system, lecturers","6","3","3","0","0","0","0","0","0","0","0","0","0","0","0","1","1","0","5","2","3","0","0","0","0","0","0","0","0","0","-2"
"137962","Trinity College of Florida","2019","Not on tenure track/No tenure system system total","9","4","5","0","0","0","0","0","0","0","0","0","0","0","0","0","0","0","9","4","5","0","0","0","0","0","0","0","0","0","-2"
"137962","Trinity College of Florida","2019","Not on tenure/no tenure system, professors","9","4","5","0","0","0","0","0","0","0","0","0","0","0","0","0","0","0","9","4","5","0","0","0","0","0","0","0","0","0","-2"
"139700","Georgia Highlands College","2019","Tenured total","73","38","35","0","0","0","1","1","0","4","2","2","0","0","0","0","0","0","66","33","33","0","0","0","0","0","0","2","2","0","-2"
"139700","Georgia Highlands College","2019","Tenured, professors","28","14","14","0","0","0","0","0","0","1","0","1","0","0","0","0","0","0","26","13","13","0","0","0","0","0","0","1","1","0","-2"
"139700","Georgia Highlands College","2019","Tenured, associate professors","37","20","17","0","0","0","0","0","0","3","2","1","0","0","0","0","0","0","33","17","16","0","0","0","0","0","0","1","1","0","-2"
"139700","Georgia Highlands College","2019","Tenured, assistant professors","8","4","4","0","0","0","1","1","0","0","0","0","0","0","0","0","0","0","7","3","4","0","0","0","0","0","0","0","0","0","-2"
"139700","Georgia Highlands College","2019","On-Tenure track total","29","7","22","0","0","0","1","1","0","4","0","4","0","0","0","0","0","0","24","6","18","0","0","0","0","0","0","0","0","0","-2"
"139700","Georgia Highlands College","2019","On-tenure track, assistant professors","29","7","22","0","0","0","1","1","0","4","0","4","0","0","0","0","0","0","24","6","18","0","0","0","0","0","0","0","0","0","-2"
"139700","Georgia Highlands College","2019","Not on tenure track/No tenure system system total","38","16","22","1","1","0","3","2","1","5","2","3","1","0","1","0","0","0","28","11","17","0","0","0","0","0","0","0","0","0","-2"
"139700","Georgia Highlands College","2019","Not on tenure/no tenure system, assistant professors","4","2","2","1","1","0","1","1","0","1","0","1","0","0","0","0","0","0","1","0","1","0","0","0","0","0","0","0","0","0","-2"
"139700","Georgia Highlands College","2019","Not on tenure/no tenure system, instructors","34","14","20","0","0","0","2","1","1","4","2","2","1","0","1","0","0","0","27","11","16","0","0","0","0","0","0","0","0","0","-2"
"140252","Life University","2019","Not on tenure track/No tenure system system total","125","74","51","0","0","0","8","3","5","16","6","10","6","3","3","0","0","0","92","60","32","3","2","1","0","0","0","0","0","0","-2"
"140252","Life University","2019","Not on tenure/no tenure system, professors","20","15","5","0","0","0","2","1","1","1","1","0","0","0","0","0","0","0","17","13","4","0","0","0","0","0","0","0","0","0","-2"
"140252","Life University","2019","Not on tenure/no tenure system, associate professors","32","19","13","0","0","0","1","0","1","4","0","4","1","1","0","0","0","0","26","18","8","0","0","0","0","0","0","0","0","0","-2"
"140252","Life University","2019","Not on tenure/no tenure system, assistant professors","72","39","33","0","0","0","5","2","3","11","5","6","5","2","3","0","0","0","48","28","20","3","2","1","0","0","0","0","0","0","-2"
"140252","Life University","2019","Not on tenure/no tenure system, instructors","1","1","0","0","0","0","0","0","0","0","0","0","0","0","0","0","0","0","1","1","0","0","0","0","0","0","0","0","0","0","-2"
"141565","University of Hawaii at Hilo","2019","Tenured total","130","74","56","1","1","0","39","22","17","1","1","0","3","3","0","12","4","8","71","40","31","0","0","0","0","0","0","3","3","0","-2"
"141565","University of Hawaii at Hilo","2019","Tenured, professors","70","35","35","1","1","0","22","11","11","1","1","0","1","1","0","1","1","0","44","20","24","0","0","0","0","0","0","0","0","0","-2"
"141565","University of Hawaii at Hilo","2019","Tenured, associate professors","58","37","21","0","0","0","16","10","6","0","0","0","2","2","0","11","3","8","27","20","7","0","0","0","0","0","0","2","2","0","-2"
"141565","University of Hawaii at Hilo","2019","Tenured, assistant professors","2","2","0","0","0","0","1","1","0","0","0","0","0","0","0","0","0","0","0","0","0","0","0","0","0","0","0","1","1","0","-2"
"141565","University of Hawaii at Hilo","2019","On-Tenure track total","42","24","18","0","0","0","12","8","4","0","0","0","0","0","0","3","0","3","19","12","7","6","3","3","0","0","0","2","1","1","-2"
"141565","University of Hawaii at Hilo","2019","On-tenure track, associate professors","1","1","0","0","0","0","1","1","0","0","0","0","0","0","0","0","0","0","0","0","0","0","0","0","0","0","0","0","0","0","-2"
"141565","University of Hawaii at Hilo","2019","On-tenure track, assistant professors","41","23","18","0","0","0","11","7","4","0","0","0","0","0","0","3","0","3","19","12","7","6","3","3","0","0","0","2","1","1","-2"
"141565","University of Hawaii at Hilo","2019","Not on tenure track/No tenure system system total","31","7","24","0","0","0","4","1","3","1","0","1","1","0","1","1","0","1","21","6","15","2","0","2","0","0","0","1","0","1","-2"
"141565","University of Hawaii at Hilo","2019","Not on tenure/no tenure system, assistant professors","1","0","1","0","0","0","0","0","0","0","0","0","0","0","0","1","0","1","0","0","0","0","0","0","0","0","0","0","0","0","-2"
"141565","University of Hawaii at Hilo","2019","Not on tenure/no tenure system, instructors","30","7","23","0","0","0","4","1","3","1","0","1","1","0","1","0","0","0","21","6","15","2","0","2","0","0","0","1","0","1","-2"
"141839","University of Hawaii Maui College","2019","Tenured total","46","24","22","0","0","0","10","4","6","1","1","0","0","0","0","4","4","0","28","13","15","1","0","1","0","0","0","2","2","0","-2"
"141839","University of Hawaii Maui College","2019","Tenured, professors","12","4","8","0","0","0","2","0","2","1","1","0","0","0","0","1","1","0","8","2","6","0","0","0","0","0","0","0","0","0","-2"
"141839","University of Hawaii Maui College","2019","Tenured, associate professors","16","7","9","0","0","0","3","1","2","0","0","0","0","0","0","3","3","0","9","2","7","0","0","0","0","0","0","1","1","0","-2"
"141839","University of Hawaii Maui College","2019","Tenured, assistant professors","18","13","5","0","0","0","5","3","2","0","0","0","0","0","0","0","0","0","11","9","2","1","0","1","0","0","0","1","1","0","-2"
"141839","University of Hawaii Maui College","2019","On-Tenure track total","25","11","14","0","0","0","2","0","2","0","0","0","0","0","0","2","1","1","18","8","10","3","2","1","0","0","0","0","0","0","-2"
"141839","University of Hawaii Maui College","2019","On-tenure track, instructors","25","11","14","0","0","0","2","0","2","0","0","0","0","0","0","2","1","1","18","8","10","3","2","1","0","0","0","0","0","0","-2"
"141839","University of Hawaii Maui College","2019","Not on tenure track/No tenure system system total","2","1","1","0","0","0","0","0","0","0","0","0","0","0","0","0","0","0","2","1","1","0","0","0","0","0","0","0","0","0","-2"
"141839","University of Hawaii Maui College","2019","Not on tenure/no tenure system, instructors","2","1","1","0","0","0","0","0","0","0","0","0","0","0","0","0","0","0","2","1","1","0","0","0","0","0","0","0","0","0","-2"
"142559","College of Southern Idaho","2019","Not on tenure track/No tenure system system total","143","68","75","1","0","1","3","0","3","1","1","0","6","2","4","0","0","0","128","63","65","2","1","1","1","1","0","1","0","1","-2"
"142559","College of Southern Idaho","2019","Not on tenure/no tenure system, professors","50","23","27","0","0","0","0","0","0","0","0","0","4","1","3","0","0","0","46","22","24","0","0","0","0","0","0","0","0","0","-2"
"142559","College of Southern Idaho","2019","Not on tenure/no tenure system, associate professors","23","10","13","1","0","1","0","0","0","0","0","0","0","0","0","0","0","0","22","10","12","0","0","0","0","0","0","0","0","0","-2"
"142559","College of Southern Idaho","2019","Not on tenure/no tenure system, assistant professors","22","11","11","0","0","0","2","0","2","0","0","0","0","0","0","0","0","0","20","11","9","0","0","0","0","0","0","0","0","0","-2"
"142559","College of Southern Idaho","2019","Not on tenure/no tenure system, instructors","48","24","24","0","0","0","1","0","1","1","1","0","2","1","1","0","0","0","40","20","20","2","1","1","1","1","0","1","0","1","-2"
"144281","Columbia College Chicago","2019","Tenured total","175","97","78","0","0","0","5","1","4","12","4","8","9","6","3","0","0","0","145","85","60","1","0","1","3","1","2","0","0","0","-2"
"144281","Columbia College Chicago","2019","Tenured, professors","34","21","13","0","0","0","1","0","1","2","1","1","3","2","1","0","0","0","27","18","9","0","0","0","1","0","1","0","0","0","-2"
"144281","Columbia College Chicago","2019","Tenured, associate professors","141","76","65","0","0","0","4","1","3","10","3","7","6","4","2","0","0","0","118","67","51","1","0","1","2","1","1","0","0","0","-2"
"144281","Columbia College Chicago","2019","On-Tenure track total","27","14","13","0","0","0","0","0","0","5","4","1","3","2","1","0","0","0","16","7","9","0","0","0","3","1","2","0","0","0","-2"
"144281","Columbia College Chicago","2019","On-tenure track, assistant professors","27","14","13","0","0","0","0","0","0","5","4","1","3","2","1","0","0","0","16","7","9","0","0","0","3","1","2","0","0","0","-2"
"144281","Columbia College Chicago","2019","Not on tenure track/No tenure system system total","57","32","25","0","0","0","1","0","1","5","0","5","1","1","0","0","0","0","48","29","19","0","0","0","2","2","0","0","0","0","-2"
"144281","Columbia College Chicago","2019","Not on tenure/no tenure system, lecturers","57","32","25","0","0","0","1","0","1","5","0","5","1","1","0","0","0","0","48","29","19","0","0","0","2","2","0","0","0","0","-2"
"144740","DePaul University","2019","Tenured total","522","292","230","2","1","1","34","21","13","35","19","16","33","14","19","0","0","0","320","181","139","6","3","3","42","23","19","50","30","20","-2"
"144740","DePaul University","2019","Tenured, professors","190","119","71","0","0","0","10","9","1","8","4","4","13","5","8","0","0","0","133","87","46","2","1","1","13","4","9","11","9","2","-2"
"144740","DePaul University","2019","Tenured, associate professors","331","172","159","2","1","1","24","12","12","27","15","12","20","9","11","0","0","0","187","94","93","4","2","2","28","18","10","39","21","18","-2"
"144740","DePaul University","2019","Tenured, assistant professors","1","1","0","0","0","0","0","0","0","0","0","0","0","0","0","0","0","0","0","0","0","0","0","0","1","1","0","0","0","0","-2"
"144740","DePaul University","2019","On-Tenure track total","117","53","64","0","0","0","5","1","4","9","3","6","8","5","3","0","0","0","49","23","26","1","1","0","33","11","22","12","9","3","-2"
"144740","DePaul University","2019","On-tenure track, associate professors","4","0","4","0","0","0","0","0","0","1","0","1","0","0","0","0","0","0","0","0","0","0","0","0","3","0","3","0","0","0","-2"
"144740","DePaul University","2019","On-tenure track, assistant professors","113","53","60","0","0","0","5","1","4","8","3","5","8","5","3","0","0","0","49","23","26","1","1","0","30","11","19","12","9","3","-2"
"144740","DePaul University","2019","Not on tenure track/No tenure system system total","231","122","109","1","1","0","8","6","2","9","4","5","11","7","4","0","0","0","158","77","81","2","2","0","31","19","12","11","6","5","-2"
"144740","DePaul University","2019","Not on tenure/no tenure system, associate professors","1","0","1","0","0","0","0","0","0","0","0","0","0","0","0","0","0","0","0","0","0","0","0","0","1","0","1","0","0","0","-2"
"144740","DePaul University","2019","Not on tenure/no tenure system, assistant professors","2","1","1","0","0","0","0","0","0","0","0","0","0","0","0","0","0","0","2","1","1","0","0","0","0","0","0","0","0","0","-2"
"144740","DePaul University","2019","Not on tenure/no tenure system, instructors","228","121","107","1","1","0","8","6","2","9","4","5","11","7","4","0","0","0","156","76","80","2","2","0","30","19","11","11","6","5","-2"
"144883","East-West University","2019","Not on tenure track/No tenure system system total","10","6","4","0","0","0","4","1","3","0","0","0","0","0","0","0","0","0","6","5","1","0","0","0","0","0","0","0","0","0","-2"
"144883","East-West University","2019","Not on tenure/no tenure system, associate professors","3","0","3","0","0","0","2","0","2","0","0","0","0","0","0","0","0","0","1","0","1","0","0","0","0","0","0","0","0","0","-2"
"144883","East-West University","2019","Not on tenure/no tenure system, assistant professors","7","6","1","0","0","0","2","1","1","0","0","0","0","0","0","0","0","0","5","5","0","0","0","0","0","0","0","0","0","0","-2"
"144962","Elmhurst University","2019","Tenured total","86","36","50","0","0","0","5","4","1","3","1","2","3","1","2","0","0","0","75","30","45","0","0","0","0","0","0","0","0","0","-2"
"144962","Elmhurst University","2019","Tenured, professors","54","24","30","0","0","0","4","3","1","1","1","0","1","0","1","0","0","0","48","20","28","0","0","0","0","0","0","0","0","0","-2"
"144962","Elmhurst University","2019","Tenured, associate professors","31","12","19","0","0","0","1","1","0","2","0","2","2","1","1","0","0","0","26","10","16","0","0","0","0","0","0","0","0","0","-2"
"144962","Elmhurst University","2019","Tenured, assistant professors","1","0","1","0","0","0","0","0","0","0","0","0","0","0","0","0","0","0","1","0","1","0","0","0","0","0","0","0","0","0","-2"
"144962","Elmhurst University","2019","On-Tenure track total","27","10","17","0","0","0","2","0","2","0","0","0","0","0","0","0","0","0","25","10","15","0","0","0","0","0","0","0","0","0","-2"
"144962","Elmhurst University","2019","On-tenure track, assistant professors","25","10","15","0","0","0","2","0","2","0","0","0","0","0","0","0","0","0","23","10","13","0","0","0","0","0","0","0","0","0","-2"
"144962","Elmhurst University","2019","On-tenure track, instructors","1","0","1","0","0","0","0","0","0","0","0","0","0","0","0","0","0","0","1","0","1","0","0","0","0","0","0","0","0","0","-2"
"144962","Elmhurst University","2019","On-tenure track, no academic rank","1","0","1","0","0","0","0","0","0","0","0","0","0","0","0","0","0","0","1","0","1","0","0","0","0","0","0","0","0","0","-2"
"144962","Elmhurst University","2019","Not on tenure track/No tenure system system total","45","13","32","0","0","0","3","0","3","4","1","3","3","2","1","0","0","0","35","10","25","0","0","0","0","0","0","0","0","0","-2"
"144962","Elmhurst University","2019","Not on tenure/no tenure system, associate professors","6","2","4","0","0","0","0","0","0","2","0","2","0","0","0","0","0","0","4","2","2","0","0","0","0","0","0","0","0","0","-2"
"144962","Elmhurst University","2019","Not on tenure/no tenure system, assistant professors","18","5","13","0","0","0","1","0","1","0","0","0","1","1","0","0","0","0","16","4","12","0","0","0","0","0","0","0","0","0","-2"
"144962","Elmhurst University","2019","Not on tenure/no tenure system, lecturers","17","5","12","0","0","0","1","0","1","2","1","1","2","1","1","0","0","0","12","3","9","0","0","0","0","0","0","0","0","0","-2"
"144962","Elmhurst University","2019","Not on tenure/no tenure system, no academic rank","4","1","3","0","0","0","1","0","1","0","0","0","0","0","0","0","0","0","3","1","2","0","0","0","0","0","0","0","0","0","-2"
"145336","Governors State University","2019","Tenured total","80","42","38","0","0","0","15","10","5","13","6","7","0","0","0","0","0","0","39","21","18","2","0","2","11","5","6","0","0","0","-2"
"145336","Governors State University","2019","Tenured, professors","29","16","13","0","0","0","5","4","1","4","1","3","0","0","0","0","0","0","14","8","6","1","0","1","5","3","2","0","0","0","-2"
"145336","Governors State University","2019","Tenured, associate professors","51","26","25","0","0","0","10","6","4","9","5","4","0","0","0","0","0","0","25","13","12","1","0","1","6","2","4","0","0","0","-2"
"145336","Governors State University","2019","On-Tenure track total","79","24","55","2","0","2","10","5","5","14","4","10","3","0","3","0","0","0","41","11","30","1","0","1","6","3","3","2","1","1","-2"
"145336","Governors State University","2019","On-tenure track, associate professors","15","7","8","0","0","0","3","1","2","2","1","1","1","0","1","0","0","0","8","5","3","1","0","1","0","0","0","0","0","0","-2"
"145336","Governors State University","2019","On-tenure track, assistant professors","62","17","45","2","0","2","7","4","3","11","3","8","2","0","2","0","0","0","33","6","27","0","0","0","5","3","2","2","1","1","-2"
"145336","Governors State University","2019","On-tenure track, instructors","2","0","2","0","0","0","0","0","0","1","0","1","0","0","0","0","0","0","0","0","0","0","0","0","1","0","1","0","0","0","-2"
"145336","Governors State University","2019","Not on tenure track/No tenure system system total","68","28","40","0","0","0","4","1","3","10","3","7","0","0","0","0","0","0","45","19","26","1","1","0","8","4","4","0","0","0","-2"
"145336","Governors State University","2019","Not on tenure/no tenure system, lecturers","60","24","36","0","0","0","3","1","2","10","3","7","0","0","0","0","0","0","38","15","23","1","1","0","8","4","4","0","0","0","-2"
"145336","Governors State University","2019","Not on tenure/no tenure system, no academic rank","8","4","4","0","0","0","1","0","1","0","0","0","0","0","0","0","0","0","7","4","3","0","0","0","0","0","0","0","0","0","-2"
"145619","Benedictine University","2019","Tenured total","73","37","36","0","0","0","8","3","5","2","1","1","1","1","0","0","0","0","60","31","29","0","0","0","2","1","1","0","0","0","-2"
"145619","Benedictine University","2019","Tenured, professors","48","26","22","0","0","0","5","3","2","2","1","1","0","0","0","0","0","0","40","22","18","0","0","0","1","0","1","0","0","0","-2"
"145619","Benedictine University","2019","Tenured, associate professors","25","11","14","0","0","0","3","0","3","0","0","0","1","1","0","0","0","0","20","9","11","0","0","0","1","1","0","0","0","0","-2"
"145619","Benedictine University","2019","On-Tenure track total","35","13","22","0","0","0","4","2","2","1","0","1","1","0","1","0","0","0","29","11","18","0","0","0","0","0","0","0","0","0","-2"
"145619","Benedictine University","2019","On-tenure track, associate professors","5","1","4","0","0","0","0","0","0","0","0","0","0","0","0","0","0","0","5","1","4","0","0","0","0","0","0","0","0","0","-2"
"145619","Benedictine University","2019","On-tenure track, assistant professors","30","12","18","0","0","0","4","2","2","1","0","1","1","0","1","0","0","0","24","10","14","0","0","0","0","0","0","0","0","0","-2"
"145619","Benedictine University","2019","Not on tenure track/No tenure system system total","32","17","15","0","0","0","2","1","1","0","0","0","2","2","0","0","0","0","27","13","14","0","0","0","1","1","0","0","0","0","-2"
"145619","Benedictine University","2019","Not on tenure/no tenure system, professors","1","0","1","0","0","0","0","0","0","0","0","0","0","0","0","0","0","0","1","0","1","0","0","0","0","0","0","0","0","0","-2"
"145619","Benedictine University","2019","Not on tenure/no tenure system, associate professors","3","2","1","0","0","0","0","0","0","0","0","0","1","1","0","0","0","0","2","1","1","0","0","0","0","0","0","0","0","0","-2"
"145619","Benedictine University","2019","Not on tenure/no tenure system, assistant professors","16","8","8","0","0","0","2","1","1","0","0","0","0","0","0","0","0","0","14","7","7","0","0","0","0","0","0","0","0","0","-2"
"145619","Benedictine University","2019","Not on tenure/no tenure system, instructors","12","7","5","0","0","0","0","0","0","0","0","0","1","1","0","0","0","0","10","5","5","0","0","0","1","1","0","0","0","0","-2"
"145725","Illinois Institute of Technology","2019","Tenured total","215","168","47","1","1","0","51","40","11","5","2","3","7","6","1","1","0","1","126","99","27","0","0","0","7","6","1","17","14","3","-2"
"145725","Illinois Institute of Technology","2019","Tenured, professors","114","94","20","1","1","0","28","24","4","3","2","1","1","1","0","0","0","0","70","57","13","0","0","0","6","5","1","5","4","1","-2"
"145725","Illinois Institute of Technology","2019","Tenured, associate professors","78","63","15","0","0","0","17","14","3","1","0","1","5","4","1","0","0","0","44","36","8","0","0","0","1","1","0","10","8","2","-2"
"145725","Illinois Institute of Technology","2019","Tenured, assistant professors","23","11","12","0","0","0","6","2","4","1","0","1","1","1","0","1","0","1","12","6","6","0","0","0","0","0","0","2","2","0","-2"
"145725","Illinois Institute of Technology","2019","On-Tenure track total","49","35","14","2","0","2","6","4","2","1","1","0","2","2","0","0","0","0","14","9","5","0","0","0","13","11","2","11","8","3","-2"
"145725","Illinois Institute of Technology","2019","On-tenure track, assistant professors","28","20","8","1","0","1","6","4","2","1","1","0","2","2","0","0","0","0","12","8","4","0","0","0","1","1","0","5","4","1","-2"
"145725","Illinois Institute of Technology","2019","On-tenure track, lecturers","1","1","0","0","0","0","0","0","0","0","0","0","0","0","0","0","0","0","0","0","0","0","0","0","0","0","0","1","1","0","-2"
"145725","Illinois Institute of Technology","2019","On-tenure track, no academic rank","20","14","6","1","0","1","0","0","0","0","0","0","0","0","0","0","0","0","2","1","1","0","0","0","12","10","2","5","3","2","-2"
"145725","Illinois Institute of Technology","2019","Not on tenure track/No tenure system system total","138","84","54","2","2","0","10","5","5","2","0","2","3","1","2","0","0","0","80","52","28","0","0","0","19","11","8","22","13","9","-2"
"145725","Illinois Institute of Technology","2019","Not on tenure/no tenure system, professors","23","15","8","2","2","0","3","1","2","0","0","0","1","0","1","0","0","0","17","12","5","0","0","0","0","0","0","0","0","0","-2"
"145725","Illinois Institute of Technology","2019","Not on tenure/no tenure system, associate professors","15","11","4","0","0","0","0","0","0","0","0","0","0","0","0","0","0","0","15","11","4","0","0","0","0","0","0","0","0","0","-2"
"145725","Illinois Institute of Technology","2019","Not on tenure/no tenure system, assistant professors","16","6","10","0","0","0","1","0","1","1","0","1","0","0","0","0","0","0","7","3","4","0","0","0","1","1","0","6","2","4","-2"
"145725","Illinois Institute of Technology","2019","Not on tenure/no tenure system, instructors","8","4","4","0","0","0","0","0","0","0","0","0","0","0","0","0","0","0","7","3","4","0","0","0","0","0","0","1","1","0","-2"
"145725","Illinois Institute of Technology","2019","Not on tenure/no tenure system, lecturers","30","21","9","0","0","0","5","3","2","1","0","1","0","0","0","0","0","0","23","18","5","0","0","0","0","0","0","1","0","1","-2"
"145725","Illinois Institute of Technology","2019","Not on tenure/no tenure system, no academic rank","46","27","19","0","0","0","1","1","0","0","0","0","2","1","1","0","0","0","11","5","6","0","0","0","18","10","8","14","10","4","-2"
"146339","Judson University","2019","Tenured total","18","11","7","0","0","0","1","0","1","0","0","0","0","0","0","0","0","0","17","11","6","0","0","0","0","0","0","0","0","0","-2"
"146339","Judson University","2019","Tenured, professors","16","11","5","0","0","0","1","0","1","0","0","0","0","0","0","0","0","0","15","11","4","0","0","0","0","0","0","0","0","0","-2"
"146339","Judson University","2019","Tenured, associate professors","2","0","2","0","0","0","0","0","0","0","0","0","0","0","0","0","0","0","2","0","2","0","0","0","0","0","0","0","0","0","-2"
"146339","Judson University","2019","On-Tenure track total","5","3","2","0","0","0","0","0","0","1","0","1","0","0","0","0","0","0","4","3","1","0","0","0","0","0","0","0","0","0","-2"
"146339","Judson University","2019","On-tenure track, associate professors","2","2","0","0","0","0","0","0","0","0","0","0","0","0","0","0","0","0","2","2","0","0","0","0","0","0","0","0","0","0","-2"
"146339","Judson University","2019","On-tenure track, assistant professors","3","1","2","0","0","0","0","0","0","1","0","1","0","0","0","0","0","0","2","1","1","0","0","0","0","0","0","0","0","0","-2"
"146339","Judson University","2019","Not on tenure track/No tenure system system total","20","10","10","0","0","0","1","1","0","4","1","3","0","0","0","0","0","0","14","8","6","0","0","0","0","0","0","1","0","1","-2"
"146339","Judson University","2019","Not on tenure/no tenure system, professors","4","2","2","0","0","0","0","0","0","1","0","1","0","0","0","0","0","0","3","2","1","0","0","0","0","0","0","0","0","0","-2"
"146339","Judson University","2019","Not on tenure/no tenure system, associate professors","4","2","2","0","0","0","0","0","0","1","1","0","0","0","0","0","0","0","3","1","2","0","0","0","0","0","0","0","0","0","-2"
"146339","Judson University","2019","Not on tenure/no tenure system, assistant professors","12","6","6","0","0","0","1","1","0","2","0","2","0","0","0","0","0","0","8","5","3","0","0","0","0","0","0","1","0","1","-2"
"146612","Lewis University","2019","Tenured total","74","39","35","0","0","0","4","3","1","3","1","2","1","0","1","0","0","0","66","35","31","0","0","0","0","0","0","0","0","0","-2"
"146612","Lewis University","2019","Tenured, professors","49","29","20","0","0","0","3","2","1","3","1","2","0","0","0","0","0","0","43","26","17","0","0","0","0","0","0","0","0","0","-2"
"146612","Lewis University","2019","Tenured, associate professors","25","10","15","0","0","0","1","1","0","0","0","0","1","0","1","0","0","0","23","9","14","0","0","0","0","0","0","0","0","0","-2"
"146612","Lewis University","2019","On-Tenure track total","54","26","28","0","0","0","7","3","4","2","2","0","3","0","3","0","0","0","41","21","20","0","0","0","0","0","0","1","0","1","-2"
"146612","Lewis University","2019","On-tenure track, professors","3","2","1","0","0","0","0","0","0","0","0","0","1","0","1","0","0","0","2","2","0","0","0","0","0","0","0","0","0","0","-2"
"146612","Lewis University","2019","On-tenure track, associate professors","19","9","10","0","0","0","3","2","1","1","1","0","0","0","0","0","0","0","14","6","8","0","0","0","0","0","0","1","0","1","-2"
"146612","Lewis University","2019","On-tenure track, assistant professors","32","15","17","0","0","0","4","1","3","1","1","0","2","0","2","0","0","0","25","13","12","0","0","0","0","0","0","0","0","0","-2"
"146612","Lewis University","2019","Not on tenure track/No tenure system system total","100","48","52","0","0","0","2","0","2","11","4","7","4","0","4","0","0","0","82","43","39","0","0","0","1","1","0","0","0","0","-2"
"146612","Lewis University","2019","Not on tenure/no tenure system, professors","2","2","0","0","0","0","0","0","0","0","0","0","0","0","0","0","0","0","2","2","0","0","0","0","0","0","0","0","0","0","-2"
"146612","Lewis University","2019","Not on tenure/no tenure system, associate professors","18","10","8","0","0","0","0","0","0","4","1","3","0","0","0","0","0","0","14","9","5","0","0","0","0","0","0","0","0","0","-2"
"146612","Lewis University","2019","Not on tenure/no tenure system, assistant professors","63","28","35","0","0","0","2","0","2","7","3","4","3","0","3","0","0","0","50","24","26","0","0","0","1","1","0","0","0","0","-2"
"146612","Lewis University","2019","Not on tenure/no tenure system, instructors","17","8","9","0","0","0","0","0","0","0","0","0","1","0","1","0","0","0","16","8","8","0","0","0","0","0","0","0","0","0","-2"
"146719","Loyola University Chicago","2019","Tenured total","433","260","173","0","0","0","36","25","11","16","8","8","19","11","8","0","0","0","353","213","140","4","1","3","3","1","2","2","1","1","-2"
"146719","Loyola University Chicago","2019","Tenured, professors","220","147","73","0","0","0","16","14","2","2","1","1","13","10","3","0","0","0","184","121","63","3","0","3","1","1","0","1","0","1","-2"
"146719","Loyola University Chicago","2019","Tenured, associate professors","206","108","98","0","0","0","19","10","9","13","7","6","6","1","5","0","0","0","164","88","76","1","1","0","2","0","2","1","1","0","-2"
"146719","Loyola University Chicago","2019","Tenured, assistant professors","7","5","2","0","0","0","1","1","0","1","0","1","0","0","0","0","0","0","5","4","1","0","0","0","0","0","0","0","0","0","-2"
"146719","Loyola University Chicago","2019","On-Tenure track total","142","71","71","0","0","0","15","7","8","10","6","4","5","2","3","0","0","0","97","52","45","2","0","2","1","1","0","12","3","9","-2"
"146719","Loyola University Chicago","2019","On-tenure track, professors","1","0","1","0","0","0","1","0","1","0","0","0","0","0","0","0","0","0","0","0","0","0","0","0","0","0","0","0","0","0","-2"
"146719","Loyola University Chicago","2019","On-tenure track, associate professors","10","7","3","0","0","0","0","0","0","1","1","0","0","0","0","0","0","0","9","6","3","0","0","0","0","0","0","0","0","0","-2"
"146719","Loyola University Chicago","2019","On-tenure track, assistant professors","131","64","67","0","0","0","14","7","7","9","5","4","5","2","3","0","0","0","88","46","42","2","0","2","1","1","0","12","3","9","-2"
"146719","Loyola University Chicago","2019","Not on tenure track/No tenure system system total","368","160","208","0","0","0","24","11","13","20","6","14","19","11","8","2","0","2","296","130","166","3","1","2","1","0","1","3","1","2","-2"
"146719","Loyola University Chicago","2019","Not on tenure/no tenure system, instructors","368","160","208","0","0","0","24","11","13","20","6","14","19","11","8","2","0","2","296","130","166","3","1","2","1","0","1","3","1","2","-2"
"147660","North Central College","2019","Tenured total","74","43","31","0","0","0","5","2","3","1","0","1","2","2","0","0","0","0","63","39","24","0","0","0","1","0","1","2","0","2","-2"
"147660","North Central College","2019","Tenured, professors","39","27","12","0","0","0","2","1","1","0","0","0","0","0","0","0","0","0","37","26","11","0","0","0","0","0","0","0","0","0","-2"
"147660","North Central College","2019","Tenured, associate professors","35","16","19","0","0","0","3","1","2","1","0","1","2","2","0","0","0","0","26","13","13","0","0","0","1","0","1","2","0","2","-2"
"147660","North Central College","2019","On-Tenure track total","39","13","26","0","0","0","3","0","3","1","1","0","2","1","1","0","0","0","25","10","15","2","0","2","2","0","2","4","1","3","-2"
"147660","North Central College","2019","On-tenure track, professors","1","1","0","0","0","0","0","0","0","0","0","0","0","0","0","0","0","0","1","1","0","0","0","0","0","0","0","0","0","0","-2"
"147660","North Central College","2019","On-tenure track, associate professors","3","1","2","0","0","0","0","0","0","0","0","0","0","0","0","0","0","0","2","1","1","0","0","0","1","0","1","0","0","0","-2"
"147660","North Central College","2019","On-tenure track, assistant professors","35","11","24","0","0","0","3","0","3","1","1","0","2","1","1","0","0","0","22","8","14","2","0","2","1","0","1","4","1","3","-2"
"147660","North Central College","2019","Not on tenure track/No tenure system system total","45","14","31","0","0","0","3","0","3","1","0","1","1","0","1","0","0","0","39","13","26","0","0","0","0","0","0","1","1","0","-2"
"147660","North Central College","2019","Not on tenure/no tenure system, professors","6","3","3","0","0","0","0","0","0","0","0","0","0","0","0","0","0","0","6","3","3","0","0","0","0","0","0","0","0","0","-2"
"147660","North Central College","2019","Not on tenure/no tenure system, associate professors","10","3","7","0","0","0","0","0","0","0","0","0","0","0","0","0","0","0","10","3","7","0","0","0","0","0","0","0","0","0","-2"
"147660","North Central College","2019","Not on tenure/no tenure system, assistant professors","25","7","18","0","0","0","2","0","2","1","0","1","1","0","1","0","0","0","20","6","14","0","0","0","0","0","0","1","1","0","-2"
"147660","North Central College","2019","Not on tenure/no tenure system, instructors","1","1","0","0","0","0","0","0","0","0","0","0","0","0","0","0","0","0","1","1","0","0","0","0","0","0","0","0","0","0","-2"
"147660","North Central College","2019","Not on tenure/no tenure system, lecturers","3","0","3","0","0","0","1","0","1","0","0","0","0","0","0","0","0","0","2","0","2","0","0","0","0","0","0","0","0","0","-2"
"148405","Rockford University","2019","Tenured total","36","17","19","0","0","0","0","0","0","0","0","0","1","1","0","0","0","0","33","15","18","1","1","0","0","0","0","1","0","1","-2"
"148405","Rockford University","2019","Tenured, professors","10","4","6","0","0","0","0","0","0","0","0","0","0","0","0","0","0","0","9","3","6","1","1","0","0","0","0","0","0","0","-2"
"148405","Rockford University","2019","Tenured, associate professors","16","10","6","0","0","0","0","0","0","0","0","0","0","0","0","0","0","0","15","10","5","0","0","0","0","0","0","1","0","1","-2"
"148405","Rockford University","2019","Tenured, assistant professors","10","3","7","0","0","0","0","0","0","0","0","0","1","1","0","0","0","0","9","2","7","0","0","0","0","0","0","0","0","0","-2"
"148405","Rockford University","2019","On-Tenure track total","30","10","20","0","0","0","1","1","0","0","0","0","1","1","0","0","0","0","26","6","20","0","0","0","0","0","0","2","2","0","-2"
"148405","Rockford University","2019","On-tenure track, associate professors","5","4","1","0","0","0","0","0","0","0","0","0","0","0","0","0","0","0","4","3","1","0","0","0","0","0","0","1","1","0","-2"
"148405","Rockford University","2019","On-tenure track, assistant professors","25","6","19","0","0","0","1","1","0","0","0","0","1","1","0","0","0","0","22","3","19","0","0","0","0","0","0","1","1","0","-2"
"148405","Rockford University","2019","Not on tenure track/No tenure system system total","5","0","5","0","0","0","0","0","0","0","0","0","0","0","0","0","0","0","5","0","5","0","0","0","0","0","0","0","0","0","-2"
"148405","Rockford University","2019","Not on tenure/no tenure system, associate professors","1","0","1","0","0","0","0","0","0","0","0","0","0","0","0","0","0","0","1","0","1","0","0","0","0","0","0","0","0","0","-2"
"148405","Rockford University","2019","Not on tenure/no tenure system, assistant professors","4","0","4","0","0","0","0","0","0","0","0","0","0","0","0","0","0","0","4","0","4","0","0","0","0","0","0","0","0","0","-2"
"148584","University of St Francis","2019","Tenured total","44","20","24","0","0","0","2","0","2","4","1","3","1","0","1","0","0","0","36","19","17","0","0","0","0","0","0","1","0","1","-2"
"148584","University of St Francis","2019","Tenured, professors","20","12","8","0","0","0","1","0","1","1","1","0","0","0","0","0","0","0","18","11","7","0","0","0","0","0","0","0","0","0","-2"
"148584","University of St Francis","2019","Tenured, associate professors","23","8","15","0","0","0","1","0","1","3","0","3","1","0","1","0","0","0","17","8","9","0","0","0","0","0","0","1","0","1","-2"
"148584","University of St Francis","2019","Tenured, assistant professors","1","0","1","0","0","0","0","0","0","0","0","0","0","0","0","0","0","0","1","0","1","0","0","0","0","0","0","0","0","0","-2"
"148584","University of St Francis","2019","On-Tenure track total","20","4","16","0","0","0","0","0","0","1","0","1","1","0","1","0","0","0","17","3","14","0","0","0","0","0","0","1","1","0","-2"
"148584","University of St Francis","2019","On-tenure track, assistant professors","20","4","16","0","0","0","0","0","0","1","0","1","1","0","1","0","0","0","17","3","14","0","0","0","0","0","0","1","1","0","-2"
"148584","University of St Francis","2019","Not on tenure track/No tenure system system total","35","13","22","0","0","0","0","0","0","2","0","2","3","1","2","0","0","0","30","12","18","0","0","0","0","0","0","0","0","0","-2"
"148584","University of St Francis","2019","Not on tenure/no tenure system, professors","5","4","1","0","0","0","0","0","0","0","0","0","1","1","0","0","0","0","4","3","1","0","0","0","0","0","0","0","0","0","-2"
"148584","University of St Francis","2019","Not on tenure/no tenure system, assistant professors","10","2","8","0","0","0","0","0","0","1","0","1","0","0","0","0","0","0","9","2","7","0","0","0","0","0","0","0","0","0","-2"
"148584","University of St Francis","2019","Not on tenure/no tenure system, instructors","20","7","13","0","0","0","0","0","0","1","0","1","2","0","2","0","0","0","17","7","10","0","0","0","0","0","0","0","0","0","-2"
"149763","Resurrection University","2019","Not on tenure track/No tenure system system total","49","10","39","0","0","0","6","3","3","9","0","9","3","1","2","0","0","0","30","6","24","1","0","1","0","0","0","0","0","0","-2"
"149763","Resurrection University","2019","Not on tenure/no tenure system, associate professors","10","1","9","0","0","0","0","0","0","2","0","2","0","0","0","0","0","0","8","1","7","0","0","0","0","0","0","0","0","0","-2"
"149763","Resurrection University","2019","Not on tenure/no tenure system, assistant professors","18","1","17","0","0","0","3","0","3","3","0","3","2","0","2","0","0","0","9","1","8","1","0","1","0","0","0","0","0","0","-2"
"149763","Resurrection University","2019","Not on tenure/no tenure system, instructors","21","8","13","0","0","0","3","3","0","4","0","4","1","1","0","0","0","0","13","4","9","0","0","0","0","0","0","0","0","0","-2"
"150668","Goshen College","2019","Tenured total","29","17","12","0","0","0","0","0","0","1","0","1","0","0","0","0","0","0","28","17","11","0","0","0","0","0","0","0","0","0","-2"
"150668","Goshen College","2019","Tenured, professors","25","15","10","0","0","0","0","0","0","1","0","1","0","0","0","0","0","0","24","15","9","0","0","0","0","0","0","0","0","0","-2"
"150668","Goshen College","2019","Tenured, associate professors","4","2","2","0","0","0","0","0","0","0","0","0","0","0","0","0","0","0","4","2","2","0","0","0","0","0","0","0","0","0","-2"
"150668","Goshen College","2019","On-Tenure track total","8","6","2","0","0","0","0","0","0","0","0","0","0","0","0","0","0","0","7","6","1","0","0","0","1","0","1","0","0","0","-2"
"150668","Goshen College","2019","On-tenure track, professors","2","2","0","0","0","0","0","0","0","0","0","0","0","0","0","0","0","0","2","2","0","0","0","0","0","0","0","0","0","0","-2"
"150668","Goshen College","2019","On-tenure track, associate professors","3","2","1","0","0","0","0","0","0","0","0","0","0","0","0","0","0","0","2","2","0","0","0","0","1","0","1","0","0","0","-2"
"150668","Goshen College","2019","On-tenure track, assistant professors","3","2","1","0","0","0","0","0","0","0","0","0","0","0","0","0","0","0","3","2","1","0","0","0","0","0","0","0","0","0","-2"
"150668","Goshen College","2019","Not on tenure track/No tenure system system total","23","7","16","0","0","0","0","0","0","0","0","0","0","0","0","0","0","0","20","5","15","1","0","1","1","1","0","1","1","0","-2"
"150668","Goshen College","2019","Not on tenure/no tenure system, professors","4","1","3","0","0","0","0","0","0","0","0","0","0","0","0","0","0","0","4","1","3","0","0","0","0","0","0","0","0","0","-2"
"150668","Goshen College","2019","Not on tenure/no tenure system, associate professors","11","2","9","0","0","0","0","0","0","0","0","0","0","0","0","0","0","0","10","2","8","1","0","1","0","0","0","0","0","0","-2"
"150668","Goshen College","2019","Not on tenure/no tenure system, assistant professors","8","4","4","0","0","0","0","0","0","0","0","0","0","0","0","0","0","0","6","2","4","0","0","0","1","1","0","1","1","0","-2"
"150774","Holy Cross College","2019","Tenured total","5","3","2","0","0","0","0","0","0","0","0","0","2","2","0","0","0","0","3","1","2","0","0","0","0","0","0","0","0","0","-2"
"150774","Holy Cross College","2019","Tenured, professors","2","1","1","0","0","0","0","0","0","0","0","0","0","0","0","0","0","0","2","1","1","0","0","0","0","0","0","0","0","0","-2"
"150774","Holy Cross College","2019","Tenured, associate professors","3","2","1","0","0","0","0","0","0","0","0","0","2","2","0","0","0","0","1","0","1","0","0","0","0","0","0","0","0","0","-2"
"150774","Holy Cross College","2019","On-Tenure track total","8","5","3","0","0","0","0","0","0","1","1","0","1","1","0","0","0","0","6","3","3","0","0","0","0","0","0","0","0","0","-2"
"150774","Holy Cross College","2019","On-tenure track, associate professors","3","2","1","0","0","0","0","0","0","1","1","0","0","0","0","0","0","0","2","1","1","0","0","0","0","0","0","0","0","0","-2"
"150774","Holy Cross College","2019","On-tenure track, assistant professors","5","3","2","0","0","0","0","0","0","0","0","0","1","1","0","0","0","0","4","2","2","0","0","0","0","0","0","0","0","0","-2"
"150774","Holy Cross College","2019","Not on tenure track/No tenure system system total","7","3","4","0","0","0","1","0","1","0","0","0","0","0","0","0","0","0","5","3","2","1","0","1","0","0","0","0","0","0","-2"
"150774","Holy Cross College","2019","Not on tenure/no tenure system, assistant professors","3","2","1","0","0","0","0","0","0","0","0","0","0","0","0","0","0","0","3","2","1","0","0","0","0","0","0","0","0","0","-2"
"150774","Holy Cross College","2019","Not on tenure/no tenure system, instructors","3","0","3","0","0","0","1","0","1","0","0","0","0","0","0","0","0","0","1","0","1","1","0","1","0","0","0","0","0","0","-2"
"150774","Holy Cross College","2019","Not on tenure/no tenure system, lecturers","1","1","0","0","0","0","0","0","0","0","0","0","0","0","0","0","0","0","1","1","0","0","0","0","0","0","0","0","0","0","-2"
"152637","Vincennes University","2019","Tenured total","46","19","27","1","0","1","1","1","0","1","1","0","0","0","0","0","0","0","42","17","25","0","0","0","0","0","0","1","0","1","-2"
"152637","Vincennes University","2019","Tenured, professors","25","7","18","1","0","1","1","1","0","0","0","0","0","0","0","0","0","0","23","6","17","0","0","0","0","0","0","0","0","0","-2"
"152637","Vincennes University","2019","Tenured, associate professors","20","11","9","0","0","0","0","0","0","1","1","0","0","0","0","0","0","0","18","10","8","0","0","0","0","0","0","1","0","1","-2"
"152637","Vincennes University","2019","Tenured, instructors","1","1","0","0","0","0","0","0","0","0","0","0","0","0","0","0","0","0","1","1","0","0","0","0","0","0","0","0","0","0","-2"
"152637","Vincennes University","2019","On-Tenure track total","13","8","5","0","0","0","0","0","0","0","0","0","0","0","0","0","0","0","13","8","5","0","0","0","0","0","0","0","0","0","-2"
"152637","Vincennes University","2019","On-tenure track, professors","1","1","0","0","0","0","0","0","0","0","0","0","0","0","0","0","0","0","1","1","0","0","0","0","0","0","0","0","0","0","-2"
"152637","Vincennes University","2019","On-tenure track, associate professors","6","4","2","0","0","0","0","0","0","0","0","0","0","0","0","0","0","0","6","4","2","0","0","0","0","0","0","0","0","0","-2"
"152637","Vincennes University","2019","On-tenure track, assistant professors","6","3","3","0","0","0","0","0","0","0","0","0","0","0","0","0","0","0","6","3","3","0","0","0","0","0","0","0","0","0","-2"
"152637","Vincennes University","2019","Not on tenure track/No tenure system system total","129","65","64","1","0","1","1","0","1","2","2","0","2","1","1","0","0","0","115","56","59","1","0","1","1","1","0","6","5","1","-2"
"152637","Vincennes University","2019","Not on tenure/no tenure system, professors","4","1","3","0","0","0","0","0","0","0","0","0","0","0","0","0","0","0","3","0","3","0","0","0","0","0","0","1","1","0","-2"
"152637","Vincennes University","2019","Not on tenure/no tenure system, associate professors","18","8","10","1","0","1","0","0","0","1","1","0","0","0","0","0","0","0","16","7","9","0","0","0","0","0","0","0","0","0","-2"
"152637","Vincennes University","2019","Not on tenure/no tenure system, assistant professors","72","26","46","0","0","0","0","0","0","1","1","0","0","0","0","0","0","0","64","20","44","1","0","1","1","1","0","5","4","1","-2"
"152637","Vincennes University","2019","Not on tenure/no tenure system, instructors","35","30","5","0","0","0","1","0","1","0","0","0","2","1","1","0","0","0","32","29","3","0","0","0","0","0","0","0","0","0","-2"
"152992","Briar Cliff University","2019","Tenured total","32","21","11","2","2","0","0","0","0","0","0","0","1","0","1","0","0","0","29","19","10","0","0","0","0","0","0","0","0","0","-2"
"152992","Briar Cliff University","2019","Tenured, professors","13","9","4","0","0","0","0","0","0","0","0","0","0","0","0","0","0","0","13","9","4","0","0","0","0","0","0","0","0","0","-2"
"152992","Briar Cliff University","2019","Tenured, associate professors","13","7","6","0","0","0","0","0","0","0","0","0","1","0","1","0","0","0","12","7","5","0","0","0","0","0","0","0","0","0","-2"
"152992","Briar Cliff University","2019","Tenured, assistant professors","6","5","1","2","2","0","0","0","0","0","0","0","0","0","0","0","0","0","4","3","1","0","0","0","0","0","0","0","0","0","-2"
"152992","Briar Cliff University","2019","On-Tenure track total","29","12","17","0","0","0","2","2","0","0","0","0","2","1","1","0","0","0","25","9","16","0","0","0","0","0","0","0","0","0","-2"
"152992","Briar Cliff University","2019","On-tenure track, professors","1","1","0","0","0","0","0","0","0","0","0","0","0","0","0","0","0","0","1","1","0","0","0","0","0","0","0","0","0","0","-2"
"152992","Briar Cliff University","2019","On-tenure track, associate professors","5","4","1","0","0","0","0","0","0","0","0","0","1","1","0","0","0","0","4","3","1","0","0","0","0","0","0","0","0","0","-2"
"152992","Briar Cliff University","2019","On-tenure track, assistant professors","23","7","16","0","0","0","2","2","0","0","0","0","1","0","1","0","0","0","20","5","15","0","0","0","0","0","0","0","0","0","-2"
"152992","Briar Cliff University","2019","Not on tenure track/No tenure system system total","5","0","5","0","0","0","0","0","0","0","0","0","0","0","0","0","0","0","5","0","5","0","0","0","0","0","0","0","0","0","-2"
"152992","Briar Cliff University","2019","Not on tenure/no tenure system, assistant professors","1","0","1","0","0","0","0","0","0","0","0","0","0","0","0","0","0","0","1","0","1","0","0","0","0","0","0","0","0","0","-2"
"152992","Briar Cliff University","2019","Not on tenure/no tenure system, instructors","3","0","3","0","0","0","0","0","0","0","0","0","0","0","0","0","0","0","3","0","3","0","0","0","0","0","0","0","0","0","-2"
"152992","Briar Cliff University","2019","Not on tenure/no tenure system, no academic rank","1","0","1","0","0","0","0","0","0","0","0","0","0","0","0","0","0","0","1","0","1","0","0","0","0","0","0","0","0","0","-2"
"154721","Bethany College","2019","Tenured total","17","13","4","0","0","0","0","0","0","0","0","0","0","0","0","0","0","0","15","11","4","0","0","0","2","2","0","0","0","0","-2"
"154721","Bethany College","2019","Tenured, professors","5","4","1","0","0","0","0","0","0","0","0","0","0","0","0","0","0","0","5","4","1","0","0","0","0","0","0","0","0","0","-2"
"154721","Bethany College","2019","Tenured, associate professors","9","6","3","0","0","0","0","0","0","0","0","0","0","0","0","0","0","0","8","5","3","0","0","0","1","1","0","0","0","0","-2"
"154721","Bethany College","2019","Tenured, assistant professors","3","3","0","0","0","0","0","0","0","0","0","0","0","0","0","0","0","0","2","2","0","0","0","0","1","1","0","0","0","0","-2"
"154721","Bethany College","2019","On-Tenure track total","25","13","12","0","0","0","1","1","0","0","0","0","0","0","0","0","0","0","24","12","12","0","0","0","0","0","0","0","0","0","-2"
"154721","Bethany College","2019","On-tenure track, professors","6","3","3","0","0","0","0","0","0","0","0","0","0","0","0","0","0","0","6","3","3","0","0","0","0","0","0","0","0","0","-2"
"154721","Bethany College","2019","On-tenure track, associate professors","3","2","1","0","0","0","0","0","0","0","0","0","0","0","0","0","0","0","3","2","1","0","0","0","0","0","0","0","0","0","-2"
"154721","Bethany College","2019","On-tenure track, assistant professors","16","8","8","0","0","0","1","1","0","0","0","0","0","0","0","0","0","0","15","7","8","0","0","0","0","0","0","0","0","0","-2"
"155414","Kansas Wesleyan University","2019","Tenured total","20","12","8","0","0","0","0","0","0","1","1","0","0","0","0","0","0","0","19","11","8","0","0","0","0","0","0","0","0","0","-2"
"155414","Kansas Wesleyan University","2019","Tenured, professors","7","5","2","0","0","0","0","0","0","0","0","0","0","0","0","0","0","0","7","5","2","0","0","0","0","0","0","0","0","0","-2"
"155414","Kansas Wesleyan University","2019","Tenured, associate professors","10","5","5","0","0","0","0","0","0","1","1","0","0","0","0","0","0","0","9","4","5","0","0","0","0","0","0","0","0","0","-2"
"155414","Kansas Wesleyan University","2019","Tenured, assistant professors","3","2","1","0","0","0","0","0","0","0","0","0","0","0","0","0","0","0","3","2","1","0","0","0","0","0","0","0","0","0","-2"
"155414","Kansas Wesleyan University","2019","On-Tenure track total","20","6","14","0","0","0","0","0","0","0","0","0","0","0","0","0","0","0","17","6","11","0","0","0","3","0","3","0","0","0","-2"
"155414","Kansas Wesleyan University","2019","On-tenure track, associate professors","1","0","1","0","0","0","0","0","0","0","0","0","0","0","0","0","0","0","1","0","1","0","0","0","0","0","0","0","0","0","-2"
"155414","Kansas Wesleyan University","2019","On-tenure track, assistant professors","19","6","13","0","0","0","0","0","0","0","0","0","0","0","0","0","0","0","16","6","10","0","0","0","3","0","3","0","0","0","-2"
"155414","Kansas Wesleyan University","2019","Not on tenure track/No tenure system system total","7","3","4","0","0","0","0","0","0","0","0","0","0","0","0","0","0","0","7","3","4","0","0","0","0","0","0","0","0","0","-2"
"155414","Kansas Wesleyan University","2019","Not on tenure/no tenure system, associate professors","1","1","0","0","0","0","0","0","0","0","0","0","0","0","0","0","0","0","1","1","0","0","0","0","0","0","0","0","0","0","-2"
"155414","Kansas Wesleyan University","2019","Not on tenure/no tenure system, assistant professors","2","0","2","0","0","0","0","0","0","0","0","0","0","0","0","0","0","0","2","0","2","0","0","0","0","0","0","0","0","0","-2"
"155414","Kansas Wesleyan University","2019","Not on tenure/no tenure system, instructors","1","0","1","0","0","0","0","0","0","0","0","0","0","0","0","0","0","0","1","0","1","0","0","0","0","0","0","0","0","0","-2"
"155414","Kansas Wesleyan University","2019","Not on tenure/no tenure system, lecturers","3","2","1","0","0","0","0","0","0","0","0","0","0","0","0","0","0","0","3","2","1","0","0","0","0","0","0","0","0","0","-2"
"155511","McPherson College","2019","Tenured total","24","17","7","1","0","1","0","0","0","0","0","0","1","0","1","0","0","0","22","17","5","0","0","0","0","0","0","0","0","0","-2"
"155511","McPherson College","2019","Tenured, professors","14","10","4","0","0","0","0","0","0","0","0","0","0","0","0","0","0","0","14","10","4","0","0","0","0","0","0","0","0","0","-2"
"155511","McPherson College","2019","Tenured, associate professors","10","7","3","1","0","1","0","0","0","0","0","0","1","0","1","0","0","0","8","7","1","0","0","0","0","0","0","0","0","0","-2"
"155511","McPherson College","2019","On-Tenure track total","17","7","10","0","0","0","0","0","0","0","0","0","1","1","0","0","0","0","15","5","10","0","0","0","0","0","0","1","1","0","-2"
"155511","McPherson College","2019","On-tenure track, associate professors","3","2","1","0","0","0","0","0","0","0","0","0","0","0","0","0","0","0","3","2","1","0","0","0","0","0","0","0","0","0","-2"
"155511","McPherson College","2019","On-tenure track, assistant professors","14","5","9","0","0","0","0","0","0","0","0","0","1","1","0","0","0","0","12","3","9","0","0","0","0","0","0","1","1","0","-2"
"155511","McPherson College","2019","Not on tenure track/No tenure system system total","4","2","2","0","0","0","0","0","0","0","0","0","0","0","0","0","0","0","4","2","2","0","0","0","0","0","0","0","0","0","-2"
"155511","McPherson College","2019","Not on tenure/no tenure system, assistant professors","4","2","2","0","0","0","0","0","0","0","0","0","0","0","0","0","0","0","4","2","2","0","0","0","0","0","0","0","0","0","-2"
"159656","Loyola University New Orleans","2019","Tenured total","130","83","47","0","0","0","5","3","2","9","5","4","10","6","4","0","0","0","102","66","36","3","2","1","1","1","0","0","0","0","-2"
"159656","Loyola University New Orleans","2019","Tenured, professors","68","42","26","0","0","0","1","0","1","5","3","2","6","3","3","0","0","0","55","36","19","1","0","1","0","0","0","0","0","0","-2"
"159656","Loyola University New Orleans","2019","Tenured, associate professors","60","41","19","0","0","0","4","3","1","4","2","2","4","3","1","0","0","0","45","30","15","2","2","0","1","1","0","0","0","0","-2"
"159656","Loyola University New Orleans","2019","Tenured, assistant professors","2","0","2","0","0","0","0","0","0","0","0","0","0","0","0","0","0","0","2","0","2","0","0","0","0","0","0","0","0","0","-2"
"159656","Loyola University New Orleans","2019","On-Tenure track total","27","11","16","0","0","0","2","1","1","1","0","1","0","0","0","0","0","0","23","9","14","0","0","0","0","0","0","1","1","0","-2"
"159656","Loyola University New Orleans","2019","On-tenure track, associate professors","2","1","1","0","0","0","0","0","0","0","0","0","0","0","0","0","0","0","2","1","1","0","0","0","0","0","0","0","0","0","-2"
"159656","Loyola University New Orleans","2019","On-tenure track, assistant professors","25","10","15","0","0","0","2","1","1","1","0","1","0","0","0","0","0","0","21","8","13","0","0","0","0","0","0","1","1","0","-2"
"159656","Loyola University New Orleans","2019","Not on tenure track/No tenure system system total","76","33","43","0","0","0","2","1","1","3","3","0","2","2","0","0","0","0","62","26","36","0","0","0","5","0","5","2","1","1","-2"
"159656","Loyola University New Orleans","2019","Not on tenure/no tenure system, lecturers","76","33","43","0","0","0","2","1","1","3","3","0","2","2","0","0","0","0","62","26","36","0","0","0","5","0","5","2","1","1","-2"
"162210","Washington Adventist University","2019","Not on tenure track/No tenure system system total","43","23","20","0","0","0","6","1","5","19","8","11","2","2","0","0","0","0","16","12","4","0","0","0","0","0","0","0","0","0","-2"
"162210","Washington Adventist University","2019","Not on tenure/no tenure system, professors","15","8","7","0","0","0","1","0","1","9","4","5","0","0","0","0","0","0","5","4","1","0","0","0","0","0","0","0","0","0","-2"
"162210","Washington Adventist University","2019","Not on tenure/no tenure system, associate professors","13","7","6","0","0","0","3","1","2","3","1","2","0","0","0","0","0","0","7","5","2","0","0","0","0","0","0","0","0","0","-2"
"162210","Washington Adventist University","2019","Not on tenure/no tenure system, assistant professors","15","8","7","0","0","0","2","0","2","7","3","4","2","2","0","0","0","0","4","3","1","0","0","0","0","0","0","0","0","0","-2"
"164447","American International College","2019","Tenured total","39","19","20","0","0","0","2","0","2","2","0","2","1","1","0","0","0","0","33","17","16","1","1","0","0","0","0","0","0","0","-2"
"164447","American International College","2019","Tenured, professors","13","4","9","0","0","0","0","0","0","0","0","0","0","0","0","0","0","0","13","4","9","0","0","0","0","0","0","0","0","0","-2"
"164447","American International College","2019","Tenured, associate professors","25","14","11","0","0","0","2","0","2","2","0","2","1","1","0","0","0","0","19","12","7","1","1","0","0","0","0","0","0","0","-2"
"164447","American International College","2019","Tenured, assistant professors","1","1","0","0","0","0","0","0","0","0","0","0","0","0","0","0","0","0","1","1","0","0","0","0","0","0","0","0","0","0","-2"
"164447","American International College","2019","On-Tenure track total","12","2","10","0","0","0","1","0","1","0","0","0","0","0","0","0","0","0","10","2","8","1","0","1","0","0","0","0","0","0","-2"
"164447","American International College","2019","On-tenure track, assistant professors","12","2","10","0","0","0","1","0","1","0","0","0","0","0","0","0","0","0","10","2","8","1","0","1","0","0","0","0","0","0","-2"
"164447","American International College","2019","Not on tenure track/No tenure system system total","14","4","10","0","0","0","0","0","0","2","0","2","0","0","0","0","0","0","11","4","7","1","0","1","0","0","0","0","0","0","-2"
"164447","American International College","2019","Not on tenure/no tenure system, assistant professors","9","2","7","0","0","0","0","0","0","2","0","2","0","0","0","0","0","0","6","2","4","1","0","1","0","0","0","0","0","0","-2"
"164447","American International College","2019","Not on tenure/no tenure system, instructors","5","2","3","0","0","0","0","0","0","0","0","0","0","0","0","0","0","0","5","2","3","0","0","0","0","0","0","0","0","0","-2"
"164632","Bay Path University","2019","Not on tenure track/No tenure system system total","72","13","59","0","0","0","2","2","0","4","1","3","1","0","1","0","0","0","64","10","54","1","0","1","0","0","0","0","0","0","-2"
"164632","Bay Path University","2019","Not on tenure/no tenure system, professors","12","3","9","0","0","0","0","0","0","0","0","0","0","0","0","0","0","0","12","3","9","0","0","0","0","0","0","0","0","0","-2"
"164632","Bay Path University","2019","Not on tenure/no tenure system, associate professors","13","4","9","0","0","0","1","1","0","0","0","0","0","0","0","0","0","0","12","3","9","0","0","0","0","0","0","0","0","0","-2"
"164632","Bay Path University","2019","Not on tenure/no tenure system, assistant professors","40","5","35","0","0","0","1","1","0","4","1","3","1","0","1","0","0","0","33","3","30","1","0","1","0","0","0","0","0","0","-2"
"164632","Bay Path University","2019","Not on tenure/no tenure system, instructors","4","1","3","0","0","0","0","0","0","0","0","0","0","0","0","0","0","0","4","1","3","0","0","0","0","0","0","0","0","0","-2"
"164632","Bay Path University","2019","Not on tenure/no tenure system, no academic rank","3","0","3","0","0","0","0","0","0","0","0","0","0","0","0","0","0","0","3","0","3","0","0","0","0","0","0","0","0","0","-2"
"164872","Boston Architectural College","2019","Not on tenure track/No tenure system system total","16","11","5","0","0","0","1","1","0","1","1","0","2","1","1","0","0","0","11","7","4","1","1","0","0","0","0","0","0","0","-2"
"164872","Boston Architectural College","2019","Not on tenure/no tenure system, no academic rank","16","11","5","0","0","0","1","1","0","1","1","0","2","1","1","0","0","0","11","7","4","1","1","0","0","0","0","0","0","0","-2"
"165644","Eastern Nazarene College","2019","Tenured total","9","9","0","0","0","0","0","0","0","0","0","0","0","0","0","0","0","0","7","7","0","1","1","0","0","0","0","1","1","0","-2"
"165644","Eastern Nazarene College","2019","Tenured, professors","6","6","0","0","0","0","0","0","0","0","0","0","0","0","0","0","0","0","4","4","0","1","1","0","0","0","0","1","1","0","-2"
"165644","Eastern Nazarene College","2019","Tenured, associate professors","3","3","0","0","0","0","0","0","0","0","0","0","0","0","0","0","0","0","3","3","0","0","0","0","0","0","0","0","0","0","-2"
"165644","Eastern Nazarene College","2019","On-Tenure track total","10","4","6","0","0","0","0","0","0","1","1","0","0","0","0","0","0","0","7","2","5","0","0","0","2","1","1","0","0","0","-2"
"165644","Eastern Nazarene College","2019","On-tenure track, assistant professors","10","4","6","0","0","0","0","0","0","1","1","0","0","0","0","0","0","0","7","2","5","0","0","0","2","1","1","0","0","0","-2"
"165644","Eastern Nazarene College","2019","Not on tenure track/No tenure system system total","13","8","5","0","0","0","2","0","2","0","0","0","0","0","0","0","0","0","10","7","3","0","0","0","1","1","0","0","0","0","-2"
"165644","Eastern Nazarene College","2019","Not on tenure/no tenure system, associate professors","2","1","1","0","0","0","0","0","0","0","0","0","0","0","0","0","0","0","2","1","1","0","0","0","0","0","0","0","0","0","-2"
"165644","Eastern Nazarene College","2019","Not on tenure/no tenure system, assistant professors","6","5","1","0","0","0","1","0","1","0","0","0","0","0","0","0","0","0","4","4","0","0","0","0","1","1","0","0","0","0","-2"
"165644","Eastern Nazarene College","2019","Not on tenure/no tenure system, instructors","5","2","3","0","0","0","1","0","1","0","0","0","0","0","0","0","0","0","4","2","2","0","0","0","0","0","0","0","0","0","-2"
"165866","Framingham State University","2019","Tenured total","121","53","68","0","0","0","7","4","3","3","2","1","3","2","1","0","0","0","107","45","62","1","0","1","0","0","0","0","0","0","-2"
"165866","Framingham State University","2019","Tenured, professors","60","24","36","0","0","0","5","4","1","1","1","0","1","0","1","0","0","0","53","19","34","0","0","0","0","0","0","0","0","0","-2"
"165866","Framingham State University","2019","Tenured, associate professors","58","28","30","0","0","0","2","0","2","2","1","1","2","2","0","0","0","0","51","25","26","1","0","1","0","0","0","0","0","0","-2"
"165866","Framingham State University","2019","Tenured, assistant professors","3","1","2","0","0","0","0","0","0","0","0","0","0","0","0","0","0","0","3","1","2","0","0","0","0","0","0","0","0","0","-2"
"165866","Framingham State University","2019","On-Tenure track total","57","23","34","0","0","0","5","1","4","4","1","3","5","1","4","0","0","0","37","16","21","1","1","0","0","0","0","5","3","2","-2"
"165866","Framingham State University","2019","On-tenure track, associate professors","6","2","4","0","0","0","2","0","2","1","0","1","0","0","0","0","0","0","3","2","1","0","0","0","0","0","0","0","0","0","-2"
"165866","Framingham State University","2019","On-tenure track, assistant professors","51","21","30","0","0","0","3","1","2","3","1","2","5","1","4","0","0","0","34","14","20","1","1","0","0","0","0","5","3","2","-2"
"165866","Framingham State University","2019","Not on tenure track/No tenure system system total","20","9","11","0","0","0","2","0","2","0","0","0","1","0","1","0","0","0","16","9","7","0","0","0","0","0","0","1","0","1","-2"
"165866","Framingham State University","2019","Not on tenure/no tenure system, assistant professors","11","6","5","0","0","0","2","0","2","0","0","0","1","0","1","0","0","0","7","6","1","0","0","0","0","0","0","1","0","1","-2"
"165866","Framingham State University","2019","Not on tenure/no tenure system, instructors","9","3","6","0","0","0","0","0","0","0","0","0","0","0","0","0","0","0","9","3","6","0","0","0","0","0","0","0","0","0","-2"
"166452","Lesley University","2019","Not on tenure track/No tenure system system total","149","51","98","0","0","0","13","3","10","9","4","5","6","2","4","0","0","0","118","40","78","2","2","0","1","0","1","0","0","0","-2"
"166452","Lesley University","2019","Not on tenure/no tenure system, professors","42","17","25","0","0","0","3","1","2","2","1","1","2","0","2","0","0","0","35","15","20","0","0","0","0","0","0","0","0","0","-2"
"166452","Lesley University","2019","Not on tenure/no tenure system, associate professors","55","20","35","0","0","0","5","1","4","2","1","1","2","1","1","0","0","0","45","16","29","1","1","0","0","0","0","0","0","0","-2"
"166452","Lesley University","2019","Not on tenure/no tenure system, assistant professors","43","11","32","0","0","0","5","1","4","4","2","2","1","0","1","0","0","0","31","7","24","1","1","0","1","0","1","0","0","0","-2"
"166452","Lesley University","2019","Not on tenure/no tenure system, instructors","9","3","6","0","0","0","0","0","0","1","0","1","1","1","0","0","0","0","7","2","5","0","0","0","0","0","0","0","0","0","-2"
"166638","University of Massachusetts-Boston","2019","Tenured total","349","189","160","0","0","0","64","42","22","26","11","15","10","0","10","12","12","0","235","123","112","1","1","0","0","0","0","1","0","1","-2"
"166638","University of Massachusetts-Boston","2019","Tenured, professors","124","77","47","0","0","0","19","12","7","9","6","3","2","0","2","3","3","0","91","56","35","0","0","0","0","0","0","0","0","0","-2"
"166638","University of Massachusetts-Boston","2019","Tenured, associate professors","224","112","112","0","0","0","45","30","15","17","5","12","7","0","7","9","9","0","144","67","77","1","1","0","0","0","0","1","0","1","-2"
"166638","University of Massachusetts-Boston","2019","Tenured, assistant professors","1","0","1","0","0","0","0","0","0","0","0","0","1","0","1","0","0","0","0","0","0","0","0","0","0","0","0","0","0","0","-2"
"166638","University of Massachusetts-Boston","2019","On-Tenure track total","125","57","68","1","0","1","22","7","15","11","3","8","9","4","5","0","0","0","60","30","30","1","1","0","0","0","0","21","12","9","-2"
"166638","University of Massachusetts-Boston","2019","On-tenure track, associate professors","3","1","2","0","0","0","1","0","1","0","0","0","0","0","0","0","0","0","1","0","1","0","0","0","0","0","0","1","1","0","-2"
"166638","University of Massachusetts-Boston","2019","On-tenure track, assistant professors","122","56","66","1","0","1","21","7","14","11","3","8","9","4","5","0","0","0","59","30","29","1","1","0","0","0","0","20","11","9","-2"
"166638","University of Massachusetts-Boston","2019","Not on tenure track/No tenure system system total","215","100","115","0","0","0","16","8","8","11","8","3","10","4","6","0","0","0","173","77","96","0","0","0","1","0","1","4","3","1","-2"
"166638","University of Massachusetts-Boston","2019","Not on tenure/no tenure system, assistant professors","1","1","0","0","0","0","0","0","0","0","0","0","0","0","0","0","0","0","1","1","0","0","0","0","0","0","0","0","0","0","-2"
"166638","University of Massachusetts-Boston","2019","Not on tenure/no tenure system, lecturers","199","93","106","0","0","0","16","8","8","10","7","3","10","4","6","0","0","0","160","72","88","0","0","0","1","0","1","2","2","0","-2"
"166638","University of Massachusetts-Boston","2019","Not on tenure/no tenure system, no academic rank","15","6","9","0","0","0","0","0","0","1","1","0","0","0","0","0","0","0","12","4","8","0","0","0","0","0","0","2","1","1","-2"
"167455","Pine Manor College","2019","Tenured total","7","1","6","0","0","0","1","0","1","0","0","0","0","0","0","0","0","0","6","1","5","0","0","0","0","0","0","0","0","0","-2"
"167455","Pine Manor College","2019","Tenured, professors","5","1","4","0","0","0","1","0","1","0","0","0","0","0","0","0","0","0","4","1","3","0","0","0","0","0","0","0","0","0","-2"
"167455","Pine Manor College","2019","Tenured, associate professors","2","0","2","0","0","0","0","0","0","0","0","0","0","0","0","0","0","0","2","0","2","0","0","0","0","0","0","0","0","0","-2"
"167455","Pine Manor College","2019","On-Tenure track total","10","3","7","0","0","0","0","0","0","0","0","0","1","1","0","0","0","0","8","2","6","1","0","1","0","0","0","0","0","0","-2"
"167455","Pine Manor College","2019","On-tenure track, assistant professors","10","3","7","0","0","0","0","0","0","0","0","0","1","1","0","0","0","0","8","2","6","1","0","1","0","0","0","0","0","0","-2"
"167455","Pine Manor College","2019","Not on tenure track/No tenure system system total","4","0","4","0","0","0","0","0","0","0","0","0","0","0","0","0","0","0","4","0","4","0","0","0","0","0","0","0","0","0","-2"
"167455","Pine Manor College","2019","Not on tenure/no tenure system, associate professors","1","0","1","0","0","0","0","0","0","0","0","0","0","0","0","0","0","0","1","0","1","0","0","0","0","0","0","0","0","0","-2"
"167455","Pine Manor College","2019","Not on tenure/no tenure system, assistant professors","3","0","3","0","0","0","0","0","0","0","0","0","0","0","0","0","0","0","3","0","3","0","0","0","0","0","0","0","0","0","-2"
"167729","Salem State University","2019","Tenured total","232","110","122","0","0","0","25","11","14","10","6","4","10","5","5","0","0","0","183","85","98","0","0","0","4","3","1","0","0","0","-2"
"167729","Salem State University","2019","Tenured, professors","144","72","72","0","0","0","10","5","5","4","2","2","4","3","1","0","0","0","126","62","64","0","0","0","0","0","0","0","0","0","-2"
"167729","Salem State University","2019","Tenured, associate professors","87","37","50","0","0","0","14","5","9","6","4","2","6","2","4","0","0","0","57","23","34","0","0","0","4","3","1","0","0","0","-2"
"167729","Salem State University","2019","Tenured, assistant professors","1","1","0","0","0","0","1","1","0","0","0","0","0","0","0","0","0","0","0","0","0","0","0","0","0","0","0","0","0","0","-2"
"167729","Salem State University","2019","On-Tenure track total","67","30","37","0","0","0","13","2","11","8","6","2","3","2","1","0","0","0","38","18","20","0","0","0","1","0","1","4","2","2","-2"
"167729","Salem State University","2019","On-tenure track, associate professors","6","3","3","0","0","0","2","1","1","1","1","0","0","0","0","0","0","0","3","1","2","0","0","0","0","0","0","0","0","0","-2"
"167729","Salem State University","2019","On-tenure track, assistant professors","57","25","32","0","0","0","11","1","10","7","5","2","3","2","1","0","0","0","31","15","16","0","0","0","1","0","1","4","2","2","-2"
"167729","Salem State University","2019","On-tenure track, instructors","4","2","2","0","0","0","0","0","0","0","0","0","0","0","0","0","0","0","4","2","2","0","0","0","0","0","0","0","0","0","-2"
"167729","Salem State University","2019","Not on tenure track/No tenure system system total","19","8","11","0","0","0","0","0","0","2","2","0","2","0","2","0","0","0","12","5","7","0","0","0","3","1","2","0","0","0","-2"
"167729","Salem State University","2019","Not on tenure/no tenure system, professors","2","2","0","0","0","0","0","0","0","0","0","0","0","0","0","0","0","0","1","1","0","0","0","0","1","1","0","0","0","0","-2"
"167729","Salem State University","2019","Not on tenure/no tenure system, associate professors","1","0","1","0","0","0","0","0","0","0","0","0","1","0","1","0","0","0","0","0","0","0","0","0","0","0","0","0","0","0","-2"
"167729","Salem State University","2019","Not on tenure/no tenure system, assistant professors","10","4","6","0","0","0","0","0","0","2","2","0","1","0","1","0","0","0","5","2","3","0","0","0","2","0","2","0","0","0","-2"
"167729","Salem State University","2019","Not on tenure/no tenure system, instructors","6","2","4","0","0","0","0","0","0","0","0","0","0","0","0","0","0","0","6","2","4","0","0","0","0","0","0","0","0","0","-2"
"168740","Andrews University","2019","Tenured total","67","45","22","0","0","0","7","4","3","5","5","0","5","4","1","0","0","0","47","30","17","2","2","0","0","0","0","1","0","1","-2"
"168740","Andrews University","2019","Tenured, professors","45","32","13","0","0","0","6","4","2","1","1","0","3","2","1","0","0","0","35","25","10","0","0","0","0","0","0","0","0","0","-2"
"168740","Andrews University","2019","Tenured, associate professors","16","8","8","0","0","0","1","0","1","3","3","0","1","1","0","0","0","0","9","3","6","1","1","0","0","0","0","1","0","1","-2"
"168740","Andrews University","2019","Tenured, assistant professors","6","5","1","0","0","0","0","0","0","1","1","0","1","1","0","0","0","0","3","2","1","1","1","0","0","0","0","0","0","0","-2"
"168740","Andrews University","2019","On-Tenure track total","130","75","55","0","0","0","7","2","5","21","10","11","11","7","4","0","0","0","82","52","30","1","1","0","7","3","4","1","0","1","-2"
"168740","Andrews University","2019","On-tenure track, professors","26","22","4","0","0","0","4","2","2","3","2","1","1","1","0","0","0","0","16","15","1","1","1","0","1","1","0","0","0","0","-2"
"168740","Andrews University","2019","On-tenure track, associate professors","44","19","25","0","0","0","1","0","1","9","3","6","4","3","1","0","0","0","27","13","14","0","0","0","3","0","3","0","0","0","-2"
"168740","Andrews University","2019","On-tenure track, assistant professors","60","34","26","0","0","0","2","0","2","9","5","4","6","3","3","0","0","0","39","24","15","0","0","0","3","2","1","1","0","1","-2"
"168740","Andrews University","2019","Not on tenure track/No tenure system system total","21","8","13","0","0","0","2","1","1","4","1","3","1","1","0","0","0","0","12","4","8","0","0","0","2","1","1","0","0","0","-2"
"168740","Andrews University","2019","Not on tenure/no tenure system, professors","2","0","2","0","0","0","0","0","0","0","0","0","0","0","0","0","0","0","1","0","1","0","0","0","1","0","1","0","0","0","-2"
"168740","Andrews University","2019","Not on tenure/no tenure system, associate professors","6","4","2","0","0","0","0","0","0","2","1","1","1","1","0","0","0","0","3","2","1","0","0","0","0","0","0","0","0","0","-2"
"168740","Andrews University","2019","Not on tenure/no tenure system, assistant professors","10","2","8","0","0","0","1","0","1","2","0","2","0","0","0","0","0","0","7","2","5","0","0","0","0","0","0","0","0","0","-2"
"168740","Andrews University","2019","Not on tenure/no tenure system, instructors","3","2","1","0","0","0","1","1","0","0","0","0","0","0","0","0","0","0","1","0","1","0","0","0","1","1","0","0","0","0","-2"
"170532","Kalamazoo College","2019","Tenured total","63","30","33","0","0","0","4","0","4","4","2","2","3","0","3","0","0","0","48","26","22","2","1","1","2","1","1","0","0","0","-2"
"170532","Kalamazoo College","2019","Tenured, professors","36","20","16","0","0","0","1","0","1","1","1","0","2","0","2","0","0","0","32","19","13","0","0","0","0","0","0","0","0","0","-2"
"170532","Kalamazoo College","2019","Tenured, associate professors","27","10","17","0","0","0","3","0","3","3","1","2","1","0","1","0","0","0","16","7","9","2","1","1","2","1","1","0","0","0","-2"
"170532","Kalamazoo College","2019","On-Tenure track total","22","13","9","0","0","0","2","1","1","1","1","0","6","2","4","0","0","0","10","6","4","0","0","0","1","1","0","2","2","0","-2"
"170532","Kalamazoo College","2019","On-tenure track, associate professors","1","1","0","0","0","0","0","0","0","0","0","0","0","0","0","0","0","0","1","1","0","0","0","0","0","0","0","0","0","0","-2"
"170532","Kalamazoo College","2019","On-tenure track, assistant professors","21","12","9","0","0","0","2","1","1","1","1","0","6","2","4","0","0","0","9","5","4","0","0","0","1","1","0","2","2","0","-2"
"170532","Kalamazoo College","2019","Not on tenure track/No tenure system system total","30","13","17","0","0","0","1","0","1","0","0","0","7","5","2","0","0","0","17","6","11","0","0","0","4","2","2","1","0","1","-2"
"170532","Kalamazoo College","2019","Not on tenure/no tenure system, assistant professors","3","1","2","0","0","0","0","0","0","0","0","0","2","1","1","0","0","0","1","0","1","0","0","0","0","0","0","0","0","0","-2"
"170532","Kalamazoo College","2019","Not on tenure/no tenure system, instructors","27","12","15","0","0","0","1","0","1","0","0","0","5","4","1","0","0","0","16","6","10","0","0","0","4","2","2","1","0","1","-2"
"172033","Sacred Heart Major Seminary","2019","Not on tenure track/No tenure system system total","15","13","2","0","0","0","0","0","0","0","0","0","2","2","0","0","0","0","13","11","2","0","0","0","0","0","0","0","0","0","-2"
"172033","Sacred Heart Major Seminary","2019","Not on tenure/no tenure system, professors","10","8","2","0","0","0","0","0","0","0","0","0","1","1","0","0","0","0","9","7","2","0","0","0","0","0","0","0","0","0","-2"
"172033","Sacred Heart Major Seminary","2019","Not on tenure/no tenure system, associate professors","2","2","0","0","0","0","0","0","0","0","0","0","1","1","0","0","0","0","1","1","0","0","0","0","0","0","0","0","0","0","-2"
"172033","Sacred Heart Major Seminary","2019","Not on tenure/no tenure system, assistant professors","2","2","0","0","0","0","0","0","0","0","0","0","0","0","0","0","0","0","2","2","0","0","0","0","0","0","0","0","0","0","-2"
"172033","Sacred Heart Major Seminary","2019","Not on tenure/no tenure system, instructors","1","1","0","0","0","0","0","0","0","0","0","0","0","0","0","0","0","0","1","1","0","0","0","0","0","0","0","0","0","0","-2"
"178721","Park University","2019","Tenured total","48","31","17","0","0","0","4","1","3","2","2","0","1","0","1","0","0","0","41","28","13","0","0","0","0","0","0","0","0","0","-2"
"178721","Park University","2019","Tenured, professors","20","14","6","0","0","0","2","0","2","1","1","0","1","0","1","0","0","0","16","13","3","0","0","0","0","0","0","0","0","0","-2"
"178721","Park University","2019","Tenured, associate professors","28","17","11","0","0","0","2","1","1","1","1","0","0","0","0","0","0","0","25","15","10","0","0","0","0","0","0","0","0","0","-2"
"178721","Park University","2019","On-Tenure track total","35","14","21","1","0","1","3","3","0","2","0","2","0","0","0","0","0","0","28","10","18","1","1","0","0","0","0","0","0","0","-2"
"178721","Park University","2019","On-tenure track, associate professors","6","1","5","1","0","1","0","0","0","0","0","0","0","0","0","0","0","0","5","1","4","0","0","0","0","0","0","0","0","0","-2"
"178721","Park University","2019","On-tenure track, assistant professors","29","13","16","0","0","0","3","3","0","2","0","2","0","0","0","0","0","0","23","9","14","1","1","0","0","0","0","0","0","0","-2"
"178721","Park University","2019","Not on tenure track/No tenure system system total","35","13","22","1","0","1","0","0","0","1","1","0","0","0","0","0","0","0","31","11","20","2","1","1","0","0","0","0","0","0","-2"
"178721","Park University","2019","Not on tenure/no tenure system, associate professors","2","1","1","0","0","0","0","0","0","0","0","0","0","0","0","0","0","0","2","1","1","0","0","0","0","0","0","0","0","0","-2"
"178721","Park University","2019","Not on tenure/no tenure system, assistant professors","14","4","10","0","0","0","0","0","0","0","0","0","0","0","0","0","0","0","12","3","9","2","1","1","0","0","0","0","0","0","-2"
"178721","Park University","2019","Not on tenure/no tenure system, instructors","4","2","2","0","0","0","0","0","0","0","0","0","0","0","0","0","0","0","4","2","2","0","0","0","0","0","0","0","0","0","-2"
"178721","Park University","2019","Not on tenure/no tenure system, lecturers","15","6","9","1","0","1","0","0","0","1","1","0","0","0","0","0","0","0","13","5","8","0","0","0","0","0","0","0","0","0","-2"
"181738","Union College","2019","Tenured total","13","7","6","0","0","0","0","0","0","1","0","1","0","0","0","0","0","0","12","7","5","0","0","0","0","0","0","0","0","0","-2"
"181738","Union College","2019","Tenured, professors","11","6","5","0","0","0","0","0","0","1","0","1","0","0","0","0","0","0","10","6","4","0","0","0","0","0","0","0","0","0","-2"
"181738","Union College","2019","Tenured, associate professors","2","1","1","0","0","0","0","0","0","0","0","0","0","0","0","0","0","0","2","1","1","0","0","0","0","0","0","0","0","0","-2"
"181738","Union College","2019","On-Tenure track total","46","21","25","0","0","0","1","1","0","4","2","2","1","1","0","0","0","0","40","17","23","0","0","0","0","0","0","0","0","0","-2"
"181738","Union College","2019","On-tenure track, professors","6","4","2","0","0","0","0","0","0","1","1","0","0","0","0","0","0","0","5","3","2","0","0","0","0","0","0","0","0","0","-2"
"181738","Union College","2019","On-tenure track, associate professors","12","3","9","0","0","0","1","1","0","1","0","1","1","1","0","0","0","0","9","1","8","0","0","0","0","0","0","0","0","0","-2"
"181738","Union College","2019","On-tenure track, assistant professors","27","14","13","0","0","0","0","0","0","2","1","1","0","0","0","0","0","0","25","13","12","0","0","0","0","0","0","0","0","0","-2"
"181738","Union College","2019","On-tenure track, instructors","1","0","1","0","0","0","0","0","0","0","0","0","0","0","0","0","0","0","1","0","1","0","0","0","0","0","0","0","0","0","-2"
"181738","Union College","2019","Not on tenure track/No tenure system system total","2","1","1","0","0","0","0","0","0","0","0","0","0","0","0","0","0","0","2","1","1","0","0","0","0","0","0","0","0","0","-2"
"181738","Union College","2019","Not on tenure/no tenure system, lecturers","2","1","1","0","0","0","0","0","0","0","0","0","0","0","0","0","0","0","2","1","1","0","0","0","0","0","0","0","0","0","-2"
"181853","York College","2019","Tenured total","12","9","3","0","0","0","0","0","0","1","1","0","1","1","0","0","0","0","10","7","3","0","0","0","0","0","0","0","0","0","-2"
"181853","York College","2019","Tenured, professors","5","5","0","0","0","0","0","0","0","0","0","0","0","0","0","0","0","0","5","5","0","0","0","0","0","0","0","0","0","0","-2"
"181853","York College","2019","Tenured, associate professors","7","4","3","0","0","0","0","0","0","1","1","0","1","1","0","0","0","0","5","2","3","0","0","0","0","0","0","0","0","0","-2"
"181853","York College","2019","On-Tenure track total","3","3","0","0","0","0","0","0","0","0","0","0","0","0","0","0","0","0","3","3","0","0","0","0","0","0","0","0","0","0","-2"
"181853","York College","2019","On-tenure track, associate professors","3","3","0","0","0","0","0","0","0","0","0","0","0","0","0","0","0","0","3","3","0","0","0","0","0","0","0","0","0","0","-2"
"181853","York College","2019","Not on tenure track/No tenure system system total","12","5","7","0","0","0","0","0","0","0","0","0","0","0","0","0","0","0","12","5","7","0","0","0","0","0","0","0","0","0","-2"
"181853","York College","2019","Not on tenure/no tenure system, professors","1","1","0","0","0","0","0","0","0","0","0","0","0","0","0","0","0","0","1","1","0","0","0","0","0","0","0","0","0","0","-2"
"181853","York College","2019","Not on tenure/no tenure system, associate professors","2","1","1","0","0","0","0","0","0","0","0","0","0","0","0","0","0","0","2","1","1","0","0","0","0","0","0","0","0","0","-2"
"181853","York College","2019","Not on tenure/no tenure system, assistant professors","9","3","6","0","0","0","0","0","0","0","0","0","0","0","0","0","0","0","9","3","6","0","0","0","0","0","0","0","0","0","-2"
"182306","Great Basin College","2019","Tenured total","32","16","16","0","0","0","3","2","1","1","0","1","5","2","3","0","0","0","23","12","11","0","0","0","0","0","0","0","0","0","-2"
"182306","Great Basin College","2019","Tenured, professors","32","16","16","0","0","0","3","2","1","1","0","1","5","2","3","0","0","0","23","12","11","0","0","0","0","0","0","0","0","0","-2"
"182306","Great Basin College","2019","On-Tenure track total","23","15","8","0","0","0","0","0","0","0","0","0","1","1","0","0","0","0","20","13","7","1","0","1","0","0","0","1","1","0","-2"
"182306","Great Basin College","2019","On-tenure track, instructors","23","15","8","0","0","0","0","0","0","0","0","0","1","1","0","0","0","0","20","13","7","1","0","1","0","0","0","1","1","0","-2"
"182306","Great Basin College","2019","Not on tenure track/No tenure system system total","16","12","4","0","0","0","1","1","0","1","0","1","1","1","0","0","0","0","13","10","3","0","0","0","0","0","0","0","0","0","-2"
"182306","Great Basin College","2019","Not on tenure/no tenure system, instructors","12","10","2","0","0","0","1","1","0","0","0","0","1","1","0","0","0","0","10","8","2","0","0","0","0","0","0","0","0","0","-2"
"182306","Great Basin College","2019","Not on tenure/no tenure system, no academic rank","4","2","2","0","0","0","0","0","0","1","0","1","0","0","0","0","0","0","3","2","1","0","0","0","0","0","0","0","0","0","-2"
"182564","Western Nevada College","2019","Tenured total","28","14","14","0","0","0","0","0","0","0","0","0","0","0","0","0","0","0","28","14","14","0","0","0","0","0","0","0","0","0","-2"
"182564","Western Nevada College","2019","Tenured, professors","28","14","14","0","0","0","0","0","0","0","0","0","0","0","0","0","0","0","28","14","14","0","0","0","0","0","0","0","0","0","-2"
"182564","Western Nevada College","2019","On-Tenure track total","17","10","7","0","0","0","1","0","1","0","0","0","1","1","0","1","1","0","14","8","6","0","0","0","0","0","0","0","0","0","-2"
"182564","Western Nevada College","2019","On-tenure track, instructors","17","10","7","0","0","0","1","0","1","0","0","0","1","1","0","1","1","0","14","8","6","0","0","0","0","0","0","0","0","0","-2"
"182564","Western Nevada College","2019","Not on tenure track/No tenure system system total","8","3","5","0","0","0","1","0","1","0","0","0","1","1","0","0","0","0","5","1","4","0","0","0","1","1","0","0","0","0","-2"
"182564","Western Nevada College","2019","Not on tenure/no tenure system, instructors","7","2","5","0","0","0","1","0","1","0","0","0","0","0","0","0","0","0","5","1","4","0","0","0","1","1","0","0","0","0","-2"
"182564","Western Nevada College","2019","Not on tenure/no tenure system, no academic rank","1","1","0","0","0","0","0","0","0","0","0","0","1","1","0","0","0","0","0","0","0","0","0","0","0","0","0","0","0","0","-2"
"183974","Centenary University","2019","Tenured total","16","8","8","0","0","0","2","0","2","0","0","0","0","0","0","0","0","0","14","8","6","0","0","0","0","0","0","0","0","0","-2"
"183974","Centenary University","2019","Tenured, professors","7","3","4","0","0","0","1","0","1","0","0","0","0","0","0","0","0","0","6","3","3","0","0","0","0","0","0","0","0","0","-2"
"183974","Centenary University","2019","Tenured, associate professors","9","5","4","0","0","0","1","0","1","0","0","0","0","0","0","0","0","0","8","5","3","0","0","0","0","0","0","0","0","0","-2"
"183974","Centenary University","2019","On-Tenure track total","8","2","6","0","0","0","0","0","0","0","0","0","0","0","0","0","0","0","8","2","6","0","0","0","0","0","0","0","0","0","-2"
"183974","Centenary University","2019","On-tenure track, associate professors","1","0","1","0","0","0","0","0","0","0","0","0","0","0","0","0","0","0","1","0","1","0","0","0","0","0","0","0","0","0","-2"
"183974","Centenary University","2019","On-tenure track, assistant professors","6","2","4","0","0","0","0","0","0","0","0","0","0","0","0","0","0","0","6","2","4","0","0","0","0","0","0","0","0","0","-2"
"183974","Centenary University","2019","On-tenure track, instructors","1","0","1","0","0","0","0","0","0","0","0","0","0","0","0","0","0","0","1","0","1","0","0","0","0","0","0","0","0","0","-2"
"183974","Centenary University","2019","Not on tenure track/No tenure system system total","53","27","26","0","0","0","1","1","0","1","0","1","1","1","0","0","0","0","50","25","25","0","0","0","0","0","0","0","0","0","-2"
"183974","Centenary University","2019","Not on tenure/no tenure system, professors","7","2","5","0","0","0","0","0","0","0","0","0","0","0","0","0","0","0","7","2","5","0","0","0","0","0","0","0","0","0","-2"
"183974","Centenary University","2019","Not on tenure/no tenure system, associate professors","13","7","6","0","0","0","1","1","0","1","0","1","0","0","0","0","0","0","11","6","5","0","0","0","0","0","0","0","0","0","-2"
"183974","Centenary University","2019","Not on tenure/no tenure system, assistant professors","28","15","13","0","0","0","0","0","0","0","0","0","0","0","0","0","0","0","28","15","13","0","0","0","0","0","0","0","0","0","-2"
"183974","Centenary University","2019","Not on tenure/no tenure system, instructors","5","3","2","0","0","0","0","0","0","0","0","0","1","1","0","0","0","0","4","2","2","0","0","0","0","0","0","0","0","0","-2"
"184348","Drew University","2019","Tenured total","94","52","42","1","1","0","7","2","5","7","5","2","6","4","2","0","0","0","67","35","32","0","0","0","0","0","0","6","5","1","-2"
"184348","Drew University","2019","Tenured, professors","45","26","19","0","0","0","2","1","1","2","1","1","2","1","1","0","0","0","38","22","16","0","0","0","0","0","0","1","1","0","-2"
"184348","Drew University","2019","Tenured, associate professors","49","26","23","1","1","0","5","1","4","5","4","1","4","3","1","0","0","0","29","13","16","0","0","0","0","0","0","5","4","1","-2"
"184348","Drew University","2019","On-Tenure track total","16","9","7","0","0","0","2","0","2","3","1","2","0","0","0","0","0","0","9","6","3","0","0","0","0","0","0","2","2","0","-2"
"184348","Drew University","2019","On-tenure track, assistant professors","16","9","7","0","0","0","2","0","2","3","1","2","0","0","0","0","0","0","9","6","3","0","0","0","0","0","0","2","2","0","-2"
"184348","Drew University","2019","Not on tenure track/No tenure system system total","29","12","17","0","0","0","1","0","1","3","1","2","2","1","1","0","0","0","20","9","11","0","0","0","1","0","1","2","1","1","-2"
"184348","Drew University","2019","Not on tenure/no tenure system, associate professors","2","1","1","0","0","0","0","0","0","1","1","0","0","0","0","0","0","0","1","0","1","0","0","0","0","0","0","0","0","0","-2"
"184348","Drew University","2019","Not on tenure/no tenure system, assistant professors","26","11","15","0","0","0","1","0","1","2","0","2","2","1","1","0","0","0","18","9","9","0","0","0","1","0","1","2","1","1","-2"
"184348","Drew University","2019","Not on tenure/no tenure system, instructors","1","0","1","0","0","0","0","0","0","0","0","0","0","0","0","0","0","0","1","0","1","0","0","0","0","0","0","0","0","0","-2"
"184694","Fairleigh Dickinson University-Florham Campus","2019","Tenured total","78","47","31","0","0","0","10","7","3","1","1","0","0","0","0","0","0","0","65","38","27","2","1","1","0","0","0","0","0","0","-2"
"184694","Fairleigh Dickinson University-Florham Campus","2019","Tenured, professors","41","27","14","0","0","0","7","5","2","0","0","0","0","0","0","0","0","0","33","22","11","1","0","1","0","0","0","0","0","0","-2"
"184694","Fairleigh Dickinson University-Florham Campus","2019","Tenured, associate professors","34","17","17","0","0","0","2","1","1","1","1","0","0","0","0","0","0","0","30","14","16","1","1","0","0","0","0","0","0","0","-2"
"184694","Fairleigh Dickinson University-Florham Campus","2019","Tenured, assistant professors","3","3","0","0","0","0","1","1","0","0","0","0","0","0","0","0","0","0","2","2","0","0","0","0","0","0","0","0","0","0","-2"
"184694","Fairleigh Dickinson University-Florham Campus","2019","On-Tenure track total","47","18","29","0","0","0","9","1","8","2","0","2","3","1","2","0","0","0","27","13","14","1","0","1","5","3","2","0","0","0","-2"
"184694","Fairleigh Dickinson University-Florham Campus","2019","On-tenure track, associate professors","6","1","5","0","0","0","2","0","2","0","0","0","0","0","0","0","0","0","4","1","3","0","0","0","0","0","0","0","0","0","-2"
"184694","Fairleigh Dickinson University-Florham Campus","2019","On-tenure track, assistant professors","41","17","24","0","0","0","7","1","6","2","0","2","3","1","2","0","0","0","23","12","11","1","0","1","5","3","2","0","0","0","-2"
"184694","Fairleigh Dickinson University-Florham Campus","2019","Not on tenure track/No tenure system system total","33","11","22","0","0","0","3","0","3","2","1","1","0","0","0","0","0","0","26","10","16","1","0","1","1","0","1","0","0","0","-2"
"184694","Fairleigh Dickinson University-Florham Campus","2019","Not on tenure/no tenure system, associate professors","2","0","2","0","0","0","0","0","0","0","0","0","0","0","0","0","0","0","2","0","2","0","0","0","0","0","0","0","0","0","-2"
"184694","Fairleigh Dickinson University-Florham Campus","2019","Not on tenure/no tenure system, assistant professors","11","3","8","0","0","0","2","0","2","0","0","0","0","0","0","0","0","0","9","3","6","0","0","0","0","0","0","0","0","0","-2"
"184694","Fairleigh Dickinson University-Florham Campus","2019","Not on tenure/no tenure system, lecturers","20","8","12","0","0","0","1","0","1","2","1","1","0","0","0","0","0","0","15","7","8","1","0","1","1","0","1","0","0","0","-2"
"185828","New Jersey Institute of Technology","2019","Tenured total","223","187","36","0","0","0","63","52","11","10","6","4","5","5","0","0","0","0","132","112","20","12","12","0","0","0","0","1","0","1","-2"
"185828","New Jersey Institute of Technology","2019","Tenured, professors","139","121","18","0","0","0","37","33","4","7","4","3","2","2","0","0","0","0","81","70","11","12","12","0","0","0","0","0","0","0","-2"
"185828","New Jersey Institute of Technology","2019","Tenured, associate professors","84","66","18","0","0","0","26","19","7","3","2","1","3","3","0","0","0","0","51","42","9","0","0","0","0","0","0","1","0","1","-2"
"185828","New Jersey Institute of Technology","2019","On-Tenure track total","95","63","32","0","0","0","28","21","7","0","0","0","2","1","1","0","0","0","36","20","16","0","0","0","0","0","0","29","21","8","-2"
"185828","New Jersey Institute of Technology","2019","On-tenure track, professors","1","1","0","0","0","0","0","0","0","0","0","0","0","0","0","0","0","0","1","1","0","0","0","0","0","0","0","0","0","0","-2"
"185828","New Jersey Institute of Technology","2019","On-tenure track, associate professors","11","8","3","0","0","0","6","5","1","0","0","0","0","0","0","0","0","0","3","1","2","0","0","0","0","0","0","2","2","0","-2"
"185828","New Jersey Institute of Technology","2019","On-tenure track, assistant professors","83","54","29","0","0","0","22","16","6","0","0","0","2","1","1","0","0","0","32","18","14","0","0","0","0","0","0","27","19","8","-2"
"185828","New Jersey Institute of Technology","2019","Not on tenure track/No tenure system system total","121","83","38","0","0","0","11","7","4","5","4","1","8","8","0","0","0","0","91","58","33","1","1","0","0","0","0","5","5","0","-2"
"185828","New Jersey Institute of Technology","2019","Not on tenure/no tenure system, lecturers","121","83","38","0","0","0","11","7","4","5","4","1","8","8","0","0","0","0","91","58","33","1","1","0","0","0","0","5","5","0","-2"
"186201","Ramapo College of New Jersey","2019","Tenured total","174","83","91","0","0","0","23","14","9","11","5","6","15","3","12","0","0","0","120","60","60","3","1","2","0","0","0","2","0","2","-2"
"186201","Ramapo College of New Jersey","2019","Tenured, professors","73","39","34","0","0","0","9","5","4","4","2","2","5","1","4","0","0","0","53","30","23","2","1","1","0","0","0","0","0","0","-2"
"186201","Ramapo College of New Jersey","2019","Tenured, associate professors","92","38","54","0","0","0","12","7","5","5","1","4","10","2","8","0","0","0","62","28","34","1","0","1","0","0","0","2","0","2","-2"
"186201","Ramapo College of New Jersey","2019","Tenured, assistant professors","8","6","2","0","0","0","2","2","0","2","2","0","0","0","0","0","0","0","4","2","2","0","0","0","0","0","0","0","0","0","-2"
"186201","Ramapo College of New Jersey","2019","Tenured, instructors","1","0","1","0","0","0","0","0","0","0","0","0","0","0","0","0","0","0","1","0","1","0","0","0","0","0","0","0","0","0","-2"
"186201","Ramapo College of New Jersey","2019","On-Tenure track total","32","16","16","0","0","0","7","2","5","5","2","3","3","2","1","0","0","0","16","9","7","0","0","0","1","1","0","0","0","0","-2"
"186201","Ramapo College of New Jersey","2019","On-tenure track, associate professors","3","3","0","0","0","0","0","0","0","0","0","0","1","1","0","0","0","0","2","2","0","0","0","0","0","0","0","0","0","0","-2"
"186201","Ramapo College of New Jersey","2019","On-tenure track, assistant professors","29","13","16","0","0","0","7","2","5","5","2","3","2","1","1","0","0","0","14","7","7","0","0","0","1","1","0","0","0","0","-2"
"186201","Ramapo College of New Jersey","2019","Not on tenure track/No tenure system system total","14","6","8","0","0","0","4","0","4","0","0","0","0","0","0","0","0","0","10","6","4","0","0","0","0","0","0","0","0","0","-2"
"186201","Ramapo College of New Jersey","2019","Not on tenure/no tenure system, assistant professors","13","6","7","0","0","0","4","0","4","0","0","0","0","0","0","0","0","0","9","6","3","0","0","0","0","0","0","0","0","0","-2"
"186201","Ramapo College of New Jersey","2019","Not on tenure/no tenure system, instructors","1","0","1","0","0","0","0","0","0","0","0","0","0","0","0","0","0","0","1","0","1","0","0","0","0","0","0","0","0","0","-2"
"186283","Rider University","2019","Tenured total","147","83","64","0","0","0","18","9","9","6","2","4","3","1","2","0","0","0","120","71","49","0","0","0","0","0","0","0","0","0","-2"
"186283","Rider University","2019","Tenured, professors","71","45","26","0","0","0","6","4","2","3","2","1","2","1","1","0","0","0","60","38","22","0","0","0","0","0","0","0","0","0","-2"
"186283","Rider University","2019","Tenured, associate professors","76","38","38","0","0","0","12","5","7","3","0","3","1","0","1","0","0","0","60","33","27","0","0","0","0","0","0","0","0","0","-2"
"186283","Rider University","2019","On-Tenure track total","46","15","31","0","0","0","5","2","3","0","0","0","1","0","1","0","0","0","34","9","25","0","0","0","0","0","0","6","4","2","-2"
"186283","Rider University","2019","On-tenure track, professors","1","0","1","0","0","0","0","0","0","0","0","0","0","0","0","0","0","0","1","0","1","0","0","0","0","0","0","0","0","0","-2"
"186283","Rider University","2019","On-tenure track, associate professors","8","2","6","0","0","0","1","1","0","0","0","0","0","0","0","0","0","0","7","1","6","0","0","0","0","0","0","0","0","0","-2"
"186283","Rider University","2019","On-tenure track, assistant professors","36","12","24","0","0","0","4","1","3","0","0","0","1","0","1","0","0","0","25","7","18","0","0","0","0","0","0","6","4","2","-2"
"186283","Rider University","2019","On-tenure track, lecturers","1","1","0","0","0","0","0","0","0","0","0","0","0","0","0","0","0","0","1","1","0","0","0","0","0","0","0","0","0","0","-2"
"186283","Rider University","2019","Not on tenure track/No tenure system system total","12","5","7","0","0","0","0","0","0","1","1","0","0","0","0","0","0","0","9","4","5","1","0","1","0","0","0","1","0","1","-2"
"186283","Rider University","2019","Not on tenure/no tenure system, professors","1","0","1","0","0","0","0","0","0","0","0","0","0","0","0","0","0","0","0","0","0","1","0","1","0","0","0","0","0","0","-2"
"186283","Rider University","2019","Not on tenure/no tenure system, assistant professors","5","2","3","0","0","0","0","0","0","0","0","0","0","0","0","0","0","0","4","2","2","0","0","0","0","0","0","1","0","1","-2"
"186283","Rider University","2019","Not on tenure/no tenure system, lecturers","5","2","3","0","0","0","0","0","0","0","0","0","0","0","0","0","0","0","5","2","3","0","0","0","0","0","0","0","0","0","-2"
"186283","Rider University","2019","Not on tenure/no tenure system, no academic rank","1","1","0","0","0","0","0","0","0","1","1","0","0","0","0","0","0","0","0","0","0","0","0","0","0","0","0","0","0","0","-2"
"186371","Rutgers University-Camden","2019","Tenured total","160","99","61","0","0","0","22","20","2","4","2","2","5","3","2","0","0","0","103","61","42","1","1","0","14","7","7","11","5","6","-2"
"186371","Rutgers University-Camden","2019","Tenured, professors","95","63","32","0","0","0","14","14","0","2","0","2","2","1","1","0","0","0","66","41","25","1","1","0","5","2","3","5","4","1","-2"
"186371","Rutgers University-Camden","2019","Tenured, associate professors","65","36","29","0","0","0","8","6","2","2","2","0","3","2","1","0","0","0","37","20","17","0","0","0","9","5","4","6","1","5","-2"
"186371","Rutgers University-Camden","2019","On-Tenure track total","70","30","40","0","0","0","4","2","2","5","2","3","3","2","1","0","0","0","18","4","14","1","1","0","21","12","9","18","7","11","-2"
"186371","Rutgers University-Camden","2019","On-tenure track, professors","1","0","1","0","0","0","0","0","0","0","0","0","0","0","0","0","0","0","1","0","1","0","0","0","0","0","0","0","0","0","-2"
"186371","Rutgers University-Camden","2019","On-tenure track, associate professors","8","5","3","0","0","0","0","0","0","2","2","0","0","0","0","0","0","0","3","1","2","0","0","0","1","0","1","2","2","0","-2"
"186371","Rutgers University-Camden","2019","On-tenure track, assistant professors","61","25","36","0","0","0","4","2","2","3","0","3","3","2","1","0","0","0","14","3","11","1","1","0","20","12","8","16","5","11","-2"
"186371","Rutgers University-Camden","2019","Not on tenure track/No tenure system system total","82","34","48","0","0","0","3","2","1","1","0","1","1","1","0","0","0","0","45","11","34","1","1","0","24","12","12","7","7","0","-2"
"186371","Rutgers University-Camden","2019","Not on tenure/no tenure system, professors","11","2","9","0","0","0","0","0","0","0","0","0","0","0","0","0","0","0","10","2","8","0","0","0","1","0","1","0","0","0","-2"
"186371","Rutgers University-Camden","2019","Not on tenure/no tenure system, associate professors","12","5","7","0","0","0","1","1","0","0","0","0","0","0","0","0","0","0","9","2","7","0","0","0","2","2","0","0","0","0","-2"
"186371","Rutgers University-Camden","2019","Not on tenure/no tenure system, assistant professors","44","15","29","0","0","0","1","1","0","1","0","1","0","0","0","0","0","0","22","4","18","1","1","0","14","4","10","5","5","0","-2"
"186371","Rutgers University-Camden","2019","Not on tenure/no tenure system, instructors","14","11","3","0","0","0","1","0","1","0","0","0","1","1","0","0","0","0","3","2","1","0","0","0","7","6","1","2","2","0","-2"
"186371","Rutgers University-Camden","2019","Not on tenure/no tenure system, lecturers","1","1","0","0","0","0","0","0","0","0","0","0","0","0","0","0","0","0","1","1","0","0","0","0","0","0","0","0","0","0","-2"
"186584","Seton Hall University","2019","Tenured total","223","130","93","0","0","0","24","12","12","7","4","3","10","7","3","0","0","0","177","104","73","0","0","0","4","2","2","1","1","0","-2"
"186584","Seton Hall University","2019","Tenured, professors","110","65","45","0","0","0","9","6","3","4","3","1","6","4","2","0","0","0","89","52","37","0","0","0","2","0","2","0","0","0","-2"
"186584","Seton Hall University","2019","Tenured, associate professors","112","64","48","0","0","0","15","6","9","3","1","2","4","3","1","0","0","0","87","51","36","0","0","0","2","2","0","1","1","0","-2"
"186584","Seton Hall University","2019","Tenured, assistant professors","1","1","0","0","0","0","0","0","0","0","0","0","0","0","0","0","0","0","1","1","0","0","0","0","0","0","0","0","0","0","-2"
"186584","Seton Hall University","2019","On-Tenure track total","63","32","31","1","0","1","3","2","1","1","1","0","2","1","1","0","0","0","43","20","23","1","1","0","7","4","3","5","3","2","-2"
"186584","Seton Hall University","2019","On-tenure track, associate professors","9","4","5","0","0","0","0","0","0","0","0","0","0","0","0","0","0","0","9","4","5","0","0","0","0","0","0","0","0","0","-2"
"186584","Seton Hall University","2019","On-tenure track, assistant professors","54","28","26","1","0","1","3","2","1","1","1","0","2","1","1","0","0","0","34","16","18","1","1","0","7","4","3","5","3","2","-2"
"186584","Seton Hall University","2019","Not on tenure track/No tenure system system total","209","91","118","0","0","0","11","5","6","11","3","8","16","7","9","0","0","0","166","73","93","0","0","0","2","1","1","3","2","1","-2"
"186584","Seton Hall University","2019","Not on tenure/no tenure system, professors","8","5","3","0","0","0","1","1","0","0","0","0","1","1","0","0","0","0","5","2","3","0","0","0","0","0","0","1","1","0","-2"
"186584","Seton Hall University","2019","Not on tenure/no tenure system, associate professors","32","15","17","0","0","0","2","2","0","0","0","0","2","1","1","0","0","0","28","12","16","0","0","0","0","0","0","0","0","0","-2"
"186584","Seton Hall University","2019","Not on tenure/no tenure system, assistant professors","41","8","33","0","0","0","2","1","1","5","0","5","2","1","1","0","0","0","32","6","26","0","0","0","0","0","0","0","0","0","-2"
"186584","Seton Hall University","2019","Not on tenure/no tenure system, instructors","40","11","29","0","0","0","1","0","1","2","0","2","4","0","4","0","0","0","32","10","22","0","0","0","0","0","0","1","1","0","-2"
"186584","Seton Hall University","2019","Not on tenure/no tenure system, lecturers","19","10","9","0","0","0","1","0","1","0","0","0","1","0","1","0","0","0","17","10","7","0","0","0","0","0","0","0","0","0","-2"
"186584","Seton Hall University","2019","Not on tenure/no tenure system, no academic rank","69","42","27","0","0","0","4","1","3","4","3","1","6","4","2","0","0","0","52","33","19","0","0","0","2","1","1","1","0","1","-2"
"188429","Adelphi University","2019","Tenured total","224","111","113","0","0","0","34","13","21","8","2","6","11","5","6","0","0","0","168","91","77","1","0","1","2","0","2","0","0","0","-2"
"188429","Adelphi University","2019","Tenured, professors","93","52","41","0","0","0","13","5","8","2","0","2","5","3","2","0","0","0","71","44","27","0","0","0","2","0","2","0","0","0","-2"
"188429","Adelphi University","2019","Tenured, associate professors","129","58","71","0","0","0","21","8","13","6","2","4","6","2","4","0","0","0","95","46","49","1","0","1","0","0","0","0","0","0","-2"
"188429","Adelphi University","2019","Tenured, assistant professors","2","1","1","0","0","0","0","0","0","0","0","0","0","0","0","0","0","0","2","1","1","0","0","0","0","0","0","0","0","0","-2"
"188429","Adelphi University","2019","On-Tenure track total","75","34","41","0","0","0","12","6","6","5","0","5","10","4","6","0","0","0","42","22","20","2","1","1","4","1","3","0","0","0","-2"
"188429","Adelphi University","2019","On-tenure track, associate professors","3","2","1","0","0","0","0","0","0","0","0","0","1","1","0","0","0","0","1","0","1","1","1","0","0","0","0","0","0","0","-2"
"188429","Adelphi University","2019","On-tenure track, assistant professors","72","32","40","0","0","0","12","6","6","5","0","5","9","3","6","0","0","0","41","22","19","1","0","1","4","1","3","0","0","0","-2"
"188429","Adelphi University","2019","Not on tenure track/No tenure system system total","62","20","42","0","0","0","2","0","2","2","0","2","7","2","5","0","0","0","49","17","32","1","0","1","1","1","0","0","0","0","-2"
"188429","Adelphi University","2019","Not on tenure/no tenure system, instructors","11","2","9","0","0","0","1","0","1","0","0","0","1","0","1","0","0","0","9","2","7","0","0","0","0","0","0","0","0","0","-2"
"188429","Adelphi University","2019","Not on tenure/no tenure system, lecturers","19","7","12","0","0","0","0","0","0","1","0","1","3","0","3","0","0","0","13","6","7","1","0","1","1","1","0","0","0","0","-2"
"188429","Adelphi University","2019","Not on tenure/no tenure system, no academic rank","32","11","21","0","0","0","1","0","1","1","0","1","3","2","1","0","0","0","27","9","18","0","0","0","0","0","0","0","0","0","-2"
"188854","American Musical and Dramatic Academy","2019","Not on tenure track/No tenure system system total","102","63","39","0","0","0","3","2","1","1","1","0","4","3","1","0","0","0","86","50","36","0","0","0","8","7","1","0","0","0","-2"
"188854","American Musical and Dramatic Academy","2019","Not on tenure/no tenure system, instructors","102","63","39","0","0","0","3","2","1","1","1","0","4","3","1","0","0","0","86","50","36","0","0","0","8","7","1","0","0","0","-2"
"190248","Concordia College","2019","Not on tenure track/No tenure system system total","49","14","35","0","0","0","4","0","4","2","0","2","2","0","2","0","0","0","41","14","27","0","0","0","0","0","0","0","0","0","-2"
"190248","Concordia College","2019","Not on tenure/no tenure system, professors","9","3","6","0","0","0","0","0","0","1","0","1","0","0","0","0","0","0","8","3","5","0","0","0","0","0","0","0","0","0","-2"
"190248","Concordia College","2019","Not on tenure/no tenure system, associate professors","13","3","10","0","0","0","3","0","3","0","0","0","0","0","0","0","0","0","10","3","7","0","0","0","0","0","0","0","0","0","-2"
"190248","Concordia College","2019","Not on tenure/no tenure system, assistant professors","23","5","18","0","0","0","1","0","1","1","0","1","2","0","2","0","0","0","19","5","14","0","0","0","0","0","0","0","0","0","-2"
"190248","Concordia College","2019","Not on tenure/no tenure system, instructors","4","3","1","0","0","0","0","0","0","0","0","0","0","0","0","0","0","0","4","3","1","0","0","0","0","0","0","0","0","0","-2"
"190503","Culinary Institute of America","2019","Not on tenure track/No tenure system system total","138","97","41","1","1","0","4","1","3","1","0","1","2","1","1","6","3","3","114","83","31","6","6","0","4","2","2","0","0","0","-2"
"190503","Culinary Institute of America","2019","Not on tenure/no tenure system, professors","35","24","11","0","0","0","2","0","2","0","0","0","0","0","0","1","1","0","29","21","8","1","1","0","2","1","1","0","0","0","-2"
"190503","Culinary Institute of America","2019","Not on tenure/no tenure system, associate professors","48","33","15","1","1","0","0","0","0","1","0","1","1","1","0","0","0","0","42","29","13","2","2","0","1","0","1","0","0","0","-2"
"190503","Culinary Institute of America","2019","Not on tenure/no tenure system, assistant professors","26","19","7","0","0","0","0","0","0","0","0","0","0","0","0","0","0","0","23","16","7","2","2","0","1","1","0","0","0","0","-2"
"190503","Culinary Institute of America","2019","Not on tenure/no tenure system, instructors","29","21","8","0","0","0","2","1","1","0","0","0","1","0","1","5","2","3","20","17","3","1","1","0","0","0","0","0","0","0","-2"
"190512","CUNY Bernard M Baruch College","2019","Tenured total","328","209","119","0","0","0","40","28","12","14","7","7","13","4","9","0","0","0","236","152","84","0","0","0","0","0","0","25","18","7","-2"
"190512","CUNY Bernard M Baruch College","2019","Tenured, professors","172","116","56","0","0","0","19","15","4","3","2","1","7","2","5","0","0","0","138","92","46","0","0","0","0","0","0","5","5","0","-2"
"190512","CUNY Bernard M Baruch College","2019","Tenured, associate professors","122","70","52","0","0","0","19","11","8","8","5","3","2","1","1","0","0","0","76","42","34","0","0","0","0","0","0","17","11","6","-2"
"190512","CUNY Bernard M Baruch College","2019","Tenured, assistant professors","10","8","2","0","0","0","1","1","0","0","0","0","1","0","1","0","0","0","5","5","0","0","0","0","0","0","0","3","2","1","-2"
"190512","CUNY Bernard M Baruch College","2019","Tenured, lecturers","24","15","9","0","0","0","1","1","0","3","0","3","3","1","2","0","0","0","17","13","4","0","0","0","0","0","0","0","0","0","-2"
"190512","CUNY Bernard M Baruch College","2019","On-Tenure track total","134","74","60","1","1","0","17","9","8","10","5","5","11","7","4","0","0","0","57","30","27","1","1","0","1","0","1","36","21","15","-2"
"190512","CUNY Bernard M Baruch College","2019","On-tenure track, associate professors","3","2","1","0","0","0","1","0","1","0","0","0","1","1","0","0","0","0","1","1","0","0","0","0","0","0","0","0","0","0","-2"
"190512","CUNY Bernard M Baruch College","2019","On-tenure track, assistant professors","114","66","48","1","1","0","15","9","6","7","4","3","9","6","3","0","0","0","45","24","21","1","1","0","0","0","0","36","21","15","-2"
"190512","CUNY Bernard M Baruch College","2019","On-tenure track, lecturers","17","6","11","0","0","0","1","0","1","3","1","2","1","0","1","0","0","0","11","5","6","0","0","0","1","0","1","0","0","0","-2"
"190512","CUNY Bernard M Baruch College","2019","Not on tenure track/No tenure system system total","24","14","10","0","0","0","0","0","0","2","0","2","0","0","0","0","0","0","21","13","8","0","0","0","0","0","0","1","1","0","-2"
"190512","CUNY Bernard M Baruch College","2019","Not on tenure/no tenure system, professors","13","9","4","0","0","0","0","0","0","1","0","1","0","0","0","0","0","0","12","9","3","0","0","0","0","0","0","0","0","0","-2"
"190512","CUNY Bernard M Baruch College","2019","Not on tenure/no tenure system, assistant professors","4","2","2","0","0","0","0","0","0","0","0","0","0","0","0","0","0","0","3","1","2","0","0","0","0","0","0","1","1","0","-2"
"190512","CUNY Bernard M Baruch College","2019","Not on tenure/no tenure system, lecturers","7","3","4","0","0","0","0","0","0","1","0","1","0","0","0","0","0","0","6","3","3","0","0","0","0","0","0","0","0","0","-2"
"190549","CUNY Brooklyn College","2019","Tenured total","367","209","158","0","0","0","44","23","21","25","16","9","19","7","12","0","0","0","261","154","107","2","1","1","1","0","1","15","8","7","-2"
"190549","CUNY Brooklyn College","2019","Tenured, professors","186","121","65","0","0","0","16","12","4","9","4","5","8","4","4","0","0","0","148","98","50","1","1","0","1","0","1","3","2","1","-2"
"190549","CUNY Brooklyn College","2019","Tenured, associate professors","138","68","70","0","0","0","24","9","15","11","9","2","10","3","7","0","0","0","83","41","42","0","0","0","0","0","0","10","6","4","-2"
"190549","CUNY Brooklyn College","2019","Tenured, assistant professors","20","9","11","0","0","0","3","2","1","3","1","2","1","0","1","0","0","0","11","6","5","0","0","0","0","0","0","2","0","2","-2"
"190549","CUNY Brooklyn College","2019","Tenured, lecturers","23","11","12","0","0","0","1","0","1","2","2","0","0","0","0","0","0","0","19","9","10","1","0","1","0","0","0","0","0","0","-2"
"190549","CUNY Brooklyn College","2019","On-Tenure track total","97","45","52","0","0","0","18","5","13","7","4","3","10","5","5","0","0","0","55","26","29","2","1","1","0","0","0","5","4","1","-2"
"190549","CUNY Brooklyn College","2019","On-tenure track, professors","1","0","1","0","0","0","1","0","1","0","0","0","0","0","0","0","0","0","0","0","0","0","0","0","0","0","0","0","0","0","-2"
"190549","CUNY Brooklyn College","2019","On-tenure track, associate professors","5","4","1","0","0","0","0","0","0","0","0","0","0","0","0","0","0","0","3","2","1","0","0","0","0","0","0","2","2","0","-2"
"190549","CUNY Brooklyn College","2019","On-tenure track, assistant professors","84","37","47","0","0","0","16","5","11","7","4","3","10","5","5","0","0","0","46","20","26","2","1","1","0","0","0","3","2","1","-2"
"190549","CUNY Brooklyn College","2019","On-tenure track, lecturers","7","4","3","0","0","0","1","0","1","0","0","0","0","0","0","0","0","0","6","4","2","0","0","0","0","0","0","0","0","0","-2"
"190549","CUNY Brooklyn College","2019","Not on tenure track/No tenure system system total","40","20","20","0","0","0","3","1","2","5","0","5","5","3","2","0","0","0","25","14","11","0","0","0","0","0","0","2","2","0","-2"
"190549","CUNY Brooklyn College","2019","Not on tenure/no tenure system, professors","8","3","5","0","0","0","0","0","0","0","0","0","1","1","0","0","0","0","7","2","5","0","0","0","0","0","0","0","0","0","-2"
"190549","CUNY Brooklyn College","2019","Not on tenure/no tenure system, associate professors","1","0","1","0","0","0","0","0","0","0","0","0","1","0","1","0","0","0","0","0","0","0","0","0","0","0","0","0","0","0","-2"
"190549","CUNY Brooklyn College","2019","Not on tenure/no tenure system, lecturers","31","17","14","0","0","0","3","1","2","5","0","5","3","2","1","0","0","0","18","12","6","0","0","0","0","0","0","2","2","0","-2"
"190646","CUNY Medgar Evers College","2019","Tenured total","93","55","38","0","0","0","8","4","4","59","38","21","7","4","3","0","0","0","13","7","6","3","2","1","0","0","0","3","0","3","-2"
"190646","CUNY Medgar Evers College","2019","Tenured, professors","38","24","14","0","0","0","5","3","2","23","15","8","2","1","1","0","0","0","7","4","3","1","1","0","0","0","0","0","0","0","-2"
"190646","CUNY Medgar Evers College","2019","Tenured, associate professors","24","9","15","0","0","0","1","0","1","12","5","7","3","2","1","0","0","0","4","2","2","1","0","1","0","0","0","3","0","3","-2"
"190646","CUNY Medgar Evers College","2019","Tenured, assistant professors","9","5","4","0","0","0","1","1","0","5","2","3","1","1","0","0","0","0","1","0","1","1","1","0","0","0","0","0","0","0","-2"
"190646","CUNY Medgar Evers College","2019","Tenured, lecturers","22","17","5","0","0","0","1","0","1","19","16","3","1","0","1","0","0","0","1","1","0","0","0","0","0","0","0","0","0","0","-2"
"190646","CUNY Medgar Evers College","2019","On-Tenure track total","47","20","27","0","0","0","5","3","2","27","10","17","2","2","0","0","0","0","10","4","6","2","0","2","0","0","0","1","1","0","-2"
"190646","CUNY Medgar Evers College","2019","On-tenure track, professors","2","2","0","0","0","0","0","0","0","1","1","0","0","0","0","0","0","0","1","1","0","0","0","0","0","0","0","0","0","0","-2"
"190646","CUNY Medgar Evers College","2019","On-tenure track, associate professors","10","6","4","0","0","0","3","2","1","4","3","1","0","0","0","0","0","0","3","1","2","0","0","0","0","0","0","0","0","0","-2"
"190646","CUNY Medgar Evers College","2019","On-tenure track, assistant professors","31","12","19","0","0","0","2","1","1","18","6","12","2","2","0","0","0","0","6","2","4","2","0","2","0","0","0","1","1","0","-2"
"190646","CUNY Medgar Evers College","2019","On-tenure track, lecturers","4","0","4","0","0","0","0","0","0","4","0","4","0","0","0","0","0","0","0","0","0","0","0","0","0","0","0","0","0","0","-2"
"190646","CUNY Medgar Evers College","2019","Not on tenure track/No tenure system system total","19","8","11","0","0","0","1","1","0","17","7","10","1","0","1","0","0","0","0","0","0","0","0","0","0","0","0","0","0","0","-2"
"190646","CUNY Medgar Evers College","2019","Not on tenure/no tenure system, professors","2","1","1","0","0","0","0","0","0","2","1","1","0","0","0","0","0","0","0","0","0","0","0","0","0","0","0","0","0","0","-2"
"190646","CUNY Medgar Evers College","2019","Not on tenure/no tenure system, associate professors","1","0","1","0","0","0","0","0","0","1","0","1","0","0","0","0","0","0","0","0","0","0","0","0","0","0","0","0","0","0","-2"
"190646","CUNY Medgar Evers College","2019","Not on tenure/no tenure system, assistant professors","7","3","4","0","0","0","1","1","0","6","2","4","0","0","0","0","0","0","0","0","0","0","0","0","0","0","0","0","0","0","-2"
"190646","CUNY Medgar Evers College","2019","Not on tenure/no tenure system, instructors","2","1","1","0","0","0","0","0","0","2","1","1","0","0","0","0","0","0","0","0","0","0","0","0","0","0","0","0","0","0","-2"
"190646","CUNY Medgar Evers College","2019","Not on tenure/no tenure system, lecturers","7","3","4","0","0","0","0","0","0","6","3","3","1","0","1","0","0","0","0","0","0","0","0","0","0","0","0","0","0","0","-2"
"191126","Fashion Institute of Technology","2019","Tenured total","195","86","109","0","0","0","8","6","2","10","4","6","4","2","2","0","0","0","94","36","58","0","0","0","59","29","30","20","9","11","-2"
"191126","Fashion Institute of Technology","2019","Tenured, professors","58","26","32","0","0","0","3","3","0","2","1","1","0","0","0","0","0","0","29","11","18","0","0","0","17","8","9","7","3","4","-2"
"191126","Fashion Institute of Technology","2019","Tenured, associate professors","65","30","35","0","0","0","4","2","2","2","2","0","2","1","1","0","0","0","25","9","16","0","0","0","23","11","12","9","5","4","-2"
"191126","Fashion Institute of Technology","2019","Tenured, assistant professors","72","30","42","0","0","0","1","1","0","6","1","5","2","1","1","0","0","0","40","16","24","0","0","0","19","10","9","4","1","3","-2"
"191126","Fashion Institute of Technology","2019","On-Tenure track total","31","9","22","0","0","0","4","1","3","2","0","2","1","0","1","0","0","0","13","4","9","0","0","0","3","1","2","8","3","5","-2"
"191126","Fashion Institute of Technology","2019","On-tenure track, associate professors","8","3","5","0","0","0","0","0","0","0","0","0","0","0","0","0","0","0","7","3","4","0","0","0","0","0","0","1","0","1","-2"
"191126","Fashion Institute of Technology","2019","On-tenure track, assistant professors","23","6","17","0","0","0","4","1","3","2","0","2","1","0","1","0","0","0","6","1","5","0","0","0","3","1","2","7","3","4","-2"
"191241","Fordham University","2019","Tenured total","459","279","180","0","0","0","43","23","20","16","10","6","22","13","9","0","0","0","332","206","126","2","1","1","27","18","9","17","8","9","-2"
"191241","Fordham University","2019","Tenured, professors","242","165","77","0","0","0","18","12","6","8","5","3","11","7","4","0","0","0","184","127","57","1","1","0","15","10","5","5","3","2","-2"
"191241","Fordham University","2019","Tenured, associate professors","193","100","93","0","0","0","22","9","13","7","4","3","11","6","5","0","0","0","129","69","60","1","0","1","12","8","4","11","4","7","-2"
"191241","Fordham University","2019","Tenured, assistant professors","24","14","10","0","0","0","3","2","1","1","1","0","0","0","0","0","0","0","19","10","9","0","0","0","0","0","0","1","1","0","-2"
"191241","Fordham University","2019","On-Tenure track total","110","45","65","0","0","0","14","3","11","14","6","8","5","3","2","0","0","0","41","13","28","1","1","0","5","2","3","30","17","13","-2"
"191241","Fordham University","2019","On-tenure track, associate professors","7","3","4","0","0","0","1","1","0","0","0","0","0","0","0","0","0","0","3","1","2","0","0","0","2","1","1","1","0","1","-2"
"191241","Fordham University","2019","On-tenure track, assistant professors","103","42","61","0","0","0","13","2","11","14","6","8","5","3","2","0","0","0","38","12","26","1","1","0","3","1","2","29","17","12","-2"
"191241","Fordham University","2019","Not on tenure track/No tenure system system total","14","10","4","0","0","0","1","1","0","3","2","1","1","1","0","0","0","0","2","1","1","1","0","1","0","0","0","6","5","1","-2"
"191241","Fordham University","2019","Not on tenure/no tenure system, instructors","14","10","4","0","0","0","1","1","0","3","2","1","1","1","0","0","0","0","2","1","1","1","0","1","0","0","0","6","5","1","-2"
"191931","Iona College","2019","Tenured total","97","59","38","0","0","0","12","6","6","2","1","1","1","0","1","0","0","0","81","51","30","0","0","0","0","0","0","1","1","0","-2"
"191931","Iona College","2019","Tenured, professors","45","31","14","0","0","0","2","1","1","1","1","0","1","0","1","0","0","0","40","28","12","0","0","0","0","0","0","1","1","0","-2"
"191931","Iona College","2019","Tenured, associate professors","51","28","23","0","0","0","10","5","5","1","0","1","0","0","0","0","0","0","40","23","17","0","0","0","0","0","0","0","0","0","-2"
"191931","Iona College","2019","Tenured, assistant professors","1","0","1","0","0","0","0","0","0","0","0","0","0","0","0","0","0","0","1","0","1","0","0","0","0","0","0","0","0","0","-2"
"191931","Iona College","2019","On-Tenure track total","52","18","34","0","0","0","12","5","7","5","1","4","2","0","2","0","0","0","33","12","21","0","0","0","0","0","0","0","0","0","-2"
"191931","Iona College","2019","On-tenure track, assistant professors","52","18","34","0","0","0","12","5","7","5","1","4","2","0","2","0","0","0","33","12","21","0","0","0","0","0","0","0","0","0","-2"
"191931","Iona College","2019","Not on tenure track/No tenure system system total","20","9","11","0","0","0","3","1","2","1","0","1","1","1","0","0","0","0","13","6","7","1","1","0","1","0","1","0","0","0","-2"
"191931","Iona College","2019","Not on tenure/no tenure system, professors","3","1","2","0","0","0","1","1","0","1","0","1","0","0","0","0","0","0","1","0","1","0","0","0","0","0","0","0","0","0","-2"
"191931","Iona College","2019","Not on tenure/no tenure system, assistant professors","2","1","1","0","0","0","0","0","0","0","0","0","1","1","0","0","0","0","1","0","1","0","0","0","0","0","0","0","0","0","-2"
"191931","Iona College","2019","Not on tenure/no tenure system, instructors","4","2","2","0","0","0","1","0","1","0","0","0","0","0","0","0","0","0","3","2","1","0","0","0","0","0","0","0","0","0","-2"
"191931","Iona College","2019","Not on tenure/no tenure system, lecturers","11","5","6","0","0","0","1","0","1","0","0","0","0","0","0","0","0","0","8","4","4","1","1","0","1","0","1","0","0","0","-2"
"192703","Manhattan College","2019","Tenured total","147","81","66","0","0","0","11","5","6","4","2","2","7","4","3","0","0","0","114","65","49","0","0","0","10","5","5","1","0","1","-2"
"192703","Manhattan College","2019","Tenured, professors","63","39","24","0","0","0","4","3","1","0","0","0","2","1","1","0","0","0","56","34","22","0","0","0","1","1","0","0","0","0","-2"
"192703","Manhattan College","2019","Tenured, associate professors","73","38","35","0","0","0","6","2","4","3","2","1","4","3","1","0","0","0","51","27","24","0","0","0","9","4","5","0","0","0","-2"
"192703","Manhattan College","2019","Tenured, assistant professors","11","4","7","0","0","0","1","0","1","1","0","1","1","0","1","0","0","0","7","4","3","0","0","0","0","0","0","1","0","1","-2"
"192703","Manhattan College","2019","On-Tenure track total","72","38","34","0","0","0","12","8","4","3","1","2","3","1","2","0","0","0","42","22","20","2","0","2","7","6","1","3","0","3","-2"
"192703","Manhattan College","2019","On-tenure track, professors","1","0","1","0","0","0","0","0","0","0","0","0","0","0","0","0","0","0","1","0","1","0","0","0","0","0","0","0","0","0","-2"
"192703","Manhattan College","2019","On-tenure track, associate professors","4","4","0","0","0","0","3","3","0","0","0","0","0","0","0","0","0","0","0","0","0","0","0","0","1","1","0","0","0","0","-2"
"192703","Manhattan College","2019","On-tenure track, assistant professors","67","34","33","0","0","0","9","5","4","3","1","2","3","1","2","0","0","0","41","22","19","2","0","2","6","5","1","3","0","3","-2"
"192703","Manhattan College","2019","Not on tenure track/No tenure system system total","20","12","8","0","0","0","0","0","0","0","0","0","1","0","1","0","0","0","17","10","7","0","0","0","1","1","0","1","1","0","-2"
"192703","Manhattan College","2019","Not on tenure/no tenure system, professors","1","1","0","0","0","0","0","0","0","0","0","0","0","0","0","0","0","0","1","1","0","0","0","0","0","0","0","0","0","0","-2"
"192703","Manhattan College","2019","Not on tenure/no tenure system, associate professors","3","3","0","0","0","0","0","0","0","0","0","0","0","0","0","0","0","0","3","3","0","0","0","0","0","0","0","0","0","0","-2"
"192703","Manhattan College","2019","Not on tenure/no tenure system, assistant professors","14","8","6","0","0","0","0","0","0","0","0","0","1","0","1","0","0","0","11","6","5","0","0","0","1","1","0","1","1","0","-2"
"192703","Manhattan College","2019","Not on tenure/no tenure system, instructors","2","0","2","0","0","0","0","0","0","0","0","0","0","0","0","0","0","0","2","0","2","0","0","0","0","0","0","0","0","0","-2"
"192864","Marymount Manhattan College","2019","Tenured total","64","24","40","1","0","1","3","1","2","1","0","1","0","0","0","0","0","0","53","20","33","0","0","0","6","3","3","0","0","0","-2"
"192864","Marymount Manhattan College","2019","Tenured, professors","28","11","17","0","0","0","2","0","2","0","0","0","0","0","0","0","0","0","26","11","15","0","0","0","0","0","0","0","0","0","-2"
"192864","Marymount Manhattan College","2019","Tenured, associate professors","36","13","23","1","0","1","1","1","0","1","0","1","0","0","0","0","0","0","27","9","18","0","0","0","6","3","3","0","0","0","-2"
"192864","Marymount Manhattan College","2019","On-Tenure track total","26","6","20","0","0","0","2","1","1","1","0","1","0","0","0","0","0","0","14","3","11","1","1","0","8","1","7","0","0","0","-2"
"192864","Marymount Manhattan College","2019","On-tenure track, assistant professors","26","6","20","0","0","0","2","1","1","1","0","1","0","0","0","0","0","0","14","3","11","1","1","0","8","1","7","0","0","0","-2"
"192864","Marymount Manhattan College","2019","Not on tenure track/No tenure system system total","3","1","2","0","0","0","1","1","0","0","0","0","0","0","0","0","0","0","1","0","1","0","0","0","1","0","1","0","0","0","-2"
"192864","Marymount Manhattan College","2019","Not on tenure/no tenure system, assistant professors","1","1","0","0","0","0","1","1","0","0","0","0","0","0","0","0","0","0","0","0","0","0","0","0","0","0","0","0","0","0","-2"
"192864","Marymount Manhattan College","2019","Not on tenure/no tenure system, instructors","2","0","2","0","0","0","0","0","0","0","0","0","0","0","0","0","0","0","1","0","1","0","0","0","1","0","1","0","0","0","-2"
"193292","Molloy College","2019","Tenured total","127","34","93","0","0","0","8","1","7","14","1","13","7","4","3","0","0","0","96","28","68","2","0","2","0","0","0","0","0","0","-2"
"193292","Molloy College","2019","Tenured, professors","54","14","40","0","0","0","1","0","1","5","0","5","4","2","2","0","0","0","43","12","31","1","0","1","0","0","0","0","0","0","-2"
"193292","Molloy College","2019","Tenured, associate professors","51","15","36","0","0","0","6","1","5","7","1","6","2","2","0","0","0","0","35","11","24","1","0","1","0","0","0","0","0","0","-2"
"193292","Molloy College","2019","Tenured, assistant professors","22","5","17","0","0","0","1","0","1","2","0","2","1","0","1","0","0","0","18","5","13","0","0","0","0","0","0","0","0","0","-2"
"193292","Molloy College","2019","On-Tenure track total","65","21","44","0","0","0","5","1","4","4","1","3","2","1","1","0","0","0","53","17","36","1","1","0","0","0","0","0","0","0","-2"
"193292","Molloy College","2019","On-tenure track, professors","1","0","1","0","0","0","0","0","0","0","0","0","0","0","0","0","0","0","1","0","1","0","0","0","0","0","0","0","0","0","-2"
"193292","Molloy College","2019","On-tenure track, associate professors","6","2","4","0","0","0","0","0","0","1","0","1","1","1","0","0","0","0","4","1","3","0","0","0","0","0","0","0","0","0","-2"
"193292","Molloy College","2019","On-tenure track, assistant professors","46","12","34","0","0","0","4","1","3","3","1","2","1","0","1","0","0","0","37","9","28","1","1","0","0","0","0","0","0","0","-2"
"193292","Molloy College","2019","On-tenure track, instructors","12","7","5","0","0","0","1","0","1","0","0","0","0","0","0","0","0","0","11","7","4","0","0","0","0","0","0","0","0","0","-2"
"193353","Mount Saint Mary College","2019","Tenured total","52","25","27","0","0","0","1","0","1","2","0","2","1","1","0","0","0","0","46","23","23","0","0","0","0","0","0","2","1","1","-2"
"193353","Mount Saint Mary College","2019","Tenured, professors","22","12","10","0","0","0","0","0","0","0","0","0","0","0","0","0","0","0","22","12","10","0","0","0","0","0","0","0","0","0","-2"
"193353","Mount Saint Mary College","2019","Tenured, associate professors","30","13","17","0","0","0","1","0","1","2","0","2","1","1","0","0","0","0","24","11","13","0","0","0","0","0","0","2","1","1","-2"
"193353","Mount Saint Mary College","2019","On-Tenure track total","29","11","18","0","0","0","4","1","3","0","0","0","1","1","0","0","0","0","24","9","15","0","0","0","0","0","0","0","0","0","-2"
"193353","Mount Saint Mary College","2019","On-tenure track, assistant professors","21","10","11","0","0","0","3","1","2","0","0","0","1","1","0","0","0","0","17","8","9","0","0","0","0","0","0","0","0","0","-2"
"193353","Mount Saint Mary College","2019","On-tenure track, instructors","8","1","7","0","0","0","1","0","1","0","0","0","0","0","0","0","0","0","7","1","6","0","0","0","0","0","0","0","0","0","-2"
"193353","Mount Saint Mary College","2019","Not on tenure track/No tenure system system total","4","3","1","0","0","0","0","0","0","0","0","0","1","1","0","0","0","0","3","2","1","0","0","0","0","0","0","0","0","0","-2"
"193353","Mount Saint Mary College","2019","Not on tenure/no tenure system, lecturers","4","3","1","0","0","0","0","0","0","0","0","0","1","1","0","0","0","0","3","2","1","0","0","0","0","0","0","0","0","0","-2"
"194091","New York Institute of Technology","2019","Tenured total","143","88","55","1","1","0","26","15","11","3","2","1","4","4","0","0","0","0","106","64","42","0","0","0","0","0","0","3","2","1","-2"
"194091","New York Institute of Technology","2019","Tenured, professors","52","41","11","1","1","0","12","8","4","2","2","0","0","0","0","0","0","0","37","30","7","0","0","0","0","0","0","0","0","0","-2"
"194091","New York Institute of Technology","2019","Tenured, associate professors","85","45","40","0","0","0","14","7","7","1","0","1","3","3","0","0","0","0","64","33","31","0","0","0","0","0","0","3","2","1","-2"
"194091","New York Institute of Technology","2019","Tenured, assistant professors","6","2","4","0","0","0","0","0","0","0","0","0","1","1","0","0","0","0","5","1","4","0","0","0","0","0","0","0","0","0","-2"
"194091","New York Institute of Technology","2019","On-Tenure track total","68","41","27","0","0","0","19","12","7","2","1","1","0","0","0","0","0","0","37","20","17","1","0","1","0","0","0","9","8","1","-2"
"194091","New York Institute of Technology","2019","On-tenure track, professors","1","0","1","0","0","0","1","0","1","0","0","0","0","0","0","0","0","0","0","0","0","0","0","0","0","0","0","0","0","0","-2"
"194091","New York Institute of Technology","2019","On-tenure track, associate professors","8","7","1","0","0","0","2","2","0","0","0","0","0","0","0","0","0","0","5","4","1","0","0","0","0","0","0","1","1","0","-2"
"194091","New York Institute of Technology","2019","On-tenure track, assistant professors","59","34","25","0","0","0","16","10","6","2","1","1","0","0","0","0","0","0","32","16","16","1","0","1","0","0","0","8","7","1","-2"
"194091","New York Institute of Technology","2019","Not on tenure track/No tenure system system total","133","71","62","0","0","0","21","14","7","6","3","3","7","3","4","0","0","0","89","48","41","4","1","3","1","0","1","5","2","3","-2"
"194091","New York Institute of Technology","2019","Not on tenure/no tenure system, professors","7","6","1","0","0","0","1","1","0","0","0","0","0","0","0","0","0","0","6","5","1","0","0","0","0","0","0","0","0","0","-2"
"194091","New York Institute of Technology","2019","Not on tenure/no tenure system, associate professors","45","25","20","0","0","0","9","7","2","1","1","0","2","1","1","0","0","0","33","16","17","0","0","0","0","0","0","0","0","0","-2"
"194091","New York Institute of Technology","2019","Not on tenure/no tenure system, assistant professors","72","34","38","0","0","0","6","3","3","5","2","3","4","1","3","0","0","0","48","25","23","4","1","3","0","0","0","5","2","3","-2"
"194091","New York Institute of Technology","2019","Not on tenure/no tenure system, instructors","8","6","2","0","0","0","5","3","2","0","0","0","1","1","0","0","0","0","2","2","0","0","0","0","0","0","0","0","0","0","-2"
"194091","New York Institute of Technology","2019","Not on tenure/no tenure system, no academic rank","1","0","1","0","0","0","0","0","0","0","0","0","0","0","0","0","0","0","0","0","0","0","0","0","1","0","1","0","0","0","-2"
"195243","St. Thomas Aquinas College","2019","Tenured total","28","12","16","0","0","0","1","0","1","0","0","0","0","0","0","0","0","0","27","12","15","0","0","0","0","0","0","0","0","0","-2"
"195243","St. Thomas Aquinas College","2019","Tenured, professors","18","8","10","0","0","0","1","0","1","0","0","0","0","0","0","0","0","0","17","8","9","0","0","0","0","0","0","0","0","0","-2"
"195243","St. Thomas Aquinas College","2019","Tenured, associate professors","9","4","5","0","0","0","0","0","0","0","0","0","0","0","0","0","0","0","9","4","5","0","0","0","0","0","0","0","0","0","-2"
"195243","St. Thomas Aquinas College","2019","Tenured, assistant professors","1","0","1","0","0","0","0","0","0","0","0","0","0","0","0","0","0","0","1","0","1","0","0","0","0","0","0","0","0","0","-2"
"195243","St. Thomas Aquinas College","2019","On-Tenure track total","14","4","10","0","0","0","2","1","1","0","0","0","0","0","0","0","0","0","12","3","9","0","0","0","0","0","0","0","0","0","-2"
"195243","St. Thomas Aquinas College","2019","On-tenure track, associate professors","1","0","1","0","0","0","0","0","0","0","0","0","0","0","0","0","0","0","1","0","1","0","0","0","0","0","0","0","0","0","-2"
"195243","St. Thomas Aquinas College","2019","On-tenure track, assistant professors","13","4","9","0","0","0","2","1","1","0","0","0","0","0","0","0","0","0","11","3","8","0","0","0","0","0","0","0","0","0","-2"
"195243","St. Thomas Aquinas College","2019","Not on tenure track/No tenure system system total","5","2","3","0","0","0","0","0","0","0","0","0","0","0","0","0","0","0","5","2","3","0","0","0","0","0","0","0","0","0","-2"
"195243","St. Thomas Aquinas College","2019","Not on tenure/no tenure system, instructors","5","2","3","0","0","0","0","0","0","0","0","0","0","0","0","0","0","0","5","2","3","0","0","0","0","0","0","0","0","0","-2"
"195562","St. Joseph's College-Long Island","2019","Tenured total","41","16","25","0","0","0","1","0","1","1","0","1","1","0","1","0","0","0","35","15","20","0","0","0","3","1","2","0","0","0","-2"
"195562","St. Joseph's College-Long Island","2019","Tenured, professors","22","9","13","0","0","0","1","0","1","1","0","1","1","0","1","0","0","0","18","9","9","0","0","0","1","0","1","0","0","0","-2"
"195562","St. Joseph's College-Long Island","2019","Tenured, associate professors","19","7","12","0","0","0","0","0","0","0","0","0","0","0","0","0","0","0","17","6","11","0","0","0","2","1","1","0","0","0","-2"
"195562","St. Joseph's College-Long Island","2019","On-Tenure track total","50","18","32","1","0","1","3","1","2","0","0","0","0","0","0","0","0","0","38","12","26","0","0","0","8","5","3","0","0","0","-2"
"195562","St. Joseph's College-Long Island","2019","On-tenure track, associate professors","12","4","8","0","0","0","1","1","0","0","0","0","0","0","0","0","0","0","10","2","8","0","0","0","1","1","0","0","0","0","-2"
"195562","St. Joseph's College-Long Island","2019","On-tenure track, assistant professors","38","14","24","1","0","1","2","0","2","0","0","0","0","0","0","0","0","0","28","10","18","0","0","0","7","4","3","0","0","0","-2"
"195562","St. Joseph's College-Long Island","2019","Not on tenure track/No tenure system system total","11","5","6","0","0","0","0","0","0","1","0","1","0","0","0","0","0","0","8","5","3","0","0","0","2","0","2","0","0","0","-2"
"195562","St. Joseph's College-Long Island","2019","Not on tenure/no tenure system, assistant professors","11","5","6","0","0","0","0","0","0","1","0","1","0","0","0","0","0","0","8","5","3","0","0","0","2","0","2","0","0","0","-2"
"196024","SUNY College of Technology at Delhi","2019","Tenured total","67","35","32","0","0","0","2","0","2","1","0","1","0","0","0","0","0","0","64","35","29","0","0","0","0","0","0","0","0","0","-2"
"196024","SUNY College of Technology at Delhi","2019","Tenured, professors","28","15","13","0","0","0","1","0","1","0","0","0","0","0","0","0","0","0","27","15","12","0","0","0","0","0","0","0","0","0","-2"
"196024","SUNY College of Technology at Delhi","2019","Tenured, associate professors","28","12","16","0","0","0","1","0","1","1","0","1","0","0","0","0","0","0","26","12","14","0","0","0","0","0","0","0","0","0","-2"
"196024","SUNY College of Technology at Delhi","2019","Tenured, assistant professors","9","7","2","0","0","0","0","0","0","0","0","0","0","0","0","0","0","0","9","7","2","0","0","0","0","0","0","0","0","0","-2"
"196024","SUNY College of Technology at Delhi","2019","Tenured, instructors","2","1","1","0","0","0","0","0","0","0","0","0","0","0","0","0","0","0","2","1","1","0","0","0","0","0","0","0","0","0","-2"
"196024","SUNY College of Technology at Delhi","2019","On-Tenure track total","73","37","36","0","0","0","3","2","1","1","1","0","1","0","1","0","0","0","68","34","34","0","0","0","0","0","0","0","0","0","-2"
"196024","SUNY College of Technology at Delhi","2019","On-tenure track, professors","1","1","0","0","0","0","0","0","0","0","0","0","0","0","0","0","0","0","1","1","0","0","0","0","0","0","0","0","0","0","-2"
"196024","SUNY College of Technology at Delhi","2019","On-tenure track, associate professors","16","5","11","0","0","0","0","0","0","0","0","0","0","0","0","0","0","0","16","5","11","0","0","0","0","0","0","0","0","0","-2"
"196024","SUNY College of Technology at Delhi","2019","On-tenure track, assistant professors","38","18","20","0","0","0","3","2","1","1","1","0","0","0","0","0","0","0","34","15","19","0","0","0","0","0","0","0","0","0","-2"
"196024","SUNY College of Technology at Delhi","2019","On-tenure track, instructors","18","13","5","0","0","0","0","0","0","0","0","0","1","0","1","0","0","0","17","13","4","0","0","0","0","0","0","0","0","0","-2"
"196024","SUNY College of Technology at Delhi","2019","Not on tenure track/No tenure system system total","4","4","0","0","0","0","0","0","0","0","0","0","0","0","0","0","0","0","4","4","0","0","0","0","0","0","0","0","0","0","-2"
"196024","SUNY College of Technology at Delhi","2019","Not on tenure/no tenure system, assistant professors","1","1","0","0","0","0","0","0","0","0","0","0","0","0","0","0","0","0","1","1","0","0","0","0","0","0","0","0","0","0","-2"
"196024","SUNY College of Technology at Delhi","2019","Not on tenure/no tenure system, instructors","3","3","0","0","0","0","0","0","0","0","0","0","0","0","0","0","0","0","3","3","0","0","0","0","0","0","0","0","0","0","-2"
"196042","Farmingdale State College","2019","Tenured total","105","60","45","0","0","0","14","11","3","5","2","3","6","5","1","0","0","0","79","42","37","1","0","1","0","0","0","0","0","0","-2"
"196042","Farmingdale State College","2019","Tenured, professors","55","30","25","0","0","0","8","7","1","2","2","0","2","1","1","0","0","0","43","20","23","0","0","0","0","0","0","0","0","0","-2"
"196042","Farmingdale State College","2019","Tenured, associate professors","43","26","17","0","0","0","5","3","2","3","0","3","4","4","0","0","0","0","30","19","11","1","0","1","0","0","0","0","0","0","-2"
"196042","Farmingdale State College","2019","Tenured, assistant professors","7","4","3","0","0","0","1","1","0","0","0","0","0","0","0","0","0","0","6","3","3","0","0","0","0","0","0","0","0","0","-2"
"196042","Farmingdale State College","2019","On-Tenure track total","122","58","64","0","0","0","22","8","14","8","3","5","6","2","4","0","0","0","82","43","39","3","2","1","0","0","0","1","0","1","-2"
"196042","Farmingdale State College","2019","On-tenure track, professors","2","1","1","0","0","0","1","0","1","0","0","0","0","0","0","0","0","0","1","1","0","0","0","0","0","0","0","0","0","0","-2"
"196042","Farmingdale State College","2019","On-tenure track, associate professors","6","0","6","0","0","0","1","0","1","0","0","0","0","0","0","0","0","0","5","0","5","0","0","0","0","0","0","0","0","0","-2"
"196042","Farmingdale State College","2019","On-tenure track, assistant professors","114","57","57","0","0","0","20","8","12","8","3","5","6","2","4","0","0","0","76","42","34","3","2","1","0","0","0","1","0","1","-2"
"196042","Farmingdale State College","2019","Not on tenure track/No tenure system system total","38","22","16","0","0","0","3","2","1","3","1","2","1","1","0","0","0","0","31","18","13","0","0","0","0","0","0","0","0","0","-2"
"196042","Farmingdale State College","2019","Not on tenure/no tenure system, associate professors","1","1","0","0","0","0","0","0","0","0","0","0","0","0","0","0","0","0","1","1","0","0","0","0","0","0","0","0","0","0","-2"
"196042","Farmingdale State College","2019","Not on tenure/no tenure system, assistant professors","27","17","10","0","0","0","2","1","1","2","1","1","1","1","0","0","0","0","22","14","8","0","0","0","0","0","0","0","0","0","-2"
"196042","Farmingdale State College","2019","Not on tenure/no tenure system, lecturers","10","4","6","0","0","0","1","1","0","1","0","1","0","0","0","0","0","0","8","3","5","0","0","0","0","0","0","0","0","0","-2"
"196176","State University of New York at New Paltz","2019","Tenured total","191","98","93","0","0","0","19","12","7","5","5","0","8","5","3","0","0","0","158","76","82","0","0","0","0","0","0","1","0","1","-2"
"196176","State University of New York at New Paltz","2019","Tenured, professors","55","34","21","0","0","0","11","7","4","1","1","0","1","1","0","0","0","0","42","25","17","0","0","0","0","0","0","0","0","0","-2"
"196176","State University of New York at New Paltz","2019","Tenured, associate professors","126","61","65","0","0","0","8","5","3","3","3","0","7","4","3","0","0","0","107","49","58","0","0","0","0","0","0","1","0","1","-2"
"196176","State University of New York at New Paltz","2019","Tenured, assistant professors","5","3","2","0","0","0","0","0","0","1","1","0","0","0","0","0","0","0","4","2","2","0","0","0","0","0","0","0","0","0","-2"
"196176","State University of New York at New Paltz","2019","Tenured, instructors","5","0","5","0","0","0","0","0","0","0","0","0","0","0","0","0","0","0","5","0","5","0","0","0","0","0","0","0","0","0","-2"
"196176","State University of New York at New Paltz","2019","On-Tenure track total","84","36","48","0","0","0","12","8","4","4","2","2","3","1","2","0","0","0","56","20","36","2","1","1","0","0","0","7","4","3","-2"
"196176","State University of New York at New Paltz","2019","On-tenure track, associate professors","12","9","3","0","0","0","3","3","0","0","0","0","0","0","0","0","0","0","9","6","3","0","0","0","0","0","0","0","0","0","-2"
"196176","State University of New York at New Paltz","2019","On-tenure track, assistant professors","68","26","42","0","0","0","9","5","4","4","2","2","3","1","2","0","0","0","43","13","30","2","1","1","0","0","0","7","4","3","-2"
"196176","State University of New York at New Paltz","2019","On-tenure track, instructors","4","1","3","0","0","0","0","0","0","0","0","0","0","0","0","0","0","0","4","1","3","0","0","0","0","0","0","0","0","0","-2"
"196176","State University of New York at New Paltz","2019","Not on tenure track/No tenure system system total","69","29","40","0","0","0","4","4","0","3","1","2","3","0","3","0","0","0","57","24","33","1","0","1","0","0","0","1","0","1","-2"
"196176","State University of New York at New Paltz","2019","Not on tenure/no tenure system, associate professors","1","1","0","0","0","0","0","0","0","0","0","0","0","0","0","0","0","0","1","1","0","0","0","0","0","0","0","0","0","0","-2"
"196176","State University of New York at New Paltz","2019","Not on tenure/no tenure system, assistant professors","3","2","1","0","0","0","1","1","0","0","0","0","0","0","0","0","0","0","2","1","1","0","0","0","0","0","0","0","0","0","-2"
"196176","State University of New York at New Paltz","2019","Not on tenure/no tenure system, lecturers","65","26","39","0","0","0","3","3","0","3","1","2","3","0","3","0","0","0","54","22","32","1","0","1","0","0","0","1","0","1","-2"
"197230","Wells College","2019","Tenured total","20","10","10","0","0","0","0","0","0","1","1","0","1","0","1","2","2","0","16","7","9","0","0","0","0","0","0","0","0","0","-2"
"197230","Wells College","2019","Tenured, professors","13","8","5","0","0","0","0","0","0","1","1","0","1","0","1","1","1","0","10","6","4","0","0","0","0","0","0","0","0","0","-2"
"197230","Wells College","2019","Tenured, associate professors","7","2","5","0","0","0","0","0","0","0","0","0","0","0","0","1","1","0","6","1","5","0","0","0","0","0","0","0","0","0","-2"
"197230","Wells College","2019","On-Tenure track total","11","4","7","0","0","0","0","0","0","0","0","0","0","0","0","0","0","0","10","3","7","1","1","0","0","0","0","0","0","0","-2"
"197230","Wells College","2019","On-tenure track, assistant professors","11","4","7","0","0","0","0","0","0","0","0","0","0","0","0","0","0","0","10","3","7","1","1","0","0","0","0","0","0","0","-2"
"197230","Wells College","2019","Not on tenure track/No tenure system system total","7","3","4","0","0","0","0","0","0","0","0","0","0","0","0","0","0","0","7","3","4","0","0","0","0","0","0","0","0","0","-2"
"197230","Wells College","2019","Not on tenure/no tenure system, assistant professors","4","2","2","0","0","0","0","0","0","0","0","0","0","0","0","0","0","0","4","2","2","0","0","0","0","0","0","0","0","0","-2"
"197230","Wells College","2019","Not on tenure/no tenure system, instructors","2","0","2","0","0","0","0","0","0","0","0","0","0","0","0","0","0","0","2","0","2","0","0","0","0","0","0","0","0","0","-2"
"197230","Wells College","2019","Not on tenure/no tenure system, lecturers","1","1","0","0","0","0","0","0","0","0","0","0","0","0","0","0","0","0","1","1","0","0","0","0","0","0","0","0","0","0","-2"
"199607","Salem College","2019","Tenured total","26","8","18","0","0","0","1","1","0","1","0","1","2","0","2","0","0","0","22","7","15","0","0","0","0","0","0","0","0","0","-2"
"199607","Salem College","2019","Tenured, professors","10","1","9","0","0","0","0","0","0","0","0","0","0","0","0","0","0","0","10","1","9","0","0","0","0","0","0","0","0","0","-2"
"199607","Salem College","2019","Tenured, associate professors","15","6","9","0","0","0","1","1","0","1","0","1","2","0","2","0","0","0","11","5","6","0","0","0","0","0","0","0","0","0","-2"
"199607","Salem College","2019","Tenured, assistant professors","1","1","0","0","0","0","0","0","0","0","0","0","0","0","0","0","0","0","1","1","0","0","0","0","0","0","0","0","0","0","-2"
"199607","Salem College","2019","On-Tenure track total","5","1","4","0","0","0","0","0","0","0","0","0","0","0","0","0","0","0","5","1","4","0","0","0","0","0","0","0","0","0","-2"
"199607","Salem College","2019","On-tenure track, associate professors","2","0","2","0","0","0","0","0","0","0","0","0","0","0","0","0","0","0","2","0","2","0","0","0","0","0","0","0","0","0","-2"
"199607","Salem College","2019","On-tenure track, assistant professors","3","1","2","0","0","0","0","0","0","0","0","0","0","0","0","0","0","0","3","1","2","0","0","0","0","0","0","0","0","0","-2"
"199607","Salem College","2019","Not on tenure track/No tenure system system total","17","0","17","0","0","0","1","0","1","1","0","1","0","0","0","0","0","0","15","0","15","0","0","0","0","0","0","0","0","0","-2"
"199607","Salem College","2019","Not on tenure/no tenure system, associate professors","5","0","5","0","0","0","1","0","1","0","0","0","0","0","0","0","0","0","4","0","4","0","0","0","0","0","0","0","0","0","-2"
"199607","Salem College","2019","Not on tenure/no tenure system, assistant professors","10","0","10","0","0","0","0","0","0","1","0","1","0","0","0","0","0","0","9","0","9","0","0","0","0","0","0","0","0","0","-2"
"199607","Salem College","2019","Not on tenure/no tenure system, instructors","1","0","1","0","0","0","0","0","0","0","0","0","0","0","0","0","0","0","1","0","1","0","0","0","0","0","0","0","0","0","-2"
"199607","Salem College","2019","Not on tenure/no tenure system, no academic rank","1","0","1","0","0","0","0","0","0","0","0","0","0","0","0","0","0","0","1","0","1","0","0","0","0","0","0","0","0","0","-2"
"205027","Pontifical College Josephinum","2019","Not on tenure track/No tenure system system total","19","15","4","0","0","0","0","0","0","0","0","0","0","0","0","0","0","0","19","15","4","0","0","0","0","0","0","0","0","0","-2"
"205027","Pontifical College Josephinum","2019","Not on tenure/no tenure system, professors","3","3","0","0","0","0","0","0","0","0","0","0","0","0","0","0","0","0","3","3","0","0","0","0","0","0","0","0","0","0","-2"
"205027","Pontifical College Josephinum","2019","Not on tenure/no tenure system, associate professors","6","6","0","0","0","0","0","0","0","0","0","0","0","0","0","0","0","0","6","6","0","0","0","0","0","0","0","0","0","0","-2"
"205027","Pontifical College Josephinum","2019","Not on tenure/no tenure system, assistant professors","7","4","3","0","0","0","0","0","0","0","0","0","0","0","0","0","0","0","7","4","3","0","0","0","0","0","0","0","0","0","-2"
"205027","Pontifical College Josephinum","2019","Not on tenure/no tenure system, instructors","3","2","1","0","0","0","0","0","0","0","0","0","0","0","0","0","0","0","3","2","1","0","0","0","0","0","0","0","0","0","-2"
"206862","Southern Nazarene University","2019","Not on tenure track/No tenure system system total","61","33","28","2","1","1","1","1","0","0","0","0","1","1","0","0","0","0","57","30","27","0","0","0","0","0","0","0","0","0","-2"
"206862","Southern Nazarene University","2019","Not on tenure/no tenure system, professors","21","12","9","1","1","0","1","1","0","0","0","0","0","0","0","0","0","0","19","10","9","0","0","0","0","0","0","0","0","0","-2"
"206862","Southern Nazarene University","2019","Not on tenure/no tenure system, associate professors","21","11","10","1","0","1","0","0","0","0","0","0","0","0","0","0","0","0","20","11","9","0","0","0","0","0","0","0","0","0","-2"
"206862","Southern Nazarene University","2019","Not on tenure/no tenure system, assistant professors","17","8","9","0","0","0","0","0","0","0","0","0","1","1","0","0","0","0","16","7","9","0","0","0","0","0","0","0","0","0","-2"
"206862","Southern Nazarene University","2019","Not on tenure/no tenure system, instructors","2","2","0","0","0","0","0","0","0","0","0","0","0","0","0","0","0","0","2","2","0","0","0","0","0","0","0","0","0","0","-2"
"207157","Randall University","2019","Not on tenure track/No tenure system system total","15","8","7","4","1","3","0","0","0","1","1","0","1","1","0","0","0","0","9","5","4","0","0","0","0","0","0","0","0","0","-2"
"207157","Randall University","2019","Not on tenure/no tenure system, no academic rank","15","8","7","4","1","3","0","0","0","1","1","0","1","1","0","0","0","0","9","5","4","0","0","0","0","0","0","0","0","0","-2"
"207397","Oklahoma State University-Oklahoma City","2019","Tenured total","25","9","16","0","0","0","0","0","0","1","1","0","2","1","1","0","0","0","22","7","15","0","0","0","0","0","0","0","0","0","-2"
"207397","Oklahoma State University-Oklahoma City","2019","Tenured, professors","7","4","3","0","0","0","0","0","0","0","0","0","1","1","0","0","0","0","6","3","3","0","0","0","0","0","0","0","0","0","-2"
"207397","Oklahoma State University-Oklahoma City","2019","Tenured, associate professors","18","5","13","0","0","0","0","0","0","1","1","0","1","0","1","0","0","0","16","4","12","0","0","0","0","0","0","0","0","0","-2"
"207397","Oklahoma State University-Oklahoma City","2019","On-Tenure track total","51","18","33","3","0","3","0","0","0","5","1","4","1","1","0","0","0","0","40","16","24","2","0","2","0","0","0","0","0","0","-2"
"207397","Oklahoma State University-Oklahoma City","2019","On-tenure track, assistant professors","23","7","16","1","0","1","0","0","0","0","0","0","1","1","0","0","0","0","19","6","13","2","0","2","0","0","0","0","0","0","-2"
"207397","Oklahoma State University-Oklahoma City","2019","On-tenure track, instructors","28","11","17","2","0","2","0","0","0","5","1","4","0","0","0","0","0","0","21","10","11","0","0","0","0","0","0","0","0","0","-2"
"209065","Linfield University-McMinnville Campus","2019","Tenured total","80","35","45","0","0","0","5","2","3","1","0","1","3","1","2","0","0","0","70","32","38","1","0","1","0","0","0","0","0","0","209065"
"209065","Linfield University-McMinnville Campus","2019","Tenured, professors","43","22","21","0","0","0","2","1","1","0","0","0","2","1","1","0","0","0","38","20","18","1","0","1","0","0","0","0","0","0","209065"
"209065","Linfield University-McMinnville Campus","2019","Tenured, associate professors","35","12","23","0","0","0","3","1","2","1","0","1","1","0","1","0","0","0","30","11","19","0","0","0","0","0","0","0","0","0","209065"
"209065","Linfield University-McMinnville Campus","2019","Tenured, assistant professors","2","1","1","0","0","0","0","0","0","0","0","0","0","0","0","0","0","0","2","1","1","0","0","0","0","0","0","0","0","0","209065"
"209065","Linfield University-McMinnville Campus","2019","On-Tenure track total","29","9","20","1","0","1","2","1","1","0","0","0","3","0","3","1","1","0","19","6","13","1","0","1","2","1","1","0","0","0","209065"
"209065","Linfield University-McMinnville Campus","2019","On-tenure track, associate professors","2","1","1","0","0","0","1","1","0","0","0","0","0","0","0","0","0","0","1","0","1","0","0","0","0","0","0","0","0","0","209065"
"209065","Linfield University-McMinnville Campus","2019","On-tenure track, assistant professors","27","8","19","1","0","1","1","0","1","0","0","0","3","0","3","1","1","0","18","6","12","1","0","1","2","1","1","0","0","0","209065"
"209065","Linfield University-McMinnville Campus","2019","Not on tenure track/No tenure system system total","23","6","17","1","0","1","0","0","0","1","0","1","0","0","0","1","0","1","19","6","13","0","0","0","1","0","1","0","0","0","209065"
"209065","Linfield University-McMinnville Campus","2019","Not on tenure/no tenure system, professors","1","0","1","0","0","0","0","0","0","0","0","0","0","0","0","0","0","0","1","0","1","0","0","0","0","0","0","0","0","0","209065"
"209065","Linfield University-McMinnville Campus","2019","Not on tenure/no tenure system, associate professors","4","1","3","1","0","1","0","0","0","0","0","0","0","0","0","0","0","0","2","1","1","0","0","0","1","0","1","0","0","0","209065"
"209065","Linfield University-McMinnville Campus","2019","Not on tenure/no tenure system, assistant professors","18","5","13","0","0","0","0","0","0","1","0","1","0","0","0","1","0","1","16","5","11","0","0","0","0","0","0","0","0","0","209065"
"209287","Multnomah University","2019","Tenured total","4","3","1","0","0","0","0","0","0","0","0","0","0","0","0","0","0","0","4","3","1","0","0","0","0","0","0","0","0","0","-2"
"209287","Multnomah University","2019","Tenured, professors","4","3","1","0","0","0","0","0","0","0","0","0","0","0","0","0","0","0","4","3","1","0","0","0","0","0","0","0","0","0","-2"
"209287","Multnomah University","2019","Not on tenure track/No tenure system system total","23","15","8","0","0","0","2","1","1","0","0","0","0","0","0","0","0","0","21","14","7","0","0","0","0","0","0","0","0","0","-2"
"209287","Multnomah University","2019","Not on tenure/no tenure system, professors","5","5","0","0","0","0","0","0","0","0","0","0","0","0","0","0","0","0","5","5","0","0","0","0","0","0","0","0","0","0","-2"
"209287","Multnomah University","2019","Not on tenure/no tenure system, associate professors","8","5","3","0","0","0","2","1","1","0","0","0","0","0","0","0","0","0","6","4","2","0","0","0","0","0","0","0","0","0","-2"
"209287","Multnomah University","2019","Not on tenure/no tenure system, assistant professors","10","5","5","0","0","0","0","0","0","0","0","0","0","0","0","0","0","0","10","5","5","0","0","0","0","0","0","0","0","0","-2"
"209490","Oregon Health & Science University","2019","Tenured total","84","51","33","0","0","0","14","11","3","0","0","0","1","0","1","0","0","0","65","39","26","0","0","0","4","1","3","0","0","0","-2"
"209490","Oregon Health & Science University","2019","Tenured, professors","66","43","23","0","0","0","10","7","3","0","0","0","1","0","1","0","0","0","53","35","18","0","0","0","2","1","1","0","0","0","-2"
"209490","Oregon Health & Science University","2019","Tenured, associate professors","18","8","10","0","0","0","4","4","0","0","0","0","0","0","0","0","0","0","12","4","8","0","0","0","2","0","2","0","0","0","-2"
"209490","Oregon Health & Science University","2019","On-Tenure track total","48","33","15","0","0","0","5","4","1","2","2","0","4","2","2","1","0","1","27","18","9","0","0","0","4","3","1","5","4","1","-2"
"209490","Oregon Health & Science University","2019","On-tenure track, professors","6","4","2","0","0","0","0","0","0","0","0","0","0","0","0","0","0","0","5","3","2","0","0","0","1","1","0","0","0","0","-2"
"209490","Oregon Health & Science University","2019","On-tenure track, associate professors","20","13","7","0","0","0","1","1","0","1","1","0","3","1","2","1","0","1","12","8","4","0","0","0","0","0","0","2","2","0","-2"
"209490","Oregon Health & Science University","2019","On-tenure track, assistant professors","22","16","6","0","0","0","4","3","1","1","1","0","1","1","0","0","0","0","10","7","3","0","0","0","3","2","1","3","2","1","-2"
"209490","Oregon Health & Science University","2019","Not on tenure track/No tenure system system total","1563","653","910","3","0","3","199","94","105","21","11","10","48","28","20","1","0","1","1073","422","651","10","3","7","180","81","99","28","14","14","-2"
"209490","Oregon Health & Science University","2019","Not on tenure/no tenure system, professors","160","103","57","0","0","0","17","11","6","1","1","0","5","5","0","0","0","0","126","80","46","0","0","0","11","6","5","0","0","0","-2"
"209490","Oregon Health & Science University","2019","Not on tenure/no tenure system, associate professors","283","147","136","1","0","1","45","27","18","2","2","0","11","8","3","0","0","0","194","94","100","4","2","2","24","14","10","2","0","2","-2"
"209490","Oregon Health & Science University","2019","Not on tenure/no tenure system, assistant professors","665","286","379","1","0","1","96","43","53","13","7","6","16","9","7","0","0","0","416","170","246","5","1","4","97","44","53","21","12","9","-2"
"209490","Oregon Health & Science University","2019","Not on tenure/no tenure system, instructors","447","117","330","1","0","1","41","13","28","5","1","4","16","6","10","1","0","1","330","78","252","1","0","1","47","17","30","5","2","3","-2"
"209490","Oregon Health & Science University","2019","Not on tenure/no tenure system, lecturers","8","0","8","0","0","0","0","0","0","0","0","0","0","0","0","0","0","0","7","0","7","0","0","0","1","0","1","0","0","0","-2"
"209612","Pacific University","2019","Tenured total","129","72","57","0","0","0","9","3","6","1","0","1","4","1","3","0","0","0","112","65","47","3","3","0","0","0","0","0","0","0","-2"
"209612","Pacific University","2019","Tenured, professors","69","42","27","0","0","0","2","1","1","0","0","0","2","0","2","0","0","0","64","40","24","1","1","0","0","0","0","0","0","0","-2"
"209612","Pacific University","2019","Tenured, associate professors","59","29","30","0","0","0","7","2","5","1","0","1","2","1","1","0","0","0","47","24","23","2","2","0","0","0","0","0","0","0","-2"
"209612","Pacific University","2019","Tenured, assistant professors","1","1","0","0","0","0","0","0","0","0","0","0","0","0","0","0","0","0","1","1","0","0","0","0","0","0","0","0","0","0","-2"
"209612","Pacific University","2019","On-Tenure track total","60","23","37","2","1","1","7","1","6","1","1","0","4","2","2","0","0","0","35","14","21","4","1","3","3","1","2","4","2","2","-2"
"209612","Pacific University","2019","On-tenure track, professors","1","1","0","0","0","0","0","0","0","0","0","0","0","0","0","0","0","0","1","1","0","0","0","0","0","0","0","0","0","0","-2"
"209612","Pacific University","2019","On-tenure track, associate professors","9","3","6","0","0","0","1","1","0","0","0","0","0","0","0","0","0","0","5","1","4","1","1","0","1","0","1","1","0","1","-2"
"209612","Pacific University","2019","On-tenure track, assistant professors","50","19","31","2","1","1","6","0","6","1","1","0","4","2","2","0","0","0","29","12","17","3","0","3","2","1","1","3","2","1","-2"
"209612","Pacific University","2019","Not on tenure track/No tenure system system total","100","37","63","1","1","0","6","3","3","1","0","1","7","0","7","0","0","0","77","29","48","4","3","1","4","1","3","0","0","0","-2"
"209612","Pacific University","2019","Not on tenure/no tenure system, professors","3","2","1","0","0","0","0","0","0","0","0","0","0","0","0","0","0","0","3","2","1","0","0","0","0","0","0","0","0","0","-2"
"209612","Pacific University","2019","Not on tenure/no tenure system, associate professors","14","8","6","1","1","0","0","0","0","0","0","0","0","0","0","0","0","0","13","7","6","0","0","0","0","0","0","0","0","0","-2"
"209612","Pacific University","2019","Not on tenure/no tenure system, assistant professors","66","21","45","0","0","0","6","3","3","1","0","1","3","0","3","0","0","0","50","15","35","3","3","0","3","0","3","0","0","0","-2"
"209612","Pacific University","2019","Not on tenure/no tenure system, instructors","16","5","11","0","0","0","0","0","0","0","0","0","4","0","4","0","0","0","11","5","6","1","0","1","0","0","0","0","0","0","-2"
"209612","Pacific University","2019","Not on tenure/no tenure system, no academic rank","1","1","0","0","0","0","0","0","0","0","0","0","0","0","0","0","0","0","0","0","0","0","0","0","1","1","0","0","0","0","-2"
"209807","Portland State University","2019","Tenured total","379","231","148","4","0","4","49","30","19","9","5","4","23","14","9","0","0","0","252","155","97","8","4","4","34","23","11","0","0","0","-2"
"209807","Portland State University","2019","Tenured, professors","195","133","62","2","0","2","26","19","7","3","2","1","12","8","4","0","0","0","130","90","40","3","1","2","19","13","6","0","0","0","-2"
"209807","Portland State University","2019","Tenured, associate professors","183","97","86","2","0","2","23","11","12","6","3","3","11","6","5","0","0","0","121","64","57","5","3","2","15","10","5","0","0","0","-2"
"209807","Portland State University","2019","Tenured, assistant professors","1","1","0","0","0","0","0","0","0","0","0","0","0","0","0","0","0","0","1","1","0","0","0","0","0","0","0","0","0","0","-2"
"209807","Portland State University","2019","On-Tenure track total","125","50","75","0","0","0","16","7","9","6","1","5","16","10","6","0","0","0","75","28","47","7","2","5","5","2","3","0","0","0","-2"
"209807","Portland State University","2019","On-tenure track, professors","2","1","1","0","0","0","0","0","0","0","0","0","0","0","0","0","0","0","2","1","1","0","0","0","0","0","0","0","0","0","-2"
"209807","Portland State University","2019","On-tenure track, associate professors","2","2","0","0","0","0","1","1","0","0","0","0","0","0","0","0","0","0","1","1","0","0","0","0","0","0","0","0","0","0","-2"
"209807","Portland State University","2019","On-tenure track, assistant professors","121","47","74","0","0","0","15","6","9","6","1","5","16","10","6","0","0","0","72","26","46","7","2","5","5","2","3","0","0","0","-2"
"209807","Portland State University","2019","Not on tenure track/No tenure system system total","260","104","156","2","1","1","15","4","11","6","3","3","15","6","9","1","1","0","186","72","114","11","4","7","20","11","9","4","2","2","-2"
"209807","Portland State University","2019","Not on tenure/no tenure system, professors","12","7","5","0","0","0","0","0","0","0","0","0","0","0","0","0","0","0","12","7","5","0","0","0","0","0","0","0","0","0","-2"
"209807","Portland State University","2019","Not on tenure/no tenure system, associate professors","17","12","5","0","0","0","1","1","0","0","0","0","0","0","0","0","0","0","14","9","5","0","0","0","1","1","0","1","1","0","-2"
"209807","Portland State University","2019","Not on tenure/no tenure system, assistant professors","76","27","49","1","0","1","2","0","2","3","1","2","8","2","6","1","1","0","46","16","30","5","0","5","9","6","3","1","1","0","-2"
"209807","Portland State University","2019","Not on tenure/no tenure system, instructors","154","57","97","1","1","0","12","3","9","3","2","1","7","4","3","0","0","0","113","39","74","6","4","2","10","4","6","2","0","2","-2"
"209807","Portland State University","2019","Not on tenure/no tenure system, no academic rank","1","1","0","0","0","0","0","0","0","0","0","0","0","0","0","0","0","0","1","1","0","0","0","0","0","0","0","0","0","0","-2"
"210429","Western Oregon University","2019","Tenured total","132","65","67","0","0","0","5","1","4","3","2","1","7","2","5","0","0","0","112","58","54","0","0","0","4","2","2","1","0","1","-2"
"210429","Western Oregon University","2019","Tenured, professors","77","41","36","0","0","0","3","1","2","2","1","1","1","0","1","0","0","0","70","38","32","0","0","0","1","1","0","0","0","0","-2"
"210429","Western Oregon University","2019","Tenured, associate professors","54","24","30","0","0","0","2","0","2","1","1","0","6","2","4","0","0","0","41","20","21","0","0","0","3","1","2","1","0","1","-2"
"210429","Western Oregon University","2019","Tenured, assistant professors","1","0","1","0","0","0","0","0","0","0","0","0","0","0","0","0","0","0","1","0","1","0","0","0","0","0","0","0","0","0","-2"
"210429","Western Oregon University","2019","On-Tenure track total","34","11","23","0","0","0","1","0","1","0","0","0","1","1","0","0","0","0","19","7","12","0","0","0","8","3","5","5","0","5","-2"
"210429","Western Oregon University","2019","On-tenure track, associate professors","1","1","0","0","0","0","0","0","0","0","0","0","0","0","0","0","0","0","1","1","0","0","0","0","0","0","0","0","0","0","-2"
"210429","Western Oregon University","2019","On-tenure track, assistant professors","33","10","23","0","0","0","1","0","1","0","0","0","1","1","0","0","0","0","18","6","12","0","0","0","8","3","5","5","0","5","-2"
"210429","Western Oregon University","2019","Not on tenure track/No tenure system system total","130","59","71","1","1","0","4","2","2","1","0","1","6","0","6","0","0","0","90","40","50","1","0","1","25","14","11","2","2","0","-2"
"210429","Western Oregon University","2019","Not on tenure/no tenure system, professors","1","1","0","0","0","0","0","0","0","0","0","0","0","0","0","0","0","0","1","1","0","0","0","0","0","0","0","0","0","0","-2"
"210429","Western Oregon University","2019","Not on tenure/no tenure system, assistant professors","53","26","27","1","1","0","2","1","1","0","0","0","1","0","1","0","0","0","32","13","19","0","0","0","16","10","6","1","1","0","-2"
"210429","Western Oregon University","2019","Not on tenure/no tenure system, instructors","71","31","40","0","0","0","2","1","1","1","0","1","5","0","5","0","0","0","53","25","28","1","0","1","8","4","4","1","1","0","-2"
"210429","Western Oregon University","2019","Not on tenure/no tenure system, lecturers","5","1","4","0","0","0","0","0","0","0","0","0","0","0","0","0","0","0","4","1","3","0","0","0","1","0","1","0","0","0","-2"
"210571","Albright College","2019","Tenured total","53","32","21","1","1","0","2","1","1","3","0","3","1","0","1","0","0","0","44","28","16","0","0","0","2","2","0","0","0","0","-2"
"210571","Albright College","2019","Tenured, professors","23","14","9","1","1","0","0","0","0","2","0","2","0","0","0","0","0","0","18","11","7","0","0","0","2","2","0","0","0","0","-2"
"210571","Albright College","2019","Tenured, associate professors","30","18","12","0","0","0","2","1","1","1","0","1","1","0","1","0","0","0","26","17","9","0","0","0","0","0","0","0","0","0","-2"
"210571","Albright College","2019","On-Tenure track total","27","14","13","0","0","0","1","1","0","1","0","1","2","1","1","0","0","0","19","9","10","0","0","0","4","3","1","0","0","0","-2"
"210571","Albright College","2019","On-tenure track, associate professors","5","1","4","0","0","0","0","0","0","1","0","1","0","0","0","0","0","0","4","1","3","0","0","0","0","0","0","0","0","0","-2"
"210571","Albright College","2019","On-tenure track, assistant professors","22","13","9","0","0","0","1","1","0","0","0","0","2","1","1","0","0","0","15","8","7","0","0","0","4","3","1","0","0","0","-2"
"210571","Albright College","2019","Not on tenure track/No tenure system system total","28","7","21","0","0","0","4","1","3","0","0","0","2","0","2","0","0","0","19","6","13","0","0","0","3","0","3","0","0","0","-2"
"210571","Albright College","2019","Not on tenure/no tenure system, associate professors","2","2","0","0","0","0","0","0","0","0","0","0","0","0","0","0","0","0","2","2","0","0","0","0","0","0","0","0","0","0","-2"
"210571","Albright College","2019","Not on tenure/no tenure system, assistant professors","11","2","9","0","0","0","2","1","1","0","0","0","0","0","0","0","0","0","8","1","7","0","0","0","1","0","1","0","0","0","-2"
"210571","Albright College","2019","Not on tenure/no tenure system, instructors","15","3","12","0","0","0","2","0","2","0","0","0","2","0","2","0","0","0","9","3","6","0","0","0","2","0","2","0","0","0","-2"
"212133","Eastern University","2019","Tenured total","48","27","21","0","0","0","5","3","2","6","5","1","2","1","1","0","0","0","35","18","17","0","0","0","0","0","0","0","0","0","-2"
"212133","Eastern University","2019","Tenured, professors","31","19","12","0","0","0","4","2","2","2","2","0","2","1","1","0","0","0","23","14","9","0","0","0","0","0","0","0","0","0","-2"
"212133","Eastern University","2019","Tenured, associate professors","17","8","9","0","0","0","1","1","0","4","3","1","0","0","0","0","0","0","12","4","8","0","0","0","0","0","0","0","0","0","-2"
"212133","Eastern University","2019","On-Tenure track total","26","8","18","0","0","0","2","0","2","3","1","2","0","0","0","0","0","0","20","7","13","1","0","1","0","0","0","0","0","0","-2"
"212133","Eastern University","2019","On-tenure track, associate professors","5","2","3","0","0","0","0","0","0","0","0","0","0","0","0","0","0","0","5","2","3","0","0","0","0","0","0","0","0","0","-2"
"212133","Eastern University","2019","On-tenure track, assistant professors","21","6","15","0","0","0","2","0","2","3","1","2","0","0","0","0","0","0","15","5","10","1","0","1","0","0","0","0","0","0","-2"
"212133","Eastern University","2019","Not on tenure track/No tenure system system total","32","10","22","0","0","0","0","0","0","2","0","2","2","0","2","0","0","0","27","10","17","1","0","1","0","0","0","0","0","0","-2"
"212133","Eastern University","2019","Not on tenure/no tenure system, assistant professors","1","0","1","0","0","0","0","0","0","0","0","0","0","0","0","0","0","0","1","0","1","0","0","0","0","0","0","0","0","0","-2"
"212133","Eastern University","2019","Not on tenure/no tenure system, lecturers","25","7","18","0","0","0","0","0","0","2","0","2","2","0","2","0","0","0","20","7","13","1","0","1","0","0","0","0","0","0","-2"
"212133","Eastern University","2019","Not on tenure/no tenure system, no academic rank","6","3","3","0","0","0","0","0","0","0","0","0","0","0","0","0","0","0","6","3","3","0","0","0","0","0","0","0","0","0","-2"
"213367","La Salle University","2019","Tenured total","124","63","61","0","0","0","8","4","4","2","1","1","4","2","2","0","0","0","108","54","54","1","1","0","0","0","0","1","1","0","-2"
"213367","La Salle University","2019","Tenured, professors","38","23","15","0","0","0","2","1","1","1","1","0","2","2","0","0","0","0","32","18","14","1","1","0","0","0","0","0","0","0","-2"
"213367","La Salle University","2019","Tenured, associate professors","81","37","44","0","0","0","6","3","3","1","0","1","2","0","2","0","0","0","71","33","38","0","0","0","0","0","0","1","1","0","-2"
"213367","La Salle University","2019","Tenured, assistant professors","5","3","2","0","0","0","0","0","0","0","0","0","0","0","0","0","0","0","5","3","2","0","0","0","0","0","0","0","0","0","-2"
"213367","La Salle University","2019","On-Tenure track total","44","13","31","0","0","0","3","1","2","2","1","1","2","1","1","0","0","0","35","9","26","0","0","0","0","0","0","2","1","1","-2"
"213367","La Salle University","2019","On-tenure track, professors","1","0","1","0","0","0","0","0","0","0","0","0","0","0","0","0","0","0","1","0","1","0","0","0","0","0","0","0","0","0","-2"
"213367","La Salle University","2019","On-tenure track, associate professors","4","1","3","0","0","0","0","0","0","0","0","0","1","1","0","0","0","0","3","0","3","0","0","0","0","0","0","0","0","0","-2"
"213367","La Salle University","2019","On-tenure track, assistant professors","39","12","27","0","0","0","3","1","2","2","1","1","1","0","1","0","0","0","31","9","22","0","0","0","0","0","0","2","1","1","-2"
"213367","La Salle University","2019","Not on tenure track/No tenure system system total","45","12","33","0","0","0","0","0","0","4","1","3","1","1","0","0","0","0","40","10","30","0","0","0","0","0","0","0","0","0","-2"
"213367","La Salle University","2019","Not on tenure/no tenure system, associate professors","2","0","2","0","0","0","0","0","0","0","0","0","0","0","0","0","0","0","2","0","2","0","0","0","0","0","0","0","0","0","-2"
"213367","La Salle University","2019","Not on tenure/no tenure system, assistant professors","33","11","22","0","0","0","0","0","0","3","1","2","1","1","0","0","0","0","29","9","20","0","0","0","0","0","0","0","0","0","-2"
"213367","La Salle University","2019","Not on tenure/no tenure system, instructors","10","1","9","0","0","0","0","0","0","1","0","1","0","0","0","0","0","0","9","1","8","0","0","0","0","0","0","0","0","0","-2"
"213774","Manor College","2019","Not on tenure track/No tenure system system total","34","10","24","0","0","0","0","0","0","4","2","2","0","0","0","0","0","0","30","8","22","0","0","0","0","0","0","0","0","0","-2"
"213774","Manor College","2019","Not on tenure/no tenure system, professors","9","3","6","0","0","0","0","0","0","1","0","1","0","0","0","0","0","0","8","3","5","0","0","0","0","0","0","0","0","0","-2"
"213774","Manor College","2019","Not on tenure/no tenure system, associate professors","1","1","0","0","0","0","0","0","0","0","0","0","0","0","0","0","0","0","1","1","0","0","0","0","0","0","0","0","0","0","-2"
"213774","Manor College","2019","Not on tenure/no tenure system, assistant professors","8","2","6","0","0","0","0","0","0","0","0","0","0","0","0","0","0","0","8","2","6","0","0","0","0","0","0","0","0","0","-2"
"213774","Manor College","2019","Not on tenure/no tenure system, instructors","16","4","12","0","0","0","0","0","0","3","2","1","0","0","0","0","0","0","13","2","11","0","0","0","0","0","0","0","0","0","-2"
"216542","University of Valley Forge","2019","Not on tenure track/No tenure system system total","25","14","11","0","0","0","0","0","0","1","0","1","0","0","0","1","0","1","23","14","9","0","0","0","0","0","0","0","0","0","-2"
"216542","University of Valley Forge","2019","Not on tenure/no tenure system, professors","7","4","3","0","0","0","0","0","0","0","0","0","0","0","0","1","0","1","6","4","2","0","0","0","0","0","0","0","0","0","-2"
"216542","University of Valley Forge","2019","Not on tenure/no tenure system, associate professors","6","5","1","0","0","0","0","0","0","0","0","0","0","0","0","0","0","0","6","5","1","0","0","0","0","0","0","0","0","0","-2"
"216542","University of Valley Forge","2019","Not on tenure/no tenure system, assistant professors","12","5","7","0","0","0","0","0","0","1","0","1","0","0","0","0","0","0","11","5","6","0","0","0","0","0","0","0","0","0","-2"
"217420","Rhode Island College","2019","Tenured total","236","94","142","1","0","1","18","5","13","4","1","3","8","5","3","2","2","0","199","78","121","4","3","1","0","0","0","0","0","0","-2"
"217420","Rhode Island College","2019","Tenured, professors","119","51","68","1","0","1","9","3","6","1","0","1","1","1","0","1","1","0","105","45","60","1","1","0","0","0","0","0","0","0","-2"
"217420","Rhode Island College","2019","Tenured, associate professors","110","41","69","0","0","0","8","1","7","3","1","2","7","4","3","1","1","0","88","32","56","3","2","1","0","0","0","0","0","0","-2"
"217420","Rhode Island College","2019","Tenured, assistant professors","7","2","5","0","0","0","1","1","0","0","0","0","0","0","0","0","0","0","6","1","5","0","0","0","0","0","0","0","0","0","-2"
"217420","Rhode Island College","2019","On-Tenure track total","65","23","42","0","0","0","5","2","3","4","0","4","3","2","1","1","1","0","51","17","34","1","1","0","0","0","0","0","0","0","-2"
"217420","Rhode Island College","2019","On-tenure track, assistant professors","65","23","42","0","0","0","5","2","3","4","0","4","3","2","1","1","1","0","51","17","34","1","1","0","0","0","0","0","0","0","-2"
"217420","Rhode Island College","2019","Not on tenure track/No tenure system system total","30","5","25","1","0","1","3","1","2","0","0","0","2","1","1","0","0","0","24","3","21","0","0","0","0","0","0","0","0","0","-2"
"217420","Rhode Island College","2019","Not on tenure/no tenure system, assistant professors","30","5","25","1","0","1","3","1","2","0","0","0","2","1","1","0","0","0","24","3","21","0","0","0","0","0","0","0","0","0","-2"
"221661","Southern Adventist University","2019","Not on tenure track/No tenure system system total","138","63","75","1","0","1","3","1","2","8","1","7","10","4","6","1","1","0","112","54","58","0","0","0","3","2","1","0","0","0","-2"
"221661","Southern Adventist University","2019","Not on tenure/no tenure system, professors","55","28","27","0","0","0","1","0","1","3","1","2","1","0","1","0","0","0","50","27","23","0","0","0","0","0","0","0","0","0","-2"
"221661","Southern Adventist University","2019","Not on tenure/no tenure system, associate professors","60","30","30","0","0","0","1","1","0","2","0","2","6","4","2","1","1","0","49","23","26","0","0","0","1","1","0","0","0","0","-2"
"221661","Southern Adventist University","2019","Not on tenure/no tenure system, assistant professors","23","5","18","1","0","1","1","0","1","3","0","3","3","0","3","0","0","0","13","4","9","0","0","0","2","1","1","0","0","0","-2"
"222178","Abilene Christian University","2019","Tenured total","131","96","35","1","1","0","3","2","1","5","3","2","4","2","2","0","0","0","115","86","29","3","2","1","0","0","0","0","0","0","-2"
"222178","Abilene Christian University","2019","Tenured, professors","58","48","10","1","1","0","1","1","0","1","0","1","2","0","2","0","0","0","51","45","6","2","1","1","0","0","0","0","0","0","-2"
"222178","Abilene Christian University","2019","Tenured, associate professors","68","45","23","0","0","0","1","0","1","4","3","1","2","2","0","0","0","0","60","39","21","1","1","0","0","0","0","0","0","0","-2"
"222178","Abilene Christian University","2019","Tenured, assistant professors","5","3","2","0","0","0","1","1","0","0","0","0","0","0","0","0","0","0","4","2","2","0","0","0","0","0","0","0","0","0","-2"
"222178","Abilene Christian University","2019","On-Tenure track total","43","26","17","0","0","0","0","0","0","3","2","1","4","3","1","0","0","0","36","21","15","0","0","0","0","0","0","0","0","0","-2"
"222178","Abilene Christian University","2019","On-tenure track, associate professors","2","2","0","0","0","0","0","0","0","0","0","0","0","0","0","0","0","0","2","2","0","0","0","0","0","0","0","0","0","0","-2"
"222178","Abilene Christian University","2019","On-tenure track, assistant professors","38","23","15","0","0","0","0","0","0","3","2","1","3","3","0","0","0","0","32","18","14","0","0","0","0","0","0","0","0","0","-2"
"222178","Abilene Christian University","2019","On-tenure track, no academic rank","3","1","2","0","0","0","0","0","0","0","0","0","1","0","1","0","0","0","2","1","1","0","0","0","0","0","0","0","0","0","-2"
"222178","Abilene Christian University","2019","Not on tenure track/No tenure system system total","91","32","59","0","0","0","0","0","0","6","2","4","5","3","2","0","0","0","77","24","53","0","0","0","0","0","0","3","3","0","-2"
"222178","Abilene Christian University","2019","Not on tenure/no tenure system, professors","1","0","1","0","0","0","0","0","0","0","0","0","0","0","0","0","0","0","1","0","1","0","0","0","0","0","0","0","0","0","-2"
"222178","Abilene Christian University","2019","Not on tenure/no tenure system, associate professors","8","5","3","0","0","0","0","0","0","1","1","0","1","1","0","0","0","0","6","3","3","0","0","0","0","0","0","0","0","0","-2"
"222178","Abilene Christian University","2019","Not on tenure/no tenure system, assistant professors","15","4","11","0","0","0","0","0","0","0","0","0","1","1","0","0","0","0","14","3","11","0","0","0","0","0","0","0","0","0","-2"
"222178","Abilene Christian University","2019","Not on tenure/no tenure system, instructors","34","10","24","0","0","0","0","0","0","2","1","1","2","1","1","0","0","0","29","7","22","0","0","0","0","0","0","1","1","0","-2"
"222178","Abilene Christian University","2019","Not on tenure/no tenure system, no academic rank","33","13","20","0","0","0","0","0","0","3","0","3","1","0","1","0","0","0","27","11","16","0","0","0","0","0","0","2","2","0","-2"
"222983","Austin College","2019","Tenured total","67","45","22","1","1","0","2","1","1","1","0","1","4","1","3","0","0","0","57","40","17","0","0","0","2","2","0","0","0","0","-2"
"222983","Austin College","2019","Tenured, professors","29","20","9","1","1","0","0","0","0","1","0","1","2","0","2","0","0","0","24","18","6","0","0","0","1","1","0","0","0","0","-2"
"222983","Austin College","2019","Tenured, associate professors","38","25","13","0","0","0","2","1","1","0","0","0","2","1","1","0","0","0","33","22","11","0","0","0","1","1","0","0","0","0","-2"
"222983","Austin College","2019","On-Tenure track total","25","14","11","0","0","0","4","2","2","2","2","0","0","0","0","0","0","0","14","8","6","0","0","0","4","2","2","1","0","1","-2"
"222983","Austin College","2019","On-tenure track, assistant professors","25","14","11","0","0","0","4","2","2","2","2","0","0","0","0","0","0","0","14","8","6","0","0","0","4","2","2","1","0","1","-2"
"222983","Austin College","2019","Not on tenure track/No tenure system system total","9","1","8","1","0","1","0","0","0","0","0","0","0","0","0","0","0","0","6","1","5","0","0","0","2","0","2","0","0","0","-2"
"222983","Austin College","2019","Not on tenure/no tenure system, assistant professors","5","1","4","0","0","0","0","0","0","0","0","0","0","0","0","0","0","0","4","1","3","0","0","0","1","0","1","0","0","0","-2"
"222983","Austin College","2019","Not on tenure/no tenure system, instructors","4","0","4","1","0","1","0","0","0","0","0","0","0","0","0","0","0","0","2","0","2","0","0","0","1","0","1","0","0","0","-2"
"223232","Baylor University","2019","Tenured total","524","379","145","0","0","0","35","28","7","12","6","6","21","16","5","1","1","0","436","313","123","13","10","3","0","0","0","6","5","1","-2"
"223232","Baylor University","2019","Tenured, professors","281","225","56","0","0","0","8","7","1","7","4","3","9","8","1","1","1","0","241","193","48","10","8","2","0","0","0","5","4","1","-2"
"223232","Baylor University","2019","Tenured, associate professors","243","154","89","0","0","0","27","21","6","5","2","3","12","8","4","0","0","0","195","120","75","3","2","1","0","0","0","1","1","0","-2"
"223232","Baylor University","2019","On-Tenure track total","178","90","88","0","0","0","19","11","8","12","5","7","8","5","3","0","0","0","122","57","65","2","2","0","4","3","1","11","7","4","-2"
"223232","Baylor University","2019","On-tenure track, associate professors","17","12","5","0","0","0","4","3","1","1","1","0","0","0","0","0","0","0","12","8","4","0","0","0","0","0","0","0","0","0","-2"
"223232","Baylor University","2019","On-tenure track, assistant professors","161","78","83","0","0","0","15","8","7","11","4","7","8","5","3","0","0","0","110","49","61","2","2","0","4","3","1","11","7","4","-2"
"223232","Baylor University","2019","Not on tenure track/No tenure system system total","442","174","268","0","0","0","12","4","8","11","3","8","22","8","14","0","0","0","370","149","221","9","4","5","7","2","5","11","4","7","-2"
"223232","Baylor University","2019","Not on tenure/no tenure system, professors","13","5","8","0","0","0","0","0","0","0","0","0","1","1","0","0","0","0","12","4","8","0","0","0","0","0","0","0","0","0","-2"
"223232","Baylor University","2019","Not on tenure/no tenure system, associate professors","33","9","24","0","0","0","1","1","0","1","1","0","0","0","0","0","0","0","30","7","23","0","0","0","1","0","1","0","0","0","-2"
"223232","Baylor University","2019","Not on tenure/no tenure system, assistant professors","69","23","46","0","0","0","2","0","2","3","0","3","2","1","1","0","0","0","60","20","40","1","1","0","0","0","0","1","1","0","-2"
"223232","Baylor University","2019","Not on tenure/no tenure system, instructors","6","0","6","0","0","0","0","0","0","1","0","1","0","0","0","0","0","0","5","0","5","0","0","0","0","0","0","0","0","0","-2"
"223232","Baylor University","2019","Not on tenure/no tenure system, lecturers","321","137","184","0","0","0","9","3","6","6","2","4","19","6","13","0","0","0","263","118","145","8","3","5","6","2","4","10","3","7","-2"
"224226","Dallas Baptist University","2019","Not on tenure track/No tenure system system total","127","77","50","0","0","0","9","8","1","4","1","3","5","3","2","0","0","0","109","65","44","0","0","0","0","0","0","0","0","0","-2"
"224226","Dallas Baptist University","2019","Not on tenure/no tenure system, professors","57","33","24","0","0","0","4","3","1","2","1","1","2","2","0","0","0","0","49","27","22","0","0","0","0","0","0","0","0","0","-2"
"224226","Dallas Baptist University","2019","Not on tenure/no tenure system, associate professors","18","12","6","0","0","0","0","0","0","0","0","0","2","1","1","0","0","0","16","11","5","0","0","0","0","0","0","0","0","0","-2"
"224226","Dallas Baptist University","2019","Not on tenure/no tenure system, assistant professors","52","32","20","0","0","0","5","5","0","2","0","2","1","0","1","0","0","0","44","27","17","0","0","0","0","0","0","0","0","0","-2"
"224244","Dallas Christian College","2019","Not on tenure track/No tenure system system total","7","4","3","0","0","0","0","0","0","1","1","0","0","0","0","0","0","0","6","3","3","0","0","0","0","0","0","0","0","0","-2"
"224244","Dallas Christian College","2019","Not on tenure/no tenure system, professors","2","2","0","0","0","0","0","0","0","0","0","0","0","0","0","0","0","0","2","2","0","0","0","0","0","0","0","0","0","0","-2"
"224244","Dallas Christian College","2019","Not on tenure/no tenure system, associate professors","4","2","2","0","0","0","0","0","0","1","1","0","0","0","0","0","0","0","3","1","2","0","0","0","0","0","0","0","0","0","-2"
"224244","Dallas Christian College","2019","Not on tenure/no tenure system, instructors","1","0","1","0","0","0","0","0","0","0","0","0","0","0","0","0","0","0","1","0","1","0","0","0","0","0","0","0","0","0","-2"
"224323","University of Dallas","2019","Tenured total","84","60","24","0","0","0","1","0","1","1","1","0","8","5","3","0","0","0","70","53","17","2","0","2","2","1","1","0","0","0","-2"
"224323","University of Dallas","2019","Tenured, professors","19","16","3","0","0","0","0","0","0","0","0","0","0","0","0","0","0","0","19","16","3","0","0","0","0","0","0","0","0","0","-2"
"224323","University of Dallas","2019","Tenured, associate professors","60","40","20","0","0","0","1","0","1","1","1","0","7","4","3","0","0","0","48","34","14","1","0","1","2","1","1","0","0","0","-2"
"224323","University of Dallas","2019","Tenured, assistant professors","5","4","1","0","0","0","0","0","0","0","0","0","1","1","0","0","0","0","3","3","0","1","0","1","0","0","0","0","0","0","-2"
"224323","University of Dallas","2019","On-Tenure track total","30","15","15","0","0","0","2","1","1","2","1","1","3","2","1","0","0","0","21","10","11","1","1","0","1","0","1","0","0","0","-2"
"224323","University of Dallas","2019","On-tenure track, professors","1","1","0","0","0","0","0","0","0","0","0","0","0","0","0","0","0","0","1","1","0","0","0","0","0","0","0","0","0","0","-2"
"224323","University of Dallas","2019","On-tenure track, associate professors","3","1","2","0","0","0","2","1","1","0","0","0","0","0","0","0","0","0","1","0","1","0","0","0","0","0","0","0","0","0","-2"
"224323","University of Dallas","2019","On-tenure track, assistant professors","26","13","13","0","0","0","0","0","0","2","1","1","3","2","1","0","0","0","19","9","10","1","1","0","1","0","1","0","0","0","-2"
"224323","University of Dallas","2019","Not on tenure track/No tenure system system total","30","13","17","0","0","0","0","0","0","0","0","0","3","1","2","0","0","0","26","12","14","0","0","0","1","0","1","0","0","0","-2"
"224323","University of Dallas","2019","Not on tenure/no tenure system, instructors","30","13","17","0","0","0","0","0","0","0","0","0","3","1","2","0","0","0","26","12","14","0","0","0","1","0","1","0","0","0","-2"
"224545","Texas A&M University-Texarkana","2019","Tenured total","30","22","8","0","0","0","3","3","0","1","1","0","1","0","1","0","0","0","24","17","7","0","0","0","1","1","0","0","0","0","-2"
"224545","Texas A&M University-Texarkana","2019","Tenured, professors","16","12","4","0","0","0","2","2","0","1","1","0","1","0","1","0","0","0","12","9","3","0","0","0","0","0","0","0","0","0","-2"
"224545","Texas A&M University-Texarkana","2019","Tenured, associate professors","14","10","4","0","0","0","1","1","0","0","0","0","0","0","0","0","0","0","12","8","4","0","0","0","1","1","0","0","0","0","-2"
"224545","Texas A&M University-Texarkana","2019","On-Tenure track total","32","18","14","0","0","0","6","3","3","1","1","0","1","1","0","0","0","0","17","9","8","0","0","0","3","1","2","4","3","1","-2"
"224545","Texas A&M University-Texarkana","2019","On-tenure track, professors","2","2","0","0","0","0","1","1","0","0","0","0","0","0","0","0","0","0","1","1","0","0","0","0","0","0","0","0","0","0","-2"
"224545","Texas A&M University-Texarkana","2019","On-tenure track, associate professors","7","5","2","0","0","0","2","1","1","0","0","0","0","0","0","0","0","0","3","3","0","0","0","0","2","1","1","0","0","0","-2"
"224545","Texas A&M University-Texarkana","2019","On-tenure track, assistant professors","23","11","12","0","0","0","3","1","2","1","1","0","1","1","0","0","0","0","13","5","8","0","0","0","1","0","1","4","3","1","-2"
"224545","Texas A&M University-Texarkana","2019","Not on tenure track/No tenure system system total","24","5","19","0","0","0","0","0","0","0","0","0","3","1","2","0","0","0","18","4","14","0","0","0","2","0","2","1","0","1","-2"
"224545","Texas A&M University-Texarkana","2019","Not on tenure/no tenure system, assistant professors","8","2","6","0","0","0","0","0","0","0","0","0","1","0","1","0","0","0","6","2","4","0","0","0","0","0","0","1","0","1","-2"
"224545","Texas A&M University-Texarkana","2019","Not on tenure/no tenure system, instructors","15","2","13","0","0","0","0","0","0","0","0","0","1","0","1","0","0","0","12","2","10","0","0","0","2","0","2","0","0","0","-2"
"224545","Texas A&M University-Texarkana","2019","Not on tenure/no tenure system, lecturers","1","1","0","0","0","0","0","0","0","0","0","0","1","1","0","0","0","0","0","0","0","0","0","0","0","0","0","0","0","0","-2"
"224554","Texas A & M University-Commerce","2019","Tenured total","146","95","51","1","1","0","22","16","6","12","8","4","11","8","3","0","0","0","98","60","38","1","1","0","1","1","0","0","0","0","-2"
"224554","Texas A & M University-Commerce","2019","Tenured, professors","72","49","23","1","1","0","15","13","2","7","4","3","5","4","1","0","0","0","43","26","17","1","1","0","0","0","0","0","0","0","-2"
"224554","Texas A & M University-Commerce","2019","Tenured, associate professors","73","46","27","0","0","0","7","3","4","5","4","1","6","4","2","0","0","0","54","34","20","0","0","0","1","1","0","0","0","0","-2"
"224554","Texas A & M University-Commerce","2019","Tenured, instructors","1","0","1","0","0","0","0","0","0","0","0","0","0","0","0","0","0","0","1","0","1","0","0","0","0","0","0","0","0","0","-2"
"224554","Texas A & M University-Commerce","2019","On-Tenure track total","127","69","58","0","0","0","15","8","7","16","5","11","13","4","9","1","0","1","54","32","22","1","1","0","5","4","1","22","15","7","-2"
"224554","Texas A & M University-Commerce","2019","On-tenure track, associate professors","42","28","14","0","0","0","10","8","2","8","4","4","6","3","3","0","0","0","16","11","5","0","0","0","1","1","0","1","1","0","-2"
"224554","Texas A & M University-Commerce","2019","On-tenure track, assistant professors","83","41","42","0","0","0","5","0","5","8","1","7","6","1","5","1","0","1","37","21","16","1","1","0","4","3","1","21","14","7","-2"
"224554","Texas A & M University-Commerce","2019","On-tenure track, instructors","2","0","2","0","0","0","0","0","0","0","0","0","1","0","1","0","0","0","1","0","1","0","0","0","0","0","0","0","0","0","-2"
"224554","Texas A & M University-Commerce","2019","Not on tenure track/No tenure system system total","121","50","71","0","0","0","11","3","8","8","3","5","5","0","5","0","0","0","90","39","51","0","0","0","3","2","1","4","3","1","-2"
"224554","Texas A & M University-Commerce","2019","Not on tenure/no tenure system, professors","1","1","0","0","0","0","1","1","0","0","0","0","0","0","0","0","0","0","0","0","0","0","0","0","0","0","0","0","0","0","-2"
"224554","Texas A & M University-Commerce","2019","Not on tenure/no tenure system, associate professors","9","4","5","0","0","0","2","1","1","1","0","1","0","0","0","0","0","0","5","2","3","0","0","0","1","1","0","0","0","0","-2"
"224554","Texas A & M University-Commerce","2019","Not on tenure/no tenure system, assistant professors","57","23","34","0","0","0","7","1","6","2","1","1","4","0","4","0","0","0","38","17","21","0","0","0","2","1","1","4","3","1","-2"
"224554","Texas A & M University-Commerce","2019","Not on tenure/no tenure system, instructors","41","14","27","0","0","0","1","0","1","4","1","3","1","0","1","0","0","0","35","13","22","0","0","0","0","0","0","0","0","0","-2"
"224554","Texas A & M University-Commerce","2019","Not on tenure/no tenure system, lecturers","13","8","5","0","0","0","0","0","0","1","1","0","0","0","0","0","0","0","12","7","5","0","0","0","0","0","0","0","0","0","-2"
"225247","Hardin-Simmons University","2019","Tenured total","70","45","25","0","0","0","1","1","0","2","1","1","0","0","0","0","0","0","67","43","24","0","0","0","0","0","0","0","0","0","-2"
"225247","Hardin-Simmons University","2019","Tenured, professors","43","30","13","0","0","0","0","0","0","0","0","0","0","0","0","0","0","0","43","30","13","0","0","0","0","0","0","0","0","0","-2"
"225247","Hardin-Simmons University","2019","Tenured, associate professors","25","15","10","0","0","0","1","1","0","2","1","1","0","0","0","0","0","0","22","13","9","0","0","0","0","0","0","0","0","0","-2"
"225247","Hardin-Simmons University","2019","Tenured, assistant professors","2","0","2","0","0","0","0","0","0","0","0","0","0","0","0","0","0","0","2","0","2","0","0","0","0","0","0","0","0","0","-2"
"225247","Hardin-Simmons University","2019","On-Tenure track total","18","7","11","0","0","0","0","0","0","0","0","0","3","0","3","0","0","0","14","7","7","0","0","0","1","0","1","0","0","0","-2"
"225247","Hardin-Simmons University","2019","On-tenure track, associate professors","2","0","2","0","0","0","0","0","0","0","0","0","1","0","1","0","0","0","1","0","1","0","0","0","0","0","0","0","0","0","-2"
"225247","Hardin-Simmons University","2019","On-tenure track, assistant professors","15","6","9","0","0","0","0","0","0","0","0","0","2","0","2","0","0","0","12","6","6","0","0","0","1","0","1","0","0","0","-2"
"225247","Hardin-Simmons University","2019","On-tenure track, instructors","1","1","0","0","0","0","0","0","0","0","0","0","0","0","0","0","0","0","1","1","0","0","0","0","0","0","0","0","0","0","-2"
"225247","Hardin-Simmons University","2019","Not on tenure track/No tenure system system total","18","11","7","0","0","0","0","0","0","0","0","0","0","0","0","0","0","0","18","11","7","0","0","0","0","0","0","0","0","0","-2"
"225247","Hardin-Simmons University","2019","Not on tenure/no tenure system, professors","1","1","0","0","0","0","0","0","0","0","0","0","0","0","0","0","0","0","1","1","0","0","0","0","0","0","0","0","0","0","-2"
"225247","Hardin-Simmons University","2019","Not on tenure/no tenure system, associate professors","4","2","2","0","0","0","0","0","0","0","0","0","0","0","0","0","0","0","4","2","2","0","0","0","0","0","0","0","0","0","-2"
"225247","Hardin-Simmons University","2019","Not on tenure/no tenure system, assistant professors","11","8","3","0","0","0","0","0","0","0","0","0","0","0","0","0","0","0","11","8","3","0","0","0","0","0","0","0","0","0","-2"
"225247","Hardin-Simmons University","2019","Not on tenure/no tenure system, instructors","2","0","2","0","0","0","0","0","0","0","0","0","0","0","0","0","0","0","2","0","2","0","0","0","0","0","0","0","0","0","-2"
"226091","Lamar University","2019","Tenured total","205","131","74","1","0","1","50","35","15","11","3","8","9","6","3","0","0","0","131","85","46","0","0","0","3","2","1","0","0","0","-2"
"226091","Lamar University","2019","Tenured, professors","92","62","30","0","0","0","26","20","6","2","0","2","2","1","1","0","0","0","62","41","21","0","0","0","0","0","0","0","0","0","-2"
"226091","Lamar University","2019","Tenured, associate professors","100","62","38","1","0","1","21","13","8","8","2","6","7","5","2","0","0","0","61","41","20","0","0","0","2","1","1","0","0","0","-2"
"226091","Lamar University","2019","Tenured, assistant professors","13","7","6","0","0","0","3","2","1","1","1","0","0","0","0","0","0","0","8","3","5","0","0","0","1","1","0","0","0","0","-2"
"226091","Lamar University","2019","On-Tenure track total","102","53","49","1","0","1","15","10","5","12","4","8","7","5","2","0","0","0","62","29","33","0","0","0","4","4","0","1","1","0","-2"
"226091","Lamar University","2019","On-tenure track, professors","1","1","0","0","0","0","0","0","0","0","0","0","0","0","0","0","0","0","1","1","0","0","0","0","0","0","0","0","0","0","-2"
"226091","Lamar University","2019","On-tenure track, associate professors","6","3","3","0","0","0","0","0","0","1","0","1","1","1","0","0","0","0","4","2","2","0","0","0","0","0","0","0","0","0","-2"
"226091","Lamar University","2019","On-tenure track, assistant professors","82","44","38","1","0","1","14","9","5","10","4","6","6","4","2","0","0","0","46","22","24","0","0","0","4","4","0","1","1","0","-2"
"226091","Lamar University","2019","On-tenure track, instructors","13","5","8","0","0","0","1","1","0","1","0","1","0","0","0","0","0","0","11","4","7","0","0","0","0","0","0","0","0","0","-2"
"226091","Lamar University","2019","Not on tenure track/No tenure system system total","147","54","93","0","0","0","11","9","2","8","1","7","9","4","5","0","0","0","116","38","78","0","0","0","2","1","1","1","1","0","-2"
"226091","Lamar University","2019","Not on tenure/no tenure system, associate professors","1","1","0","0","0","0","0","0","0","0","0","0","0","0","0","0","0","0","1","1","0","0","0","0","0","0","0","0","0","0","-2"
"226091","Lamar University","2019","Not on tenure/no tenure system, assistant professors","15","6","9","0","0","0","2","2","0","1","0","1","2","1","1","0","0","0","10","3","7","0","0","0","0","0","0","0","0","0","-2"
"226091","Lamar University","2019","Not on tenure/no tenure system, instructors","131","47","84","0","0","0","9","7","2","7","1","6","7","3","4","0","0","0","105","34","71","0","0","0","2","1","1","1","1","0","-2"
"226383","Lubbock Christian University","2019","Tenured total","57","31","26","0","0","0","0","0","0","0","0","0","4","4","0","0","0","0","53","27","26","0","0","0","0","0","0","0","0","0","-2"
"226383","Lubbock Christian University","2019","Tenured, professors","32","20","12","0","0","0","0","0","0","0","0","0","2","2","0","0","0","0","30","18","12","0","0","0","0","0","0","0","0","0","-2"
"226383","Lubbock Christian University","2019","Tenured, associate professors","19","10","9","0","0","0","0","0","0","0","0","0","2","2","0","0","0","0","17","8","9","0","0","0","0","0","0","0","0","0","-2"
"226383","Lubbock Christian University","2019","Tenured, assistant professors","6","1","5","0","0","0","0","0","0","0","0","0","0","0","0","0","0","0","6","1","5","0","0","0","0","0","0","0","0","0","-2"
"226383","Lubbock Christian University","2019","On-Tenure track total","34","18","16","0","0","0","0","0","0","1","0","1","1","0","1","0","0","0","32","18","14","0","0","0","0","0","0","0","0","0","-2"
"226383","Lubbock Christian University","2019","On-tenure track, professors","2","1","1","0","0","0","0","0","0","0","0","0","0","0","0","0","0","0","2","1","1","0","0","0","0","0","0","0","0","0","-2"
"226383","Lubbock Christian University","2019","On-tenure track, associate professors","6","6","0","0","0","0","0","0","0","0","0","0","0","0","0","0","0","0","6","6","0","0","0","0","0","0","0","0","0","0","-2"
"226383","Lubbock Christian University","2019","On-tenure track, assistant professors","25","11","14","0","0","0","0","0","0","1","0","1","1","0","1","0","0","0","23","11","12","0","0","0","0","0","0","0","0","0","-2"
"226383","Lubbock Christian University","2019","On-tenure track, instructors","1","0","1","0","0","0","0","0","0","0","0","0","0","0","0","0","0","0","1","0","1","0","0","0","0","0","0","0","0","0","-2"
"226383","Lubbock Christian University","2019","Not on tenure track/No tenure system system total","5","2","3","0","0","0","0","0","0","0","0","0","0","0","0","0","0","0","5","2","3","0","0","0","0","0","0","0","0","0","-2"
"226383","Lubbock Christian University","2019","Not on tenure/no tenure system, lecturers","2","1","1","0","0","0","0","0","0","0","0","0","0","0","0","0","0","0","2","1","1","0","0","0","0","0","0","0","0","0","-2"
"226383","Lubbock Christian University","2019","Not on tenure/no tenure system, no academic rank","3","1","2","0","0","0","0","0","0","0","0","0","0","0","0","0","0","0","3","1","2","0","0","0","0","0","0","0","0","0","-2"
"226471","University of Mary Hardin-Baylor","2019","Tenured total","64","33","31","0","0","0","4","2","2","1","0","1","1","0","1","0","0","0","55","29","26","1","1","0","1","1","0","1","0","1","-2"
"226471","University of Mary Hardin-Baylor","2019","Tenured, professors","45","22","23","0","0","0","3","1","2","1","0","1","0","0","0","0","0","0","39","20","19","0","0","0","1","1","0","1","0","1","-2"
"226471","University of Mary Hardin-Baylor","2019","Tenured, associate professors","19","11","8","0","0","0","1","1","0","0","0","0","1","0","1","0","0","0","16","9","7","1","1","0","0","0","0","0","0","0","-2"
"226471","University of Mary Hardin-Baylor","2019","On-Tenure track total","66","26","40","0","0","0","5","4","1","6","4","2","3","0","3","1","1","0","48","17","31","1","0","1","2","0","2","0","0","0","-2"
"226471","University of Mary Hardin-Baylor","2019","On-tenure track, professors","4","1","3","0","0","0","0","0","0","0","0","0","0","0","0","0","0","0","4","1","3","0","0","0","0","0","0","0","0","0","-2"
"226471","University of Mary Hardin-Baylor","2019","On-tenure track, associate professors","16","4","12","0","0","0","1","1","0","2","0","2","2","0","2","0","0","0","9","3","6","0","0","0","2","0","2","0","0","0","-2"
"226471","University of Mary Hardin-Baylor","2019","On-tenure track, assistant professors","46","21","25","0","0","0","4","3","1","4","4","0","1","0","1","1","1","0","35","13","22","1","0","1","0","0","0","0","0","0","-2"
"226471","University of Mary Hardin-Baylor","2019","Not on tenure track/No tenure system system total","35","11","24","0","0","0","1","1","0","0","0","0","0","0","0","0","0","0","30","9","21","2","0","2","2","1","1","0","0","0","-2"
"226471","University of Mary Hardin-Baylor","2019","Not on tenure/no tenure system, associate professors","3","1","2","0","0","0","0","0","0","0","0","0","0","0","0","0","0","0","3","1","2","0","0","0","0","0","0","0","0","0","-2"
"226471","University of Mary Hardin-Baylor","2019","Not on tenure/no tenure system, assistant professors","20","5","15","0","0","0","0","0","0","0","0","0","0","0","0","0","0","0","18","5","13","1","0","1","1","0","1","0","0","0","-2"
"226471","University of Mary Hardin-Baylor","2019","Not on tenure/no tenure system, instructors","12","5","7","0","0","0","1","1","0","0","0","0","0","0","0","0","0","0","9","3","6","1","0","1","1","1","0","0","0","0","-2"
"226833","Midwestern State University","2019","Tenured total","122","69","53","1","0","1","5","3","2","1","0","1","3","2","1","0","0","0","97","56","41","1","1","0","1","0","1","13","7","6","-2"
"226833","Midwestern State University","2019","Tenured, professors","48","32","16","1","0","1","3","2","1","0","0","0","3","2","1","0","0","0","35","24","11","0","0","0","1","0","1","5","4","1","-2"
"226833","Midwestern State University","2019","Tenured, associate professors","70","35","35","0","0","0","2","1","1","1","0","1","0","0","0","0","0","0","58","30","28","1","1","0","0","0","0","8","3","5","-2"
"226833","Midwestern State University","2019","Tenured, assistant professors","4","2","2","0","0","0","0","0","0","0","0","0","0","0","0","0","0","0","4","2","2","0","0","0","0","0","0","0","0","0","-2"
"226833","Midwestern State University","2019","On-Tenure track total","45","26","19","0","0","0","2","0","2","0","0","0","4","3","1","0","0","0","28","14","14","0","0","0","0","0","0","11","9","2","-2"
"226833","Midwestern State University","2019","On-tenure track, associate professors","3","2","1","0","0","0","0","0","0","0","0","0","0","0","0","0","0","0","2","1","1","0","0","0","0","0","0","1","1","0","-2"
"226833","Midwestern State University","2019","On-tenure track, assistant professors","42","24","18","0","0","0","2","0","2","0","0","0","4","3","1","0","0","0","26","13","13","0","0","0","0","0","0","10","8","2","-2"
"226833","Midwestern State University","2019","Not on tenure track/No tenure system system total","74","23","51","0","0","0","0","0","0","1","0","1","3","0","3","0","0","0","65","20","45","0","0","0","1","1","0","4","2","2","-2"
"226833","Midwestern State University","2019","Not on tenure/no tenure system, associate professors","1","1","0","0","0","0","0","0","0","0","0","0","0","0","0","0","0","0","1","1","0","0","0","0","0","0","0","0","0","0","-2"
"226833","Midwestern State University","2019","Not on tenure/no tenure system, assistant professors","46","9","37","0","0","0","0","0","0","1","0","1","2","0","2","0","0","0","41","8","33","0","0","0","0","0","0","2","1","1","-2"
"226833","Midwestern State University","2019","Not on tenure/no tenure system, instructors","21","8","13","0","0","0","0","0","0","0","0","0","1","0","1","0","0","0","20","8","12","0","0","0","0","0","0","0","0","0","-2"
"226833","Midwestern State University","2019","Not on tenure/no tenure system, lecturers","5","4","1","0","0","0","0","0","0","0","0","0","0","0","0","0","0","0","3","3","0","0","0","0","1","1","0","1","0","1","-2"
"226833","Midwestern State University","2019","Not on tenure/no tenure system, no academic rank","1","1","0","0","0","0","0","0","0","0","0","0","0","0","0","0","0","0","0","0","0","0","0","0","0","0","0","1","1","0","-2"
"227429","Paul Quinn College","2019","Not on tenure track/No tenure system system total","12","6","6","0","0","0","0","0","0","10","5","5","1","0","1","0","0","0","1","1","0","0","0","0","0","0","0","0","0","0","-2"
"227429","Paul Quinn College","2019","Not on tenure/no tenure system, associate professors","7","4","3","0","0","0","0","0","0","6","4","2","1","0","1","0","0","0","0","0","0","0","0","0","0","0","0","0","0","0","-2"
"227429","Paul Quinn College","2019","Not on tenure/no tenure system, lecturers","5","2","3","0","0","0","0","0","0","4","1","3","0","0","0","0","0","0","1","1","0","0","0","0","0","0","0","0","0","0","-2"
"227881","Sam Houston State University","2019","Tenured total","351","213","138","1","0","1","36","23","13","8","4","4","21","10","11","0","0","0","283","176","107","2","0","2","0","0","0","0","0","0","-2"
"227881","Sam Houston State University","2019","Tenured, professors","175","114","61","0","0","0","18","13","5","4","3","1","8","5","3","0","0","0","145","93","52","0","0","0","0","0","0","0","0","0","-2"
"227881","Sam Houston State University","2019","Tenured, associate professors","173","99","74","1","0","1","18","10","8","4","1","3","13","5","8","0","0","0","135","83","52","2","0","2","0","0","0","0","0","0","-2"
"227881","Sam Houston State University","2019","Tenured, assistant professors","2","0","2","0","0","0","0","0","0","0","0","0","0","0","0","0","0","0","2","0","2","0","0","0","0","0","0","0","0","0","-2"
"227881","Sam Houston State University","2019","Tenured, instructors","1","0","1","0","0","0","0","0","0","0","0","0","0","0","0","0","0","0","1","0","1","0","0","0","0","0","0","0","0","0","-2"
"227881","Sam Houston State University","2019","On-Tenure track total","200","101","99","1","0","1","15","11","4","11","6","5","18","9","9","0","0","0","128","61","67","4","0","4","0","0","0","23","14","9","-2"
"227881","Sam Houston State University","2019","On-tenure track, professors","1","1","0","0","0","0","0","0","0","0","0","0","0","0","0","0","0","0","1","1","0","0","0","0","0","0","0","0","0","0","-2"
"227881","Sam Houston State University","2019","On-tenure track, associate professors","15","11","4","0","0","0","2","1","1","0","0","0","1","1","0","0","0","0","11","9","2","1","0","1","0","0","0","0","0","0","-2"
"227881","Sam Houston State University","2019","On-tenure track, assistant professors","184","89","95","1","0","1","13","10","3","11","6","5","17","8","9","0","0","0","116","51","65","3","0","3","0","0","0","23","14","9","-2"
"227881","Sam Houston State University","2019","Not on tenure track/No tenure system system total","230","94","136","2","1","1","7","1","6","18","8","10","23","10","13","0","0","0","166","70","96","8","2","6","0","0","0","6","2","4","-2"
"227881","Sam Houston State University","2019","Not on tenure/no tenure system, lecturers","230","94","136","2","1","1","7","1","6","18","8","10","23","10","13","0","0","0","166","70","96","8","2","6","0","0","0","6","2","4","-2"
"228325","Southwestern Assemblies of God University","2019","Not on tenure track/No tenure system system total","73","46","27","1","1","0","3","0","3","4","2","2","2","2","0","0","0","0","63","41","22","0","0","0","0","0","0","0","0","0","-2"
"228325","Southwestern Assemblies of God University","2019","Not on tenure/no tenure system, professors","21","15","6","0","0","0","1","0","1","1","1","0","1","1","0","0","0","0","18","13","5","0","0","0","0","0","0","0","0","0","-2"
"228325","Southwestern Assemblies of God University","2019","Not on tenure/no tenure system, associate professors","10","5","5","0","0","0","0","0","0","1","0","1","0","0","0","0","0","0","9","5","4","0","0","0","0","0","0","0","0","0","-2"
"228325","Southwestern Assemblies of God University","2019","Not on tenure/no tenure system, assistant professors","21","14","7","0","0","0","2","0","2","1","0","1","0","0","0","0","0","0","18","14","4","0","0","0","0","0","0","0","0","0","-2"
"228325","Southwestern Assemblies of God University","2019","Not on tenure/no tenure system, instructors","21","12","9","1","1","0","0","0","0","1","1","0","1","1","0","0","0","0","18","9","9","0","0","0","0","0","0","0","0","0","-2"
"228343","Southwestern University","2019","Tenured total","76","37","39","1","1","0","3","1","2","2","1","1","8","4","4","0","0","0","60","28","32","1","1","0","1","1","0","0","0","0","-2"
"228343","Southwestern University","2019","Tenured, professors","40","16","24","0","0","0","2","1","1","0","0","0","3","1","2","0","0","0","34","13","21","0","0","0","1","1","0","0","0","0","-2"
"228343","Southwestern University","2019","Tenured, associate professors","36","21","15","1","1","0","1","0","1","2","1","1","5","3","2","0","0","0","26","15","11","1","1","0","0","0","0","0","0","0","-2"
"228343","Southwestern University","2019","On-Tenure track total","14","7","7","0","0","0","3","1","2","0","0","0","2","1","1","0","0","0","8","4","4","0","0","0","0","0","0","1","1","0","-2"
"228343","Southwestern University","2019","On-tenure track, assistant professors","14","7","7","0","0","0","3","1","2","0","0","0","2","1","1","0","0","0","8","4","4","0","0","0","0","0","0","1","1","0","-2"
"228343","Southwestern University","2019","Not on tenure track/No tenure system system total","22","7","15","0","0","0","1","0","1","1","0","1","5","1","4","0","0","0","14","6","8","1","0","1","0","0","0","0","0","0","-2"
"228343","Southwestern University","2019","Not on tenure/no tenure system, instructors","22","7","15","0","0","0","1","0","1","1","0","1","5","1","4","0","0","0","14","6","8","1","0","1","0","0","0","0","0","0","-2"
"228431","Stephen F Austin State University","2019","Tenured total","269","166","103","2","0","2","3","1","2","11","8","3","14","8","6","0","0","0","229","145","84","7","2","5","1","1","0","2","1","1","-2"
"228431","Stephen F Austin State University","2019","Tenured, professors","113","79","34","0","0","0","0","0","0","4","3","1","5","1","4","0","0","0","101","74","27","2","0","2","1","1","0","0","0","0","-2"
"228431","Stephen F Austin State University","2019","Tenured, associate professors","133","77","56","0","0","0","3","1","2","7","5","2","9","7","2","0","0","0","109","62","47","4","2","2","0","0","0","1","0","1","-2"
"228431","Stephen F Austin State University","2019","Tenured, assistant professors","18","9","9","2","0","2","0","0","0","0","0","0","0","0","0","0","0","0","14","8","6","1","0","1","0","0","0","1","1","0","-2"
"228431","Stephen F Austin State University","2019","Tenured, instructors","3","1","2","0","0","0","0","0","0","0","0","0","0","0","0","0","0","0","3","1","2","0","0","0","0","0","0","0","0","0","-2"
"228431","Stephen F Austin State University","2019","Tenured, lecturers","2","0","2","0","0","0","0","0","0","0","0","0","0","0","0","0","0","0","2","0","2","0","0","0","0","0","0","0","0","0","-2"
"228431","Stephen F Austin State University","2019","On-Tenure track total","122","59","63","0","0","0","5","2","3","1","0","1","5","5","0","0","0","0","101","49","52","0","0","0","1","0","1","9","3","6","-2"
"228431","Stephen F Austin State University","2019","On-tenure track, associate professors","8","4","4","0","0","0","1","0","1","0","0","0","0","0","0","0","0","0","7","4","3","0","0","0","0","0","0","0","0","0","-2"
"228431","Stephen F Austin State University","2019","On-tenure track, assistant professors","101","52","49","0","0","0","4","2","2","1","0","1","5","5","0","0","0","0","82","42","40","0","0","0","0","0","0","9","3","6","-2"
"228431","Stephen F Austin State University","2019","On-tenure track, instructors","10","2","8","0","0","0","0","0","0","0","0","0","0","0","0","0","0","0","9","2","7","0","0","0","1","0","1","0","0","0","-2"
"228431","Stephen F Austin State University","2019","On-tenure track, no academic rank","3","1","2","0","0","0","0","0","0","0","0","0","0","0","0","0","0","0","3","1","2","0","0","0","0","0","0","0","0","0","-2"
"228431","Stephen F Austin State University","2019","Not on tenure track/No tenure system system total","144","41","103","1","0","1","2","0","2","4","1","3","9","3","6","0","0","0","123","32","91","3","3","0","0","0","0","2","2","0","-2"
"228431","Stephen F Austin State University","2019","Not on tenure/no tenure system, assistant professors","15","7","8","0","0","0","0","0","0","0","0","0","1","1","0","0","0","0","13","5","8","0","0","0","0","0","0","1","1","0","-2"
"228431","Stephen F Austin State University","2019","Not on tenure/no tenure system, instructors","39","5","34","0","0","0","0","0","0","2","0","2","2","0","2","0","0","0","35","5","30","0","0","0","0","0","0","0","0","0","-2"
"228431","Stephen F Austin State University","2019","Not on tenure/no tenure system, lecturers","78","24","54","1","0","1","2","0","2","1","0","1","5","2","3","0","0","0","65","18","47","3","3","0","0","0","0","1","1","0","-2"
"228431","Stephen F Austin State University","2019","Not on tenure/no tenure system, no academic rank","12","5","7","0","0","0","0","0","0","1","1","0","1","0","1","0","0","0","10","4","6","0","0","0","0","0","0","0","0","0","-2"
"228529","Tarleton State University","2019","Tenured total","158","101","57","3","2","1","10","7","3","5","3","2","12","8","4","0","0","0","122","76","46","1","1","0","4","3","1","1","1","0","-2"
"228529","Tarleton State University","2019","Tenured, professors","74","52","22","3","2","1","3","3","0","0","0","0","4","2","2","0","0","0","62","43","19","1","1","0","1","1","0","0","0","0","-2"
"228529","Tarleton State University","2019","Tenured, associate professors","84","49","35","0","0","0","7","4","3","5","3","2","8","6","2","0","0","0","60","33","27","0","0","0","3","2","1","1","1","0","-2"
"228529","Tarleton State University","2019","On-Tenure track total","145","74","71","1","1","0","8","5","3","9","2","7","5","3","2","0","0","0","108","53","55","3","2","1","1","1","0","10","7","3","-2"
"228529","Tarleton State University","2019","On-tenure track, professors","3","1","2","0","0","0","0","0","0","0","0","0","0","0","0","0","0","0","3","1","2","0","0","0","0","0","0","0","0","0","-2"
"228529","Tarleton State University","2019","On-tenure track, associate professors","6","3","3","1","1","0","0","0","0","0","0","0","0","0","0","0","0","0","5","2","3","0","0","0","0","0","0","0","0","0","-2"
"228529","Tarleton State University","2019","On-tenure track, assistant professors","135","70","65","0","0","0","8","5","3","9","2","7","5","3","2","0","0","0","99","50","49","3","2","1","1","1","0","10","7","3","-2"
"228529","Tarleton State University","2019","On-tenure track, instructors","1","0","1","0","0","0","0","0","0","0","0","0","0","0","0","0","0","0","1","0","1","0","0","0","0","0","0","0","0","0","-2"
"228529","Tarleton State University","2019","Not on tenure track/No tenure system system total","127","49","78","0","0","0","2","1","1","4","1","3","9","3","6","0","0","0","102","40","62","1","0","1","6","3","3","3","1","2","-2"
"228529","Tarleton State University","2019","Not on tenure/no tenure system, professors","1","1","0","0","0","0","0","0","0","0","0","0","0","0","0","0","0","0","1","1","0","0","0","0","0","0","0","0","0","0","-2"
"228529","Tarleton State University","2019","Not on tenure/no tenure system, associate professors","3","0","3","0","0","0","0","0","0","0","0","0","0","0","0","0","0","0","3","0","3","0","0","0","0","0","0","0","0","0","-2"
"228529","Tarleton State University","2019","Not on tenure/no tenure system, assistant professors","34","14","20","0","0","0","0","0","0","2","0","2","3","1","2","0","0","0","28","12","16","0","0","0","1","1","0","0","0","0","-2"
"228529","Tarleton State University","2019","Not on tenure/no tenure system, instructors","88","33","55","0","0","0","2","1","1","2","1","1","6","2","4","0","0","0","70","27","43","1","0","1","5","2","3","2","0","2","-2"
"228529","Tarleton State University","2019","Not on tenure/no tenure system, lecturers","1","1","0","0","0","0","0","0","0","0","0","0","0","0","0","0","0","0","0","0","0","0","0","0","0","0","0","1","1","0","-2"
"228653","The University of Texas Medical Branch at Galveston","2019","Tenured total","185","120","65","0","0","0","49","32","17","3","2","1","15","10","5","0","0","0","117","75","42","1","1","0","0","0","0","0","0","0","-2"
"228653","The University of Texas Medical Branch at Galveston","2019","Tenured, professors","145","101","44","0","0","0","39","27","12","1","1","0","10","8","2","0","0","0","94","64","30","1","1","0","0","0","0","0","0","0","-2"
"228653","The University of Texas Medical Branch at Galveston","2019","Tenured, associate professors","40","19","21","0","0","0","10","5","5","2","1","1","5","2","3","0","0","0","23","11","12","0","0","0","0","0","0","0","0","0","-2"
"228653","The University of Texas Medical Branch at Galveston","2019","On-Tenure track total","64","36","28","0","0","0","17","9","8","3","0","3","9","8","1","0","0","0","32","18","14","1","0","1","0","0","0","2","1","1","-2"
"228653","The University of Texas Medical Branch at Galveston","2019","On-tenure track, professors","3","2","1","0","0","0","0","0","0","0","0","0","1","0","1","0","0","0","1","1","0","0","0","0","0","0","0","1","1","0","-2"
"228653","The University of Texas Medical Branch at Galveston","2019","On-tenure track, associate professors","23","15","8","0","0","0","5","4","1","1","0","1","4","4","0","0","0","0","13","7","6","0","0","0","0","0","0","0","0","0","-2"
"228653","The University of Texas Medical Branch at Galveston","2019","On-tenure track, assistant professors","38","19","19","0","0","0","12","5","7","2","0","2","4","4","0","0","0","0","18","10","8","1","0","1","0","0","0","1","0","1","-2"
"228653","The University of Texas Medical Branch at Galveston","2019","Not on tenure track/No tenure system system total","313","134","179","0","0","0","80","41","39","18","7","11","23","9","14","1","1","0","182","71","111","6","4","2","0","0","0","3","1","2","-2"
"228653","The University of Texas Medical Branch at Galveston","2019","Not on tenure/no tenure system, professors","46","26","20","0","0","0","12","9","3","2","0","2","2","2","0","1","1","0","29","14","15","0","0","0","0","0","0","0","0","0","-2"
"228653","The University of Texas Medical Branch at Galveston","2019","Not on tenure/no tenure system, associate professors","81","37","44","0","0","0","22","9","13","6","3","3","6","3","3","0","0","0","46","21","25","1","1","0","0","0","0","0","0","0","-2"
"228653","The University of Texas Medical Branch at Galveston","2019","Not on tenure/no tenure system, assistant professors","182","69","113","0","0","0","45","23","22","9","3","6","15","4","11","0","0","0","105","35","70","5","3","2","0","0","0","3","1","2","-2"
"228653","The University of Texas Medical Branch at Galveston","2019","Not on tenure/no tenure system, instructors","3","1","2","0","0","0","1","0","1","1","1","0","0","0","0","0","0","0","1","0","1","0","0","0","0","0","0","0","0","0","-2"
"228653","The University of Texas Medical Branch at Galveston","2019","Not on tenure/no tenure system, no academic rank","1","1","0","0","0","0","0","0","0","0","0","0","0","0","0","0","0","0","1","1","0","0","0","0","0","0","0","0","0","0","-2"
"228787","The University of Texas at Dallas","2019","Tenured total","404","320","84","0","0","0","122","101","21","8","5","3","15","13","2","0","0","0","248","191","57","5","5","0","4","3","1","2","2","0","-2"
"228787","The University of Texas at Dallas","2019","Tenured, professors","257","213","44","0","0","0","79","68","11","0","0","0","7","6","1","0","0","0","165","133","32","3","3","0","2","2","0","1","1","0","-2"
"228787","The University of Texas at Dallas","2019","Tenured, associate professors","147","107","40","0","0","0","43","33","10","8","5","3","8","7","1","0","0","0","83","58","25","2","2","0","2","1","1","1","1","0","-2"
"228787","The University of Texas at Dallas","2019","On-Tenure track total","128","88","40","0","0","0","48","34","14","5","3","2","1","1","0","0","0","0","47","29","18","2","2","0","14","8","6","11","11","0","-2"
"228787","The University of Texas at Dallas","2019","On-tenure track, professors","1","1","0","0","0","0","0","0","0","0","0","0","0","0","0","0","0","0","1","1","0","0","0","0","0","0","0","0","0","0","-2"
"228787","The University of Texas at Dallas","2019","On-tenure track, associate professors","5","4","1","0","0","0","1","1","0","1","1","0","0","0","0","0","0","0","2","1","1","0","0","0","1","1","0","0","0","0","-2"
"228787","The University of Texas at Dallas","2019","On-tenure track, assistant professors","122","83","39","0","0","0","47","33","14","4","2","2","1","1","0","0","0","0","44","27","17","2","2","0","13","7","6","11","11","0","-2"
"228787","The University of Texas at Dallas","2019","Not on tenure track/No tenure system system total","366","198","168","0","0","0","89","47","42","9","6","3","12","8","4","0","0","0","229","120","109","5","4","1","19","12","7","3","1","2","-2"
"228787","The University of Texas at Dallas","2019","Not on tenure/no tenure system, lecturers","366","198","168","0","0","0","89","47","42","9","6","3","12","8","4","0","0","0","229","120","109","5","4","1","19","12","7","3","1","2","-2"
"228802","The University of Texas at Tyler","2019","Tenured total","139","87","52","0","0","0","17","13","4","8","3","5","8","8","0","0","0","0","105","62","43","0","0","0","1","1","0","0","0","0","-2"
"228802","The University of Texas at Tyler","2019","Tenured, professors","60","45","15","0","0","0","9","7","2","1","1","0","2","2","0","0","0","0","47","34","13","0","0","0","1","1","0","0","0","0","-2"
"228802","The University of Texas at Tyler","2019","Tenured, associate professors","79","42","37","0","0","0","8","6","2","7","2","5","6","6","0","0","0","0","58","28","30","0","0","0","0","0","0","0","0","0","-2"
"228802","The University of Texas at Tyler","2019","On-Tenure track total","78","36","42","0","0","0","19","9","10","1","1","0","3","1","2","0","0","0","52","24","28","0","0","0","2","1","1","1","0","1","-2"
"228802","The University of Texas at Tyler","2019","On-tenure track, associate professors","5","2","3","0","0","0","1","0","1","0","0","0","0","0","0","0","0","0","4","2","2","0","0","0","0","0","0","0","0","0","-2"
"228802","The University of Texas at Tyler","2019","On-tenure track, assistant professors","73","34","39","0","0","0","18","9","9","1","1","0","3","1","2","0","0","0","48","22","26","0","0","0","2","1","1","1","0","1","-2"
"228802","The University of Texas at Tyler","2019","Not on tenure track/No tenure system system total","130","35","95","0","0","0","8","6","2","6","2","4","6","3","3","0","0","0","106","22","84","0","0","0","3","1","2","1","1","0","-2"
"228802","The University of Texas at Tyler","2019","Not on tenure/no tenure system, professors","1","1","0","0","0","0","0","0","0","0","0","0","0","0","0","0","0","0","1","1","0","0","0","0","0","0","0","0","0","0","-2"
"228802","The University of Texas at Tyler","2019","Not on tenure/no tenure system, associate professors","2","1","1","0","0","0","0","0","0","0","0","0","0","0","0","0","0","0","1","0","1","0","0","0","0","0","0","1","1","0","-2"
"228802","The University of Texas at Tyler","2019","Not on tenure/no tenure system, instructors","74","11","63","0","0","0","3","2","1","4","1","3","3","2","1","0","0","0","62","6","56","0","0","0","2","0","2","0","0","0","-2"
"228802","The University of Texas at Tyler","2019","Not on tenure/no tenure system, lecturers","53","22","31","0","0","0","5","4","1","2","1","1","3","1","2","0","0","0","42","15","27","0","0","0","1","1","0","0","0","0","-2"
"229267","Trinity University","2019","Tenured total","171","102","69","1","0","1","16","8","8","6","4","2","17","10","7","0","0","0","130","79","51","0","0","0","1","1","0","0","0","0","-2"
"229267","Trinity University","2019","Tenured, professors","88","51","37","0","0","0","6","4","2","0","0","0","4","2","2","0","0","0","77","44","33","0","0","0","1","1","0","0","0","0","-2"
"229267","Trinity University","2019","Tenured, associate professors","83","51","32","1","0","1","10","4","6","6","4","2","13","8","5","0","0","0","53","35","18","0","0","0","0","0","0","0","0","0","-2"
"229267","Trinity University","2019","On-Tenure track total","50","24","26","0","0","0","8","3","5","0","0","0","6","4","2","0","0","0","36","17","19","0","0","0","0","0","0","0","0","0","-2"
"229267","Trinity University","2019","On-tenure track, assistant professors","50","24","26","0","0","0","8","3","5","0","0","0","6","4","2","0","0","0","36","17","19","0","0","0","0","0","0","0","0","0","-2"
"229267","Trinity University","2019","Not on tenure track/No tenure system system total","42","22","20","0","0","0","5","2","3","1","0","1","5","2","3","0","0","0","27","17","10","2","1","1","2","0","2","0","0","0","-2"
"229267","Trinity University","2019","Not on tenure/no tenure system, professors","4","4","0","0","0","0","1","1","0","0","0","0","0","0","0","0","0","0","2","2","0","1","1","0","0","0","0","0","0","0","-2"
"229267","Trinity University","2019","Not on tenure/no tenure system, associate professors","3","2","1","0","0","0","0","0","0","0","0","0","0","0","0","0","0","0","2","2","0","0","0","0","1","0","1","0","0","0","-2"
"229267","Trinity University","2019","Not on tenure/no tenure system, assistant professors","20","12","8","0","0","0","4","1","3","0","0","0","3","1","2","0","0","0","13","10","3","0","0","0","0","0","0","0","0","0","-2"
"229267","Trinity University","2019","Not on tenure/no tenure system, instructors","6","2","4","0","0","0","0","0","0","0","0","0","1","0","1","0","0","0","5","2","3","0","0","0","0","0","0","0","0","0","-2"
"229267","Trinity University","2019","Not on tenure/no tenure system, lecturers","9","2","7","0","0","0","0","0","0","1","0","1","1","1","0","0","0","0","5","1","4","1","0","1","1","0","1","0","0","0","-2"
"232706","Marymount University","2019","Tenured total","85","25","60","0","0","0","4","0","4","1","0","1","1","0","1","0","0","0","73","24","49","2","0","2","4","1","3","0","0","0","-2"
"232706","Marymount University","2019","Tenured, professors","45","8","37","0","0","0","2","0","2","1","0","1","1","0","1","0","0","0","39","7","32","1","0","1","1","1","0","0","0","0","-2"
"232706","Marymount University","2019","Tenured, associate professors","40","17","23","0","0","0","2","0","2","0","0","0","0","0","0","0","0","0","34","17","17","1","0","1","3","0","3","0","0","0","-2"
"232706","Marymount University","2019","On-Tenure track total","51","8","43","1","0","1","2","0","2","1","1","0","2","1","1","1","0","1","41","6","35","1","0","1","2","0","2","0","0","0","-2"
"232706","Marymount University","2019","On-tenure track, associate professors","5","1","4","0","0","0","1","0","1","0","0","0","0","0","0","0","0","0","4","1","3","0","0","0","0","0","0","0","0","0","-2"
"232706","Marymount University","2019","On-tenure track, assistant professors","46","7","39","1","0","1","1","0","1","1","1","0","2","1","1","1","0","1","37","5","32","1","0","1","2","0","2","0","0","0","-2"
"232706","Marymount University","2019","Not on tenure track/No tenure system system total","29","8","21","0","0","0","0","0","0","5","1","4","3","1","2","0","0","0","19","5","14","0","0","0","2","1","1","0","0","0","-2"
"232706","Marymount University","2019","Not on tenure/no tenure system, professors","1","1","0","0","0","0","0","0","0","0","0","0","0","0","0","0","0","0","1","1","0","0","0","0","0","0","0","0","0","0","-2"
"232706","Marymount University","2019","Not on tenure/no tenure system, associate professors","1","1","0","0","0","0","0","0","0","0","0","0","0","0","0","0","0","0","1","1","0","0","0","0","0","0","0","0","0","0","-2"
"232706","Marymount University","2019","Not on tenure/no tenure system, assistant professors","1","0","1","0","0","0","0","0","0","0","0","0","0","0","0","0","0","0","1","0","1","0","0","0","0","0","0","0","0","0","-2"
"232706","Marymount University","2019","Not on tenure/no tenure system, instructors","25","6","19","0","0","0","0","0","0","5","1","4","2","1","1","0","0","0","16","3","13","0","0","0","2","1","1","0","0","0","-2"
"232706","Marymount University","2019","Not on tenure/no tenure system, no academic rank","1","0","1","0","0","0","0","0","0","0","0","0","1","0","1","0","0","0","0","0","0","0","0","0","0","0","0","0","0","0","-2"
"234827","Central Washington University","2019","Tenured total","171","104","67","0","0","0","16","9","7","2","1","1","9","5","4","3","3","0","140","86","54","1","0","1","0","0","0","0","0","0","-2"
"234827","Central Washington University","2019","Tenured, professors","88","54","34","0","0","0","7","5","2","1","0","1","3","3","0","2","2","0","74","44","30","1","0","1","0","0","0","0","0","0","-2"
"234827","Central Washington University","2019","Tenured, associate professors","82","49","33","0","0","0","9","4","5","1","1","0","6","2","4","1","1","0","65","41","24","0","0","0","0","0","0","0","0","0","-2"
"234827","Central Washington University","2019","Tenured, assistant professors","1","1","0","0","0","0","0","0","0","0","0","0","0","0","0","0","0","0","1","1","0","0","0","0","0","0","0","0","0","0","-2"
"234827","Central Washington University","2019","On-Tenure track total","92","42","50","0","0","0","7","5","2","5","1","4","4","1","3","0","0","0","74","33","41","0","0","0","1","1","0","1","1","0","-2"
"234827","Central Washington University","2019","On-tenure track, associate professors","6","2","4","0","0","0","0","0","0","0","0","0","0","0","0","0","0","0","6","2","4","0","0","0","0","0","0","0","0","0","-2"
"234827","Central Washington University","2019","On-tenure track, assistant professors","83","39","44","0","0","0","7","5","2","5","1","4","4","1","3","0","0","0","65","30","35","0","0","0","1","1","0","1","1","0","-2"
"234827","Central Washington University","2019","On-tenure track, lecturers","3","1","2","0","0","0","0","0","0","0","0","0","0","0","0","0","0","0","3","1","2","0","0","0","0","0","0","0","0","0","-2"
"234827","Central Washington University","2019","Not on tenure track/No tenure system system total","134","60","74","1","1","0","2","2","0","2","1","1","7","4","3","0","0","0","118","52","66","4","0","4","0","0","0","0","0","0","-2"
"234827","Central Washington University","2019","Not on tenure/no tenure system, professors","3","3","0","0","0","0","0","0","0","0","0","0","0","0","0","0","0","0","3","3","0","0","0","0","0","0","0","0","0","0","-2"
"234827","Central Washington University","2019","Not on tenure/no tenure system, assistant professors","1","0","1","0","0","0","0","0","0","0","0","0","0","0","0","0","0","0","1","0","1","0","0","0","0","0","0","0","0","0","-2"
"234827","Central Washington University","2019","Not on tenure/no tenure system, instructors","17","6","11","0","0","0","0","0","0","0","0","0","1","0","1","0","0","0","15","6","9","1","0","1","0","0","0","0","0","0","-2"
"234827","Central Washington University","2019","Not on tenure/no tenure system, lecturers","113","51","62","1","1","0","2","2","0","2","1","1","6","4","2","0","0","0","99","43","56","3","0","3","0","0","0","0","0","0","-2"
"235097","Eastern Washington University","2019","Tenured total","220","130","90","2","1","1","16","10","6","3","3","0","8","6","2","0","0","0","185","108","77","5","2","3","0","0","0","1","0","1","-2"
"235097","Eastern Washington University","2019","Tenured, professors","154","96","58","2","1","1","13","8","5","2","2","0","5","4","1","0","0","0","131","80","51","1","1","0","0","0","0","0","0","0","-2"
"235097","Eastern Washington University","2019","Tenured, associate professors","66","34","32","0","0","0","3","2","1","1","1","0","3","2","1","0","0","0","54","28","26","4","1","3","0","0","0","1","0","1","-2"
"235097","Eastern Washington University","2019","On-Tenure track total","90","38","52","2","0","2","8","3","5","2","2","0","4","3","1","0","0","0","61","24","37","6","3","3","0","0","0","7","3","4","-2"
"235097","Eastern Washington University","2019","On-tenure track, assistant professors","90","38","52","2","0","2","8","3","5","2","2","0","4","3","1","0","0","0","61","24","37","6","3","3","0","0","0","7","3","4","-2"
"235097","Eastern Washington University","2019","Not on tenure track/No tenure system system total","150","68","82","0","0","0","12","7","5","5","3","2","5","3","2","0","0","0","124","52","72","2","1","1","0","0","0","2","2","0","-2"
"235097","Eastern Washington University","2019","Not on tenure/no tenure system, lecturers","150","68","82","0","0","0","12","7","5","5","3","2","5","3","2","0","0","0","124","52","72","2","1","1","0","0","0","2","2","0","-2"
"235237","Pierce College District","2019","Tenured total","57","23","34","1","1","0","4","1","3","0","0","0","3","1","2","0","0","0","44","19","25","5","1","4","0","0","0","0","0","0","-2"
"235237","Pierce College District","2019","Tenured, no academic rank","57","23","34","1","1","0","4","1","3","0","0","0","3","1","2","0","0","0","44","19","25","5","1","4","0","0","0","0","0","0","-2"
"235237","Pierce College District","2019","On-Tenure track total","19","7","12","0","0","0","2","1","1","3","1","2","0","0","0","0","0","0","14","5","9","0","0","0","0","0","0","0","0","0","-2"
"235237","Pierce College District","2019","On-tenure track, no academic rank","19","7","12","0","0","0","2","1","1","3","1","2","0","0","0","0","0","0","14","5","9","0","0","0","0","0","0","0","0","0","-2"
"235237","Pierce College District","2019","Not on tenure track/No tenure system system total","9","2","7","0","0","0","0","0","0","1","0","1","0","0","0","0","0","0","8","2","6","0","0","0","0","0","0","0","0","0","-2"
"235237","Pierce College District","2019","Not on tenure/no tenure system, no academic rank","9","2","7","0","0","0","0","0","0","1","0","1","0","0","0","0","0","0","8","2","6","0","0","0","0","0","0","0","0","0","-2"
"236452","Saint Martin's University","2019","Tenured total","38","20","18","0","0","0","2","1","1","1","1","0","2","0","2","0","0","0","29","15","14","0","0","0","4","3","1","0","0","0","-2"
"236452","Saint Martin's University","2019","Tenured, professors","17","10","7","0","0","0","1","1","0","1","1","0","1","0","1","0","0","0","12","7","5","0","0","0","2","1","1","0","0","0","-2"
"236452","Saint Martin's University","2019","Tenured, associate professors","21","10","11","0","0","0","1","0","1","0","0","0","1","0","1","0","0","0","17","8","9","0","0","0","2","2","0","0","0","0","-2"
"236452","Saint Martin's University","2019","On-Tenure track total","40","20","20","0","0","0","4","3","1","0","0","0","0","0","0","0","0","0","33","14","19","3","3","0","0","0","0","0","0","0","-2"
"236452","Saint Martin's University","2019","On-tenure track, associate professors","2","0","2","0","0","0","0","0","0","0","0","0","0","0","0","0","0","0","2","0","2","0","0","0","0","0","0","0","0","0","-2"
"236452","Saint Martin's University","2019","On-tenure track, assistant professors","38","20","18","0","0","0","4","3","1","0","0","0","0","0","0","0","0","0","31","14","17","3","3","0","0","0","0","0","0","0","-2"
"236452","Saint Martin's University","2019","Not on tenure track/No tenure system system total","18","11","7","1","1","0","0","0","0","1","1","0","1","1","0","0","0","0","14","8","6","1","0","1","0","0","0","0","0","0","-2"
"236452","Saint Martin's University","2019","Not on tenure/no tenure system, assistant professors","3","3","0","0","0","0","0","0","0","1","1","0","0","0","0","0","0","0","2","2","0","0","0","0","0","0","0","0","0","0","-2"
"236452","Saint Martin's University","2019","Not on tenure/no tenure system, instructors","14","8","6","1","1","0","0","0","0","0","0","0","1","1","0","0","0","0","12","6","6","0","0","0","0","0","0","0","0","0","-2"
"236452","Saint Martin's University","2019","Not on tenure/no tenure system, lecturers","1","0","1","0","0","0","0","0","0","0","0","0","0","0","0","0","0","0","0","0","0","1","0","1","0","0","0","0","0","0","-2"
"236638","Skagit Valley College","2019","Tenured total","76","31","45","1","1","0","1","0","1","0","0","0","4","3","1","0","0","0","69","27","42","0","0","0","0","0","0","1","0","1","-2"
"236638","Skagit Valley College","2019","Tenured, no academic rank","76","31","45","1","1","0","1","0","1","0","0","0","4","3","1","0","0","0","69","27","42","0","0","0","0","0","0","1","0","1","-2"
"236638","Skagit Valley College","2019","On-Tenure track total","14","7","7","0","0","0","1","0","1","0","0","0","3","1","2","0","0","0","10","6","4","0","0","0","0","0","0","0","0","0","-2"
"236638","Skagit Valley College","2019","On-tenure track, no academic rank","14","7","7","0","0","0","1","0","1","0","0","0","3","1","2","0","0","0","10","6","4","0","0","0","0","0","0","0","0","0","-2"
"236638","Skagit Valley College","2019","Not on tenure track/No tenure system system total","7","3","4","0","0","0","0","0","0","0","0","0","0","0","0","0","0","0","6","2","4","1","1","0","0","0","0","0","0","0","-2"
"236638","Skagit Valley College","2019","Not on tenure/no tenure system, no academic rank","7","3","4","0","0","0","0","0","0","0","0","0","0","0","0","0","0","0","6","2","4","1","1","0","0","0","0","0","0","0","-2"
"236887","Walla Walla Community College","2019","Tenured total","64","31","33","4","3","1","1","0","1","0","0","0","0","0","0","0","0","0","58","28","30","1","0","1","0","0","0","0","0","0","-2"
"236887","Walla Walla Community College","2019","Tenured, no academic rank","64","31","33","4","3","1","1","0","1","0","0","0","0","0","0","0","0","0","58","28","30","1","0","1","0","0","0","0","0","0","-2"
"236887","Walla Walla Community College","2019","On-Tenure track total","15","9","6","0","0","0","0","0","0","0","0","0","2","1","1","0","0","0","13","8","5","0","0","0","0","0","0","0","0","0","-2"
"236887","Walla Walla Community College","2019","On-tenure track, no academic rank","15","9","6","0","0","0","0","0","0","0","0","0","2","1","1","0","0","0","13","8","5","0","0","0","0","0","0","0","0","0","-2"
"236887","Walla Walla Community College","2019","Not on tenure track/No tenure system system total","40","29","11","1","1","0","0","0","0","0","0","0","3","3","0","0","0","0","36","25","11","0","0","0","0","0","0","0","0","0","-2"
"236887","Walla Walla Community College","2019","Not on tenure/no tenure system, no academic rank","40","29","11","1","1","0","0","0","0","0","0","0","3","3","0","0","0","0","36","25","11","0","0","0","0","0","0","0","0","0","-2"
"236896","Walla Walla University","2019","Tenured total","52","33","19","0","0","0","1","1","0","0","0","0","1","0","1","0","0","0","48","30","18","1","1","0","1","1","0","0","0","0","-2"
"236896","Walla Walla University","2019","Tenured, professors","35","22","13","0","0","0","1","1","0","0","0","0","1","0","1","0","0","0","31","19","12","1","1","0","1","1","0","0","0","0","-2"
"236896","Walla Walla University","2019","Tenured, associate professors","13","8","5","0","0","0","0","0","0","0","0","0","0","0","0","0","0","0","13","8","5","0","0","0","0","0","0","0","0","0","-2"
"236896","Walla Walla University","2019","Tenured, assistant professors","4","3","1","0","0","0","0","0","0","0","0","0","0","0","0","0","0","0","4","3","1","0","0","0","0","0","0","0","0","0","-2"
"236896","Walla Walla University","2019","On-Tenure track total","29","13","16","0","0","0","1","0","1","1","0","1","5","2","3","0","0","0","21","11","10","0","0","0","1","0","1","0","0","0","-2"
"236896","Walla Walla University","2019","On-tenure track, professors","2","0","2","0","0","0","0","0","0","0","0","0","0","0","0","0","0","0","2","0","2","0","0","0","0","0","0","0","0","0","-2"
"236896","Walla Walla University","2019","On-tenure track, associate professors","7","5","2","0","0","0","0","0","0","0","0","0","1","0","1","0","0","0","6","5","1","0","0","0","0","0","0","0","0","0","-2"
"236896","Walla Walla University","2019","On-tenure track, assistant professors","19","8","11","0","0","0","1","0","1","1","0","1","4","2","2","0","0","0","12","6","6","0","0","0","1","0","1","0","0","0","-2"
"236896","Walla Walla University","2019","On-tenure track, instructors","1","0","1","0","0","0","0","0","0","0","0","0","0","0","0","0","0","0","1","0","1","0","0","0","0","0","0","0","0","0","-2"
"236896","Walla Walla University","2019","Not on tenure track/No tenure system system total","10","5","5","0","0","0","0","0","0","0","0","0","0","0","0","0","0","0","9","4","5","1","1","0","0","0","0","0","0","0","-2"
"236896","Walla Walla University","2019","Not on tenure/no tenure system, professors","1","0","1","0","0","0","0","0","0","0","0","0","0","0","0","0","0","0","1","0","1","0","0","0","0","0","0","0","0","0","-2"
"236896","Walla Walla University","2019","Not on tenure/no tenure system, associate professors","1","0","1","0","0","0","0","0","0","0","0","0","0","0","0","0","0","0","1","0","1","0","0","0","0","0","0","0","0","0","-2"
"236896","Walla Walla University","2019","Not on tenure/no tenure system, assistant professors","4","1","3","0","0","0","0","0","0","0","0","0","0","0","0","0","0","0","3","0","3","1","1","0","0","0","0","0","0","0","-2"
"236896","Walla Walla University","2019","Not on tenure/no tenure system, instructors","4","4","0","0","0","0","0","0","0","0","0","0","0","0","0","0","0","0","4","4","0","0","0","0","0","0","0","0","0","0","-2"
"238430","Cardinal Stritch University","2019","Tenured total","36","18","18","0","0","0","1","0","1","4","3","1","1","0","1","0","0","0","30","15","15","0","0","0","0","0","0","0","0","0","-2"
"238430","Cardinal Stritch University","2019","Tenured, professors","8","4","4","0","0","0","0","0","0","0","0","0","1","0","1","0","0","0","7","4","3","0","0","0","0","0","0","0","0","0","-2"
"238430","Cardinal Stritch University","2019","Tenured, associate professors","13","6","7","0","0","0","1","0","1","2","1","1","0","0","0","0","0","0","10","5","5","0","0","0","0","0","0","0","0","0","-2"
"238430","Cardinal Stritch University","2019","Tenured, assistant professors","15","8","7","0","0","0","0","0","0","2","2","0","0","0","0","0","0","0","13","6","7","0","0","0","0","0","0","0","0","0","-2"
"238430","Cardinal Stritch University","2019","On-Tenure track total","8","3","5","0","0","0","0","0","0","1","1","0","0","0","0","0","0","0","7","2","5","0","0","0","0","0","0","0","0","0","-2"
"238430","Cardinal Stritch University","2019","On-tenure track, professors","1","0","1","0","0","0","0","0","0","0","0","0","0","0","0","0","0","0","1","0","1","0","0","0","0","0","0","0","0","0","-2"
"238430","Cardinal Stritch University","2019","On-tenure track, assistant professors","7","3","4","0","0","0","0","0","0","1","1","0","0","0","0","0","0","0","6","2","4","0","0","0","0","0","0","0","0","0","-2"
"238430","Cardinal Stritch University","2019","Not on tenure track/No tenure system system total","30","6","24","0","0","0","1","0","1","2","0","2","1","1","0","0","0","0","26","5","21","0","0","0","0","0","0","0","0","0","-2"
"238430","Cardinal Stritch University","2019","Not on tenure/no tenure system, assistant professors","29","6","23","0","0","0","1","0","1","2","0","2","1","1","0","0","0","0","25","5","20","0","0","0","0","0","0","0","0","0","-2"
"238430","Cardinal Stritch University","2019","Not on tenure/no tenure system, instructors","1","0","1","0","0","0","0","0","0","0","0","0","0","0","0","0","0","0","1","0","1","0","0","0","0","0","0","0","0","0","-2"
"239309","Milwaukee Institute of Art & Design","2019","Not on tenure track/No tenure system system total","51","30","21","0","0","0","2","1","1","1","1","0","1","1","0","0","0","0","44","26","18","1","1","0","2","0","2","0","0","0","-2"
"239309","Milwaukee Institute of Art & Design","2019","Not on tenure/no tenure system, professors","22","14","8","0","0","0","2","1","1","0","0","0","1","1","0","0","0","0","19","12","7","0","0","0","0","0","0","0","0","0","-2"
"239309","Milwaukee Institute of Art & Design","2019","Not on tenure/no tenure system, associate professors","4","4","0","0","0","0","0","0","0","1","1","0","0","0","0","0","0","0","2","2","0","1","1","0","0","0","0","0","0","0","-2"
"239309","Milwaukee Institute of Art & Design","2019","Not on tenure/no tenure system, assistant professors","5","1","4","0","0","0","0","0","0","0","0","0","0","0","0","0","0","0","5","1","4","0","0","0","0","0","0","0","0","0","-2"
"239309","Milwaukee Institute of Art & Design","2019","Not on tenure/no tenure system, instructors","20","11","9","0","0","0","0","0","0","0","0","0","0","0","0","0","0","0","18","11","7","0","0","0","2","0","2","0","0","0","-2"
"240374","University of Wisconsin-Parkside","2019","Tenured total","68","42","26","0","0","0","16","10","6","5","5","0","4","1","3","0","0","0","42","25","17","0","0","0","0","0","0","1","1","0","240374"
"240374","University of Wisconsin-Parkside","2019","Tenured, professors","22","15","7","0","0","0","7","5","2","2","2","0","2","0","2","0","0","0","11","8","3","0","0","0","0","0","0","0","0","0","240374"
"240374","University of Wisconsin-Parkside","2019","Tenured, associate professors","46","27","19","0","0","0","9","5","4","3","3","0","2","1","1","0","0","0","31","17","14","0","0","0","0","0","0","1","1","0","240374"
"240374","University of Wisconsin-Parkside","2019","On-Tenure track total","37","18","19","0","0","0","4","1","3","1","0","1","3","3","0","0","0","0","28","13","15","0","0","0","0","0","0","1","1","0","240374"
"240374","University of Wisconsin-Parkside","2019","On-tenure track, associate professors","11","7","4","0","0","0","1","0","1","0","0","0","1","1","0","0","0","0","8","5","3","0","0","0","0","0","0","1","1","0","240374"
"240374","University of Wisconsin-Parkside","2019","On-tenure track, assistant professors","26","11","15","0","0","0","3","1","2","1","0","1","2","2","0","0","0","0","20","8","12","0","0","0","0","0","0","0","0","0","240374"
"240374","University of Wisconsin-Parkside","2019","Not on tenure track/No tenure system system total","55","24","31","1","1","0","5","2","3","3","2","1","1","0","1","0","0","0","42","17","25","0","0","0","1","1","0","2","1","1","240374"
"240374","University of Wisconsin-Parkside","2019","Not on tenure/no tenure system, associate professors","1","1","0","0","0","0","0","0","0","0","0","0","0","0","0","0","0","0","1","1","0","0","0","0","0","0","0","0","0","0","240374"
"240374","University of Wisconsin-Parkside","2019","Not on tenure/no tenure system, assistant professors","15","7","8","0","0","0","3","1","2","1","1","0","0","0","0","0","0","0","9","4","5","0","0","0","1","1","0","1","0","1","240374"
"240374","University of Wisconsin-Parkside","2019","Not on tenure/no tenure system, lecturers","39","16","23","1","1","0","2","1","1","2","1","1","1","0","1","0","0","0","32","12","20","0","0","0","0","0","0","1","1","0","240374"
"243823","Parker University","2019","Not on tenure track/No tenure system system total","66","38","28","1","1","0","6","5","1","6","3","3","6","5","1","0","0","0","44","22","22","2","1","1","1","1","0","0","0","0","-2"
"243823","Parker University","2019","Not on tenure/no tenure system, professors","12","8","4","0","0","0","2","1","1","0","0","0","0","0","0","0","0","0","10","7","3","0","0","0","0","0","0","0","0","0","-2"
"243823","Parker University","2019","Not on tenure/no tenure system, associate professors","9","5","4","0","0","0","1","1","0","0","0","0","3","2","1","0","0","0","5","2","3","0","0","0","0","0","0","0","0","0","-2"
"243823","Parker University","2019","Not on tenure/no tenure system, assistant professors","26","16","10","1","1","0","2","2","0","2","1","1","1","1","0","0","0","0","20","11","9","0","0","0","0","0","0","0","0","0","-2"
"243823","Parker University","2019","Not on tenure/no tenure system, instructors","19","9","10","0","0","0","1","1","0","4","2","2","2","2","0","0","0","0","9","2","7","2","1","1","1","1","0","0","0","0","-2"
"244233","City College-Fort Lauderdale","2019","Not on tenure track/No tenure system system total","5","3","2","0","0","0","1","1","0","1","0","1","1","0","1","0","0","0","2","2","0","0","0","0","0","0","0","0","0","0","-2"
"244233","City College-Fort Lauderdale","2019","Not on tenure/no tenure system, instructors","5","3","2","0","0","0","1","1","0","1","0","1","1","0","1","0","0","0","2","2","0","0","0","0","0","0","0","0","0","0","-2"
"247834","Collin County Community College District","2019","Not on tenure track/No tenure system system total","468","194","274","5","3","2","33","9","24","32","11","21","27","8","19","0","0","0","362","158","204","7","4","3","2","1","1","0","0","0","-2"
"247834","Collin County Community College District","2019","Not on tenure/no tenure system, no academic rank","468","194","274","5","3","2","33","9","24","32","11","21","27","8","19","0","0","0","362","158","204","7","4","3","2","1","1","0","0","0","-2"
"262086","Brandman University","2019","Not on tenure track/No tenure system system total","91","27","64","0","0","0","6","3","3","6","2","4","7","3","4","0","0","0","53","13","40","1","0","1","18","6","12","0","0","0","-2"
"262086","Brandman University","2019","Not on tenure/no tenure system, professors","15","7","8","0","0","0","1","1","0","0","0","0","0","0","0","0","0","0","12","5","7","0","0","0","2","1","1","0","0","0","-2"
"262086","Brandman University","2019","Not on tenure/no tenure system, associate professors","32","12","20","0","0","0","4","2","2","3","2","1","1","1","0","0","0","0","19","4","15","0","0","0","5","3","2","0","0","0","-2"
"262086","Brandman University","2019","Not on tenure/no tenure system, assistant professors","44","8","36","0","0","0","1","0","1","3","0","3","6","2","4","0","0","0","22","4","18","1","0","1","11","2","9","0","0","0","-2"
"262129","New College of Florida","2019","Tenured total","55","24","31","0","0","0","2","1","1","2","0","2","3","1","2","0","0","0","46","22","24","0","0","0","0","0","0","2","0","2","-2"
"262129","New College of Florida","2019","Tenured, professors","30","17","13","0","0","0","1","1","0","0","0","0","1","1","0","0","0","0","28","15","13","0","0","0","0","0","0","0","0","0","-2"
"262129","New College of Florida","2019","Tenured, associate professors","25","7","18","0","0","0","1","0","1","2","0","2","2","0","2","0","0","0","18","7","11","0","0","0","0","0","0","2","0","2","-2"
"262129","New College of Florida","2019","On-Tenure track total","35","21","14","1","0","1","1","0","1","1","0","1","5","4","1","0","0","0","19","13","6","1","1","0","0","0","0","7","3","4","-2"
"262129","New College of Florida","2019","On-tenure track, professors","2","2","0","0","0","0","0","0","0","0","0","0","0","0","0","0","0","0","1","1","0","0","0","0","0","0","0","1","1","0","-2"
"262129","New College of Florida","2019","On-tenure track, assistant professors","33","19","14","1","0","1","1","0","1","1","0","1","5","4","1","0","0","0","18","12","6","1","1","0","0","0","0","6","2","4","-2"
"262129","New College of Florida","2019","Not on tenure track/No tenure system system total","15","4","11","0","0","0","4","2","2","0","0","0","1","0","1","0","0","0","6","1","5","0","0","0","0","0","0","4","1","3","-2"
"262129","New College of Florida","2019","Not on tenure/no tenure system, assistant professors","8","3","5","0","0","0","3","2","1","0","0","0","0","0","0","0","0","0","2","0","2","0","0","0","0","0","0","3","1","2","-2"
"262129","New College of Florida","2019","Not on tenure/no tenure system, instructors","4","0","4","0","0","0","1","0","1","0","0","0","1","0","1","0","0","0","2","0","2","0","0","0","0","0","0","0","0","0","-2"
"262129","New College of Florida","2019","Not on tenure/no tenure system, no academic rank","3","1","2","0","0","0","0","0","0","0","0","0","0","0","0","0","0","0","2","1","1","0","0","0","0","0","0","1","0","1","-2"
"377564","University of Washington-Tacoma Campus","2019","Tenured total","120","65","55","2","0","2","24","14","10","4","2","2","9","6","3","0","0","0","70","36","34","2","0","2","8","6","2","1","1","0","-2"
"377564","University of Washington-Tacoma Campus","2019","Tenured, professors","47","28","19","0","0","0","12","8","4","2","1","1","3","2","1","0","0","0","25","14","11","2","0","2","3","3","0","0","0","0","-2"
"377564","University of Washington-Tacoma Campus","2019","Tenured, associate professors","73","37","36","2","0","2","12","6","6","2","1","1","6","4","2","0","0","0","45","22","23","0","0","0","5","3","2","1","1","0","-2"
"377564","University of Washington-Tacoma Campus","2019","On-Tenure track total","63","24","39","0","0","0","6","2","4","5","2","3","9","3","6","0","0","0","29","15","14","2","1","1","4","0","4","8","1","7","-2"
"377564","University of Washington-Tacoma Campus","2019","On-tenure track, assistant professors","63","24","39","0","0","0","6","2","4","5","2","3","9","3","6","0","0","0","29","15","14","2","1","1","4","0","4","8","1","7","-2"
"377564","University of Washington-Tacoma Campus","2019","Not on tenure track/No tenure system system total","88","34","54","0","0","0","6","0","6","1","0","1","3","0","3","2","1","1","59","26","33","3","0","3","5","3","2","9","4","5","-2"
"377564","University of Washington-Tacoma Campus","2019","Not on tenure/no tenure system, lecturers","88","34","54","0","0","0","6","0","6","1","0","1","3","0","3","2","1","1","59","26","33","3","0","3","5","3","2","9","4","5","-2"
"385619","Everglades University","2019","Not on tenure track/No tenure system system total","48","33","15","0","0","0","0","0","0","8","5","3","8","6","2","0","0","0","31","21","10","1","1","0","0","0","0","0","0","0","-2"
"385619","Everglades University","2019","Not on tenure/no tenure system, instructors","48","33","15","0","0","0","0","0","0","8","5","3","8","6","2","0","0","0","31","21","10","1","1","0","0","0","0","0","0","0","-2"
"386472","Herzing University-Orlando","2019","Not on tenure track/No tenure system system total","19","3","16","0","0","0","0","0","0","5","2","3","2","0","2","0","0","0","10","1","9","2","0","2","0","0","0","0","0","0","-2"
"386472","Herzing University-Orlando","2019","Not on tenure/no tenure system, professors","2","1","1","0","0","0","0","0","0","0","0","0","0","0","0","0","0","0","2","1","1","0","0","0","0","0","0","0","0","0","-2"
"386472","Herzing University-Orlando","2019","Not on tenure/no tenure system, associate professors","4","0","4","0","0","0","0","0","0","2","0","2","0","0","0","0","0","0","2","0","2","0","0","0","0","0","0","0","0","0","-2"
"386472","Herzing University-Orlando","2019","Not on tenure/no tenure system, assistant professors","11","2","9","0","0","0","0","0","0","3","2","1","2","0","2","0","0","0","5","0","5","1","0","1","0","0","0","0","0","0","-2"
"386472","Herzing University-Orlando","2019","Not on tenure/no tenure system, instructors","2","0","2","0","0","0","0","0","0","0","0","0","0","0","0","0","0","0","1","0","1","1","0","1","0","0","0","0","0","0","-2"
"388520","College of Biblical Studies-Houston","2019","Not on tenure track/No tenure system system total","18","15","3","0","0","0","0","0","0","5","4","1","2","2","0","0","0","0","11","9","2","0","0","0","0","0","0","0","0","0","-2"
"388520","College of Biblical Studies-Houston","2019","Not on tenure/no tenure system, professors","14","12","2","0","0","0","0","0","0","4","3","1","1","1","0","0","0","0","9","8","1","0","0","0","0","0","0","0","0","0","-2"
"388520","College of Biblical Studies-Houston","2019","Not on tenure/no tenure system, associate professors","1","1","0","0","0","0","0","0","0","0","0","0","0","0","0","0","0","0","1","1","0","0","0","0","0","0","0","0","0","0","-2"
"388520","College of Biblical Studies-Houston","2019","Not on tenure/no tenure system, assistant professors","3","2","1","0","0","0","0","0","0","1","1","0","1","1","0","0","0","0","1","0","1","0","0","0","0","0","0","0","0","0","-2"
"418126","New York College of Health Professions","2019","Not on tenure track/No tenure system system total","7","4","3","0","0","0","4","3","1","1","0","1","0","0","0","0","0","0","2","1","1","0","0","0","0","0","0","0","0","0","-2"
"418126","New York College of Health Professions","2019","Not on tenure/no tenure system, instructors","7","4","3","0","0","0","4","3","1","1","0","1","0","0","0","0","0","0","2","1","1","0","0","0","0","0","0","0","0","0","-2"
"420574","Arizona State University-Polytechnic","2019","Tenured total","63","43","20","0","0","0","9","6","3","2","1","1","1","1","0","0","0","0","49","33","16","1","1","0","1","1","0","0","0","0","-2"
"420574","Arizona State University-Polytechnic","2019","Tenured, professors","18","14","4","0","0","0","3","2","1","1","1","0","0","0","0","0","0","0","14","11","3","0","0","0","0","0","0","0","0","0","-2"
"420574","Arizona State University-Polytechnic","2019","Tenured, associate professors","45","29","16","0","0","0","6","4","2","1","0","1","1","1","0","0","0","0","35","22","13","1","1","0","1","1","0","0","0","0","-2"
"420574","Arizona State University-Polytechnic","2019","On-Tenure track total","29","20","9","0","0","0","8","7","1","1","0","1","2","1","1","0","0","0","13","9","4","0","0","0","0","0","0","5","3","2","-2"
"420574","Arizona State University-Polytechnic","2019","On-tenure track, associate professors","2","2","0","0","0","0","1","1","0","0","0","0","0","0","0","0","0","0","1","1","0","0","0","0","0","0","0","0","0","0","-2"
"420574","Arizona State University-Polytechnic","2019","On-tenure track, assistant professors","27","18","9","0","0","0","7","6","1","1","0","1","2","1","1","0","0","0","12","8","4","0","0","0","0","0","0","5","3","2","-2"
"420574","Arizona State University-Polytechnic","2019","Not on tenure track/No tenure system system total","89","40","49","0","0","0","5","1","4","4","0","4","7","2","5","0","0","0","66","34","32","2","1","1","3","1","2","2","1","1","-2"
"420574","Arizona State University-Polytechnic","2019","Not on tenure/no tenure system, professors","4","3","1","0","0","0","0","0","0","0","0","0","0","0","0","0","0","0","4","3","1","0","0","0","0","0","0","0","0","0","-2"
"420574","Arizona State University-Polytechnic","2019","Not on tenure/no tenure system, associate professors","5","2","3","0","0","0","0","0","0","1","0","1","2","0","2","0","0","0","1","1","0","1","1","0","0","0","0","0","0","0","-2"
"420574","Arizona State University-Polytechnic","2019","Not on tenure/no tenure system, assistant professors","8","3","5","0","0","0","0","0","0","0","0","0","1","0","1","0","0","0","7","3","4","0","0","0","0","0","0","0","0","0","-2"
"420574","Arizona State University-Polytechnic","2019","Not on tenure/no tenure system, instructors","35","12","23","0","0","0","2","0","2","2","0","2","3","1","2","0","0","0","26","11","15","1","0","1","1","0","1","0","0","0","-2"
"420574","Arizona State University-Polytechnic","2019","Not on tenure/no tenure system, lecturers","36","20","16","0","0","0","2","1","1","1","0","1","1","1","0","0","0","0","28","16","12","0","0","0","2","1","1","2","1","1","-2"
"420574","Arizona State University-Polytechnic","2019","Not on tenure/no tenure system, no academic rank","1","0","1","0","0","0","1","0","1","0","0","0","0","0","0","0","0","0","0","0","0","0","0","0","0","0","0","0","0","0","-2"
"426314","Embry-Riddle Aeronautical University-Worldwide","2019","Tenured total","14","10","4","0","0","0","1","1","0","0","0","0","0","0","0","0","0","0","13","9","4","0","0","0","0","0","0","0","0","0","-2"
"426314","Embry-Riddle Aeronautical University-Worldwide","2019","Tenured, professors","2","2","0","0","0","0","0","0","0","0","0","0","0","0","0","0","0","0","2","2","0","0","0","0","0","0","0","0","0","0","-2"
"426314","Embry-Riddle Aeronautical University-Worldwide","2019","Tenured, associate professors","12","8","4","0","0","0","1","1","0","0","0","0","0","0","0","0","0","0","11","7","4","0","0","0","0","0","0","0","0","0","-2"
"426314","Embry-Riddle Aeronautical University-Worldwide","2019","On-Tenure track total","30","12","18","0","0","0","2","2","0","3","0","3","0","0","0","0","0","0","24","9","15","0","0","0","0","0","0","1","1","0","-2"
"426314","Embry-Riddle Aeronautical University-Worldwide","2019","On-tenure track, associate professors","4","3","1","0","0","0","1","1","0","0","0","0","0","0","0","0","0","0","3","2","1","0","0","0","0","0","0","0","0","0","-2"
"426314","Embry-Riddle Aeronautical University-Worldwide","2019","On-tenure track, assistant professors","26","9","17","0","0","0","1","1","0","3","0","3","0","0","0","0","0","0","21","7","14","0","0","0","0","0","0","1","1","0","-2"
"426314","Embry-Riddle Aeronautical University-Worldwide","2019","Not on tenure track/No tenure system system total","81","55","26","1","1","0","1","0","1","6","5","1","4","3","1","0","0","0","67","46","21","2","0","2","0","0","0","0","0","0","-2"
"426314","Embry-Riddle Aeronautical University-Worldwide","2019","Not on tenure/no tenure system, professors","1","1","0","0","0","0","0","0","0","0","0","0","0","0","0","0","0","0","1","1","0","0","0","0","0","0","0","0","0","0","-2"
"426314","Embry-Riddle Aeronautical University-Worldwide","2019","Not on tenure/no tenure system, associate professors","10","8","2","0","0","0","0","0","0","0","0","0","0","0","0","0","0","0","9","8","1","1","0","1","0","0","0","0","0","0","-2"
"426314","Embry-Riddle Aeronautical University-Worldwide","2019","Not on tenure/no tenure system, assistant professors","42","28","14","0","0","0","1","0","1","2","2","0","3","2","1","0","0","0","35","24","11","1","0","1","0","0","0","0","0","0","-2"
"426314","Embry-Riddle Aeronautical University-Worldwide","2019","Not on tenure/no tenure system, instructors","28","18","10","1","1","0","0","0","0","4","3","1","1","1","0","0","0","0","22","13","9","0","0","0","0","0","0","0","0","0","-2"
"433660","Florida Gulf Coast University","2019","Tenured total","4","1","3","0","0","0","0","0","0","0","0","0","1","0","1","0","0","0","3","1","2","0","0","0","0","0","0","0","0","0","-2"
"433660","Florida Gulf Coast University","2019","Tenured, professors","3","1","2","0","0","0","0","0","0","0","0","0","1","0","1","0","0","0","2","1","1","0","0","0","0","0","0","0","0","0","-2"
"433660","Florida Gulf Coast University","2019","Tenured, associate professors","1","0","1","0","0","0","0","0","0","0","0","0","0","0","0","0","0","0","1","0","1","0","0","0","0","0","0","0","0","0","-2"
"433660","Florida Gulf Coast University","2019","Not on tenure track/No tenure system system total","503","283","220","3","3","0","42","31","11","20","12","8","24","12","12","0","0","0","386","207","179","5","3","2","0","0","0","23","15","8","-2"
"433660","Florida Gulf Coast University","2019","Not on tenure/no tenure system, professors","88","64","24","0","0","0","12","10","2","1","1","0","3","2","1","0","0","0","70","49","21","1","1","0","0","0","0","1","1","0","-2"
"433660","Florida Gulf Coast University","2019","Not on tenure/no tenure system, associate professors","129","89","40","0","0","0","12","9","3","7","5","2","8","5","3","0","0","0","97","66","31","0","0","0","0","0","0","5","4","1","-2"
"433660","Florida Gulf Coast University","2019","Not on tenure/no tenure system, assistant professors","151","73","78","3","3","0","14","10","4","8","3","5","7","3","4","0","0","0","103","45","58","2","1","1","0","0","0","14","8","6","-2"
"433660","Florida Gulf Coast University","2019","Not on tenure/no tenure system, instructors","134","57","77","0","0","0","4","2","2","4","3","1","6","2","4","0","0","0","115","47","68","2","1","1","0","0","0","3","2","1","-2"
"433660","Florida Gulf Coast University","2019","Not on tenure/no tenure system, lecturers","1","0","1","0","0","0","0","0","0","0","0","0","0","0","0","0","0","0","1","0","1","0","0","0","0","0","0","0","0","0","-2"
"439288","Johnson & Wales University-Denver","2019","Not on tenure track/No tenure system system total","47","23","24","0","0","0","0","0","0","0","0","0","2","1","1","0","0","0","45","22","23","0","0","0","0","0","0","0","0","0","-2"
"439288","Johnson & Wales University-Denver","2019","Not on tenure/no tenure system, professors","6","1","5","0","0","0","0","0","0","0","0","0","1","0","1","0","0","0","5","1","4","0","0","0","0","0","0","0","0","0","-2"
"439288","Johnson & Wales University-Denver","2019","Not on tenure/no tenure system, associate professors","21","14","7","0","0","0","0","0","0","0","0","0","1","1","0","0","0","0","20","13","7","0","0","0","0","0","0","0","0","0","-2"
"439288","Johnson & Wales University-Denver","2019","Not on tenure/no tenure system, assistant professors","10","5","5","0","0","0","0","0","0","0","0","0","0","0","0","0","0","0","10","5","5","0","0","0","0","0","0","0","0","0","-2"
"439288","Johnson & Wales University-Denver","2019","Not on tenure/no tenure system, instructors","6","2","4","0","0","0","0","0","0","0","0","0","0","0","0","0","0","0","6","2","4","0","0","0","0","0","0","0","0","0","-2"
"439288","Johnson & Wales University-Denver","2019","Not on tenure/no tenure system, lecturers","4","1","3","0","0","0","0","0","0","0","0","0","0","0","0","0","0","0","4","1","3","0","0","0","0","0","0","0","0","0","-2"
"446233","Ecclesia College","2019","Not on tenure track/No tenure system system total","15","10","5","0","0","0","0","0","0","0","0","0","1","0","1","0","0","0","12","9","3","0","0","0","0","0","0","2","1","1","-2"
"446233","Ecclesia College","2019","Not on tenure/no tenure system, instructors","15","10","5","0","0","0","0","0","0","0","0","0","1","0","1","0","0","0","12","9","3","0","0","0","0","0","0","2","1","1","-2"
"447689","Georgia Gwinnett College","2019","Not on tenure track/No tenure system system total","454","216","238","2","1","1","57","28","29","52","20","32","17","13","4","0","0","0","298","136","162","2","1","1","8","7","1","18","10","8","-2"
"447689","Georgia Gwinnett College","2019","Not on tenure/no tenure system, professors","50","31","19","0","0","0","12","8","4","4","2","2","0","0","0","0","0","0","33","21","12","0","0","0","0","0","0","1","0","1","-2"
"447689","Georgia Gwinnett College","2019","Not on tenure/no tenure system, associate professors","173","84","89","1","0","1","24","10","14","18","7","11","8","5","3","0","0","0","111","55","56","0","0","0","1","1","0","10","6","4","-2"
"447689","Georgia Gwinnett College","2019","Not on tenure/no tenure system, assistant professors","175","85","90","1","1","0","18","10","8","22","8","14","7","7","0","0","0","0","113","49","64","1","1","0","6","5","1","7","4","3","-2"
"447689","Georgia Gwinnett College","2019","Not on tenure/no tenure system, instructors","31","5","26","0","0","0","1","0","1","3","0","3","1","0","1","0","0","0","25","5","20","1","0","1","0","0","0","0","0","0","-2"
"447689","Georgia Gwinnett College","2019","Not on tenure/no tenure system, lecturers","25","11","14","0","0","0","2","0","2","5","3","2","1","1","0","0","0","0","16","6","10","0","0","0","1","1","0","0","0","0","-2"
"448840","University of South Florida-St Petersburg","2019","Tenured total","72","42","30","1","1","0","6","4","2","1","1","0","6","3","3","0","0","0","56","32","24","1","1","0","0","0","0","1","0","1","-2"
"448840","University of South Florida-St Petersburg","2019","Tenured, professors","35","25","10","0","0","0","5","4","1","0","0","0","2","2","0","0","0","0","28","19","9","0","0","0","0","0","0","0","0","0","-2"
"448840","University of South Florida-St Petersburg","2019","Tenured, associate professors","37","17","20","1","1","0","1","0","1","1","1","0","4","1","3","0","0","0","28","13","15","1","1","0","0","0","0","1","0","1","-2"
"448840","University of South Florida-St Petersburg","2019","On-Tenure track total","31","13","18","0","0","0","3","1","2","3","2","1","4","2","2","0","0","0","18","6","12","1","0","1","0","0","0","2","2","0","-2"
"448840","University of South Florida-St Petersburg","2019","On-tenure track, associate professors","5","3","2","0","0","0","2","1","1","0","0","0","0","0","0","0","0","0","2","1","1","0","0","0","0","0","0","1","1","0","-2"
"448840","University of South Florida-St Petersburg","2019","On-tenure track, assistant professors","23","9","14","0","0","0","1","0","1","3","2","1","4","2","2","0","0","0","13","4","9","1","0","1","0","0","0","1","1","0","-2"
"448840","University of South Florida-St Petersburg","2019","On-tenure track, instructors","3","1","2","0","0","0","0","0","0","0","0","0","0","0","0","0","0","0","3","1","2","0","0","0","0","0","0","0","0","0","-2"
"448840","University of South Florida-St Petersburg","2019","Not on tenure track/No tenure system system total","39","17","22","0","0","0","6","2","4","2","0","2","1","1","0","0","0","0","29","13","16","1","1","0","0","0","0","0","0","0","-2"
"448840","University of South Florida-St Petersburg","2019","Not on tenure/no tenure system, assistant professors","3","2","1","0","0","0","0","0","0","0","0","0","0","0","0","0","0","0","2","1","1","1","1","0","0","0","0","0","0","0","-2"
"448840","University of South Florida-St Petersburg","2019","Not on tenure/no tenure system, instructors","36","15","21","0","0","0","6","2","4","2","0","2","1","1","0","0","0","0","27","12","15","0","0","0","0","0","0","0","0","0","-2"
"451671","University of South Florida-Sarasota-Manatee","2019","Tenured total","31","16","15","0","0","0","3","1","2","3","1","2","0","0","0","0","0","0","23","13","10","1","0","1","0","0","0","1","1","0","-2"
"451671","University of South Florida-Sarasota-Manatee","2019","Tenured, professors","13","7","6","0","0","0","2","1","1","0","0","0","0","0","0","0","0","0","9","5","4","1","0","1","0","0","0","1","1","0","-2"
"451671","University of South Florida-Sarasota-Manatee","2019","Tenured, associate professors","18","9","9","0","0","0","1","0","1","3","1","2","0","0","0","0","0","0","14","8","6","0","0","0","0","0","0","0","0","0","-2"
"451671","University of South Florida-Sarasota-Manatee","2019","On-Tenure track total","12","6","6","0","0","0","3","1","2","0","0","0","2","2","0","0","0","0","6","2","4","0","0","0","0","0","0","1","1","0","-2"
"451671","University of South Florida-Sarasota-Manatee","2019","On-tenure track, assistant professors","12","6","6","0","0","0","3","1","2","0","0","0","2","2","0","0","0","0","6","2","4","0","0","0","0","0","0","1","1","0","-2"
"451671","University of South Florida-Sarasota-Manatee","2019","Not on tenure track/No tenure system system total","47","25","22","0","0","0","3","1","2","0","0","0","1","1","0","0","0","0","38","18","20","1","1","0","0","0","0","4","4","0","-2"
"451671","University of South Florida-Sarasota-Manatee","2019","Not on tenure/no tenure system, assistant professors","2","1","1","0","0","0","0","0","0","0","0","0","0","0","0","0","0","0","1","0","1","0","0","0","0","0","0","1","1","0","-2"
"451671","University of South Florida-Sarasota-Manatee","2019","Not on tenure/no tenure system, instructors","43","22","21","0","0","0","3","1","2","0","0","0","1","1","0","0","0","0","35","16","19","1","1","0","0","0","0","3","3","0","-2"
"451671","University of South Florida-Sarasota-Manatee","2019","Not on tenure/no tenure system, no academic rank","2","2","0","0","0","0","0","0","0","0","0","0","0","0","0","0","0","0","2","2","0","0","0","0","0","0","0","0","0","0","-2"
"455664","The Chicago School of Professional Psychology at Los Angeles","2019","Not on tenure track/No tenure system system total","29","19","10","0","0","0","1","1","0","4","1","3","3","2","1","0","0","0","17","12","5","3","2","1","1","1","0","0","0","0","-2"
"455664","The Chicago School of Professional Psychology at Los Angeles","2019","Not on tenure/no tenure system, professors","7","7","0","0","0","0","0","0","0","1","1","0","0","0","0","0","0","0","5","5","0","0","0","0","1","1","0","0","0","0","-2"
"455664","The Chicago School of Professional Psychology at Los Angeles","2019","Not on tenure/no tenure system, associate professors","15","9","6","0","0","0","0","0","0","3","0","3","3","2","1","0","0","0","7","5","2","2","2","0","0","0","0","0","0","0","-2"
"455664","The Chicago School of Professional Psychology at Los Angeles","2019","Not on tenure/no tenure system, assistant professors","7","3","4","0","0","0","1","1","0","0","0","0","0","0","0","0","0","0","5","2","3","1","0","1","0","0","0","0","0","0","-2"
"459824","Touro University Nevada","2019","Not on tenure track/No tenure system system total","79","33","46","0","0","0","6","3","3","2","0","2","1","0","1","3","2","1","67","28","39","0","0","0","0","0","0","0","0","0","-2"
"459824","Touro University Nevada","2019","Not on tenure/no tenure system, professors","10","5","5","0","0","0","1","0","1","0","0","0","0","0","0","1","1","0","8","4","4","0","0","0","0","0","0","0","0","0","-2"
"459824","Touro University Nevada","2019","Not on tenure/no tenure system, associate professors","18","8","10","0","0","0","1","1","0","0","0","0","0","0","0","0","0","0","17","7","10","0","0","0","0","0","0","0","0","0","-2"
"459824","Touro University Nevada","2019","Not on tenure/no tenure system, assistant professors","50","19","31","0","0","0","4","2","2","2","0","2","1","0","1","1","0","1","42","17","25","0","0","0","0","0","0","0","0","0","-2"
"459824","Touro University Nevada","2019","Not on tenure/no tenure system, instructors","1","1","0","0","0","0","0","0","0","0","0","0","0","0","0","1","1","0","0","0","0","0","0","0","0","0","0","0","0","0","-2"
"459842","Herzing University-Kenosha","2019","Not on tenure track/No tenure system system total","14","3","11","0","0","0","0","0","0","1","0","1","0","0","0","0","0","0","13","3","10","0","0","0","0","0","0","0","0","0","-2"
"459842","Herzing University-Kenosha","2019","Not on tenure/no tenure system, professors","3","1","2","0","0","0","0","0","0","0","0","0","0","0","0","0","0","0","3","1","2","0","0","0","0","0","0","0","0","0","-2"
"459842","Herzing University-Kenosha","2019","Not on tenure/no tenure system, associate professors","2","1","1","0","0","0","0","0","0","0","0","0","0","0","0","0","0","0","2","1","1","0","0","0","0","0","0","0","0","0","-2"
"459842","Herzing University-Kenosha","2019","Not on tenure/no tenure system, assistant professors","7","0","7","0","0","0","0","0","0","1","0","1","0","0","0","0","0","0","6","0","6","0","0","0","0","0","0","0","0","0","-2"
"459842","Herzing University-Kenosha","2019","Not on tenure/no tenure system, instructors","2","1","1","0","0","0","0","0","0","0","0","0","0","0","0","0","0","0","2","1","1","0","0","0","0","0","0","0","0","0","-2"
"460899","Stevens-Henager College","2019","Not on tenure track/No tenure system system total","10","8","2","0","0","0","2","1","1","0","0","0","0","0","0","0","0","0","7","6","1","1","1","0","0","0","0","0","0","0","-2"
"460899","Stevens-Henager College","2019","Not on tenure/no tenure system, no academic rank","10","8","2","0","0","0","2","1","1","0","0","0","0","0","0","0","0","0","7","6","1","1","1","0","0","0","0","0","0","0","-2"
"461795","North American University","2019","Not on tenure track/No tenure system system total","15","12","3","0","0","0","2","2","0","1","1","0","1","0","1","0","0","0","11","9","2","0","0","0","0","0","0","0","0","0","-2"
"461795","North American University","2019","Not on tenure/no tenure system, professors","1","1","0","0","0","0","0","0","0","0","0","0","0","0","0","0","0","0","1","1","0","0","0","0","0","0","0","0","0","0","-2"
"461795","North American University","2019","Not on tenure/no tenure system, associate professors","6","5","1","0","0","0","1","1","0","0","0","0","0","0","0","0","0","0","5","4","1","0","0","0","0","0","0","0","0","0","-2"
"461795","North American University","2019","Not on tenure/no tenure system, assistant professors","3","1","2","0","0","0","0","0","0","0","0","0","1","0","1","0","0","0","2","1","1","0","0","0","0","0","0","0","0","0","-2"
"461795","North American University","2019","Not on tenure/no tenure system, instructors","5","5","0","0","0","0","1","1","0","1","1","0","0","0","0","0","0","0","3","3","0","0","0","0","0","0","0","0","0","0","-2"
"482936","Florida Polytechnic University","2019","Not on tenure track/No tenure system system total","75","55","20","0","0","0","14","11","3","0","0","0","7","6","1","0","0","0","39","26","13","0","0","0","0","0","0","15","12","3","-2"
"482936","Florida Polytechnic University","2019","Not on tenure/no tenure system, professors","4","3","1","0","0","0","1","1","0","0","0","0","1","0","1","0","0","0","2","2","0","0","0","0","0","0","0","0","0","0","-2"
"482936","Florida Polytechnic University","2019","Not on tenure/no tenure system, associate professors","13","11","2","0","0","0","3","3","0","0","0","0","3","3","0","0","0","0","7","5","2","0","0","0","0","0","0","0","0","0","-2"
"482936","Florida Polytechnic University","2019","Not on tenure/no tenure system, assistant professors","49","35","14","0","0","0","9","7","2","0","0","0","2","2","0","0","0","0","24","15","9","0","0","0","0","0","0","14","11","3","-2"
"482936","Florida Polytechnic University","2019","Not on tenure/no tenure system, instructors","9","6","3","0","0","0","1","0","1","0","0","0","1","1","0","0","0","0","6","4","2","0","0","0","0","0","0","1","1","0","-2"
"483124","Arizona State University Digital Immersion","2019","Tenured total","232","139","93","1","1","0","22","14","8","9","4","5","21","12","9","0","0","0","170","104","66","3","0","3","5","3","2","1","1","0","-2"
"483124","Arizona State University Digital Immersion","2019","Tenured, professors","118","84","34","1","1","0","13","11","2","4","3","1","10","6","4","0","0","0","87","61","26","1","0","1","2","2","0","0","0","0","-2"
"483124","Arizona State University Digital Immersion","2019","Tenured, associate professors","114","55","59","0","0","0","9","3","6","5","1","4","11","6","5","0","0","0","83","43","40","2","0","2","3","1","2","1","1","0","-2"
"483124","Arizona State University Digital Immersion","2019","On-Tenure track total","75","38","37","0","0","0","15","7","8","1","0","1","7","2","5","0","0","0","39","23","16","2","0","2","4","1","3","7","5","2","-2"
"483124","Arizona State University Digital Immersion","2019","On-tenure track, professors","1","1","0","0","0","0","0","0","0","0","0","0","0","0","0","0","0","0","1","1","0","0","0","0","0","0","0","0","0","0","-2"
"483124","Arizona State University Digital Immersion","2019","On-tenure track, associate professors","3","0","3","0","0","0","0","0","0","0","0","0","0","0","0","0","0","0","3","0","3","0","0","0","0","0","0","0","0","0","-2"
"483124","Arizona State University Digital Immersion","2019","On-tenure track, assistant professors","71","37","34","0","0","0","15","7","8","1","0","1","7","2","5","0","0","0","35","22","13","2","0","2","4","1","3","7","5","2","-2"
"483124","Arizona State University Digital Immersion","2019","Not on tenure track/No tenure system system total","569","233","336","3","0","3","31","16","15","15","5","10","44","15","29","1","0","1","432","174","258","5","3","2","22","10","12","16","10","6","-2"
"483124","Arizona State University Digital Immersion","2019","Not on tenure/no tenure system, professors","28","16","12","0","0","0","2","1","1","0","0","0","2","0","2","0","0","0","23","14","9","0","0","0","1","1","0","0","0","0","-2"
"483124","Arizona State University Digital Immersion","2019","Not on tenure/no tenure system, associate professors","45","21","24","1","0","1","2","2","0","5","2","3","2","2","0","1","0","1","32","14","18","1","0","1","1","1","0","0","0","0","-2"
"483124","Arizona State University Digital Immersion","2019","Not on tenure/no tenure system, assistant professors","75","28","47","0","0","0","3","1","2","1","0","1","8","3","5","0","0","0","54","20","34","0","0","0","6","1","5","3","3","0","-2"
"483124","Arizona State University Digital Immersion","2019","Not on tenure/no tenure system, instructors","162","59","103","0","0","0","2","1","1","4","1","3","18","3","15","0","0","0","128","49","79","2","2","0","7","2","5","1","1","0","-2"
"483124","Arizona State University Digital Immersion","2019","Not on tenure/no tenure system, lecturers","258","109","149","2","0","2","21","11","10","5","2","3","14","7","7","0","0","0","195","77","118","2","1","1","7","5","2","12","6","6","-2"
"483124","Arizona State University Digital Immersion","2019","Not on tenure/no tenure system, no academic rank","1","0","1","0","0","0","1","0","1","0","0","0","0","0","0","0","0","0","0","0","0","0","0","0","0","0","0","0","0","0","-2"
"484473","University of Florida-Online","2019","Not on tenure track/No tenure system system total","10","3","7","0","0","0","0","0","0","0","0","0","0","0","0","0","0","0","10","3","7","0","0","0","0","0","0","0","0","0","-2"
"484473","University of Florida-Online","2019","Not on tenure/no tenure system, lecturers","6","2","4","0","0","0","0","0","0","0","0","0","0","0","0","0","0","0","6","2","4","0","0","0","0","0","0","0","0","0","-2"
"484473","University of Florida-Online","2019","Not on tenure/no tenure system, no academic rank","4","1","3","0","0","0","0","0","0","0","0","0","0","0","0","0","0","0","4","1","3","0","0","0","0","0","0","0","0","0","-2"
"488800","Teachers College of San Joaquin","2019","Not on tenure track/No tenure system system total","12","0","12","1","0","1","2","0","2","0","0","0","0","0","0","0","0","0","9","0","9","0","0","0","0","0","0","0","0","0","-2"
"488800","Teachers College of San Joaquin","2019","Not on tenure/no tenure system, professors","4","0","4","0","0","0","1","0","1","0","0","0","0","0","0","0","0","0","3","0","3","0","0","0","0","0","0","0","0","0","-2"
"488800","Teachers College of San Joaquin","2019","Not on tenure/no tenure system, instructors","8","0","8","1","0","1","1","0","1","0","0","0","0","0","0","0","0","0","6","0","6","0","0","0","0","0","0","0","0","0","-2"
"490805","Purdue University Northwest","2019","Tenured total","180","108","72","0","0","0","44","26","18","7","3","4","10","7","3","1","0","1","116","71","45","0","0","0","2","1","1","0","0","0","-2"
"490805","Purdue University Northwest","2019","Tenured, professors","81","54","27","0","0","0","23","14","9","3","3","0","3","2","1","0","0","0","51","34","17","0","0","0","1","1","0","0","0","0","-2"
"490805","Purdue University Northwest","2019","Tenured, associate professors","99","54","45","0","0","0","21","12","9","4","0","4","7","5","2","1","0","1","65","37","28","0","0","0","1","0","1","0","0","0","-2"
"490805","Purdue University Northwest","2019","On-Tenure track total","65","34","31","0","0","0","9","8","1","3","3","0","1","0","1","0","0","0","33","12","21","0","0","0","6","2","4","13","9","4","-2"
"490805","Purdue University Northwest","2019","On-tenure track, associate professors","1","1","0","0","0","0","0","0","0","0","0","0","0","0","0","0","0","0","0","0","0","0","0","0","0","0","0","1","1","0","-2"
"490805","Purdue University Northwest","2019","On-tenure track, assistant professors","64","33","31","0","0","0","9","8","1","3","3","0","1","0","1","0","0","0","33","12","21","0","0","0","6","2","4","12","8","4","-2"
"490805","Purdue University Northwest","2019","Not on tenure track/No tenure system system total","38","20","18","0","0","0","2","1","1","1","0","1","0","0","0","0","0","0","22","10","12","0","0","0","9","5","4","4","4","0","-2"
"490805","Purdue University Northwest","2019","Not on tenure/no tenure system, assistant professors","10","6","4","0","0","0","1","1","0","0","0","0","0","0","0","0","0","0","3","1","2","0","0","0","2","0","2","4","4","0","-2"
"490805","Purdue University Northwest","2019","Not on tenure/no tenure system, instructors","28","14","14","0","0","0","1","0","1","1","0","1","0","0","0","0","0","0","19","9","10","0","0","0","7","5","2","0","0","0","-2"
