"unitid","institution name","year","S2011_F.Tenure status and academic rank of full-time instruction/research/public service staff","S2011_F_RV.Grand total","S2011_F_RV.Grand total men","S2011_F_RV.Grand total women","S2011_F_RV.American Indian or Alaska Native total","S2011_F_RV.American Indian or Alaska Native men","S2011_F_RV.American Indian or Alaska Native women","S2011_F_RV.Asian total","S2011_F_RV.Asian men","S2011_F_RV.Asian women","S2011_F_RV.Black or African American total","S2011_F_RV.Black or African American men","S2011_F_RV.Black or African American women","S2011_F_RV.Hispanic or Latino total","S2011_F_RV.Hispanic or Latino men","S2011_F_RV.Hispanic or Latino women","S2011_F_RV.Native Hawaiian or Other Pacific Islander total","S2011_F_RV.Native Hawaiian or Other Pacific Islander men","S2011_F_RV.Native Hawaiian or Other Pacific Islander women","S2011_F_RV.White total","S2011_F_RV.White men","S2011_F_RV.White women","S2011_F_RV.Two or more races total","S2011_F_RV.Two or more races men","S2011_F_RV.Two or more races women","S2011_F_RV.Race/ethnicity unknown total","S2011_F_RV.Race/ethnicity unknown men","S2011_F_RV.Race/ethnicity unknown women","S2011_F_RV.Nonresident alien total","S2011_F_RV.Nonresident alien men","S2011_F_RV.Nonresident alien women","IDX_HR"
"105367","Ottawa University-Phoenix","2011","Total full-time Instruction/research/public service, Tenured, Professors","1","0","1","0","0","0","0","0","0","0","0","0","0","0","0","0","0","0","1","0","1","0","0","0","0","0","0","0","0","0","-2"
"105367","Ottawa University-Phoenix","2011","Total full-time Instruction/research/public service, Tenured, Associate professors","3","1","2","0","0","0","0","0","0","0","0","0","0","0","0","0","0","0","3","1","2","0","0","0","0","0","0","0","0","0","-2"
"105367","Ottawa University-Phoenix","2011","Total full-time Instruction/research/public service, Tenured, Assistant professors","1","0","1","0","0","0","1","0","1","0","0","0","0","0","0","0","0","0","0","0","0","0","0","0","0","0","0","0","0","0","-2"
"105367","Ottawa University-Phoenix","2011","Total full-time Instruction/research/public service, Tenured total","5","1","4","0","0","0","1","0","1","0","0","0","0","0","0","0","0","0","4","1","3","0","0","0","0","0","0","0","0","0","-2"
"105367","Ottawa University-Phoenix","2011","Total full-time Instruction/research/public servicey, Non-tenured not on tenure track, Assistant professors","3","0","3","0","0","0","0","0","0","0","0","0","2","0","2","0","0","0","1","0","1","0","0","0","0","0","0","0","0","0","-2"
"105367","Ottawa University-Phoenix","2011","Total full-time Instruction/research/public service, Non-tenured not on tenure track total","3","0","3","0","0","0","0","0","0","0","0","0","2","0","2","0","0","0","1","0","1","0","0","0","0","0","0","0","0","0","-2"
"109350","Antelope Valley College","2011","Total full-time Instruction/research/public service, Tenured, Professors","72","32","40","1","1","0","2","1","1","6","2","4","3","1","2","0","0","0","58","26","32","0","0","0","2","1","1","0","0","0","-2"
"109350","Antelope Valley College","2011","Total full-time Instruction/research/public service, Tenured, Associate professors","24","15","9","0","0","0","2","1","1","0","0","0","5","4","1","0","0","0","16","9","7","0","0","0","1","1","0","0","0","0","-2"
"109350","Antelope Valley College","2011","Total full-time Instruction/research/public service, Tenured, Assistant professors","8","0","8","0","0","0","0","0","0","0","0","0","0","0","0","0","0","0","8","0","8","0","0","0","0","0","0","0","0","0","-2"
"109350","Antelope Valley College","2011","Total full-time Instruction/research/public service, Tenured, Instructors","64","36","28","0","0","0","3","3","0","4","2","2","6","3","3","0","0","0","48","27","21","0","0","0","3","1","2","0","0","0","-2"
"109350","Antelope Valley College","2011","Total full-time Instruction/research/public service, Tenured total","168","83","85","1","1","0","7","5","2","10","4","6","14","8","6","0","0","0","130","62","68","0","0","0","6","3","3","0","0","0","-2"
"109350","Antelope Valley College","2011","Total full-time Instruction/research/public service, Non-tenured on tenure track, Professors","1","0","1","0","0","0","0","0","0","0","0","0","0","0","0","0","0","0","1","0","1","0","0","0","0","0","0","0","0","0","-2"
"109350","Antelope Valley College","2011","Total full-time Instruction/research/public service, Non-tenured on tenure track, Associate professors","1","1","0","0","0","0","0","0","0","0","0","0","0","0","0","0","0","0","1","1","0","0","0","0","0","0","0","0","0","0","-2"
"109350","Antelope Valley College","2011","Total full-time Instruction/research/public service, Non-tenured on tenure track, Instructors","10","7","3","0","0","0","1","1","0","2","1","1","1","1","0","0","0","0","6","4","2","0","0","0","0","0","0","0","0","0","-2"
"109350","Antelope Valley College","2011","Total full-time Instruction/research/public service, Non-tenured on tenure track total","12","8","4","0","0","0","1","1","0","2","1","1","1","1","0","0","0","0","8","5","3","0","0","0","0","0","0","0","0","0","-2"
"109350","Antelope Valley College","2011","Total full-time Instruction/research/public service, Non-tenured not on tenure track, Instructors","1","1","0","0","0","0","0","0","0","1","1","0","0","0","0","0","0","0","0","0","0","0","0","0","0","0","0","0","0","0","-2"
"109350","Antelope Valley College","2011","Total full-time Instruction/research/public service, Non-tenured not on tenure track total","1","1","0","0","0","0","0","0","0","1","1","0","0","0","0","0","0","0","0","0","0","0","0","0","0","0","0","0","0","0","-2"
"109785","Azusa Pacific University","2011","Total full-time Instruction/research/public service, Non-tenured not on tenure track, Professors","135","83","52","1","0","1","15","9","6","10","8","2","7","3","4","0","0","0","93","56","37","0","0","0","9","7","2","0","0","0","-2"
"109785","Azusa Pacific University","2011","Total full-time Instruction/research/public service, Non-tenured not on tenure track, Associate professors","107","61","46","1","0","1","14","8","6","8","3","5","4","3","1","0","0","0","74","43","31","0","0","0","6","4","2","0","0","0","-2"
"109785","Azusa Pacific University","2011","Total full-time Instruction/research/public servicey, Non-tenured not on tenure track, Assistant professors","129","44","85","0","0","0","17","7","10","9","2","7","16","5","11","2","1","1","78","24","54","0","0","0","7","5","2","0","0","0","-2"
"109785","Azusa Pacific University","2011","Total full-time Instruction/research/public service, Non-tenured not on tenure track, Instructors","16","3","13","0","0","0","3","1","2","2","0","2","0","0","0","0","0","0","11","2","9","0","0","0","0","0","0","0","0","0","-2"
"109785","Azusa Pacific University","2011","Total full-time Instruction/research/public service, Non-tenured not on tenure track total","387","191","196","2","0","2","49","25","24","29","13","16","27","11","16","2","1","1","256","125","131","0","0","0","22","16","6","0","0","0","-2"
"109819","Bakersfield College","2011","Total full-time Instruction/research/public service, Tenured, Instructors","202","106","96","1","0","1","6","2","4","9","4","5","23","11","12","1","1","0","152","84","68","0","0","0","10","4","6","0","0","0","-2"
"109819","Bakersfield College","2011","Total full-time Instruction/research/public service, Tenured total","202","106","96","1","0","1","6","2","4","9","4","5","23","11","12","1","1","0","152","84","68","0","0","0","10","4","6","0","0","0","-2"
"109819","Bakersfield College","2011","Total full-time Instruction/research/public service, Non-tenured on tenure track, Instructors","46","20","26","1","1","0","1","1","0","1","1","0","3","1","2","0","0","0","37","15","22","0","0","0","3","1","2","0","0","0","-2"
"109819","Bakersfield College","2011","Total full-time Instruction/research/public service, Non-tenured on tenure track total","46","20","26","1","1","0","1","1","0","1","1","0","3","1","2","0","0","0","37","15","22","0","0","0","3","1","2","0","0","0","-2"
"109819","Bakersfield College","2011","Total full-time Instruction/research/public service, Non-tenured not on tenure track, Instructors","1","0","1","0","0","0","0","0","0","0","0","0","0","0","0","0","0","0","0","0","0","0","0","0","1","0","1","0","0","0","-2"
"109819","Bakersfield College","2011","Total full-time Instruction/research/public service, Non-tenured not on tenure track total","1","0","1","0","0","0","0","0","0","0","0","0","0","0","0","0","0","0","0","0","0","0","0","0","1","0","1","0","0","0","-2"
"110361","California Baptist University","2011","Total full-time Instruction/research/public service, Tenured, Professors","32","26","6","1","0","1","1","1","0","0","0","0","0","0","0","0","0","0","29","24","5","1","1","0","0","0","0","0","0","0","-2"
"110361","California Baptist University","2011","Total full-time Instruction/research/public service, Tenured, Associate professors","8","5","3","0","0","0","2","2","0","0","0","0","0","0","0","0","0","0","6","3","3","0","0","0","0","0","0","0","0","0","-2"
"110361","California Baptist University","2011","Total full-time Instruction/research/public service, Tenured total","40","31","9","1","0","1","3","3","0","0","0","0","0","0","0","0","0","0","35","27","8","1","1","0","0","0","0","0","0","0","-2"
"110361","California Baptist University","2011","Total full-time Instruction/research/public service, Non-tenured on tenure track, Professors","11","10","1","0","0","0","1","1","0","0","0","0","0","0","0","0","0","0","10","9","1","0","0","0","0","0","0","0","0","0","-2"
"110361","California Baptist University","2011","Total full-time Instruction/research/public service, Non-tenured on tenure track, Associate professors","42","29","13","0","0","0","7","6","1","1","1","0","3","2","1","0","0","0","30","20","10","1","0","1","0","0","0","0","0","0","-2"
"110361","California Baptist University","2011","Total full-time Instruction/research/public service, Non-tenured on tenure track, Assistant professors","86","36","50","1","0","1","6","3","3","2","1","1","5","3","2","1","0","1","70","29","41","1","0","1","0","0","0","0","0","0","-2"
"110361","California Baptist University","2011","Total full-time Instruction/research/public service, Non-tenured on tenure track total","139","75","64","1","0","1","14","10","4","3","2","1","8","5","3","1","0","1","110","58","52","2","0","2","0","0","0","0","0","0","-2"
"110361","California Baptist University","2011","Total full-time Instruction/research/public service, Non-tenured not on tenure track, Instructors","1","0","1","0","0","0","0","0","0","0","0","0","0","0","0","0","0","0","1","0","1","0","0","0","0","0","0","0","0","0","-2"
"110361","California Baptist University","2011","Total full-time Instruction/research/public service, Non-tenured not on tenure track, Lecturers","19","5","14","0","0","0","0","0","0","1","0","1","1","1","0","0","0","0","17","4","13","0","0","0","0","0","0","0","0","0","-2"
"110361","California Baptist University","2011","Total full-time Instruction/research/public service, Non-tenured not on tenure track total","20","5","15","0","0","0","0","0","0","1","0","1","1","1","0","0","0","0","18","4","14","0","0","0","0","0","0","0","0","0","-2"
"110413","California Lutheran University","2011","Total full-time Instruction/research/public service, Tenured, Professors","44","29","15","1","1","0","5","3","2","1","1","0","0","0","0","0","0","0","36","23","13","0","0","0","0","0","0","1","1","0","-2"
"110413","California Lutheran University","2011","Total full-time Instruction/research/public service, Tenured, Associate professors","28","12","16","0","0","0","3","0","3","2","1","1","2","1","1","0","0","0","20","10","10","0","0","0","0","0","0","1","0","1","-2"
"110413","California Lutheran University","2011","Total full-time Instruction/research/public service, Tenured, Assistant professors","2","1","1","0","0","0","0","0","0","0","0","0","1","1","0","0","0","0","1","0","1","0","0","0","0","0","0","0","0","0","-2"
"110413","California Lutheran University","2011","Total full-time Instruction/research/public service, Tenured total","74","42","32","1","1","0","8","3","5","3","2","1","3","2","1","0","0","0","57","33","24","0","0","0","0","0","0","2","1","1","-2"
"110413","California Lutheran University","2011","Total full-time Instruction/research/public service, Non-tenured on tenure track, Professors","1","1","0","0","0","0","0","0","0","0","0","0","0","0","0","0","0","0","1","1","0","0","0","0","0","0","0","0","0","0","-2"
"110413","California Lutheran University","2011","Total full-time Instruction/research/public service, Non-tenured on tenure track, Associate professors","3","0","3","0","0","0","0","0","0","2","0","2","0","0","0","0","0","0","1","0","1","0","0","0","0","0","0","0","0","0","-2"
"110413","California Lutheran University","2011","Total full-time Instruction/research/public service, Non-tenured on tenure track, Assistant professors","37","18","19","0","0","0","3","2","1","1","0","1","3","1","2","0","0","0","28","15","13","0","0","0","0","0","0","2","0","2","-2"
"110413","California Lutheran University","2011","Total full-time Instruction/research/public service, Non-tenured on tenure track, Instructors","2","2","0","0","0","0","0","0","0","0","0","0","0","0","0","0","0","0","2","2","0","0","0","0","0","0","0","0","0","0","-2"
"110413","California Lutheran University","2011","Total full-time Instruction/research/public service, Non-tenured on tenure track total","43","21","22","0","0","0","3","2","1","3","0","3","3","1","2","0","0","0","32","18","14","0","0","0","0","0","0","2","0","2","-2"
"110413","California Lutheran University","2011","Total full-time Instruction/research/public service, Non-tenured not on tenure track, Professors","4","2","2","0","0","0","0","0","0","0","0","0","0","0","0","0","0","0","4","2","2","0","0","0","0","0","0","0","0","0","-2"
"110413","California Lutheran University","2011","Total full-time Instruction/research/public service, Non-tenured not on tenure track, Associate professors","3","2","1","0","0","0","0","0","0","0","0","0","0","0","0","0","0","0","3","2","1","0","0","0","0","0","0","0","0","0","-2"
"110413","California Lutheran University","2011","Total full-time Instruction/research/public servicey, Non-tenured not on tenure track, Assistant professors","7","2","5","0","0","0","1","0","1","0","0","0","2","0","2","0","0","0","4","2","2","0","0","0","0","0","0","0","0","0","-2"
"110413","California Lutheran University","2011","Total full-time Instruction/research/public service, Non-tenured not on tenure track, Instructors","6","5","1","0","0","0","0","0","0","0","0","0","0","0","0","0","0","0","6","5","1","0","0","0","0","0","0","0","0","0","-2"
"110413","California Lutheran University","2011","Total full-time Instruction/research/public service, Non-tenured not on tenure track, Lecturers","27","10","17","0","0","0","1","0","1","0","0","0","0","0","0","0","0","0","25","10","15","1","0","1","0","0","0","0","0","0","-2"
"110413","California Lutheran University","2011","Total full-time Instruction/research/public service, Non-tenured not on tenure track total","47","21","26","0","0","0","2","0","2","0","0","0","2","0","2","0","0","0","42","21","21","1","0","1","0","0","0","0","0","0","-2"
"110486","California State University-Bakersfield","2011","Total full-time Instruction/research/public service, Tenured, Professors","78","54","24","0","0","0","11","9","2","5","3","2","9","7","2","1","1","0","50","32","18","0","0","0","1","1","0","1","1","0","-2"
"110486","California State University-Bakersfield","2011","Total full-time Instruction/research/public service, Tenured, Associate professors","61","31","30","0","0","0","6","4","2","2","1","1","5","2","3","1","0","1","41","20","21","1","0","1","1","1","0","4","3","1","-2"
"110486","California State University-Bakersfield","2011","Total full-time Instruction/research/public service, Tenured, Assistant professors","2","1","1","0","0","0","1","1","0","0","0","0","0","0","0","0","0","0","1","0","1","0","0","0","0","0","0","0","0","0","-2"
"110486","California State University-Bakersfield","2011","Total full-time Instruction/research/public service, Tenured total","141","86","55","0","0","0","18","14","4","7","4","3","14","9","5","2","1","1","92","52","40","1","0","1","2","2","0","5","4","1","-2"
"110486","California State University-Bakersfield","2011","Total full-time Instruction/research/public service, Non-tenured on tenure track, Associate professors","1","0","1","0","0","0","0","0","0","0","0","0","0","0","0","0","0","0","1","0","1","0","0","0","0","0","0","0","0","0","-2"
"110486","California State University-Bakersfield","2011","Total full-time Instruction/research/public service, Non-tenured on tenure track, Assistant professors","27","10","17","0","0","0","3","1","2","2","0","2","7","4","3","0","0","0","12","4","8","0","0","0","0","0","0","3","1","2","-2"
"110486","California State University-Bakersfield","2011","Total full-time Instruction/research/public service, Non-tenured on tenure track total","28","10","18","0","0","0","3","1","2","2","0","2","7","4","3","0","0","0","13","4","9","0","0","0","0","0","0","3","1","2","-2"
"110486","California State University-Bakersfield","2011","Total full-time Instruction/research/public service, Non-tenured not on tenure track, Lecturers","61","13","48","0","0","0","4","0","4","0","0","0","5","2","3","0","0","0","49","10","39","1","1","0","1","0","1","1","0","1","-2"
"110486","California State University-Bakersfield","2011","Total full-time Instruction/research/public service, Non-tenured not on tenure track total","61","13","48","0","0","0","4","0","4","0","0","0","5","2","3","0","0","0","49","10","39","1","1","0","1","0","1","1","0","1","-2"
"110495","California State University-Stanislaus","2011","Total full-time Instruction/research/public service, Tenured, Professors","112","69","43","0","0","0","14","5","9","1","1","0","8","4","4","0","0","0","82","54","28","0","0","0","7","5","2","0","0","0","-2"
"110495","California State University-Stanislaus","2011","Total full-time Instruction/research/public service, Tenured, Associate professors","58","31","27","1","0","1","7","2","5","3","3","0","5","2","3","0","0","0","37","20","17","0","0","0","4","4","0","1","0","1","-2"
"110495","California State University-Stanislaus","2011","Total full-time Instruction/research/public service, Tenured, Assistant professors","1","1","0","0","0","0","0","0","0","0","0","0","0","0","0","0","0","0","1","1","0","0","0","0","0","0","0","0","0","0","-2"
"110495","California State University-Stanislaus","2011","Total full-time Instruction/research/public service, Tenured total","171","101","70","1","0","1","21","7","14","4","4","0","13","6","7","0","0","0","120","75","45","0","0","0","11","9","2","1","0","1","-2"
"110495","California State University-Stanislaus","2011","Total full-time Instruction/research/public service, Non-tenured on tenure track, Professors","1","1","0","0","0","0","0","0","0","0","0","0","0","0","0","0","0","0","1","1","0","0","0","0","0","0","0","0","0","0","-2"
"110495","California State University-Stanislaus","2011","Total full-time Instruction/research/public service, Non-tenured on tenure track, Assistant professors","57","27","30","0","0","0","4","2","2","3","1","2","7","5","2","0","0","0","35","16","19","0","0","0","3","1","2","5","2","3","-2"
"110495","California State University-Stanislaus","2011","Total full-time Instruction/research/public service, Non-tenured on tenure track total","58","28","30","0","0","0","4","2","2","3","1","2","7","5","2","0","0","0","36","17","19","0","0","0","3","1","2","5","2","3","-2"
"110495","California State University-Stanislaus","2011","Total full-time Instruction/research/public service, Non-tenured not on tenure track, Lecturers","52","24","28","1","1","0","4","2","2","1","0","1","4","2","2","0","0","0","38","16","22","0","0","0","4","3","1","0","0","0","-2"
"110495","California State University-Stanislaus","2011","Total full-time Instruction/research/public service, Non-tenured not on tenure track total","52","24","28","1","1","0","4","2","2","1","0","1","4","2","2","0","0","0","38","16","22","0","0","0","4","3","1","0","0","0","-2"
"110510","California State University-San Bernardino","2011","Total full-time Instruction/research/public service, Tenured, Professors","213","140","73","2","1","1","33","21","12","11","4","7","18","11","7","0","0","0","145","100","45","1","1","0","3","2","1","0","0","0","-2"
"110510","California State University-San Bernardino","2011","Total full-time Instruction/research/public service, Tenured, Associate professors","68","34","34","0","0","0","7","3","4","2","0","2","4","2","2","0","0","0","52","27","25","0","0","0","1","0","1","2","2","0","-2"
"110510","California State University-San Bernardino","2011","Total full-time Instruction/research/public service, Tenured, Assistant professors","6","2","4","0","0","0","0","0","0","1","0","1","0","0","0","0","0","0","5","2","3","0","0","0","0","0","0","0","0","0","-2"
"110510","California State University-San Bernardino","2011","Total full-time Instruction/research/public service, Tenured, No academic rank","1","0","1","0","0","0","0","0","0","0","0","0","0","0","0","0","0","0","1","0","1","0","0","0","0","0","0","0","0","0","-2"
"110510","California State University-San Bernardino","2011","Total full-time Instruction/research/public service, Tenured total","288","176","112","2","1","1","40","24","16","14","4","10","22","13","9","0","0","0","203","129","74","1","1","0","4","2","2","2","2","0","-2"
"110510","California State University-San Bernardino","2011","Total full-time Instruction/research/public service, Non-tenured on tenure track, Professors","2","2","0","0","0","0","2","2","0","0","0","0","0","0","0","0","0","0","0","0","0","0","0","0","0","0","0","0","0","0","-2"
"110510","California State University-San Bernardino","2011","Total full-time Instruction/research/public service, Non-tenured on tenure track, Associate professors","2","2","0","0","0","0","1","1","0","0","0","0","0","0","0","0","0","0","1","1","0","0","0","0","0","0","0","0","0","0","-2"
"110510","California State University-San Bernardino","2011","Total full-time Instruction/research/public service, Non-tenured on tenure track, Assistant professors","70","32","38","0","0","0","12","6","6","5","3","2","8","5","3","0","0","0","32","12","20","0","0","0","4","1","3","9","5","4","-2"
"110510","California State University-San Bernardino","2011","Total full-time Instruction/research/public service, Non-tenured on tenure track total","74","36","38","0","0","0","15","9","6","5","3","2","8","5","3","0","0","0","33","13","20","0","0","0","4","1","3","9","5","4","-2"
"110510","California State University-San Bernardino","2011","Total full-time Instruction/research/public service, Non-tenured not on tenure track, Lecturers","72","23","49","0","0","0","3","1","2","1","0","1","6","2","4","1","0","1","58","17","41","0","0","0","2","2","0","1","1","0","-2"
"110510","California State University-San Bernardino","2011","Total full-time Instruction/research/public service, Non-tenured not on tenure track total","72","23","49","0","0","0","3","1","2","1","0","1","6","2","4","1","0","1","58","17","41","0","0","0","2","2","0","1","1","0","-2"
"110529","California State Polytechnic University-Pomona","2011","Total full-time Instruction/research/public service, Tenured, Professors","263","170","93","0","0","0","62","45","17","8","5","3","18","13","5","1","1","0","165","101","64","0","0","0","8","4","4","1","1","0","-2"
"110529","California State Polytechnic University-Pomona","2011","Total full-time Instruction/research/public service, Tenured, Associate professors","76","41","35","1","0","1","6","4","2","2","2","0","13","8","5","0","0","0","44","21","23","1","0","1","8","5","3","1","1","0","-2"
"110529","California State Polytechnic University-Pomona","2011","Total full-time Instruction/research/public service, Tenured total","339","211","128","1","0","1","68","49","19","10","7","3","31","21","10","1","1","0","209","122","87","1","0","1","16","9","7","2","2","0","-2"
"110529","California State Polytechnic University-Pomona","2011","Total full-time Instruction/research/public service, Non-tenured on tenure track, Professors","1","1","0","0","0","0","0","0","0","0","0","0","0","0","0","0","0","0","1","1","0","0","0","0","0","0","0","0","0","0","-2"
"110529","California State Polytechnic University-Pomona","2011","Total full-time Instruction/research/public service, Non-tenured on tenure track, Associate professors","13","10","3","0","0","0","3","3","0","1","1","0","1","0","1","0","0","0","6","5","1","0","0","0","0","0","0","2","1","1","-2"
"110529","California State Polytechnic University-Pomona","2011","Total full-time Instruction/research/public service, Non-tenured on tenure track, Assistant professors","101","48","53","0","0","0","25","11","14","5","3","2","3","2","1","0","0","0","40","21","19","0","0","0","5","3","2","23","8","15","-2"
"110529","California State Polytechnic University-Pomona","2011","Total full-time Instruction/research/public service, Non-tenured on tenure track total","115","59","56","0","0","0","28","14","14","6","4","2","4","2","2","0","0","0","47","27","20","0","0","0","5","3","2","25","9","16","-2"
"110529","California State Polytechnic University-Pomona","2011","Total full-time Instruction/research/public service, Non-tenured not on tenure track, Lecturers","61","34","27","0","0","0","9","6","3","3","1","2","7","4","3","0","0","0","40","22","18","1","0","1","1","1","0","0","0","0","-2"
"110529","California State Polytechnic University-Pomona","2011","Total full-time Instruction/research/public service, Non-tenured not on tenure track total","61","34","27","0","0","0","9","6","3","3","1","2","7","4","3","0","0","0","40","22","18","1","0","1","1","1","0","0","0","0","-2"
"110547","California State University-Dominguez Hills","2011","Total full-time Instruction/research/public service, Tenured, Professors","82","47","35","0","0","0","8","5","3","5","1","4","6","4","2","0","0","0","58","36","22","0","0","0","5","1","4","0","0","0","-2"
"110547","California State University-Dominguez Hills","2011","Total full-time Instruction/research/public service, Tenured, Associate professors","68","31","37","1","0","1","12","6","6","9","5","4","2","1","1","0","0","0","39","17","22","0","0","0","5","2","3","0","0","0","-2"
"110547","California State University-Dominguez Hills","2011","Total full-time Instruction/research/public service, Tenured, Assistant professors","7","3","4","0","0","0","1","1","0","2","1","1","1","1","0","0","0","0","2","0","2","1","0","1","0","0","0","0","0","0","-2"
"110547","California State University-Dominguez Hills","2011","Total full-time Instruction/research/public service, Tenured total","157","81","76","1","0","1","21","12","9","16","7","9","9","6","3","0","0","0","99","53","46","1","0","1","10","3","7","0","0","0","-2"
"110547","California State University-Dominguez Hills","2011","Total full-time Instruction/research/public service, Non-tenured on tenure track, Professors","1","1","0","0","0","0","0","0","0","0","0","0","1","1","0","0","0","0","0","0","0","0","0","0","0","0","0","0","0","0","-2"
"110547","California State University-Dominguez Hills","2011","Total full-time Instruction/research/public service, Non-tenured on tenure track, Associate professors","7","4","3","0","0","0","1","1","0","0","0","0","2","2","0","0","0","0","4","1","3","0","0","0","0","0","0","0","0","0","-2"
"110547","California State University-Dominguez Hills","2011","Total full-time Instruction/research/public service, Non-tenured on tenure track, Assistant professors","34","12","22","0","0","0","3","0","3","3","2","1","5","3","2","0","0","0","18","5","13","1","1","0","3","1","2","1","0","1","-2"
"110547","California State University-Dominguez Hills","2011","Total full-time Instruction/research/public service, Non-tenured on tenure track total","42","17","25","0","0","0","4","1","3","3","2","1","8","6","2","0","0","0","22","6","16","1","1","0","3","1","2","1","0","1","-2"
"110547","California State University-Dominguez Hills","2011","Total full-time Instruction/research/public service, Non-tenured not on tenure track, Lecturers","75","33","42","1","0","1","4","3","1","11","3","8","7","3","4","0","0","0","47","21","26","1","1","0","4","2","2","0","0","0","-2"
"110547","California State University-Dominguez Hills","2011","Total full-time Instruction/research/public service, Non-tenured not on tenure track total","75","33","42","1","0","1","4","3","1","11","3","8","7","3","4","0","0","0","47","21","26","1","1","0","4","2","2","0","0","0","-2"
"110556","California State University-Fresno","2011","Total full-time Instruction/research/public service, Tenured, Professors","220","150","70","1","1","0","25","23","2","12","7","5","19","15","4","0","0","0","160","103","57","0","0","0","3","1","2","0","0","0","-2"
"110556","California State University-Fresno","2011","Total full-time Instruction/research/public service, Tenured, Associate professors","145","85","60","1","0","1","17","11","6","3","2","1","14","8","6","0","0","0","102","59","43","3","3","0","3","2","1","2","0","2","-2"
"110556","California State University-Fresno","2011","Total full-time Instruction/research/public service, Tenured, Assistant professors","4","1","3","0","0","0","0","0","0","0","0","0","1","0","1","0","0","0","3","1","2","0","0","0","0","0","0","0","0","0","-2"
"110556","California State University-Fresno","2011","Total full-time Instruction/research/public service, Tenured, No academic rank","3","2","1","0","0","0","0","0","0","0","0","0","1","0","1","0","0","0","2","2","0","0","0","0","0","0","0","0","0","0","-2"
"110556","California State University-Fresno","2011","Total full-time Instruction/research/public service, Tenured total","372","238","134","2","1","1","42","34","8","15","9","6","35","23","12","0","0","0","267","165","102","3","3","0","6","3","3","2","0","2","-2"
"110556","California State University-Fresno","2011","Total full-time Instruction/research/public service, Non-tenured on tenure track, Associate professors","9","7","2","0","0","0","3","2","1","0","0","0","1","0","1","0","0","0","3","3","0","0","0","0","0","0","0","2","2","0","-2"
"110556","California State University-Fresno","2011","Total full-time Instruction/research/public service, Non-tenured on tenure track, Assistant professors","130","69","61","1","0","1","30","20","10","5","2","3","12","6","6","0","0","0","70","37","33","2","1","1","3","0","3","7","3","4","-2"
"110556","California State University-Fresno","2011","Total full-time Instruction/research/public service, Non-tenured on tenure track total","139","76","63","1","0","1","33","22","11","5","2","3","13","6","7","0","0","0","73","40","33","2","1","1","3","0","3","9","5","4","-2"
"110556","California State University-Fresno","2011","Total full-time Instruction/research/public service, Non-tenured not on tenure track, Lecturers","120","53","67","0","0","0","9","5","4","2","0","2","12","5","7","0","0","0","92","41","51","2","1","1","2","1","1","1","0","1","-2"
"110556","California State University-Fresno","2011","Total full-time Instruction/research/public service, Non-tenured not on tenure track total","120","53","67","0","0","0","9","5","4","2","0","2","12","5","7","0","0","0","92","41","51","2","1","1","2","1","1","1","0","1","-2"
"110565","California State University-Fullerton","2011","Total full-time Instruction/research/public service, Tenured, Professors","256","166","90","1","1","0","47","32","15","8","3","5","12","7","5","0","0","0","187","122","65","1","1","0","0","0","0","0","0","0","-2"
"110565","California State University-Fullerton","2011","Total full-time Instruction/research/public service, Tenured, Associate professors","180","90","90","0","0","0","31","14","17","4","3","1","16","8","8","0","0","0","124","60","64","1","1","0","0","0","0","4","4","0","-2"
"110565","California State University-Fullerton","2011","Total full-time Instruction/research/public service, Tenured, Assistant professors","1","0","1","0","0","0","0","0","0","0","0","0","0","0","0","0","0","0","1","0","1","0","0","0","0","0","0","0","0","0","-2"
"110565","California State University-Fullerton","2011","Total full-time Instruction/research/public service, Tenured total","437","256","181","1","1","0","78","46","32","12","6","6","28","15","13","0","0","0","312","182","130","2","2","0","0","0","0","4","4","0","-2"
"110565","California State University-Fullerton","2011","Total full-time Instruction/research/public service, Non-tenured on tenure track, Professors","5","2","3","0","0","0","3","1","2","0","0","0","0","0","0","0","0","0","2","1","1","0","0","0","0","0","0","0","0","0","-2"
"110565","California State University-Fullerton","2011","Total full-time Instruction/research/public service, Non-tenured on tenure track, Associate professors","32","20","12","0","0","0","11","7","4","0","0","0","0","0","0","0","0","0","16","10","6","0","0","0","0","0","0","5","3","2","-2"
"110565","California State University-Fullerton","2011","Total full-time Instruction/research/public service, Non-tenured on tenure track, Assistant professors","224","115","109","1","0","1","28","14","14","11","5","6","18","13","5","0","0","0","136","68","68","2","0","2","0","0","0","28","15","13","-2"
"110565","California State University-Fullerton","2011","Total full-time Instruction/research/public service, Non-tenured on tenure track total","261","137","124","1","0","1","42","22","20","11","5","6","18","13","5","0","0","0","154","79","75","2","0","2","0","0","0","33","18","15","-2"
"110565","California State University-Fullerton","2011","Total full-time Instruction/research/public service, Non-tenured not on tenure track, Lecturers","182","65","117","0","0","0","20","7","13","4","4","0","9","2","7","0","0","0","143","47","96","3","2","1","0","0","0","3","3","0","-2"
"110565","California State University-Fullerton","2011","Total full-time Instruction/research/public service, Non-tenured not on tenure track total","182","65","117","0","0","0","20","7","13","4","4","0","9","2","7","0","0","0","143","47","96","3","2","1","0","0","0","3","3","0","-2"
"110574","California State University-East Bay","2011","Total full-time Instruction/research/public service, Tenured, Professors","109","67","42","0","0","0","12","7","5","8","6","2","15","8","7","1","1","0","72","44","28","0","0","0","1","1","0","0","0","0","-2"
"110574","California State University-East Bay","2011","Total full-time Instruction/research/public service, Tenured, Associate professors","82","41","41","1","1","0","21","12","9","5","1","4","8","4","4","1","0","1","41","20","21","0","0","0","3","1","2","2","2","0","-2"
"110574","California State University-East Bay","2011","Total full-time Instruction/research/public service, Tenured, Assistant professors","5","4","1","0","0","0","0","0","0","0","0","0","2","1","1","0","0","0","3","3","0","0","0","0","0","0","0","0","0","0","-2"
"110574","California State University-East Bay","2011","Total full-time Instruction/research/public service, Tenured total","196","112","84","1","1","0","33","19","14","13","7","6","25","13","12","2","1","1","116","67","49","0","0","0","4","2","2","2","2","0","-2"
"110574","California State University-East Bay","2011","Total full-time Instruction/research/public service, Non-tenured on tenure track, Associate professors","7","1","6","0","0","0","1","0","1","0","0","0","0","0","0","0","0","0","6","1","5","0","0","0","0","0","0","0","0","0","-2"
"110574","California State University-East Bay","2011","Total full-time Instruction/research/public service, Non-tenured on tenure track, Assistant professors","71","33","38","1","1","0","12","5","7","4","1","3","3","1","2","0","0","0","33","14","19","0","0","0","8","5","3","10","6","4","-2"
"110574","California State University-East Bay","2011","Total full-time Instruction/research/public service, Non-tenured on tenure track total","78","34","44","1","1","0","13","5","8","4","1","3","3","1","2","0","0","0","39","15","24","0","0","0","8","5","3","10","6","4","-2"
"110574","California State University-East Bay","2011","Total full-time Instruction/research/public service, Non-tenured not on tenure track, Lecturers","36","14","22","0","0","0","3","1","2","3","0","3","2","2","0","0","0","0","25","11","14","0","0","0","2","0","2","1","0","1","-2"
"110574","California State University-East Bay","2011","Total full-time Instruction/research/public service, Non-tenured not on tenure track total","36","14","22","0","0","0","3","1","2","3","0","3","2","2","0","0","0","0","25","11","14","0","0","0","2","0","2","1","0","1","-2"
"110583","California State University-Long Beach","2011","Total full-time Instruction/research/public service, Tenured, Professors","380","244","136","1","1","0","70","42","28","10","8","2","25","18","7","0","0","0","267","170","97","0","0","0","7","5","2","0","0","0","-2"
"110583","California State University-Long Beach","2011","Total full-time Instruction/research/public service, Tenured, Associate professors","171","82","89","1","1","0","30","13","17","6","6","0","16","6","10","0","0","0","113","54","59","2","1","1","2","1","1","1","0","1","-2"
"110583","California State University-Long Beach","2011","Total full-time Instruction/research/public service, Tenured, Assistant professors","4","2","2","0","0","0","2","1","1","0","0","0","0","0","0","0","0","0","2","1","1","0","0","0","0","0","0","0","0","0","-2"
"110583","California State University-Long Beach","2011","Total full-time Instruction/research/public service, Tenured, No academic rank","4","3","1","0","0","0","0","0","0","0","0","0","0","0","0","0","0","0","4","3","1","0","0","0","0","0","0","0","0","0","-2"
"110583","California State University-Long Beach","2011","Total full-time Instruction/research/public service, Tenured total","559","331","228","2","2","0","102","56","46","16","14","2","41","24","17","0","0","0","386","228","158","2","1","1","9","6","3","1","0","1","-2"
"110583","California State University-Long Beach","2011","Total full-time Instruction/research/public service, Non-tenured on tenure track, Associate professors","10","9","1","0","0","0","2","2","0","0","0","0","1","1","0","0","0","0","2","2","0","0","0","0","3","3","0","2","1","1","-2"
"110583","California State University-Long Beach","2011","Total full-time Instruction/research/public service, Non-tenured on tenure track, Assistant professors","190","82","108","1","0","1","36","10","26","10","4","6","21","10","11","0","0","0","92","43","49","3","2","1","10","8","2","17","5","12","-2"
"110583","California State University-Long Beach","2011","Total full-time Instruction/research/public service, Non-tenured on tenure track total","200","91","109","1","0","1","38","12","26","10","4","6","22","11","11","0","0","0","94","45","49","3","2","1","13","11","2","19","6","13","-2"
"110583","California State University-Long Beach","2011","Total full-time Instruction/research/public service, Non-tenured not on tenure track, Lecturers","205","98","107","1","0","1","20","8","12","7","3","4","18","6","12","0","0","0","149","75","74","2","1","1","6","4","2","2","1","1","-2"
"110583","California State University-Long Beach","2011","Total full-time Instruction/research/public service, Non-tenured not on tenure track total","205","98","107","1","0","1","20","8","12","7","3","4","18","6","12","0","0","0","149","75","74","2","1","1","6","4","2","2","1","1","-2"
"110592","California State University-Los Angeles","2011","Total full-time Instruction/research/public service, Tenured, Professors","273","160","113","2","0","2","68","43","25","12","7","5","34","21","13","0","0","0","151","85","66","2","0","2","4","4","0","0","0","0","-2"
"110592","California State University-Los Angeles","2011","Total full-time Instruction/research/public service, Tenured, Associate professors","111","56","55","0","0","0","27","14","13","7","4","3","14","8","6","0","0","0","61","29","32","0","0","0","2","1","1","0","0","0","-2"
"110592","California State University-Los Angeles","2011","Total full-time Instruction/research/public service, Tenured, No academic rank","1","1","0","0","0","0","0","0","0","0","0","0","1","1","0","0","0","0","0","0","0","0","0","0","0","0","0","0","0","0","-2"
"110592","California State University-Los Angeles","2011","Total full-time Instruction/research/public service, Tenured total","385","217","168","2","0","2","95","57","38","19","11","8","49","30","19","0","0","0","212","114","98","2","0","2","6","5","1","0","0","0","-2"
"110592","California State University-Los Angeles","2011","Total full-time Instruction/research/public service, Non-tenured on tenure track, Associate professors","19","10","9","0","0","0","5","1","4","0","0","0","4","2","2","1","1","0","7","4","3","0","0","0","1","1","0","1","1","0","-2"
"110592","California State University-Los Angeles","2011","Total full-time Instruction/research/public service, Non-tenured on tenure track, Assistant professors","94","41","53","1","0","1","20","9","11","3","1","2","13","7","6","0","0","0","45","18","27","0","0","0","6","2","4","6","4","2","-2"
"110592","California State University-Los Angeles","2011","Total full-time Instruction/research/public service, Non-tenured on tenure track total","113","51","62","1","0","1","25","10","15","3","1","2","17","9","8","1","1","0","52","22","30","0","0","0","7","3","4","7","5","2","-2"
"110592","California State University-Los Angeles","2011","Total full-time Instruction/research/public service, Non-tenured not on tenure track, Lecturers","66","25","41","0","0","0","10","5","5","6","1","5","12","7","5","0","0","0","33","11","22","0","0","0","4","1","3","1","0","1","-2"
"110592","California State University-Los Angeles","2011","Total full-time Instruction/research/public service, Non-tenured not on tenure track total","66","25","41","0","0","0","10","5","5","6","1","5","12","7","5","0","0","0","33","11","22","0","0","0","4","1","3","1","0","1","-2"
"110608","California State University-Northridge","2011","Total full-time Instruction/research/public service, Tenured, Professors","346","206","140","2","1","1","43","27","16","16","9","7","39","20","19","0","0","0","241","145","96","4","3","1","0","0","0","1","1","0","-2"
"110608","California State University-Northridge","2011","Total full-time Instruction/research/public service, Tenured, Associate professors","175","92","83","1","0","1","28","18","10","9","4","5","24","9","15","0","0","0","106","57","49","1","0","1","2","1","1","4","3","1","-2"
"110608","California State University-Northridge","2011","Total full-time Instruction/research/public service, Tenured, Assistant professors","2","2","0","0","0","0","0","0","0","0","0","0","1","1","0","0","0","0","1","1","0","0","0","0","0","0","0","0","0","0","-2"
"110608","California State University-Northridge","2011","Total full-time Instruction/research/public service, Tenured, No academic rank","3","2","1","0","0","0","1","1","0","0","0","0","1","0","1","0","0","0","1","1","0","0","0","0","0","0","0","0","0","0","-2"
"110608","California State University-Northridge","2011","Total full-time Instruction/research/public service, Tenured total","526","302","224","3","1","2","72","46","26","25","13","12","65","30","35","0","0","0","349","204","145","5","3","2","2","1","1","5","4","1","-2"
"110608","California State University-Northridge","2011","Total full-time Instruction/research/public service, Non-tenured on tenure track, Professors","1","1","0","0","0","0","0","0","0","0","0","0","0","0","0","0","0","0","1","1","0","0","0","0","0","0","0","0","0","0","-2"
"110608","California State University-Northridge","2011","Total full-time Instruction/research/public service, Non-tenured on tenure track, Associate professors","29","12","17","0","0","0","2","1","1","3","1","2","1","1","0","0","0","0","23","9","14","0","0","0","0","0","0","0","0","0","-2"
"110608","California State University-Northridge","2011","Total full-time Instruction/research/public service, Non-tenured on tenure track, Assistant professors","181","85","96","2","1","1","30","12","18","13","5","8","17","10","7","0","0","0","96","45","51","2","0","2","10","6","4","11","6","5","-2"
"110608","California State University-Northridge","2011","Total full-time Instruction/research/public service, Non-tenured on tenure track total","211","98","113","2","1","1","32","13","19","16","6","10","18","11","7","0","0","0","120","55","65","2","0","2","10","6","4","11","6","5","-2"
"110608","California State University-Northridge","2011","Total full-time Instruction/research/public service, Non-tenured not on tenure track, Lecturers","113","44","69","1","0","1","11","4","7","7","4","3","20","12","8","0","0","0","72","23","49","0","0","0","2","1","1","0","0","0","-2"
"110608","California State University-Northridge","2011","Total full-time Instruction/research/public service, Non-tenured not on tenure track total","113","44","69","1","0","1","11","4","7","7","4","3","20","12","8","0","0","0","72","23","49","0","0","0","2","1","1","0","0","0","-2"
"110617","California State University-Sacramento","2011","Total full-time Instruction/research/public service, Tenured, Professors","287","170","117","2","1","1","31","19","12","17","5","12","29","20","9","2","2","0","204","122","82","0","0","0","1","1","0","1","0","1","-2"
"110617","California State University-Sacramento","2011","Total full-time Instruction/research/public service, Tenured, Associate professors","198","105","93","4","2","2","29","19","10","10","5","5","14","7","7","0","0","0","125","66","59","2","1","1","6","2","4","8","3","5","-2"
"110617","California State University-Sacramento","2011","Total full-time Instruction/research/public service, Tenured, Assistant professors","5","3","2","0","0","0","1","1","0","0","0","0","0","0","0","0","0","0","3","1","2","0","0","0","1","1","0","0","0","0","-2"
"110617","California State University-Sacramento","2011","Total full-time Instruction/research/public service, Tenured, No academic rank","1","1","0","0","0","0","0","0","0","0","0","0","0","0","0","0","0","0","1","1","0","0","0","0","0","0","0","0","0","0","-2"
"110617","California State University-Sacramento","2011","Total full-time Instruction/research/public service, Tenured total","491","279","212","6","3","3","61","39","22","27","10","17","43","27","16","2","2","0","333","190","143","2","1","1","8","4","4","9","3","6","-2"
"110617","California State University-Sacramento","2011","Total full-time Instruction/research/public service, Non-tenured on tenure track, Professors","1","1","0","0","0","0","0","0","0","0","0","0","1","1","0","0","0","0","0","0","0","0","0","0","0","0","0","0","0","0","-2"
"110617","California State University-Sacramento","2011","Total full-time Instruction/research/public service, Non-tenured on tenure track, Associate professors","3","0","3","0","0","0","0","0","0","0","0","0","0","0","0","0","0","0","2","0","2","0","0","0","0","0","0","1","0","1","-2"
"110617","California State University-Sacramento","2011","Total full-time Instruction/research/public service, Non-tenured on tenure track, Assistant professors","114","57","57","1","1","0","17","8","9","3","2","1","8","1","7","0","0","0","59","27","32","0","0","0","7","4","3","19","14","5","-2"
"110617","California State University-Sacramento","2011","Total full-time Instruction/research/public service, Non-tenured on tenure track total","118","58","60","1","1","0","17","8","9","3","2","1","9","2","7","0","0","0","61","27","34","0","0","0","7","4","3","20","14","6","-2"
"110617","California State University-Sacramento","2011","Total full-time Instruction/research/public service, Non-tenured not on tenure track, Lecturers","92","33","59","0","0","0","2","1","1","1","1","0","4","0","4","1","0","1","76","26","50","2","1","1","5","3","2","1","1","0","-2"
"110617","California State University-Sacramento","2011","Total full-time Instruction/research/public service, Non-tenured not on tenure track total","92","33","59","0","0","0","2","1","1","1","1","0","4","0","4","1","0","1","76","26","50","2","1","1","5","3","2","1","1","0","-2"
"110671","University of California-Riverside","2011","Total full-time Instruction/research/public service, Tenured, Professors","325","263","62","1","1","0","57","49","8","7","6","1","12","8","4","0","0","0","244","195","49","0","0","0","4","4","0","0","0","0","-2"
"110671","University of California-Riverside","2011","Total full-time Instruction/research/public service, Tenured, Associate professors","143","76","67","2","0","2","20","7","13","6","5","1","11","6","5","0","0","0","98","55","43","0","0","0","5","3","2","1","0","1","-2"
"110671","University of California-Riverside","2011","Total full-time Instruction/research/public service, Tenured, Lecturers","1","0","1","0","0","0","0","0","0","0","0","0","0","0","0","0","0","0","1","0","1","0","0","0","0","0","0","0","0","0","-2"
"110671","University of California-Riverside","2011","Total full-time Instruction/research/public service, Tenured total","469","339","130","3","1","2","77","56","21","13","11","2","23","14","9","0","0","0","343","250","93","0","0","0","9","7","2","1","0","1","-2"
"110671","University of California-Riverside","2011","Total full-time Instruction/research/public service, Non-tenured on tenure track, Assistant professors","148","83","65","1","1","0","51","30","21","6","2","4","11","5","6","0","0","0","68","41","27","0","0","0","7","2","5","4","2","2","-2"
"110671","University of California-Riverside","2011","Total full-time Instruction/research/public service, Non-tenured on tenure track, Lecturers","1","1","0","0","0","0","0","0","0","0","0","0","0","0","0","0","0","0","1","1","0","0","0","0","0","0","0","0","0","0","-2"
"110671","University of California-Riverside","2011","Total full-time Instruction/research/public service, Non-tenured on tenure track total","149","84","65","1","1","0","51","30","21","6","2","4","11","5","6","0","0","0","69","42","27","0","0","0","7","2","5","4","2","2","-2"
"110671","University of California-Riverside","2011","Total full-time Instruction/research/public service, Non-tenured not on tenure track, Professors","1","0","1","0","0","0","0","0","0","0","0","0","0","0","0","0","0","0","1","0","1","0","0","0","0","0","0","0","0","0","-2"
"110671","University of California-Riverside","2011","Total full-time Instruction/research/public service, Non-tenured not on tenure track, Associate professors","1","1","0","0","0","0","0","0","0","0","0","0","0","0","0","0","0","0","1","1","0","0","0","0","0","0","0","0","0","0","-2"
"110671","University of California-Riverside","2011","Total full-time Instruction/research/public servicey, Non-tenured not on tenure track, Assistant professors","21","13","8","0","0","0","5","3","2","2","1","1","1","1","0","0","0","0","10","7","3","1","0","1","1","0","1","1","1","0","-2"
"110671","University of California-Riverside","2011","Total full-time Instruction/research/public service, Non-tenured not on tenure track, Lecturers","70","31","39","2","2","0","8","3","5","1","0","1","6","1","5","0","0","0","51","25","26","0","0","0","2","0","2","0","0","0","-2"
"110671","University of California-Riverside","2011","Total full-time Instruction/research/public service, Non-tenured not on tenure track, No academic rank","1","0","1","0","0","0","0","0","0","0","0","0","0","0","0","0","0","0","1","0","1","0","0","0","0","0","0","0","0","0","-2"
"110671","University of California-Riverside","2011","Total full-time Instruction/research/public service, Non-tenured not on tenure track total","94","45","49","2","2","0","13","6","7","3","1","2","7","2","5","0","0","0","64","33","31","1","0","1","3","0","3","1","1","0","-2"
"110705","University of California-Santa Barbara","2011","Total full-time Instruction/research/public service, Tenured, Professors","498","362","136","3","1","2","49","36","13","5","2","3","21","18","3","0","0","0","419","304","115","0","0","0","0","0","0","1","1","0","-2"
"110705","University of California-Santa Barbara","2011","Total full-time Instruction/research/public service, Tenured, Associate professors","175","101","74","0","0","0","25","13","12","7","4","3","17","8","9","0","0","0","126","76","50","0","0","0","0","0","0","0","0","0","-2"
"110705","University of California-Santa Barbara","2011","Total full-time Instruction/research/public service, Tenured, Lecturers","19","11","8","0","0","0","1","0","1","1","1","0","2","1","1","0","0","0","15","9","6","0","0","0","0","0","0","0","0","0","-2"
"110705","University of California-Santa Barbara","2011","Total full-time Instruction/research/public service, Tenured total","692","474","218","3","1","2","75","49","26","13","7","6","40","27","13","0","0","0","560","389","171","0","0","0","0","0","0","1","1","0","-2"
"110705","University of California-Santa Barbara","2011","Total full-time Instruction/research/public service, Non-tenured on tenure track, Professors","1","1","0","0","0","0","0","0","0","0","0","0","0","0","0","0","0","0","0","0","0","0","0","0","0","0","0","1","1","0","-2"
"110705","University of California-Santa Barbara","2011","Total full-time Instruction/research/public service, Non-tenured on tenure track, Associate professors","1","1","0","0","0","0","0","0","0","0","0","0","0","0","0","0","0","0","1","1","0","0","0","0","0","0","0","0","0","0","-2"
"110705","University of California-Santa Barbara","2011","Total full-time Instruction/research/public service, Non-tenured on tenure track, Assistant professors","78","41","37","3","0","3","8","5","3","5","2","3","6","3","3","0","0","0","48","27","21","0","0","0","2","1","1","6","3","3","-2"
"110705","University of California-Santa Barbara","2011","Total full-time Instruction/research/public service, Non-tenured on tenure track, Lecturers","8","2","6","0","0","0","1","0","1","0","0","0","1","0","1","0","0","0","6","2","4","0","0","0","0","0","0","0","0","0","-2"
"110705","University of California-Santa Barbara","2011","Total full-time Instruction/research/public service, Non-tenured on tenure track total","88","45","43","3","0","3","9","5","4","5","2","3","7","3","4","0","0","0","55","30","25","0","0","0","2","1","1","7","4","3","-2"
"110705","University of California-Santa Barbara","2011","Total full-time Instruction/research/public service, Non-tenured not on tenure track, Professors","1","1","0","0","0","0","0","0","0","0","0","0","0","0","0","0","0","0","0","0","0","0","0","0","0","0","0","1","1","0","-2"
"110705","University of California-Santa Barbara","2011","Total full-time Instruction/research/public servicey, Non-tenured not on tenure track, Assistant professors","14","9","5","0","0","0","0","0","0","0","0","0","0","0","0","0","0","0","8","4","4","0","0","0","2","2","0","4","3","1","-2"
"110705","University of California-Santa Barbara","2011","Total full-time Instruction/research/public service, Non-tenured not on tenure track, Lecturers","86","37","49","0","0","0","9","3","6","0","0","0","2","0","2","0","0","0","72","33","39","0","0","0","1","1","0","2","0","2","-2"
"110705","University of California-Santa Barbara","2011","Total full-time Instruction/research/public service, Non-tenured not on tenure track total","101","47","54","0","0","0","9","3","6","0","0","0","2","0","2","0","0","0","80","37","43","0","0","0","3","3","0","7","4","3","-2"
"110714","University of California-Santa Cruz","2011","Total full-time Instruction/research/public service, Tenured, Professors","294","199","95","3","1","2","39","27","12","6","6","0","17","6","11","0","0","0","227","157","70","0","0","0","2","2","0","0","0","0","-2"
"110714","University of California-Santa Cruz","2011","Total full-time Instruction/research/public service, Tenured, Associate professors","122","65","57","4","1","3","18","7","11","6","4","2","12","7","5","0","0","0","81","45","36","0","0","0","1","1","0","0","0","0","-2"
"110714","University of California-Santa Cruz","2011","Total full-time Instruction/research/public service, Tenured, Lecturers","6","4","2","0","0","0","0","0","0","0","0","0","1","0","1","0","0","0","5","4","1","0","0","0","0","0","0","0","0","0","-2"
"110714","University of California-Santa Cruz","2011","Total full-time Instruction/research/public service, Tenured total","422","268","154","7","2","5","57","34","23","12","10","2","30","13","17","0","0","0","313","206","107","0","0","0","3","3","0","0","0","0","-2"
"110714","University of California-Santa Cruz","2011","Total full-time Instruction/research/public service, Non-tenured on tenure track, Assistant professors","85","52","33","2","0","2","16","10","6","2","1","1","11","6","5","0","0","0","53","34","19","0","0","0","1","1","0","0","0","0","-2"
"110714","University of California-Santa Cruz","2011","Total full-time Instruction/research/public service, Non-tenured on tenure track, Lecturers","1","1","0","0","0","0","0","0","0","0","0","0","0","0","0","0","0","0","0","0","0","0","0","0","1","1","0","0","0","0","-2"
"110714","University of California-Santa Cruz","2011","Total full-time Instruction/research/public service, Non-tenured on tenure track total","86","53","33","2","0","2","16","10","6","2","1","1","11","6","5","0","0","0","53","34","19","0","0","0","2","2","0","0","0","0","-2"
"110714","University of California-Santa Cruz","2011","Total full-time Instruction/research/public service, Non-tenured not on tenure track, Professors","6","5","1","0","0","0","1","1","0","0","0","0","1","0","1","0","0","0","4","4","0","0","0","0","0","0","0","0","0","0","-2"
"110714","University of California-Santa Cruz","2011","Total full-time Instruction/research/public service, Non-tenured not on tenure track, Associate professors","2","2","0","0","0","0","0","0","0","0","0","0","0","0","0","0","0","0","2","2","0","0","0","0","0","0","0","0","0","0","-2"
"110714","University of California-Santa Cruz","2011","Total full-time Instruction/research/public servicey, Non-tenured not on tenure track, Assistant professors","9","5","4","0","0","0","3","2","1","0","0","0","1","0","1","0","0","0","3","1","2","1","1","0","1","1","0","0","0","0","-2"
"110714","University of California-Santa Cruz","2011","Total full-time Instruction/research/public service, Non-tenured not on tenure track, Lecturers","35","16","19","0","0","0","3","1","2","1","0","1","6","3","3","0","0","0","25","12","13","0","0","0","0","0","0","0","0","0","-2"
"110714","University of California-Santa Cruz","2011","Total full-time Instruction/research/public service, Non-tenured not on tenure track, No academic rank","2","1","1","0","0","0","0","0","0","0","0","0","1","0","1","0","0","0","1","1","0","0","0","0","0","0","0","0","0","0","-2"
"110714","University of California-Santa Cruz","2011","Total full-time Instruction/research/public service, Non-tenured not on tenure track total","54","29","25","0","0","0","7","4","3","1","0","1","9","3","6","0","0","0","35","20","15","1","1","0","1","1","0","0","0","0","-2"
"111966","Charles R Drew University of Medicine and Science","2011","Total full-time Instruction/research/public service, Non-tenured not on tenure track, Professors","1","0","1","0","0","0","1","0","1","0","0","0","0","0","0","0","0","0","0","0","0","0","0","0","0","0","0","0","0","0","-2"
"111966","Charles R Drew University of Medicine and Science","2011","Total full-time Instruction/research/public service, Non-tenured not on tenure track, Associate professors","3","0","3","0","0","0","0","0","0","1","0","1","1","0","1","0","0","0","1","0","1","0","0","0","0","0","0","0","0","0","-2"
"111966","Charles R Drew University of Medicine and Science","2011","Total full-time Instruction/research/public servicey, Non-tenured not on tenure track, Assistant professors","15","7","8","0","0","0","4","2","2","5","1","4","2","2","0","0","0","0","3","2","1","1","0","1","0","0","0","0","0","0","-2"
"111966","Charles R Drew University of Medicine and Science","2011","Total full-time Instruction/research/public service, Non-tenured not on tenure track, Instructors","19","3","16","0","0","0","3","2","1","13","1","12","0","0","0","0","0","0","1","0","1","2","0","2","0","0","0","0","0","0","-2"
"111966","Charles R Drew University of Medicine and Science","2011","Total full-time Instruction/research/public service, Non-tenured not on tenure track total","38","10","28","0","0","0","8","4","4","19","2","17","3","2","1","0","0","0","5","2","3","3","0","3","0","0","0","0","0","0","-2"
"112075","Concordia University-Irvine","2011","Total full-time Instruction/research/public service, Non-tenured not on tenure track, Professors","25","18","7","0","0","0","0","0","0","2","1","1","2","2","0","0","0","0","21","15","6","0","0","0","0","0","0","0","0","0","-2"
"112075","Concordia University-Irvine","2011","Total full-time Instruction/research/public service, Non-tenured not on tenure track, Associate professors","9","5","4","0","0","0","0","0","0","0","0","0","0","0","0","0","0","0","9","5","4","0","0","0","0","0","0","0","0","0","-2"
"112075","Concordia University-Irvine","2011","Total full-time Instruction/research/public servicey, Non-tenured not on tenure track, Assistant professors","36","17","19","0","0","0","3","1","2","2","0","2","0","0","0","0","0","0","30","16","14","0","0","0","1","0","1","0","0","0","-2"
"112075","Concordia University-Irvine","2011","Total full-time Instruction/research/public service, Non-tenured not on tenure track, Instructors","7","2","5","1","0","1","0","0","0","0","0","0","0","0","0","0","0","0","6","2","4","0","0","0","0","0","0","0","0","0","-2"
"112075","Concordia University-Irvine","2011","Total full-time Instruction/research/public service, Non-tenured not on tenure track total","77","42","35","1","0","1","3","1","2","4","1","3","2","2","0","0","0","0","66","38","28","0","0","0","1","0","1","0","0","0","-2"
"112084","San Diego Christian College","2011","Total full-time Instruction/research/public service, Non-tenured not on tenure track, Associate professors","6","4","2","0","0","0","0","0","0","0","0","0","0","0","0","0","0","0","6","4","2","0","0","0","0","0","0","0","0","0","-2"
"112084","San Diego Christian College","2011","Total full-time Instruction/research/public servicey, Non-tenured not on tenure track, Assistant professors","19","8","11","0","0","0","1","0","1","1","0","1","1","1","0","1","1","0","15","6","9","0","0","0","0","0","0","0","0","0","-2"
"112084","San Diego Christian College","2011","Total full-time Instruction/research/public service, Non-tenured not on tenure track, No academic rank","1","1","0","0","0","0","0","0","0","0","0","0","0","0","0","0","0","0","1","1","0","0","0","0","0","0","0","0","0","0","-2"
"112084","San Diego Christian College","2011","Total full-time Instruction/research/public service, Non-tenured not on tenure track total","26","13","13","0","0","0","1","0","1","1","0","1","1","1","0","1","1","0","22","11","11","0","0","0","0","0","0","0","0","0","-2"
"113236","Cypress College","2011","Total full-time Instruction/research/public service, Tenured, Instructors","180","78","102","1","1","0","7","1","6","4","0","4","13","7","6","1","0","1","70","30","40","4","0","4","78","38","40","2","1","1","-2"
"113236","Cypress College","2011","Total full-time Instruction/research/public service, Tenured total","180","78","102","1","1","0","7","1","6","4","0","4","13","7","6","1","0","1","70","30","40","4","0","4","78","38","40","2","1","1","-2"
"113236","Cypress College","2011","Total full-time Instruction/research/public service, Non-tenured on tenure track, Instructors","18","4","14","0","0","0","1","0","1","0","0","0","4","1","3","0","0","0","8","2","6","2","1","1","2","0","2","1","0","1","-2"
"113236","Cypress College","2011","Total full-time Instruction/research/public service, Non-tenured on tenure track total","18","4","14","0","0","0","1","0","1","0","0","0","4","1","3","0","0","0","8","2","6","2","1","1","2","0","2","1","0","1","-2"
"113236","Cypress College","2011","Total full-time Instruction/research/public service, Non-tenured not on tenure track, Instructors","7","3","4","0","0","0","1","0","1","0","0","0","0","0","0","0","0","0","3","1","2","0","0","0","1","1","0","2","1","1","-2"
"113236","Cypress College","2011","Total full-time Instruction/research/public service, Non-tenured not on tenure track total","7","3","4","0","0","0","1","0","1","0","0","0","0","0","0","0","0","0","3","1","2","0","0","0","1","1","0","2","1","1","-2"
"113698","Dominican University of California","2011","Total full-time Instruction/research/public service, Tenured, Professors","20","11","9","0","0","0","2","1","1","1","1","0","0","0","0","0","0","0","11","7","4","0","0","0","6","2","4","0","0","0","-2"
"113698","Dominican University of California","2011","Total full-time Instruction/research/public service, Tenured, Associate professors","17","5","12","0","0","0","2","1","1","2","1","1","0","0","0","0","0","0","11","3","8","0","0","0","2","0","2","0","0","0","-2"
"113698","Dominican University of California","2011","Total full-time Instruction/research/public service, Tenured total","37","16","21","0","0","0","4","2","2","3","2","1","0","0","0","0","0","0","22","10","12","0","0","0","8","2","6","0","0","0","-2"
"113698","Dominican University of California","2011","Total full-time Instruction/research/public service, Non-tenured on tenure track, Professors","1","0","1","0","0","0","0","0","0","0","0","0","0","0","0","0","0","0","1","0","1","0","0","0","0","0","0","0","0","0","-2"
"113698","Dominican University of California","2011","Total full-time Instruction/research/public service, Non-tenured on tenure track, Associate professors","4","2","2","0","0","0","0","0","0","0","0","0","0","0","0","0","0","0","2","1","1","0","0","0","2","1","1","0","0","0","-2"
"113698","Dominican University of California","2011","Total full-time Instruction/research/public service, Non-tenured on tenure track, Assistant professors","16","7","9","0","0","0","2","1","1","0","0","0","0","0","0","0","0","0","13","5","8","0","0","0","1","1","0","0","0","0","-2"
"113698","Dominican University of California","2011","Total full-time Instruction/research/public service, Non-tenured on tenure track total","21","9","12","0","0","0","2","1","1","0","0","0","0","0","0","0","0","0","16","6","10","0","0","0","3","2","1","0","0","0","-2"
"113698","Dominican University of California","2011","Total full-time Instruction/research/public service, Non-tenured not on tenure track, Professors","3","1","2","0","0","0","0","0","0","0","0","0","0","0","0","0","0","0","2","1","1","0","0","0","1","0","1","0","0","0","-2"
"113698","Dominican University of California","2011","Total full-time Instruction/research/public service, Non-tenured not on tenure track, Associate professors","6","2","4","0","0","0","0","0","0","0","0","0","1","1","0","0","0","0","3","0","3","0","0","0","2","1","1","0","0","0","-2"
"113698","Dominican University of California","2011","Total full-time Instruction/research/public servicey, Non-tenured not on tenure track, Assistant professors","31","11","20","0","0","0","0","0","0","1","0","1","3","1","2","0","0","0","25","8","17","1","1","0","1","1","0","0","0","0","-2"
"113698","Dominican University of California","2011","Total full-time Instruction/research/public service, Non-tenured not on tenure track, Instructors","1","1","0","0","0","0","0","0","0","0","0","0","0","0","0","0","0","0","0","0","0","0","0","0","1","1","0","0","0","0","-2"
"113698","Dominican University of California","2011","Total full-time Instruction/research/public service, Non-tenured not on tenure track total","41","15","26","0","0","0","0","0","0","1","0","1","4","2","2","0","0","0","30","9","21","1","1","0","5","3","2","0","0","0","-2"
"114433","Feather River Community College District","2011","Total full-time Instruction/research/public service, Tenured, Instructors","12","7","5","0","0","0","0","0","0","0","0","0","0","0","0","0","0","0","12","7","5","0","0","0","0","0","0","0","0","0","-2"
"114433","Feather River Community College District","2011","Total full-time Instruction/research/public service, Tenured total","12","7","5","0","0","0","0","0","0","0","0","0","0","0","0","0","0","0","12","7","5","0","0","0","0","0","0","0","0","0","-2"
"114433","Feather River Community College District","2011","Total full-time Instruction/research/public service, Non-tenured on tenure track, Instructors","10","6","4","0","0","0","0","0","0","0","0","0","0","0","0","0","0","0","10","6","4","0","0","0","0","0","0","0","0","0","-2"
"114433","Feather River Community College District","2011","Total full-time Instruction/research/public service, Non-tenured on tenure track total","10","6","4","0","0","0","0","0","0","0","0","0","0","0","0","0","0","0","10","6","4","0","0","0","0","0","0","0","0","0","-2"
"114433","Feather River Community College District","2011","Total full-time Instruction/research/public service, Non-tenured not on tenure track, Instructors","2","2","0","0","0","0","0","0","0","0","0","0","0","0","0","0","0","0","1","1","0","0","0","0","1","1","0","0","0","0","-2"
"114433","Feather River Community College District","2011","Total full-time Instruction/research/public service, Non-tenured not on tenure track total","2","2","0","0","0","0","0","0","0","0","0","0","0","0","0","0","0","0","1","1","0","0","0","0","1","1","0","0","0","0","-2"
"114716","Foothill College","2011","Total full-time Instruction/research/public service, Tenured, Instructors","139","53","86","0","0","0","20","5","15","8","3","5","15","5","10","0","0","0","89","37","52","3","1","2","4","2","2","0","0","0","-2"
"114716","Foothill College","2011","Total full-time Instruction/research/public service, Tenured total","139","53","86","0","0","0","20","5","15","8","3","5","15","5","10","0","0","0","89","37","52","3","1","2","4","2","2","0","0","0","-2"
"114716","Foothill College","2011","Total full-time Instruction/research/public service, Non-tenured on tenure track, Instructors","51","21","30","0","0","0","9","2","7","3","1","2","7","3","4","0","0","0","29","13","16","0","0","0","3","2","1","0","0","0","-2"
"114716","Foothill College","2011","Total full-time Instruction/research/public service, Non-tenured on tenure track total","51","21","30","0","0","0","9","2","7","3","1","2","7","3","4","0","0","0","29","13","16","0","0","0","3","2","1","0","0","0","-2"
"114813","Fresno Pacific University","2011","Total full-time Instruction/research/public service, Tenured, Professors","10","8","2","0","0","0","1","1","0","0","0","0","0","0","0","0","0","0","9","7","2","0","0","0","0","0","0","0","0","0","-2"
"114813","Fresno Pacific University","2011","Total full-time Instruction/research/public service, Tenured, Associate professors","25","15","10","0","0","0","0","0","0","0","0","0","0","0","0","0","0","0","24","14","10","0","0","0","1","1","0","0","0","0","-2"
"114813","Fresno Pacific University","2011","Total full-time Instruction/research/public service, Tenured, Assistant professors","1","0","1","0","0","0","0","0","0","0","0","0","0","0","0","0","0","0","1","0","1","0","0","0","0","0","0","0","0","0","-2"
"114813","Fresno Pacific University","2011","Total full-time Instruction/research/public service, Tenured total","36","23","13","0","0","0","1","1","0","0","0","0","0","0","0","0","0","0","34","21","13","0","0","0","1","1","0","0","0","0","-2"
"114813","Fresno Pacific University","2011","Total full-time Instruction/research/public service, Non-tenured on tenure track, Professors","1","1","0","0","0","0","0","0","0","0","0","0","0","0","0","0","0","0","0","0","0","0","0","0","1","1","0","0","0","0","-2"
"114813","Fresno Pacific University","2011","Total full-time Instruction/research/public service, Non-tenured on tenure track, Associate professors","3","3","0","0","0","0","0","0","0","0","0","0","0","0","0","0","0","0","3","3","0","0","0","0","0","0","0","0","0","0","-2"
"114813","Fresno Pacific University","2011","Total full-time Instruction/research/public service, Non-tenured on tenure track, Assistant professors","21","13","8","1","1","0","2","1","1","2","1","1","0","0","0","0","0","0","15","10","5","0","0","0","1","0","1","0","0","0","-2"
"114813","Fresno Pacific University","2011","Total full-time Instruction/research/public service, Non-tenured on tenure track, Instructors","1","1","0","0","0","0","0","0","0","0","0","0","0","0","0","0","0","0","1","1","0","0","0","0","0","0","0","0","0","0","-2"
"114813","Fresno Pacific University","2011","Total full-time Instruction/research/public service, Non-tenured on tenure track total","26","18","8","1","1","0","2","1","1","2","1","1","0","0","0","0","0","0","19","14","5","0","0","0","2","1","1","0","0","0","-2"
"114813","Fresno Pacific University","2011","Total full-time Instruction/research/public service, Non-tenured not on tenure track, Professors","3","2","1","0","0","0","0","0","0","0","0","0","0","0","0","0","0","0","3","2","1","0","0","0","0","0","0","0","0","0","-2"
"114813","Fresno Pacific University","2011","Total full-time Instruction/research/public service, Non-tenured not on tenure track, Associate professors","1","1","0","0","0","0","0","0","0","0","0","0","0","0","0","0","0","0","1","1","0","0","0","0","0","0","0","0","0","0","-2"
"114813","Fresno Pacific University","2011","Total full-time Instruction/research/public servicey, Non-tenured not on tenure track, Assistant professors","15","9","6","0","0","0","0","0","0","0","0","0","1","0","1","0","0","0","11","7","4","0","0","0","3","2","1","0","0","0","-2"
"114813","Fresno Pacific University","2011","Total full-time Instruction/research/public service, Non-tenured not on tenure track, Instructors","7","2","5","0","0","0","0","0","0","0","0","0","1","0","1","0","0","0","6","2","4","0","0","0","0","0","0","0","0","0","-2"
"114813","Fresno Pacific University","2011","Total full-time Instruction/research/public service, Non-tenured not on tenure track total","26","14","12","0","0","0","0","0","0","0","0","0","2","0","2","0","0","0","21","12","9","0","0","0","3","2","1","0","0","0","-2"
"115728","Holy Names University","2011","Total full-time Instruction/research/public service, Tenured, Professors","8","2","6","0","0","0","0","0","0","0","0","0","1","0","1","0","0","0","7","2","5","0","0","0","0","0","0","0","0","0","-2"
"115728","Holy Names University","2011","Total full-time Instruction/research/public service, Tenured, Associate professors","7","3","4","0","0","0","0","0","0","1","0","1","1","0","1","1","0","1","4","3","1","0","0","0","0","0","0","0","0","0","-2"
"115728","Holy Names University","2011","Total full-time Instruction/research/public service, Tenured total","15","5","10","0","0","0","0","0","0","1","0","1","2","0","2","1","0","1","11","5","6","0","0","0","0","0","0","0","0","0","-2"
"115728","Holy Names University","2011","Total full-time Instruction/research/public service, Non-tenured on tenure track, Professors","1","1","0","0","0","0","0","0","0","0","0","0","0","0","0","0","0","0","1","1","0","0","0","0","0","0","0","0","0","0","-2"
"115728","Holy Names University","2011","Total full-time Instruction/research/public service, Non-tenured on tenure track, Associate professors","2","1","1","0","0","0","0","0","0","0","0","0","0","0","0","0","0","0","2","1","1","0","0","0","0","0","0","0","0","0","-2"
"115728","Holy Names University","2011","Total full-time Instruction/research/public service, Non-tenured on tenure track, Assistant professors","17","5","12","0","0","0","2","1","1","3","1","2","1","0","1","0","0","0","10","3","7","0","0","0","0","0","0","1","0","1","-2"
"115728","Holy Names University","2011","Total full-time Instruction/research/public service, Non-tenured on tenure track total","20","7","13","0","0","0","2","1","1","3","1","2","1","0","1","0","0","0","13","5","8","0","0","0","0","0","0","1","0","1","-2"
"115728","Holy Names University","2011","Total full-time Instruction/research/public service, Non-tenured not on tenure track, Professors","4","2","2","0","0","0","0","0","0","0","0","0","0","0","0","0","0","0","4","2","2","0","0","0","0","0","0","0","0","0","-2"
"115728","Holy Names University","2011","Total full-time Instruction/research/public service, Non-tenured not on tenure track, Associate professors","2","0","2","0","0","0","0","0","0","0","0","0","0","0","0","0","0","0","2","0","2","0","0","0","0","0","0","0","0","0","-2"
"115728","Holy Names University","2011","Total full-time Instruction/research/public servicey, Non-tenured not on tenure track, Assistant professors","2","1","1","0","0","0","1","1","0","0","0","0","0","0","0","0","0","0","1","0","1","0","0","0","0","0","0","0","0","0","-2"
"115728","Holy Names University","2011","Total full-time Instruction/research/public service, Non-tenured not on tenure track, Lecturers","2","0","2","0","0","0","0","0","0","0","0","0","0","0","0","0","0","0","2","0","2","0","0","0","0","0","0","0","0","0","-2"
"115728","Holy Names University","2011","Total full-time Instruction/research/public service, Non-tenured not on tenure track total","10","3","7","0","0","0","1","1","0","0","0","0","0","0","0","0","0","0","9","2","7","0","0","0","0","0","0","0","0","0","-2"
"115773","Humphreys University-Stockton and Modesto Campuses","2011","Total full-time Instruction/research/public service, Non-tenured not on tenure track, Professors","4","4","0","0","0","0","0","0","0","0","0","0","0","0","0","0","0","0","4","4","0","0","0","0","0","0","0","0","0","0","-2"
"115773","Humphreys University-Stockton and Modesto Campuses","2011","Total full-time Instruction/research/public service, Non-tenured not on tenure track, Associate professors","3","1","2","0","0","0","0","0","0","1","0","1","0","0","0","0","0","0","2","1","1","0","0","0","0","0","0","0","0","0","-2"
"115773","Humphreys University-Stockton and Modesto Campuses","2011","Total full-time Instruction/research/public servicey, Non-tenured not on tenure track, Assistant professors","10","4","6","0","0","0","1","1","0","0","0","0","1","1","0","0","0","0","8","2","6","0","0","0","0","0","0","0","0","0","-2"
"115773","Humphreys University-Stockton and Modesto Campuses","2011","Total full-time Instruction/research/public service, Non-tenured not on tenure track, Instructors","3","0","3","0","0","0","0","0","0","0","0","0","0","0","0","0","0","0","3","0","3","0","0","0","0","0","0","0","0","0","-2"
"115773","Humphreys University-Stockton and Modesto Campuses","2011","Total full-time Instruction/research/public service, Non-tenured not on tenure track, No academic rank","1","0","1","0","0","0","0","0","0","1","0","1","0","0","0","0","0","0","0","0","0","0","0","0","0","0","0","0","0","0","-2"
"115773","Humphreys University-Stockton and Modesto Campuses","2011","Total full-time Instruction/research/public service, Non-tenured not on tenure track total","21","9","12","0","0","0","1","1","0","2","0","2","1","1","0","0","0","0","17","7","10","0","0","0","0","0","0","0","0","0","-2"
"117104","Life Pacific University","2011","Total full-time Instruction/research/public service, Non-tenured not on tenure track, Professors","3","3","0","0","0","0","0","0","0","0","0","0","0","0","0","0","0","0","3","3","0","0","0","0","0","0","0","0","0","0","-2"
"117104","Life Pacific University","2011","Total full-time Instruction/research/public service, Non-tenured not on tenure track, Associate professors","2","2","0","0","0","0","0","0","0","0","0","0","0","0","0","0","0","0","2","2","0","0","0","0","0","0","0","0","0","0","-2"
"117104","Life Pacific University","2011","Total full-time Instruction/research/public servicey, Non-tenured not on tenure track, Assistant professors","3","1","2","0","0","0","0","0","0","0","0","0","0","0","0","0","0","0","3","1","2","0","0","0","0","0","0","0","0","0","-2"
"117104","Life Pacific University","2011","Total full-time Instruction/research/public service, Non-tenured not on tenure track total","8","6","2","0","0","0","0","0","0","0","0","0","0","0","0","0","0","0","8","6","2","0","0","0","0","0","0","0","0","0","-2"
"117140","University of La Verne","2011","Total full-time Instruction/research/public service, Tenured, Professors","93","60","33","0","0","0","5","3","2","3","2","1","4","3","1","0","0","0","81","52","29","0","0","0","0","0","0","0","0","0","-2"
"117140","University of La Verne","2011","Total full-time Instruction/research/public service, Tenured, Associate professors","25","10","15","0","0","0","2","1","1","1","0","1","2","1","1","0","0","0","20","8","12","0","0","0","0","0","0","0","0","0","-2"
"117140","University of La Verne","2011","Total full-time Instruction/research/public service, Tenured, Assistant professors","1","1","0","0","0","0","1","1","0","0","0","0","0","0","0","0","0","0","0","0","0","0","0","0","0","0","0","0","0","0","-2"
"117140","University of La Verne","2011","Total full-time Instruction/research/public service, Tenured total","119","71","48","0","0","0","8","5","3","4","2","2","6","4","2","0","0","0","101","60","41","0","0","0","0","0","0","0","0","0","-2"
"117140","University of La Verne","2011","Total full-time Instruction/research/public service, Non-tenured on tenure track, Associate professors","23","9","14","0","0","0","4","1","3","2","1","1","2","0","2","0","0","0","15","7","8","0","0","0","0","0","0","0","0","0","-2"
"117140","University of La Verne","2011","Total full-time Instruction/research/public service, Non-tenured on tenure track, Assistant professors","37","13","24","1","0","1","3","0","3","4","1","3","5","3","2","0","0","0","21","9","12","0","0","0","3","0","3","0","0","0","-2"
"117140","University of La Verne","2011","Total full-time Instruction/research/public service, Non-tenured on tenure track total","60","22","38","1","0","1","7","1","6","6","2","4","7","3","4","0","0","0","36","16","20","0","0","0","3","0","3","0","0","0","-2"
"117140","University of La Verne","2011","Total full-time Instruction/research/public service, Non-tenured not on tenure track, Professors","3","2","1","0","0","0","0","0","0","0","0","0","0","0","0","0","0","0","3","2","1","0","0","0","0","0","0","0","0","0","-2"
"117140","University of La Verne","2011","Total full-time Instruction/research/public service, Non-tenured not on tenure track, Associate professors","4","2","2","0","0","0","0","0","0","0","0","0","0","0","0","0","0","0","4","2","2","0","0","0","0","0","0","0","0","0","-2"
"117140","University of La Verne","2011","Total full-time Instruction/research/public servicey, Non-tenured not on tenure track, Assistant professors","18","7","11","0","0","0","2","0","2","1","1","0","2","0","2","0","0","0","13","6","7","0","0","0","0","0","0","0","0","0","-2"
"117140","University of La Verne","2011","Total full-time Instruction/research/public service, Non-tenured not on tenure track, Instructors","7","4","3","0","0","0","0","0","0","1","1","0","2","2","0","0","0","0","3","1","2","0","0","0","1","0","1","0","0","0","-2"
"117140","University of La Verne","2011","Total full-time Instruction/research/public service, Non-tenured not on tenure track total","32","15","17","0","0","0","2","0","2","2","2","0","4","2","2","0","0","0","23","11","12","0","0","0","1","0","1","0","0","0","-2"
"117627","La Sierra University","2011","Total full-time Instruction/research/public service, Tenured, Professors","27","19","8","1","0","1","3","3","0","1","1","0","2","1","1","0","0","0","20","14","6","0","0","0","0","0","0","0","0","0","-2"
"117627","La Sierra University","2011","Total full-time Instruction/research/public service, Tenured, Associate professors","19","11","8","1","0","1","3","2","1","2","2","0","0","0","0","0","0","0","11","6","5","2","1","1","0","0","0","0","0","0","-2"
"117627","La Sierra University","2011","Total full-time Instruction/research/public service, Tenured total","46","30","16","2","0","2","6","5","1","3","3","0","2","1","1","0","0","0","31","20","11","2","1","1","0","0","0","0","0","0","-2"
"117627","La Sierra University","2011","Total full-time Instruction/research/public service, Non-tenured on tenure track, Professors","2","1","1","0","0","0","1","0","1","0","0","0","0","0","0","0","0","0","1","1","0","0","0","0","0","0","0","0","0","0","-2"
"117627","La Sierra University","2011","Total full-time Instruction/research/public service, Non-tenured on tenure track, Associate professors","6","3","3","0","0","0","0","0","0","0","0","0","0","0","0","0","0","0","6","3","3","0","0","0","0","0","0","0","0","0","-2"
"117627","La Sierra University","2011","Total full-time Instruction/research/public service, Non-tenured on tenure track, Assistant professors","22","12","10","0","0","0","2","1","1","5","3","2","1","0","1","0","0","0","14","8","6","0","0","0","0","0","0","0","0","0","-2"
"117627","La Sierra University","2011","Total full-time Instruction/research/public service, Non-tenured on tenure track total","30","16","14","0","0","0","3","1","2","5","3","2","1","0","1","0","0","0","21","12","9","0","0","0","0","0","0","0","0","0","-2"
"117627","La Sierra University","2011","Total full-time Instruction/research/public service, Non-tenured not on tenure track, Professors","3","2","1","0","0","0","1","0","1","0","0","0","0","0","0","0","0","0","2","2","0","0","0","0","0","0","0","0","0","0","-2"
"117627","La Sierra University","2011","Total full-time Instruction/research/public service, Non-tenured not on tenure track, Associate professors","5","2","3","0","0","0","1","1","0","0","0","0","0","0","0","0","0","0","4","1","3","0","0","0","0","0","0","0","0","0","-2"
"117627","La Sierra University","2011","Total full-time Instruction/research/public servicey, Non-tenured not on tenure track, Assistant professors","10","6","4","0","0","0","3","2","1","0","0","0","0","0","0","0","0","0","6","4","2","1","0","1","0","0","0","0","0","0","-2"
"117627","La Sierra University","2011","Total full-time Instruction/research/public service, Non-tenured not on tenure track total","18","10","8","0","0","0","5","3","2","0","0","0","0","0","0","0","0","0","12","7","5","1","0","1","0","0","0","0","0","0","-2"
"117636","Loma Linda University","2011","Total full-time Instruction/research/public service, Tenured, Professors","29","22","7","0","0","0","3","2","1","1","1","0","2","2","0","0","0","0","21","15","6","0","0","0","2","2","0","0","0","0","-2"
"117636","Loma Linda University","2011","Total full-time Instruction/research/public service, Tenured, Associate professors","6","3","3","0","0","0","1","0","1","0","0","0","2","1","1","0","0","0","3","2","1","0","0","0","0","0","0","0","0","0","-2"
"117636","Loma Linda University","2011","Total full-time Instruction/research/public service, Tenured total","35","25","10","0","0","0","4","2","2","1","1","0","4","3","1","0","0","0","24","17","7","0","0","0","2","2","0","0","0","0","-2"
"117636","Loma Linda University","2011","Total full-time Instruction/research/public service, Non-tenured on tenure track, Professors","14","9","5","0","0","0","1","0","1","4","3","1","1","1","0","0","0","0","7","4","3","0","0","0","1","1","0","0","0","0","-2"
"117636","Loma Linda University","2011","Total full-time Instruction/research/public service, Non-tenured on tenure track, Associate professors","32","15","17","0","0","0","6","3","3","4","2","2","2","1","1","0","0","0","19","8","11","0","0","0","1","1","0","0","0","0","-2"
"117636","Loma Linda University","2011","Total full-time Instruction/research/public service, Non-tenured on tenure track, Assistant professors","50","12","38","0","0","0","5","1","4","4","1","3","5","2","3","1","0","1","34","7","27","0","0","0","0","0","0","1","1","0","-2"
"117636","Loma Linda University","2011","Total full-time Instruction/research/public service, Non-tenured on tenure track, Instructors","5","1","4","0","0","0","2","1","1","0","0","0","0","0","0","0","0","0","3","0","3","0","0","0","0","0","0","0","0","0","-2"
"117636","Loma Linda University","2011","Total full-time Instruction/research/public service, Non-tenured on tenure track total","101","37","64","0","0","0","14","5","9","12","6","6","8","4","4","1","0","1","63","19","44","0","0","0","2","2","0","1","1","0","-2"
"117636","Loma Linda University","2011","Total full-time Instruction/research/public service, Non-tenured not on tenure track, Professors","29","20","9","0","0","0","4","3","1","0","0","0","1","1","0","0","0","0","24","16","8","0","0","0","0","0","0","0","0","0","-2"
"117636","Loma Linda University","2011","Total full-time Instruction/research/public service, Non-tenured not on tenure track, Associate professors","63","36","27","1","0","1","11","7","4","5","3","2","4","2","2","16","0","16","23","23","0","0","0","0","0","0","0","3","1","2","-2"
"117636","Loma Linda University","2011","Total full-time Instruction/research/public servicey, Non-tenured not on tenure track, Assistant professors","153","71","82","0","0","0","27","9","18","11","3","8","18","7","11","1","0","1","88","45","43","0","0","0","0","0","0","8","7","1","-2"
"117636","Loma Linda University","2011","Total full-time Instruction/research/public service, Non-tenured not on tenure track, Instructors","38","12","26","1","1","0","10","2","8","0","0","0","4","0","4","0","0","0","20","8","12","0","0","0","0","0","0","3","1","2","-2"
"117636","Loma Linda University","2011","Total full-time Instruction/research/public service, Non-tenured not on tenure track total","283","139","144","2","1","1","52","21","31","16","6","10","27","10","17","17","0","17","155","92","63","0","0","0","0","0","0","14","9","5","-2"
"118541","Marymount California University","2011","Total full-time Instruction/research/public service, Non-tenured not on tenure track, Professors","19","10","9","0","0","0","0","0","0","0","0","0","0","0","0","0","0","0","19","10","9","0","0","0","0","0","0","0","0","0","-2"
"118541","Marymount California University","2011","Total full-time Instruction/research/public service, Non-tenured not on tenure track, Associate professors","8","3","5","0","0","0","0","0","0","1","0","1","0","0","0","0","0","0","6","3","3","0","0","0","1","0","1","0","0","0","-2"
"118541","Marymount California University","2011","Total full-time Instruction/research/public servicey, Non-tenured not on tenure track, Assistant professors","6","3","3","0","0","0","0","0","0","1","1","0","1","1","0","0","0","0","4","1","3","0","0","0","0","0","0","0","0","0","-2"
"118541","Marymount California University","2011","Total full-time Instruction/research/public service, Non-tenured not on tenure track total","33","16","17","0","0","0","0","0","0","2","1","1","1","1","0","0","0","0","29","14","15","0","0","0","1","0","1","0","0","0","-2"
"118693","Menlo College","2011","Total full-time Instruction/research/public service, Non-tenured not on tenure track, Professors","7","5","2","0","0","0","2","2","0","0","0","0","0","0","0","0","0","0","5","3","2","0","0","0","0","0","0","0","0","0","-2"
"118693","Menlo College","2011","Total full-time Instruction/research/public service, Non-tenured not on tenure track, Associate professors","8","2","6","0","0","0","0","0","0","1","0","1","0","0","0","0","0","0","7","2","5","0","0","0","0","0","0","0","0","0","-2"
"118693","Menlo College","2011","Total full-time Instruction/research/public servicey, Non-tenured not on tenure track, Assistant professors","10","7","3","0","0","0","1","0","1","0","0","0","0","0","0","0","0","0","9","7","2","0","0","0","0","0","0","0","0","0","-2"
"118693","Menlo College","2011","Total full-time Instruction/research/public service, Non-tenured not on tenure track, Lecturers","2","0","2","0","0","0","1","0","1","1","0","1","0","0","0","0","0","0","0","0","0","0","0","0","0","0","0","0","0","0","-2"
"118693","Menlo College","2011","Total full-time Instruction/research/public service, Non-tenured not on tenure track total","27","14","13","0","0","0","4","2","2","2","0","2","0","0","0","0","0","0","21","12","9","0","0","0","0","0","0","0","0","0","-2"
"118888","Mills College","2011","Total full-time Instruction/research/public service, Tenured, Professors","47","20","27","0","0","0","3","1","2","3","1","2","4","1","3","0","0","0","37","17","20","0","0","0","0","0","0","0","0","0","-2"
"118888","Mills College","2011","Total full-time Instruction/research/public service, Tenured, Associate professors","19","4","15","1","0","1","2","0","2","2","0","2","0","0","0","0","0","0","11","3","8","2","0","2","1","1","0","0","0","0","-2"
"118888","Mills College","2011","Total full-time Instruction/research/public service, Tenured total","66","24","42","1","0","1","5","1","4","5","1","4","4","1","3","0","0","0","48","20","28","2","0","2","1","1","0","0","0","0","-2"
"118888","Mills College","2011","Total full-time Instruction/research/public service, Non-tenured on tenure track, Associate professors","1","0","1","0","0","0","0","0","0","0","0","0","0","0","0","0","0","0","1","0","1","0","0","0","0","0","0","0","0","0","-2"
"118888","Mills College","2011","Total full-time Instruction/research/public service, Non-tenured on tenure track, Assistant professors","12","4","8","0","0","0","4","2","2","0","0","0","1","0","1","0","0","0","6","2","4","1","0","1","0","0","0","0","0","0","-2"
"118888","Mills College","2011","Total full-time Instruction/research/public service, Non-tenured on tenure track total","13","4","9","0","0","0","4","2","2","0","0","0","1","0","1","0","0","0","7","2","5","1","0","1","0","0","0","0","0","0","-2"
"118888","Mills College","2011","Total full-time Instruction/research/public service, Non-tenured not on tenure track, Professors","2","1","1","0","0","0","0","0","0","1","1","0","0","0","0","0","0","0","1","0","1","0","0","0","0","0","0","0","0","0","-2"
"118888","Mills College","2011","Total full-time Instruction/research/public service, Non-tenured not on tenure track, Associate professors","4","1","3","0","0","0","0","0","0","0","0","0","0","0","0","0","0","0","4","1","3","0","0","0","0","0","0","0","0","0","-2"
"118888","Mills College","2011","Total full-time Instruction/research/public servicey, Non-tenured not on tenure track, Assistant professors","11","3","8","0","0","0","1","0","1","0","0","0","2","0","2","0","0","0","7","2","5","1","1","0","0","0","0","0","0","0","-2"
"118888","Mills College","2011","Total full-time Instruction/research/public service, Non-tenured not on tenure track, Lecturers","4","0","4","0","0","0","1","0","1","0","0","0","0","0","0","0","0","0","2","0","2","0","0","0","1","0","1","0","0","0","-2"
"118888","Mills College","2011","Total full-time Instruction/research/public service, Non-tenured not on tenure track total","21","5","16","0","0","0","2","0","2","1","1","0","2","0","2","0","0","0","14","3","11","1","1","0","1","0","1","0","0","0","-2"
"118912","MiraCosta College","2011","Total full-time Instruction/research/public service, Tenured, Instructors","127","60","67","2","0","2","8","5","3","7","4","3","24","15","9","0","0","0","86","36","50","0","0","0","0","0","0","0","0","0","-2"
"118912","MiraCosta College","2011","Total full-time Instruction/research/public service, Tenured total","127","60","67","2","0","2","8","5","3","7","4","3","24","15","9","0","0","0","86","36","50","0","0","0","0","0","0","0","0","0","-2"
"118912","MiraCosta College","2011","Total full-time Instruction/research/public service, Non-tenured on tenure track, Instructors","43","22","21","1","0","1","4","3","1","3","2","1","5","2","3","0","0","0","28","13","15","1","1","0","1","1","0","0","0","0","-2"
"118912","MiraCosta College","2011","Total full-time Instruction/research/public service, Non-tenured on tenure track total","43","22","21","1","0","1","4","3","1","3","2","1","5","2","3","0","0","0","28","13","15","1","1","0","1","1","0","0","0","0","-2"
"118912","MiraCosta College","2011","Total full-time Instruction/research/public service, Non-tenured not on tenure track, Instructors","22","3","19","0","0","0","4","1","3","1","0","1","4","0","4","0","0","0","12","2","10","0","0","0","0","0","0","1","0","1","-2"
"118912","MiraCosta College","2011","Total full-time Instruction/research/public service, Non-tenured not on tenure track total","22","3","19","0","0","0","4","1","3","1","0","1","4","0","4","0","0","0","12","2","10","0","0","0","0","0","0","1","0","1","-2"
"118976","Modesto Junior College","2011","Total full-time Instruction/research/public service, Tenured, Instructors","153","67","86","2","0","2","6","2","4","5","2","3","15","9","6","0","0","0","109","48","61","0","0","0","15","6","9","1","0","1","-2"
"118976","Modesto Junior College","2011","Total full-time Instruction/research/public service, Tenured total","153","67","86","2","0","2","6","2","4","5","2","3","15","9","6","0","0","0","109","48","61","0","0","0","15","6","9","1","0","1","-2"
"118976","Modesto Junior College","2011","Total full-time Instruction/research/public service, Non-tenured on tenure track, Instructors","75","41","34","0","0","0","3","1","2","4","1","3","4","3","1","0","0","0","57","33","24","0","0","0","7","3","4","0","0","0","-2"
"118976","Modesto Junior College","2011","Total full-time Instruction/research/public service, Non-tenured on tenure track total","75","41","34","0","0","0","3","1","2","4","1","3","4","3","1","0","0","0","57","33","24","0","0","0","7","3","4","0","0","0","-2"
"118976","Modesto Junior College","2011","Total full-time Instruction/research/public service, Non-tenured not on tenure track, Instructors","2","1","1","0","0","0","0","0","0","0","0","0","0","0","0","0","0","0","2","1","1","0","0","0","0","0","0","0","0","0","-2"
"118976","Modesto Junior College","2011","Total full-time Instruction/research/public service, Non-tenured not on tenure track total","2","1","1","0","0","0","0","0","0","0","0","0","0","0","0","0","0","0","2","1","1","0","0","0","0","0","0","0","0","0","-2"
"119173","Mount Saint Mary's University","2011","Total full-time Instruction/research/public service, Tenured, Professors","17","5","12","0","0","0","2","0","2","0","0","0","2","1","1","0","0","0","12","3","9","0","0","0","1","1","0","0","0","0","-2"
"119173","Mount Saint Mary's University","2011","Total full-time Instruction/research/public service, Tenured, Associate professors","19","4","15","0","0","0","0","0","0","0","0","0","1","0","1","0","0","0","17","4","13","1","0","1","0","0","0","0","0","0","-2"
"119173","Mount Saint Mary's University","2011","Total full-time Instruction/research/public service, Tenured, Assistant professors","6","1","5","0","0","0","0","0","0","1","0","1","1","1","0","0","0","0","4","0","4","0","0","0","0","0","0","0","0","0","-2"
"119173","Mount Saint Mary's University","2011","Total full-time Instruction/research/public service, Tenured total","42","10","32","0","0","0","2","0","2","1","0","1","4","2","2","0","0","0","33","7","26","1","0","1","1","1","0","0","0","0","-2"
"119173","Mount Saint Mary's University","2011","Total full-time Instruction/research/public service, Non-tenured on tenure track, Professors","1","0","1","0","0","0","0","0","0","0","0","0","0","0","0","0","0","0","1","0","1","0","0","0","0","0","0","0","0","0","-2"
"119173","Mount Saint Mary's University","2011","Total full-time Instruction/research/public service, Non-tenured on tenure track, Associate professors","13","1","12","0","0","0","1","0","1","1","0","1","0","0","0","0","0","0","10","1","9","0","0","0","1","0","1","0","0","0","-2"
"119173","Mount Saint Mary's University","2011","Total full-time Instruction/research/public service, Non-tenured on tenure track, Assistant professors","12","4","8","0","0","0","0","0","0","0","0","0","2","0","2","0","0","0","8","4","4","0","0","0","2","0","2","0","0","0","-2"
"119173","Mount Saint Mary's University","2011","Total full-time Instruction/research/public service, Non-tenured on tenure track, Instructors","4","0","4","0","0","0","0","0","0","2","0","2","0","0","0","0","0","0","2","0","2","0","0","0","0","0","0","0","0","0","-2"
"119173","Mount Saint Mary's University","2011","Total full-time Instruction/research/public service, Non-tenured on tenure track total","30","5","25","0","0","0","1","0","1","3","0","3","2","0","2","0","0","0","21","5","16","0","0","0","3","0","3","0","0","0","-2"
"119173","Mount Saint Mary's University","2011","Total full-time Instruction/research/public service, Non-tenured not on tenure track, Associate professors","2","0","2","0","0","0","0","0","0","0","0","0","0","0","0","0","0","0","2","0","2","0","0","0","0","0","0","0","0","0","-2"
"119173","Mount Saint Mary's University","2011","Total full-time Instruction/research/public servicey, Non-tenured not on tenure track, Assistant professors","9","4","5","0","0","0","3","2","1","0","0","0","1","1","0","0","0","0","5","1","4","0","0","0","0","0","0","0","0","0","-2"
"119173","Mount Saint Mary's University","2011","Total full-time Instruction/research/public service, Non-tenured not on tenure track, Instructors","16","4","12","1","0","1","2","0","2","3","1","2","2","0","2","0","0","0","8","3","5","0","0","0","0","0","0","0","0","0","-2"
"119173","Mount Saint Mary's University","2011","Total full-time Instruction/research/public service, Non-tenured not on tenure track total","27","8","19","1","0","1","5","2","3","3","1","2","3","1","2","0","0","0","15","4","11","0","0","0","0","0","0","0","0","0","-2"
"119605","National University","2011","Total full-time Instruction/research/public service, Non-tenured not on tenure track, Professors","59","38","21","1","1","0","5","4","1","1","1","0","2","1","1","0","0","0","45","29","16","0","0","0","5","2","3","0","0","0","-2"
"119605","National University","2011","Total full-time Instruction/research/public service, Non-tenured not on tenure track, Associate professors","86","44","42","1","0","1","5","3","2","2","0","2","5","3","2","0","0","0","58","30","28","0","0","0","15","8","7","0","0","0","-2"
"119605","National University","2011","Total full-time Instruction/research/public servicey, Non-tenured not on tenure track, Assistant professors","79","30","49","0","0","0","5","2","3","6","3","3","3","1","2","0","0","0","55","20","35","0","0","0","10","4","6","0","0","0","-2"
"119605","National University","2011","Total full-time Instruction/research/public service, Non-tenured not on tenure track, Instructors","17","7","10","0","0","0","2","1","1","1","0","1","0","0","0","0","0","0","12","5","7","0","0","0","2","1","1","0","0","0","-2"
"119605","National University","2011","Total full-time Instruction/research/public service, Non-tenured not on tenure track, No academic rank","4","1","3","0","0","0","0","0","0","0","0","0","0","0","0","0","0","0","1","0","1","0","0","0","3","1","2","0","0","0","-2"
"119605","National University","2011","Total full-time Instruction/research/public service, Non-tenured not on tenure track total","245","120","125","2","1","1","17","10","7","10","4","6","10","5","5","0","0","0","171","84","87","0","0","0","35","16","19","0","0","0","-2"
"120184","Notre Dame de Namur University","2011","Total full-time Instruction/research/public service, Tenured, Professors","35","19","16","1","1","0","5","2","3","0","0","0","1","0","1","0","0","0","28","16","12","0","0","0","0","0","0","0","0","0","-2"
"120184","Notre Dame de Namur University","2011","Total full-time Instruction/research/public service, Tenured total","35","19","16","1","1","0","5","2","3","0","0","0","1","0","1","0","0","0","28","16","12","0","0","0","0","0","0","0","0","0","-2"
"120184","Notre Dame de Namur University","2011","Total full-time Instruction/research/public service, Non-tenured on tenure track, Professors","1","1","0","0","0","0","1","1","0","0","0","0","0","0","0","0","0","0","0","0","0","0","0","0","0","0","0","0","0","0","-2"
"120184","Notre Dame de Namur University","2011","Total full-time Instruction/research/public service, Non-tenured on tenure track, Associate professors","4","1","3","0","0","0","1","0","1","0","0","0","0","0","0","0","0","0","3","1","2","0","0","0","0","0","0","0","0","0","-2"
"120184","Notre Dame de Namur University","2011","Total full-time Instruction/research/public service, Non-tenured on tenure track, Assistant professors","4","0","4","0","0","0","2","0","2","0","0","0","0","0","0","0","0","0","2","0","2","0","0","0","0","0","0","0","0","0","-2"
"120184","Notre Dame de Namur University","2011","Total full-time Instruction/research/public service, Non-tenured on tenure track total","9","2","7","0","0","0","4","1","3","0","0","0","0","0","0","0","0","0","5","1","4","0","0","0","0","0","0","0","0","0","-2"
"120184","Notre Dame de Namur University","2011","Total full-time Instruction/research/public servicey, Non-tenured not on tenure track, Assistant professors","6","1","5","0","0","0","2","1","1","0","0","0","0","0","0","0","0","0","4","0","4","0","0","0","0","0","0","0","0","0","-2"
"120184","Notre Dame de Namur University","2011","Total full-time Instruction/research/public service, Non-tenured not on tenure track, Instructors","5","3","2","0","0","0","0","0","0","1","1","0","0","0","0","0","0","0","4","2","2","0","0","0","0","0","0","0","0","0","-2"
"120184","Notre Dame de Namur University","2011","Total full-time Instruction/research/public service, Non-tenured not on tenure track, No academic rank","1","0","1","0","0","0","0","0","0","0","0","0","0","0","0","0","0","0","1","0","1","0","0","0","0","0","0","0","0","0","-2"
"120184","Notre Dame de Namur University","2011","Total full-time Instruction/research/public service, Non-tenured not on tenure track total","12","4","8","0","0","0","2","1","1","1","1","0","0","0","0","0","0","0","9","2","7","0","0","0","0","0","0","0","0","0","-2"
"120537","Hope International University","2011","Total full-time Instruction/research/public service, Non-tenured not on tenure track, Professors","8","7","1","0","0","0","0","0","0","0","0","0","0","0","0","0","0","0","8","7","1","0","0","0","0","0","0","0","0","0","-2"
"120537","Hope International University","2011","Total full-time Instruction/research/public service, Non-tenured not on tenure track, Associate professors","18","11","7","0","0","0","1","1","0","0","0","0","0","0","0","0","0","0","17","10","7","0","0","0","0","0","0","0","0","0","-2"
"120537","Hope International University","2011","Total full-time Instruction/research/public servicey, Non-tenured not on tenure track, Assistant professors","10","5","5","0","0","0","0","0","0","0","0","0","1","1","0","0","0","0","9","4","5","0","0","0","0","0","0","0","0","0","-2"
"120537","Hope International University","2011","Total full-time Instruction/research/public service, Non-tenured not on tenure track total","36","23","13","0","0","0","1","1","0","0","0","0","1","1","0","0","0","0","34","21","13","0","0","0","0","0","0","0","0","0","-2"
"120768","Pacific Oaks College","2011","Total full-time Instruction/research/public service, Non-tenured not on tenure track, No academic rank","11","2","9","0","0","0","1","0","1","3","0","3","2","0","2","0","0","0","5","2","3","0","0","0","0","0","0","0","0","0","-2"
"120768","Pacific Oaks College","2011","Total full-time Instruction/research/public service, Non-tenured not on tenure track total","11","2","9","0","0","0","1","0","1","3","0","3","2","0","2","0","0","0","5","2","3","0","0","0","0","0","0","0","0","0","-2"
"120865","Pacific Union College","2011","Total full-time Instruction/research/public service, Tenured, Professors","27","21","6","0","0","0","2","1","1","1","1","0","1","1","0","0","0","0","18","15","3","1","0","1","4","3","1","0","0","0","-2"
"120865","Pacific Union College","2011","Total full-time Instruction/research/public service, Tenured, Associate professors","7","3","4","0","0","0","0","0","0","0","0","0","1","0","1","0","0","0","5","3","2","0","0","0","1","0","1","0","0","0","-2"
"120865","Pacific Union College","2011","Total full-time Instruction/research/public service, Tenured total","34","24","10","0","0","0","2","1","1","1","1","0","2","1","1","0","0","0","23","18","5","1","0","1","5","3","2","0","0","0","-2"
"120865","Pacific Union College","2011","Total full-time Instruction/research/public service, Non-tenured on tenure track, Professors","7","5","2","0","0","0","0","0","0","0","0","0","0","0","0","0","0","0","6","4","2","1","1","0","0","0","0","0","0","0","-2"
"120865","Pacific Union College","2011","Total full-time Instruction/research/public service, Non-tenured on tenure track, Associate professors","15","7","8","0","0","0","0","0","0","0","0","0","1","0","1","0","0","0","12","6","6","2","1","1","0","0","0","0","0","0","-2"
"120865","Pacific Union College","2011","Total full-time Instruction/research/public service, Non-tenured on tenure track, Assistant professors","25","6","19","0","0","0","2","2","0","2","0","2","1","1","0","0","0","0","17","3","14","3","0","3","0","0","0","0","0","0","-2"
"120865","Pacific Union College","2011","Total full-time Instruction/research/public service, Non-tenured on tenure track total","47","18","29","0","0","0","2","2","0","2","0","2","2","1","1","0","0","0","35","13","22","6","2","4","0","0","0","0","0","0","-2"
"120865","Pacific Union College","2011","Total full-time Instruction/research/public service, Non-tenured not on tenure track, Instructors","6","2","4","0","0","0","0","0","0","0","0","0","0","0","0","0","0","0","5","2","3","0","0","0","1","0","1","0","0","0","-2"
"120865","Pacific Union College","2011","Total full-time Instruction/research/public service, Non-tenured not on tenure track total","6","2","4","0","0","0","0","0","0","0","0","0","0","0","0","0","0","0","5","2","3","0","0","0","1","0","1","0","0","0","-2"
"121619","Santa Ana College","2011","Total full-time Instruction/research/public service, Tenured, Instructors","163","76","87","4","2","2","14","7","7","5","3","2","30","14","16","0","0","0","107","48","59","0","0","0","1","0","1","2","2","0","-2"
"121619","Santa Ana College","2011","Total full-time Instruction/research/public service, Tenured total","163","76","87","4","2","2","14","7","7","5","3","2","30","14","16","0","0","0","107","48","59","0","0","0","1","0","1","2","2","0","-2"
"121619","Santa Ana College","2011","Total full-time Instruction/research/public service, Non-tenured on tenure track, Instructors","48","23","25","0","0","0","8","4","4","1","0","1","13","7","6","0","0","0","26","12","14","0","0","0","0","0","0","0","0","0","-2"
"121619","Santa Ana College","2011","Total full-time Instruction/research/public service, Non-tenured on tenure track total","48","23","25","0","0","0","8","4","4","1","0","1","13","7","6","0","0","0","26","12","14","0","0","0","0","0","0","0","0","0","-2"
"121619","Santa Ana College","2011","Total full-time Instruction/research/public service, Non-tenured not on tenure track, Instructors","10","3","7","0","0","0","1","0","1","0","0","0","2","0","2","0","0","0","5","2","3","0","0","0","0","0","0","2","1","1","-2"
"121619","Santa Ana College","2011","Total full-time Instruction/research/public service, Non-tenured not on tenure track total","10","3","7","0","0","0","1","0","1","0","0","0","2","0","2","0","0","0","5","2","3","0","0","0","0","0","0","2","1","1","-2"
"121691","University of Redlands","2011","Total full-time Instruction/research/public service, Tenured, Professors","82","49","33","0","0","0","9","8","1","1","1","0","0","0","0","2","1","1","69","39","30","0","0","0","1","0","1","0","0","0","-2"
"121691","University of Redlands","2011","Total full-time Instruction/research/public service, Tenured, Associate professors","41","16","25","0","0","0","4","0","4","3","1","2","0","0","0","0","0","0","33","14","19","0","0","0","0","0","0","1","1","0","-2"
"121691","University of Redlands","2011","Total full-time Instruction/research/public service, Tenured total","123","65","58","0","0","0","13","8","5","4","2","2","0","0","0","2","1","1","102","53","49","0","0","0","1","0","1","1","1","0","-2"
"121691","University of Redlands","2011","Total full-time Instruction/research/public service, Non-tenured on tenure track, Professors","2","1","1","0","0","0","0","0","0","0","0","0","0","0","0","0","0","0","2","1","1","0","0","0","0","0","0","0","0","0","-2"
"121691","University of Redlands","2011","Total full-time Instruction/research/public service, Non-tenured on tenure track, Associate professors","14","9","5","0","0","0","1","1","0","0","0","0","0","0","0","0","0","0","12","7","5","0","0","0","1","1","0","0","0","0","-2"
"121691","University of Redlands","2011","Total full-time Instruction/research/public service, Non-tenured on tenure track, Assistant professors","35","16","19","1","1","0","6","2","4","2","1","1","2","1","1","0","0","0","22","10","12","0","0","0","0","0","0","2","1","1","-2"
"121691","University of Redlands","2011","Total full-time Instruction/research/public service, Non-tenured on tenure track total","51","26","25","1","1","0","7","3","4","2","1","1","2","1","1","0","0","0","36","18","18","0","0","0","1","1","0","2","1","1","-2"
"121691","University of Redlands","2011","Total full-time Instruction/research/public service, Non-tenured not on tenure track, Professors","1","1","0","0","0","0","0","0","0","0","0","0","0","0","0","0","0","0","1","1","0","0","0","0","0","0","0","0","0","0","-2"
"121691","University of Redlands","2011","Total full-time Instruction/research/public service, Non-tenured not on tenure track, Associate professors","1","0","1","0","0","0","0","0","0","0","0","0","0","0","0","0","0","0","1","0","1","0","0","0","0","0","0","0","0","0","-2"
"121691","University of Redlands","2011","Total full-time Instruction/research/public service, Non-tenured not on tenure track, Lecturers","10","3","7","0","0","0","0","0","0","0","0","0","1","1","0","0","0","0","9","2","7","0","0","0","0","0","0","0","0","0","-2"
"121691","University of Redlands","2011","Total full-time Instruction/research/public service, Non-tenured not on tenure track, No academic rank","16","11","5","0","0","0","1","1","0","2","1","1","1","1","0","0","0","0","12","8","4","0","0","0","0","0","0","0","0","0","-2"
"121691","University of Redlands","2011","Total full-time Instruction/research/public service, Non-tenured not on tenure track total","28","15","13","0","0","0","1","1","0","2","1","1","2","2","0","0","0","0","23","11","12","0","0","0","0","0","0","0","0","0","-2"
"121886","Rio Hondo College","2011","Total full-time Instruction/research/public service, Tenured, Instructors","157","78","79","2","2","0","14","6","8","6","4","2","46","18","28","0","0","0","86","47","39","2","1","1","1","0","1","0","0","0","-2"
"121886","Rio Hondo College","2011","Total full-time Instruction/research/public service, Tenured total","157","78","79","2","2","0","14","6","8","6","4","2","46","18","28","0","0","0","86","47","39","2","1","1","1","0","1","0","0","0","-2"
"121886","Rio Hondo College","2011","Total full-time Instruction/research/public service, Non-tenured on tenure track, Instructors","35","19","16","0","0","0","5","2","3","2","1","1","11","5","6","0","0","0","14","8","6","1","1","0","0","0","0","2","2","0","-2"
"121886","Rio Hondo College","2011","Total full-time Instruction/research/public service, Non-tenured on tenure track total","35","19","16","0","0","0","5","2","3","2","1","1","11","5","6","0","0","0","14","8","6","1","1","0","0","0","0","2","2","0","-2"
"122375","San Diego Mesa College","2011","Total full-time Instruction/research/public service, Tenured, Instructors","258","132","126","2","1","1","22","8","14","22","13","9","30","14","16","0","0","0","158","84","74","0","0","0","24","12","12","0","0","0","-2"
"122375","San Diego Mesa College","2011","Total full-time Instruction/research/public service, Tenured total","258","132","126","2","1","1","22","8","14","22","13","9","30","14","16","0","0","0","158","84","74","0","0","0","24","12","12","0","0","0","-2"
"122375","San Diego Mesa College","2011","Total full-time Instruction/research/public service, Non-tenured on tenure track, Instructors","10","1","9","0","0","0","0","0","0","0","0","0","0","0","0","0","0","0","6","1","5","0","0","0","3","0","3","1","0","1","-2"
"122375","San Diego Mesa College","2011","Total full-time Instruction/research/public service, Non-tenured on tenure track total","10","1","9","0","0","0","0","0","0","0","0","0","0","0","0","0","0","0","6","1","5","0","0","0","3","0","3","1","0","1","-2"
"122375","San Diego Mesa College","2011","Total full-time Instruction/research/public service, Non-tenured not on tenure track, Instructors","18","6","12","0","0","0","0","0","0","2","0","2","2","1","1","0","0","0","14","5","9","0","0","0","0","0","0","0","0","0","-2"
"122375","San Diego Mesa College","2011","Total full-time Instruction/research/public service, Non-tenured not on tenure track total","18","6","12","0","0","0","0","0","0","2","0","2","2","1","1","0","0","0","14","5","9","0","0","0","0","0","0","0","0","0","-2"
"122977","Santa Monica College","2011","Total full-time Instruction/research/public service, Tenured, Instructors","269","112","157","0","0","0","28","12","16","33","13","20","34","13","21","0","0","0","168","74","94","0","0","0","1","0","1","5","0","5","-2"
"122977","Santa Monica College","2011","Total full-time Instruction/research/public service, Tenured total","269","112","157","0","0","0","28","12","16","33","13","20","34","13","21","0","0","0","168","74","94","0","0","0","1","0","1","5","0","5","-2"
"122977","Santa Monica College","2011","Total full-time Instruction/research/public service, Non-tenured on tenure track, Instructors","40","18","22","0","0","0","4","2","2","2","1","1","5","2","3","0","0","0","16","8","8","1","0","1","0","0","0","12","5","7","-2"
"122977","Santa Monica College","2011","Total full-time Instruction/research/public service, Non-tenured on tenure track total","40","18","22","0","0","0","4","2","2","2","1","1","5","2","3","0","0","0","16","8","8","1","0","1","0","0","0","12","5","7","-2"
"122977","Santa Monica College","2011","Total full-time Instruction/research/public service, Non-tenured not on tenure track, Instructors","1","1","0","0","0","0","0","0","0","0","0","0","0","0","0","0","0","0","1","1","0","0","0","0","0","0","0","0","0","0","-2"
"122977","Santa Monica College","2011","Total full-time Instruction/research/public service, Non-tenured not on tenure track total","1","1","0","0","0","0","0","0","0","0","0","0","0","0","0","0","0","0","1","1","0","0","0","0","0","0","0","0","0","0","-2"
"123509","Skyline College","2011","Total full-time Instruction/research/public service, Tenured, Instructors","94","51","43","0","0","0","18","8","10","7","6","1","18","8","10","0","0","0","50","29","21","0","0","0","0","0","0","1","0","1","-2"
"123509","Skyline College","2011","Total full-time Instruction/research/public service, Tenured total","94","51","43","0","0","0","18","8","10","7","6","1","18","8","10","0","0","0","50","29","21","0","0","0","0","0","0","1","0","1","-2"
"123509","Skyline College","2011","Total full-time Instruction/research/public service, Non-tenured on tenure track, Instructors","15","7","8","0","0","0","2","1","1","0","0","0","3","2","1","1","0","1","6","2","4","0","0","0","3","2","1","0","0","0","-2"
"123509","Skyline College","2011","Total full-time Instruction/research/public service, Non-tenured on tenure track total","15","7","8","0","0","0","2","1","1","0","0","0","3","2","1","1","0","1","6","2","4","0","0","0","3","2","1","0","0","0","-2"
"123509","Skyline College","2011","Total full-time Instruction/research/public service, Non-tenured not on tenure track, Instructors","9","5","4","0","0","0","2","1","1","0","0","0","1","0","1","0","0","0","6","4","2","0","0","0","0","0","0","0","0","0","-2"
"123509","Skyline College","2011","Total full-time Instruction/research/public service, Non-tenured not on tenure track total","9","5","4","0","0","0","2","1","1","0","0","0","1","0","1","0","0","0","6","4","2","0","0","0","0","0","0","0","0","0","-2"
"123554","Saint Mary's College of California","2011","Total full-time Instruction/research/public service, Tenured, Professors","84","50","34","0","0","0","6","6","0","0","0","0","6","4","2","0","0","0","71","39","32","0","0","0","1","1","0","0","0","0","-2"
"123554","Saint Mary's College of California","2011","Total full-time Instruction/research/public service, Tenured, Associate professors","47","23","24","1","0","1","9","4","5","3","1","2","1","0","1","0","0","0","31","17","14","0","0","0","2","1","1","0","0","0","-2"
"123554","Saint Mary's College of California","2011","Total full-time Instruction/research/public service, Tenured total","131","73","58","1","0","1","15","10","5","3","1","2","7","4","3","0","0","0","102","56","46","0","0","0","3","2","1","0","0","0","-2"
"123554","Saint Mary's College of California","2011","Total full-time Instruction/research/public service, Non-tenured on tenure track, Associate professors","12","4","8","0","0","0","2","0","2","0","0","0","2","1","1","0","0","0","5","2","3","0","0","0","1","0","1","2","1","1","-2"
"123554","Saint Mary's College of California","2011","Total full-time Instruction/research/public service, Non-tenured on tenure track, Assistant professors","29","11","18","0","0","0","4","0","4","0","0","0","2","0","2","0","0","0","16","9","7","0","0","0","4","1","3","3","1","2","-2"
"123554","Saint Mary's College of California","2011","Total full-time Instruction/research/public service, Non-tenured on tenure track total","41","15","26","0","0","0","6","0","6","0","0","0","4","1","3","0","0","0","21","11","10","0","0","0","5","1","4","5","2","3","-2"
"123554","Saint Mary's College of California","2011","Total full-time Instruction/research/public service, Non-tenured not on tenure track, Professors","2","0","2","0","0","0","0","0","0","0","0","0","0","0","0","0","0","0","2","0","2","0","0","0","0","0","0","0","0","0","-2"
"123554","Saint Mary's College of California","2011","Total full-time Instruction/research/public service, Non-tenured not on tenure track, Associate professors","17","3","14","0","0","0","0","0","0","0","0","0","0","0","0","0","0","0","15","2","13","0","0","0","1","1","0","1","0","1","-2"
"123554","Saint Mary's College of California","2011","Total full-time Instruction/research/public servicey, Non-tenured not on tenure track, Assistant professors","5","1","4","0","0","0","1","0","1","0","0","0","1","0","1","0","0","0","1","0","1","0","0","0","1","0","1","1","1","0","-2"
"123554","Saint Mary's College of California","2011","Total full-time Instruction/research/public service, Non-tenured not on tenure track total","24","4","20","0","0","0","1","0","1","0","0","0","1","0","1","0","0","0","18","2","16","0","0","0","2","1","1","2","1","1","-2"
"123563","Solano Community College","2011","Total full-time Instruction/research/public service, Tenured, Instructors","140","64","76","0","0","0","6","3","3","10","4","6","13","6","7","0","0","0","111","51","60","0","0","0","0","0","0","0","0","0","-2"
"123563","Solano Community College","2011","Total full-time Instruction/research/public service, Tenured total","140","64","76","0","0","0","6","3","3","10","4","6","13","6","7","0","0","0","111","51","60","0","0","0","0","0","0","0","0","0","-2"
"123563","Solano Community College","2011","Total full-time Instruction/research/public service, Non-tenured on tenure track, Instructors","11","2","9","0","0","0","0","0","0","2","0","2","2","0","2","0","0","0","7","2","5","0","0","0","0","0","0","0","0","0","-2"
"123563","Solano Community College","2011","Total full-time Instruction/research/public service, Non-tenured on tenure track total","11","2","9","0","0","0","0","0","0","2","0","2","2","0","2","0","0","0","7","2","5","0","0","0","0","0","0","0","0","0","-2"
"123563","Solano Community College","2011","Total full-time Instruction/research/public service, Non-tenured not on tenure track, Instructors","3","2","1","0","0","0","0","0","0","0","0","0","0","0","0","0","0","0","3","2","1","0","0","0","0","0","0","0","0","0","-2"
"123563","Solano Community College","2011","Total full-time Instruction/research/public service, Non-tenured not on tenure track total","3","2","1","0","0","0","0","0","0","0","0","0","0","0","0","0","0","0","3","2","1","0","0","0","0","0","0","0","0","0","-2"
"123572","Sonoma State University","2011","Total full-time Instruction/research/public service, Tenured, Professors","120","67","53","1","1","0","9","7","2","1","0","1","4","3","1","1","1","0","98","52","46","3","1","2","3","2","1","0","0","0","-2"
"123572","Sonoma State University","2011","Total full-time Instruction/research/public service, Tenured, Associate professors","58","27","31","0","0","0","6","3","3","2","1","1","6","1","5","0","0","0","42","21","21","0","0","0","2","1","1","0","0","0","-2"
"123572","Sonoma State University","2011","Total full-time Instruction/research/public service, Tenured, Assistant professors","2","2","0","0","0","0","0","0","0","0","0","0","1","1","0","0","0","0","1","1","0","0","0","0","0","0","0","0","0","0","-2"
"123572","Sonoma State University","2011","Total full-time Instruction/research/public service, Tenured total","180","96","84","1","1","0","15","10","5","3","1","2","11","5","6","1","1","0","141","74","67","3","1","2","5","3","2","0","0","0","-2"
"123572","Sonoma State University","2011","Total full-time Instruction/research/public service, Non-tenured on tenure track, Associate professors","2","1","1","0","0","0","0","0","0","0","0","0","0","0","0","0","0","0","2","1","1","0","0","0","0","0","0","0","0","0","-2"
"123572","Sonoma State University","2011","Total full-time Instruction/research/public service, Non-tenured on tenure track, Assistant professors","54","29","25","0","0","0","5","5","0","1","0","1","5","2","3","0","0","0","37","19","18","1","1","0","3","1","2","2","1","1","-2"
"123572","Sonoma State University","2011","Total full-time Instruction/research/public service, Non-tenured on tenure track total","56","30","26","0","0","0","5","5","0","1","0","1","5","2","3","0","0","0","39","20","19","1","1","0","3","1","2","2","1","1","-2"
"123572","Sonoma State University","2011","Total full-time Instruction/research/public service, Non-tenured not on tenure track, Lecturers","21","9","12","0","0","0","0","0","0","0","0","0","0","0","0","0","0","0","21","9","12","0","0","0","0","0","0","0","0","0","-2"
"123572","Sonoma State University","2011","Total full-time Instruction/research/public service, Non-tenured not on tenure track total","21","9","12","0","0","0","0","0","0","0","0","0","0","0","0","0","0","0","21","9","12","0","0","0","0","0","0","0","0","0","-2"
"123651","Vanguard University of Southern California","2011","Total full-time Instruction/research/public service, Tenured, Professors","22","16","6","0","0","0","0","0","0","0","0","0","1","1","0","0","0","0","18","13","5","0","0","0","3","2","1","0","0","0","-2"
"123651","Vanguard University of Southern California","2011","Total full-time Instruction/research/public service, Tenured, Associate professors","24","12","12","0","0","0","0","0","0","0","0","0","0","0","0","0","0","0","24","12","12","0","0","0","0","0","0","0","0","0","-2"
"123651","Vanguard University of Southern California","2011","Total full-time Instruction/research/public service, Tenured total","46","28","18","0","0","0","0","0","0","0","0","0","1","1","0","0","0","0","42","25","17","0","0","0","3","2","1","0","0","0","-2"
"123651","Vanguard University of Southern California","2011","Total full-time Instruction/research/public service, Non-tenured on tenure track, Professors","1","1","0","0","0","0","0","0","0","0","0","0","0","0","0","0","0","0","0","0","0","0","0","0","1","1","0","0","0","0","-2"
"123651","Vanguard University of Southern California","2011","Total full-time Instruction/research/public service, Non-tenured on tenure track, Associate professors","3","1","2","0","0","0","0","0","0","0","0","0","0","0","0","0","0","0","2","0","2","0","0","0","1","1","0","0","0","0","-2"
"123651","Vanguard University of Southern California","2011","Total full-time Instruction/research/public service, Non-tenured on tenure track, Assistant professors","11","3","8","0","0","0","0","0","0","0","0","0","0","0","0","0","0","0","11","3","8","0","0","0","0","0","0","0","0","0","-2"
"123651","Vanguard University of Southern California","2011","Total full-time Instruction/research/public service, Non-tenured on tenure track total","15","5","10","0","0","0","0","0","0","0","0","0","0","0","0","0","0","0","13","3","10","0","0","0","2","2","0","0","0","0","-2"
"123651","Vanguard University of Southern California","2011","Total full-time Instruction/research/public servicey, Non-tenured not on tenure track, Assistant professors","1","0","1","0","0","0","0","0","0","0","0","0","0","0","0","0","0","0","1","0","1","0","0","0","0","0","0","0","0","0","-2"
"123651","Vanguard University of Southern California","2011","Total full-time Instruction/research/public service, Non-tenured not on tenure track, Instructors","1","1","0","0","0","0","0","0","0","0","0","0","0","0","0","0","0","0","1","1","0","0","0","0","0","0","0","0","0","0","-2"
"123651","Vanguard University of Southern California","2011","Total full-time Instruction/research/public service, Non-tenured not on tenure track total","2","1","1","0","0","0","0","0","0","0","0","0","0","0","0","0","0","0","2","1","1","0","0","0","0","0","0","0","0","0","-2"
"125471","West Los Angeles College","2011","Total full-time Instruction/research/public service, Tenured, Instructors","67","30","37","0","0","0","7","3","4","17","4","13","6","1","5","0","0","0","35","20","15","0","0","0","2","2","0","0","0","0","-2"
"125471","West Los Angeles College","2011","Total full-time Instruction/research/public service, Tenured total","67","30","37","0","0","0","7","3","4","17","4","13","6","1","5","0","0","0","35","20","15","0","0","0","2","2","0","0","0","0","-2"
"125471","West Los Angeles College","2011","Total full-time Instruction/research/public service, Non-tenured on tenure track, Instructors","11","2","9","0","0","0","2","1","1","3","1","2","2","0","2","0","0","0","2","0","2","0","0","0","2","0","2","0","0","0","-2"
"125471","West Los Angeles College","2011","Total full-time Instruction/research/public service, Non-tenured on tenure track total","11","2","9","0","0","0","2","1","1","3","1","2","2","0","2","0","0","0","2","0","2","0","0","0","2","0","2","0","0","0","-2"
"125471","West Los Angeles College","2011","Total full-time Instruction/research/public service, Non-tenured not on tenure track, Instructors","19","11","8","1","0","1","2","1","1","1","1","0","2","1","1","0","0","0","10","5","5","0","0","0","3","3","0","0","0","0","-2"
"125471","West Los Angeles College","2011","Total full-time Instruction/research/public service, Non-tenured not on tenure track total","19","11","8","1","0","1","2","1","1","1","1","0","2","1","1","0","0","0","10","5","5","0","0","0","3","3","0","0","0","0","-2"
"125763","Whittier College","2011","Total full-time Instruction/research/public service, Tenured, Professors","49","33","16","1","1","0","1","1","0","1","1","0","2","2","0","0","0","0","44","28","16","0","0","0","0","0","0","0","0","0","-2"
"125763","Whittier College","2011","Total full-time Instruction/research/public service, Tenured, Associate professors","33","14","19","0","0","0","1","0","1","2","1","1","3","2","1","0","0","0","27","11","16","0","0","0","0","0","0","0","0","0","-2"
"125763","Whittier College","2011","Total full-time Instruction/research/public service, Tenured total","82","47","35","1","1","0","2","1","1","3","2","1","5","4","1","0","0","0","71","39","32","0","0","0","0","0","0","0","0","0","-2"
"125763","Whittier College","2011","Total full-time Instruction/research/public service, Non-tenured on tenure track, Associate professors","1","0","1","0","0","0","1","0","1","0","0","0","0","0","0","0","0","0","0","0","0","0","0","0","0","0","0","0","0","0","-2"
"125763","Whittier College","2011","Total full-time Instruction/research/public service, Non-tenured on tenure track, Assistant professors","30","12","18","0","0","0","2","1","1","2","1","1","9","6","3","0","0","0","16","4","12","0","0","0","1","0","1","0","0","0","-2"
"125763","Whittier College","2011","Total full-time Instruction/research/public service, Non-tenured on tenure track total","31","12","19","0","0","0","3","1","2","2","1","1","9","6","3","0","0","0","16","4","12","0","0","0","1","0","1","0","0","0","-2"
"125763","Whittier College","2011","Total full-time Instruction/research/public service, Non-tenured not on tenure track, Professors","1","0","1","0","0","0","0","0","0","0","0","0","0","0","0","0","0","0","1","0","1","0","0","0","0","0","0","0","0","0","-2"
"125763","Whittier College","2011","Total full-time Instruction/research/public servicey, Non-tenured not on tenure track, Assistant professors","3","1","2","0","0","0","1","0","1","0","0","0","1","1","0","0","0","0","1","0","1","0","0","0","0","0","0","0","0","0","-2"
"125763","Whittier College","2011","Total full-time Instruction/research/public service, Non-tenured not on tenure track total","4","1","3","0","0","0","1","0","1","0","0","0","1","1","0","0","0","0","2","0","2","0","0","0","0","0","0","0","0","0","-2"
"125897","Woodbury University","2011","Total full-time Instruction/research/public service, Non-tenured not on tenure track, Professors","23","12","11","0","0","0","1","1","0","0","0","0","1","1","0","0","0","0","21","10","11","0","0","0","0","0","0","0","0","0","-2"
"125897","Woodbury University","2011","Total full-time Instruction/research/public service, Non-tenured not on tenure track, Associate professors","19","9","10","0","0","0","1","0","1","0","0","0","0","0","0","0","0","0","18","9","9","0","0","0","0","0","0","0","0","0","-2"
"125897","Woodbury University","2011","Total full-time Instruction/research/public servicey, Non-tenured not on tenure track, Assistant professors","29","18","11","0","0","0","2","1","1","1","0","1","1","1","0","0","0","0","23","14","9","0","0","0","0","0","0","2","2","0","-2"
"125897","Woodbury University","2011","Total full-time Instruction/research/public service, Non-tenured not on tenure track total","71","39","32","0","0","0","4","2","2","1","0","1","2","2","0","0","0","0","62","33","29","0","0","0","0","0","0","2","2","0","-2"
"126182","Adams State University","2011","Total full-time Instruction/research/public service, Tenured, Professors","36","22","14","0","0","0","0","0","0","0","0","0","2","1","1","0","0","0","33","20","13","0","0","0","1","1","0","0","0","0","-2"
"126182","Adams State University","2011","Total full-time Instruction/research/public service, Tenured, Associate professors","24","15","9","0","0","0","0","0","0","0","0","0","6","4","2","0","0","0","16","10","6","1","1","0","1","0","1","0","0","0","-2"
"126182","Adams State University","2011","Total full-time Instruction/research/public service, Tenured, Assistant professors","2","2","0","0","0","0","0","0","0","0","0","0","1","1","0","0","0","0","1","1","0","0","0","0","0","0","0","0","0","0","-2"
"126182","Adams State University","2011","Total full-time Instruction/research/public service, Tenured total","62","39","23","0","0","0","0","0","0","0","0","0","9","6","3","0","0","0","50","31","19","1","1","0","2","1","1","0","0","0","-2"
"126182","Adams State University","2011","Total full-time Instruction/research/public service, Non-tenured on tenure track, Associate professors","2","1","1","0","0","0","0","0","0","0","0","0","0","0","0","0","0","0","2","1","1","0","0","0","0","0","0","0","0","0","-2"
"126182","Adams State University","2011","Total full-time Instruction/research/public service, Non-tenured on tenure track, Assistant professors","34","12","22","0","0","0","2","1","1","0","0","0","6","1","5","1","0","1","25","10","15","0","0","0","0","0","0","0","0","0","-2"
"126182","Adams State University","2011","Total full-time Instruction/research/public service, Non-tenured on tenure track total","36","13","23","0","0","0","2","1","1","0","0","0","6","1","5","1","0","1","27","11","16","0","0","0","0","0","0","0","0","0","-2"
"126562","University of Colorado Denver/Anschutz Medical Campus","2011","Total full-time Instruction/research/public service, Tenured, Professors","354","268","86","2","1","1","20","14","6","5","3","2","8","5","3","0","0","0","313","240","73","0","0","0","6","5","1","0","0","0","-2"
"126562","University of Colorado Denver/Anschutz Medical Campus","2011","Total full-time Instruction/research/public service, Tenured, Associate professors","195","121","74","2","1","1","18","11","7","2","1","1","13","10","3","0","0","0","154","95","59","0","0","0","6","3","3","0","0","0","-2"
"126562","University of Colorado Denver/Anschutz Medical Campus","2011","Total full-time Instruction/research/public service, Tenured total","549","389","160","4","2","2","38","25","13","7","4","3","21","15","6","0","0","0","467","335","132","0","0","0","12","8","4","0","0","0","-2"
"126562","University of Colorado Denver/Anschutz Medical Campus","2011","Total full-time Instruction/research/public service, Non-tenured on tenure track, Professors","142","100","42","0","0","0","12","8","4","0","0","0","5","4","1","0","0","0","114","80","34","0","0","0","11","8","3","0","0","0","-2"
"126562","University of Colorado Denver/Anschutz Medical Campus","2011","Total full-time Instruction/research/public service, Non-tenured on tenure track, Associate professors","396","220","176","3","0","3","24","16","8","2","0","2","12","5","7","1","1","0","305","168","137","0","0","0","48","29","19","1","1","0","-2"
"126562","University of Colorado Denver/Anschutz Medical Campus","2011","Total full-time Instruction/research/public service, Non-tenured on tenure track, Assistant professors","636","321","315","3","2","1","69","37","32","11","3","8","24","12","12","1","0","1","425","206","219","0","0","0","79","41","38","24","20","4","-2"
"126562","University of Colorado Denver/Anschutz Medical Campus","2011","Total full-time Instruction/research/public service, Non-tenured on tenure track total","1174","641","533","6","2","4","105","61","44","13","3","10","41","21","20","2","1","1","844","454","390","0","0","0","138","78","60","25","21","4","-2"
"126562","University of Colorado Denver/Anschutz Medical Campus","2011","Total full-time Instruction/research/public service, Non-tenured not on tenure track, Professors","23","15","8","0","0","0","2","2","0","0","0","0","0","0","0","0","0","0","20","13","7","0","0","0","1","0","1","0","0","0","-2"
"126562","University of Colorado Denver/Anschutz Medical Campus","2011","Total full-time Instruction/research/public service, Non-tenured not on tenure track, Associate professors","60","37","23","1","1","0","5","3","2","0","0","0","1","1","0","0","0","0","49","30","19","0","0","0","4","2","2","0","0","0","-2"
"126562","University of Colorado Denver/Anschutz Medical Campus","2011","Total full-time Instruction/research/public servicey, Non-tenured not on tenure track, Assistant professors","170","79","91","0","0","0","21","14","7","3","2","1","11","5","6","0","0","0","110","51","59","0","0","0","11","1","10","14","6","8","-2"
"126562","University of Colorado Denver/Anschutz Medical Campus","2011","Total full-time Instruction/research/public service, Non-tenured not on tenure track, Instructors","1003","325","678","10","2","8","59","31","28","13","5","8","40","14","26","1","0","1","709","226","483","0","0","0","146","36","110","25","11","14","-2"
"126562","University of Colorado Denver/Anschutz Medical Campus","2011","Total full-time Instruction/research/public service, Non-tenured not on tenure track, No academic rank","37","17","20","0","0","0","1","1","0","1","1","0","0","0","0","0","0","0","27","10","17","0","0","0","2","1","1","6","4","2","-2"
"126562","University of Colorado Denver/Anschutz Medical Campus","2011","Total full-time Instruction/research/public service, Non-tenured not on tenure track total","1293","473","820","11","3","8","88","51","37","17","8","9","52","20","32","1","0","1","915","330","585","0","0","0","164","40","124","45","21","24","-2"
"126711","Colorado Mountain College","2011","Total full-time Instruction/research/public service, Non-tenured not on tenure track, Professors","28","15","13","0","0","0","0","0","0","0","0","0","1","1","0","0","0","0","27","14","13","0","0","0","0","0","0","0","0","0","-2"
"126711","Colorado Mountain College","2011","Total full-time Instruction/research/public service, Non-tenured not on tenure track, Associate professors","47","22","25","0","0","0","1","1","0","0","0","0","1","0","1","0","0","0","42","19","23","0","0","0","3","2","1","0","0","0","-2"
"126711","Colorado Mountain College","2011","Total full-time Instruction/research/public servicey, Non-tenured not on tenure track, Assistant professors","26","15","11","1","1","0","1","0","1","0","0","0","0","0","0","0","0","0","23","14","9","0","0","0","1","0","1","0","0","0","-2"
"126711","Colorado Mountain College","2011","Total full-time Instruction/research/public service, Non-tenured not on tenure track, Instructors","4","2","2","0","0","0","0","0","0","0","0","0","1","0","1","0","0","0","3","2","1","0","0","0","0","0","0","0","0","0","-2"
"126711","Colorado Mountain College","2011","Total full-time Instruction/research/public service, Non-tenured not on tenure track total","105","54","51","1","1","0","2","1","1","0","0","0","3","1","2","0","0","0","95","49","46","0","0","0","4","2","2","0","0","0","-2"
"126942","Community College of Denver","2011","Total full-time Instruction/research/public service, Non-tenured not on tenure track, Professors","25","12","13","0","0","0","1","0","1","2","1","1","0","0","0","0","0","0","22","11","11","0","0","0","0","0","0","0","0","0","-2"
"126942","Community College of Denver","2011","Total full-time Instruction/research/public service, Non-tenured not on tenure track, Associate professors","19","7","12","0","0","0","1","1","0","2","0","2","4","2","2","0","0","0","12","4","8","0","0","0","0","0","0","0","0","0","-2"
"126942","Community College of Denver","2011","Total full-time Instruction/research/public servicey, Non-tenured not on tenure track, Assistant professors","14","6","8","0","0","0","1","1","0","1","0","1","1","1","0","0","0","0","11","4","7","0","0","0","0","0","0","0","0","0","-2"
"126942","Community College of Denver","2011","Total full-time Instruction/research/public service, Non-tenured not on tenure track, Instructors","63","29","34","1","0","1","2","0","2","2","2","0","3","1","2","0","0","0","54","26","28","1","0","1","0","0","0","0","0","0","-2"
"126942","Community College of Denver","2011","Total full-time Instruction/research/public service, Non-tenured not on tenure track total","121","54","67","1","0","1","5","2","3","7","3","4","8","4","4","0","0","0","99","45","54","1","0","1","0","0","0","0","0","0","-2"
"127617","Morgan Community College","2011","Total full-time Instruction/research/public service, Non-tenured not on tenure track, No academic rank","33","13","20","0","0","0","0","0","0","0","0","0","0","0","0","0","0","0","33","13","20","0","0","0","0","0","0","0","0","0","-2"
"127617","Morgan Community College","2011","Total full-time Instruction/research/public service, Non-tenured not on tenure track total","33","13","20","0","0","0","0","0","0","0","0","0","0","0","0","0","0","0","33","13","20","0","0","0","0","0","0","0","0","0","-2"
"127884","Pueblo Community College","2011","Total full-time Instruction/research/public service, Non-tenured not on tenure track, No academic rank","98","44","54","1","1","0","0","0","0","1","0","1","13","8","5","0","0","0","79","33","46","0","0","0","4","2","2","0","0","0","-2"
"127884","Pueblo Community College","2011","Total full-time Instruction/research/public service, Non-tenured not on tenure track total","98","44","54","1","1","0","0","0","0","1","0","1","13","8","5","0","0","0","79","33","46","0","0","0","4","2","2","0","0","0","-2"
"128106","Colorado State University Pueblo","2011","Total full-time Instruction/research/public service, Tenured, Professors","48","35","13","0","0","0","3","3","0","3","3","0","8","4","4","0","0","0","31","22","9","0","0","0","3","3","0","0","0","0","-2"
"128106","Colorado State University Pueblo","2011","Total full-time Instruction/research/public service, Tenured, Associate professors","44","21","23","0","0","0","3","1","2","0","0","0","4","1","3","0","0","0","35","19","16","0","0","0","2","0","2","0","0","0","-2"
"128106","Colorado State University Pueblo","2011","Total full-time Instruction/research/public service, Tenured, Assistant professors","9","3","6","0","0","0","2","1","1","1","0","1","0","0","0","0","0","0","6","2","4","0","0","0","0","0","0","0","0","0","-2"
"128106","Colorado State University Pueblo","2011","Total full-time Instruction/research/public service, Tenured total","101","59","42","0","0","0","8","5","3","4","3","1","12","5","7","0","0","0","72","43","29","0","0","0","5","3","2","0","0","0","-2"
"128106","Colorado State University Pueblo","2011","Total full-time Instruction/research/public service, Non-tenured on tenure track, Assistant professors","53","25","28","0","0","0","1","0","1","1","0","1","4","2","2","1","0","1","39","19","20","1","0","1","3","2","1","3","2","1","-2"
"128106","Colorado State University Pueblo","2011","Total full-time Instruction/research/public service, Non-tenured on tenure track, Instructors","1","0","1","0","0","0","0","0","0","0","0","0","0","0","0","0","0","0","1","0","1","0","0","0","0","0","0","0","0","0","-2"
"128106","Colorado State University Pueblo","2011","Total full-time Instruction/research/public service, Non-tenured on tenure track total","54","25","29","0","0","0","1","0","1","1","0","1","4","2","2","1","0","1","40","19","21","1","0","1","3","2","1","3","2","1","-2"
"128106","Colorado State University Pueblo","2011","Total full-time Instruction/research/public servicey, Non-tenured not on tenure track, Assistant professors","4","2","2","0","0","0","1","0","1","0","0","0","0","0","0","0","0","0","2","1","1","0","0","0","0","0","0","1","1","0","-2"
"128106","Colorado State University Pueblo","2011","Total full-time Instruction/research/public service, Non-tenured not on tenure track, Instructors","1","0","1","0","0","0","0","0","0","0","0","0","0","0","0","0","0","0","1","0","1","0","0","0","0","0","0","0","0","0","-2"
"128106","Colorado State University Pueblo","2011","Total full-time Instruction/research/public service, Non-tenured not on tenure track, Lecturers","28","13","15","0","0","0","0","0","0","0","0","0","3","1","2","0","0","0","21","10","11","0","0","0","2","2","0","2","0","2","-2"
"128106","Colorado State University Pueblo","2011","Total full-time Instruction/research/public service, Non-tenured not on tenure track, No academic rank","5","4","1","0","0","0","0","0","0","0","0","0","0","0","0","0","0","0","5","4","1","0","0","0","0","0","0","0","0","0","-2"
"128106","Colorado State University Pueblo","2011","Total full-time Instruction/research/public service, Non-tenured not on tenure track total","38","19","19","0","0","0","1","0","1","0","0","0","3","1","2","0","0","0","29","15","14","0","0","0","2","2","0","3","1","2","-2"
"128744","University of Bridgeport","2011","Total full-time Instruction/research/public service, Tenured, Professors","17","14","3","0","0","0","4","3","1","0","0","0","0","0","0","0","0","0","13","11","2","0","0","0","0","0","0","0","0","0","-2"
"128744","University of Bridgeport","2011","Total full-time Instruction/research/public service, Tenured, Associate professors","25","17","8","0","0","0","5","4","1","1","1","0","1","0","1","0","0","0","18","12","6","0","0","0","0","0","0","0","0","0","-2"
"128744","University of Bridgeport","2011","Total full-time Instruction/research/public service, Tenured, Assistant professors","2","0","2","0","0","0","0","0","0","0","0","0","0","0","0","0","0","0","2","0","2","0","0","0","0","0","0","0","0","0","-2"
"128744","University of Bridgeport","2011","Total full-time Instruction/research/public service, Tenured total","44","31","13","0","0","0","9","7","2","1","1","0","1","0","1","0","0","0","33","23","10","0","0","0","0","0","0","0","0","0","-2"
"128744","University of Bridgeport","2011","Total full-time Instruction/research/public service, Non-tenured on tenure track, Associate professors","11","9","2","0","0","0","1","1","0","1","1","0","0","0","0","0","0","0","9","7","2","0","0","0","0","0","0","0","0","0","-2"
"128744","University of Bridgeport","2011","Total full-time Instruction/research/public service, Non-tenured on tenure track, Assistant professors","28","15","13","0","0","0","9","7","2","1","0","1","0","0","0","0","0","0","18","8","10","0","0","0","0","0","0","0","0","0","-2"
"128744","University of Bridgeport","2011","Total full-time Instruction/research/public service, Non-tenured on tenure track total","39","24","15","0","0","0","10","8","2","2","1","1","0","0","0","0","0","0","27","15","12","0","0","0","0","0","0","0","0","0","-2"
"128744","University of Bridgeport","2011","Total full-time Instruction/research/public service, Non-tenured not on tenure track, Associate professors","1","1","0","0","0","0","0","0","0","0","0","0","0","0","0","0","0","0","1","1","0","0","0","0","0","0","0","0","0","0","-2"
"128744","University of Bridgeport","2011","Total full-time Instruction/research/public servicey, Non-tenured not on tenure track, Assistant professors","22","9","13","0","0","0","0","0","0","2","0","2","0","0","0","0","0","0","20","9","11","0","0","0","0","0","0","0","0","0","-2"
"128744","University of Bridgeport","2011","Total full-time Instruction/research/public service, Non-tenured not on tenure track, Lecturers","18","11","7","0","0","0","2","1","1","0","0","0","0","0","0","0","0","0","16","10","6","0","0","0","0","0","0","0","0","0","-2"
"128744","University of Bridgeport","2011","Total full-time Instruction/research/public service, Non-tenured not on tenure track total","41","21","20","0","0","0","2","1","1","2","0","2","0","0","0","0","0","0","37","20","17","0","0","0","0","0","0","0","0","0","-2"
"131876","Trinity Washington University","2011","Total full-time Instruction/research/public service, Tenured, Professors","9","1","8","0","0","0","0","0","0","1","0","1","0","0","0","0","0","0","8","1","7","0","0","0","0","0","0","0","0","0","-2"
"131876","Trinity Washington University","2011","Total full-time Instruction/research/public service, Tenured, Associate professors","19","5","14","0","0","0","3","2","1","2","1","1","3","1","2","0","0","0","11","1","10","0","0","0","0","0","0","0","0","0","-2"
"131876","Trinity Washington University","2011","Total full-time Instruction/research/public service, Tenured total","28","6","22","0","0","0","3","2","1","3","1","2","3","1","2","0","0","0","19","2","17","0","0","0","0","0","0","0","0","0","-2"
"131876","Trinity Washington University","2011","Total full-time Instruction/research/public service, Non-tenured on tenure track, Assistant professors","14","5","9","0","0","0","1","0","1","4","1","3","1","0","1","0","0","0","8","4","4","0","0","0","0","0","0","0","0","0","-2"
"131876","Trinity Washington University","2011","Total full-time Instruction/research/public service, Non-tenured on tenure track total","14","5","9","0","0","0","1","0","1","4","1","3","1","0","1","0","0","0","8","4","4","0","0","0","0","0","0","0","0","0","-2"
"131876","Trinity Washington University","2011","Total full-time Instruction/research/public servicey, Non-tenured not on tenure track, Assistant professors","22","6","16","0","0","0","0","0","0","10","4","6","0","0","0","0","0","0","12","2","10","0","0","0","0","0","0","0","0","0","-2"
"131876","Trinity Washington University","2011","Total full-time Instruction/research/public service, Non-tenured not on tenure track, Instructors","4","2","2","0","0","0","0","0","0","1","0","1","0","0","0","0","0","0","3","2","1","0","0","0","0","0","0","0","0","0","-2"
"131876","Trinity Washington University","2011","Total full-time Instruction/research/public service, Non-tenured not on tenure track total","26","8","18","0","0","0","0","0","0","11","4","7","0","0","0","0","0","0","15","4","11","0","0","0","0","0","0","0","0","0","-2"
"132471","Barry University","2011","Total full-time Instruction/research/public service, Tenured, Professors","10","6","4","0","0","0","0","0","0","2","2","0","0","0","0","0","0","0","8","4","4","0","0","0","0","0","0","0","0","0","-2"
"132471","Barry University","2011","Total full-time Instruction/research/public service, Tenured, Associate professors","5","4","1","0","0","0","0","0","0","0","0","0","0","0","0","0","0","0","5","4","1","0","0","0","0","0","0","0","0","0","-2"
"132471","Barry University","2011","Total full-time Instruction/research/public service, Tenured total","15","10","5","0","0","0","0","0","0","2","2","0","0","0","0","0","0","0","13","8","5","0","0","0","0","0","0","0","0","0","-2"
"132471","Barry University","2011","Total full-time Instruction/research/public service, Non-tenured on tenure track, Professors","1","0","1","0","0","0","0","0","0","1","0","1","0","0","0","0","0","0","0","0","0","0","0","0","0","0","0","0","0","0","-2"
"132471","Barry University","2011","Total full-time Instruction/research/public service, Non-tenured on tenure track, Assistant professors","2","2","0","0","0","0","0","0","0","0","0","0","0","0","0","0","0","0","2","2","0","0","0","0","0","0","0","0","0","0","-2"
"132471","Barry University","2011","Total full-time Instruction/research/public service, Non-tenured on tenure track total","3","2","1","0","0","0","0","0","0","1","0","1","0","0","0","0","0","0","2","2","0","0","0","0","0","0","0","0","0","0","-2"
"132471","Barry University","2011","Total full-time Instruction/research/public service, Non-tenured not on tenure track, Professors","68","41","27","1","1","0","5","3","2","2","0","2","7","6","1","0","0","0","52","30","22","0","0","0","1","1","0","0","0","0","-2"
"132471","Barry University","2011","Total full-time Instruction/research/public service, Non-tenured not on tenure track, Associate professors","96","43","53","0","0","0","5","3","2","8","3","5","21","7","14","0","0","0","58","28","30","0","0","0","4","2","2","0","0","0","-2"
"132471","Barry University","2011","Total full-time Instruction/research/public servicey, Non-tenured not on tenure track, Assistant professors","140","51","89","3","0","3","8","3","5","12","1","11","16","7","9","0","0","0","85","34","51","0","0","0","6","2","4","10","4","6","-2"
"132471","Barry University","2011","Total full-time Instruction/research/public service, Non-tenured not on tenure track, Instructors","46","12","34","0","0","0","1","0","1","6","0","6","15","7","8","0","0","0","19","4","15","0","0","0","3","1","2","2","0","2","-2"
"132471","Barry University","2011","Total full-time Instruction/research/public service, Non-tenured not on tenure track, Lecturers","2","1","1","0","0","0","0","0","0","0","0","0","0","0","0","0","0","0","2","1","1","0","0","0","0","0","0","0","0","0","-2"
"132471","Barry University","2011","Total full-time Instruction/research/public service, Non-tenured not on tenure track total","352","148","204","4","1","3","19","9","10","28","4","24","59","27","32","0","0","0","216","97","119","0","0","0","14","6","8","12","4","8","-2"
"132709","Broward College","2011","Total full-time Instruction/research/public service, Tenured, Professors","57","37","20","2","0","2","3","1","2","3","1","2","8","6","2","0","0","0","41","29","12","0","0","0","0","0","0","0","0","0","-2"
"132709","Broward College","2011","Total full-time Instruction/research/public service, Tenured, Associate professors","27","11","16","0","0","0","1","1","0","4","2","2","6","2","4","0","0","0","16","6","10","0","0","0","0","0","0","0","0","0","-2"
"132709","Broward College","2011","Total full-time Instruction/research/public service, Tenured, Assistant professors","168","77","91","2","0","2","6","5","1","29","9","20","30","16","14","0","0","0","99","47","52","0","0","0","2","0","2","0","0","0","-2"
"132709","Broward College","2011","Total full-time Instruction/research/public service, Tenured, Instructors","16","5","11","0","0","0","0","0","0","1","0","1","3","2","1","0","0","0","12","3","9","0","0","0","0","0","0","0","0","0","-2"
"132709","Broward College","2011","Total full-time Instruction/research/public service, Tenured, Lecturers","2","1","1","0","0","0","0","0","0","0","0","0","0","0","0","0","0","0","2","1","1","0","0","0","0","0","0","0","0","0","-2"
"132709","Broward College","2011","Total full-time Instruction/research/public service, Tenured total","270","131","139","4","0","4","10","7","3","37","12","25","47","26","21","0","0","0","170","86","84","0","0","0","2","0","2","0","0","0","-2"
"132709","Broward College","2011","Total full-time Instruction/research/public service, Non-tenured on tenure track, Assistant professors","70","34","36","1","0","1","3","3","0","13","6","7","16","7","9","0","0","0","30","14","16","0","0","0","7","4","3","0","0","0","-2"
"132709","Broward College","2011","Total full-time Instruction/research/public service, Non-tenured on tenure track, Instructors","5","4","1","0","0","0","0","0","0","1","1","0","0","0","0","0","0","0","3","2","1","0","0","0","1","1","0","0","0","0","-2"
"132709","Broward College","2011","Total full-time Instruction/research/public service, Non-tenured on tenure track total","75","38","37","1","0","1","3","3","0","14","7","7","16","7","9","0","0","0","33","16","17","0","0","0","8","5","3","0","0","0","-2"
"132709","Broward College","2011","Total full-time Instruction/research/public service, Non-tenured not on tenure track, Professors","1","1","0","0","0","0","0","0","0","0","0","0","0","0","0","0","0","0","1","1","0","0","0","0","0","0","0","0","0","0","-2"
"132709","Broward College","2011","Total full-time Instruction/research/public servicey, Non-tenured not on tenure track, Assistant professors","9","4","5","0","0","0","1","1","0","2","0","2","1","1","0","0","0","0","5","2","3","0","0","0","0","0","0","0","0","0","-2"
"132709","Broward College","2011","Total full-time Instruction/research/public service, Non-tenured not on tenure track, Instructors","4","2","2","0","0","0","0","0","0","0","0","0","0","0","0","0","0","0","4","2","2","0","0","0","0","0","0","0","0","0","-2"
"132709","Broward College","2011","Total full-time Instruction/research/public service, Non-tenured not on tenure track, Lecturers","27","11","16","1","0","1","2","0","2","4","1","3","4","0","4","0","0","0","15","10","5","0","0","0","1","0","1","0","0","0","-2"
"132709","Broward College","2011","Total full-time Instruction/research/public service, Non-tenured not on tenure track total","41","18","23","1","0","1","3","1","2","6","1","5","5","1","4","0","0","0","25","15","10","0","0","0","1","0","1","0","0","0","-2"
"132903","University of Central Florida","2011","Total full-time Instruction/research/public service, Tenured, Professors","244","194","50","1","0","1","46","40","6","4","3","1","9","9","0","0","0","0","184","142","42","0","0","0","0","0","0","0","0","0","-2"
"132903","University of Central Florida","2011","Total full-time Instruction/research/public service, Tenured, Associate professors","331","220","111","1","1","0","48","39","9","23","14","9","26","15","11","0","0","0","230","149","81","1","0","1","0","0","0","2","2","0","-2"
"132903","University of Central Florida","2011","Total full-time Instruction/research/public service, Tenured, Assistant professors","4","4","0","0","0","0","0","0","0","0","0","0","0","0","0","0","0","0","4","4","0","0","0","0","0","0","0","0","0","0","-2"
"132903","University of Central Florida","2011","Total full-time Instruction/research/public service, Tenured total","579","418","161","2","1","1","94","79","15","27","17","10","35","24","11","0","0","0","418","295","123","1","0","1","0","0","0","2","2","0","-2"
"132903","University of Central Florida","2011","Total full-time Instruction/research/public service, Non-tenured on tenure track, Professors","1","1","0","0","0","0","0","0","0","0","0","0","1","1","0","0","0","0","0","0","0","0","0","0","0","0","0","0","0","0","-2"
"132903","University of Central Florida","2011","Total full-time Instruction/research/public service, Non-tenured on tenure track, Associate professors","13","12","1","0","0","0","0","0","0","2","2","0","3","2","1","0","0","0","8","8","0","0","0","0","0","0","0","0","0","0","-2"
"132903","University of Central Florida","2011","Total full-time Instruction/research/public service, Non-tenured on tenure track, Assistant professors","192","111","81","1","1","0","27","20","7","10","6","4","11","5","6","0","0","0","111","58","53","0","0","0","0","0","0","32","21","11","-2"
"132903","University of Central Florida","2011","Total full-time Instruction/research/public service, Non-tenured on tenure track total","206","124","82","1","1","0","27","20","7","12","8","4","15","8","7","0","0","0","119","66","53","0","0","0","0","0","0","32","21","11","-2"
"132903","University of Central Florida","2011","Total full-time Instruction/research/public service, Non-tenured not on tenure track, Professors","11","9","2","0","0","0","1","1","0","0","0","0","1","0","1","0","0","0","9","8","1","0","0","0","0","0","0","0","0","0","-2"
"132903","University of Central Florida","2011","Total full-time Instruction/research/public service, Non-tenured not on tenure track, Associate professors","11","4","7","0","0","0","0","0","0","0","0","0","1","0","1","0","0","0","10","4","6","0","0","0","0","0","0","0","0","0","-2"
"132903","University of Central Florida","2011","Total full-time Instruction/research/public servicey, Non-tenured not on tenure track, Assistant professors","49","27","22","0","0","0","5","2","3","1","1","0","4","3","1","0","0","0","32","17","15","0","0","0","0","0","0","7","4","3","-2"
"132903","University of Central Florida","2011","Total full-time Instruction/research/public service, Non-tenured not on tenure track, Instructors","337","133","204","1","1","0","1","0","1","6","1","5","21","5","16","0","0","0","305","125","180","2","1","1","0","0","0","1","0","1","-2"
"132903","University of Central Florida","2011","Total full-time Instruction/research/public service, Non-tenured not on tenure track, Lecturers","72","52","20","0","0","0","4","3","1","6","4","2","4","4","0","0","0","0","54","37","17","1","1","0","0","0","0","3","3","0","-2"
"132903","University of Central Florida","2011","Total full-time Instruction/research/public service, Non-tenured not on tenure track, No academic rank","141","72","69","0","0","0","10","5","5","1","0","1","6","1","5","0","0","0","84","40","44","1","1","0","0","0","0","39","25","14","-2"
"132903","University of Central Florida","2011","Total full-time Instruction/research/public service, Non-tenured not on tenure track total","621","297","324","1","1","0","21","11","10","14","6","8","37","13","24","0","0","0","494","231","263","4","3","1","0","0","0","50","32","18","-2"
"133508","Florida SouthWestern State College","2011","Total full-time Instruction/research/public service, Tenured, No academic rank","79","37","42","0","0","0","2","1","1","3","1","2","2","2","0","0","0","0","71","32","39","0","0","0","1","1","0","0","0","0","-2"
"133508","Florida SouthWestern State College","2011","Total full-time Instruction/research/public service, Tenured total","79","37","42","0","0","0","2","1","1","3","1","2","2","2","0","0","0","0","71","32","39","0","0","0","1","1","0","0","0","0","-2"
"133508","Florida SouthWestern State College","2011","Total full-time Instruction/research/public service, Non-tenured on tenure track, No academic rank","70","21","49","1","0","1","0","0","0","3","1","2","2","0","2","0","0","0","59","18","41","0","0","0","0","0","0","5","2","3","-2"
"133508","Florida SouthWestern State College","2011","Total full-time Instruction/research/public service, Non-tenured on tenure track total","70","21","49","1","0","1","0","0","0","3","1","2","2","0","2","0","0","0","59","18","41","0","0","0","0","0","0","5","2","3","-2"
"133508","Florida SouthWestern State College","2011","Total full-time Instruction/research/public service, Non-tenured not on tenure track, No academic rank","12","7","5","0","0","0","0","0","0","0","0","0","1","1","0","0","0","0","11","6","5","0","0","0","0","0","0","0","0","0","-2"
"133508","Florida SouthWestern State College","2011","Total full-time Instruction/research/public service, Non-tenured not on tenure track total","12","7","5","0","0","0","0","0","0","0","0","0","1","1","0","0","0","0","11","6","5","0","0","0","0","0","0","0","0","0","-2"
"133669","Florida Atlantic University","2011","Total full-time Instruction/research/public service, Tenured, Professors","203","148","55","1","1","0","34","30","4","10","5","5","12","6","6","0","0","0","144","104","40","0","0","0","0","0","0","2","2","0","-2"
"133669","Florida Atlantic University","2011","Total full-time Instruction/research/public service, Tenured, Associate professors","228","136","92","0","0","0","32","23","9","17","6","11","16","6","10","0","0","0","158","96","62","0","0","0","0","0","0","5","5","0","-2"
"133669","Florida Atlantic University","2011","Total full-time Instruction/research/public service, Tenured total","431","284","147","1","1","0","66","53","13","27","11","16","28","12","16","0","0","0","302","200","102","0","0","0","0","0","0","7","7","0","-2"
"133669","Florida Atlantic University","2011","Total full-time Instruction/research/public service, Non-tenured on tenure track, Associate professors","9","4","5","0","0","0","1","0","1","1","0","1","0","0","0","0","0","0","6","3","3","0","0","0","0","0","0","1","1","0","-2"
"133669","Florida Atlantic University","2011","Total full-time Instruction/research/public service, Non-tenured on tenure track, Assistant professors","127","68","59","0","0","0","11","9","2","3","0","3","14","8","6","0","0","0","80","42","38","0","0","0","0","0","0","19","9","10","-2"
"133669","Florida Atlantic University","2011","Total full-time Instruction/research/public service, Non-tenured on tenure track total","136","72","64","0","0","0","12","9","3","4","0","4","14","8","6","0","0","0","86","45","41","0","0","0","0","0","0","20","10","10","-2"
"133669","Florida Atlantic University","2011","Total full-time Instruction/research/public service, Non-tenured not on tenure track, Associate professors","6","4","2","0","0","0","1","1","0","1","0","1","1","0","1","0","0","0","3","3","0","0","0","0","0","0","0","0","0","0","-2"
"133669","Florida Atlantic University","2011","Total full-time Instruction/research/public servicey, Non-tenured not on tenure track, Assistant professors","28","9","19","0","0","0","2","1","1","2","0","2","7","4","3","0","0","0","14","3","11","1","0","1","0","0","0","2","1","1","-2"
"133669","Florida Atlantic University","2011","Total full-time Instruction/research/public service, Non-tenured not on tenure track, Instructors","188","79","109","0","0","0","6","1","5","9","6","3","20","5","15","0","0","0","146","64","82","0","0","0","0","0","0","7","3","4","-2"
"133669","Florida Atlantic University","2011","Total full-time Instruction/research/public service, Non-tenured not on tenure track, Lecturers","1","0","1","0","0","0","0","0","0","0","0","0","0","0","0","0","0","0","1","0","1","0","0","0","0","0","0","0","0","0","-2"
"133669","Florida Atlantic University","2011","Total full-time Instruction/research/public service, Non-tenured not on tenure track, No academic rank","60","28","32","0","0","0","4","2","2","1","1","0","4","0","4","0","0","0","40","19","21","0","0","0","0","0","0","11","6","5","-2"
"133669","Florida Atlantic University","2011","Total full-time Instruction/research/public service, Non-tenured not on tenure track total","283","120","163","0","0","0","13","5","8","13","7","6","32","9","23","0","0","0","204","89","115","1","0","1","0","0","0","20","10","10","-2"
"133872","AdventHealth University","2011","Total full-time Instruction/research/public service, Non-tenured not on tenure track, Professors","12","4","8","0","0","0","0","0","0","4","0","4","0","0","0","0","0","0","8","4","4","0","0","0","0","0","0","0","0","0","-2"
"133872","AdventHealth University","2011","Total full-time Instruction/research/public service, Non-tenured not on tenure track, Associate professors","16","4","12","0","0","0","0","0","0","2","1","1","1","0","1","0","0","0","13","3","10","0","0","0","0","0","0","0","0","0","-2"
"133872","AdventHealth University","2011","Total full-time Instruction/research/public servicey, Non-tenured not on tenure track, Assistant professors","21","6","15","0","0","0","2","0","2","3","0","3","2","1","1","0","0","0","14","5","9","0","0","0","0","0","0","0","0","0","-2"
"133872","AdventHealth University","2011","Total full-time Instruction/research/public service, Non-tenured not on tenure track, Instructors","11","0","11","0","0","0","1","0","1","1","0","1","0","0","0","0","0","0","8","0","8","1","0","1","0","0","0","0","0","0","-2"
"133872","AdventHealth University","2011","Total full-time Instruction/research/public service, Non-tenured not on tenure track total","60","14","46","0","0","0","3","0","3","10","1","9","3","1","2","0","0","0","43","12","31","1","0","1","0","0","0","0","0","0","-2"
"133960","The College of the Florida Keys","2011","Total full-time Instruction/research/public service, Tenured, Professors","4","3","1","1","1","0","0","0","0","0","0","0","0","0","0","0","0","0","2","2","0","0","0","0","1","0","1","0","0","0","-2"
"133960","The College of the Florida Keys","2011","Total full-time Instruction/research/public service, Tenured, Associate professors","2","0","2","0","0","0","0","0","0","0","0","0","0","0","0","0","0","0","2","0","2","0","0","0","0","0","0","0","0","0","-2"
"133960","The College of the Florida Keys","2011","Total full-time Instruction/research/public service, Tenured, Assistant professors","1","0","1","0","0","0","0","0","0","0","0","0","1","0","1","0","0","0","0","0","0","0","0","0","0","0","0","0","0","0","-2"
"133960","The College of the Florida Keys","2011","Total full-time Instruction/research/public service, Tenured total","7","3","4","1","1","0","0","0","0","0","0","0","1","0","1","0","0","0","4","2","2","0","0","0","1","0","1","0","0","0","-2"
"133960","The College of the Florida Keys","2011","Total full-time Instruction/research/public service, Non-tenured on tenure track, Professors","2","2","0","0","0","0","0","0","0","0","0","0","0","0","0","0","0","0","2","2","0","0","0","0","0","0","0","0","0","0","-2"
"133960","The College of the Florida Keys","2011","Total full-time Instruction/research/public service, Non-tenured on tenure track, Associate professors","4","2","2","0","0","0","0","0","0","0","0","0","0","0","0","0","0","0","3","2","1","1","0","1","0","0","0","0","0","0","-2"
"133960","The College of the Florida Keys","2011","Total full-time Instruction/research/public service, Non-tenured on tenure track, Assistant professors","5","0","5","0","0","0","0","0","0","1","0","1","0","0","0","0","0","0","4","0","4","0","0","0","0","0","0","0","0","0","-2"
"133960","The College of the Florida Keys","2011","Total full-time Instruction/research/public service, Non-tenured on tenure track, Instructors","2","1","1","0","0","0","0","0","0","0","0","0","0","0","0","0","0","0","2","1","1","0","0","0","0","0","0","0","0","0","-2"
"133960","The College of the Florida Keys","2011","Total full-time Instruction/research/public service, Non-tenured on tenure track total","13","5","8","0","0","0","0","0","0","1","0","1","0","0","0","0","0","0","11","5","6","1","0","1","0","0","0","0","0","0","-2"
"133960","The College of the Florida Keys","2011","Total full-time Instruction/research/public service, Non-tenured not on tenure track, Instructors","1","0","1","0","0","0","0","0","0","0","0","0","0","0","0","0","0","0","0","0","0","0","0","0","1","0","1","0","0","0","-2"
"133960","The College of the Florida Keys","2011","Total full-time Instruction/research/public service, Non-tenured not on tenure track, No academic rank","6","3","3","0","0","0","0","0","0","0","0","0","0","0","0","0","0","0","5","3","2","1","0","1","0","0","0","0","0","0","-2"
"133960","The College of the Florida Keys","2011","Total full-time Instruction/research/public service, Non-tenured not on tenure track total","7","3","4","0","0","0","0","0","0","0","0","0","0","0","0","0","0","0","5","3","2","1","0","1","1","0","1","0","0","0","-2"
"134608","Indian River State College","2011","Total full-time Instruction/research/public service, Tenured, Professors","13","9","4","0","0","0","0","0","0","1","1","0","0","0","0","0","0","0","11","7","4","1","1","0","0","0","0","0","0","0","-2"
"134608","Indian River State College","2011","Total full-time Instruction/research/public service, Tenured, Associate professors","16","10","6","0","0","0","0","0","0","1","1","0","0","0","0","0","0","0","15","9","6","0","0","0","0","0","0","0","0","0","-2"
"134608","Indian River State College","2011","Total full-time Instruction/research/public service, Tenured, Assistant professors","56","25","31","1","0","1","3","1","2","7","2","5","2","2","0","0","0","0","42","19","23","0","0","0","0","0","0","1","1","0","-2"
"134608","Indian River State College","2011","Total full-time Instruction/research/public service, Tenured, Instructors","62","23","39","1","0","1","4","2","2","6","3","3","8","1","7","0","0","0","42","16","26","1","1","0","0","0","0","0","0","0","-2"
"134608","Indian River State College","2011","Total full-time Instruction/research/public service, Tenured, No academic rank","7","2","5","0","0","0","0","0","0","0","0","0","0","0","0","0","0","0","7","2","5","0","0","0","0","0","0","0","0","0","-2"
"134608","Indian River State College","2011","Total full-time Instruction/research/public service, Tenured total","154","69","85","2","0","2","7","3","4","15","7","8","10","3","7","0","0","0","117","53","64","2","2","0","0","0","0","1","1","0","-2"
"134608","Indian River State College","2011","Total full-time Instruction/research/public service, Non-tenured on tenure track, Assistant professors","33","18","15","0","0","0","0","0","0","3","2","1","1","0","1","1","0","1","27","15","12","0","0","0","0","0","0","1","1","0","-2"
"134608","Indian River State College","2011","Total full-time Instruction/research/public service, Non-tenured on tenure track, Instructors","9","1","8","0","0","0","0","0","0","0","0","0","0","0","0","0","0","0","9","1","8","0","0","0","0","0","0","0","0","0","-2"
"134608","Indian River State College","2011","Total full-time Instruction/research/public service, Non-tenured on tenure track, No academic rank","1","0","1","0","0","0","0","0","0","1","0","1","0","0","0","0","0","0","0","0","0","0","0","0","0","0","0","0","0","0","-2"
"134608","Indian River State College","2011","Total full-time Instruction/research/public service, Non-tenured on tenure track total","43","19","24","0","0","0","0","0","0","4","2","2","1","0","1","1","0","1","36","16","20","0","0","0","0","0","0","1","1","0","-2"
"135081","Keiser University-Ft Lauderdale","2011","Total full-time Instruction/research/public service, Non-tenured not on tenure track, Instructors","795","322","473","2","0","2","25","14","11","111","36","75","101","44","57","1","0","1","543","225","318","12","3","9","0","0","0","0","0","0","-2"
"135081","Keiser University-Ft Lauderdale","2011","Total full-time Instruction/research/public service, Non-tenured not on tenure track total","795","322","473","2","0","2","25","14","11","111","36","75","101","44","57","1","0","1","543","225","318","12","3","9","0","0","0","0","0","0","-2"
"135610","Trinity International University-Florida","2011","Total full-time Instruction/research/public service, Tenured, Associate professors","1","0","1","0","0","0","0","0","0","0","0","0","1","0","1","0","0","0","0","0","0","0","0","0","0","0","0","0","0","0","-2"
"135610","Trinity International University-Florida","2011","Total full-time Instruction/research/public service, Tenured, Assistant professors","1","0","1","0","0","0","0","0","0","0","0","0","0","0","0","0","0","0","1","0","1","0","0","0","0","0","0","0","0","0","-2"
"135610","Trinity International University-Florida","2011","Total full-time Instruction/research/public service, Tenured total","2","0","2","0","0","0","0","0","0","0","0","0","1","0","1","0","0","0","1","0","1","0","0","0","0","0","0","0","0","0","-2"
"135610","Trinity International University-Florida","2011","Total full-time Instruction/research/public servicey, Non-tenured not on tenure track, Assistant professors","1","0","1","0","0","0","0","0","0","0","0","0","0","0","0","0","0","0","1","0","1","0","0","0","0","0","0","0","0","0","-2"
"135610","Trinity International University-Florida","2011","Total full-time Instruction/research/public service, Non-tenured not on tenure track total","1","0","1","0","0","0","0","0","0","0","0","0","0","0","0","0","0","0","1","0","1","0","0","0","0","0","0","0","0","0","-2"
"135717","Miami Dade College","2011","Total full-time Instruction/research/public service, Tenured, Professors","167","80","87","1","1","0","5","1","4","20","7","13","54","23","31","0","0","0","84","46","38","3","2","1","0","0","0","0","0","0","-2"
"135717","Miami Dade College","2011","Total full-time Instruction/research/public service, Tenured, Associate professors","263","124","139","0","0","0","14","7","7","39","15","24","127","60","67","0","0","0","82","42","40","1","0","1","0","0","0","0","0","0","-2"
"135717","Miami Dade College","2011","Total full-time Instruction/research/public service, Tenured, Assistant professors","131","58","73","1","0","1","11","4","7","19","6","13","53","29","24","0","0","0","45","19","26","2","0","2","0","0","0","0","0","0","-2"
"135717","Miami Dade College","2011","Total full-time Instruction/research/public service, Tenured, Instructors","13","11","2","0","0","0","0","0","0","3","2","1","6","5","1","0","0","0","4","4","0","0","0","0","0","0","0","0","0","0","-2"
"135717","Miami Dade College","2011","Total full-time Instruction/research/public service, Tenured total","574","273","301","2","1","1","30","12","18","81","30","51","240","117","123","0","0","0","215","111","104","6","2","4","0","0","0","0","0","0","-2"
"135717","Miami Dade College","2011","Total full-time Instruction/research/public service, Non-tenured on tenure track, Assistant professors","25","11","14","0","0","0","1","0","1","2","0","2","14","6","8","0","0","0","8","5","3","0","0","0","0","0","0","0","0","0","-2"
"135717","Miami Dade College","2011","Total full-time Instruction/research/public service, Non-tenured on tenure track, Instructors","74","33","41","1","0","1","1","0","1","18","7","11","29","13","16","0","0","0","24","13","11","1","0","1","0","0","0","0","0","0","-2"
"135717","Miami Dade College","2011","Total full-time Instruction/research/public service, Non-tenured on tenure track total","99","44","55","1","0","1","2","0","2","20","7","13","43","19","24","0","0","0","32","18","14","1","0","1","0","0","0","0","0","0","-2"
"136215","Nova Southeastern University","2011","Total full-time Instruction/research/public service, Tenured, Professors","28","18","10","0","0","0","0","0","0","1","0","1","1","0","1","0","0","0","26","18","8","0","0","0","0","0","0","0","0","0","-2"
"136215","Nova Southeastern University","2011","Total full-time Instruction/research/public service, Tenured total","28","18","10","0","0","0","0","0","0","1","0","1","1","0","1","0","0","0","26","18","8","0","0","0","0","0","0","0","0","0","-2"
"136215","Nova Southeastern University","2011","Total full-time Instruction/research/public service, Non-tenured on tenure track, Associate professors","2","2","0","0","0","0","1","1","0","1","1","0","0","0","0","0","0","0","0","0","0","0","0","0","0","0","0","0","0","0","-2"
"136215","Nova Southeastern University","2011","Total full-time Instruction/research/public service, Non-tenured on tenure track total","2","2","0","0","0","0","1","1","0","1","1","0","0","0","0","0","0","0","0","0","0","0","0","0","0","0","0","0","0","0","-2"
"136215","Nova Southeastern University","2011","Total full-time Instruction/research/public service, Non-tenured not on tenure track, Professors","143","89","54","0","0","0","15","11","4","4","2","2","8","4","4","0","0","0","115","71","44","0","0","0","1","1","0","0","0","0","-2"
"136215","Nova Southeastern University","2011","Total full-time Instruction/research/public service, Non-tenured not on tenure track, Associate professors","275","151","124","0","0","0","18","13","5","21","6","15","36","14","22","0","0","0","194","112","82","0","0","0","0","0","0","6","6","0","-2"
"136215","Nova Southeastern University","2011","Total full-time Instruction/research/public servicey, Non-tenured not on tenure track, Assistant professors","328","145","183","3","1","2","25","15","10","28","8","20","48","17","31","0","0","0","215","98","117","0","0","0","0","0","0","9","6","3","-2"
"136215","Nova Southeastern University","2011","Total full-time Instruction/research/public service, Non-tenured not on tenure track, Instructors","34","11","23","0","0","0","2","2","0","2","0","2","10","5","5","0","0","0","17","4","13","0","0","0","2","0","2","1","0","1","-2"
"136215","Nova Southeastern University","2011","Total full-time Instruction/research/public service, Non-tenured not on tenure track, Lecturers","5","4","1","0","0","0","0","0","0","0","0","0","1","0","1","0","0","0","4","4","0","0","0","0","0","0","0","0","0","0","-2"
"136215","Nova Southeastern University","2011","Total full-time Instruction/research/public service, Non-tenured not on tenure track total","785","400","385","3","1","2","60","41","19","55","16","39","103","40","63","0","0","0","545","289","256","0","0","0","3","1","2","16","12","4","-2"
"136358","Palm Beach State College","2011","Total full-time Instruction/research/public service, Tenured, Professors","24","18","6","0","0","0","2","2","0","2","2","0","2","1","1","0","0","0","14","9","5","0","0","0","4","4","0","0","0","0","-2"
"136358","Palm Beach State College","2011","Total full-time Instruction/research/public service, Tenured, Associate professors","15","8","7","0","0","0","1","1","0","4","2","2","2","1","1","0","0","0","7","3","4","1","1","0","0","0","0","0","0","0","-2"
"136358","Palm Beach State College","2011","Total full-time Instruction/research/public service, Tenured, Assistant professors","25","7","18","0","0","0","0","0","0","4","1","3","2","0","2","0","0","0","19","6","13","0","0","0","0","0","0","0","0","0","-2"
"136358","Palm Beach State College","2011","Total full-time Instruction/research/public service, Tenured, Instructors","150","55","95","0","0","0","3","2","1","17","8","9","16","3","13","0","0","0","105","39","66","0","0","0","9","3","6","0","0","0","-2"
"136358","Palm Beach State College","2011","Total full-time Instruction/research/public service, Tenured total","214","88","126","0","0","0","6","5","1","27","13","14","22","5","17","0","0","0","145","57","88","1","1","0","13","7","6","0","0","0","-2"
"136358","Palm Beach State College","2011","Total full-time Instruction/research/public service, Non-tenured on tenure track, Professors","4","4","0","0","0","0","1","1","0","0","0","0","1","1","0","0","0","0","2","2","0","0","0","0","0","0","0","0","0","0","-2"
"136358","Palm Beach State College","2011","Total full-time Instruction/research/public service, Non-tenured on tenure track, Associate professors","6","4","2","0","0","0","1","1","0","0","0","0","0","0","0","0","0","0","5","3","2","0","0","0","0","0","0","0","0","0","-2"
"136358","Palm Beach State College","2011","Total full-time Instruction/research/public service, Non-tenured on tenure track, Assistant professors","11","5","6","0","0","0","1","1","0","3","1","2","0","0","0","0","0","0","7","3","4","0","0","0","0","0","0","0","0","0","-2"
"136358","Palm Beach State College","2011","Total full-time Instruction/research/public service, Non-tenured on tenure track, Instructors","30","16","14","1","0","1","2","2","0","5","3","2","3","1","2","0","0","0","19","10","9","0","0","0","0","0","0","0","0","0","-2"
"136358","Palm Beach State College","2011","Total full-time Instruction/research/public service, Non-tenured on tenure track, No academic rank","3","1","2","0","0","0","0","0","0","0","0","0","0","0","0","0","0","0","3","1","2","0","0","0","0","0","0","0","0","0","-2"
"136358","Palm Beach State College","2011","Total full-time Instruction/research/public service, Non-tenured on tenure track total","54","30","24","1","0","1","5","5","0","8","4","4","4","2","2","0","0","0","36","19","17","0","0","0","0","0","0","0","0","0","-2"
"136358","Palm Beach State College","2011","Total full-time Instruction/research/public service, Non-tenured not on tenure track, No academic rank","23","8","15","0","0","0","0","0","0","2","0","2","3","1","2","0","0","0","16","6","10","1","1","0","1","0","1","0","0","0","-2"
"136358","Palm Beach State College","2011","Total full-time Instruction/research/public service, Non-tenured not on tenure track total","23","8","15","0","0","0","0","0","0","2","0","2","3","1","2","0","0","0","16","6","10","1","1","0","1","0","1","0","0","0","-2"
"136516","Polk State College","2011","Total full-time Instruction/research/public service, Tenured, No academic rank","88","37","51","2","1","1","0","0","0","5","2","3","4","1","3","0","0","0","74","31","43","0","0","0","1","0","1","2","2","0","-2"
"136516","Polk State College","2011","Total full-time Instruction/research/public service, Tenured total","88","37","51","2","1","1","0","0","0","5","2","3","4","1","3","0","0","0","74","31","43","0","0","0","1","0","1","2","2","0","-2"
"136516","Polk State College","2011","Total full-time Instruction/research/public service, Non-tenured on tenure track, No academic rank","33","12","21","0","0","0","1","1","0","4","1","3","1","1","0","0","0","0","25","9","16","1","0","1","0","0","0","1","0","1","-2"
"136516","Polk State College","2011","Total full-time Instruction/research/public service, Non-tenured on tenure track total","33","12","21","0","0","0","1","1","0","4","1","3","1","1","0","0","0","0","25","9","16","1","0","1","0","0","0","1","0","1","-2"
"136516","Polk State College","2011","Total full-time Instruction/research/public service, Non-tenured not on tenure track, No academic rank","3","1","2","0","0","0","0","0","0","0","0","0","1","1","0","0","0","0","2","0","2","0","0","0","0","0","0","0","0","0","-2"
"136516","Polk State College","2011","Total full-time Instruction/research/public service, Non-tenured not on tenure track total","3","1","2","0","0","0","0","0","0","0","0","0","1","1","0","0","0","0","2","0","2","0","0","0","0","0","0","0","0","0","-2"
"137209","Seminole State College of Florida","2011","Total full-time Instruction/research/public service, Tenured, No academic rank","148","50","98","0","0","0","4","2","2","10","3","7","9","3","6","1","1","0","123","40","83","1","1","0","0","0","0","0","0","0","-2"
"137209","Seminole State College of Florida","2011","Total full-time Instruction/research/public service, Tenured total","148","50","98","0","0","0","4","2","2","10","3","7","9","3","6","1","1","0","123","40","83","1","1","0","0","0","0","0","0","0","-2"
"137209","Seminole State College of Florida","2011","Total full-time Instruction/research/public service, Non-tenured on tenure track, No academic rank","48","24","24","0","0","0","1","1","0","5","2","3","5","4","1","0","0","0","36","17","19","1","0","1","0","0","0","0","0","0","-2"
"137209","Seminole State College of Florida","2011","Total full-time Instruction/research/public service, Non-tenured on tenure track total","48","24","24","0","0","0","1","1","0","5","2","3","5","4","1","0","0","0","36","17","19","1","0","1","0","0","0","0","0","0","-2"
"137209","Seminole State College of Florida","2011","Total full-time Instruction/research/public service, Non-tenured not on tenure track, No academic rank","3","3","0","0","0","0","0","0","0","0","0","0","0","0","0","0","0","0","3","3","0","0","0","0","0","0","0","0","0","0","-2"
"137209","Seminole State College of Florida","2011","Total full-time Instruction/research/public service, Non-tenured not on tenure track total","3","3","0","0","0","0","0","0","0","0","0","0","0","0","0","0","0","0","3","3","0","0","0","0","0","0","0","0","0","0","-2"
"137315","South Florida State College","2011","Total full-time Instruction/research/public service, Tenured, Instructors","50","26","24","0","0","0","1","0","1","1","0","1","1","1","0","0","0","0","47","25","22","0","0","0","0","0","0","0","0","0","-2"
"137315","South Florida State College","2011","Total full-time Instruction/research/public service, Tenured total","50","26","24","0","0","0","1","0","1","1","0","1","1","1","0","0","0","0","47","25","22","0","0","0","0","0","0","0","0","0","-2"
"137315","South Florida State College","2011","Total full-time Instruction/research/public service, Non-tenured on tenure track, Instructors","12","2","10","0","0","0","0","0","0","0","0","0","0","0","0","0","0","0","12","2","10","0","0","0","0","0","0","0","0","0","-2"
"137315","South Florida State College","2011","Total full-time Instruction/research/public service, Non-tenured on tenure track total","12","2","10","0","0","0","0","0","0","0","0","0","0","0","0","0","0","0","12","2","10","0","0","0","0","0","0","0","0","0","-2"
"137476","St. Thomas University","2011","Total full-time Instruction/research/public service, Tenured, Professors","18","11","7","0","0","0","0","0","0","2","1","1","1","1","0","0","0","0","15","9","6","0","0","0","0","0","0","0","0","0","-2"
"137476","St. Thomas University","2011","Total full-time Instruction/research/public service, Tenured, Associate professors","1","1","0","0","0","0","0","0","0","0","0","0","0","0","0","0","0","0","1","1","0","0","0","0","0","0","0","0","0","0","-2"
"137476","St. Thomas University","2011","Total full-time Instruction/research/public service, Tenured total","19","12","7","0","0","0","0","0","0","2","1","1","1","1","0","0","0","0","16","10","6","0","0","0","0","0","0","0","0","0","-2"
"137476","St. Thomas University","2011","Total full-time Instruction/research/public service, Non-tenured on tenure track, Professors","1","1","0","0","0","0","1","1","0","0","0","0","0","0","0","0","0","0","0","0","0","0","0","0","0","0","0","0","0","0","-2"
"137476","St. Thomas University","2011","Total full-time Instruction/research/public service, Non-tenured on tenure track, Associate professors","2","0","2","0","0","0","0","0","0","0","0","0","0","0","0","0","0","0","2","0","2","0","0","0","0","0","0","0","0","0","-2"
"137476","St. Thomas University","2011","Total full-time Instruction/research/public service, Non-tenured on tenure track total","3","1","2","0","0","0","1","1","0","0","0","0","0","0","0","0","0","0","2","0","2","0","0","0","0","0","0","0","0","0","-2"
"137476","St. Thomas University","2011","Total full-time Instruction/research/public service, Non-tenured not on tenure track, Professors","26","16","10","0","0","0","1","1","0","0","0","0","5","3","2","0","0","0","20","12","8","0","0","0","0","0","0","0","0","0","-2"
"137476","St. Thomas University","2011","Total full-time Instruction/research/public service, Non-tenured not on tenure track, Associate professors","26","16","10","0","0","0","1","0","1","3","1","2","5","4","1","0","0","0","17","11","6","0","0","0","0","0","0","0","0","0","-2"
"137476","St. Thomas University","2011","Total full-time Instruction/research/public servicey, Non-tenured not on tenure track, Assistant professors","22","8","14","0","0","0","1","1","0","4","1","3","6","1","5","0","0","0","10","5","5","0","0","0","0","0","0","1","0","1","-2"
"137476","St. Thomas University","2011","Total full-time Instruction/research/public service, Non-tenured not on tenure track, Instructors","5","2","3","0","0","0","0","0","0","0","0","0","2","0","2","0","0","0","3","2","1","0","0","0","0","0","0","0","0","0","-2"
"137476","St. Thomas University","2011","Total full-time Instruction/research/public service, Non-tenured not on tenure track, Lecturers","1","1","0","0","0","0","0","0","0","0","0","0","1","1","0","0","0","0","0","0","0","0","0","0","0","0","0","0","0","0","-2"
"137476","St. Thomas University","2011","Total full-time Instruction/research/public service, Non-tenured not on tenure track, No academic rank","3","1","2","0","0","0","0","0","0","0","0","0","1","0","1","0","0","0","2","1","1","0","0","0","0","0","0","0","0","0","-2"
"137476","St. Thomas University","2011","Total full-time Instruction/research/public service, Non-tenured not on tenure track total","83","44","39","0","0","0","3","2","1","7","2","5","20","9","11","0","0","0","52","31","21","0","0","0","0","0","0","1","0","1","-2"
"138187","Valencia College","2011","Total full-time Instruction/research/public service, Tenured, No academic rank","280","120","160","3","1","2","10","5","5","19","9","10","24","7","17","0","0","0","221","96","125","0","0","0","3","2","1","0","0","0","-2"
"138187","Valencia College","2011","Total full-time Instruction/research/public service, Tenured total","280","120","160","3","1","2","10","5","5","19","9","10","24","7","17","0","0","0","221","96","125","0","0","0","3","2","1","0","0","0","-2"
"138187","Valencia College","2011","Total full-time Instruction/research/public service, Non-tenured on tenure track, No academic rank","105","37","68","0","0","0","6","2","4","14","8","6","12","4","8","0","0","0","69","22","47","0","0","0","4","1","3","0","0","0","-2"
"138187","Valencia College","2011","Total full-time Instruction/research/public service, Non-tenured on tenure track total","105","37","68","0","0","0","6","2","4","14","8","6","12","4","8","0","0","0","69","22","47","0","0","0","4","1","3","0","0","0","-2"
"138187","Valencia College","2011","Total full-time Instruction/research/public service, Non-tenured not on tenure track, No academic rank","23","10","13","0","0","0","0","0","0","2","1","1","3","0","3","0","0","0","17","9","8","0","0","0","0","0","0","1","0","1","-2"
"138187","Valencia College","2011","Total full-time Instruction/research/public service, Non-tenured not on tenure track total","23","10","13","0","0","0","0","0","0","2","1","1","3","0","3","0","0","0","17","9","8","0","0","0","0","0","0","1","0","1","-2"
"139463","Dalton State College","2011","Total full-time Instruction/research/public service, Tenured, Professors","15","11","4","0","0","0","1","1","0","0","0","0","0","0","0","0","0","0","14","10","4","0","0","0","0","0","0","0","0","0","-2"
"139463","Dalton State College","2011","Total full-time Instruction/research/public service, Tenured, Associate professors","43","18","25","0","0","0","1","1","0","1","0","1","0","0","0","0","0","0","41","17","24","0","0","0","0","0","0","0","0","0","-2"
"139463","Dalton State College","2011","Total full-time Instruction/research/public service, Tenured, Assistant professors","4","1","3","0","0","0","0","0","0","1","0","1","0","0","0","0","0","0","3","1","2","0","0","0","0","0","0","0","0","0","-2"
"139463","Dalton State College","2011","Total full-time Instruction/research/public service, Tenured total","62","30","32","0","0","0","2","2","0","2","0","2","0","0","0","0","0","0","58","28","30","0","0","0","0","0","0","0","0","0","-2"
"139463","Dalton State College","2011","Total full-time Instruction/research/public service, Non-tenured on tenure track, Associate professors","12","9","3","0","0","0","0","0","0","1","1","0","0","0","0","0","0","0","10","7","3","0","0","0","1","1","0","0","0","0","-2"
"139463","Dalton State College","2011","Total full-time Instruction/research/public service, Non-tenured on tenure track, Assistant professors","51","24","27","0","0","0","3","2","1","2","1","1","0","0","0","0","0","0","45","20","25","0","0","0","1","1","0","0","0","0","-2"
"139463","Dalton State College","2011","Total full-time Instruction/research/public service, Non-tenured on tenure track, Instructors","14","3","11","0","0","0","0","0","0","0","0","0","0","0","0","0","0","0","14","3","11","0","0","0","0","0","0","0","0","0","-2"
"139463","Dalton State College","2011","Total full-time Instruction/research/public service, Non-tenured on tenure track total","77","36","41","0","0","0","3","2","1","3","2","1","0","0","0","0","0","0","69","30","39","0","0","0","2","2","0","0","0","0","-2"
"139463","Dalton State College","2011","Total full-time Instruction/research/public servicey, Non-tenured not on tenure track, Assistant professors","1","0","1","0","0","0","0","0","0","0","0","0","0","0","0","0","0","0","1","0","1","0","0","0","0","0","0","0","0","0","-2"
"139463","Dalton State College","2011","Total full-time Instruction/research/public service, Non-tenured not on tenure track, Instructors","1","1","0","0","0","0","0","0","0","0","0","0","0","0","0","0","0","0","1","1","0","0","0","0","0","0","0","0","0","0","-2"
"139463","Dalton State College","2011","Total full-time Instruction/research/public service, Non-tenured not on tenure track, Lecturers","9","4","5","0","0","0","0","0","0","2","0","2","0","0","0","0","0","0","7","4","3","0","0","0","0","0","0","0","0","0","-2"
"139463","Dalton State College","2011","Total full-time Instruction/research/public service, Non-tenured not on tenure track total","11","5","6","0","0","0","0","0","0","2","0","2","0","0","0","0","0","0","9","5","4","0","0","0","0","0","0","0","0","0","-2"
"142887","American Academy of Art","2011","Total full-time Instruction/research/public service, Non-tenured not on tenure track, Instructors","31","16","15","0","0","0","1","1","0","2","0","2","0","0","0","0","0","0","27","15","12","1","0","1","0","0","0","0","0","0","-2"
"142887","American Academy of Art","2011","Total full-time Instruction/research/public service, Non-tenured not on tenure track total","31","16","15","0","0","0","1","1","0","2","0","2","0","0","0","0","0","0","27","15","12","1","0","1","0","0","0","0","0","0","-2"
"143118","Aurora University","2011","Total full-time Instruction/research/public service, Tenured, Professors","17","10","7","0","0","0","1","0","1","1","1","0","0","0","0","0","0","0","15","9","6","0","0","0","0","0","0","0","0","0","-2"
"143118","Aurora University","2011","Total full-time Instruction/research/public service, Tenured, Associate professors","24","12","12","0","0","0","0","0","0","0","0","0","1","0","1","0","0","0","23","12","11","0","0","0","0","0","0","0","0","0","-2"
"143118","Aurora University","2011","Total full-time Instruction/research/public service, Tenured, Assistant professors","1","1","0","0","0","0","0","0","0","0","0","0","0","0","0","0","0","0","1","1","0","0","0","0","0","0","0","0","0","0","-2"
"143118","Aurora University","2011","Total full-time Instruction/research/public service, Tenured total","42","23","19","0","0","0","1","0","1","1","1","0","1","0","1","0","0","0","39","22","17","0","0","0","0","0","0","0","0","0","-2"
"143118","Aurora University","2011","Total full-time Instruction/research/public service, Non-tenured on tenure track, Associate professors","6","4","2","0","0","0","0","0","0","0","0","0","0","0","0","0","0","0","6","4","2","0","0","0","0","0","0","0","0","0","-2"
"143118","Aurora University","2011","Total full-time Instruction/research/public service, Non-tenured on tenure track, Assistant professors","41","20","21","1","1","0","0","0","0","0","0","0","4","2","2","0","0","0","35","17","18","0","0","0","0","0","0","1","0","1","-2"
"143118","Aurora University","2011","Total full-time Instruction/research/public service, Non-tenured on tenure track, Instructors","2","0","2","0","0","0","0","0","0","0","0","0","0","0","0","0","0","0","2","0","2","0","0","0","0","0","0","0","0","0","-2"
"143118","Aurora University","2011","Total full-time Instruction/research/public service, Non-tenured on tenure track total","49","24","25","1","1","0","0","0","0","0","0","0","4","2","2","0","0","0","43","21","22","0","0","0","0","0","0","1","0","1","-2"
"143118","Aurora University","2011","Total full-time Instruction/research/public service, Non-tenured not on tenure track, Associate professors","7","3","4","0","0","0","0","0","0","0","0","0","0","0","0","0","0","0","6","3","3","0","0","0","1","0","1","0","0","0","-2"
"143118","Aurora University","2011","Total full-time Instruction/research/public servicey, Non-tenured not on tenure track, Assistant professors","17","7","10","0","0","0","1","0","1","0","0","0","1","1","0","0","0","0","15","6","9","0","0","0","0","0","0","0","0","0","-2"
"143118","Aurora University","2011","Total full-time Instruction/research/public service, Non-tenured not on tenure track, Instructors","3","2","1","0","0","0","0","0","0","0","0","0","0","0","0","0","0","0","3","2","1","0","0","0","0","0","0","0","0","0","-2"
"143118","Aurora University","2011","Total full-time Instruction/research/public service, Non-tenured not on tenure track total","27","12","15","0","0","0","1","0","1","0","0","0","1","1","0","0","0","0","24","11","13","0","0","0","1","0","1","0","0","0","-2"
"143978","The Chicago School of Professional Psychology at Chicago","2011","Total full-time Instruction/research/public service, Non-tenured not on tenure track, Professors","8","5","3","1","0","1","0","0","0","0","0","0","0","0","0","0","0","0","5","3","2","0","0","0","2","2","0","0","0","0","-2"
"143978","The Chicago School of Professional Psychology at Chicago","2011","Total full-time Instruction/research/public service, Non-tenured not on tenure track, Associate professors","26","17","9","1","1","0","0","0","0","3","1","2","0","0","0","0","0","0","18","13","5","0","0","0","4","2","2","0","0","0","-2"
"143978","The Chicago School of Professional Psychology at Chicago","2011","Total full-time Instruction/research/public servicey, Non-tenured not on tenure track, Assistant professors","32","12","20","0","0","0","2","1","1","5","3","2","6","3","3","0","0","0","19","5","14","0","0","0","0","0","0","0","0","0","-2"
"143978","The Chicago School of Professional Psychology at Chicago","2011","Total full-time Instruction/research/public service, Non-tenured not on tenure track total","66","34","32","2","1","1","2","1","1","8","4","4","6","3","3","0","0","0","42","21","21","0","0","0","6","4","2","0","0","0","-2"
"144351","Concordia University-Chicago","2011","Total full-time Instruction/research/public service, Tenured, Professors","20","15","5","0","0","0","0","0","0","0","0","0","0","0","0","0","0","0","20","15","5","0","0","0","0","0","0","0","0","0","-2"
"144351","Concordia University-Chicago","2011","Total full-time Instruction/research/public service, Tenured, Associate professors","1","0","1","0","0","0","0","0","0","0","0","0","0","0","0","0","0","0","1","0","1","0","0","0","0","0","0","0","0","0","-2"
"144351","Concordia University-Chicago","2011","Total full-time Instruction/research/public service, Tenured total","21","15","6","0","0","0","0","0","0","0","0","0","0","0","0","0","0","0","21","15","6","0","0","0","0","0","0","0","0","0","-2"
"144351","Concordia University-Chicago","2011","Total full-time Instruction/research/public service, Non-tenured on tenure track, Professors","15","7","8","0","0","0","0","0","0","0","0","0","0","0","0","0","0","0","15","7","8","0","0","0","0","0","0","0","0","0","-2"
"144351","Concordia University-Chicago","2011","Total full-time Instruction/research/public service, Non-tenured on tenure track, Associate professors","50","13","37","0","0","0","2","0","2","3","0","3","1","0","1","0","0","0","42","12","30","0","0","0","2","1","1","0","0","0","-2"
"144351","Concordia University-Chicago","2011","Total full-time Instruction/research/public service, Non-tenured on tenure track, Assistant professors","43","21","22","0","0","0","0","0","0","2","0","2","2","0","2","0","0","0","36","19","17","0","0","0","1","1","0","2","1","1","-2"
"144351","Concordia University-Chicago","2011","Total full-time Instruction/research/public service, Non-tenured on tenure track total","108","41","67","0","0","0","2","0","2","5","0","5","3","0","3","0","0","0","93","38","55","0","0","0","3","2","1","2","1","1","-2"
"144351","Concordia University-Chicago","2011","Total full-time Instruction/research/public service, Non-tenured not on tenure track, Associate professors","1","0","1","0","0","0","0","0","0","0","0","0","0","0","0","0","0","0","1","0","1","0","0","0","0","0","0","0","0","0","-2"
"144351","Concordia University-Chicago","2011","Total full-time Instruction/research/public servicey, Non-tenured not on tenure track, Assistant professors","9","2","7","0","0","0","2","1","1","2","0","2","0","0","0","0","0","0","4","1","3","0","0","0","0","0","0","1","0","1","-2"
"144351","Concordia University-Chicago","2011","Total full-time Instruction/research/public service, Non-tenured not on tenure track, Instructors","2","2","0","0","0","0","0","0","0","0","0","0","0","0","0","0","0","0","2","2","0","0","0","0","0","0","0","0","0","0","-2"
"144351","Concordia University-Chicago","2011","Total full-time Instruction/research/public service, Non-tenured not on tenure track total","12","4","8","0","0","0","2","1","1","2","0","2","0","0","0","0","0","0","7","3","4","0","0","0","0","0","0","1","0","1","-2"
"145600","University of Illinois Chicago","2011","Total full-time Instruction/research/public service, Tenured, Professors","448","320","128","0","0","0","73","59","14","6","4","2","15","9","6","0","0","0","350","246","104","0","0","0","1","0","1","3","2","1","-2"
"145600","University of Illinois Chicago","2011","Total full-time Instruction/research/public service, Tenured, Associate professors","362","221","141","0","0","0","51","34","17","21","10","11","29","17","12","0","0","0","251","153","98","2","1","1","2","2","0","6","4","2","-2"
"145600","University of Illinois Chicago","2011","Total full-time Instruction/research/public service, Tenured, Assistant professors","25","13","12","0","0","0","6","3","3","3","1","2","1","1","0","0","0","0","14","8","6","0","0","0","1","0","1","0","0","0","-2"
"145600","University of Illinois Chicago","2011","Total full-time Instruction/research/public service, Tenured, No academic rank","1","1","0","0","0","0","1","1","0","0","0","0","0","0","0","0","0","0","0","0","0","0","0","0","0","0","0","0","0","0","-2"
"145600","University of Illinois Chicago","2011","Total full-time Instruction/research/public service, Tenured total","836","555","281","0","0","0","131","97","34","30","15","15","45","27","18","0","0","0","615","407","208","2","1","1","4","2","2","9","6","3","-2"
"145600","University of Illinois Chicago","2011","Total full-time Instruction/research/public service, Non-tenured on tenure track, Professors","14","10","4","0","0","0","2","2","0","0","0","0","0","0","0","0","0","0","10","7","3","1","1","0","0","0","0","1","0","1","-2"
"145600","University of Illinois Chicago","2011","Total full-time Instruction/research/public service, Non-tenured on tenure track, Associate professors","33","20","13","0","0","0","9","5","4","2","1","1","0","0","0","0","0","0","20","12","8","1","1","0","0","0","0","1","1","0","-2"
"145600","University of Illinois Chicago","2011","Total full-time Instruction/research/public service, Non-tenured on tenure track, Assistant professors","333","155","178","2","0","2","71","43","28","27","10","17","33","11","22","0","0","0","143","63","80","3","0","3","9","4","5","45","24","21","-2"
"145600","University of Illinois Chicago","2011","Total full-time Instruction/research/public service, Non-tenured on tenure track total","380","185","195","2","0","2","82","50","32","29","11","18","33","11","22","0","0","0","173","82","91","5","2","3","9","4","5","47","25","22","-2"
"145600","University of Illinois Chicago","2011","Total full-time Instruction/research/public service, Non-tenured not on tenure track, Professors","28","21","7","0","0","0","4","4","0","0","0","0","1","1","0","0","0","0","21","14","7","0","0","0","2","2","0","0","0","0","-2"
"145600","University of Illinois Chicago","2011","Total full-time Instruction/research/public service, Non-tenured not on tenure track, Associate professors","87","45","42","0","0","0","15","10","5","8","3","5","2","0","2","0","0","0","55","26","29","0","0","0","3","2","1","4","4","0","-2"
"145600","University of Illinois Chicago","2011","Total full-time Instruction/research/public servicey, Non-tenured not on tenure track, Assistant professors","395","212","183","0","0","0","92","50","42","14","8","6","21","12","9","0","0","0","206","103","103","2","0","2","11","5","6","49","34","15","-2"
"145600","University of Illinois Chicago","2011","Total full-time Instruction/research/public service, Non-tenured not on tenure track, Instructors","47","9","38","0","0","0","3","1","2","3","0","3","2","1","1","0","0","0","31","6","25","2","0","2","3","1","2","3","0","3","-2"
"145600","University of Illinois Chicago","2011","Total full-time Instruction/research/public service, Non-tenured not on tenure track, Lecturers","133","68","65","0","0","0","9","2","7","4","1","3","11","5","6","0","0","0","99","57","42","1","1","0","8","2","6","1","0","1","-2"
"145600","University of Illinois Chicago","2011","Total full-time Instruction/research/public service, Non-tenured not on tenure track, No academic rank","16","4","12","0","0","0","0","0","0","0","0","0","0","0","0","0","0","0","13","3","10","0","0","0","1","0","1","2","1","1","-2"
"145600","University of Illinois Chicago","2011","Total full-time Instruction/research/public service, Non-tenured not on tenure track total","706","359","347","0","0","0","123","67","56","29","12","17","37","19","18","0","0","0","425","209","216","5","1","4","28","12","16","59","39","20","-2"
"147536","National Louis University","2011","Total full-time Instruction/research/public service, Tenured, Professors","26","12","14","0","0","0","1","0","1","0","0","0","0","0","0","0","0","0","25","12","13","0","0","0","0","0","0","0","0","0","-2"
"147536","National Louis University","2011","Total full-time Instruction/research/public service, Tenured, Associate professors","67","22","45","0","0","0","1","0","1","2","1","1","2","2","0","0","0","0","59","19","40","1","0","1","0","0","0","2","0","2","-2"
"147536","National Louis University","2011","Total full-time Instruction/research/public service, Tenured, Assistant professors","9","4","5","0","0","0","0","0","0","1","1","0","0","0","0","0","0","0","6","2","4","2","1","1","0","0","0","0","0","0","-2"
"147536","National Louis University","2011","Total full-time Instruction/research/public service, Tenured total","102","38","64","0","0","0","2","0","2","3","2","1","2","2","0","0","0","0","90","33","57","3","1","2","0","0","0","2","0","2","-2"
"147536","National Louis University","2011","Total full-time Instruction/research/public service, Non-tenured on tenure track, Associate professors","1","1","0","0","0","0","0","0","0","0","0","0","0","0","0","0","0","0","0","0","0","0","0","0","0","0","0","1","1","0","-2"
"147536","National Louis University","2011","Total full-time Instruction/research/public service, Non-tenured on tenure track, Assistant professors","49","17","32","0","0","0","1","0","1","5","2","3","3","2","1","0","0","0","37","13","24","0","0","0","0","0","0","3","0","3","-2"
"147536","National Louis University","2011","Total full-time Instruction/research/public service, Non-tenured on tenure track, Instructors","1","0","1","0","0","0","0","0","0","0","0","0","0","0","0","0","0","0","1","0","1","0","0","0","0","0","0","0","0","0","-2"
"147536","National Louis University","2011","Total full-time Instruction/research/public service, Non-tenured on tenure track total","51","18","33","0","0","0","1","0","1","5","2","3","3","2","1","0","0","0","38","13","25","0","0","0","0","0","0","4","1","3","-2"
"147536","National Louis University","2011","Total full-time Instruction/research/public service, Non-tenured not on tenure track, Associate professors","5","0","5","0","0","0","0","0","0","0","0","0","0","0","0","0","0","0","5","0","5","0","0","0","0","0","0","0","0","0","-2"
"147536","National Louis University","2011","Total full-time Instruction/research/public servicey, Non-tenured not on tenure track, Assistant professors","34","10","24","0","0","0","0","0","0","4","1","3","0","0","0","0","0","0","29","9","20","1","0","1","0","0","0","0","0","0","-2"
"147536","National Louis University","2011","Total full-time Instruction/research/public service, Non-tenured not on tenure track, Instructors","16","5","11","0","0","0","0","0","0","0","0","0","0","0","0","0","0","0","16","5","11","0","0","0","0","0","0","0","0","0","-2"
"147536","National Louis University","2011","Total full-time Instruction/research/public service, Non-tenured not on tenure track total","55","15","40","0","0","0","0","0","0","4","1","3","0","0","0","0","0","0","50","14","36","1","0","1","0","0","0","0","0","0","-2"
"147679","North Park University","2011","Total full-time Instruction/research/public service, Tenured, Professors","51","32","19","0","0","0","2","2","0","3","1","2","2","1","1","0","0","0","44","28","16","0","0","0","0","0","0","0","0","0","-2"
"147679","North Park University","2011","Total full-time Instruction/research/public service, Tenured, Associate professors","20","5","15","0","0","0","4","2","2","1","0","1","1","0","1","0","0","0","14","3","11","0","0","0","0","0","0","0","0","0","-2"
"147679","North Park University","2011","Total full-time Instruction/research/public service, Tenured, Assistant professors","3","1","2","0","0","0","0","0","0","0","0","0","0","0","0","0","0","0","3","1","2","0","0","0","0","0","0","0","0","0","-2"
"147679","North Park University","2011","Total full-time Instruction/research/public service, Tenured total","74","38","36","0","0","0","6","4","2","4","1","3","3","1","2","0","0","0","61","32","29","0","0","0","0","0","0","0","0","0","-2"
"147679","North Park University","2011","Total full-time Instruction/research/public service, Non-tenured on tenure track, Professors","3","1","2","0","0","0","0","0","0","0","0","0","0","0","0","0","0","0","3","1","2","0","0","0","0","0","0","0","0","0","-2"
"147679","North Park University","2011","Total full-time Instruction/research/public service, Non-tenured on tenure track, Associate professors","9","6","3","0","0","0","1","1","0","0","0","0","1","0","1","0","0","0","7","5","2","0","0","0","0","0","0","0","0","0","-2"
"147679","North Park University","2011","Total full-time Instruction/research/public service, Non-tenured on tenure track, Assistant professors","11","4","7","0","0","0","2","1","1","0","0","0","1","0","1","0","0","0","8","3","5","0","0","0","0","0","0","0","0","0","-2"
"147679","North Park University","2011","Total full-time Instruction/research/public service, Non-tenured on tenure track total","23","11","12","0","0","0","3","2","1","0","0","0","2","0","2","0","0","0","18","9","9","0","0","0","0","0","0","0","0","0","-2"
"147679","North Park University","2011","Total full-time Instruction/research/public service, Non-tenured not on tenure track, Professors","4","1","3","0","0","0","0","0","0","0","0","0","0","0","0","0","0","0","4","1","3","0","0","0","0","0","0","0","0","0","-2"
"147679","North Park University","2011","Total full-time Instruction/research/public service, Non-tenured not on tenure track, Associate professors","8","2","6","0","0","0","0","0","0","1","0","1","0","0","0","0","0","0","7","2","5","0","0","0","0","0","0","0","0","0","-2"
"147679","North Park University","2011","Total full-time Instruction/research/public servicey, Non-tenured not on tenure track, Assistant professors","13","5","8","0","0","0","0","0","0","0","0","0","0","0","0","0","0","0","13","5","8","0","0","0","0","0","0","0","0","0","-2"
"147679","North Park University","2011","Total full-time Instruction/research/public service, Non-tenured not on tenure track total","25","8","17","0","0","0","0","0","0","1","0","1","0","0","0","0","0","0","24","8","16","0","0","0","0","0","0","0","0","0","-2"
"147776","Northeastern Illinois University","2011","Total full-time Instruction/research/public service, Tenured, Professors","88","46","42","0","0","0","13","9","4","3","2","1","7","3","4","0","0","0","65","32","33","0","0","0","0","0","0","0","0","0","-2"
"147776","Northeastern Illinois University","2011","Total full-time Instruction/research/public service, Tenured, Associate professors","81","33","48","0","0","0","8","3","5","6","3","3","10","3","7","0","0","0","54","21","33","0","0","0","3","3","0","0","0","0","-2"
"147776","Northeastern Illinois University","2011","Total full-time Instruction/research/public service, Tenured, Assistant professors","8","7","1","0","0","0","1","1","0","2","2","0","1","1","0","0","0","0","4","3","1","0","0","0","0","0","0","0","0","0","-2"
"147776","Northeastern Illinois University","2011","Total full-time Instruction/research/public service, Tenured total","177","86","91","0","0","0","22","13","9","11","7","4","18","7","11","0","0","0","123","56","67","0","0","0","3","3","0","0","0","0","-2"
"147776","Northeastern Illinois University","2011","Total full-time Instruction/research/public service, Non-tenured on tenure track, Professors","8","4","4","0","0","0","2","1","1","0","0","0","3","1","2","0","0","0","3","2","1","0","0","0","0","0","0","0","0","0","-2"
"147776","Northeastern Illinois University","2011","Total full-time Instruction/research/public service, Non-tenured on tenure track, Associate professors","7","2","5","0","0","0","0","0","0","2","1","1","0","0","0","0","0","0","5","1","4","0","0","0","0","0","0","0","0","0","-2"
"147776","Northeastern Illinois University","2011","Total full-time Instruction/research/public service, Non-tenured on tenure track, Assistant professors","78","39","39","0","0","0","7","4","3","7","2","5","12","6","6","0","0","0","38","19","19","0","0","0","9","6","3","5","2","3","-2"
"147776","Northeastern Illinois University","2011","Total full-time Instruction/research/public service, Non-tenured on tenure track total","93","45","48","0","0","0","9","5","4","9","3","6","15","7","8","0","0","0","46","22","24","0","0","0","9","6","3","5","2","3","-2"
"147776","Northeastern Illinois University","2011","Total full-time Instruction/research/public service, Non-tenured not on tenure track, Instructors","147","72","75","0","0","0","7","5","2","8","4","4","11","7","4","0","0","0","109","50","59","0","0","0","12","6","6","0","0","0","-2"
"147776","Northeastern Illinois University","2011","Total full-time Instruction/research/public service, Non-tenured not on tenure track total","147","72","75","0","0","0","7","5","2","8","4","4","11","7","4","0","0","0","109","50","59","0","0","0","12","6","6","0","0","0","-2"
"148335","Robert Morris University Illinois","2011","Total full-time Instruction/research/public service, Non-tenured not on tenure track, No academic rank","126","62","64","0","0","0","13","9","4","12","4","8","4","4","0","0","0","0","97","45","52","0","0","0","0","0","0","0","0","0","-2"
"148335","Robert Morris University Illinois","2011","Total full-time Instruction/research/public service, Non-tenured not on tenure track total","126","62","64","0","0","0","13","9","4","12","4","8","4","4","0","0","0","0","97","45","52","0","0","0","0","0","0","0","0","0","-2"
"148487","Roosevelt University","2011","Total full-time Instruction/research/public service, Tenured, Professors","48","36","12","0","0","0","5","4","1","5","3","2","3","3","0","0","0","0","33","24","9","0","0","0","2","2","0","0","0","0","-2"
"148487","Roosevelt University","2011","Total full-time Instruction/research/public service, Tenured, Associate professors","87","49","38","1","1","0","2","2","0","3","1","2","4","3","1","0","0","0","68","34","34","0","0","0","9","8","1","0","0","0","-2"
"148487","Roosevelt University","2011","Total full-time Instruction/research/public service, Tenured, Assistant professors","5","4","1","0","0","0","0","0","0","0","0","0","0","0","0","0","0","0","5","4","1","0","0","0","0","0","0","0","0","0","-2"
"148487","Roosevelt University","2011","Total full-time Instruction/research/public service, Tenured total","140","89","51","1","1","0","7","6","1","8","4","4","7","6","1","0","0","0","106","62","44","0","0","0","11","10","1","0","0","0","-2"
"148487","Roosevelt University","2011","Total full-time Instruction/research/public service, Non-tenured on tenure track, Associate professors","5","5","0","0","0","0","0","0","0","0","0","0","1","1","0","0","0","0","2","2","0","1","1","0","1","1","0","0","0","0","-2"
"148487","Roosevelt University","2011","Total full-time Instruction/research/public service, Non-tenured on tenure track, Assistant professors","73","33","40","0","0","0","15","4","11","5","1","4","3","2","1","0","0","0","41","21","20","3","1","2","6","4","2","0","0","0","-2"
"148487","Roosevelt University","2011","Total full-time Instruction/research/public service, Non-tenured on tenure track total","78","38","40","0","0","0","15","4","11","5","1","4","4","3","1","0","0","0","43","23","20","4","2","2","7","5","2","0","0","0","-2"
"148487","Roosevelt University","2011","Total full-time Instruction/research/public servicey, Non-tenured not on tenure track, Assistant professors","2","2","0","0","0","0","0","0","0","0","0","0","1","1","0","0","0","0","1","1","0","0","0","0","0","0","0","0","0","0","-2"
"148487","Roosevelt University","2011","Total full-time Instruction/research/public service, Non-tenured not on tenure track, Lecturers","20","8","12","0","0","0","1","0","1","3","2","1","0","0","0","0","0","0","14","6","8","1","0","1","1","0","1","0","0","0","-2"
"148487","Roosevelt University","2011","Total full-time Instruction/research/public service, Non-tenured not on tenure track, No academic rank","2","1","1","0","0","0","0","0","0","0","0","0","1","0","1","0","0","0","1","1","0","0","0","0","0","0","0","0","0","0","-2"
"148487","Roosevelt University","2011","Total full-time Instruction/research/public service, Non-tenured not on tenure track total","24","11","13","0","0","0","1","0","1","3","2","1","2","1","1","0","0","0","16","8","8","1","0","1","1","0","1","0","0","0","-2"
"148496","Dominican University","2011","Total full-time Instruction/research/public service, Tenured, Professors","40","24","16","0","0","0","0","0","0","0","0","0","1","1","0","0","0","0","39","23","16","0","0","0","0","0","0","0","0","0","-2"
"148496","Dominican University","2011","Total full-time Instruction/research/public service, Tenured, Associate professors","18","5","13","0","0","0","1","1","0","0","0","0","0","0","0","0","0","0","17","4","13","0","0","0","0","0","0","0","0","0","-2"
"148496","Dominican University","2011","Total full-time Instruction/research/public service, Tenured, Assistant professors","9","2","7","0","0","0","0","0","0","0","0","0","0","0","0","0","0","0","9","2","7","0","0","0","0","0","0","0","0","0","-2"
"148496","Dominican University","2011","Total full-time Instruction/research/public service, Tenured total","67","31","36","0","0","0","1","1","0","0","0","0","1","1","0","0","0","0","65","29","36","0","0","0","0","0","0","0","0","0","-2"
"148496","Dominican University","2011","Total full-time Instruction/research/public service, Non-tenured on tenure track, Professors","1","1","0","0","0","0","1","1","0","0","0","0","0","0","0","0","0","0","0","0","0","0","0","0","0","0","0","0","0","0","-2"
"148496","Dominican University","2011","Total full-time Instruction/research/public service, Non-tenured on tenure track, Associate professors","10","3","7","0","0","0","0","0","0","1","0","1","0","0","0","1","0","1","8","3","5","0","0","0","0","0","0","0","0","0","-2"
"148496","Dominican University","2011","Total full-time Instruction/research/public service, Non-tenured on tenure track, Assistant professors","53","17","36","0","0","0","4","1","3","5","3","2","2","0","2","0","0","0","42","13","29","0","0","0","0","0","0","0","0","0","-2"
"148496","Dominican University","2011","Total full-time Instruction/research/public service, Non-tenured on tenure track, Instructors","3","1","2","0","0","0","0","0","0","1","0","1","0","0","0","0","0","0","2","1","1","0","0","0","0","0","0","0","0","0","-2"
"148496","Dominican University","2011","Total full-time Instruction/research/public service, Non-tenured on tenure track total","67","22","45","0","0","0","5","2","3","7","3","4","2","0","2","1","0","1","52","17","35","0","0","0","0","0","0","0","0","0","-2"
"148496","Dominican University","2011","Total full-time Instruction/research/public servicey, Non-tenured not on tenure track, Assistant professors","4","2","2","0","0","0","1","0","1","0","0","0","0","0","0","0","0","0","3","2","1","0","0","0","0","0","0","0","0","0","-2"
"148496","Dominican University","2011","Total full-time Instruction/research/public service, Non-tenured not on tenure track, Instructors","2","2","0","0","0","0","0","0","0","1","1","0","0","0","0","0","0","0","1","1","0","0","0","0","0","0","0","0","0","0","-2"
"148496","Dominican University","2011","Total full-time Instruction/research/public service, Non-tenured not on tenure track, Lecturers","16","8","8","0","0","0","0","0","0","0","0","0","0","0","0","0","0","0","16","8","8","0","0","0","0","0","0","0","0","0","-2"
"148496","Dominican University","2011","Total full-time Instruction/research/public service, Non-tenured not on tenure track total","22","12","10","0","0","0","1","0","1","1","1","0","0","0","0","0","0","0","20","11","9","0","0","0","0","0","0","0","0","0","-2"
"148511","Rush University","2011","Total full-time Instruction/research/public service, Tenured, Professors","75","55","20","0","0","0","14","9","5","0","0","0","0","0","0","0","0","0","61","46","15","0","0","0","0","0","0","0","0","0","-2"
"148511","Rush University","2011","Total full-time Instruction/research/public service, Tenured, Associate professors","85","52","33","1","1","0","13","7","6","2","1","1","6","5","1","1","1","0","61","36","25","1","1","0","0","0","0","0","0","0","-2"
"148511","Rush University","2011","Total full-time Instruction/research/public service, Tenured total","160","107","53","1","1","0","27","16","11","2","1","1","6","5","1","1","1","0","122","82","40","1","1","0","0","0","0","0","0","0","-2"
"148511","Rush University","2011","Total full-time Instruction/research/public service, Non-tenured on tenure track, Assistant professors","388","209","179","0","0","0","116","62","54","9","3","6","9","4","5","0","0","0","252","139","113","2","1","1","0","0","0","0","0","0","-2"
"148511","Rush University","2011","Total full-time Instruction/research/public service, Non-tenured on tenure track, Instructors","175","68","107","0","0","0","56","25","31","8","2","6","7","3","4","0","0","0","98","35","63","6","3","3","0","0","0","0","0","0","-2"
"148511","Rush University","2011","Total full-time Instruction/research/public service, Non-tenured on tenure track total","563","277","286","0","0","0","172","87","85","17","5","12","16","7","9","0","0","0","350","174","176","8","4","4","0","0","0","0","0","0","-2"
"148511","Rush University","2011","Total full-time Instruction/research/public service, Non-tenured not on tenure track, Professors","11","1","10","0","0","0","0","0","0","0","0","0","0","0","0","0","0","0","11","1","10","0","0","0","0","0","0","0","0","0","-2"
"148511","Rush University","2011","Total full-time Instruction/research/public service, Non-tenured not on tenure track, Associate professors","16","1","15","0","0","0","0","0","0","1","0","1","0","0","0","0","0","0","15","1","14","0","0","0","0","0","0","0","0","0","-2"
"148511","Rush University","2011","Total full-time Instruction/research/public servicey, Non-tenured not on tenure track, Assistant professors","23","1","22","0","0","0","0","0","0","1","1","0","0","0","0","0","0","0","22","0","22","0","0","0","0","0","0","0","0","0","-2"
"148511","Rush University","2011","Total full-time Instruction/research/public service, Non-tenured not on tenure track, Instructors","39","2","37","0","0","0","2","0","2","2","0","2","1","0","1","0","0","0","34","2","32","0","0","0","0","0","0","0","0","0","-2"
"148511","Rush University","2011","Total full-time Instruction/research/public service, Non-tenured not on tenure track total","89","5","84","0","0","0","2","0","2","4","1","3","1","0","1","0","0","0","82","4","78","0","0","0","0","0","0","0","0","0","-2"
"148627","Saint Xavier University","2011","Total full-time Instruction/research/public service, Tenured, Professors","30","18","12","0","0","0","1","1","0","1","1","0","0","0","0","0","0","0","28","16","12","0","0","0","0","0","0","0","0","0","-2"
"148627","Saint Xavier University","2011","Total full-time Instruction/research/public service, Tenured, Associate professors","70","33","37","0","0","0","4","2","2","5","3","2","1","0","1","0","0","0","60","28","32","0","0","0","0","0","0","0","0","0","-2"
"148627","Saint Xavier University","2011","Total full-time Instruction/research/public service, Tenured, Assistant professors","1","0","1","0","0","0","0","0","0","0","0","0","0","0","0","0","0","0","1","0","1","0","0","0","0","0","0","0","0","0","-2"
"148627","Saint Xavier University","2011","Total full-time Instruction/research/public service, Tenured total","101","51","50","0","0","0","5","3","2","6","4","2","1","0","1","0","0","0","89","44","45","0","0","0","0","0","0","0","0","0","-2"
"148627","Saint Xavier University","2011","Total full-time Instruction/research/public service, Non-tenured on tenure track, Associate professors","10","4","6","0","0","0","1","1","0","1","1","0","0","0","0","0","0","0","8","2","6","0","0","0","0","0","0","0","0","0","-2"
"148627","Saint Xavier University","2011","Total full-time Instruction/research/public service, Non-tenured on tenure track, Assistant professors","34","10","24","0","0","0","4","2","2","1","0","1","2","1","1","0","0","0","23","5","18","0","0","0","4","2","2","0","0","0","-2"
"148627","Saint Xavier University","2011","Total full-time Instruction/research/public service, Non-tenured on tenure track total","44","14","30","0","0","0","5","3","2","2","1","1","2","1","1","0","0","0","31","7","24","0","0","0","4","2","2","0","0","0","-2"
"148627","Saint Xavier University","2011","Total full-time Instruction/research/public servicey, Non-tenured not on tenure track, Assistant professors","24","10","14","0","0","0","0","0","0","0","0","0","0","0","0","0","0","0","20","8","12","1","1","0","3","1","2","0","0","0","-2"
"148627","Saint Xavier University","2011","Total full-time Instruction/research/public service, Non-tenured not on tenure track, Lecturers","4","2","2","0","0","0","0","0","0","0","0","0","1","0","1","0","0","0","3","2","1","0","0","0","0","0","0","0","0","0","-2"
"148627","Saint Xavier University","2011","Total full-time Instruction/research/public service, Non-tenured not on tenure track total","28","12","16","0","0","0","0","0","0","0","0","0","1","0","1","0","0","0","23","10","13","1","1","0","3","1","2","0","0","0","-2"
"148876","Saint Augustine College","2011","Total full-time Instruction/research/public service, Non-tenured not on tenure track, Associate professors","3","2","1","0","0","0","0","0","0","0","0","0","2","2","0","0","0","0","1","0","1","0","0","0","0","0","0","0","0","0","-2"
"148876","Saint Augustine College","2011","Total full-time Instruction/research/public servicey, Non-tenured not on tenure track, Assistant professors","20","7","13","0","0","0","2","1","1","2","0","2","11","6","5","0","0","0","5","0","5","0","0","0","0","0","0","0","0","0","-2"
"148876","Saint Augustine College","2011","Total full-time Instruction/research/public service, Non-tenured not on tenure track, Instructors","4","3","1","0","0","0","0","0","0","1","1","0","2","2","0","0","0","0","1","0","1","0","0","0","0","0","0","0","0","0","-2"
"148876","Saint Augustine College","2011","Total full-time Instruction/research/public service, Non-tenured not on tenure track total","27","12","15","0","0","0","2","1","1","3","1","2","15","10","5","0","0","0","7","0","7","0","0","0","0","0","0","0","0","0","-2"
"149639","VanderCook College of Music","2011","Total full-time Instruction/research/public service, Non-tenured not on tenure track, Professors","1","0","1","0","0","0","0","0","0","0","0","0","0","0","0","0","0","0","1","0","1","0","0","0","0","0","0","0","0","0","-2"
"149639","VanderCook College of Music","2011","Total full-time Instruction/research/public service, Non-tenured not on tenure track, Associate professors","5","3","2","0","0","0","0","0","0","1","1","0","0","0","0","0","0","0","4","2","2","0","0","0","0","0","0","0","0","0","-2"
"149639","VanderCook College of Music","2011","Total full-time Instruction/research/public servicey, Non-tenured not on tenure track, Assistant professors","6","1","5","0","0","0","2","0","2","0","0","0","0","0","0","0","0","0","4","1","3","0","0","0","0","0","0","0","0","0","-2"
"149639","VanderCook College of Music","2011","Total full-time Instruction/research/public service, Non-tenured not on tenure track total","12","4","8","0","0","0","2","0","2","1","1","0","0","0","0","0","0","0","9","3","6","0","0","0","0","0","0","0","0","0","-2"
"150172","Calumet College of Saint Joseph","2011","Total full-time Instruction/research/public service, Tenured, Professors","5","4","1","0","0","0","0","0","0","0","0","0","0","0","0","0","0","0","5","4","1","0","0","0","0","0","0","0","0","0","-2"
"150172","Calumet College of Saint Joseph","2011","Total full-time Instruction/research/public service, Tenured, Associate professors","11","9","2","0","0","0","0","0","0","0","0","0","0","0","0","0","0","0","11","9","2","0","0","0","0","0","0","0","0","0","-2"
"150172","Calumet College of Saint Joseph","2011","Total full-time Instruction/research/public service, Tenured, Assistant professors","2","2","0","0","0","0","0","0","0","0","0","0","0","0","0","0","0","0","2","2","0","0","0","0","0","0","0","0","0","0","-2"
"150172","Calumet College of Saint Joseph","2011","Total full-time Instruction/research/public service, Tenured total","18","15","3","0","0","0","0","0","0","0","0","0","0","0","0","0","0","0","18","15","3","0","0","0","0","0","0","0","0","0","-2"
"150172","Calumet College of Saint Joseph","2011","Total full-time Instruction/research/public service, Non-tenured on tenure track, Associate professors","1","0","1","0","0","0","0","0","0","0","0","0","0","0","0","0","0","0","1","0","1","0","0","0","0","0","0","0","0","0","-2"
"150172","Calumet College of Saint Joseph","2011","Total full-time Instruction/research/public service, Non-tenured on tenure track, Assistant professors","9","5","4","0","0","0","0","0","0","1","0","1","0","0","0","0","0","0","8","5","3","0","0","0","0","0","0","0","0","0","-2"
"150172","Calumet College of Saint Joseph","2011","Total full-time Instruction/research/public service, Non-tenured on tenure track total","10","5","5","0","0","0","0","0","0","1","0","1","0","0","0","0","0","0","9","5","4","0","0","0","0","0","0","0","0","0","-2"
"150172","Calumet College of Saint Joseph","2011","Total full-time Instruction/research/public servicey, Non-tenured not on tenure track, Assistant professors","1","1","0","0","0","0","0","0","0","0","0","0","0","0","0","0","0","0","1","1","0","0","0","0","0","0","0","0","0","0","-2"
"150172","Calumet College of Saint Joseph","2011","Total full-time Instruction/research/public service, Non-tenured not on tenure track, Instructors","4","3","1","0","0","0","0","0","0","1","1","0","1","1","0","0","0","0","2","1","1","0","0","0","0","0","0","0","0","0","-2"
"150172","Calumet College of Saint Joseph","2011","Total full-time Instruction/research/public service, Non-tenured not on tenure track, Lecturers","1","1","0","0","0","0","0","0","0","0","0","0","0","0","0","0","0","0","1","1","0","0","0","0","0","0","0","0","0","0","-2"
"150172","Calumet College of Saint Joseph","2011","Total full-time Instruction/research/public service, Non-tenured not on tenure track total","6","5","1","0","0","0","0","0","0","1","1","0","1","1","0","0","0","0","4","3","1","0","0","0","0","0","0","0","0","0","-2"
"151360","Indiana University-Northwest","2011","Total full-time Instruction/research/public service, Tenured, Professors","32","23","9","0","0","0","4","4","0","2","1","1","1","0","1","0","0","0","25","18","7","0","0","0","0","0","0","0","0","0","-2"
"151360","Indiana University-Northwest","2011","Total full-time Instruction/research/public service, Tenured, Associate professors","41","23","18","0","0","0","5","2","3","3","3","0","4","3","1","0","0","0","29","15","14","0","0","0","0","0","0","0","0","0","-2"
"151360","Indiana University-Northwest","2011","Total full-time Instruction/research/public service, Tenured total","73","46","27","0","0","0","9","6","3","5","4","1","5","3","2","0","0","0","54","33","21","0","0","0","0","0","0","0","0","0","-2"
"151360","Indiana University-Northwest","2011","Total full-time Instruction/research/public service, Non-tenured on tenure track, Professors","4","2","2","0","0","0","0","0","0","1","1","0","0","0","0","0","0","0","3","1","2","0","0","0","0","0","0","0","0","0","-2"
"151360","Indiana University-Northwest","2011","Total full-time Instruction/research/public service, Non-tenured on tenure track, Associate professors","3","1","2","0","0","0","0","0","0","1","0","1","0","0","0","0","0","0","2","1","1","0","0","0","0","0","0","0","0","0","-2"
"151360","Indiana University-Northwest","2011","Total full-time Instruction/research/public service, Non-tenured on tenure track, Assistant professors","39","20","19","1","0","1","6","4","2","4","1","3","1","1","0","0","0","0","27","14","13","0","0","0","0","0","0","0","0","0","-2"
"151360","Indiana University-Northwest","2011","Total full-time Instruction/research/public service, Non-tenured on tenure track, Lecturers","1","0","1","0","0","0","0","0","0","0","0","0","0","0","0","0","0","0","1","0","1","0","0","0","0","0","0","0","0","0","-2"
"151360","Indiana University-Northwest","2011","Total full-time Instruction/research/public service, Non-tenured on tenure track total","47","23","24","1","0","1","6","4","2","6","2","4","1","1","0","0","0","0","33","16","17","0","0","0","0","0","0","0","0","0","-2"
"151360","Indiana University-Northwest","2011","Total full-time Instruction/research/public service, Non-tenured not on tenure track, Associate professors","4","0","4","0","0","0","1","0","1","0","0","0","0","0","0","0","0","0","3","0","3","0","0","0","0","0","0","0","0","0","-2"
"151360","Indiana University-Northwest","2011","Total full-time Instruction/research/public servicey, Non-tenured not on tenure track, Assistant professors","8","0","8","0","0","0","0","0","0","1","0","1","0","0","0","0","0","0","7","0","7","0","0","0","0","0","0","0","0","0","-2"
"151360","Indiana University-Northwest","2011","Total full-time Instruction/research/public service, Non-tenured not on tenure track, Lecturers","45","11","34","0","0","0","5","0","5","3","0","3","2","0","2","0","0","0","34","11","23","1","0","1","0","0","0","0","0","0","-2"
"151360","Indiana University-Northwest","2011","Total full-time Instruction/research/public service, Non-tenured not on tenure track, No academic rank","3","1","2","0","0","0","3","1","2","0","0","0","0","0","0","0","0","0","0","0","0","0","0","0","0","0","0","0","0","0","-2"
"151360","Indiana University-Northwest","2011","Total full-time Instruction/research/public service, Non-tenured not on tenure track total","60","12","48","0","0","0","9","1","8","4","0","4","2","0","2","0","0","0","44","11","33","1","0","1","0","0","0","0","0","0","-2"
"155007","Donnelly College","2011","Total full-time Instruction/research/public service, Non-tenured not on tenure track, Instructors","17","7","10","0","0","0","1","1","0","0","0","0","1","1","0","0","0","0","15","5","10","0","0","0","0","0","0","0","0","0","-2"
"155007","Donnelly College","2011","Total full-time Instruction/research/public service, Non-tenured not on tenure track total","17","7","10","0","0","0","1","1","0","0","0","0","1","1","0","0","0","0","15","5","10","0","0","0","0","0","0","0","0","0","-2"
"160409","Saint Joseph Seminary College","2011","Total full-time Instruction/research/public service, Non-tenured not on tenure track, Professors","17","15","2","0","0","0","0","0","0","0","0","0","0","0","0","0","0","0","17","15","2","0","0","0","0","0","0","0","0","0","-2"
"160409","Saint Joseph Seminary College","2011","Total full-time Instruction/research/public service, Non-tenured not on tenure track total","17","15","2","0","0","0","0","0","0","0","0","0","0","0","0","0","0","0","17","15","2","0","0","0","0","0","0","0","0","0","-2"
"165167","Cambridge College","2011","Total full-time Instruction/research/public service, Non-tenured not on tenure track, Professors","17","9","8","0","0","0","1","0","1","6","2","4","1","1","0","0","0","0","9","6","3","0","0","0","0","0","0","0","0","0","-2"
"165167","Cambridge College","2011","Total full-time Instruction/research/public service, Non-tenured not on tenure track, Associate professors","6","5","1","0","0","0","0","0","0","1","1","0","0","0","0","0","0","0","5","4","1","0","0","0","0","0","0","0","0","0","-2"
"165167","Cambridge College","2011","Total full-time Instruction/research/public servicey, Non-tenured not on tenure track, Assistant professors","5","0","5","0","0","0","0","0","0","0","0","0","0","0","0","0","0","0","5","0","5","0","0","0","0","0","0","0","0","0","-2"
"165167","Cambridge College","2011","Total full-time Instruction/research/public service, Non-tenured not on tenure track, Lecturers","1","1","0","0","0","0","0","0","0","0","0","0","0","0","0","0","0","0","1","1","0","0","0","0","0","0","0","0","0","0","-2"
"165167","Cambridge College","2011","Total full-time Instruction/research/public service, Non-tenured not on tenure track total","29","15","14","0","0","0","1","0","1","7","3","4","1","1","0","0","0","0","20","11","9","0","0","0","0","0","0","0","0","0","-2"
"165884","Benjamin Franklin Institute of Technology","2011","Total full-time Instruction/research/public service, Non-tenured not on tenure track, Professors","5","2","3","0","0","0","0","0","0","0","0","0","0","0","0","0","0","0","5","2","3","0","0","0","0","0","0","0","0","0","-2"
"165884","Benjamin Franklin Institute of Technology","2011","Total full-time Instruction/research/public service, Non-tenured not on tenure track, Associate professors","6","3","3","0","0","0","0","0","0","0","0","0","0","0","0","0","0","0","6","3","3","0","0","0","0","0","0","0","0","0","-2"
"165884","Benjamin Franklin Institute of Technology","2011","Total full-time Instruction/research/public servicey, Non-tenured not on tenure track, Assistant professors","15","13","2","0","0","0","0","0","0","0","0","0","0","0","0","0","0","0","15","13","2","0","0","0","0","0","0","0","0","0","-2"
"165884","Benjamin Franklin Institute of Technology","2011","Total full-time Instruction/research/public service, Non-tenured not on tenure track, Instructors","9","6","3","0","0","0","0","0","0","0","0","0","0","0","0","0","0","0","9","6","3","0","0","0","0","0","0","0","0","0","-2"
"165884","Benjamin Franklin Institute of Technology","2011","Total full-time Instruction/research/public service, Non-tenured not on tenure track total","35","24","11","0","0","0","0","0","0","0","0","0","0","0","0","0","0","0","35","24","11","0","0","0","0","0","0","0","0","0","-2"
"182005","College of Southern Nevada","2011","Total full-time Instruction/research/public service, Tenured, Professors","342","195","147","3","1","2","23","12","11","18","8","10","21","8","13","0","0","0","273","162","111","3","3","0","0","0","0","1","1","0","-2"
"182005","College of Southern Nevada","2011","Total full-time Instruction/research/public service, Tenured total","342","195","147","3","1","2","23","12","11","18","8","10","21","8","13","0","0","0","273","162","111","3","3","0","0","0","0","1","1","0","-2"
"182005","College of Southern Nevada","2011","Total full-time Instruction/research/public service, Non-tenured on tenure track, Instructors","80","37","43","2","1","1","9","2","7","3","1","2","5","4","1","0","0","0","60","28","32","0","0","0","0","0","0","1","1","0","-2"
"182005","College of Southern Nevada","2011","Total full-time Instruction/research/public service, Non-tenured on tenure track total","80","37","43","2","1","1","9","2","7","3","1","2","5","4","1","0","0","0","60","28","32","0","0","0","0","0","0","1","1","0","-2"
"182005","College of Southern Nevada","2011","Total full-time Instruction/research/public service, Non-tenured not on tenure track, Instructors","70","32","38","0","0","0","4","2","2","3","0","3","5","3","2","0","0","0","58","27","31","0","0","0","0","0","0","0","0","0","-2"
"182005","College of Southern Nevada","2011","Total full-time Instruction/research/public service, Non-tenured not on tenure track total","70","32","38","0","0","0","4","2","2","3","0","3","5","3","2","0","0","0","58","27","31","0","0","0","0","0","0","0","0","0","-2"
"182500","Truckee Meadows Community College","2011","Total full-time Instruction/research/public service, Tenured, Professors","128","68","60","2","1","1","4","0","4","0","0","0","5","3","2","0","0","0","114","63","51","3","1","2","0","0","0","0","0","0","-2"
"182500","Truckee Meadows Community College","2011","Total full-time Instruction/research/public service, Tenured total","128","68","60","2","1","1","4","0","4","0","0","0","5","3","2","0","0","0","114","63","51","3","1","2","0","0","0","0","0","0","-2"
"182500","Truckee Meadows Community College","2011","Total full-time Instruction/research/public service, Non-tenured on tenure track, Instructors","3","0","3","0","0","0","0","0","0","0","0","0","0","0","0","0","0","0","2","0","2","0","0","0","1","0","1","0","0","0","-2"
"182500","Truckee Meadows Community College","2011","Total full-time Instruction/research/public service, Non-tenured on tenure track total","3","0","3","0","0","0","0","0","0","0","0","0","0","0","0","0","0","0","2","0","2","0","0","0","1","0","1","0","0","0","-2"
"182500","Truckee Meadows Community College","2011","Total full-time Instruction/research/public service, Non-tenured not on tenure track, Instructors","38","20","18","0","0","0","2","0","2","0","0","0","3","1","2","0","0","0","33","19","14","0","0","0","0","0","0","0","0","0","-2"
"182500","Truckee Meadows Community College","2011","Total full-time Instruction/research/public service, Non-tenured not on tenure track total","38","20","18","0","0","0","2","0","2","0","0","0","3","1","2","0","0","0","33","19","14","0","0","0","0","0","0","0","0","0","-2"
"183822","Bloomfield College","2011","Total full-time Instruction/research/public service, Tenured, Professors","32","12","20","0","0","0","1","0","1","6","1","5","1","0","1","0","0","0","24","11","13","0","0","0","0","0","0","0","0","0","-2"
"183822","Bloomfield College","2011","Total full-time Instruction/research/public service, Tenured, Associate professors","15","5","10","0","0","0","0","0","0","1","1","0","1","0","1","0","0","0","13","4","9","0","0","0","0","0","0","0","0","0","-2"
"183822","Bloomfield College","2011","Total full-time Instruction/research/public service, Tenured total","47","17","30","0","0","0","1","0","1","7","2","5","2","0","2","0","0","0","37","15","22","0","0","0","0","0","0","0","0","0","-2"
"183822","Bloomfield College","2011","Total full-time Instruction/research/public service, Non-tenured on tenure track, Associate professors","5","3","2","0","0","0","0","0","0","0","0","0","0","0","0","0","0","0","5","3","2","0","0","0","0","0","0","0","0","0","-2"
"183822","Bloomfield College","2011","Total full-time Instruction/research/public service, Non-tenured on tenure track, Assistant professors","14","6","8","0","0","0","2","1","1","1","0","1","2","1","1","0","0","0","9","4","5","0","0","0","0","0","0","0","0","0","-2"
"183822","Bloomfield College","2011","Total full-time Instruction/research/public service, Non-tenured on tenure track, Instructors","2","1","1","0","0","0","0","0","0","1","0","1","0","0","0","0","0","0","1","1","0","0","0","0","0","0","0","0","0","0","-2"
"183822","Bloomfield College","2011","Total full-time Instruction/research/public service, Non-tenured on tenure track total","21","10","11","0","0","0","2","1","1","2","0","2","2","1","1","0","0","0","15","8","7","0","0","0","0","0","0","0","0","0","-2"
"183822","Bloomfield College","2011","Total full-time Instruction/research/public service, Non-tenured not on tenure track, Associate professors","1","1","0","0","0","0","0","0","0","1","1","0","0","0","0","0","0","0","0","0","0","0","0","0","0","0","0","0","0","0","-2"
"183822","Bloomfield College","2011","Total full-time Instruction/research/public servicey, Non-tenured not on tenure track, Assistant professors","1","1","0","0","0","0","0","0","0","0","0","0","0","0","0","0","0","0","1","1","0","0","0","0","0","0","0","0","0","0","-2"
"183822","Bloomfield College","2011","Total full-time Instruction/research/public service, Non-tenured not on tenure track total","2","2","0","0","0","0","0","0","0","1","1","0","0","0","0","0","0","0","1","1","0","0","0","0","0","0","0","0","0","0","-2"
"183910","Caldwell University","2011","Total full-time Instruction/research/public service, Tenured, Professors","39","16","23","0","0","0","1","0","1","1","0","1","2","1","1","0","0","0","15","15","0","20","0","20","0","0","0","0","0","0","-2"
"183910","Caldwell University","2011","Total full-time Instruction/research/public service, Tenured, Associate professors","14","6","8","0","0","0","1","0","1","0","0","0","0","0","0","0","0","0","6","6","0","7","0","7","0","0","0","0","0","0","-2"
"183910","Caldwell University","2011","Total full-time Instruction/research/public service, Tenured, Assistant professors","1","0","1","0","0","0","0","0","0","0","0","0","0","0","0","0","0","0","0","0","0","1","0","1","0","0","0","0","0","0","-2"
"183910","Caldwell University","2011","Total full-time Instruction/research/public service, Tenured total","54","22","32","0","0","0","2","0","2","1","0","1","2","1","1","0","0","0","21","21","0","28","0","28","0","0","0","0","0","0","-2"
"183910","Caldwell University","2011","Total full-time Instruction/research/public service, Non-tenured on tenure track, Associate professors","6","3","3","0","0","0","0","0","0","0","0","0","0","0","0","0","0","0","6","3","3","0","0","0","0","0","0","0","0","0","-2"
"183910","Caldwell University","2011","Total full-time Instruction/research/public service, Non-tenured on tenure track, Assistant professors","16","6","10","0","0","0","1","1","0","0","0","0","1","1","0","0","0","0","12","3","9","0","0","0","2","1","1","0","0","0","-2"
"183910","Caldwell University","2011","Total full-time Instruction/research/public service, Non-tenured on tenure track total","22","9","13","0","0","0","1","1","0","0","0","0","1","1","0","0","0","0","18","6","12","0","0","0","2","1","1","0","0","0","-2"
"183910","Caldwell University","2011","Total full-time Instruction/research/public servicey, Non-tenured not on tenure track, Assistant professors","1","1","0","0","0","0","0","0","0","0","0","0","1","1","0","0","0","0","0","0","0","0","0","0","0","0","0","0","0","0","-2"
"183910","Caldwell University","2011","Total full-time Instruction/research/public service, Non-tenured not on tenure track, Instructors","2","0","2","0","0","0","0","0","0","1","0","1","0","0","0","0","0","0","1","0","1","0","0","0","0","0","0","0","0","0","-2"
"183910","Caldwell University","2011","Total full-time Instruction/research/public service, Non-tenured not on tenure track total","3","1","2","0","0","0","0","0","0","1","0","1","1","1","0","0","0","0","1","0","1","0","0","0","0","0","0","0","0","0","-2"
"184603","Fairleigh Dickinson University-Metropolitan Campus","2011","Total full-time Instruction/research/public service, Tenured, Professors","56","35","21","0","0","0","5","3","2","1","1","0","1","1","0","0","0","0","48","29","19","0","0","0","1","1","0","0","0","0","-2"
"184603","Fairleigh Dickinson University-Metropolitan Campus","2011","Total full-time Instruction/research/public service, Tenured, Associate professors","31","24","7","0","0","0","5","4","1","2","2","0","0","0","0","0","0","0","24","18","6","0","0","0","0","0","0","0","0","0","-2"
"184603","Fairleigh Dickinson University-Metropolitan Campus","2011","Total full-time Instruction/research/public service, Tenured, Assistant professors","6","2","4","0","0","0","1","0","1","0","0","0","0","0","0","0","0","0","5","2","3","0","0","0","0","0","0","0","0","0","-2"
"184603","Fairleigh Dickinson University-Metropolitan Campus","2011","Total full-time Instruction/research/public service, Tenured total","93","61","32","0","0","0","11","7","4","3","3","0","1","1","0","0","0","0","77","49","28","0","0","0","1","1","0","0","0","0","-2"
"184603","Fairleigh Dickinson University-Metropolitan Campus","2011","Total full-time Instruction/research/public service, Non-tenured on tenure track, Professors","1","1","0","0","0","0","0","0","0","0","0","0","0","0","0","0","0","0","1","1","0","0","0","0","0","0","0","0","0","0","-2"
"184603","Fairleigh Dickinson University-Metropolitan Campus","2011","Total full-time Instruction/research/public service, Non-tenured on tenure track, Associate professors","9","3","6","0","0","0","0","0","0","0","0","0","0","0","0","0","0","0","9","3","6","0","0","0","0","0","0","0","0","0","-2"
"184603","Fairleigh Dickinson University-Metropolitan Campus","2011","Total full-time Instruction/research/public service, Non-tenured on tenure track, Assistant professors","39","18","21","0","0","0","7","2","5","2","2","0","3","3","0","0","0","0","26","10","16","0","0","0","1","1","0","0","0","0","-2"
"184603","Fairleigh Dickinson University-Metropolitan Campus","2011","Total full-time Instruction/research/public service, Non-tenured on tenure track, Instructors","1","0","1","0","0","0","0","0","0","0","0","0","0","0","0","0","0","0","1","0","1","0","0","0","0","0","0","0","0","0","-2"
"184603","Fairleigh Dickinson University-Metropolitan Campus","2011","Total full-time Instruction/research/public service, Non-tenured on tenure track total","50","22","28","0","0","0","7","2","5","2","2","0","3","3","0","0","0","0","37","14","23","0","0","0","1","1","0","0","0","0","-2"
"184603","Fairleigh Dickinson University-Metropolitan Campus","2011","Total full-time Instruction/research/public service, Non-tenured not on tenure track, Associate professors","1","1","0","0","0","0","0","0","0","0","0","0","0","0","0","0","0","0","1","1","0","0","0","0","0","0","0","0","0","0","-2"
"184603","Fairleigh Dickinson University-Metropolitan Campus","2011","Total full-time Instruction/research/public servicey, Non-tenured not on tenure track, Assistant professors","1","0","1","0","0","0","0","0","0","0","0","0","0","0","0","0","0","0","1","0","1","0","0","0","0","0","0","0","0","0","-2"
"184603","Fairleigh Dickinson University-Metropolitan Campus","2011","Total full-time Instruction/research/public service, Non-tenured not on tenure track, Instructors","2","2","0","0","0","0","1","1","0","0","0","0","0","0","0","0","0","0","1","1","0","0","0","0","0","0","0","0","0","0","-2"
"184603","Fairleigh Dickinson University-Metropolitan Campus","2011","Total full-time Instruction/research/public service, Non-tenured not on tenure track, Lecturers","44","22","22","0","0","0","2","0","2","2","0","2","7","4","3","0","0","0","31","17","14","0","0","0","2","1","1","0","0","0","-2"
"184603","Fairleigh Dickinson University-Metropolitan Campus","2011","Total full-time Instruction/research/public service, Non-tenured not on tenure track total","48","25","23","0","0","0","3","1","2","2","0","2","7","4","3","0","0","0","34","19","15","0","0","0","2","1","1","0","0","0","-2"
"184612","Felician University","2011","Total full-time Instruction/research/public service, Non-tenured not on tenure track, Professors","14","6","8","0","0","0","0","0","0","1","0","1","0","0","0","0","0","0","13","6","7","0","0","0","0","0","0","0","0","0","-2"
"184612","Felician University","2011","Total full-time Instruction/research/public service, Non-tenured not on tenure track, Associate professors","40","20","20","0","0","0","0","0","0","0","0","0","3","2","1","0","0","0","31","15","16","0","0","0","6","3","3","0","0","0","-2"
"184612","Felician University","2011","Total full-time Instruction/research/public servicey, Non-tenured not on tenure track, Assistant professors","41","14","27","0","0","0","1","0","1","2","0","2","0","0","0","0","0","0","30","12","18","0","0","0","8","2","6","0","0","0","-2"
"184612","Felician University","2011","Total full-time Instruction/research/public service, Non-tenured not on tenure track, Instructors","21","3","18","0","0","0","1","1","0","0","0","0","0","0","0","0","0","0","13","2","11","0","0","0","7","0","7","0","0","0","-2"
"184612","Felician University","2011","Total full-time Instruction/research/public service, Non-tenured not on tenure track total","116","43","73","0","0","0","2","1","1","3","0","3","3","2","1","0","0","0","87","35","52","0","0","0","21","5","16","0","0","0","-2"
"185129","New Jersey City University","2011","Total full-time Instruction/research/public service, Tenured, Professors","84","44","40","0","0","0","9","4","5","10","3","7","8","3","5","0","0","0","57","34","23","0","0","0","0","0","0","0","0","0","-2"
"185129","New Jersey City University","2011","Total full-time Instruction/research/public service, Tenured, Associate professors","79","42","37","0","0","0","10","5","5","14","6","8","7","4","3","0","0","0","48","27","21","0","0","0","0","0","0","0","0","0","-2"
"185129","New Jersey City University","2011","Total full-time Instruction/research/public service, Tenured, Assistant professors","41","17","24","0","0","0","1","0","1","10","4","6","5","0","5","0","0","0","25","13","12","0","0","0","0","0","0","0","0","0","-2"
"185129","New Jersey City University","2011","Total full-time Instruction/research/public service, Tenured total","204","103","101","0","0","0","20","9","11","34","13","21","20","7","13","0","0","0","130","74","56","0","0","0","0","0","0","0","0","0","-2"
"185129","New Jersey City University","2011","Total full-time Instruction/research/public service, Non-tenured on tenure track, Associate professors","4","1","3","0","0","0","0","0","0","0","0","0","0","0","0","1","1","0","3","0","3","0","0","0","0","0","0","0","0","0","-2"
"185129","New Jersey City University","2011","Total full-time Instruction/research/public service, Non-tenured on tenure track, Assistant professors","24","10","14","0","0","0","1","0","1","2","0","2","1","1","0","9","9","0","11","0","11","0","0","0","0","0","0","0","0","0","-2"
"185129","New Jersey City University","2011","Total full-time Instruction/research/public service, Non-tenured on tenure track total","28","11","17","0","0","0","1","0","1","2","0","2","1","1","0","10","10","0","14","0","14","0","0","0","0","0","0","0","0","0","-2"
"185129","New Jersey City University","2011","Total full-time Instruction/research/public service, Non-tenured not on tenure track, Associate professors","2","0","2","0","0","0","0","0","0","0","0","0","0","0","0","0","0","0","2","0","2","0","0","0","0","0","0","0","0","0","-2"
"185129","New Jersey City University","2011","Total full-time Instruction/research/public servicey, Non-tenured not on tenure track, Assistant professors","8","3","5","0","0","0","1","0","1","0","0","0","0","0","0","0","0","0","7","3","4","0","0","0","0","0","0","0","0","0","-2"
"185129","New Jersey City University","2011","Total full-time Instruction/research/public service, Non-tenured not on tenure track, Instructors","1","0","1","0","0","0","0","0","0","0","0","0","1","0","1","0","0","0","0","0","0","0","0","0","0","0","0","0","0","0","-2"
"185129","New Jersey City University","2011","Total full-time Instruction/research/public service, Non-tenured not on tenure track total","11","3","8","0","0","0","1","0","1","0","0","0","1","0","1","0","0","0","9","3","6","0","0","0","0","0","0","0","0","0","-2"
"185590","Montclair State University","2011","Total full-time Instruction/research/public service, Tenured, Professors","172","103","69","0","0","0","23","18","5","12","6","6","9","5","4","0","0","0","125","71","54","2","2","0","1","1","0","0","0","0","-2"
"185590","Montclair State University","2011","Total full-time Instruction/research/public service, Tenured, Associate professors","187","100","87","0","0","0","24","13","11","12","6","6","14","7","7","0","0","0","133","71","62","3","3","0","1","0","1","0","0","0","-2"
"185590","Montclair State University","2011","Total full-time Instruction/research/public service, Tenured, Assistant professors","41","17","24","0","0","0","3","2","1","9","1","8","3","1","2","0","0","0","25","12","13","0","0","0","0","0","0","1","1","0","-2"
"185590","Montclair State University","2011","Total full-time Instruction/research/public service, Tenured, Instructors","1","1","0","0","0","0","0","0","0","0","0","0","0","0","0","0","0","0","1","1","0","0","0","0","0","0","0","0","0","0","-2"
"185590","Montclair State University","2011","Total full-time Instruction/research/public service, Tenured total","401","221","180","0","0","0","50","33","17","33","13","20","26","13","13","0","0","0","284","155","129","5","5","0","2","1","1","1","1","0","-2"
"185590","Montclair State University","2011","Total full-time Instruction/research/public service, Non-tenured on tenure track, Professors","10","6","4","0","0","0","1","1","0","0","0","0","0","0","0","0","0","0","9","5","4","0","0","0","0","0","0","0","0","0","-2"
"185590","Montclair State University","2011","Total full-time Instruction/research/public service, Non-tenured on tenure track, Associate professors","15","8","7","0","0","0","1","0","1","0","0","0","2","2","0","0","0","0","10","5","5","0","0","0","1","0","1","1","1","0","-2"
"185590","Montclair State University","2011","Total full-time Instruction/research/public service, Non-tenured on tenure track, Assistant professors","105","45","60","0","0","0","16","7","9","7","5","2","2","0","2","0","0","0","53","22","31","1","0","1","13","7","6","13","4","9","-2"
"185590","Montclair State University","2011","Total full-time Instruction/research/public service, Non-tenured on tenure track total","130","59","71","0","0","0","18","8","10","7","5","2","4","2","2","0","0","0","72","32","40","1","0","1","14","7","7","14","5","9","-2"
"185590","Montclair State University","2011","Total full-time Instruction/research/public service, Non-tenured not on tenure track, Associate professors","3","2","1","0","0","0","0","0","0","0","0","0","0","0","0","0","0","0","3","2","1","0","0","0","0","0","0","0","0","0","-2"
"185590","Montclair State University","2011","Total full-time Instruction/research/public servicey, Non-tenured not on tenure track, Assistant professors","20","6","14","0","0","0","1","0","1","0","0","0","4","0","4","0","0","0","11","5","6","1","0","1","3","1","2","0","0","0","-2"
"185590","Montclair State University","2011","Total full-time Instruction/research/public service, Non-tenured not on tenure track, Instructors","15","1","14","0","0","0","0","0","0","0","0","0","2","1","1","0","0","0","11","0","11","0","0","0","2","0","2","0","0","0","-2"
"185590","Montclair State University","2011","Total full-time Instruction/research/public service, Non-tenured not on tenure track total","38","9","29","0","0","0","1","0","1","0","0","0","6","1","5","0","0","0","25","7","18","1","0","1","5","1","4","0","0","0","-2"
"186399","Rutgers University-Newark","2011","Total full-time Instruction/research/public service, Tenured, Professors","155","109","46","0","0","0","15","14","1","8","6","2","5","3","2","0","0","0","121","83","38","0","0","0","2","1","1","4","2","2","-2"
"186399","Rutgers University-Newark","2011","Total full-time Instruction/research/public service, Tenured, Associate professors","103","62","41","0","0","0","8","4","4","13","7","6","3","3","0","0","0","0","71","41","30","0","0","0","0","0","0","8","7","1","-2"
"186399","Rutgers University-Newark","2011","Total full-time Instruction/research/public service, Tenured total","258","171","87","0","0","0","23","18","5","21","13","8","8","6","2","0","0","0","192","124","68","0","0","0","2","1","1","12","9","3","-2"
"186399","Rutgers University-Newark","2011","Total full-time Instruction/research/public service, Non-tenured on tenure track, Professors","2","2","0","0","0","0","0","0","0","0","0","0","0","0","0","0","0","0","2","2","0","0","0","0","0","0","0","0","0","0","-2"
"186399","Rutgers University-Newark","2011","Total full-time Instruction/research/public service, Non-tenured on tenure track, Associate professors","11","6","5","0","0","0","2","1","1","1","1","0","0","0","0","0","0","0","5","3","2","0","0","0","2","1","1","1","0","1","-2"
"186399","Rutgers University-Newark","2011","Total full-time Instruction/research/public service, Non-tenured on tenure track, Assistant professors","116","63","53","3","0","3","15","8","7","8","2","6","6","5","1","0","0","0","31","18","13","0","0","0","28","14","14","25","16","9","-2"
"186399","Rutgers University-Newark","2011","Total full-time Instruction/research/public service, Non-tenured on tenure track, Instructors","1","0","1","0","0","0","0","0","0","0","0","0","0","0","0","0","0","0","0","0","0","0","0","0","1","0","1","0","0","0","-2"
"186399","Rutgers University-Newark","2011","Total full-time Instruction/research/public service, Non-tenured on tenure track total","130","71","59","3","0","3","17","9","8","9","3","6","6","5","1","0","0","0","38","23","15","0","0","0","31","15","16","26","16","10","-2"
"186399","Rutgers University-Newark","2011","Total full-time Instruction/research/public service, Non-tenured not on tenure track, Professors","15","6","9","0","0","0","2","1","1","2","1","1","1","1","0","0","0","0","9","3","6","0","0","0","1","0","1","0","0","0","-2"
"186399","Rutgers University-Newark","2011","Total full-time Instruction/research/public service, Non-tenured not on tenure track, Associate professors","6","2","4","0","0","0","0","0","0","0","0","0","0","0","0","0","0","0","3","1","2","0","0","0","2","1","1","1","0","1","-2"
"186399","Rutgers University-Newark","2011","Total full-time Instruction/research/public servicey, Non-tenured not on tenure track, Assistant professors","22","12","10","0","0","0","1","1","0","0","0","0","0","0","0","0","0","0","9","5","4","1","0","1","8","5","3","3","1","2","-2"
"186399","Rutgers University-Newark","2011","Total full-time Instruction/research/public service, Non-tenured not on tenure track, Instructors","82","48","34","0","0","0","3","3","0","6","4","2","2","1","1","0","0","0","52","32","20","1","1","0","10","4","6","8","3","5","-2"
"186399","Rutgers University-Newark","2011","Total full-time Instruction/research/public service, Non-tenured not on tenure track, Lecturers","7","3","4","0","0","0","1","0","1","0","0","0","0","0","0","0","0","0","2","1","1","0","0","0","2","1","1","2","1","1","-2"
"186399","Rutgers University-Newark","2011","Total full-time Instruction/research/public service, Non-tenured not on tenure track, No academic rank","30","20","10","0","0","0","1","1","0","0","0","0","0","0","0","0","0","0","4","1","3","0","0","0","10","7","3","15","11","4","-2"
"186399","Rutgers University-Newark","2011","Total full-time Instruction/research/public service, Non-tenured not on tenure track total","162","91","71","0","0","0","8","6","2","8","5","3","3","2","1","0","0","0","79","43","36","2","1","1","33","18","15","29","16","13","-2"
"186432","Saint Peter's University","2011","Total full-time Instruction/research/public service, Tenured, Professors","33","19","14","0","0","0","0","0","0","0","0","0","1","0","1","0","0","0","32","19","13","0","0","0","0","0","0","0","0","0","-2"
"186432","Saint Peter's University","2011","Total full-time Instruction/research/public service, Tenured, Associate professors","37","20","17","0","0","0","1","1","0","1","0","1","2","1","1","0","0","0","33","18","15","0","0","0","0","0","0","0","0","0","-2"
"186432","Saint Peter's University","2011","Total full-time Instruction/research/public service, Tenured, Assistant professors","3","2","1","0","0","0","0","0","0","1","1","0","0","0","0","0","0","0","2","1","1","0","0","0","0","0","0","0","0","0","-2"
"186432","Saint Peter's University","2011","Total full-time Instruction/research/public service, Tenured, Lecturers","4","2","2","0","0","0","1","0","1","1","0","1","0","0","0","0","0","0","2","2","0","0","0","0","0","0","0","0","0","0","-2"
"186432","Saint Peter's University","2011","Total full-time Instruction/research/public service, Tenured total","77","43","34","0","0","0","2","1","1","3","1","2","3","1","2","0","0","0","69","40","29","0","0","0","0","0","0","0","0","0","-2"
"186432","Saint Peter's University","2011","Total full-time Instruction/research/public service, Non-tenured on tenure track, Associate professors","1","1","0","0","0","0","0","0","0","0","0","0","0","0","0","0","0","0","1","1","0","0","0","0","0","0","0","0","0","0","-2"
"186432","Saint Peter's University","2011","Total full-time Instruction/research/public service, Non-tenured on tenure track, Assistant professors","21","11","10","0","0","0","1","1","0","1","1","0","0","0","0","0","0","0","18","8","10","0","0","0","0","0","0","1","1","0","-2"
"186432","Saint Peter's University","2011","Total full-time Instruction/research/public service, Non-tenured on tenure track, Instructors","2","1","1","0","0","0","1","0","1","0","0","0","0","0","0","0","0","0","1","1","0","0","0","0","0","0","0","0","0","0","-2"
"186432","Saint Peter's University","2011","Total full-time Instruction/research/public service, Non-tenured on tenure track total","24","13","11","0","0","0","2","1","1","1","1","0","0","0","0","0","0","0","20","10","10","0","0","0","0","0","0","1","1","0","-2"
"186432","Saint Peter's University","2011","Total full-time Instruction/research/public servicey, Non-tenured not on tenure track, Assistant professors","1","1","0","0","0","0","0","0","0","0","0","0","0","0","0","0","0","0","1","1","0","0","0","0","0","0","0","0","0","0","-2"
"186432","Saint Peter's University","2011","Total full-time Instruction/research/public service, Non-tenured not on tenure track, Lecturers","9","3","6","0","0","0","0","0","0","0","0","0","0","0","0","0","0","0","9","3","6","0","0","0","0","0","0","0","0","0","-2"
"186432","Saint Peter's University","2011","Total full-time Instruction/research/public service, Non-tenured not on tenure track, No academic rank","6","1","5","0","0","0","1","0","1","0","0","0","0","0","0","0","0","0","5","1","4","0","0","0","0","0","0","0","0","0","-2"
"186432","Saint Peter's University","2011","Total full-time Instruction/research/public service, Non-tenured not on tenure track total","16","5","11","0","0","0","1","0","1","0","0","0","0","0","0","0","0","0","15","5","10","0","0","0","0","0","0","0","0","0","-2"
"187444","William Paterson University of New Jersey","2011","Total full-time Instruction/research/public service, Tenured, Professors","146","93","53","0","0","0","32","25","7","8","6","2","10","5","5","0","0","0","95","56","39","1","1","0","0","0","0","0","0","0","-2"
"187444","William Paterson University of New Jersey","2011","Total full-time Instruction/research/public service, Tenured, Associate professors","100","49","51","0","0","0","11","5","6","14","10","4","6","2","4","0","0","0","65","31","34","3","0","3","0","0","0","1","1","0","-2"
"187444","William Paterson University of New Jersey","2011","Total full-time Instruction/research/public service, Tenured, Assistant professors","46","19","27","0","0","0","5","2","3","8","4","4","6","2","4","0","0","0","27","11","16","0","0","0","0","0","0","0","0","0","-2"
"187444","William Paterson University of New Jersey","2011","Total full-time Instruction/research/public service, Tenured total","292","161","131","0","0","0","48","32","16","30","20","10","22","9","13","0","0","0","187","98","89","4","1","3","0","0","0","1","1","0","-2"
"187444","William Paterson University of New Jersey","2011","Total full-time Instruction/research/public service, Non-tenured on tenure track, Associate professors","7","6","1","0","0","0","2","2","0","0","0","0","0","0","0","0","0","0","5","4","1","0","0","0","0","0","0","0","0","0","-2"
"187444","William Paterson University of New Jersey","2011","Total full-time Instruction/research/public service, Non-tenured on tenure track, Assistant professors","67","23","44","0","0","0","8","1","7","3","2","1","7","4","3","0","0","0","44","14","30","0","0","0","0","0","0","5","2","3","-2"
"187444","William Paterson University of New Jersey","2011","Total full-time Instruction/research/public service, Non-tenured on tenure track, Instructors","3","0","3","0","0","0","0","0","0","0","0","0","0","0","0","0","0","0","2","0","2","0","0","0","0","0","0","1","0","1","-2"
"187444","William Paterson University of New Jersey","2011","Total full-time Instruction/research/public service, Non-tenured on tenure track total","77","29","48","0","0","0","10","3","7","3","2","1","7","4","3","0","0","0","51","18","33","0","0","0","0","0","0","6","2","4","-2"
"187444","William Paterson University of New Jersey","2011","Total full-time Instruction/research/public servicey, Non-tenured not on tenure track, Assistant professors","8","1","7","0","0","0","0","0","0","1","1","0","1","0","1","0","0","0","6","0","6","0","0","0","0","0","0","0","0","0","-2"
"187444","William Paterson University of New Jersey","2011","Total full-time Instruction/research/public service, Non-tenured not on tenure track, Instructors","12","1","11","0","0","0","0","0","0","0","0","0","1","0","1","0","0","0","10","1","9","1","0","1","0","0","0","0","0","0","-2"
"187444","William Paterson University of New Jersey","2011","Total full-time Instruction/research/public service, Non-tenured not on tenure track total","20","2","18","0","0","0","0","0","0","1","1","0","2","0","2","0","0","0","16","1","15","1","0","1","0","0","0","0","0","0","-2"
"187648","Eastern New Mexico University-Main Campus","2011","Total full-time Instruction/research/public service, Tenured, Professors","40","26","14","1","0","1","1","1","0","0","0","0","4","3","1","0","0","0","32","21","11","2","1","1","0","0","0","0","0","0","-2"
"187648","Eastern New Mexico University-Main Campus","2011","Total full-time Instruction/research/public service, Tenured, Associate professors","31","14","17","0","0","0","1","1","0","0","0","0","1","1","0","0","0","0","27","11","16","1","1","0","0","0","0","1","0","1","-2"
"187648","Eastern New Mexico University-Main Campus","2011","Total full-time Instruction/research/public service, Tenured, Assistant professors","3","2","1","0","0","0","0","0","0","0","0","0","0","0","0","0","0","0","3","2","1","0","0","0","0","0","0","0","0","0","-2"
"187648","Eastern New Mexico University-Main Campus","2011","Total full-time Instruction/research/public service, Tenured, Instructors","3","2","1","0","0","0","0","0","0","0","0","0","0","0","0","0","0","0","3","2","1","0","0","0","0","0","0","0","0","0","-2"
"187648","Eastern New Mexico University-Main Campus","2011","Total full-time Instruction/research/public service, Tenured total","77","44","33","1","0","1","2","2","0","0","0","0","5","4","1","0","0","0","65","36","29","3","2","1","0","0","0","1","0","1","-2"
"187648","Eastern New Mexico University-Main Campus","2011","Total full-time Instruction/research/public service, Non-tenured on tenure track, Associate professors","2","1","1","0","0","0","0","0","0","0","0","0","0","0","0","0","0","0","2","1","1","0","0","0","0","0","0","0","0","0","-2"
"187648","Eastern New Mexico University-Main Campus","2011","Total full-time Instruction/research/public service, Non-tenured on tenure track, Assistant professors","40","26","14","0","0","0","2","2","0","1","0","1","2","2","0","0","0","0","31","19","12","2","1","1","2","2","0","0","0","0","-2"
"187648","Eastern New Mexico University-Main Campus","2011","Total full-time Instruction/research/public service, Non-tenured on tenure track, Instructors","10","2","8","0","0","0","0","0","0","0","0","0","0","0","0","0","0","0","9","2","7","0","0","0","1","0","1","0","0","0","-2"
"187648","Eastern New Mexico University-Main Campus","2011","Total full-time Instruction/research/public service, Non-tenured on tenure track total","52","29","23","0","0","0","2","2","0","1","0","1","2","2","0","0","0","0","42","22","20","2","1","1","3","2","1","0","0","0","-2"
"187648","Eastern New Mexico University-Main Campus","2011","Total full-time Instruction/research/public servicey, Non-tenured not on tenure track, Assistant professors","1","1","0","0","0","0","0","0","0","0","0","0","0","0","0","0","0","0","1","1","0","0","0","0","0","0","0","0","0","0","-2"
"187648","Eastern New Mexico University-Main Campus","2011","Total full-time Instruction/research/public service, Non-tenured not on tenure track, Instructors","14","4","10","0","0","0","0","0","0","1","0","1","0","0","0","0","0","0","13","4","9","0","0","0","0","0","0","0","0","0","-2"
"187648","Eastern New Mexico University-Main Campus","2011","Total full-time Instruction/research/public service, Non-tenured not on tenure track, Lecturers","1","0","1","0","0","0","0","0","0","0","0","0","0","0","0","0","0","0","1","0","1","0","0","0","0","0","0","0","0","0","-2"
"187648","Eastern New Mexico University-Main Campus","2011","Total full-time Instruction/research/public service, Non-tenured not on tenure track total","16","5","11","0","0","0","0","0","0","1","0","1","0","0","0","0","0","0","15","5","10","0","0","0","0","0","0","0","0","0","-2"
"187897","New Mexico Highlands University","2011","Total full-time Instruction/research/public service, Tenured, Professors","22","15","7","0","0","0","0","0","0","1","1","0","5","4","1","0","0","0","15","10","5","0","0","0","1","0","1","0","0","0","-2"
"187897","New Mexico Highlands University","2011","Total full-time Instruction/research/public service, Tenured, Associate professors","31","21","10","0","0","0","0","0","0","1","1","0","7","5","2","0","0","0","19","12","7","1","1","0","1","1","0","2","1","1","-2"
"187897","New Mexico Highlands University","2011","Total full-time Instruction/research/public service, Tenured, Assistant professors","3","3","0","0","0","0","0","0","0","0","0","0","2","2","0","0","0","0","0","0","0","0","0","0","1","1","0","0","0","0","-2"
"187897","New Mexico Highlands University","2011","Total full-time Instruction/research/public service, Tenured total","56","39","17","0","0","0","0","0","0","2","2","0","14","11","3","0","0","0","34","22","12","1","1","0","3","2","1","2","1","1","-2"
"187897","New Mexico Highlands University","2011","Total full-time Instruction/research/public service, Non-tenured on tenure track, Associate professors","8","3","5","0","0","0","0","0","0","0","0","0","4","1","3","0","0","0","3","2","1","1","0","1","0","0","0","0","0","0","-2"
"187897","New Mexico Highlands University","2011","Total full-time Instruction/research/public service, Non-tenured on tenure track, Assistant professors","23","9","14","0","0","0","3","2","1","0","0","0","4","1","3","0","0","0","14","6","8","0","0","0","0","0","0","2","0","2","-2"
"187897","New Mexico Highlands University","2011","Total full-time Instruction/research/public service, Non-tenured on tenure track total","31","12","19","0","0","0","3","2","1","0","0","0","8","2","6","0","0","0","17","8","9","1","0","1","0","0","0","2","0","2","-2"
"187897","New Mexico Highlands University","2011","Total full-time Instruction/research/public service, Non-tenured not on tenure track, Professors","2","1","1","0","0","0","0","0","0","0","0","0","1","0","1","0","0","0","1","1","0","0","0","0","0","0","0","0","0","0","-2"
"187897","New Mexico Highlands University","2011","Total full-time Instruction/research/public service, Non-tenured not on tenure track, Associate professors","3","1","2","0","0","0","0","0","0","0","0","0","1","0","1","0","0","0","2","1","1","0","0","0","0","0","0","0","0","0","-2"
"187897","New Mexico Highlands University","2011","Total full-time Instruction/research/public servicey, Non-tenured not on tenure track, Assistant professors","18","9","9","0","0","0","0","0","0","0","0","0","6","1","5","0","0","0","11","7","4","0","0","0","0","0","0","1","1","0","-2"
"187897","New Mexico Highlands University","2011","Total full-time Instruction/research/public service, Non-tenured not on tenure track, Instructors","13","8","5","0","0","0","1","0","1","1","0","1","5","4","1","0","0","0","4","2","2","1","1","0","1","1","0","0","0","0","-2"
"187897","New Mexico Highlands University","2011","Total full-time Instruction/research/public service, Non-tenured not on tenure track, No academic rank","12","5","7","0","0","0","1","1","0","0","0","0","3","0","3","0","0","0","7","3","4","0","0","0","0","0","0","1","1","0","-2"
"187897","New Mexico Highlands University","2011","Total full-time Instruction/research/public service, Non-tenured not on tenure track total","48","24","24","0","0","0","2","1","1","1","0","1","16","5","11","0","0","0","25","14","11","1","1","0","1","1","0","2","2","0","-2"
"187985","University of New Mexico-Main Campus","2011","Total full-time Instruction/research/public service, Tenured, Professors","388","259","129","5","3","2","26","20","6","3","2","1","38","20","18","0","0","0","310","210","100","0","0","0","6","4","2","0","0","0","-2"
"187985","University of New Mexico-Main Campus","2011","Total full-time Instruction/research/public service, Tenured, Associate professors","300","159","141","10","2","8","25","17","8","3","1","2","41","19","22","0","0","0","213","114","99","1","1","0","6","4","2","1","1","0","-2"
"187985","University of New Mexico-Main Campus","2011","Total full-time Instruction/research/public service, Tenured, Assistant professors","4","3","1","0","0","0","0","0","0","0","0","0","1","1","0","0","0","0","3","2","1","0","0","0","0","0","0","0","0","0","-2"
"187985","University of New Mexico-Main Campus","2011","Total full-time Instruction/research/public service, Tenured total","692","421","271","15","5","10","51","37","14","6","3","3","80","40","40","0","0","0","526","326","200","1","1","0","12","8","4","1","1","0","-2"
"187985","University of New Mexico-Main Campus","2011","Total full-time Instruction/research/public service, Non-tenured on tenure track, Professors","3","3","0","0","0","0","1","1","0","0","0","0","0","0","0","0","0","0","2","2","0","0","0","0","0","0","0","0","0","0","-2"
"187985","University of New Mexico-Main Campus","2011","Total full-time Instruction/research/public service, Non-tenured on tenure track, Associate professors","11","8","3","1","0","1","1","1","0","1","1","0","1","0","1","0","0","0","7","6","1","0","0","0","0","0","0","0","0","0","-2"
"187985","University of New Mexico-Main Campus","2011","Total full-time Instruction/research/public service, Non-tenured on tenure track, Assistant professors","199","94","105","6","3","3","27","19","8","8","3","5","30","11","19","0","0","0","109","49","60","2","0","2","12","5","7","5","4","1","-2"
"187985","University of New Mexico-Main Campus","2011","Total full-time Instruction/research/public service, Non-tenured on tenure track total","213","105","108","7","3","4","29","21","8","9","4","5","31","11","20","0","0","0","118","57","61","2","0","2","12","5","7","5","4","1","-2"
"187985","University of New Mexico-Main Campus","2011","Total full-time Instruction/research/public service, Non-tenured not on tenure track, Professors","103","67","36","0","0","0","6","4","2","0","0","0","5","3","2","0","0","0","88","57","31","0","0","0","3","2","1","1","1","0","-2"
"187985","University of New Mexico-Main Campus","2011","Total full-time Instruction/research/public service, Non-tenured not on tenure track, Associate professors","125","65","60","2","1","1","11","6","5","2","0","2","9","3","6","0","0","0","95","53","42","1","1","0","5","1","4","0","0","0","-2"
"187985","University of New Mexico-Main Campus","2011","Total full-time Instruction/research/public servicey, Non-tenured not on tenure track, Assistant professors","327","166","161","3","0","3","39","18","21","8","5","3","49","19","30","1","0","1","210","114","96","2","2","0","6","3","3","9","5","4","-2"
"187985","University of New Mexico-Main Campus","2011","Total full-time Instruction/research/public service, Non-tenured not on tenure track, Instructors","30","12","18","1","1","0","1","0","1","0","0","0","8","2","6","0","0","0","19","8","11","0","0","0","0","0","0","1","1","0","-2"
"187985","University of New Mexico-Main Campus","2011","Total full-time Instruction/research/public service, Non-tenured not on tenure track, Lecturers","150","60","90","3","1","2","1","0","1","8","5","3","19","9","10","0","0","0","113","41","72","0","0","0","6","4","2","0","0","0","-2"
"187985","University of New Mexico-Main Campus","2011","Total full-time Instruction/research/public service, Non-tenured not on tenure track, No academic rank","149","93","56","4","0","4","2","2","0","2","2","0","16","9","7","0","0","0","57","37","20","1","1","0","33","21","12","34","21","13","-2"
"187985","University of New Mexico-Main Campus","2011","Total full-time Instruction/research/public service, Non-tenured not on tenure track total","884","463","421","13","3","10","60","30","30","20","12","8","106","45","61","1","0","1","582","310","272","4","4","0","53","31","22","45","28","17","-2"
"188030","New Mexico State University-Main Campus","2011","Total full-time Instruction/research/public service, Tenured, Professors","233","172","61","1","1","0","16","14","2","2","2","0","15","13","2","0","0","0","189","133","56","1","1","0","8","7","1","1","1","0","-2"
"188030","New Mexico State University-Main Campus","2011","Total full-time Instruction/research/public service, Tenured, Associate professors","222","133","89","4","3","1","18","12","6","4","2","2","33","17","16","0","0","0","151","90","61","2","1","1","3","2","1","7","6","1","-2"
"188030","New Mexico State University-Main Campus","2011","Total full-time Instruction/research/public service, Tenured, Assistant professors","14","10","4","1","1","0","0","0","0","0","0","0","2","2","0","0","0","0","10","6","4","0","0","0","1","1","0","0","0","0","-2"
"188030","New Mexico State University-Main Campus","2011","Total full-time Instruction/research/public service, Tenured, Instructors","1","1","0","0","0","0","0","0","0","0","0","0","1","1","0","0","0","0","0","0","0","0","0","0","0","0","0","0","0","0","-2"
"188030","New Mexico State University-Main Campus","2011","Total full-time Instruction/research/public service, Tenured total","470","316","154","6","5","1","34","26","8","6","4","2","51","33","18","0","0","0","350","229","121","3","2","1","12","10","2","8","7","1","-2"
"188030","New Mexico State University-Main Campus","2011","Total full-time Instruction/research/public service, Non-tenured on tenure track, Associate professors","8","6","2","0","0","0","1","1","0","0","0","0","0","0","0","0","0","0","5","4","1","2","1","1","0","0","0","0","0","0","-2"
"188030","New Mexico State University-Main Campus","2011","Total full-time Instruction/research/public service, Non-tenured on tenure track, Assistant professors","175","86","89","3","0","3","18","10","8","3","2","1","31","15","16","0","0","0","80","31","49","0","0","0","19","13","6","21","15","6","-2"
"188030","New Mexico State University-Main Campus","2011","Total full-time Instruction/research/public service, Non-tenured on tenure track, Instructors","1","1","0","0","0","0","0","0","0","0","0","0","1","1","0","0","0","0","0","0","0","0","0","0","0","0","0","0","0","0","-2"
"188030","New Mexico State University-Main Campus","2011","Total full-time Instruction/research/public service, Non-tenured on tenure track total","184","93","91","3","0","3","19","11","8","3","2","1","32","16","16","0","0","0","85","35","50","2","1","1","19","13","6","21","15","6","-2"
"188030","New Mexico State University-Main Campus","2011","Total full-time Instruction/research/public service, Non-tenured not on tenure track, Professors","18","11","7","0","0","0","0","0","0","0","0","0","2","1","1","0","0","0","16","10","6","0","0","0","0","0","0","0","0","0","-2"
"188030","New Mexico State University-Main Campus","2011","Total full-time Instruction/research/public service, Non-tenured not on tenure track, Associate professors","32","13","19","1","1","0","0","0","0","2","1","1","6","2","4","0","0","0","22","8","14","0","0","0","0","0","0","1","1","0","-2"
"188030","New Mexico State University-Main Campus","2011","Total full-time Instruction/research/public servicey, Non-tenured not on tenure track, Assistant professors","69","26","43","1","1","0","6","2","4","0","0","0","12","3","9","0","0","0","45","19","26","0","0","0","2","1","1","3","0","3","-2"
"188030","New Mexico State University-Main Campus","2011","Total full-time Instruction/research/public service, Non-tenured not on tenure track, Instructors","35","11","24","2","1","1","0","0","0","0","0","0","10","3","7","0","0","0","17","4","13","0","0","0","6","3","3","0","0","0","-2"
"188030","New Mexico State University-Main Campus","2011","Total full-time Instruction/research/public service, Non-tenured not on tenure track total","154","61","93","4","3","1","6","2","4","2","1","1","30","9","21","0","0","0","100","41","59","0","0","0","8","4","4","4","1","3","-2"
"188058","Northern New Mexico College","2011","Total full-time Instruction/research/public service, Tenured, Associate professors","16","7","9","0","0","0","2","1","1","0","0","0","7","3","4","0","0","0","7","3","4","0","0","0","0","0","0","0","0","0","-2"
"188058","Northern New Mexico College","2011","Total full-time Instruction/research/public service, Tenured total","16","7","9","0","0","0","2","1","1","0","0","0","7","3","4","0","0","0","7","3","4","0","0","0","0","0","0","0","0","0","-2"
"188058","Northern New Mexico College","2011","Total full-time Instruction/research/public service, Non-tenured on tenure track, Assistant professors","28","12","16","1","1","0","1","0","1","1","1","0","15","7","8","0","0","0","10","3","7","0","0","0","0","0","0","0","0","0","-2"
"188058","Northern New Mexico College","2011","Total full-time Instruction/research/public service, Non-tenured on tenure track total","28","12","16","1","1","0","1","0","1","1","1","0","15","7","8","0","0","0","10","3","7","0","0","0","0","0","0","0","0","0","-2"
"188058","Northern New Mexico College","2011","Total full-time Instruction/research/public service, Non-tenured not on tenure track, Instructors","6","3","3","0","0","0","0","0","0","0","0","0","6","3","3","0","0","0","0","0","0","0","0","0","0","0","0","0","0","0","-2"
"188058","Northern New Mexico College","2011","Total full-time Instruction/research/public service, Non-tenured not on tenure track total","6","3","3","0","0","0","0","0","0","0","0","0","6","3","3","0","0","0","0","0","0","0","0","0","0","0","0","0","0","0","-2"
"188182","University of the Southwest","2011","Total full-time Instruction/research/public service, Non-tenured not on tenure track, Professors","4","1","3","0","0","0","0","0","0","0","0","0","0","0","0","0","0","0","4","1","3","0","0","0","0","0","0","0","0","0","-2"
"188182","University of the Southwest","2011","Total full-time Instruction/research/public service, Non-tenured not on tenure track, Associate professors","5","3","2","0","0","0","0","0","0","0","0","0","0","0","0","0","0","0","5","3","2","0","0","0","0","0","0","0","0","0","-2"
"188182","University of the Southwest","2011","Total full-time Instruction/research/public servicey, Non-tenured not on tenure track, Assistant professors","6","5","1","0","0","0","1","1","0","0","0","0","2","1","1","0","0","0","3","3","0","0","0","0","0","0","0","0","0","0","-2"
"188182","University of the Southwest","2011","Total full-time Instruction/research/public service, Non-tenured not on tenure track total","15","9","6","0","0","0","1","1","0","0","0","0","2","1","1","0","0","0","12","7","5","0","0","0","0","0","0","0","0","0","-2"
"188304","Western New Mexico University","2011","Total full-time Instruction/research/public service, Tenured, Professors","38","15","23","0","0","0","0","0","0","0","0","0","3","1","2","0","0","0","29","11","18","0","0","0","6","3","3","0","0","0","-2"
"188304","Western New Mexico University","2011","Total full-time Instruction/research/public service, Tenured, Associate professors","12","6","6","0","0","0","0","0","0","0","0","0","2","2","0","0","0","0","9","4","5","0","0","0","1","0","1","0","0","0","-2"
"188304","Western New Mexico University","2011","Total full-time Instruction/research/public service, Tenured total","50","21","29","0","0","0","0","0","0","0","0","0","5","3","2","0","0","0","38","15","23","0","0","0","7","3","4","0","0","0","-2"
"188304","Western New Mexico University","2011","Total full-time Instruction/research/public service, Non-tenured on tenure track, Associate professors","8","4","4","0","0","0","0","0","0","0","0","0","1","0","1","0","0","0","5","2","3","0","0","0","2","2","0","0","0","0","-2"
"188304","Western New Mexico University","2011","Total full-time Instruction/research/public service, Non-tenured on tenure track, Assistant professors","30","17","13","0","0","0","3","3","0","0","0","0","8","5","3","0","0","0","16","8","8","0","0","0","3","1","2","0","0","0","-2"
"188304","Western New Mexico University","2011","Total full-time Instruction/research/public service, Non-tenured on tenure track total","38","21","17","0","0","0","3","3","0","0","0","0","9","5","4","0","0","0","21","10","11","0","0","0","5","3","2","0","0","0","-2"
"188304","Western New Mexico University","2011","Total full-time Instruction/research/public service, Non-tenured not on tenure track, Professors","1","1","0","0","0","0","0","0","0","0","0","0","0","0","0","0","0","0","1","1","0","0","0","0","0","0","0","0","0","0","-2"
"188304","Western New Mexico University","2011","Total full-time Instruction/research/public servicey, Non-tenured not on tenure track, Assistant professors","11","2","9","0","0","0","0","0","0","0","0","0","4","0","4","0","0","0","7","2","5","0","0","0","0","0","0","0","0","0","-2"
"188304","Western New Mexico University","2011","Total full-time Instruction/research/public service, Non-tenured not on tenure track, Instructors","3","1","2","0","0","0","0","0","0","0","0","0","1","1","0","0","0","0","2","0","2","0","0","0","0","0","0","0","0","0","-2"
"188304","Western New Mexico University","2011","Total full-time Instruction/research/public service, Non-tenured not on tenure track total","15","4","11","0","0","0","0","0","0","0","0","0","5","1","4","0","0","0","10","3","7","0","0","0","0","0","0","0","0","0","-2"
"188340","Vaughn College of Aeronautics and Technology","2011","Total full-time Instruction/research/public service, Tenured, Professors","8","7","1","0","0","0","1","1","0","1","0","1","0","0","0","1","1","0","5","5","0","0","0","0","0","0","0","0","0","0","-2"
"188340","Vaughn College of Aeronautics and Technology","2011","Total full-time Instruction/research/public service, Tenured, Associate professors","10","8","2","0","0","0","0","0","0","0","0","0","0","0","0","1","1","0","9","7","2","0","0","0","0","0","0","0","0","0","-2"
"188340","Vaughn College of Aeronautics and Technology","2011","Total full-time Instruction/research/public service, Tenured total","18","15","3","0","0","0","1","1","0","1","0","1","0","0","0","2","2","0","14","12","2","0","0","0","0","0","0","0","0","0","-2"
"188340","Vaughn College of Aeronautics and Technology","2011","Total full-time Instruction/research/public service, Non-tenured on tenure track, Professors","3","2","1","0","0","0","0","0","0","0","0","0","0","0","0","0","0","0","3","2","1","0","0","0","0","0","0","0","0","0","-2"
"188340","Vaughn College of Aeronautics and Technology","2011","Total full-time Instruction/research/public service, Non-tenured on tenure track, Associate professors","1","1","0","0","0","0","0","0","0","1","1","0","0","0","0","0","0","0","0","0","0","0","0","0","0","0","0","0","0","0","-2"
"188340","Vaughn College of Aeronautics and Technology","2011","Total full-time Instruction/research/public service, Non-tenured on tenure track, Assistant professors","2","1","1","0","0","0","1","0","1","0","0","0","1","1","0","0","0","0","0","0","0","0","0","0","0","0","0","0","0","0","-2"
"188340","Vaughn College of Aeronautics and Technology","2011","Total full-time Instruction/research/public service, Non-tenured on tenure track total","6","4","2","0","0","0","1","0","1","1","1","0","1","1","0","0","0","0","3","2","1","0","0","0","0","0","0","0","0","0","-2"
"188340","Vaughn College of Aeronautics and Technology","2011","Total full-time Instruction/research/public service, Non-tenured not on tenure track, Professors","1","1","0","0","0","0","0","0","0","1","1","0","0","0","0","0","0","0","0","0","0","0","0","0","0","0","0","0","0","0","-2"
"188340","Vaughn College of Aeronautics and Technology","2011","Total full-time Instruction/research/public service, Non-tenured not on tenure track, Associate professors","1","1","0","0","0","0","0","0","0","1","1","0","0","0","0","0","0","0","0","0","0","0","0","0","0","0","0","0","0","0","-2"
"188340","Vaughn College of Aeronautics and Technology","2011","Total full-time Instruction/research/public servicey, Non-tenured not on tenure track, Assistant professors","4","3","1","0","0","0","3","2","1","0","0","0","0","0","0","0","0","0","1","1","0","0","0","0","0","0","0","0","0","0","-2"
"188340","Vaughn College of Aeronautics and Technology","2011","Total full-time Instruction/research/public service, Non-tenured not on tenure track total","6","5","1","0","0","0","3","2","1","2","2","0","0","0","0","0","0","0","1","1","0","0","0","0","0","0","0","0","0","0","-2"
"189413","Boricua College","2011","Total full-time Instruction/research/public service, Non-tenured not on tenure track, Professors","6","3","3","0","0","0","0","0","0","1","1","0","5","2","3","0","0","0","0","0","0","0","0","0","0","0","0","0","0","0","-2"
"189413","Boricua College","2011","Total full-time Instruction/research/public service, Non-tenured not on tenure track, Associate professors","10","6","4","0","0","0","0","0","0","0","0","0","9","6","3","0","0","0","1","0","1","0","0","0","0","0","0","0","0","0","-2"
"189413","Boricua College","2011","Total full-time Instruction/research/public servicey, Non-tenured not on tenure track, Assistant professors","15","7","8","0","0","0","0","0","0","0","0","0","14","7","7","0","0","0","1","0","1","0","0","0","0","0","0","0","0","0","-2"
"189413","Boricua College","2011","Total full-time Instruction/research/public service, Non-tenured not on tenure track, Instructors","29","17","12","0","0","0","0","0","0","2","1","1","26","16","10","0","0","0","1","0","1","0","0","0","0","0","0","0","0","0","-2"
"189413","Boricua College","2011","Total full-time Instruction/research/public service, Non-tenured not on tenure track, Lecturers","1","0","1","0","0","0","0","0","0","0","0","0","1","0","1","0","0","0","0","0","0","0","0","0","0","0","0","0","0","0","-2"
"189413","Boricua College","2011","Total full-time Instruction/research/public service, Non-tenured not on tenure track total","61","33","28","0","0","0","0","0","0","3","2","1","55","31","24","0","0","0","3","0","3","0","0","0","0","0","0","0","0","0","-2"
"190114","Metropolitan College of New York","2011","Total full-time Instruction/research/public service, Non-tenured not on tenure track, Professors","7","5","2","0","0","0","0","0","0","0","0","0","0","0","0","0","0","0","7","5","2","0","0","0","0","0","0","0","0","0","-2"
"190114","Metropolitan College of New York","2011","Total full-time Instruction/research/public service, Non-tenured not on tenure track, Associate professors","12","5","7","0","0","0","2","1","1","2","0","2","0","0","0","0","0","0","8","4","4","0","0","0","0","0","0","0","0","0","-2"
"190114","Metropolitan College of New York","2011","Total full-time Instruction/research/public servicey, Non-tenured not on tenure track, Assistant professors","8","5","3","0","0","0","1","0","1","3","2","1","0","0","0","0","0","0","4","3","1","0","0","0","0","0","0","0","0","0","-2"
"190114","Metropolitan College of New York","2011","Total full-time Instruction/research/public service, Non-tenured not on tenure track total","27","15","12","0","0","0","3","1","2","5","2","3","0","0","0","0","0","0","19","12","7","0","0","0","0","0","0","0","0","0","-2"
"190558","College of Staten Island CUNY","2011","Total full-time Instruction/research/public service, Tenured, Professors","90","59","31","0","0","0","12","9","3","2","1","1","5","4","1","0","0","0","71","45","26","0","0","0","0","0","0","0","0","0","-2"
"190558","College of Staten Island CUNY","2011","Total full-time Instruction/research/public service, Tenured, Associate professors","110","59","51","1","1","0","14","9","5","2","2","0","4","3","1","0","0","0","88","44","44","0","0","0","0","0","0","1","0","1","-2"
"190558","College of Staten Island CUNY","2011","Total full-time Instruction/research/public service, Tenured, Assistant professors","36","19","17","0","0","0","7","2","5","2","1","1","2","1","1","0","0","0","25","15","10","0","0","0","0","0","0","0","0","0","-2"
"190558","College of Staten Island CUNY","2011","Total full-time Instruction/research/public service, Tenured, Lecturers","3","2","1","0","0","0","0","0","0","0","0","0","0","0","0","0","0","0","3","2","1","0","0","0","0","0","0","0","0","0","-2"
"190558","College of Staten Island CUNY","2011","Total full-time Instruction/research/public service, Tenured total","239","139","100","1","1","0","33","20","13","6","4","2","11","8","3","0","0","0","187","106","81","0","0","0","0","0","0","1","0","1","-2"
"190558","College of Staten Island CUNY","2011","Total full-time Instruction/research/public service, Non-tenured on tenure track, Associate professors","6","3","3","0","0","0","1","0","1","1","1","0","2","1","1","0","0","0","1","1","0","1","0","1","0","0","0","0","0","0","-2"
"190558","College of Staten Island CUNY","2011","Total full-time Instruction/research/public service, Non-tenured on tenure track, Assistant professors","80","41","39","0","0","0","7","4","3","6","2","4","2","1","1","0","0","0","63","32","31","0","0","0","0","0","0","2","2","0","-2"
"190558","College of Staten Island CUNY","2011","Total full-time Instruction/research/public service, Non-tenured on tenure track, Lecturers","22","7","15","0","0","0","1","0","1","0","0","0","2","0","2","0","0","0","19","7","12","0","0","0","0","0","0","0","0","0","-2"
"190558","College of Staten Island CUNY","2011","Total full-time Instruction/research/public service, Non-tenured on tenure track total","108","51","57","0","0","0","9","4","5","7","3","4","6","2","4","0","0","0","83","40","43","1","0","1","0","0","0","2","2","0","-2"
"190558","College of Staten Island CUNY","2011","Total full-time Instruction/research/public service, Non-tenured not on tenure track, Professors","1","0","1","0","0","0","0","0","0","0","0","0","0","0","0","0","0","0","1","0","1","0","0","0","0","0","0","0","0","0","-2"
"190558","College of Staten Island CUNY","2011","Total full-time Instruction/research/public service, Non-tenured not on tenure track, Lecturers","9","6","3","0","0","0","0","0","0","2","2","0","1","1","0","0","0","0","5","3","2","0","0","0","0","0","0","1","0","1","-2"
"190558","College of Staten Island CUNY","2011","Total full-time Instruction/research/public service, Non-tenured not on tenure track total","10","6","4","0","0","0","0","0","0","2","2","0","1","1","0","0","0","0","6","3","3","0","0","0","0","0","0","1","0","1","-2"
"190594","CUNY Hunter College","2011","Total full-time Instruction/research/public service, Tenured, Professors","231","131","100","0","0","0","9","5","4","17","10","7","19","11","8","0","0","0","184","104","80","0","0","0","0","0","0","2","1","1","-2"
"190594","CUNY Hunter College","2011","Total full-time Instruction/research/public service, Tenured, Associate professors","209","98","111","0","0","0","28","13","15","21","9","12","27","8","19","0","0","0","133","68","65","0","0","0","0","0","0","0","0","0","-2"
"190594","CUNY Hunter College","2011","Total full-time Instruction/research/public service, Tenured, Assistant professors","23","11","12","0","0","0","4","1","3","5","2","3","2","2","0","0","0","0","12","6","6","0","0","0","0","0","0","0","0","0","-2"
"190594","CUNY Hunter College","2011","Total full-time Instruction/research/public service, Tenured, Lecturers","12","5","7","0","0","0","1","0","1","5","1","4","1","0","1","0","0","0","5","4","1","0","0","0","0","0","0","0","0","0","-2"
"190594","CUNY Hunter College","2011","Total full-time Instruction/research/public service, Tenured total","475","245","230","0","0","0","42","19","23","48","22","26","49","21","28","0","0","0","334","182","152","0","0","0","0","0","0","2","1","1","-2"
"190594","CUNY Hunter College","2011","Total full-time Instruction/research/public service, Non-tenured on tenure track, Professors","10","4","6","0","0","0","1","1","0","0","0","0","0","0","0","0","0","0","9","3","6","0","0","0","0","0","0","0","0","0","-2"
"190594","CUNY Hunter College","2011","Total full-time Instruction/research/public service, Non-tenured on tenure track, Associate professors","20","12","8","0","0","0","5","3","2","0","0","0","1","1","0","0","0","0","13","8","5","0","0","0","0","0","0","1","0","1","-2"
"190594","CUNY Hunter College","2011","Total full-time Instruction/research/public service, Non-tenured on tenure track, Assistant professors","116","53","63","0","0","0","11","3","8","9","5","4","12","7","5","0","0","0","71","32","39","0","0","0","0","0","0","13","6","7","-2"
"190594","CUNY Hunter College","2011","Total full-time Instruction/research/public service, Non-tenured on tenure track, Lecturers","25","10","15","0","0","0","1","0","1","0","0","0","4","1","3","0","0","0","16","9","7","0","0","0","0","0","0","4","0","4","-2"
"190594","CUNY Hunter College","2011","Total full-time Instruction/research/public service, Non-tenured on tenure track total","171","79","92","0","0","0","18","7","11","9","5","4","17","9","8","0","0","0","109","52","57","0","0","0","0","0","0","18","6","12","-2"
"190594","CUNY Hunter College","2011","Total full-time Instruction/research/public service, Non-tenured not on tenure track, Professors","34","15","19","0","0","0","2","1","1","2","1","1","1","0","1","0","0","0","29","13","16","0","0","0","0","0","0","0","0","0","-2"
"190594","CUNY Hunter College","2011","Total full-time Instruction/research/public service, Non-tenured not on tenure track, Associate professors","5","2","3","0","0","0","1","0","1","0","0","0","1","1","0","0","0","0","3","1","2","0","0","0","0","0","0","0","0","0","-2"
"190594","CUNY Hunter College","2011","Total full-time Instruction/research/public servicey, Non-tenured not on tenure track, Assistant professors","12","7","5","0","0","0","0","0","0","0","0","0","1","1","0","0","0","0","11","6","5","0","0","0","0","0","0","0","0","0","-2"
"190594","CUNY Hunter College","2011","Total full-time Instruction/research/public service, Non-tenured not on tenure track, Instructors","5","3","2","0","0","0","0","0","0","0","0","0","0","0","0","0","0","0","5","3","2","0","0","0","0","0","0","0","0","0","-2"
"190594","CUNY Hunter College","2011","Total full-time Instruction/research/public service, Non-tenured not on tenure track, Lecturers","11","6","5","0","0","0","1","1","0","1","1","0","1","0","1","0","0","0","8","4","4","0","0","0","0","0","0","0","0","0","-2"
"190594","CUNY Hunter College","2011","Total full-time Instruction/research/public service, Non-tenured not on tenure track total","67","33","34","0","0","0","4","2","2","3","2","1","4","2","2","0","0","0","56","27","29","0","0","0","0","0","0","0","0","0","-2"
"190600","CUNY John Jay College of Criminal Justice","2011","Total full-time Instruction/research/public service, Tenured, Professors","83","54","29","0","0","0","4","2","2","8","4","4","4","2","2","0","0","0","67","46","21","0","0","0","0","0","0","0","0","0","-2"
"190600","CUNY John Jay College of Criminal Justice","2011","Total full-time Instruction/research/public service, Tenured, Associate professors","112","60","52","0","0","0","7","2","5","12","6","6","11","4","7","0","0","0","78","47","31","0","0","0","0","0","0","4","1","3","-2"
"190600","CUNY John Jay College of Criminal Justice","2011","Total full-time Instruction/research/public service, Tenured, Assistant professors","30","10","20","0","0","0","4","1","3","6","2","4","3","2","1","0","0","0","17","5","12","0","0","0","0","0","0","0","0","0","-2"
"190600","CUNY John Jay College of Criminal Justice","2011","Total full-time Instruction/research/public service, Tenured, Lecturers","7","4","3","0","0","0","1","0","1","1","1","0","1","0","1","0","0","0","3","2","1","0","0","0","0","0","0","1","1","0","-2"
"190600","CUNY John Jay College of Criminal Justice","2011","Total full-time Instruction/research/public service, Tenured total","232","128","104","0","0","0","16","5","11","27","13","14","19","8","11","0","0","0","165","100","65","0","0","0","0","0","0","5","2","3","-2"
"190600","CUNY John Jay College of Criminal Justice","2011","Total full-time Instruction/research/public service, Non-tenured on tenure track, Professors","1","1","0","0","0","0","0","0","0","0","0","0","0","0","0","0","0","0","1","1","0","0","0","0","0","0","0","0","0","0","-2"
"190600","CUNY John Jay College of Criminal Justice","2011","Total full-time Instruction/research/public service, Non-tenured on tenure track, Associate professors","17","8","9","0","0","0","3","1","2","2","1","1","3","2","1","0","0","0","9","4","5","0","0","0","0","0","0","0","0","0","-2"
"190600","CUNY John Jay College of Criminal Justice","2011","Total full-time Instruction/research/public service, Non-tenured on tenure track, Assistant professors","98","51","47","0","0","0","8","3","5","13","9","4","12","5","7","2","1","1","55","31","24","0","0","0","0","0","0","8","2","6","-2"
"190600","CUNY John Jay College of Criminal Justice","2011","Total full-time Instruction/research/public service, Non-tenured on tenure track, Lecturers","16","9","7","0","0","0","1","0","1","3","2","1","1","1","0","1","0","1","10","6","4","0","0","0","0","0","0","0","0","0","-2"
"190600","CUNY John Jay College of Criminal Justice","2011","Total full-time Instruction/research/public service, Non-tenured on tenure track total","132","69","63","0","0","0","12","4","8","18","12","6","16","8","8","3","1","2","75","42","33","0","0","0","0","0","0","8","2","6","-2"
"190600","CUNY John Jay College of Criminal Justice","2011","Total full-time Instruction/research/public service, Non-tenured not on tenure track, Professors","3","3","0","0","0","0","0","0","0","0","0","0","0","0","0","0","0","0","3","3","0","0","0","0","0","0","0","0","0","0","-2"
"190600","CUNY John Jay College of Criminal Justice","2011","Total full-time Instruction/research/public service, Non-tenured not on tenure track, Associate professors","1","0","1","0","0","0","0","0","0","0","0","0","0","0","0","0","0","0","1","0","1","0","0","0","0","0","0","0","0","0","-2"
"190600","CUNY John Jay College of Criminal Justice","2011","Total full-time Instruction/research/public servicey, Non-tenured not on tenure track, Assistant professors","6","4","2","0","0","0","0","0","0","0","0","0","2","2","0","0","0","0","4","2","2","0","0","0","0","0","0","0","0","0","-2"
"190600","CUNY John Jay College of Criminal Justice","2011","Total full-time Instruction/research/public service, Non-tenured not on tenure track, Instructors","5","4","1","0","0","0","0","0","0","0","0","0","0","0","0","0","0","0","5","4","1","0","0","0","0","0","0","0","0","0","-2"
"190600","CUNY John Jay College of Criminal Justice","2011","Total full-time Instruction/research/public service, Non-tenured not on tenure track, Lecturers","6","4","2","0","0","0","0","0","0","1","1","0","1","1","0","0","0","0","4","2","2","0","0","0","0","0","0","0","0","0","-2"
"190600","CUNY John Jay College of Criminal Justice","2011","Total full-time Instruction/research/public service, Non-tenured not on tenure track total","21","15","6","0","0","0","0","0","0","1","1","0","3","3","0","0","0","0","17","11","6","0","0","0","0","0","0","0","0","0","-2"
"190637","CUNY Lehman College","2011","Total full-time Instruction/research/public service, Tenured, Professors","91","65","26","0","0","0","1","0","1","2","1","1","11","9","2","0","0","0","77","55","22","0","0","0","0","0","0","0","0","0","-2"
"190637","CUNY Lehman College","2011","Total full-time Instruction/research/public service, Tenured, Associate professors","86","36","50","1","0","1","6","5","1","3","3","0","13","3","10","0","0","0","61","24","37","0","0","0","0","0","0","2","1","1","-2"
"190637","CUNY Lehman College","2011","Total full-time Instruction/research/public service, Tenured, Assistant professors","30","10","20","0","0","0","4","3","1","7","2","5","3","1","2","0","0","0","16","4","12","0","0","0","0","0","0","0","0","0","-2"
"190637","CUNY Lehman College","2011","Total full-time Instruction/research/public service, Tenured, Lecturers","20","9","11","0","0","0","1","0","1","4","2","2","3","2","1","0","0","0","12","5","7","0","0","0","0","0","0","0","0","0","-2"
"190637","CUNY Lehman College","2011","Total full-time Instruction/research/public service, Tenured total","227","120","107","1","0","1","12","8","4","16","8","8","30","15","15","0","0","0","166","88","78","0","0","0","0","0","0","2","1","1","-2"
"190637","CUNY Lehman College","2011","Total full-time Instruction/research/public service, Non-tenured on tenure track, Associate professors","11","6","5","0","0","0","1","1","0","0","0","0","2","1","1","0","0","0","8","4","4","0","0","0","0","0","0","0","0","0","-2"
"190637","CUNY Lehman College","2011","Total full-time Instruction/research/public service, Non-tenured on tenure track, Assistant professors","86","34","52","1","0","1","8","3","5","12","3","9","11","5","6","0","0","0","53","22","31","0","0","0","0","0","0","1","1","0","-2"
"190637","CUNY Lehman College","2011","Total full-time Instruction/research/public service, Non-tenured on tenure track, Lecturers","27","10","17","0","0","0","0","0","0","3","1","2","4","3","1","0","0","0","20","6","14","0","0","0","0","0","0","0","0","0","-2"
"190637","CUNY Lehman College","2011","Total full-time Instruction/research/public service, Non-tenured on tenure track total","124","50","74","1","0","1","9","4","5","15","4","11","17","9","8","0","0","0","81","32","49","0","0","0","0","0","0","1","1","0","-2"
"190637","CUNY Lehman College","2011","Total full-time Instruction/research/public service, Non-tenured not on tenure track, Professors","7","3","4","0","0","0","0","0","0","0","0","0","2","1","1","0","0","0","5","2","3","0","0","0","0","0","0","0","0","0","-2"
"190637","CUNY Lehman College","2011","Total full-time Instruction/research/public servicey, Non-tenured not on tenure track, Assistant professors","3","1","2","0","0","0","1","1","0","1","0","1","0","0","0","0","0","0","1","0","1","0","0","0","0","0","0","0","0","0","-2"
"190637","CUNY Lehman College","2011","Total full-time Instruction/research/public service, Non-tenured not on tenure track, Lecturers","7","6","1","0","0","0","0","0","0","2","1","1","0","0","0","0","0","0","4","4","0","0","0","0","0","0","0","1","1","0","-2"
"190637","CUNY Lehman College","2011","Total full-time Instruction/research/public service, Non-tenured not on tenure track total","17","10","7","0","0","0","1","1","0","3","1","2","2","1","1","0","0","0","10","6","4","0","0","0","0","0","0","1","1","0","-2"
"190655","CUNY New York City College of Technology","2011","Total full-time Instruction/research/public service, Tenured, Professors","55","35","20","0","0","0","4","0","4","5","3","2","5","3","2","0","0","0","41","29","12","0","0","0","0","0","0","0","0","0","-2"
"190655","CUNY New York City College of Technology","2011","Total full-time Instruction/research/public service, Tenured, Associate professors","84","43","41","0","0","0","12","6","6","12","7","5","5","2","3","0","0","0","54","27","27","0","0","0","0","0","0","1","1","0","-2"
"190655","CUNY New York City College of Technology","2011","Total full-time Instruction/research/public service, Tenured, Assistant professors","66","38","28","1","1","0","12","6","6","7","5","2","4","1","3","0","0","0","41","24","17","0","0","0","0","0","0","1","1","0","-2"
"190655","CUNY New York City College of Technology","2011","Total full-time Instruction/research/public service, Tenured, Lecturers","19","7","12","0","0","0","1","1","0","9","3","6","1","1","0","0","0","0","8","2","6","0","0","0","0","0","0","0","0","0","-2"
"190655","CUNY New York City College of Technology","2011","Total full-time Instruction/research/public service, Tenured total","224","123","101","1","1","0","29","13","16","33","18","15","15","7","8","0","0","0","144","82","62","0","0","0","0","0","0","2","2","0","-2"
"190655","CUNY New York City College of Technology","2011","Total full-time Instruction/research/public service, Non-tenured on tenure track, Associate professors","2","0","2","0","0","0","0","0","0","0","0","0","0","0","0","0","0","0","2","0","2","0","0","0","0","0","0","0","0","0","-2"
"190655","CUNY New York City College of Technology","2011","Total full-time Instruction/research/public service, Non-tenured on tenure track, Assistant professors","137","68","69","1","0","1","20","12","8","14","6","8","12","5","7","1","1","0","76","35","41","0","0","0","0","0","0","13","9","4","-2"
"190655","CUNY New York City College of Technology","2011","Total full-time Instruction/research/public service, Non-tenured on tenure track, Lecturers","15","10","5","0","0","0","0","0","0","3","2","1","0","0","0","0","0","0","12","8","4","0","0","0","0","0","0","0","0","0","-2"
"190655","CUNY New York City College of Technology","2011","Total full-time Instruction/research/public service, Non-tenured on tenure track total","154","78","76","1","0","1","20","12","8","17","8","9","12","5","7","1","1","0","90","43","47","0","0","0","0","0","0","13","9","4","-2"
"190655","CUNY New York City College of Technology","2011","Total full-time Instruction/research/public service, Non-tenured not on tenure track, Professors","2","1","1","0","0","0","0","0","0","0","0","0","0","0","0","0","0","0","2","1","1","0","0","0","0","0","0","0","0","0","-2"
"190655","CUNY New York City College of Technology","2011","Total full-time Instruction/research/public servicey, Non-tenured not on tenure track, Assistant professors","7","6","1","0","0","0","1","1","0","1","1","0","1","1","0","0","0","0","3","2","1","0","0","0","0","0","0","1","1","0","-2"
"190655","CUNY New York City College of Technology","2011","Total full-time Instruction/research/public service, Non-tenured not on tenure track, Instructors","8","2","6","0","0","0","1","0","1","1","0","1","1","0","1","0","0","0","3","1","2","0","0","0","0","0","0","2","1","1","-2"
"190655","CUNY New York City College of Technology","2011","Total full-time Instruction/research/public service, Non-tenured not on tenure track, Lecturers","2","0","2","0","0","0","0","0","0","1","0","1","0","0","0","0","0","0","1","0","1","0","0","0","0","0","0","0","0","0","-2"
"190655","CUNY New York City College of Technology","2011","Total full-time Instruction/research/public service, Non-tenured not on tenure track total","19","9","10","0","0","0","2","1","1","3","1","2","2","1","1","0","0","0","9","4","5","0","0","0","0","0","0","3","2","1","-2"
"190664","CUNY Queens College","2011","Total full-time Instruction/research/public service, Tenured, Professors","198","139","59","0","0","0","15","7","8","7","3","4","7","4","3","0","0","0","169","125","44","0","0","0","0","0","0","0","0","0","-2"
"190664","CUNY Queens College","2011","Total full-time Instruction/research/public service, Tenured, Associate professors","138","75","63","0","0","0","20","11","9","9","7","2","11","2","9","0","0","0","97","55","42","0","0","0","0","0","0","1","0","1","-2"
"190664","CUNY Queens College","2011","Total full-time Instruction/research/public service, Tenured, Assistant professors","47","19","28","1","0","1","6","2","4","3","2","1","2","2","0","0","0","0","30","12","18","0","0","0","0","0","0","5","1","4","-2"
"190664","CUNY Queens College","2011","Total full-time Instruction/research/public service, Tenured, Lecturers","25","12","13","0","0","0","1","0","1","0","0","0","2","2","0","0","0","0","22","10","12","0","0","0","0","0","0","0","0","0","-2"
"190664","CUNY Queens College","2011","Total full-time Instruction/research/public service, Tenured total","408","245","163","1","0","1","42","20","22","19","12","7","22","10","12","0","0","0","318","202","116","0","0","0","0","0","0","6","1","5","-2"
"190664","CUNY Queens College","2011","Total full-time Instruction/research/public service, Non-tenured on tenure track, Associate professors","1","0","1","0","0","0","0","0","0","0","0","0","0","0","0","0","0","0","1","0","1","0","0","0","0","0","0","0","0","0","-2"
"190664","CUNY Queens College","2011","Total full-time Instruction/research/public service, Non-tenured on tenure track, Assistant professors","132","61","71","0","0","0","16","6","10","10","3","7","7","3","4","1","1","0","73","39","34","0","0","0","0","0","0","25","9","16","-2"
"190664","CUNY Queens College","2011","Total full-time Instruction/research/public service, Non-tenured on tenure track, Lecturers","37","16","21","0","0","0","1","0","1","1","1","0","1","1","0","0","0","0","32","14","18","0","0","0","0","0","0","2","0","2","-2"
"190664","CUNY Queens College","2011","Total full-time Instruction/research/public service, Non-tenured on tenure track total","170","77","93","0","0","0","17","6","11","11","4","7","8","4","4","1","1","0","106","53","53","0","0","0","0","0","0","27","9","18","-2"
"190664","CUNY Queens College","2011","Total full-time Instruction/research/public service, Non-tenured not on tenure track, Professors","8","4","4","0","0","0","2","1","1","2","0","2","0","0","0","0","0","0","4","3","1","0","0","0","0","0","0","0","0","0","-2"
"190664","CUNY Queens College","2011","Total full-time Instruction/research/public service, Non-tenured not on tenure track, Associate professors","1","1","0","0","0","0","0","0","0","0","0","0","0","0","0","0","0","0","1","1","0","0","0","0","0","0","0","0","0","0","-2"
"190664","CUNY Queens College","2011","Total full-time Instruction/research/public servicey, Non-tenured not on tenure track, Assistant professors","9","5","4","0","0","0","0","0","0","0","0","0","1","1","0","0","0","0","7","3","4","0","0","0","0","0","0","1","1","0","-2"
"190664","CUNY Queens College","2011","Total full-time Instruction/research/public service, Non-tenured not on tenure track, Instructors","7","2","5","0","0","0","1","0","1","0","0","0","0","0","0","0","0","0","6","2","4","0","0","0","0","0","0","0","0","0","-2"
"190664","CUNY Queens College","2011","Total full-time Instruction/research/public service, Non-tenured not on tenure track, Lecturers","3","3","0","0","0","0","0","0","0","0","0","0","0","0","0","0","0","0","3","3","0","0","0","0","0","0","0","0","0","0","-2"
"190664","CUNY Queens College","2011","Total full-time Instruction/research/public service, Non-tenured not on tenure track total","28","15","13","0","0","0","3","1","2","2","0","2","1","1","0","0","0","0","21","12","9","0","0","0","0","0","0","1","1","0","-2"
"190691","CUNY York College","2011","Total full-time Instruction/research/public service, Tenured, Professors","38","25","13","0","0","0","4","4","0","1","1","0","2","1","1","0","0","0","31","19","12","0","0","0","0","0","0","0","0","0","-2"
"190691","CUNY York College","2011","Total full-time Instruction/research/public service, Tenured, Associate professors","53","29","24","0","0","0","8","7","1","12","7","5","6","2","4","0","0","0","27","13","14","0","0","0","0","0","0","0","0","0","-2"
"190691","CUNY York College","2011","Total full-time Instruction/research/public service, Tenured, Assistant professors","13","9","4","0","0","0","3","3","0","4","2","2","1","0","1","0","0","0","5","4","1","0","0","0","0","0","0","0","0","0","-2"
"190691","CUNY York College","2011","Total full-time Instruction/research/public service, Tenured, Lecturers","5","3","2","0","0","0","0","0","0","1","1","0","0","0","0","0","0","0","4","2","2","0","0","0","0","0","0","0","0","0","-2"
"190691","CUNY York College","2011","Total full-time Instruction/research/public service, Tenured total","109","66","43","0","0","0","15","14","1","18","11","7","9","3","6","0","0","0","67","38","29","0","0","0","0","0","0","0","0","0","-2"
"190691","CUNY York College","2011","Total full-time Instruction/research/public service, Non-tenured on tenure track, Professors","1","1","0","0","0","0","1","1","0","0","0","0","0","0","0","0","0","0","0","0","0","0","0","0","0","0","0","0","0","0","-2"
"190691","CUNY York College","2011","Total full-time Instruction/research/public service, Non-tenured on tenure track, Associate professors","9","3","6","0","0","0","0","0","0","1","1","0","0","0","0","0","0","0","8","2","6","0","0","0","0","0","0","0","0","0","-2"
"190691","CUNY York College","2011","Total full-time Instruction/research/public service, Non-tenured on tenure track, Assistant professors","61","28","33","0","0","0","10","2","8","9","3","6","4","2","2","0","0","0","34","20","14","0","0","0","0","0","0","4","1","3","-2"
"190691","CUNY York College","2011","Total full-time Instruction/research/public service, Non-tenured on tenure track, Lecturers","26","9","17","1","0","1","2","1","1","10","3","7","1","0","1","0","0","0","12","5","7","0","0","0","0","0","0","0","0","0","-2"
"190691","CUNY York College","2011","Total full-time Instruction/research/public service, Non-tenured on tenure track total","97","41","56","1","0","1","13","4","9","20","7","13","5","2","3","0","0","0","54","27","27","0","0","0","0","0","0","4","1","3","-2"
"190691","CUNY York College","2011","Total full-time Instruction/research/public service, Non-tenured not on tenure track, Professors","2","1","1","0","0","0","0","0","0","2","1","1","0","0","0","0","0","0","0","0","0","0","0","0","0","0","0","0","0","0","-2"
"190691","CUNY York College","2011","Total full-time Instruction/research/public servicey, Non-tenured not on tenure track, Assistant professors","1","1","0","0","0","0","1","1","0","0","0","0","0","0","0","0","0","0","0","0","0","0","0","0","0","0","0","0","0","0","-2"
"190691","CUNY York College","2011","Total full-time Instruction/research/public service, Non-tenured not on tenure track, Instructors","2","0","2","0","0","0","0","0","0","0","0","0","0","0","0","0","0","0","2","0","2","0","0","0","0","0","0","0","0","0","-2"
"190691","CUNY York College","2011","Total full-time Instruction/research/public service, Non-tenured not on tenure track total","5","2","3","0","0","0","1","1","0","2","1","1","0","0","0","0","0","0","2","0","2","0","0","0","0","0","0","0","0","0","-2"
"190761","Dominican College of Blauvelt","2011","Total full-time Instruction/research/public service, Tenured, Professors","3","0","3","0","0","0","0","0","0","0","0","0","0","0","0","0","0","0","3","0","3","0","0","0","0","0","0","0","0","0","-2"
"190761","Dominican College of Blauvelt","2011","Total full-time Instruction/research/public service, Tenured, Associate professors","12","3","9","0","0","0","2","1","1","1","0","1","0","0","0","0","0","0","9","2","7","0","0","0","0","0","0","0","0","0","-2"
"190761","Dominican College of Blauvelt","2011","Total full-time Instruction/research/public service, Tenured, Assistant professors","13","6","7","0","0","0","0","0","0","0","0","0","2","0","2","0","0","0","11","6","5","0","0","0","0","0","0","0","0","0","-2"
"190761","Dominican College of Blauvelt","2011","Total full-time Instruction/research/public service, Tenured, Instructors","1","0","1","0","0","0","0","0","0","0","0","0","0","0","0","0","0","0","1","0","1","0","0","0","0","0","0","0","0","0","-2"
"190761","Dominican College of Blauvelt","2011","Total full-time Instruction/research/public service, Tenured total","29","9","20","0","0","0","2","1","1","1","0","1","2","0","2","0","0","0","24","8","16","0","0","0","0","0","0","0","0","0","-2"
"190761","Dominican College of Blauvelt","2011","Total full-time Instruction/research/public service, Non-tenured on tenure track, Associate professors","2","2","0","0","0","0","1","1","0","0","0","0","0","0","0","0","0","0","1","1","0","0","0","0","0","0","0","0","0","0","-2"
"190761","Dominican College of Blauvelt","2011","Total full-time Instruction/research/public service, Non-tenured on tenure track, Assistant professors","13","4","9","0","0","0","1","0","1","0","0","0","1","1","0","0","0","0","11","3","8","0","0","0","0","0","0","0","0","0","-2"
"190761","Dominican College of Blauvelt","2011","Total full-time Instruction/research/public service, Non-tenured on tenure track, Instructors","2","1","1","0","0","0","0","0","0","0","0","0","0","0","0","0","0","0","2","1","1","0","0","0","0","0","0","0","0","0","-2"
"190761","Dominican College of Blauvelt","2011","Total full-time Instruction/research/public service, Non-tenured on tenure track total","17","7","10","0","0","0","2","1","1","0","0","0","1","1","0","0","0","0","14","5","9","0","0","0","0","0","0","0","0","0","-2"
"190761","Dominican College of Blauvelt","2011","Total full-time Instruction/research/public servicey, Non-tenured not on tenure track, Assistant professors","20","5","15","0","0","0","1","0","1","0","0","0","0","0","0","0","0","0","19","5","14","0","0","0","0","0","0","0","0","0","-2"
"190761","Dominican College of Blauvelt","2011","Total full-time Instruction/research/public service, Non-tenured not on tenure track, Instructors","9","0","9","0","0","0","0","0","0","0","0","0","0","0","0","0","0","0","9","0","9","0","0","0","0","0","0","0","0","0","-2"
"190761","Dominican College of Blauvelt","2011","Total full-time Instruction/research/public service, Non-tenured not on tenure track total","29","5","24","0","0","0","1","0","1","0","0","0","0","0","0","0","0","0","28","5","23","0","0","0","0","0","0","0","0","0","-2"
"192749","Manhattanville College","2011","Total full-time Instruction/research/public service, Tenured, Professors","34","20","14","0","0","0","3","2","1","2","2","0","0","0","0","0","0","0","29","16","13","0","0","0","0","0","0","0","0","0","-2"
"192749","Manhattanville College","2011","Total full-time Instruction/research/public service, Tenured, Associate professors","38","19","19","0","0","0","2","0","2","1","1","0","1","1","0","0","0","0","32","17","15","0","0","0","0","0","0","2","0","2","-2"
"192749","Manhattanville College","2011","Total full-time Instruction/research/public service, Tenured, Assistant professors","6","2","4","0","0","0","0","0","0","0","0","0","0","0","0","0","0","0","6","2","4","0","0","0","0","0","0","0","0","0","-2"
"192749","Manhattanville College","2011","Total full-time Instruction/research/public service, Tenured total","78","41","37","0","0","0","5","2","3","3","3","0","1","1","0","0","0","0","67","35","32","0","0","0","0","0","0","2","0","2","-2"
"192749","Manhattanville College","2011","Total full-time Instruction/research/public service, Non-tenured on tenure track, Professors","1","1","0","0","0","0","0","0","0","0","0","0","0","0","0","0","0","0","1","1","0","0","0","0","0","0","0","0","0","0","-2"
"192749","Manhattanville College","2011","Total full-time Instruction/research/public service, Non-tenured on tenure track, Associate professors","2","2","0","0","0","0","0","0","0","0","0","0","0","0","0","0","0","0","2","2","0","0","0","0","0","0","0","0","0","0","-2"
"192749","Manhattanville College","2011","Total full-time Instruction/research/public service, Non-tenured on tenure track, Assistant professors","23","9","14","0","0","0","3","1","2","0","0","0","0","0","0","0","0","0","19","7","12","0","0","0","1","1","0","0","0","0","-2"
"192749","Manhattanville College","2011","Total full-time Instruction/research/public service, Non-tenured on tenure track total","26","12","14","0","0","0","3","1","2","0","0","0","0","0","0","0","0","0","22","10","12","0","0","0","1","1","0","0","0","0","-2"
"192749","Manhattanville College","2011","Total full-time Instruction/research/public servicey, Non-tenured not on tenure track, Assistant professors","9","4","5","0","0","0","0","0","0","0","0","0","0","0","0","0","0","0","7","3","4","0","0","0","2","1","1","0","0","0","-2"
"192749","Manhattanville College","2011","Total full-time Instruction/research/public service, Non-tenured not on tenure track, Instructors","1","1","0","0","0","0","0","0","0","1","1","0","0","0","0","0","0","0","0","0","0","0","0","0","0","0","0","0","0","0","-2"
"192749","Manhattanville College","2011","Total full-time Instruction/research/public service, Non-tenured not on tenure track, Lecturers","2","2","0","0","0","0","0","0","0","0","0","0","0","0","0","0","0","0","2","2","0","0","0","0","0","0","0","0","0","0","-2"
"192749","Manhattanville College","2011","Total full-time Instruction/research/public service, Non-tenured not on tenure track total","12","7","5","0","0","0","0","0","0","1","1","0","0","0","0","0","0","0","9","5","4","0","0","0","2","1","1","0","0","0","-2"
"193016","Mercy College","2011","Total full-time Instruction/research/public service, Tenured, Professors","32","19","13","0","0","0","2","2","0","1","1","0","1","1","0","0","0","0","28","15","13","0","0","0","0","0","0","0","0","0","-2"
"193016","Mercy College","2011","Total full-time Instruction/research/public service, Tenured, Associate professors","15","8","7","0","0","0","2","1","1","1","1","0","0","0","0","1","0","1","11","6","5","0","0","0","0","0","0","0","0","0","-2"
"193016","Mercy College","2011","Total full-time Instruction/research/public service, Tenured, Assistant professors","3","3","0","0","0","0","1","1","0","0","0","0","0","0","0","0","0","0","2","2","0","0","0","0","0","0","0","0","0","0","-2"
"193016","Mercy College","2011","Total full-time Instruction/research/public service, Tenured total","50","30","20","0","0","0","5","4","1","2","2","0","1","1","0","1","0","1","41","23","18","0","0","0","0","0","0","0","0","0","-2"
"193016","Mercy College","2011","Total full-time Instruction/research/public service, Non-tenured on tenure track, Professors","1","0","1","0","0","0","0","0","0","0","0","0","0","0","0","0","0","0","1","0","1","0","0","0","0","0","0","0","0","0","-2"
"193016","Mercy College","2011","Total full-time Instruction/research/public service, Non-tenured on tenure track, Associate professors","16","5","11","0","0","0","1","0","1","3","0","3","1","0","1","0","0","0","11","5","6","0","0","0","0","0","0","0","0","0","-2"
"193016","Mercy College","2011","Total full-time Instruction/research/public service, Non-tenured on tenure track, Assistant professors","27","7","20","0","0","0","6","1","5","0","0","0","1","1","0","0","0","0","19","5","14","0","0","0","1","0","1","0","0","0","-2"
"193016","Mercy College","2011","Total full-time Instruction/research/public service, Non-tenured on tenure track total","44","12","32","0","0","0","7","1","6","3","0","3","2","1","1","0","0","0","31","10","21","0","0","0","1","0","1","0","0","0","-2"
"193016","Mercy College","2011","Total full-time Instruction/research/public service, Non-tenured not on tenure track, Professors","6","1","5","0","0","0","0","0","0","1","0","1","0","0","0","0","0","0","5","1","4","0","0","0","0","0","0","0","0","0","-2"
"193016","Mercy College","2011","Total full-time Instruction/research/public service, Non-tenured not on tenure track, Associate professors","32","15","17","0","0","0","1","0","1","0","0","0","1","1","0","0","0","0","30","14","16","0","0","0","0","0","0","0","0","0","-2"
"193016","Mercy College","2011","Total full-time Instruction/research/public servicey, Non-tenured not on tenure track, Assistant professors","48","22","26","0","0","0","3","1","2","5","1","4","4","4","0","0","0","0","36","16","20","0","0","0","0","0","0","0","0","0","-2"
"193016","Mercy College","2011","Total full-time Instruction/research/public service, Non-tenured not on tenure track, Instructors","19","8","11","0","0","0","2","1","1","1","1","0","1","0","1","0","0","0","12","5","7","0","0","0","3","1","2","0","0","0","-2"
"193016","Mercy College","2011","Total full-time Instruction/research/public service, Non-tenured not on tenure track total","105","46","59","0","0","0","6","2","4","7","2","5","6","5","1","0","0","0","83","36","47","0","0","0","3","1","2","0","0","0","-2"
"193399","College of Mount Saint Vincent","2011","Total full-time Instruction/research/public service, Tenured, Professors","13","5","8","0","0","0","0","0","0","0","0","0","0","0","0","0","0","0","13","5","8","0","0","0","0","0","0","0","0","0","-2"
"193399","College of Mount Saint Vincent","2011","Total full-time Instruction/research/public service, Tenured, Associate professors","25","11","14","0","0","0","1","0","1","0","0","0","0","0","0","0","0","0","24","11","13","0","0","0","0","0","0","0","0","0","-2"
"193399","College of Mount Saint Vincent","2011","Total full-time Instruction/research/public service, Tenured, Assistant professors","7","4","3","0","0","0","0","0","0","0","0","0","0","0","0","0","0","0","7","4","3","0","0","0","0","0","0","0","0","0","-2"
"193399","College of Mount Saint Vincent","2011","Total full-time Instruction/research/public service, Tenured total","45","20","25","0","0","0","1","0","1","0","0","0","0","0","0","0","0","0","44","20","24","0","0","0","0","0","0","0","0","0","-2"
"193399","College of Mount Saint Vincent","2011","Total full-time Instruction/research/public service, Non-tenured on tenure track, Associate professors","1","0","1","0","0","0","0","0","0","0","0","0","0","0","0","0","0","0","1","0","1","0","0","0","0","0","0","0","0","0","-2"
"193399","College of Mount Saint Vincent","2011","Total full-time Instruction/research/public service, Non-tenured on tenure track, Assistant professors","18","5","13","0","0","0","2","1","1","0","0","0","2","1","1","0","0","0","13","3","10","1","0","1","0","0","0","0","0","0","-2"
"193399","College of Mount Saint Vincent","2011","Total full-time Instruction/research/public service, Non-tenured on tenure track, Instructors","7","2","5","0","0","0","0","0","0","0","0","0","0","0","0","0","0","0","7","2","5","0","0","0","0","0","0","0","0","0","-2"
"193399","College of Mount Saint Vincent","2011","Total full-time Instruction/research/public service, Non-tenured on tenure track total","26","7","19","0","0","0","2","1","1","0","0","0","2","1","1","0","0","0","21","5","16","1","0","1","0","0","0","0","0","0","-2"
"193399","College of Mount Saint Vincent","2011","Total full-time Instruction/research/public servicey, Non-tenured not on tenure track, Assistant professors","1","0","1","0","0","0","0","0","0","0","0","0","0","0","0","0","0","0","1","0","1","0","0","0","0","0","0","0","0","0","-2"
"193399","College of Mount Saint Vincent","2011","Total full-time Instruction/research/public service, Non-tenured not on tenure track, Instructors","4","1","3","0","0","0","0","0","0","1","0","1","0","0","0","0","0","0","3","1","2","0","0","0","0","0","0","0","0","0","-2"
"193399","College of Mount Saint Vincent","2011","Total full-time Instruction/research/public service, Non-tenured not on tenure track total","5","1","4","0","0","0","0","0","0","1","0","1","0","0","0","0","0","0","4","1","3","0","0","0","0","0","0","0","0","0","-2"
"194161","Nyack College","2011","Total full-time Instruction/research/public service, Tenured, Professors","29","18","11","0","0","0","5","2","3","2","1","1","1","0","1","0","0","0","21","15","6","0","0","0","0","0","0","0","0","0","-2"
"194161","Nyack College","2011","Total full-time Instruction/research/public service, Tenured, Associate professors","7","5","2","0","0","0","1","1","0","3","2","1","0","0","0","0","0","0","3","2","1","0","0","0","0","0","0","0","0","0","-2"
"194161","Nyack College","2011","Total full-time Instruction/research/public service, Tenured total","36","23","13","0","0","0","6","3","3","5","3","2","1","0","1","0","0","0","24","17","7","0","0","0","0","0","0","0","0","0","-2"
"194161","Nyack College","2011","Total full-time Instruction/research/public service, Non-tenured on tenure track, Professors","6","4","2","0","0","0","1","1","0","2","0","2","0","0","0","0","0","0","3","3","0","0","0","0","0","0","0","0","0","0","-2"
"194161","Nyack College","2011","Total full-time Instruction/research/public service, Non-tenured on tenure track, Associate professors","14","11","3","0","0","0","1","0","1","3","1","2","1","1","0","0","0","0","9","9","0","0","0","0","0","0","0","0","0","0","-2"
"194161","Nyack College","2011","Total full-time Instruction/research/public service, Non-tenured on tenure track, Assistant professors","36","16","20","0","0","0","9","6","3","6","1","5","5","2","3","0","0","0","15","6","9","0","0","0","0","0","0","1","1","0","-2"
"194161","Nyack College","2011","Total full-time Instruction/research/public service, Non-tenured on tenure track, Lecturers","17","5","12","0","0","0","0","0","0","6","1","5","3","2","1","0","0","0","8","2","6","0","0","0","0","0","0","0","0","0","-2"
"194161","Nyack College","2011","Total full-time Instruction/research/public service, Non-tenured on tenure track total","73","36","37","0","0","0","11","7","4","17","3","14","9","5","4","0","0","0","35","20","15","0","0","0","0","0","0","1","1","0","-2"
"195173","St Francis College","2011","Total full-time Instruction/research/public service, Tenured, Professors","25","16","9","0","0","0","1","1","0","1","0","1","0","0","0","0","0","0","23","15","8","0","0","0","0","0","0","0","0","0","-2"
"195173","St Francis College","2011","Total full-time Instruction/research/public service, Tenured, Associate professors","20","9","11","0","0","0","1","0","1","1","0","1","2","0","2","0","0","0","16","9","7","0","0","0","0","0","0","0","0","0","-2"
"195173","St Francis College","2011","Total full-time Instruction/research/public service, Tenured, Assistant professors","2","2","0","0","0","0","0","0","0","0","0","0","0","0","0","0","0","0","2","2","0","0","0","0","0","0","0","0","0","0","-2"
"195173","St Francis College","2011","Total full-time Instruction/research/public service, Tenured total","47","27","20","0","0","0","2","1","1","2","0","2","2","0","2","0","0","0","41","26","15","0","0","0","0","0","0","0","0","0","-2"
"195173","St Francis College","2011","Total full-time Instruction/research/public service, Non-tenured on tenure track, Professors","1","0","1","0","0","0","0","0","0","0","0","0","0","0","0","0","0","0","1","0","1","0","0","0","0","0","0","0","0","0","-2"
"195173","St Francis College","2011","Total full-time Instruction/research/public service, Non-tenured on tenure track, Associate professors","5","2","3","0","0","0","0","0","0","0","0","0","1","1","0","0","0","0","4","1","3","0","0","0","0","0","0","0","0","0","-2"
"195173","St Francis College","2011","Total full-time Instruction/research/public service, Non-tenured on tenure track, Assistant professors","18","6","12","0","0","0","2","2","0","2","0","2","0","0","0","0","0","0","14","4","10","0","0","0","0","0","0","0","0","0","-2"
"195173","St Francis College","2011","Total full-time Instruction/research/public service, Non-tenured on tenure track total","24","8","16","0","0","0","2","2","0","2","0","2","1","1","0","0","0","0","19","5","14","0","0","0","0","0","0","0","0","0","-2"
"195173","St Francis College","2011","Total full-time Instruction/research/public servicey, Non-tenured not on tenure track, Assistant professors","1","1","0","0","0","0","0","0","0","0","0","0","0","0","0","0","0","0","1","1","0","0","0","0","0","0","0","0","0","0","-2"
"195173","St Francis College","2011","Total full-time Instruction/research/public service, Non-tenured not on tenure track, Lecturers","9","6","3","0","0","0","0","0","0","1","0","1","0","0","0","0","0","0","8","6","2","0","0","0","0","0","0","0","0","0","-2"
"195173","St Francis College","2011","Total full-time Instruction/research/public service, Non-tenured not on tenure track total","10","7","3","0","0","0","0","0","0","1","0","1","0","0","0","0","0","0","9","7","2","0","0","0","0","0","0","0","0","0","-2"
"196219","SUNY at Purchase College","2011","Total full-time Instruction/research/public service, Tenured, Professors","46","27","19","0","0","0","2","1","1","1","1","0","0","0","0","0","0","0","43","25","18","0","0","0","0","0","0","0","0","0","-2"
"196219","SUNY at Purchase College","2011","Total full-time Instruction/research/public service, Tenured, Associate professors","51","20","31","0","0","0","3","1","2","2","1","1","1","1","0","0","0","0","45","17","28","0","0","0","0","0","0","0","0","0","-2"
"196219","SUNY at Purchase College","2011","Total full-time Instruction/research/public service, Tenured total","97","47","50","0","0","0","5","2","3","3","2","1","1","1","0","0","0","0","88","42","46","0","0","0","0","0","0","0","0","0","-2"
"196219","SUNY at Purchase College","2011","Total full-time Instruction/research/public service, Non-tenured on tenure track, Associate professors","9","1","8","0","0","0","2","0","2","0","0","0","0","0","0","0","0","0","7","1","6","0","0","0","0","0","0","0","0","0","-2"
"196219","SUNY at Purchase College","2011","Total full-time Instruction/research/public service, Non-tenured on tenure track, Assistant professors","40","23","17","0","0","0","0","0","0","4","2","2","1","0","1","0","0","0","30","18","12","1","0","1","0","0","0","4","3","1","-2"
"196219","SUNY at Purchase College","2011","Total full-time Instruction/research/public service, Non-tenured on tenure track total","49","24","25","0","0","0","2","0","2","4","2","2","1","0","1","0","0","0","37","19","18","1","0","1","0","0","0","4","3","1","-2"
"196219","SUNY at Purchase College","2011","Total full-time Instruction/research/public service, Non-tenured not on tenure track, Associate professors","2","1","1","0","0","0","1","0","1","0","0","0","0","0","0","0","0","0","1","1","0","0","0","0","0","0","0","0","0","0","-2"
"196219","SUNY at Purchase College","2011","Total full-time Instruction/research/public servicey, Non-tenured not on tenure track, Assistant professors","13","4","9","0","0","0","2","0","2","0","0","0","0","0","0","0","0","0","10","4","6","0","0","0","0","0","0","1","0","1","-2"
"196219","SUNY at Purchase College","2011","Total full-time Instruction/research/public service, Non-tenured not on tenure track, Lecturers","8","0","8","0","0","0","0","0","0","0","0","0","0","0","0","0","0","0","8","0","8","0","0","0","0","0","0","0","0","0","-2"
"196219","SUNY at Purchase College","2011","Total full-time Instruction/research/public service, Non-tenured not on tenure track total","23","5","18","0","0","0","3","0","3","0","0","0","0","0","0","0","0","0","19","5","14","0","0","0","0","0","0","1","0","1","-2"
"196237","SUNY College at Old Westbury","2011","Total full-time Instruction/research/public service, Tenured, Professors","31","17","14","0","0","0","8","6","2","4","3","1","4","3","1","0","0","0","15","5","10","0","0","0","0","0","0","0","0","0","-2"
"196237","SUNY College at Old Westbury","2011","Total full-time Instruction/research/public service, Tenured, Associate professors","51","22","29","0","0","0","4","0","4","7","4","3","4","3","1","0","0","0","35","15","20","0","0","0","0","0","0","1","0","1","-2"
"196237","SUNY College at Old Westbury","2011","Total full-time Instruction/research/public service, Tenured, Instructors","1","1","0","0","0","0","0","0","0","0","0","0","0","0","0","0","0","0","1","1","0","0","0","0","0","0","0","0","0","0","-2"
"196237","SUNY College at Old Westbury","2011","Total full-time Instruction/research/public service, Tenured total","83","40","43","0","0","0","12","6","6","11","7","4","8","6","2","0","0","0","51","21","30","0","0","0","0","0","0","1","0","1","-2"
"196237","SUNY College at Old Westbury","2011","Total full-time Instruction/research/public service, Non-tenured on tenure track, Associate professors","2","1","1","0","0","0","0","0","0","0","0","0","0","0","0","0","0","0","2","1","1","0","0","0","0","0","0","0","0","0","-2"
"196237","SUNY College at Old Westbury","2011","Total full-time Instruction/research/public service, Non-tenured on tenure track, Assistant professors","30","15","15","0","0","0","4","3","1","5","3","2","2","1","1","0","0","0","17","7","10","0","0","0","0","0","0","2","1","1","-2"
"196237","SUNY College at Old Westbury","2011","Total full-time Instruction/research/public service, Non-tenured on tenure track, Instructors","1","1","0","0","0","0","0","0","0","0","0","0","0","0","0","0","0","0","1","1","0","0","0","0","0","0","0","0","0","0","-2"
"196237","SUNY College at Old Westbury","2011","Total full-time Instruction/research/public service, Non-tenured on tenure track total","33","17","16","0","0","0","4","3","1","5","3","2","2","1","1","0","0","0","20","9","11","0","0","0","0","0","0","2","1","1","-2"
"196237","SUNY College at Old Westbury","2011","Total full-time Instruction/research/public service, Non-tenured not on tenure track, Professors","1","1","0","0","0","0","0","0","0","0","0","0","0","0","0","0","0","0","1","1","0","0","0","0","0","0","0","0","0","0","-2"
"196237","SUNY College at Old Westbury","2011","Total full-time Instruction/research/public service, Non-tenured not on tenure track, Associate professors","1","1","0","0","0","0","0","0","0","1","1","0","0","0","0","0","0","0","0","0","0","0","0","0","0","0","0","0","0","0","-2"
"196237","SUNY College at Old Westbury","2011","Total full-time Instruction/research/public servicey, Non-tenured not on tenure track, Assistant professors","2","1","1","0","0","0","2","1","1","0","0","0","0","0","0","0","0","0","0","0","0","0","0","0","0","0","0","0","0","0","-2"
"196237","SUNY College at Old Westbury","2011","Total full-time Instruction/research/public service, Non-tenured not on tenure track, Instructors","10","3","7","0","0","0","0","0","0","0","0","0","0","0","0","0","0","0","10","3","7","0","0","0","0","0","0","0","0","0","-2"
"196237","SUNY College at Old Westbury","2011","Total full-time Instruction/research/public service, Non-tenured not on tenure track, Lecturers","6","3","3","0","0","0","1","0","1","0","0","0","0","0","0","0","0","0","5","3","2","0","0","0","0","0","0","0","0","0","-2"
"196237","SUNY College at Old Westbury","2011","Total full-time Instruction/research/public service, Non-tenured not on tenure track total","20","9","11","0","0","0","3","1","2","1","1","0","0","0","0","0","0","0","16","7","9","0","0","0","0","0","0","0","0","0","-2"
"206279","Union Institute & University","2011","Total full-time Instruction/research/public service, Non-tenured not on tenure track, No academic rank","31","15","16","0","0","0","1","0","1","5","2","3","0","0","0","0","0","0","22","13","9","0","0","0","3","0","3","0","0","0","-2"
"206279","Union Institute & University","2011","Total full-time Instruction/research/public service, Non-tenured not on tenure track total","31","15","16","0","0","0","1","0","1","5","2","3","0","0","0","0","0","0","22","13","9","0","0","0","3","0","3","0","0","0","-2"
"207351","Oklahoma Panhandle State University","2011","Total full-time Instruction/research/public service, Tenured, Professors","3","2","1","0","0","0","0","0","0","0","0","0","0","0","0","0","0","0","3","2","1","0","0","0","0","0","0","0","0","0","-2"
"207351","Oklahoma Panhandle State University","2011","Total full-time Instruction/research/public service, Tenured, Associate professors","6","3","3","0","0","0","0","0","0","0","0","0","0","0","0","0","0","0","6","3","3","0","0","0","0","0","0","0","0","0","-2"
"207351","Oklahoma Panhandle State University","2011","Total full-time Instruction/research/public service, Tenured total","9","5","4","0","0","0","0","0","0","0","0","0","0","0","0","0","0","0","9","5","4","0","0","0","0","0","0","0","0","0","-2"
"207351","Oklahoma Panhandle State University","2011","Total full-time Instruction/research/public service, Non-tenured on tenure track, Associate professors","4","4","0","0","0","0","0","0","0","0","0","0","0","0","0","0","0","0","4","4","0","0","0","0","0","0","0","0","0","0","-2"
"207351","Oklahoma Panhandle State University","2011","Total full-time Instruction/research/public service, Non-tenured on tenure track, Assistant professors","15","9","6","1","1","0","0","0","0","0","0","0","0","0","0","0","0","0","14","8","6","0","0","0","0","0","0","0","0","0","-2"
"207351","Oklahoma Panhandle State University","2011","Total full-time Instruction/research/public service, Non-tenured on tenure track total","19","13","6","1","1","0","0","0","0","0","0","0","0","0","0","0","0","0","18","12","6","0","0","0","0","0","0","0","0","0","-2"
"207351","Oklahoma Panhandle State University","2011","Total full-time Instruction/research/public service, Non-tenured not on tenure track, Associate professors","1","1","0","0","0","0","0","0","0","0","0","0","0","0","0","0","0","0","1","1","0","0","0","0","0","0","0","0","0","0","-2"
"207351","Oklahoma Panhandle State University","2011","Total full-time Instruction/research/public servicey, Non-tenured not on tenure track, Assistant professors","3","3","0","0","0","0","0","0","0","0","0","0","0","0","0","0","0","0","3","3","0","0","0","0","0","0","0","0","0","0","-2"
"207351","Oklahoma Panhandle State University","2011","Total full-time Instruction/research/public service, Non-tenured not on tenure track, Instructors","15","7","8","0","0","0","1","1","0","0","0","0","0","0","0","0","0","0","14","6","8","0","0","0","0","0","0","0","0","0","-2"
"207351","Oklahoma Panhandle State University","2011","Total full-time Instruction/research/public service, Non-tenured not on tenure track, Lecturers","5","2","3","0","0","0","0","0","0","0","0","0","0","0","0","0","0","0","5","2","3","0","0","0","0","0","0","0","0","0","-2"
"207351","Oklahoma Panhandle State University","2011","Total full-time Instruction/research/public service, Non-tenured not on tenure track total","24","13","11","0","0","0","1","1","0","0","0","0","0","0","0","0","0","0","23","12","11","0","0","0","0","0","0","0","0","0","-2"
"209241","Mount Angel Seminary","2011","Total full-time Instruction/research/public service, Non-tenured not on tenure track, Professors","4","4","0","0","0","0","0","0","0","0","0","0","0","0","0","0","0","0","4","4","0","0","0","0","0","0","0","0","0","0","-2"
"209241","Mount Angel Seminary","2011","Total full-time Instruction/research/public service, Non-tenured not on tenure track, Associate professors","8","6","2","0","0","0","1","0","1","0","0","0","0","0","0","0","0","0","6","5","1","0","0","0","0","0","0","1","1","0","-2"
"209241","Mount Angel Seminary","2011","Total full-time Instruction/research/public servicey, Non-tenured not on tenure track, Assistant professors","2","2","0","0","0","0","1","1","0","0","0","0","0","0","0","0","0","0","1","1","0","0","0","0","0","0","0","0","0","0","-2"
"209241","Mount Angel Seminary","2011","Total full-time Instruction/research/public service, Non-tenured not on tenure track total","14","12","2","0","0","0","2","1","1","0","0","0","0","0","0","0","0","0","11","10","1","0","0","0","0","0","0","1","1","0","-2"
"210304","Warner Pacific University","2011","Total full-time Instruction/research/public service, Non-tenured not on tenure track, Professors","9","7","2","0","0","0","0","0","0","0","0","0","1","1","0","0","0","0","7","5","2","1","1","0","0","0","0","0","0","0","-2"
"210304","Warner Pacific University","2011","Total full-time Instruction/research/public service, Non-tenured not on tenure track, Associate professors","9","5","4","0","0","0","0","0","0","0","0","0","0","0","0","0","0","0","9","5","4","0","0","0","0","0","0","0","0","0","-2"
"210304","Warner Pacific University","2011","Total full-time Instruction/research/public servicey, Non-tenured not on tenure track, Assistant professors","11","6","5","0","0","0","0","0","0","0","0","0","1","0","1","0","0","0","10","6","4","0","0","0","0","0","0","0","0","0","-2"
"210304","Warner Pacific University","2011","Total full-time Instruction/research/public service, Non-tenured not on tenure track total","29","18","11","0","0","0","0","0","0","0","0","0","2","1","1","0","0","0","26","16","10","1","1","0","0","0","0","0","0","0","-2"
"222831","Angelo State University","2011","Total full-time Instruction/research/public service, Tenured, Professors","70","50","20","4","3","1","3","2","1","0","0","0","1","1","0","0","0","0","62","44","18","0","0","0","0","0","0","0","0","0","-2"
"222831","Angelo State University","2011","Total full-time Instruction/research/public service, Tenured, Associate professors","47","32","15","0","0","0","3","3","0","1","1","0","4","2","2","0","0","0","39","26","13","0","0","0","0","0","0","0","0","0","-2"
"222831","Angelo State University","2011","Total full-time Instruction/research/public service, Tenured, Assistant professors","5","3","2","0","0","0","0","0","0","0","0","0","1","0","1","0","0","0","4","3","1","0","0","0","0","0","0","0","0","0","-2"
"222831","Angelo State University","2011","Total full-time Instruction/research/public service, Tenured total","122","85","37","4","3","1","6","5","1","1","1","0","6","3","3","0","0","0","105","73","32","0","0","0","0","0","0","0","0","0","-2"
"222831","Angelo State University","2011","Total full-time Instruction/research/public service, Non-tenured on tenure track, Professors","1","1","0","0","0","0","0","0","0","0","0","0","0","0","0","0","0","0","1","1","0","0","0","0","0","0","0","0","0","0","-2"
"222831","Angelo State University","2011","Total full-time Instruction/research/public service, Non-tenured on tenure track, Associate professors","5","3","2","0","0","0","0","0","0","0","0","0","0","0","0","0","0","0","5","3","2","0","0","0","0","0","0","0","0","0","-2"
"222831","Angelo State University","2011","Total full-time Instruction/research/public service, Non-tenured on tenure track, Assistant professors","74","40","34","2","0","2","2","2","0","5","3","2","6","3","3","0","0","0","54","28","26","0","0","0","0","0","0","5","4","1","-2"
"222831","Angelo State University","2011","Total full-time Instruction/research/public service, Non-tenured on tenure track total","80","44","36","2","0","2","2","2","0","5","3","2","6","3","3","0","0","0","60","32","28","0","0","0","0","0","0","5","4","1","-2"
"222831","Angelo State University","2011","Total full-time Instruction/research/public service, Non-tenured not on tenure track, Professors","1","1","0","0","0","0","0","0","0","0","0","0","0","0","0","0","0","0","1","1","0","0","0","0","0","0","0","0","0","0","-2"
"222831","Angelo State University","2011","Total full-time Instruction/research/public servicey, Non-tenured not on tenure track, Assistant professors","2","1","1","0","0","0","0","0","0","0","0","0","0","0","0","0","0","0","2","1","1","0","0","0","0","0","0","0","0","0","-2"
"222831","Angelo State University","2011","Total full-time Instruction/research/public service, Non-tenured not on tenure track, Instructors","16","8","8","0","0","0","0","0","0","0","0","0","1","1","0","0","0","0","15","7","8","0","0","0","0","0","0","0","0","0","-2"
"222831","Angelo State University","2011","Total full-time Instruction/research/public service, Non-tenured not on tenure track, Lecturers","26","12","14","0","0","0","0","0","0","0","0","0","5","3","2","0","0","0","21","9","12","0","0","0","0","0","0","0","0","0","-2"
"222831","Angelo State University","2011","Total full-time Instruction/research/public service, Non-tenured not on tenure track, No academic rank","25","4","21","0","0","0","0","0","0","1","0","1","3","0","3","0","0","0","20","4","16","0","0","0","0","0","0","1","0","1","-2"
"222831","Angelo State University","2011","Total full-time Instruction/research/public service, Non-tenured not on tenure track total","70","26","44","0","0","0","0","0","0","1","0","1","9","4","5","0","0","0","59","22","37","0","0","0","0","0","0","1","0","1","-2"
"222992","Austin Community College District","2011","Total full-time Instruction/research/public service, Non-tenured not on tenure track, Professors","356","173","183","1","0","1","11","3","8","26","11","15","41","24","17","1","1","0","271","134","137","5","0","5","0","0","0","0","0","0","-2"
"222992","Austin Community College District","2011","Total full-time Instruction/research/public service, Non-tenured not on tenure track, Associate professors","182","66","116","1","0","1","11","3","8","17","7","10","28","11","17","0","0","0","125","45","80","0","0","0","0","0","0","0","0","0","-2"
"222992","Austin Community College District","2011","Total full-time Instruction/research/public servicey, Non-tenured not on tenure track, Assistant professors","80","29","51","0","0","0","5","1","4","6","2","4","15","6","9","1","1","0","50","18","32","3","1","2","0","0","0","0","0","0","-2"
"222992","Austin Community College District","2011","Total full-time Instruction/research/public service, Non-tenured not on tenure track total","618","268","350","2","0","2","27","7","20","49","20","29","84","41","43","2","2","0","446","197","249","8","1","7","0","0","0","0","0","0","-2"
"223463","Remington College-Dallas Campus","2011","Total full-time Instruction/research/public service, Non-tenured not on tenure track, Instructors","44","21","23","0","0","0","2","1","1","15","5","10","4","1","3","0","0","0","23","14","9","0","0","0","0","0","0","0","0","0","-2"
"223463","Remington College-Dallas Campus","2011","Total full-time Instruction/research/public service, Non-tenured not on tenure track total","44","21","23","0","0","0","2","1","1","15","5","10","4","1","3","0","0","0","23","14","9","0","0","0","0","0","0","0","0","0","-2"
"223506","Brazosport College","2011","Total full-time Instruction/research/public service, Tenured, Professors","17","15","2","0","0","0","1","1","0","0","0","0","0","0","0","0","0","0","16","14","2","0","0","0","0","0","0","0","0","0","-2"
"223506","Brazosport College","2011","Total full-time Instruction/research/public service, Tenured, Associate professors","20","7","13","1","1","0","1","0","1","0","0","0","0","0","0","0","0","0","18","6","12","0","0","0","0","0","0","0","0","0","-2"
"223506","Brazosport College","2011","Total full-time Instruction/research/public service, Tenured, Assistant professors","17","12","5","0","0","0","0","0","0","2","2","0","2","0","2","0","0","0","13","10","3","0","0","0","0","0","0","0","0","0","-2"
"223506","Brazosport College","2011","Total full-time Instruction/research/public service, Tenured, Instructors","2","0","2","0","0","0","0","0","0","0","0","0","0","0","0","0","0","0","2","0","2","0","0","0","0","0","0","0","0","0","-2"
"223506","Brazosport College","2011","Total full-time Instruction/research/public service, Tenured total","56","34","22","1","1","0","2","1","1","2","2","0","2","0","2","0","0","0","49","30","19","0","0","0","0","0","0","0","0","0","-2"
"223506","Brazosport College","2011","Total full-time Instruction/research/public service, Non-tenured on tenure track, Associate professors","2","2","0","0","0","0","0","0","0","0","0","0","0","0","0","0","0","0","2","2","0","0","0","0","0","0","0","0","0","0","-2"
"223506","Brazosport College","2011","Total full-time Instruction/research/public service, Non-tenured on tenure track, Assistant professors","9","2","7","0","0","0","1","0","1","0","0","0","2","1","1","0","0","0","6","1","5","0","0","0","0","0","0","0","0","0","-2"
"223506","Brazosport College","2011","Total full-time Instruction/research/public service, Non-tenured on tenure track, Instructors","6","4","2","0","0","0","0","0","0","0","0","0","0","0","0","0","0","0","6","4","2","0","0","0","0","0","0","0","0","0","-2"
"223506","Brazosport College","2011","Total full-time Instruction/research/public service, Non-tenured on tenure track total","17","8","9","0","0","0","1","0","1","0","0","0","2","1","1","0","0","0","14","7","7","0","0","0","0","0","0","0","0","0","-2"
"223506","Brazosport College","2011","Total full-time Instruction/research/public servicey, Non-tenured not on tenure track, Assistant professors","2","0","2","0","0","0","0","0","0","0","0","0","0","0","0","0","0","0","2","0","2","0","0","0","0","0","0","0","0","0","-2"
"223506","Brazosport College","2011","Total full-time Instruction/research/public service, Non-tenured not on tenure track, Instructors","11","8","3","1","1","0","0","0","0","1","1","0","0","0","0","0","0","0","9","6","3","0","0","0","0","0","0","0","0","0","-2"
"223506","Brazosport College","2011","Total full-time Instruction/research/public service, Non-tenured not on tenure track total","13","8","5","1","1","0","0","0","0","1","1","0","0","0","0","0","0","0","11","6","5","0","0","0","0","0","0","0","0","0","-2"
"224004","Concordia University Texas","2011","Total full-time Instruction/research/public service, Tenured, Professors","1","1","0","0","0","0","0","0","0","0","0","0","0","0","0","0","0","0","1","1","0","0","0","0","0","0","0","0","0","0","-2"
"224004","Concordia University Texas","2011","Total full-time Instruction/research/public service, Tenured total","1","1","0","0","0","0","0","0","0","0","0","0","0","0","0","0","0","0","1","1","0","0","0","0","0","0","0","0","0","0","-2"
"224004","Concordia University Texas","2011","Total full-time Instruction/research/public service, Non-tenured not on tenure track, Professors","11","5","6","0","0","0","0","0","0","0","0","0","0","0","0","0","0","0","11","5","6","0","0","0","0","0","0","0","0","0","-2"
"224004","Concordia University Texas","2011","Total full-time Instruction/research/public service, Non-tenured not on tenure track, Associate professors","12","7","5","0","0","0","0","0","0","0","0","0","0","0","0","0","0","0","12","7","5","0","0","0","0","0","0","0","0","0","-2"
"224004","Concordia University Texas","2011","Total full-time Instruction/research/public servicey, Non-tenured not on tenure track, Assistant professors","38","23","15","1","0","1","0","0","0","2","1","1","1","1","0","1","1","0","31","18","13","0","0","0","2","2","0","0","0","0","-2"
"224004","Concordia University Texas","2011","Total full-time Instruction/research/public service, Non-tenured not on tenure track, Instructors","5","4","1","0","0","0","0","0","0","0","0","0","0","0","0","0","0","0","5","4","1","0","0","0","0","0","0","0","0","0","-2"
"224004","Concordia University Texas","2011","Total full-time Instruction/research/public service, Non-tenured not on tenure track total","66","39","27","1","0","1","0","0","0","2","1","1","1","1","0","1","1","0","59","34","25","0","0","0","2","2","0","0","0","0","-2"
"224961","Galveston College","2011","Total full-time Instruction/research/public service, Tenured, Professors","6","3","3","0","0","0","0","0","0","1","0","1","0","0","0","0","0","0","5","3","2","0","0","0","0","0","0","0","0","0","-2"
"224961","Galveston College","2011","Total full-time Instruction/research/public service, Tenured, Associate professors","5","3","2","0","0","0","0","0","0","1","1","0","2","1","1","0","0","0","2","1","1","0","0","0","0","0","0","0","0","0","-2"
"224961","Galveston College","2011","Total full-time Instruction/research/public service, Tenured, Assistant professors","5","3","2","0","0","0","1","1","0","1","0","1","0","0","0","0","0","0","3","2","1","0","0","0","0","0","0","0","0","0","-2"
"224961","Galveston College","2011","Total full-time Instruction/research/public service, Tenured, Instructors","12","7","5","0","0","0","0","0","0","1","0","1","2","1","1","0","0","0","9","6","3","0","0","0","0","0","0","0","0","0","-2"
"224961","Galveston College","2011","Total full-time Instruction/research/public service, Tenured total","28","16","12","0","0","0","1","1","0","4","1","3","4","2","2","0","0","0","19","12","7","0","0","0","0","0","0","0","0","0","-2"
"224961","Galveston College","2011","Total full-time Instruction/research/public service, Non-tenured on tenure track, Assistant professors","1","1","0","0","0","0","0","0","0","0","0","0","0","0","0","0","0","0","1","1","0","0","0","0","0","0","0","0","0","0","-2"
"224961","Galveston College","2011","Total full-time Instruction/research/public service, Non-tenured on tenure track, Instructors","18","9","9","0","0","0","0","0","0","1","0","1","1","1","0","0","0","0","16","8","8","0","0","0","0","0","0","0","0","0","-2"
"224961","Galveston College","2011","Total full-time Instruction/research/public service, Non-tenured on tenure track total","19","10","9","0","0","0","0","0","0","1","0","1","1","1","0","0","0","0","17","9","8","0","0","0","0","0","0","0","0","0","-2"
"225201","Hallmark University","2011","Total full-time Instruction/research/public service, Non-tenured not on tenure track, Instructors","33","19","14","0","0","0","2","1","1","5","2","3","9","5","4","0","0","0","16","11","5","1","0","1","0","0","0","0","0","0","-2"
"225201","Hallmark University","2011","Total full-time Instruction/research/public service, Non-tenured not on tenure track total","33","19","14","0","0","0","2","1","1","5","2","3","9","5","4","0","0","0","16","11","5","1","0","1","0","0","0","0","0","0","-2"
"225399","Houston Baptist University","2011","Total full-time Instruction/research/public service, Non-tenured not on tenure track, Professors","34","19","15","1","0","1","0","0","0","1","0","1","1","0","1","0","0","0","29","18","11","2","1","1","0","0","0","0","0","0","-2"
"225399","Houston Baptist University","2011","Total full-time Instruction/research/public service, Non-tenured not on tenure track, Associate professors","24","15","9","0","0","0","2","2","0","1","0","1","2","2","0","0","0","0","19","11","8","0","0","0","0","0","0","0","0","0","-2"
"225399","Houston Baptist University","2011","Total full-time Instruction/research/public servicey, Non-tenured not on tenure track, Assistant professors","43","21","22","0","0","0","2","1","1","3","1","2","4","1","3","0","0","0","31","17","14","1","1","0","2","0","2","0","0","0","-2"
"225399","Houston Baptist University","2011","Total full-time Instruction/research/public service, Non-tenured not on tenure track, Instructors","9","4","5","0","0","0","0","0","0","0","0","0","0","0","0","0","0","0","7","3","4","0","0","0","0","0","0","2","1","1","-2"
"225399","Houston Baptist University","2011","Total full-time Instruction/research/public service, Non-tenured not on tenure track total","110","59","51","1","0","1","4","3","1","5","1","4","7","3","4","0","0","0","86","49","37","3","2","1","2","0","2","2","1","1","-2"
"225414","University of Houston-Clear Lake","2011","Total full-time Instruction/research/public service, Tenured, Professors","50","37","13","0","0","0","11","8","3","1","1","0","1","0","1","0","0","0","37","28","9","0","0","0","0","0","0","0","0","0","-2"
"225414","University of Houston-Clear Lake","2011","Total full-time Instruction/research/public service, Tenured, Associate professors","81","45","36","0","0","0","9","7","2","5","3","2","4","1","3","0","0","0","63","34","29","0","0","0","0","0","0","0","0","0","-2"
"225414","University of Houston-Clear Lake","2011","Total full-time Instruction/research/public service, Tenured total","131","82","49","0","0","0","20","15","5","6","4","2","5","1","4","0","0","0","100","62","38","0","0","0","0","0","0","0","0","0","-2"
"225414","University of Houston-Clear Lake","2011","Total full-time Instruction/research/public service, Non-tenured on tenure track, Associate professors","2","1","1","0","0","0","0","0","0","0","0","0","0","0","0","0","0","0","2","1","1","0","0","0","0","0","0","0","0","0","-2"
"225414","University of Houston-Clear Lake","2011","Total full-time Instruction/research/public service, Non-tenured on tenure track, Assistant professors","76","33","43","0","0","0","9","5","4","9","1","8","3","0","3","0","0","0","43","17","26","2","2","0","0","0","0","10","8","2","-2"
"225414","University of Houston-Clear Lake","2011","Total full-time Instruction/research/public service, Non-tenured on tenure track, Instructors","1","1","0","0","0","0","0","0","0","0","0","0","0","0","0","0","0","0","1","1","0","0","0","0","0","0","0","0","0","0","-2"
"225414","University of Houston-Clear Lake","2011","Total full-time Instruction/research/public service, Non-tenured on tenure track total","79","35","44","0","0","0","9","5","4","9","1","8","3","0","3","0","0","0","46","19","27","2","2","0","0","0","0","10","8","2","-2"
"225414","University of Houston-Clear Lake","2011","Total full-time Instruction/research/public service, Non-tenured not on tenure track, Lecturers","26","10","16","0","0","0","1","0","1","0","0","0","0","0","0","0","0","0","23","10","13","2","0","2","0","0","0","0","0","0","-2"
"225414","University of Houston-Clear Lake","2011","Total full-time Instruction/research/public service, Non-tenured not on tenure track, No academic rank","14","7","7","1","0","1","3","2","1","0","0","0","0","0","0","0","0","0","9","4","5","0","0","0","0","0","0","1","1","0","-2"
"225414","University of Houston-Clear Lake","2011","Total full-time Instruction/research/public service, Non-tenured not on tenure track total","40","17","23","1","0","1","4","2","2","0","0","0","0","0","0","0","0","0","32","14","18","2","0","2","0","0","0","1","1","0","-2"
"225432","University of Houston-Downtown","2011","Total full-time Instruction/research/public service, Tenured, Professors","56","37","19","0","0","0","10","8","2","6","2","4","8","6","2","0","0","0","32","21","11","0","0","0","0","0","0","0","0","0","-2"
"225432","University of Houston-Downtown","2011","Total full-time Instruction/research/public service, Tenured, Associate professors","104","56","48","0","0","0","23","16","7","4","0","4","11","7","4","0","0","0","66","33","33","0","0","0","0","0","0","0","0","0","-2"
"225432","University of Houston-Downtown","2011","Total full-time Instruction/research/public service, Tenured total","160","93","67","0","0","0","33","24","9","10","2","8","19","13","6","0","0","0","98","54","44","0","0","0","0","0","0","0","0","0","-2"
"225432","University of Houston-Downtown","2011","Total full-time Instruction/research/public service, Non-tenured on tenure track, Assistant professors","86","42","44","1","0","1","8","4","4","9","1","8","7","4","3","0","0","0","54","28","26","0","0","0","0","0","0","7","5","2","-2"
"225432","University of Houston-Downtown","2011","Total full-time Instruction/research/public service, Non-tenured on tenure track, Instructors","3","2","1","0","0","0","0","0","0","0","0","0","0","0","0","0","0","0","3","2","1","0","0","0","0","0","0","0","0","0","-2"
"225432","University of Houston-Downtown","2011","Total full-time Instruction/research/public service, Non-tenured on tenure track total","89","44","45","1","0","1","8","4","4","9","1","8","7","4","3","0","0","0","57","30","27","0","0","0","0","0","0","7","5","2","-2"
"225432","University of Houston-Downtown","2011","Total full-time Instruction/research/public service, Non-tenured not on tenure track, Lecturers","62","23","39","0","0","0","7","3","4","10","3","7","3","1","2","1","0","1","39","16","23","1","0","1","0","0","0","1","0","1","-2"
"225432","University of Houston-Downtown","2011","Total full-time Instruction/research/public service, Non-tenured not on tenure track, No academic rank","12","4","8","0","0","0","1","0","1","0","0","0","2","2","0","0","0","0","9","2","7","0","0","0","0","0","0","0","0","0","-2"
"225432","University of Houston-Downtown","2011","Total full-time Instruction/research/public service, Non-tenured not on tenure track total","74","27","47","0","0","0","8","3","5","10","3","7","5","3","2","1","0","1","48","18","30","1","0","1","0","0","0","1","0","1","-2"
"225502","University of Houston-Victoria","2011","Total full-time Instruction/research/public service, Tenured, Professors","24","18","6","0","0","0","5","4","1","1","1","0","1","1","0","1","1","0","16","11","5","0","0","0","0","0","0","0","0","0","-2"
"225502","University of Houston-Victoria","2011","Total full-time Instruction/research/public service, Tenured, Associate professors","30","17","13","0","0","0","10","9","1","0","0","0","3","2","1","0","0","0","16","5","11","0","0","0","0","0","0","1","1","0","-2"
"225502","University of Houston-Victoria","2011","Total full-time Instruction/research/public service, Tenured total","54","35","19","0","0","0","15","13","2","1","1","0","4","3","1","1","1","0","32","16","16","0","0","0","0","0","0","1","1","0","-2"
"225502","University of Houston-Victoria","2011","Total full-time Instruction/research/public service, Non-tenured on tenure track, Associate professors","1","0","1","0","0","0","1","0","1","0","0","0","0","0","0","0","0","0","0","0","0","0","0","0","0","0","0","0","0","0","-2"
"225502","University of Houston-Victoria","2011","Total full-time Instruction/research/public service, Non-tenured on tenure track, Assistant professors","46","22","24","1","1","0","7","4","3","4","2","2","4","1","3","0","0","0","20","10","10","0","0","0","0","0","0","10","4","6","-2"
"225502","University of Houston-Victoria","2011","Total full-time Instruction/research/public service, Non-tenured on tenure track total","47","22","25","1","1","0","8","4","4","4","2","2","4","1","3","0","0","0","20","10","10","0","0","0","0","0","0","10","4","6","-2"
"225502","University of Houston-Victoria","2011","Total full-time Instruction/research/public servicey, Non-tenured not on tenure track, Assistant professors","8","2","6","0","0","0","0","0","0","0","0","0","1","0","1","0","0","0","7","2","5","0","0","0","0","0","0","0","0","0","-2"
"225502","University of Houston-Victoria","2011","Total full-time Instruction/research/public service, Non-tenured not on tenure track, Lecturers","16","7","9","0","0","0","2","2","0","0","0","0","5","1","4","0","0","0","8","3","5","0","0","0","0","0","0","1","1","0","-2"
"225502","University of Houston-Victoria","2011","Total full-time Instruction/research/public service, Non-tenured not on tenure track total","24","9","15","0","0","0","2","2","0","0","0","0","6","1","5","0","0","0","15","5","10","0","0","0","0","0","0","1","1","0","-2"
"225548","Howard Payne University","2011","Total full-time Instruction/research/public service, Tenured, Professors","6","4","2","0","0","0","0","0","0","0","0","0","0","0","0","0","0","0","6","4","2","0","0","0","0","0","0","0","0","0","-2"
"225548","Howard Payne University","2011","Total full-time Instruction/research/public service, Tenured total","6","4","2","0","0","0","0","0","0","0","0","0","0","0","0","0","0","0","6","4","2","0","0","0","0","0","0","0","0","0","-2"
"225548","Howard Payne University","2011","Total full-time Instruction/research/public service, Non-tenured not on tenure track, Professors","18","11","7","0","0","0","0","0","0","0","0","0","1","0","1","0","0","0","17","11","6","0","0","0","0","0","0","0","0","0","-2"
"225548","Howard Payne University","2011","Total full-time Instruction/research/public service, Non-tenured not on tenure track, Associate professors","27","17","10","0","0","0","0","0","0","0","0","0","2","2","0","0","0","0","25","15","10","0","0","0","0","0","0","0","0","0","-2"
"225548","Howard Payne University","2011","Total full-time Instruction/research/public servicey, Non-tenured not on tenure track, Assistant professors","27","18","9","0","0","0","0","0","0","0","0","0","0","0","0","0","0","0","27","18","9","0","0","0","0","0","0","0","0","0","-2"
"225548","Howard Payne University","2011","Total full-time Instruction/research/public service, Non-tenured not on tenure track, Instructors","6","3","3","0","0","0","0","0","0","0","0","0","0","0","0","0","0","0","6","3","3","0","0","0","0","0","0","0","0","0","-2"
"225548","Howard Payne University","2011","Total full-time Instruction/research/public service, Non-tenured not on tenure track total","78","49","29","0","0","0","0","0","0","0","0","0","3","2","1","0","0","0","75","47","28","0","0","0","0","0","0","0","0","0","-2"
"225575","Huston-Tillotson University","2011","Total full-time Instruction/research/public service, Tenured, Professors","9","2","7","0","0","0","0","0","0","5","1","4","0","0","0","3","0","3","1","1","0","0","0","0","0","0","0","0","0","0","-2"
"225575","Huston-Tillotson University","2011","Total full-time Instruction/research/public service, Tenured total","9","2","7","0","0","0","0","0","0","5","1","4","0","0","0","3","0","3","1","1","0","0","0","0","0","0","0","0","0","0","-2"
"225575","Huston-Tillotson University","2011","Total full-time Instruction/research/public service, Non-tenured on tenure track, Associate professors","2","0","2","0","0","0","0","0","0","2","0","2","0","0","0","0","0","0","0","0","0","0","0","0","0","0","0","0","0","0","-2"
"225575","Huston-Tillotson University","2011","Total full-time Instruction/research/public service, Non-tenured on tenure track, Assistant professors","1","0","1","0","0","0","0","0","0","0","0","0","0","0","0","0","0","0","1","0","1","0","0","0","0","0","0","0","0","0","-2"
"225575","Huston-Tillotson University","2011","Total full-time Instruction/research/public service, Non-tenured on tenure track total","3","0","3","0","0","0","0","0","0","2","0","2","0","0","0","0","0","0","1","0","1","0","0","0","0","0","0","0","0","0","-2"
"225575","Huston-Tillotson University","2011","Total full-time Instruction/research/public service, Non-tenured not on tenure track, Professors","5","5","0","0","0","0","0","0","0","1","1","0","1","1","0","0","0","0","3","3","0","0","0","0","0","0","0","0","0","0","-2"
"225575","Huston-Tillotson University","2011","Total full-time Instruction/research/public service, Non-tenured not on tenure track, Associate professors","4","2","2","0","0","0","0","0","0","2","1","1","0","0","0","0","0","0","2","1","1","0","0","0","0","0","0","0","0","0","-2"
"225575","Huston-Tillotson University","2011","Total full-time Instruction/research/public servicey, Non-tenured not on tenure track, Assistant professors","20","11","9","1","0","1","0","0","0","8","3","5","2","1","1","0","0","0","9","7","2","0","0","0","0","0","0","0","0","0","-2"
"225575","Huston-Tillotson University","2011","Total full-time Instruction/research/public service, Non-tenured not on tenure track, Instructors","8","4","4","0","0","0","2","1","1","2","1","1","1","1","0","0","0","0","3","1","2","0","0","0","0","0","0","0","0","0","-2"
"225575","Huston-Tillotson University","2011","Total full-time Instruction/research/public service, Non-tenured not on tenure track total","37","22","15","1","0","1","2","1","1","13","6","7","4","3","1","0","0","0","17","12","5","0","0","0","0","0","0","0","0","0","-2"
"226134","Laredo College","2011","Total full-time Instruction/research/public service, Tenured, Instructors","133","82","51","0","0","0","5","2","3","1","1","0","98","59","39","0","0","0","21","15","6","2","2","0","6","3","3","0","0","0","-2"
"226134","Laredo College","2011","Total full-time Instruction/research/public service, Tenured total","133","82","51","0","0","0","5","2","3","1","1","0","98","59","39","0","0","0","21","15","6","2","2","0","6","3","3","0","0","0","-2"
"226134","Laredo College","2011","Total full-time Instruction/research/public service, Non-tenured on tenure track, Instructors","53","26","27","0","0","0","1","1","0","2","0","2","38","18","20","0","0","0","10","7","3","0","0","0","1","0","1","1","0","1","-2"
"226134","Laredo College","2011","Total full-time Instruction/research/public service, Non-tenured on tenure track total","53","26","27","0","0","0","1","1","0","2","0","2","38","18","20","0","0","0","10","7","3","0","0","0","1","0","1","1","0","1","-2"
"226134","Laredo College","2011","Total full-time Instruction/research/public service, Non-tenured not on tenure track, Instructors","10","6","4","0","0","0","0","0","0","0","0","0","9","5","4","0","0","0","1","1","0","0","0","0","0","0","0","0","0","0","-2"
"226134","Laredo College","2011","Total full-time Instruction/research/public service, Non-tenured not on tenure track total","10","6","4","0","0","0","0","0","0","0","0","0","9","5","4","0","0","0","1","1","0","0","0","0","0","0","0","0","0","0","-2"
"226152","Texas A & M International University","2011","Total full-time Instruction/research/public service, Tenured, Professors","26","22","4","0","0","0","5","5","0","0","0","0","8","8","0","0","0","0","12","8","4","0","0","0","0","0","0","1","1","0","-2"
"226152","Texas A & M International University","2011","Total full-time Instruction/research/public service, Tenured, Associate professors","41","28","13","0","0","0","7","5","2","1","1","0","10","7","3","0","0","0","23","15","8","0","0","0","0","0","0","0","0","0","-2"
"226152","Texas A & M International University","2011","Total full-time Instruction/research/public service, Tenured, Assistant professors","5","1","4","0","0","0","1","0","1","0","0","0","1","0","1","0","0","0","3","1","2","0","0","0","0","0","0","0","0","0","-2"
"226152","Texas A & M International University","2011","Total full-time Instruction/research/public service, Tenured, Lecturers","1","1","0","0","0","0","0","0","0","0","0","0","0","0","0","0","0","0","1","1","0","0","0","0","0","0","0","0","0","0","-2"
"226152","Texas A & M International University","2011","Total full-time Instruction/research/public service, Tenured total","73","52","21","0","0","0","13","10","3","1","1","0","19","15","4","0","0","0","39","25","14","0","0","0","0","0","0","1","1","0","-2"
"226152","Texas A & M International University","2011","Total full-time Instruction/research/public service, Non-tenured on tenure track, Associate professors","6","1","5","0","0","0","1","0","1","0","0","0","0","0","0","0","0","0","4","1","3","0","0","0","0","0","0","1","0","1","-2"
"226152","Texas A & M International University","2011","Total full-time Instruction/research/public service, Non-tenured on tenure track, Assistant professors","62","33","29","0","0","0","5","3","2","2","2","0","21","11","10","0","0","0","18","8","10","0","0","0","1","1","0","15","8","7","-2"
"226152","Texas A & M International University","2011","Total full-time Instruction/research/public service, Non-tenured on tenure track total","68","34","34","0","0","0","6","3","3","2","2","0","21","11","10","0","0","0","22","9","13","0","0","0","1","1","0","16","8","8","-2"
"226152","Texas A & M International University","2011","Total full-time Instruction/research/public service, Non-tenured not on tenure track, Professors","2","2","0","0","0","0","0","0","0","0","0","0","0","0","0","0","0","0","2","2","0","0","0","0","0","0","0","0","0","0","-2"
"226152","Texas A & M International University","2011","Total full-time Instruction/research/public service, Non-tenured not on tenure track, Associate professors","3","2","1","0","0","0","0","0","0","0","0","0","1","0","1","0","0","0","2","2","0","0","0","0","0","0","0","0","0","0","-2"
"226152","Texas A & M International University","2011","Total full-time Instruction/research/public servicey, Non-tenured not on tenure track, Assistant professors","16","3","13","0","0","0","1","0","1","1","0","1","8","2","6","0","0","0","6","1","5","0","0","0","0","0","0","0","0","0","-2"
"226152","Texas A & M International University","2011","Total full-time Instruction/research/public service, Non-tenured not on tenure track, Instructors","30","11","19","0","0","0","1","0","1","2","0","2","16","8","8","0","0","0","10","3","7","1","0","1","0","0","0","0","0","0","-2"
"226152","Texas A & M International University","2011","Total full-time Instruction/research/public service, Non-tenured not on tenure track total","51","18","33","0","0","0","2","0","2","3","0","3","25","10","15","0","0","0","20","8","12","1","0","1","0","0","0","0","0","0","-2"
"226587","McMurry University","2011","Total full-time Instruction/research/public service, Tenured, Professors","18","11","7","1","1","0","0","0","0","0","0","0","0","0","0","0","0","0","17","10","7","0","0","0","0","0","0","0","0","0","-2"
"226587","McMurry University","2011","Total full-time Instruction/research/public service, Tenured, Associate professors","21","15","6","0","0","0","0","0","0","0","0","0","2","0","2","0","0","0","19","15","4","0","0","0","0","0","0","0","0","0","-2"
"226587","McMurry University","2011","Total full-time Instruction/research/public service, Tenured, Assistant professors","1","0","1","0","0","0","0","0","0","0","0","0","0","0","0","0","0","0","1","0","1","0","0","0","0","0","0","0","0","0","-2"
"226587","McMurry University","2011","Total full-time Instruction/research/public service, Tenured total","40","26","14","1","1","0","0","0","0","0","0","0","2","0","2","0","0","0","37","25","12","0","0","0","0","0","0","0","0","0","-2"
"226587","McMurry University","2011","Total full-time Instruction/research/public service, Non-tenured on tenure track, Professors","1","1","0","0","0","0","0","0","0","0","0","0","0","0","0","0","0","0","1","1","0","0","0","0","0","0","0","0","0","0","-2"
"226587","McMurry University","2011","Total full-time Instruction/research/public service, Non-tenured on tenure track, Associate professors","1","1","0","0","0","0","0","0","0","0","0","0","0","0","0","0","0","0","1","1","0","0","0","0","0","0","0","0","0","0","-2"
"226587","McMurry University","2011","Total full-time Instruction/research/public service, Non-tenured on tenure track, Assistant professors","16","11","5","0","0","0","1","0","1","0","0","0","3","2","1","0","0","0","12","9","3","0","0","0","0","0","0","0","0","0","-2"
"226587","McMurry University","2011","Total full-time Instruction/research/public service, Non-tenured on tenure track total","18","13","5","0","0","0","1","0","1","0","0","0","3","2","1","0","0","0","14","11","3","0","0","0","0","0","0","0","0","0","-2"
"226587","McMurry University","2011","Total full-time Instruction/research/public servicey, Non-tenured not on tenure track, Assistant professors","1","1","0","0","0","0","0","0","0","0","0","0","0","0","0","0","0","0","1","1","0","0","0","0","0","0","0","0","0","0","-2"
"226587","McMurry University","2011","Total full-time Instruction/research/public service, Non-tenured not on tenure track, Instructors","19","7","12","0","0","0","1","1","0","1","0","1","1","0","1","0","0","0","16","6","10","0","0","0","0","0","0","0","0","0","-2"
"226587","McMurry University","2011","Total full-time Instruction/research/public service, Non-tenured not on tenure track total","20","8","12","0","0","0","1","1","0","1","0","1","1","0","1","0","0","0","17","7","10","0","0","0","0","0","0","0","0","0","-2"
"226806","Midland College","2011","Total full-time Instruction/research/public service, Non-tenured not on tenure track, Professors","37","19","18","0","0","0","0","0","0","1","1","0","4","2","2","0","0","0","31","15","16","0","0","0","0","0","0","1","1","0","-2"
"226806","Midland College","2011","Total full-time Instruction/research/public service, Non-tenured not on tenure track, Associate professors","30","10","20","0","0","0","0","0","0","0","0","0","3","2","1","0","0","0","27","8","19","0","0","0","0","0","0","0","0","0","-2"
"226806","Midland College","2011","Total full-time Instruction/research/public servicey, Non-tenured not on tenure track, Assistant professors","24","11","13","0","0","0","0","0","0","1","0","1","4","1","3","0","0","0","17","9","8","0","0","0","1","0","1","1","1","0","-2"
"226806","Midland College","2011","Total full-time Instruction/research/public service, Non-tenured not on tenure track, Instructors","29","16","13","0","0","0","0","0","0","0","0","0","3","2","1","0","0","0","25","13","12","0","0","0","0","0","0","1","1","0","-2"
"226806","Midland College","2011","Total full-time Instruction/research/public service, Non-tenured not on tenure track, No academic rank","9","5","4","0","0","0","0","0","0","0","0","0","0","0","0","0","0","0","9","5","4","0","0","0","0","0","0","0","0","0","-2"
"226806","Midland College","2011","Total full-time Instruction/research/public service, Non-tenured not on tenure track total","129","61","68","0","0","0","0","0","0","2","1","1","14","7","7","0","0","0","109","50","59","0","0","0","1","0","1","3","3","0","-2"
"227216","University of North Texas","2011","Total full-time Instruction/research/public service, Tenured, Professors","275","220","55","1","1","0","24","21","3","6","4","2","10","6","4","0","0","0","217","173","44","2","2","0","10","9","1","5","4","1","-2"
"227216","University of North Texas","2011","Total full-time Instruction/research/public service, Tenured, Associate professors","266","155","111","2","1","1","30","22","8","12","4","8","15","9","6","0","0","0","186","104","82","2","1","1","8","6","2","11","8","3","-2"
"227216","University of North Texas","2011","Total full-time Instruction/research/public service, Tenured, Assistant professors","1","1","0","0","0","0","0","0","0","0","0","0","0","0","0","0","0","0","1","1","0","0","0","0","0","0","0","0","0","0","-2"
"227216","University of North Texas","2011","Total full-time Instruction/research/public service, Tenured, Instructors","2","1","1","0","0","0","0","0","0","1","0","1","0","0","0","0","0","0","1","1","0","0","0","0","0","0","0","0","0","0","-2"
"227216","University of North Texas","2011","Total full-time Instruction/research/public service, Tenured total","544","377","167","3","2","1","54","43","11","19","8","11","25","15","10","0","0","0","405","279","126","4","3","1","18","15","3","16","12","4","-2"
"227216","University of North Texas","2011","Total full-time Instruction/research/public service, Non-tenured on tenure track, Professors","3","3","0","0","0","0","0","0","0","0","0","0","0","0","0","0","0","0","1","1","0","0","0","0","0","0","0","2","2","0","-2"
"227216","University of North Texas","2011","Total full-time Instruction/research/public service, Non-tenured on tenure track, Associate professors","6","5","1","0","0","0","1","1","0","0","0","0","0","0","0","0","0","0","4","3","1","0","0","0","0","0","0","1","1","0","-2"
"227216","University of North Texas","2011","Total full-time Instruction/research/public service, Non-tenured on tenure track, Assistant professors","204","119","85","0","0","0","31","23","8","11","4","7","15","8","7","1","1","0","109","63","46","1","0","1","3","2","1","33","18","15","-2"
"227216","University of North Texas","2011","Total full-time Instruction/research/public service, Non-tenured on tenure track total","213","127","86","0","0","0","32","24","8","11","4","7","15","8","7","1","1","0","114","67","47","1","0","1","3","2","1","36","21","15","-2"
"227216","University of North Texas","2011","Total full-time Instruction/research/public service, Non-tenured not on tenure track, Professors","3","1","2","0","0","0","0","0","0","0","0","0","0","0","0","0","0","0","3","1","2","0","0","0","0","0","0","0","0","0","-2"
"227216","University of North Texas","2011","Total full-time Instruction/research/public service, Non-tenured not on tenure track, Associate professors","4","2","2","0","0","0","2","2","0","0","0","0","0","0","0","0","0","0","2","0","2","0","0","0","0","0","0","0","0","0","-2"
"227216","University of North Texas","2011","Total full-time Instruction/research/public servicey, Non-tenured not on tenure track, Assistant professors","14","6","8","0","0","0","1","1","0","1","1","0","1","0","1","0","0","0","9","3","6","1","0","1","0","0","0","1","1","0","-2"
"227216","University of North Texas","2011","Total full-time Instruction/research/public service, Non-tenured not on tenure track, Instructors","6","4","2","0","0","0","0","0","0","0","0","0","0","0","0","0","0","0","3","1","2","0","0","0","0","0","0","3","3","0","-2"
"227216","University of North Texas","2011","Total full-time Instruction/research/public service, Non-tenured not on tenure track, Lecturers","198","73","125","0","0","0","8","1","7","7","5","2","9","2","7","0","0","0","157","62","95","5","1","4","5","2","3","7","0","7","-2"
"227216","University of North Texas","2011","Total full-time Instruction/research/public service, Non-tenured not on tenure track, No academic rank","84","31","53","2","0","2","2","0","2","1","0","1","13","4","9","0","0","0","58","23","35","3","1","2","2","1","1","3","2","1","-2"
"227216","University of North Texas","2011","Total full-time Instruction/research/public service, Non-tenured not on tenure track total","309","117","192","2","0","2","13","4","9","9","6","3","23","6","17","0","0","0","232","90","142","9","2","7","7","3","4","14","6","8","-2"
"227331","Our Lady of the Lake University","2011","Total full-time Instruction/research/public service, Tenured, Professors","20","8","12","0","0","0","0","0","0","1","0","1","4","1","3","0","0","0","15","7","8","0","0","0","0","0","0","0","0","0","-2"
"227331","Our Lady of the Lake University","2011","Total full-time Instruction/research/public service, Tenured, Associate professors","6","4","2","0","0","0","0","0","0","1","1","0","0","0","0","0","0","0","5","3","2","0","0","0","0","0","0","0","0","0","-2"
"227331","Our Lady of the Lake University","2011","Total full-time Instruction/research/public service, Tenured total","26","12","14","0","0","0","0","0","0","2","1","1","4","1","3","0","0","0","20","10","10","0","0","0","0","0","0","0","0","0","-2"
"227331","Our Lady of the Lake University","2011","Total full-time Instruction/research/public service, Non-tenured on tenure track, Professors","5","3","2","0","0","0","0","0","0","0","0","0","0","0","0","1","1","0","4","2","2","0","0","0","0","0","0","0","0","0","-2"
"227331","Our Lady of the Lake University","2011","Total full-time Instruction/research/public service, Non-tenured on tenure track, Associate professors","11","6","5","0","0","0","0","0","0","0","0","0","6","4","2","0","0","0","5","2","3","0","0","0","0","0","0","0","0","0","-2"
"227331","Our Lady of the Lake University","2011","Total full-time Instruction/research/public service, Non-tenured on tenure track, Assistant professors","18","7","11","1","0","1","1","0","1","0","0","0","6","4","2","0","0","0","10","3","7","0","0","0","0","0","0","0","0","0","-2"
"227331","Our Lady of the Lake University","2011","Total full-time Instruction/research/public service, Non-tenured on tenure track, Instructors","5","0","5","0","0","0","0","0","0","0","0","0","3","0","3","0","0","0","2","0","2","0","0","0","0","0","0","0","0","0","-2"
"227331","Our Lady of the Lake University","2011","Total full-time Instruction/research/public service, Non-tenured on tenure track total","39","16","23","1","0","1","1","0","1","0","0","0","15","8","7","1","1","0","21","7","14","0","0","0","0","0","0","0","0","0","-2"
"227331","Our Lady of the Lake University","2011","Total full-time Instruction/research/public service, Non-tenured not on tenure track, Professors","7","2","5","0","0","0","0","0","0","0","0","0","2","0","2","0","0","0","5","2","3","0","0","0","0","0","0","0","0","0","-2"
"227331","Our Lady of the Lake University","2011","Total full-time Instruction/research/public service, Non-tenured not on tenure track, Associate professors","8","4","4","0","0","0","0","0","0","0","0","0","3","1","2","0","0","0","5","3","2","0","0","0","0","0","0","0","0","0","-2"
"227331","Our Lady of the Lake University","2011","Total full-time Instruction/research/public servicey, Non-tenured not on tenure track, Assistant professors","23","8","15","1","0","1","0","0","0","1","0","1","8","2","6","1","1","0","12","5","7","0","0","0","0","0","0","0","0","0","-2"
"227331","Our Lady of the Lake University","2011","Total full-time Instruction/research/public service, Non-tenured not on tenure track, Instructors","11","3","8","0","0","0","0","0","0","1","1","0","5","0","5","0","0","0","5","2","3","0","0","0","0","0","0","0","0","0","-2"
"227331","Our Lady of the Lake University","2011","Total full-time Instruction/research/public service, Non-tenured not on tenure track total","49","17","32","1","0","1","0","0","0","2","1","1","18","3","15","1","1","0","27","12","15","0","0","0","0","0","0","0","0","0","-2"
"227368","The University of Texas Rio Grande Valley","2011","Total full-time Instruction/research/public service, Tenured, Professors","120","90","30","0","0","0","20","17","3","1","1","0","30","17","13","0","0","0","55","44","11","8","6","2","6","5","1","0","0","0","-2"
"227368","The University of Texas Rio Grande Valley","2011","Total full-time Instruction/research/public service, Tenured, Associate professors","167","113","54","0","0","0","29","23","6","6","5","1","44","25","19","0","0","0","74","50","24","5","5","0","9","5","4","0","0","0","-2"
"227368","The University of Texas Rio Grande Valley","2011","Total full-time Instruction/research/public service, Tenured, Assistant professors","2","1","1","0","0","0","0","0","0","0","0","0","2","1","1","0","0","0","0","0","0","0","0","0","0","0","0","0","0","0","-2"
"227368","The University of Texas Rio Grande Valley","2011","Total full-time Instruction/research/public service, Tenured total","289","204","85","0","0","0","49","40","9","7","6","1","76","43","33","0","0","0","129","94","35","13","11","2","15","10","5","0","0","0","-2"
"227368","The University of Texas Rio Grande Valley","2011","Total full-time Instruction/research/public service, Non-tenured on tenure track, Professors","1","1","0","0","0","0","0","0","0","0","0","0","0","0","0","0","0","0","0","0","0","1","1","0","0","0","0","0","0","0","-2"
"227368","The University of Texas Rio Grande Valley","2011","Total full-time Instruction/research/public service, Non-tenured on tenure track, Associate professors","6","5","1","0","0","0","1","1","0","0","0","0","0","0","0","0","0","0","4","3","1","0","0","0","1","1","0","0","0","0","-2"
"227368","The University of Texas Rio Grande Valley","2011","Total full-time Instruction/research/public service, Non-tenured on tenure track, Assistant professors","164","91","73","0","0","0","30","18","12","8","5","3","38","12","26","0","0","0","77","50","27","5","4","1","6","2","4","0","0","0","-2"
"227368","The University of Texas Rio Grande Valley","2011","Total full-time Instruction/research/public service, Non-tenured on tenure track total","171","97","74","0","0","0","31","19","12","8","5","3","38","12","26","0","0","0","81","53","28","6","5","1","7","3","4","0","0","0","-2"
"227368","The University of Texas Rio Grande Valley","2011","Total full-time Instruction/research/public service, Non-tenured not on tenure track, Lecturers","138","70","68","1","1","0","14","4","10","4","1","3","62","29","33","0","0","0","50","31","19","3","1","2","4","3","1","0","0","0","-2"
"227368","The University of Texas Rio Grande Valley","2011","Total full-time Instruction/research/public service, Non-tenured not on tenure track, No academic rank","33","13","20","0","0","0","3","2","1","1","0","1","16","6","10","0","0","0","13","5","8","0","0","0","0","0","0","0","0","0","-2"
"227368","The University of Texas Rio Grande Valley","2011","Total full-time Instruction/research/public service, Non-tenured not on tenure track total","171","83","88","1","1","0","17","6","11","5","1","4","78","35","43","0","0","0","63","36","27","3","1","2","4","3","1","0","0","0","-2"
"227845","Saint Edward's University","2011","Total full-time Instruction/research/public service, Tenured, Professors","41","27","14","0","0","0","0","0","0","0","0","0","0","0","0","0","0","0","40","26","14","1","1","0","0","0","0","0","0","0","-2"
"227845","Saint Edward's University","2011","Total full-time Instruction/research/public service, Tenured, Associate professors","19","13","6","0","0","0","1","1","0","0","0","0","1","0","1","0","0","0","17","12","5","0","0","0","0","0","0","0","0","0","-2"
"227845","Saint Edward's University","2011","Total full-time Instruction/research/public service, Tenured total","60","40","20","0","0","0","1","1","0","0","0","0","1","0","1","0","0","0","57","38","19","1","1","0","0","0","0","0","0","0","-2"
"227845","Saint Edward's University","2011","Total full-time Instruction/research/public service, Non-tenured on tenure track, Professors","1","1","0","1","1","0","0","0","0","0","0","0","0","0","0","0","0","0","0","0","0","0","0","0","0","0","0","0","0","0","-2"
"227845","Saint Edward's University","2011","Total full-time Instruction/research/public service, Non-tenured on tenure track, Associate professors","44","21","23","0","0","0","2","1","1","1","0","1","4","1","3","0","0","0","36","18","18","1","1","0","0","0","0","0","0","0","-2"
"227845","Saint Edward's University","2011","Total full-time Instruction/research/public service, Non-tenured on tenure track, Assistant professors","70","35","35","0","0","0","3","2","1","3","0","3","6","3","3","0","0","0","57","30","27","0","0","0","0","0","0","1","0","1","-2"
"227845","Saint Edward's University","2011","Total full-time Instruction/research/public service, Non-tenured on tenure track total","115","57","58","1","1","0","5","3","2","4","0","4","10","4","6","0","0","0","93","48","45","1","1","0","0","0","0","1","0","1","-2"
"227845","Saint Edward's University","2011","Total full-time Instruction/research/public service, Non-tenured not on tenure track, Associate professors","2","1","1","0","0","0","0","0","0","0","0","0","0","0","0","0","0","0","2","1","1","0","0","0","0","0","0","0","0","0","-2"
"227845","Saint Edward's University","2011","Total full-time Instruction/research/public servicey, Non-tenured not on tenure track, Assistant professors","16","9","7","0","0","0","2","2","0","0","0","0","3","1","2","0","0","0","11","6","5","0","0","0","0","0","0","0","0","0","-2"
"227845","Saint Edward's University","2011","Total full-time Instruction/research/public service, Non-tenured not on tenure track, Instructors","8","5","3","0","0","0","0","0","0","0","0","0","0","0","0","0","0","0","8","5","3","0","0","0","0","0","0","0","0","0","-2"
"227845","Saint Edward's University","2011","Total full-time Instruction/research/public service, Non-tenured not on tenure track, No academic rank","2","1","1","0","0","0","1","1","0","0","0","0","0","0","0","0","0","0","1","0","1","0","0","0","0","0","0","0","0","0","-2"
"227845","Saint Edward's University","2011","Total full-time Instruction/research/public service, Non-tenured not on tenure track total","28","16","12","0","0","0","3","3","0","0","0","0","3","1","2","0","0","0","22","12","10","0","0","0","0","0","0","0","0","0","-2"
"227863","University of St Thomas","2011","Total full-time Instruction/research/public service, Tenured, Professors","37","23","14","0","0","0","2","1","1","0","0","0","1","0","1","0","0","0","33","21","12","0","0","0","1","1","0","0","0","0","-2"
"227863","University of St Thomas","2011","Total full-time Instruction/research/public service, Tenured, Associate professors","39","30","9","0","0","0","1","0","1","1","1","0","2","1","1","0","0","0","32","27","5","0","0","0","3","1","2","0","0","0","-2"
"227863","University of St Thomas","2011","Total full-time Instruction/research/public service, Tenured, Assistant professors","2","2","0","0","0","0","0","0","0","0","0","0","1","1","0","0","0","0","1","1","0","0","0","0","0","0","0","0","0","0","-2"
"227863","University of St Thomas","2011","Total full-time Instruction/research/public service, Tenured total","78","55","23","0","0","0","3","1","2","1","1","0","4","2","2","0","0","0","66","49","17","0","0","0","4","2","2","0","0","0","-2"
"227863","University of St Thomas","2011","Total full-time Instruction/research/public service, Non-tenured on tenure track, Professors","1","1","0","0","0","0","0","0","0","0","0","0","0","0","0","0","0","0","1","1","0","0","0","0","0","0","0","0","0","0","-2"
"227863","University of St Thomas","2011","Total full-time Instruction/research/public service, Non-tenured on tenure track, Associate professors","5","4","1","0","0","0","0","0","0","0","0","0","1","0","1","0","0","0","1","1","0","1","1","0","2","2","0","0","0","0","-2"
"227863","University of St Thomas","2011","Total full-time Instruction/research/public service, Non-tenured on tenure track, Assistant professors","28","14","14","0","0","0","3","2","1","1","1","0","7","3","4","0","0","0","9","3","6","1","1","0","4","3","1","3","1","2","-2"
"227863","University of St Thomas","2011","Total full-time Instruction/research/public service, Non-tenured on tenure track total","34","19","15","0","0","0","3","2","1","1","1","0","8","3","5","0","0","0","11","5","6","2","2","0","6","5","1","3","1","2","-2"
"227863","University of St Thomas","2011","Total full-time Instruction/research/public service, Non-tenured not on tenure track, Professors","6","4","2","0","0","0","0","0","0","0","0","0","0","0","0","0","0","0","5","3","2","0","0","0","1","1","0","0","0","0","-2"
"227863","University of St Thomas","2011","Total full-time Instruction/research/public service, Non-tenured not on tenure track, Associate professors","1","1","0","0","0","0","0","0","0","0","0","0","0","0","0","0","0","0","1","1","0","0","0","0","0","0","0","0","0","0","-2"
"227863","University of St Thomas","2011","Total full-time Instruction/research/public servicey, Non-tenured not on tenure track, Assistant professors","30","15","15","0","0","0","1","0","1","3","0","3","4","2","2","0","0","0","21","13","8","0","0","0","0","0","0","1","0","1","-2"
"227863","University of St Thomas","2011","Total full-time Instruction/research/public service, Non-tenured not on tenure track, Instructors","3","2","1","0","0","0","1","0","1","0","0","0","0","0","0","0","0","0","2","2","0","0","0","0","0","0","0","0","0","0","-2"
"227863","University of St Thomas","2011","Total full-time Instruction/research/public service, Non-tenured not on tenure track total","40","22","18","0","0","0","2","0","2","3","0","3","4","2","2","0","0","0","29","19","10","0","0","0","1","1","0","1","0","1","-2"
"228042","Schreiner University","2011","Total full-time Instruction/research/public service, Tenured, Professors","15","11","4","0","0","0","0","0","0","0","0","0","0","0","0","0","0","0","15","11","4","0","0","0","0","0","0","0","0","0","-2"
"228042","Schreiner University","2011","Total full-time Instruction/research/public service, Tenured, Associate professors","7","6","1","0","0","0","0","0","0","0","0","0","0","0","0","0","0","0","7","6","1","0","0","0","0","0","0","0","0","0","-2"
"228042","Schreiner University","2011","Total full-time Instruction/research/public service, Tenured total","22","17","5","0","0","0","0","0","0","0","0","0","0","0","0","0","0","0","22","17","5","0","0","0","0","0","0","0","0","0","-2"
"228042","Schreiner University","2011","Total full-time Instruction/research/public service, Non-tenured on tenure track, Associate professors","1","0","1","0","0","0","0","0","0","0","0","0","0","0","0","0","0","0","1","0","1","0","0","0","0","0","0","0","0","0","-2"
"228042","Schreiner University","2011","Total full-time Instruction/research/public service, Non-tenured on tenure track, Assistant professors","14","8","6","0","0","0","1","0","1","0","0","0","1","0","1","0","0","0","12","8","4","0","0","0","0","0","0","0","0","0","-2"
"228042","Schreiner University","2011","Total full-time Instruction/research/public service, Non-tenured on tenure track total","15","8","7","0","0","0","1","0","1","0","0","0","1","0","1","0","0","0","13","8","5","0","0","0","0","0","0","0","0","0","-2"
"228042","Schreiner University","2011","Total full-time Instruction/research/public servicey, Non-tenured not on tenure track, Assistant professors","4","4","0","0","0","0","0","0","0","0","0","0","1","1","0","0","0","0","3","3","0","0","0","0","0","0","0","0","0","0","-2"
"228042","Schreiner University","2011","Total full-time Instruction/research/public service, Non-tenured not on tenure track, Instructors","13","1","12","0","0","0","0","0","0","1","0","1","1","0","1","0","0","0","11","1","10","0","0","0","0","0","0","0","0","0","-2"
"228042","Schreiner University","2011","Total full-time Instruction/research/public service, Non-tenured not on tenure track total","17","5","12","0","0","0","0","0","0","1","0","1","2","1","1","0","0","0","14","4","10","0","0","0","0","0","0","0","0","0","-2"
"228149","St. Mary's University","2011","Total full-time Instruction/research/public service, Tenured, Professors","80","60","20","0","0","0","5","5","0","3","3","0","7","4","3","0","0","0","63","46","17","0","0","0","0","0","0","2","2","0","-2"
"228149","St. Mary's University","2011","Total full-time Instruction/research/public service, Tenured, Associate professors","40","25","15","1","1","0","0","0","0","0","0","0","5","4","1","1","1","0","31","17","14","0","0","0","0","0","0","2","2","0","-2"
"228149","St. Mary's University","2011","Total full-time Instruction/research/public service, Tenured, Assistant professors","10","6","4","0","0","0","0","0","0","0","0","0","1","1","0","0","0","0","9","5","4","0","0","0","0","0","0","0","0","0","-2"
"228149","St. Mary's University","2011","Total full-time Instruction/research/public service, Tenured total","130","91","39","1","1","0","5","5","0","3","3","0","13","9","4","1","1","0","103","68","35","0","0","0","0","0","0","4","4","0","-2"
"228149","St. Mary's University","2011","Total full-time Instruction/research/public service, Non-tenured on tenure track, Associate professors","4","2","2","0","0","0","0","0","0","1","0","1","0","0","0","0","0","0","3","2","1","0","0","0","0","0","0","0","0","0","-2"
"228149","St. Mary's University","2011","Total full-time Instruction/research/public service, Non-tenured on tenure track, Assistant professors","26","16","10","0","0","0","0","0","0","0","0","0","3","2","1","1","1","0","18","10","8","0","0","0","0","0","0","4","3","1","-2"
"228149","St. Mary's University","2011","Total full-time Instruction/research/public service, Non-tenured on tenure track total","30","18","12","0","0","0","0","0","0","1","0","1","3","2","1","1","1","0","21","12","9","0","0","0","0","0","0","4","3","1","-2"
"228149","St. Mary's University","2011","Total full-time Instruction/research/public service, Non-tenured not on tenure track, Professors","3","0","3","0","0","0","0","0","0","0","0","0","0","0","0","0","0","0","3","0","3","0","0","0","0","0","0","0","0","0","-2"
"228149","St. Mary's University","2011","Total full-time Instruction/research/public service, Non-tenured not on tenure track, Associate professors","2","2","0","0","0","0","0","0","0","0","0","0","0","0","0","0","0","0","2","2","0","0","0","0","0","0","0","0","0","0","-2"
"228149","St. Mary's University","2011","Total full-time Instruction/research/public servicey, Non-tenured not on tenure track, Assistant professors","24","14","10","0","0","0","0","0","0","0","0","0","5","2","3","0","0","0","19","12","7","0","0","0","0","0","0","0","0","0","-2"
"228149","St. Mary's University","2011","Total full-time Instruction/research/public service, Non-tenured not on tenure track, Instructors","1","1","0","0","0","0","0","0","0","0","0","0","1","1","0","0","0","0","0","0","0","0","0","0","0","0","0","0","0","0","-2"
"228149","St. Mary's University","2011","Total full-time Instruction/research/public service, Non-tenured not on tenure track, Lecturers","8","3","5","0","0","0","0","0","0","0","0","0","3","1","2","0","0","0","5","2","3","0","0","0","0","0","0","0","0","0","-2"
"228149","St. Mary's University","2011","Total full-time Instruction/research/public service, Non-tenured not on tenure track total","38","20","18","0","0","0","0","0","0","0","0","0","9","4","5","0","0","0","29","16","13","0","0","0","0","0","0","0","0","0","-2"
"228468","Southwestern Adventist University","2011","Total full-time Instruction/research/public service, Tenured, Professors","17","14","3","0","0","0","1","1","0","1","1","0","0","0","0","0","0","0","15","12","3","0","0","0","0","0","0","0","0","0","-2"
"228468","Southwestern Adventist University","2011","Total full-time Instruction/research/public service, Tenured, Associate professors","2","1","1","0","0","0","0","0","0","0","0","0","0","0","0","0","0","0","2","1","1","0","0","0","0","0","0","0","0","0","-2"
"228468","Southwestern Adventist University","2011","Total full-time Instruction/research/public service, Tenured total","19","15","4","0","0","0","1","1","0","1","1","0","0","0","0","0","0","0","17","13","4","0","0","0","0","0","0","0","0","0","-2"
"228468","Southwestern Adventist University","2011","Total full-time Instruction/research/public service, Non-tenured on tenure track, Professors","3","2","1","0","0","0","0","0","0","1","1","0","1","1","0","0","0","0","1","0","1","0","0","0","0","0","0","0","0","0","-2"
"228468","Southwestern Adventist University","2011","Total full-time Instruction/research/public service, Non-tenured on tenure track, Associate professors","16","10","6","0","0","0","0","0","0","3","3","0","2","1","1","0","0","0","11","6","5","0","0","0","0","0","0","0","0","0","-2"
"228468","Southwestern Adventist University","2011","Total full-time Instruction/research/public service, Non-tenured on tenure track, Assistant professors","13","8","5","1","1","0","0","0","0","0","0","0","2","2","0","1","0","1","9","5","4","0","0","0","0","0","0","0","0","0","-2"
"228468","Southwestern Adventist University","2011","Total full-time Instruction/research/public service, Non-tenured on tenure track, Instructors","2","1","1","0","0","0","0","0","0","0","0","0","0","0","0","0","0","0","2","1","1","0","0","0","0","0","0","0","0","0","-2"
"228468","Southwestern Adventist University","2011","Total full-time Instruction/research/public service, Non-tenured on tenure track total","34","21","13","1","1","0","0","0","0","4","4","0","5","4","1","1","0","1","23","12","11","0","0","0","0","0","0","0","0","0","-2"
"228501","Sul Ross State University","2011","Total full-time Instruction/research/public service, Tenured, Professors","36","29","7","0","0","0","3","3","0","1","1","0","1","1","0","0","0","0","31","24","7","0","0","0","0","0","0","0","0","0","-2"
"228501","Sul Ross State University","2011","Total full-time Instruction/research/public service, Tenured, Associate professors","30","16","14","0","0","0","0","0","0","1","1","0","5","3","2","0","0","0","23","12","11","1","0","1","0","0","0","0","0","0","-2"
"228501","Sul Ross State University","2011","Total full-time Instruction/research/public service, Tenured, Assistant professors","3","2","1","1","1","0","0","0","0","0","0","0","1","1","0","0","0","0","1","0","1","0","0","0","0","0","0","0","0","0","-2"
"228501","Sul Ross State University","2011","Total full-time Instruction/research/public service, Tenured total","69","47","22","1","1","0","3","3","0","2","2","0","7","5","2","0","0","0","55","36","19","1","0","1","0","0","0","0","0","0","-2"
"228501","Sul Ross State University","2011","Total full-time Instruction/research/public service, Non-tenured on tenure track, Associate professors","3","2","1","0","0","0","0","0","0","0","0","0","1","1","0","0","0","0","2","1","1","0","0","0","0","0","0","0","0","0","-2"
"228501","Sul Ross State University","2011","Total full-time Instruction/research/public service, Non-tenured on tenure track, Assistant professors","19","9","10","0","0","0","1","1","0","0","0","0","4","3","1","0","0","0","14","5","9","0","0","0","0","0","0","0","0","0","-2"
"228501","Sul Ross State University","2011","Total full-time Instruction/research/public service, Non-tenured on tenure track, Instructors","2","2","0","0","0","0","0","0","0","0","0","0","0","0","0","0","0","0","2","2","0","0","0","0","0","0","0","0","0","0","-2"
"228501","Sul Ross State University","2011","Total full-time Instruction/research/public service, Non-tenured on tenure track total","24","13","11","0","0","0","1","1","0","0","0","0","5","4","1","0","0","0","18","8","10","0","0","0","0","0","0","0","0","0","-2"
"228501","Sul Ross State University","2011","Total full-time Instruction/research/public service, Non-tenured not on tenure track, Professors","1","1","0","0","0","0","0","0","0","0","0","0","1","1","0","0","0","0","0","0","0","0","0","0","0","0","0","0","0","0","-2"
"228501","Sul Ross State University","2011","Total full-time Instruction/research/public servicey, Non-tenured not on tenure track, Assistant professors","1","1","0","0","0","0","0","0","0","0","0","0","0","0","0","0","0","0","1","1","0","0","0","0","0","0","0","0","0","0","-2"
"228501","Sul Ross State University","2011","Total full-time Instruction/research/public service, Non-tenured not on tenure track, Instructors","1","0","1","0","0","0","0","0","0","0","0","0","0","0","0","0","0","0","1","0","1","0","0","0","0","0","0","0","0","0","-2"
"228501","Sul Ross State University","2011","Total full-time Instruction/research/public service, Non-tenured not on tenure track, Lecturers","23","11","12","0","0","0","0","0","0","0","0","0","5","3","2","1","1","0","17","7","10","0","0","0","0","0","0","0","0","0","-2"
"228501","Sul Ross State University","2011","Total full-time Instruction/research/public service, Non-tenured not on tenure track total","26","13","13","0","0","0","0","0","0","0","0","0","6","4","2","1","1","0","19","8","11","0","0","0","0","0","0","0","0","0","-2"
"228644","The University of Texas Health Science Center at San Antonio","2011","Total full-time Instruction/research/public service, Tenured, Professors","235","177","58","0","0","0","30","23","7","1","1","0","16","12","4","0","0","0","186","139","47","0","0","0","1","1","0","1","1","0","-2"
"228644","The University of Texas Health Science Center at San Antonio","2011","Total full-time Instruction/research/public service, Tenured, Associate professors","88","48","40","0","0","0","13","8","5","3","2","1","11","3","8","0","0","0","60","35","25","0","0","0","0","0","0","1","0","1","-2"
"228644","The University of Texas Health Science Center at San Antonio","2011","Total full-time Instruction/research/public service, Tenured, Assistant professors","5","3","2","0","0","0","0","0","0","0","0","0","1","0","1","0","0","0","4","3","1","0","0","0","0","0","0","0","0","0","-2"
"228644","The University of Texas Health Science Center at San Antonio","2011","Total full-time Instruction/research/public service, Tenured total","328","228","100","0","0","0","43","31","12","4","3","1","28","15","13","0","0","0","250","177","73","0","0","0","1","1","0","2","1","1","-2"
"228644","The University of Texas Health Science Center at San Antonio","2011","Total full-time Instruction/research/public service, Non-tenured on tenure track, Professors","3","3","0","0","0","0","1","1","0","1","1","0","0","0","0","0","0","0","1","1","0","0","0","0","0","0","0","0","0","0","-2"
"228644","The University of Texas Health Science Center at San Antonio","2011","Total full-time Instruction/research/public service, Non-tenured on tenure track, Associate professors","25","18","7","0","0","0","3","3","0","3","3","0","4","3","1","0","0","0","13","8","5","0","0","0","0","0","0","2","1","1","-2"
"228644","The University of Texas Health Science Center at San Antonio","2011","Total full-time Instruction/research/public service, Non-tenured on tenure track, Assistant professors","118","76","42","0","0","0","13","6","7","11","10","1","22","8","14","0","0","0","62","44","18","0","0","0","2","1","1","8","7","1","-2"
"228644","The University of Texas Health Science Center at San Antonio","2011","Total full-time Instruction/research/public service, Non-tenured on tenure track total","146","97","49","0","0","0","17","10","7","15","14","1","26","11","15","0","0","0","76","53","23","0","0","0","2","1","1","10","8","2","-2"
"228644","The University of Texas Health Science Center at San Antonio","2011","Total full-time Instruction/research/public service, Non-tenured not on tenure track, Professors","56","44","12","0","0","0","4","4","0","2","2","0","6","5","1","0","0","0","43","32","11","0","0","0","0","0","0","1","1","0","-2"
"228644","The University of Texas Health Science Center at San Antonio","2011","Total full-time Instruction/research/public service, Non-tenured not on tenure track, Associate professors","118","64","54","1","0","1","18","15","3","2","1","1","11","3","8","1","0","1","82","43","39","0","0","0","0","0","0","3","2","1","-2"
"228644","The University of Texas Health Science Center at San Antonio","2011","Total full-time Instruction/research/public servicey, Non-tenured not on tenure track, Assistant professors","406","247","159","0","0","0","90","56","34","9","5","4","62","33","29","1","1","0","189","111","78","0","0","0","8","5","3","47","36","11","-2"
"228644","The University of Texas Health Science Center at San Antonio","2011","Total full-time Instruction/research/public service, Non-tenured not on tenure track, Instructors","130","61","69","0","0","0","25","15","10","3","0","3","15","3","12","0","0","0","55","19","36","0","0","0","9","9","0","23","15","8","-2"
"228644","The University of Texas Health Science Center at San Antonio","2011","Total full-time Instruction/research/public service, Non-tenured not on tenure track, Lecturers","36","16","20","0","0","0","3","3","0","1","0","1","21","13","8","0","0","0","11","0","11","0","0","0","0","0","0","0","0","0","-2"
"228644","The University of Texas Health Science Center at San Antonio","2011","Total full-time Instruction/research/public service, Non-tenured not on tenure track total","746","432","314","1","0","1","140","93","47","17","8","9","115","57","58","2","1","1","380","205","175","0","0","0","17","14","3","74","54","20","-2"
"228705","Texas A & M University-Kingsville","2011","Total full-time Instruction/research/public service, Tenured, Professors","78","61","17","1","1","0","11","11","0","2","2","0","9","5","4","0","0","0","55","42","13","0","0","0","0","0","0","0","0","0","-2"
"228705","Texas A & M University-Kingsville","2011","Total full-time Instruction/research/public service, Tenured, Associate professors","72","51","21","0","0","0","14","11","3","1","1","0","14","12","2","0","0","0","41","26","15","0","0","0","0","0","0","2","1","1","-2"
"228705","Texas A & M University-Kingsville","2011","Total full-time Instruction/research/public service, Tenured, Assistant professors","20","12","8","0","0","0","0","0","0","1","0","1","0","0","0","0","0","0","18","11","7","0","0","0","0","0","0","1","1","0","-2"
"228705","Texas A & M University-Kingsville","2011","Total full-time Instruction/research/public service, Tenured, Lecturers","1","1","0","0","0","0","0","0","0","0","0","0","0","0","0","0","0","0","1","1","0","0","0","0","0","0","0","0","0","0","-2"
"228705","Texas A & M University-Kingsville","2011","Total full-time Instruction/research/public service, Tenured total","171","125","46","1","1","0","25","22","3","4","3","1","23","17","6","0","0","0","115","80","35","0","0","0","0","0","0","3","2","1","-2"
"228705","Texas A & M University-Kingsville","2011","Total full-time Instruction/research/public service, Non-tenured on tenure track, Professors","4","4","0","0","0","0","0","0","0","0","0","0","0","0","0","0","0","0","3","3","0","0","0","0","0","0","0","1","1","0","-2"
"228705","Texas A & M University-Kingsville","2011","Total full-time Instruction/research/public service, Non-tenured on tenure track, Associate professors","4","2","2","0","0","0","0","0","0","1","1","0","1","0","1","0","0","0","2","1","1","0","0","0","0","0","0","0","0","0","-2"
"228705","Texas A & M University-Kingsville","2011","Total full-time Instruction/research/public service, Non-tenured on tenure track, Assistant professors","75","35","40","1","1","0","3","2","1","2","2","0","7","1","6","0","0","0","49","18","31","0","0","0","1","1","0","12","10","2","-2"
"228705","Texas A & M University-Kingsville","2011","Total full-time Instruction/research/public service, Non-tenured on tenure track total","83","41","42","1","1","0","3","2","1","3","3","0","8","1","7","0","0","0","54","22","32","0","0","0","1","1","0","13","11","2","-2"
"228705","Texas A & M University-Kingsville","2011","Total full-time Instruction/research/public service, Non-tenured not on tenure track, Professors","3","2","1","0","0","0","1","1","0","0","0","0","0","0","0","0","0","0","2","1","1","0","0","0","0","0","0","0","0","0","-2"
"228705","Texas A & M University-Kingsville","2011","Total full-time Instruction/research/public service, Non-tenured not on tenure track, Associate professors","4","3","1","0","0","0","0","0","0","0","0","0","2","2","0","0","0","0","2","1","1","0","0","0","0","0","0","0","0","0","-2"
"228705","Texas A & M University-Kingsville","2011","Total full-time Instruction/research/public servicey, Non-tenured not on tenure track, Assistant professors","44","28","16","0","0","0","4","3","1","1","1","0","8","4","4","1","0","1","24","17","7","0","0","0","0","0","0","6","3","3","-2"
"228705","Texas A & M University-Kingsville","2011","Total full-time Instruction/research/public service, Non-tenured not on tenure track, Instructors","2","0","2","0","0","0","0","0","0","0","0","0","1","0","1","0","0","0","1","0","1","0","0","0","0","0","0","0","0","0","-2"
"228705","Texas A & M University-Kingsville","2011","Total full-time Instruction/research/public service, Non-tenured not on tenure track, Lecturers","83","38","45","2","0","2","4","1","3","7","5","2","28","13","15","0","0","0","38","18","20","1","0","1","1","0","1","2","1","1","-2"
"228705","Texas A & M University-Kingsville","2011","Total full-time Instruction/research/public service, Non-tenured not on tenure track total","136","71","65","2","0","2","9","5","4","8","6","2","39","19","20","1","0","1","67","37","30","1","0","1","1","0","1","8","4","4","-2"
"228981","Texas Lutheran University","2011","Total full-time Instruction/research/public service, Tenured, Professors","19","13","6","0","0","0","0","0","0","0","0","0","0","0","0","0","0","0","19","13","6","0","0","0","0","0","0","0","0","0","-2"
"228981","Texas Lutheran University","2011","Total full-time Instruction/research/public service, Tenured, Associate professors","19","9","10","0","0","0","0","0","0","0","0","0","2","1","1","0","0","0","16","7","9","0","0","0","1","1","0","0","0","0","-2"
"228981","Texas Lutheran University","2011","Total full-time Instruction/research/public service, Tenured, Assistant professors","1","1","0","0","0","0","0","0","0","0","0","0","0","0","0","0","0","0","1","1","0","0","0","0","0","0","0","0","0","0","-2"
"228981","Texas Lutheran University","2011","Total full-time Instruction/research/public service, Tenured total","39","23","16","0","0","0","0","0","0","0","0","0","2","1","1","0","0","0","36","21","15","0","0","0","1","1","0","0","0","0","-2"
"228981","Texas Lutheran University","2011","Total full-time Instruction/research/public service, Non-tenured on tenure track, Associate professors","4","3","1","0","0","0","0","0","0","0","0","0","0","0","0","0","0","0","4","3","1","0","0","0","0","0","0","0","0","0","-2"
"228981","Texas Lutheran University","2011","Total full-time Instruction/research/public service, Non-tenured on tenure track, Assistant professors","18","12","6","0","0","0","1","0","1","1","1","0","1","1","0","0","0","0","15","10","5","0","0","0","0","0","0","0","0","0","-2"
"228981","Texas Lutheran University","2011","Total full-time Instruction/research/public service, Non-tenured on tenure track, Instructors","1","1","0","0","0","0","0","0","0","1","1","0","0","0","0","0","0","0","0","0","0","0","0","0","0","0","0","0","0","0","-2"
"228981","Texas Lutheran University","2011","Total full-time Instruction/research/public service, Non-tenured on tenure track total","23","16","7","0","0","0","1","0","1","2","2","0","1","1","0","0","0","0","19","13","6","0","0","0","0","0","0","0","0","0","-2"
"228981","Texas Lutheran University","2011","Total full-time Instruction/research/public service, Non-tenured not on tenure track, Instructors","1","0","1","0","0","0","0","0","0","0","0","0","0","0","0","0","0","0","1","0","1","0","0","0","0","0","0","0","0","0","-2"
"228981","Texas Lutheran University","2011","Total full-time Instruction/research/public service, Non-tenured not on tenure track, Lecturers","5","1","4","0","0","0","0","0","0","0","0","0","0","0","0","0","0","0","5","1","4","0","0","0","0","0","0","0","0","0","-2"
"228981","Texas Lutheran University","2011","Total full-time Instruction/research/public service, Non-tenured not on tenure track total","6","1","5","0","0","0","0","0","0","0","0","0","0","0","0","0","0","0","6","1","5","0","0","0","0","0","0","0","0","0","-2"
"229018","The University of Texas Permian Basin","2011","Total full-time Instruction/research/public service, Tenured, Professors","19","13","6","0","0","0","0","0","0","0","0","0","2","0","2","0","0","0","17","13","4","0","0","0","0","0","0","0","0","0","-2"
"229018","The University of Texas Permian Basin","2011","Total full-time Instruction/research/public service, Tenured, Associate professors","35","21","14","1","0","1","4","2","2","0","0","0","3","1","2","0","0","0","26","17","9","0","0","0","0","0","0","1","1","0","-2"
"229018","The University of Texas Permian Basin","2011","Total full-time Instruction/research/public service, Tenured total","54","34","20","1","0","1","4","2","2","0","0","0","5","1","4","0","0","0","43","30","13","0","0","0","0","0","0","1","1","0","-2"
"229018","The University of Texas Permian Basin","2011","Total full-time Instruction/research/public service, Non-tenured on tenure track, Associate professors","4","2","2","0","0","0","1","1","0","0","0","0","0","0","0","0","0","0","3","1","2","0","0","0","0","0","0","0","0","0","-2"
"229018","The University of Texas Permian Basin","2011","Total full-time Instruction/research/public service, Non-tenured on tenure track, Assistant professors","25","17","8","0","0","0","2","2","0","1","0","1","2","1","1","0","0","0","16","12","4","0","0","0","0","0","0","4","2","2","-2"
"229018","The University of Texas Permian Basin","2011","Total full-time Instruction/research/public service, Non-tenured on tenure track total","29","19","10","0","0","0","3","3","0","1","0","1","2","1","1","0","0","0","19","13","6","0","0","0","0","0","0","4","2","2","-2"
"229018","The University of Texas Permian Basin","2011","Total full-time Instruction/research/public service, Non-tenured not on tenure track, Professors","3","1","2","0","0","0","0","0","0","0","0","0","0","0","0","0","0","0","3","1","2","0","0","0","0","0","0","0","0","0","-2"
"229018","The University of Texas Permian Basin","2011","Total full-time Instruction/research/public servicey, Non-tenured not on tenure track, Assistant professors","5","3","2","0","0","0","0","0","0","1","0","1","1","0","1","0","0","0","3","3","0","0","0","0","0","0","0","0","0","0","-2"
"229018","The University of Texas Permian Basin","2011","Total full-time Instruction/research/public service, Non-tenured not on tenure track, Lecturers","28","7","21","0","0","0","1","0","1","0","0","0","3","0","3","0","0","0","23","6","17","0","0","0","0","0","0","1","1","0","-2"
"229018","The University of Texas Permian Basin","2011","Total full-time Instruction/research/public service, Non-tenured not on tenure track total","36","11","25","0","0","0","1","0","1","1","0","1","4","0","4","0","0","0","29","10","19","0","0","0","0","0","0","1","1","0","-2"
"229027","The University of Texas at San Antonio","2011","Total full-time Instruction/research/public service, Tenured, Professors","212","162","50","3","3","0","41","37","4","6","2","4","26","18","8","0","0","0","134","101","33","1","0","1","0","0","0","1","1","0","-2"
"229027","The University of Texas at San Antonio","2011","Total full-time Instruction/research/public service, Tenured, Associate professors","213","132","81","2","1","1","32","23","9","10","8","2","39","20","19","0","0","0","123","74","49","1","1","0","0","0","0","6","5","1","-2"
"229027","The University of Texas at San Antonio","2011","Total full-time Instruction/research/public service, Tenured total","425","294","131","5","4","1","73","60","13","16","10","6","65","38","27","0","0","0","257","175","82","2","1","1","0","0","0","7","6","1","-2"
"229027","The University of Texas at San Antonio","2011","Total full-time Instruction/research/public service, Non-tenured on tenure track, Associate professors","4","4","0","0","0","0","0","0","0","0","0","0","1","1","0","0","0","0","3","3","0","0","0","0","0","0","0","0","0","0","-2"
"229027","The University of Texas at San Antonio","2011","Total full-time Instruction/research/public service, Non-tenured on tenure track, Assistant professors","159","94","65","0","0","0","37","27","10","7","2","5","30","12","18","0","0","0","82","51","31","1","0","1","0","0","0","2","2","0","-2"
"229027","The University of Texas at San Antonio","2011","Total full-time Instruction/research/public service, Non-tenured on tenure track total","163","98","65","0","0","0","37","27","10","7","2","5","31","13","18","0","0","0","85","54","31","1","0","1","0","0","0","2","2","0","-2"
"229027","The University of Texas at San Antonio","2011","Total full-time Instruction/research/public service, Non-tenured not on tenure track, Lecturers","366","170","196","3","2","1","25","12","13","8","4","4","70","34","36","1","0","1","248","113","135","7","3","4","0","0","0","4","2","2","-2"
"229027","The University of Texas at San Antonio","2011","Total full-time Instruction/research/public service, Non-tenured not on tenure track total","366","170","196","3","2","1","25","12","13","8","4","4","70","34","36","1","0","1","248","113","135","7","3","4","0","0","0","4","2","2","-2"
"229160","Texas Wesleyan University","2011","Total full-time Instruction/research/public service, Tenured, Professors","61","37","24","0","0","0","2","1","1","3","3","0","4","3","1","0","0","0","51","29","22","0","0","0","1","1","0","0","0","0","-2"
"229160","Texas Wesleyan University","2011","Total full-time Instruction/research/public service, Tenured, Associate professors","29","11","18","0","0","0","4","2","2","0","0","0","1","0","1","0","0","0","24","9","15","0","0","0","0","0","0","0","0","0","-2"
"229160","Texas Wesleyan University","2011","Total full-time Instruction/research/public service, Tenured, Assistant professors","2","0","2","0","0","0","0","0","0","0","0","0","0","0","0","0","0","0","2","0","2","0","0","0","0","0","0","0","0","0","-2"
"229160","Texas Wesleyan University","2011","Total full-time Instruction/research/public service, Tenured total","92","48","44","0","0","0","6","3","3","3","3","0","5","3","2","0","0","0","77","38","39","0","0","0","1","1","0","0","0","0","-2"
"229160","Texas Wesleyan University","2011","Total full-time Instruction/research/public service, Non-tenured on tenure track, Associate professors","21","12","9","0","0","0","1","0","1","3","1","2","1","0","1","0","0","0","15","11","4","0","0","0","1","0","1","0","0","0","-2"
"229160","Texas Wesleyan University","2011","Total full-time Instruction/research/public service, Non-tenured on tenure track, Assistant professors","42","17","25","0","0","0","2","1","1","0","0","0","2","0","2","0","0","0","37","16","21","0","0","0","1","0","1","0","0","0","-2"
"229160","Texas Wesleyan University","2011","Total full-time Instruction/research/public service, Non-tenured on tenure track total","63","29","34","0","0","0","3","1","2","3","1","2","3","0","3","0","0","0","52","27","25","0","0","0","2","0","2","0","0","0","-2"
"229160","Texas Wesleyan University","2011","Total full-time Instruction/research/public service, Non-tenured not on tenure track, Associate professors","2","1","1","0","0","0","0","0","0","1","0","1","0","0","0","0","0","0","1","1","0","0","0","0","0","0","0","0","0","0","-2"
"229160","Texas Wesleyan University","2011","Total full-time Instruction/research/public servicey, Non-tenured not on tenure track, Assistant professors","8","2","6","0","0","0","0","0","0","0","0","0","0","0","0","0","0","0","8","2","6","0","0","0","0","0","0","0","0","0","-2"
"229160","Texas Wesleyan University","2011","Total full-time Instruction/research/public service, Non-tenured not on tenure track, Instructors","13","3","10","1","0","1","0","0","0","0","0","0","0","0","0","0","0","0","12","3","9","0","0","0","0","0","0","0","0","0","-2"
"229160","Texas Wesleyan University","2011","Total full-time Instruction/research/public service, Non-tenured not on tenure track total","23","6","17","1","0","1","0","0","0","1","0","1","0","0","0","0","0","0","21","6","15","0","0","0","0","0","0","0","0","0","-2"
"229179","Texas Woman's University","2011","Total full-time Instruction/research/public service, Tenured, Professors","50","27","23","0","0","0","2","1","1","1","1","0","0","0","0","0","0","0","47","25","22","0","0","0","0","0","0","0","0","0","-2"
"229179","Texas Woman's University","2011","Total full-time Instruction/research/public service, Tenured, Associate professors","66","18","48","0","0","0","7","4","3","3","0","3","3","2","1","0","0","0","53","12","41","0","0","0","0","0","0","0","0","0","-2"
"229179","Texas Woman's University","2011","Total full-time Instruction/research/public service, Tenured, Assistant professors","66","15","51","1","0","1","5","2","3","3","1","2","3","1","2","0","0","0","54","11","43","0","0","0","0","0","0","0","0","0","-2"
"229179","Texas Woman's University","2011","Total full-time Instruction/research/public service, Tenured, Instructors","2","0","2","0","0","0","0","0","0","0","0","0","0","0","0","0","0","0","2","0","2","0","0","0","0","0","0","0","0","0","-2"
"229179","Texas Woman's University","2011","Total full-time Instruction/research/public service, Tenured, No academic rank","7","3","4","0","0","0","0","0","0","0","0","0","1","0","1","0","0","0","6","3","3","0","0","0","0","0","0","0","0","0","-2"
"229179","Texas Woman's University","2011","Total full-time Instruction/research/public service, Tenured total","191","63","128","1","0","1","14","7","7","7","2","5","7","3","4","0","0","0","162","51","111","0","0","0","0","0","0","0","0","0","-2"
"229179","Texas Woman's University","2011","Total full-time Instruction/research/public service, Non-tenured on tenure track, Associate professors","2","1","1","0","0","0","0","0","0","0","0","0","0","0","0","0","0","0","2","1","1","0","0","0","0","0","0","0","0","0","-2"
"229179","Texas Woman's University","2011","Total full-time Instruction/research/public service, Non-tenured on tenure track, Assistant professors","7","1","6","0","0","0","0","0","0","1","1","0","0","0","0","0","0","0","6","0","6","0","0","0","0","0","0","0","0","0","-2"
"229179","Texas Woman's University","2011","Total full-time Instruction/research/public service, Non-tenured on tenure track, Lecturers","2","1","1","0","0","0","1","1","0","0","0","0","0","0","0","0","0","0","1","0","1","0","0","0","0","0","0","0","0","0","-2"
"229179","Texas Woman's University","2011","Total full-time Instruction/research/public service, Non-tenured on tenure track, No academic rank","111","29","82","0","0","0","13","5","8","9","3","6","4","2","2","2","1","1","83","18","65","0","0","0","0","0","0","0","0","0","-2"
"229179","Texas Woman's University","2011","Total full-time Instruction/research/public service, Non-tenured on tenure track total","122","32","90","0","0","0","14","6","8","10","4","6","4","2","2","2","1","1","92","19","73","0","0","0","0","0","0","0","0","0","-2"
"229179","Texas Woman's University","2011","Total full-time Instruction/research/public service, Non-tenured not on tenure track, Professors","1","0","1","0","0","0","0","0","0","0","0","0","0","0","0","0","0","0","1","0","1","0","0","0","0","0","0","0","0","0","-2"
"229179","Texas Woman's University","2011","Total full-time Instruction/research/public service, Non-tenured not on tenure track, Associate professors","10","0","10","0","0","0","0","0","0","2","0","2","0","0","0","0","0","0","8","0","8","0","0","0","0","0","0","0","0","0","-2"
"229179","Texas Woman's University","2011","Total full-time Instruction/research/public servicey, Non-tenured not on tenure track, Assistant professors","20","2","18","1","0","1","1","0","1","0","0","0","0","0","0","0","0","0","18","2","16","0","0","0","0","0","0","0","0","0","-2"
"229179","Texas Woman's University","2011","Total full-time Instruction/research/public service, Non-tenured not on tenure track, Instructors","9","0","9","0","0","0","1","0","1","0","0","0","0","0","0","0","0","0","8","0","8","0","0","0","0","0","0","0","0","0","-2"
"229179","Texas Woman's University","2011","Total full-time Instruction/research/public service, Non-tenured not on tenure track, Lecturers","6","0","6","0","0","0","0","0","0","0","0","0","0","0","0","0","0","0","6","0","6","0","0","0","0","0","0","0","0","0","-2"
"229179","Texas Woman's University","2011","Total full-time Instruction/research/public service, Non-tenured not on tenure track, No academic rank","42","4","38","0","0","0","2","0","2","2","0","2","1","0","1","0","0","0","37","4","33","0","0","0","0","0","0","0","0","0","-2"
"229179","Texas Woman's University","2011","Total full-time Instruction/research/public service, Non-tenured not on tenure track total","88","6","82","1","0","1","4","0","4","4","0","4","1","0","1","0","0","0","78","6","72","0","0","0","0","0","0","0","0","0","-2"
"229300","The University of Texas Health Science Center at Houston","2011","Total full-time Instruction/research/public service, Tenured, Professors","184","130","54","1","1","0","27","24","3","2","2","0","8","8","0","0","0","0","145","94","51","0","0","0","1","1","0","0","0","0","-2"
"229300","The University of Texas Health Science Center at Houston","2011","Total full-time Instruction/research/public service, Tenured, Associate professors","69","37","32","0","0","0","8","3","5","1","1","0","7","2","5","0","0","0","51","29","22","0","0","0","2","2","0","0","0","0","-2"
"229300","The University of Texas Health Science Center at Houston","2011","Total full-time Instruction/research/public service, Tenured, Assistant professors","2","2","0","0","0","0","0","0","0","0","0","0","0","0","0","0","0","0","2","2","0","0","0","0","0","0","0","0","0","0","-2"
"229300","The University of Texas Health Science Center at Houston","2011","Total full-time Instruction/research/public service, Tenured total","255","169","86","1","1","0","35","27","8","3","3","0","15","10","5","0","0","0","198","125","73","0","0","0","3","3","0","0","0","0","-2"
"229300","The University of Texas Health Science Center at Houston","2011","Total full-time Instruction/research/public service, Non-tenured on tenure track, Professors","17","14","3","0","0","0","4","4","0","0","0","0","0","0","0","0","0","0","13","10","3","0","0","0","0","0","0","0","0","0","-2"
"229300","The University of Texas Health Science Center at Houston","2011","Total full-time Instruction/research/public service, Non-tenured on tenure track, Associate professors","34","23","11","0","0","0","5","5","0","1","1","0","4","3","1","1","1","0","21","11","10","0","0","0","2","2","0","0","0","0","-2"
"229300","The University of Texas Health Science Center at Houston","2011","Total full-time Instruction/research/public service, Non-tenured on tenure track, Assistant professors","89","54","35","0","0","0","37","26","11","5","2","3","8","4","4","0","0","0","37","21","16","0","0","0","2","1","1","0","0","0","-2"
"229300","The University of Texas Health Science Center at Houston","2011","Total full-time Instruction/research/public service, Non-tenured on tenure track total","140","91","49","0","0","0","46","35","11","6","3","3","12","7","5","1","1","0","71","42","29","0","0","0","4","3","1","0","0","0","-2"
"229300","The University of Texas Health Science Center at Houston","2011","Total full-time Instruction/research/public service, Non-tenured not on tenure track, Professors","92","69","23","0","0","0","7","6","1","0","0","0","7","5","2","0","0","0","76","56","20","0","0","0","2","2","0","0","0","0","-2"
"229300","The University of Texas Health Science Center at Houston","2011","Total full-time Instruction/research/public service, Non-tenured not on tenure track, Associate professors","164","98","66","3","2","1","44","25","19","6","4","2","13","11","2","0","0","0","90","52","38","0","0","0","8","4","4","0","0","0","-2"
"229300","The University of Texas Health Science Center at Houston","2011","Total full-time Instruction/research/public servicey, Non-tenured not on tenure track, Assistant professors","523","265","258","3","3","0","178","97","81","45","12","33","42","16","26","0","0","0","237","129","108","0","0","0","18","8","10","0","0","0","-2"
"229300","The University of Texas Health Science Center at Houston","2011","Total full-time Instruction/research/public service, Non-tenured not on tenure track, Instructors","86","36","50","0","0","0","20","13","7","10","3","7","3","2","1","0","0","0","53","18","35","0","0","0","0","0","0","0","0","0","-2"
"229300","The University of Texas Health Science Center at Houston","2011","Total full-time Instruction/research/public service, Non-tenured not on tenure track total","865","468","397","6","5","1","249","141","108","61","19","42","65","34","31","0","0","0","456","255","201","0","0","0","28","14","14","0","0","0","-2"
"229337","Texas Tech University Health Sciences Center","2011","Total full-time Instruction/research/public service, Tenured, Professors","98","78","20","0","0","0","12","10","2","2","1","1","8","7","1","0","0","0","75","59","16","0","0","0","1","1","0","0","0","0","-2"
"229337","Texas Tech University Health Sciences Center","2011","Total full-time Instruction/research/public service, Tenured, Associate professors","48","34","14","0","0","0","8","6","2","0","0","0","3","2","1","0","0","0","37","26","11","0","0","0","0","0","0","0","0","0","-2"
"229337","Texas Tech University Health Sciences Center","2011","Total full-time Instruction/research/public service, Tenured total","146","112","34","0","0","0","20","16","4","2","1","1","11","9","2","0","0","0","112","85","27","0","0","0","1","1","0","0","0","0","-2"
"229337","Texas Tech University Health Sciences Center","2011","Total full-time Instruction/research/public service, Non-tenured on tenure track, Professors","7","7","0","0","0","0","0","0","0","0","0","0","0","0","0","0","0","0","7","7","0","0","0","0","0","0","0","0","0","0","-2"
"229337","Texas Tech University Health Sciences Center","2011","Total full-time Instruction/research/public service, Non-tenured on tenure track, Associate professors","25","15","10","0","0","0","6","4","2","0","0","0","0","0","0","0","0","0","18","10","8","0","0","0","1","1","0","0","0","0","-2"
"229337","Texas Tech University Health Sciences Center","2011","Total full-time Instruction/research/public service, Non-tenured on tenure track, Assistant professors","38","19","19","0","0","0","9","2","7","0","0","0","3","3","0","0","0","0","26","14","12","0","0","0","0","0","0","0","0","0","-2"
"229337","Texas Tech University Health Sciences Center","2011","Total full-time Instruction/research/public service, Non-tenured on tenure track, No academic rank","1","1","0","0","0","0","0","0","0","0","0","0","0","0","0","0","0","0","1","1","0","0","0","0","0","0","0","0","0","0","-2"
"229337","Texas Tech University Health Sciences Center","2011","Total full-time Instruction/research/public service, Non-tenured on tenure track total","71","42","29","0","0","0","15","6","9","0","0","0","3","3","0","0","0","0","52","32","20","0","0","0","1","1","0","0","0","0","-2"
"229337","Texas Tech University Health Sciences Center","2011","Total full-time Instruction/research/public service, Non-tenured not on tenure track, Professors","44","32","12","1","1","0","2","2","0","1","1","0","3","3","0","0","0","0","37","25","12","0","0","0","0","0","0","0","0","0","-2"
"229337","Texas Tech University Health Sciences Center","2011","Total full-time Instruction/research/public service, Non-tenured not on tenure track, Associate professors","130","80","50","0","0","0","19","13","6","4","1","3","13","11","2","0","0","0","92","54","38","0","0","0","1","1","0","1","0","1","-2"
"229337","Texas Tech University Health Sciences Center","2011","Total full-time Instruction/research/public servicey, Non-tenured not on tenure track, Assistant professors","250","123","127","2","1","1","39","23","16","15","4","11","48","25","23","0","0","0","141","66","75","0","0","0","2","1","1","3","3","0","-2"
"229337","Texas Tech University Health Sciences Center","2011","Total full-time Instruction/research/public service, Non-tenured not on tenure track, Instructors","39","9","30","0","0","0","1","0","1","2","0","2","6","4","2","0","0","0","3","3","0","0","0","0","25","0","25","2","2","0","-2"
"229337","Texas Tech University Health Sciences Center","2011","Total full-time Instruction/research/public service, Non-tenured not on tenure track, No academic rank","150","61","89","1","1","0","29","15","14","6","1","5","30","11","19","0","0","0","81","31","50","0","0","0","3","2","1","0","0","0","-2"
"229337","Texas Tech University Health Sciences Center","2011","Total full-time Instruction/research/public service, Non-tenured not on tenure track total","613","305","308","4","3","1","90","53","37","28","7","21","100","54","46","0","0","0","354","179","175","0","0","0","31","4","27","6","5","1","-2"
"229355","Tyler Junior College","2011","Total full-time Instruction/research/public service, Non-tenured not on tenure track, Instructors","281","123","158","6","3","3","0","0","0","12","4","8","6","3","3","0","0","0","256","113","143","0","0","0","0","0","0","1","0","1","-2"
"229355","Tyler Junior College","2011","Total full-time Instruction/research/public service, Non-tenured not on tenure track total","281","123","158","6","3","3","0","0","0","12","4","8","6","3","3","0","0","0","256","113","143","0","0","0","0","0","0","1","0","1","-2"
"229780","Wayland Baptist University","2011","Total full-time Instruction/research/public service, Non-tenured not on tenure track, Professors","48","34","14","0","0","0","0","0","0","1","1","0","1","1","0","0","0","0","46","32","14","0","0","0","0","0","0","0","0","0","-2"
"229780","Wayland Baptist University","2011","Total full-time Instruction/research/public service, Non-tenured not on tenure track, Associate professors","42","29","13","1","1","0","2","1","1","5","3","2","0","0","0","0","0","0","31","23","8","0","0","0","3","1","2","0","0","0","-2"
"229780","Wayland Baptist University","2011","Total full-time Instruction/research/public servicey, Non-tenured not on tenure track, Assistant professors","50","26","24","0","0","0","0","0","0","3","1","2","1","1","0","0","0","0","35","21","14","1","1","0","9","2","7","1","0","1","-2"
"229780","Wayland Baptist University","2011","Total full-time Instruction/research/public service, Non-tenured not on tenure track, Instructors","6","5","1","0","0","0","0","0","0","0","0","0","0","0","0","0","0","0","5","5","0","1","0","1","0","0","0","0","0","0","-2"
"229780","Wayland Baptist University","2011","Total full-time Instruction/research/public service, Non-tenured not on tenure track, Lecturers","2","2","0","0","0","0","0","0","0","1","1","0","0","0","0","0","0","0","1","1","0","0","0","0","0","0","0","0","0","0","-2"
"229780","Wayland Baptist University","2011","Total full-time Instruction/research/public service, Non-tenured not on tenure track, No academic rank","1","1","0","0","0","0","0","0","0","0","0","0","0","0","0","0","0","0","0","0","0","0","0","0","1","1","0","0","0","0","-2"
"229780","Wayland Baptist University","2011","Total full-time Instruction/research/public service, Non-tenured not on tenure track total","149","97","52","1","1","0","2","1","1","10","6","4","2","2","0","0","0","0","118","82","36","2","1","1","13","4","9","1","0","1","-2"
"229814","West Texas A & M University","2011","Total full-time Instruction/research/public service, Tenured, Professors","42","31","11","1","1","0","3","3","0","0","0","0","1","1","0","0","0","0","37","26","11","0","0","0","0","0","0","0","0","0","-2"
"229814","West Texas A & M University","2011","Total full-time Instruction/research/public service, Tenured, Associate professors","53","36","17","1","1","0","3","2","1","1","0","1","0","0","0","0","0","0","48","33","15","0","0","0","0","0","0","0","0","0","-2"
"229814","West Texas A & M University","2011","Total full-time Instruction/research/public service, Tenured, Assistant professors","1","1","0","0","0","0","0","0","0","0","0","0","0","0","0","0","0","0","1","1","0","0","0","0","0","0","0","0","0","0","-2"
"229814","West Texas A & M University","2011","Total full-time Instruction/research/public service, Tenured total","96","68","28","2","2","0","6","5","1","1","0","1","1","1","0","0","0","0","86","60","26","0","0","0","0","0","0","0","0","0","-2"
"229814","West Texas A & M University","2011","Total full-time Instruction/research/public service, Non-tenured on tenure track, Assistant professors","82","47","35","0","0","0","8","4","4","3","1","2","4","2","2","0","0","0","64","37","27","0","0","0","3","3","0","0","0","0","-2"
"229814","West Texas A & M University","2011","Total full-time Instruction/research/public service, Non-tenured on tenure track total","82","47","35","0","0","0","8","4","4","3","1","2","4","2","2","0","0","0","64","37","27","0","0","0","3","3","0","0","0","0","-2"
"229814","West Texas A & M University","2011","Total full-time Instruction/research/public service, Non-tenured not on tenure track, Professors","2","2","0","0","0","0","0","0","0","0","0","0","0","0","0","0","0","0","2","2","0","0","0","0","0","0","0","0","0","0","-2"
"229814","West Texas A & M University","2011","Total full-time Instruction/research/public servicey, Non-tenured not on tenure track, Assistant professors","2","1","1","0","0","0","0","0","0","0","0","0","0","0","0","0","0","0","2","1","1","0","0","0","0","0","0","0","0","0","-2"
"229814","West Texas A & M University","2011","Total full-time Instruction/research/public service, Non-tenured not on tenure track, Instructors","67","24","43","0","0","0","1","0","1","1","0","1","4","2","2","0","0","0","60","21","39","0","0","0","1","1","0","0","0","0","-2"
"229814","West Texas A & M University","2011","Total full-time Instruction/research/public service, Non-tenured not on tenure track total","71","27","44","0","0","0","1","0","1","1","0","1","4","2","2","0","0","0","64","24","40","0","0","0","1","1","0","0","0","0","-2"
"234979","Columbia Basin College","2011","Total full-time Instruction/research/public service, Tenured, No academic rank","105","53","52","1","1","0","7","3","4","3","2","1","4","1","3","0","0","0","90","46","44","0","0","0","0","0","0","0","0","0","-2"
"234979","Columbia Basin College","2011","Total full-time Instruction/research/public service, Tenured total","105","53","52","1","1","0","7","3","4","3","2","1","4","1","3","0","0","0","90","46","44","0","0","0","0","0","0","0","0","0","-2"
"234979","Columbia Basin College","2011","Total full-time Instruction/research/public service, Non-tenured on tenure track, No academic rank","6","3","3","0","0","0","0","0","0","0","0","0","1","0","1","0","0","0","5","3","2","0","0","0","0","0","0","0","0","0","-2"
"234979","Columbia Basin College","2011","Total full-time Instruction/research/public service, Non-tenured on tenure track total","6","3","3","0","0","0","0","0","0","0","0","0","1","0","1","0","0","0","5","3","2","0","0","0","0","0","0","0","0","0","-2"
"234979","Columbia Basin College","2011","Total full-time Instruction/research/public service, Non-tenured not on tenure track, No academic rank","16","5","11","0","0","0","0","0","0","0","0","0","1","1","0","0","0","0","15","4","11","0","0","0","0","0","0","0","0","0","-2"
"234979","Columbia Basin College","2011","Total full-time Instruction/research/public service, Non-tenured not on tenure track total","16","5","11","0","0","0","0","0","0","0","0","0","1","1","0","0","0","0","15","4","11","0","0","0","0","0","0","0","0","0","-2"
"235422","Heritage University","2011","Total full-time Instruction/research/public service, Non-tenured not on tenure track, Professors","7","2","5","2","1","1","0","0","0","0","0","0","1","0","1","0","0","0","4","1","3","0","0","0","0","0","0","0","0","0","-2"
"235422","Heritage University","2011","Total full-time Instruction/research/public service, Non-tenured not on tenure track, Associate professors","10","5","5","1","0","1","1","1","0","0","0","0","1","0","1","0","0","0","7","4","3","0","0","0","0","0","0","0","0","0","-2"
"235422","Heritage University","2011","Total full-time Instruction/research/public servicey, Non-tenured not on tenure track, Assistant professors","32","13","19","1","0","1","1","1","0","2","1","1","3","1","2","0","0","0","25","10","15","0","0","0","0","0","0","0","0","0","-2"
"235422","Heritage University","2011","Total full-time Instruction/research/public service, Non-tenured not on tenure track, Instructors","12","5","7","4","1","3","0","0","0","0","0","0","1","0","1","0","0","0","7","4","3","0","0","0","0","0","0","0","0","0","-2"
"235422","Heritage University","2011","Total full-time Instruction/research/public service, Non-tenured not on tenure track total","61","25","36","8","2","6","2","2","0","2","1","1","6","1","5","0","0","0","43","19","24","0","0","0","0","0","0","0","0","0","-2"
"236975","Wenatchee Valley College","2011","Total full-time Instruction/research/public service, Tenured, No academic rank","56","31","25","0","0","0","0","0","0","0","0","0","3","3","0","0","0","0","51","27","24","2","1","1","0","0","0","0","0","0","-2"
"236975","Wenatchee Valley College","2011","Total full-time Instruction/research/public service, Tenured total","56","31","25","0","0","0","0","0","0","0","0","0","3","3","0","0","0","0","51","27","24","2","1","1","0","0","0","0","0","0","-2"
"236975","Wenatchee Valley College","2011","Total full-time Instruction/research/public service, Non-tenured on tenure track, No academic rank","7","4","3","0","0","0","0","0","0","0","0","0","1","1","0","0","0","0","6","3","3","0","0","0","0","0","0","0","0","0","-2"
"236975","Wenatchee Valley College","2011","Total full-time Instruction/research/public service, Non-tenured on tenure track total","7","4","3","0","0","0","0","0","0","0","0","0","1","1","0","0","0","0","6","3","3","0","0","0","0","0","0","0","0","0","-2"
"236975","Wenatchee Valley College","2011","Total full-time Instruction/research/public service, Non-tenured not on tenure track, No academic rank","6","3","3","0","0","0","0","0","0","0","0","0","0","0","0","0","0","0","6","3","3","0","0","0","0","0","0","0","0","0","-2"
"236975","Wenatchee Valley College","2011","Total full-time Instruction/research/public service, Non-tenured not on tenure track total","6","3","3","0","0","0","0","0","0","0","0","0","0","0","0","0","0","0","6","3","3","0","0","0","0","0","0","0","0","0","-2"
"237109","Yakima Valley College","2011","Total full-time Instruction/research/public service, Tenured, Instructors","70","30","40","2","1","1","1","1","0","0","0","0","3","2","1","0","0","0","64","26","38","0","0","0","0","0","0","0","0","0","-2"
"237109","Yakima Valley College","2011","Total full-time Instruction/research/public service, Tenured total","70","30","40","2","1","1","1","1","0","0","0","0","3","2","1","0","0","0","64","26","38","0","0","0","0","0","0","0","0","0","-2"
"237109","Yakima Valley College","2011","Total full-time Instruction/research/public service, Non-tenured on tenure track, Instructors","11","5","6","0","0","0","1","0","1","0","0","0","0","0","0","0","0","0","10","5","5","0","0","0","0","0","0","0","0","0","-2"
"237109","Yakima Valley College","2011","Total full-time Instruction/research/public service, Non-tenured on tenure track total","11","5","6","0","0","0","1","0","1","0","0","0","0","0","0","0","0","0","10","5","5","0","0","0","0","0","0","0","0","0","-2"
"237109","Yakima Valley College","2011","Total full-time Instruction/research/public service, Non-tenured not on tenure track, Instructors","25","13","12","1","0","1","0","0","0","0","0","0","3","1","2","0","0","0","21","12","9","0","0","0","0","0","0","0","0","0","-2"
"237109","Yakima Valley College","2011","Total full-time Instruction/research/public service, Non-tenured not on tenure track total","25","13","12","1","0","1","0","0","0","0","0","0","3","1","2","0","0","0","21","12","9","0","0","0","0","0","0","0","0","0","-2"
"238193","Alverno College","2011","Total full-time Instruction/research/public service, Tenured, Professors","39","11","28","0","0","0","1","0","1","1","1","0","0","0","0","0","0","0","37","10","27","0","0","0","0","0","0","0","0","0","-2"
"238193","Alverno College","2011","Total full-time Instruction/research/public service, Tenured, Associate professors","30","5","25","0","0","0","0","0","0","1","0","1","0","0","0","0","0","0","29","5","24","0","0","0","0","0","0","0","0","0","-2"
"238193","Alverno College","2011","Total full-time Instruction/research/public service, Tenured, Assistant professors","10","2","8","0","0","0","1","0","1","1","0","1","1","0","1","0","0","0","7","2","5","0","0","0","0","0","0","0","0","0","-2"
"238193","Alverno College","2011","Total full-time Instruction/research/public service, Tenured total","79","18","61","0","0","0","2","0","2","3","1","2","1","0","1","0","0","0","73","17","56","0","0","0","0","0","0","0","0","0","-2"
"238193","Alverno College","2011","Total full-time Instruction/research/public service, Non-tenured on tenure track, Associate professors","1","0","1","0","0","0","0","0","0","0","0","0","0","0","0","0","0","0","1","0","1","0","0","0","0","0","0","0","0","0","-2"
"238193","Alverno College","2011","Total full-time Instruction/research/public service, Non-tenured on tenure track, Assistant professors","37","7","30","0","0","0","0","0","0","3","0","3","2","0","2","0","0","0","31","6","25","0","0","0","1","1","0","0","0","0","-2"
"238193","Alverno College","2011","Total full-time Instruction/research/public service, Non-tenured on tenure track total","38","7","31","0","0","0","0","0","0","3","0","3","2","0","2","0","0","0","32","6","26","0","0","0","1","1","0","0","0","0","-2"
"238193","Alverno College","2011","Total full-time Instruction/research/public servicey, Non-tenured not on tenure track, Assistant professors","1","1","0","0","0","0","0","0","0","0","0","0","0","0","0","0","0","0","1","1","0","0","0","0","0","0","0","0","0","0","-2"
"238193","Alverno College","2011","Total full-time Instruction/research/public service, Non-tenured not on tenure track total","1","1","0","0","0","0","0","0","0","0","0","0","0","0","0","0","0","0","1","1","0","0","0","0","0","0","0","0","0","0","-2"
"239390","Mount Mary University","2011","Total full-time Instruction/research/public service, Tenured, Professors","11","3","8","0","0","0","0","0","0","0","0","0","0","0","0","0","0","0","11","3","8","0","0","0","0","0","0","0","0","0","-2"
"239390","Mount Mary University","2011","Total full-time Instruction/research/public service, Tenured, Associate professors","24","3","21","0","0","0","1","0","1","0","0","0","0","0","0","0","0","0","23","3","20","0","0","0","0","0","0","0","0","0","-2"
"239390","Mount Mary University","2011","Total full-time Instruction/research/public service, Tenured, Assistant professors","8","0","8","0","0","0","0","0","0","0","0","0","0","0","0","0","0","0","8","0","8","0","0","0","0","0","0","0","0","0","-2"
"239390","Mount Mary University","2011","Total full-time Instruction/research/public service, Tenured total","43","6","37","0","0","0","1","0","1","0","0","0","0","0","0","0","0","0","42","6","36","0","0","0","0","0","0","0","0","0","-2"
"239390","Mount Mary University","2011","Total full-time Instruction/research/public service, Non-tenured on tenure track, Assistant professors","14","1","13","0","0","0","0","0","0","2","1","1","0","0","0","0","0","0","12","0","12","0","0","0","0","0","0","0","0","0","-2"
"239390","Mount Mary University","2011","Total full-time Instruction/research/public service, Non-tenured on tenure track, Instructors","1","1","0","0","0","0","0","0","0","0","0","0","0","0","0","0","0","0","1","1","0","0","0","0","0","0","0","0","0","0","-2"
"239390","Mount Mary University","2011","Total full-time Instruction/research/public service, Non-tenured on tenure track total","15","2","13","0","0","0","0","0","0","2","1","1","0","0","0","0","0","0","13","1","12","0","0","0","0","0","0","0","0","0","-2"
"239390","Mount Mary University","2011","Total full-time Instruction/research/public servicey, Non-tenured not on tenure track, Assistant professors","3","1","2","0","0","0","0","0","0","0","0","0","0","0","0","0","0","0","3","1","2","0","0","0","0","0","0","0","0","0","-2"
"239390","Mount Mary University","2011","Total full-time Instruction/research/public service, Non-tenured not on tenure track, Instructors","7","0","7","0","0","0","0","0","0","0","0","0","0","0","0","0","0","0","7","0","7","0","0","0","0","0","0","0","0","0","-2"
"239390","Mount Mary University","2011","Total full-time Instruction/research/public service, Non-tenured not on tenure track total","10","1","9","0","0","0","0","0","0","0","0","0","0","0","0","0","0","0","10","1","9","0","0","0","0","0","0","0","0","0","-2"
"241100","American University of Puerto Rico","2011","Total full-time Instruction/research/public service, Tenured, Associate professors","3","1","2","0","0","0","0","0","0","0","0","0","3","1","2","0","0","0","0","0","0","0","0","0","0","0","0","0","0","0","-2"
"241100","American University of Puerto Rico","2011","Total full-time Instruction/research/public service, Tenured, Assistant professors","6","3","3","0","0","0","0","0","0","0","0","0","6","3","3","0","0","0","0","0","0","0","0","0","0","0","0","0","0","0","-2"
"241100","American University of Puerto Rico","2011","Total full-time Instruction/research/public service, Tenured, Instructors","12","6","6","0","0","0","0","0","0","0","0","0","12","6","6","0","0","0","0","0","0","0","0","0","0","0","0","0","0","0","-2"
"241100","American University of Puerto Rico","2011","Total full-time Instruction/research/public service, Tenured total","21","10","11","0","0","0","0","0","0","0","0","0","21","10","11","0","0","0","0","0","0","0","0","0","0","0","0","0","0","0","-2"
"241128","American University of Puerto Rico","2011","Total full-time Instruction/research/public service, Tenured, Assistant professors","6","2","4","0","0","0","0","0","0","0","0","0","6","2","4","0","0","0","0","0","0","0","0","0","0","0","0","0","0","0","-2"
"241128","American University of Puerto Rico","2011","Total full-time Instruction/research/public service, Tenured, Instructors","18","10","8","0","0","0","0","0","0","0","0","0","18","10","8","0","0","0","0","0","0","0","0","0","0","0","0","0","0","0","-2"
"241128","American University of Puerto Rico","2011","Total full-time Instruction/research/public service, Tenured total","24","12","12","0","0","0","0","0","0","0","0","0","24","12","12","0","0","0","0","0","0","0","0","0","0","0","0","0","0","0","-2"
"241191","Universidad Adventista de las Antillas","2011","Total full-time Instruction/research/public service, Tenured, Professors","9","2","7","0","0","0","0","0","0","0","0","0","9","2","7","0","0","0","0","0","0","0","0","0","0","0","0","0","0","0","-2"
"241191","Universidad Adventista de las Antillas","2011","Total full-time Instruction/research/public service, Tenured, Associate professors","14","7","7","0","0","0","0","0","0","0","0","0","14","7","7","0","0","0","0","0","0","0","0","0","0","0","0","0","0","0","-2"
"241191","Universidad Adventista de las Antillas","2011","Total full-time Instruction/research/public service, Tenured, Assistant professors","15","8","7","0","0","0","0","0","0","0","0","0","15","8","7","0","0","0","0","0","0","0","0","0","0","0","0","0","0","0","-2"
"241191","Universidad Adventista de las Antillas","2011","Total full-time Instruction/research/public service, Tenured, Instructors","4","3","1","0","0","0","0","0","0","0","0","0","4","3","1","0","0","0","0","0","0","0","0","0","0","0","0","0","0","0","-2"
"241191","Universidad Adventista de las Antillas","2011","Total full-time Instruction/research/public service, Tenured total","42","20","22","0","0","0","0","0","0","0","0","0","42","20","22","0","0","0","0","0","0","0","0","0","0","0","0","0","0","0","-2"
"241191","Universidad Adventista de las Antillas","2011","Total full-time Instruction/research/public service, Non-tenured on tenure track, No academic rank","5","2","3","0","0","0","0","0","0","0","0","0","4","2","2","0","0","0","1","0","1","0","0","0","0","0","0","0","0","0","-2"
"241191","Universidad Adventista de las Antillas","2011","Total full-time Instruction/research/public service, Non-tenured on tenure track total","5","2","3","0","0","0","0","0","0","0","0","0","4","2","2","0","0","0","1","0","1","0","0","0","0","0","0","0","0","0","-2"
"241191","Universidad Adventista de las Antillas","2011","Total full-time Instruction/research/public service, Non-tenured not on tenure track, No academic rank","3","2","1","0","0","0","0","0","0","0","0","0","2","1","1","0","0","0","1","1","0","0","0","0","0","0","0","0","0","0","-2"
"241191","Universidad Adventista de las Antillas","2011","Total full-time Instruction/research/public service, Non-tenured not on tenure track total","3","2","1","0","0","0","0","0","0","0","0","0","2","1","1","0","0","0","1","1","0","0","0","0","0","0","0","0","0","0","-2"
"241216","Atlantic University College","2011","Total full-time Instruction/research/public service, Tenured, Professors","23","17","6","0","0","0","0","0","0","0","0","0","23","17","6","0","0","0","0","0","0","0","0","0","0","0","0","0","0","0","-2"
"241216","Atlantic University College","2011","Total full-time Instruction/research/public service, Tenured total","23","17","6","0","0","0","0","0","0","0","0","0","23","17","6","0","0","0","0","0","0","0","0","0","0","0","0","0","0","0","-2"
"241225","Universidad Central de Bayamon","2011","Total full-time Instruction/research/public service, Non-tenured on tenure track, Professors","2","1","1","0","0","0","0","0","0","0","0","0","0","0","0","0","0","0","2","1","1","0","0","0","0","0","0","0","0","0","-2"
"241225","Universidad Central de Bayamon","2011","Total full-time Instruction/research/public service, Non-tenured on tenure track, Associate professors","6","3","3","0","0","0","0","0","0","0","0","0","6","3","3","0","0","0","0","0","0","0","0","0","0","0","0","0","0","0","-2"
"241225","Universidad Central de Bayamon","2011","Total full-time Instruction/research/public service, Non-tenured on tenure track, Assistant professors","23","6","17","0","0","0","0","0","0","0","0","0","23","6","17","0","0","0","0","0","0","0","0","0","0","0","0","0","0","0","-2"
"241225","Universidad Central de Bayamon","2011","Total full-time Instruction/research/public service, Non-tenured on tenure track, Instructors","9","3","6","0","0","0","0","0","0","0","0","0","9","3","6","0","0","0","0","0","0","0","0","0","0","0","0","0","0","0","-2"
"241225","Universidad Central de Bayamon","2011","Total full-time Instruction/research/public service, Non-tenured on tenure track total","40","13","27","0","0","0","0","0","0","0","0","0","38","12","26","0","0","0","2","1","1","0","0","0","0","0","0","0","0","0","-2"
"241225","Universidad Central de Bayamon","2011","Total full-time Instruction/research/public service, Non-tenured not on tenure track, Lecturers","2","1","1","0","0","0","0","0","0","0","0","0","2","1","1","0","0","0","0","0","0","0","0","0","0","0","0","0","0","0","-2"
"241225","Universidad Central de Bayamon","2011","Total full-time Instruction/research/public service, Non-tenured not on tenure track total","2","1","1","0","0","0","0","0","0","0","0","0","2","1","1","0","0","0","0","0","0","0","0","0","0","0","0","0","0","0","-2"
"241377","Caribbean University-Bayamon","2011","Total full-time Instruction/research/public service, Tenured, Professors","1","1","0","0","0","0","0","0","0","0","0","0","1","1","0","0","0","0","0","0","0","0","0","0","0","0","0","0","0","0","-2"
"241377","Caribbean University-Bayamon","2011","Total full-time Instruction/research/public service, Tenured, Assistant professors","10","6","4","0","0","0","0","0","0","0","0","0","10","6","4","0","0","0","0","0","0","0","0","0","0","0","0","0","0","0","-2"
"241377","Caribbean University-Bayamon","2011","Total full-time Instruction/research/public service, Tenured, Instructors","24","13","11","0","0","0","0","0","0","0","0","0","24","13","11","0","0","0","0","0","0","0","0","0","0","0","0","0","0","0","-2"
"241377","Caribbean University-Bayamon","2011","Total full-time Instruction/research/public service, Tenured total","35","20","15","0","0","0","0","0","0","0","0","0","35","20","15","0","0","0","0","0","0","0","0","0","0","0","0","0","0","0","-2"
"241386","Caribbean University-Carolina","2011","Total full-time Instruction/research/public service, Tenured, Assistant professors","8","7","1","0","0","0","0","0","0","0","0","0","8","7","1","0","0","0","0","0","0","0","0","0","0","0","0","0","0","0","-2"
"241386","Caribbean University-Carolina","2011","Total full-time Instruction/research/public service, Tenured, Instructors","6","2","4","0","0","0","0","0","0","0","0","0","6","2","4","0","0","0","0","0","0","0","0","0","0","0","0","0","0","0","-2"
"241386","Caribbean University-Carolina","2011","Total full-time Instruction/research/public service, Tenured total","14","9","5","0","0","0","0","0","0","0","0","0","14","9","5","0","0","0","0","0","0","0","0","0","0","0","0","0","0","0","-2"
"241395","Pontifical Catholic University of Puerto Rico-Arecibo","2011","Total full-time Instruction/research/public service, Tenured, Professors","2","1","1","0","0","0","0","0","0","0","0","0","2","1","1","0","0","0","0","0","0","0","0","0","0","0","0","0","0","0","-2"
"241395","Pontifical Catholic University of Puerto Rico-Arecibo","2011","Total full-time Instruction/research/public service, Tenured, Associate professors","1","0","1","0","0","0","0","0","0","0","0","0","1","0","1","0","0","0","0","0","0","0","0","0","0","0","0","0","0","0","-2"
"241395","Pontifical Catholic University of Puerto Rico-Arecibo","2011","Total full-time Instruction/research/public service, Tenured total","3","1","2","0","0","0","0","0","0","0","0","0","3","1","2","0","0","0","0","0","0","0","0","0","0","0","0","0","0","0","-2"
"241395","Pontifical Catholic University of Puerto Rico-Arecibo","2011","Total full-time Instruction/research/public service, Non-tenured not on tenure track, Associate professors","1","1","0","0","0","0","0","0","0","0","0","0","1","1","0","0","0","0","0","0","0","0","0","0","0","0","0","0","0","0","-2"
"241395","Pontifical Catholic University of Puerto Rico-Arecibo","2011","Total full-time Instruction/research/public servicey, Non-tenured not on tenure track, Assistant professors","3","2","1","0","0","0","0","0","0","0","0","0","3","2","1","0","0","0","0","0","0","0","0","0","0","0","0","0","0","0","-2"
"241395","Pontifical Catholic University of Puerto Rico-Arecibo","2011","Total full-time Instruction/research/public service, Non-tenured not on tenure track, Instructors","1","0","1","0","0","0","0","0","0","0","0","0","1","0","1","0","0","0","0","0","0","0","0","0","0","0","0","0","0","0","-2"
"241395","Pontifical Catholic University of Puerto Rico-Arecibo","2011","Total full-time Instruction/research/public service, Non-tenured not on tenure track, No academic rank","5","2","3","0","0","0","0","0","0","0","0","0","5","2","3","0","0","0","0","0","0","0","0","0","0","0","0","0","0","0","-2"
"241395","Pontifical Catholic University of Puerto Rico-Arecibo","2011","Total full-time Instruction/research/public service, Non-tenured not on tenure track total","10","5","5","0","0","0","0","0","0","0","0","0","10","5","5","0","0","0","0","0","0","0","0","0","0","0","0","0","0","0","-2"
"241410","Pontifical Catholic University of Puerto Rico-Ponce","2011","Total full-time Instruction/research/public service, Tenured, Professors","22","11","11","0","0","0","0","0","0","0","0","0","21","10","11","0","0","0","0","0","0","0","0","0","1","1","0","0","0","0","-2"
"241410","Pontifical Catholic University of Puerto Rico-Ponce","2011","Total full-time Instruction/research/public service, Tenured, Associate professors","27","12","15","0","0","0","0","0","0","0","0","0","24","9","15","0","0","0","3","3","0","0","0","0","0","0","0","0","0","0","-2"
"241410","Pontifical Catholic University of Puerto Rico-Ponce","2011","Total full-time Instruction/research/public service, Tenured, Assistant professors","13","6","7","0","0","0","0","0","0","0","0","0","12","5","7","0","0","0","1","1","0","0","0","0","0","0","0","0","0","0","-2"
"241410","Pontifical Catholic University of Puerto Rico-Ponce","2011","Total full-time Instruction/research/public service, Tenured, No academic rank","2","0","2","0","0","0","0","0","0","0","0","0","2","0","2","0","0","0","0","0","0","0","0","0","0","0","0","0","0","0","-2"
"241410","Pontifical Catholic University of Puerto Rico-Ponce","2011","Total full-time Instruction/research/public service, Tenured total","64","29","35","0","0","0","0","0","0","0","0","0","59","24","35","0","0","0","4","4","0","0","0","0","1","1","0","0","0","0","-2"
"241410","Pontifical Catholic University of Puerto Rico-Ponce","2011","Total full-time Instruction/research/public service, Non-tenured on tenure track, Professors","1","0","1","0","0","0","0","0","0","0","0","0","1","0","1","0","0","0","0","0","0","0","0","0","0","0","0","0","0","0","-2"
"241410","Pontifical Catholic University of Puerto Rico-Ponce","2011","Total full-time Instruction/research/public service, Non-tenured on tenure track, Associate professors","5","4","1","0","0","0","0","0","0","0","0","0","5","4","1","0","0","0","0","0","0","0","0","0","0","0","0","0","0","0","-2"
"241410","Pontifical Catholic University of Puerto Rico-Ponce","2011","Total full-time Instruction/research/public service, Non-tenured on tenure track, Assistant professors","4","3","1","0","0","0","0","0","0","0","0","0","4","3","1","0","0","0","0","0","0","0","0","0","0","0","0","0","0","0","-2"
"241410","Pontifical Catholic University of Puerto Rico-Ponce","2011","Total full-time Instruction/research/public service, Non-tenured on tenure track total","10","7","3","0","0","0","0","0","0","0","0","0","10","7","3","0","0","0","0","0","0","0","0","0","0","0","0","0","0","0","-2"
"241410","Pontifical Catholic University of Puerto Rico-Ponce","2011","Total full-time Instruction/research/public service, Non-tenured not on tenure track, Professors","2","0","2","0","0","0","0","0","0","0","0","0","2","0","2","0","0","0","0","0","0","0","0","0","0","0","0","0","0","0","-2"
"241410","Pontifical Catholic University of Puerto Rico-Ponce","2011","Total full-time Instruction/research/public service, Non-tenured not on tenure track, Associate professors","19","10","9","0","0","0","0","0","0","0","0","0","18","9","9","0","0","0","1","1","0","0","0","0","0","0","0","0","0","0","-2"
"241410","Pontifical Catholic University of Puerto Rico-Ponce","2011","Total full-time Instruction/research/public servicey, Non-tenured not on tenure track, Assistant professors","51","26","25","0","0","0","0","0","0","0","0","0","42","23","19","0","0","0","8","2","6","0","0","0","1","1","0","0","0","0","-2"
"241410","Pontifical Catholic University of Puerto Rico-Ponce","2011","Total full-time Instruction/research/public service, Non-tenured not on tenure track, Instructors","7","5","2","0","0","0","0","0","0","0","0","0","6","4","2","0","0","0","1","1","0","0","0","0","0","0","0","0","0","0","-2"
"241410","Pontifical Catholic University of Puerto Rico-Ponce","2011","Total full-time Instruction/research/public service, Non-tenured not on tenure track, No academic rank","62","20","42","0","0","0","0","0","0","0","0","0","60","20","40","0","0","0","1","0","1","0","0","0","1","0","1","0","0","0","-2"
"241410","Pontifical Catholic University of Puerto Rico-Ponce","2011","Total full-time Instruction/research/public service, Non-tenured not on tenure track total","141","61","80","0","0","0","0","0","0","0","0","0","128","56","72","0","0","0","11","4","7","0","0","0","2","1","1","0","0","0","-2"
"241614","Universidad Teologica del Caribe","2011","Total full-time Instruction/research/public service, Non-tenured not on tenure track, No academic rank","8","4","4","0","0","0","0","0","0","0","0","0","8","4","4","0","0","0","0","0","0","0","0","0","0","0","0","0","0","0","-2"
"241614","Universidad Teologica del Caribe","2011","Total full-time Instruction/research/public service, Non-tenured not on tenure track total","8","4","4","0","0","0","0","0","0","0","0","0","8","4","4","0","0","0","0","0","0","0","0","0","0","0","0","0","0","0","-2"
"241720","Colegio Universitario de San Juan","2011","Total full-time Instruction/research/public service, Tenured, Professors","2","1","1","0","0","0","0","0","0","0","0","0","2","1","1","0","0","0","0","0","0","0","0","0","0","0","0","0","0","0","-2"
"241720","Colegio Universitario de San Juan","2011","Total full-time Instruction/research/public service, Tenured, Associate professors","5","1","4","0","0","0","0","0","0","0","0","0","5","1","4","0","0","0","0","0","0","0","0","0","0","0","0","0","0","0","-2"
"241720","Colegio Universitario de San Juan","2011","Total full-time Instruction/research/public service, Tenured, Assistant professors","6","2","4","0","0","0","0","0","0","0","0","0","6","2","4","0","0","0","0","0","0","0","0","0","0","0","0","0","0","0","-2"
"241720","Colegio Universitario de San Juan","2011","Total full-time Instruction/research/public service, Tenured, Instructors","18","6","12","0","0","0","0","0","0","0","0","0","18","6","12","0","0","0","0","0","0","0","0","0","0","0","0","0","0","0","-2"
"241720","Colegio Universitario de San Juan","2011","Total full-time Instruction/research/public service, Tenured total","31","10","21","0","0","0","0","0","0","0","0","0","31","10","21","0","0","0","0","0","0","0","0","0","0","0","0","0","0","0","-2"
"241739","Universidad Ana G. Mendez-Cupey Campus","2011","Total full-time Instruction/research/public service, Tenured, Professors","15","3","12","0","0","0","0","0","0","0","0","0","15","3","12","0","0","0","0","0","0","0","0","0","0","0","0","0","0","0","-2"
"241739","Universidad Ana G. Mendez-Cupey Campus","2011","Total full-time Instruction/research/public service, Tenured, Associate professors","7","2","5","0","0","0","0","0","0","0","0","0","7","2","5","0","0","0","0","0","0","0","0","0","0","0","0","0","0","0","-2"
"241739","Universidad Ana G. Mendez-Cupey Campus","2011","Total full-time Instruction/research/public service, Tenured, Assistant professors","2","0","2","0","0","0","0","0","0","0","0","0","2","0","2","0","0","0","0","0","0","0","0","0","0","0","0","0","0","0","-2"
"241739","Universidad Ana G. Mendez-Cupey Campus","2011","Total full-time Instruction/research/public service, Tenured total","24","5","19","0","0","0","0","0","0","0","0","0","24","5","19","0","0","0","0","0","0","0","0","0","0","0","0","0","0","0","-2"
"241739","Universidad Ana G. Mendez-Cupey Campus","2011","Total full-time Instruction/research/public service, Non-tenured not on tenure track, Professors","11","6","5","0","0","0","0","0","0","0","0","0","11","6","5","0","0","0","0","0","0","0","0","0","0","0","0","0","0","0","-2"
"241739","Universidad Ana G. Mendez-Cupey Campus","2011","Total full-time Instruction/research/public service, Non-tenured not on tenure track, Associate professors","19","9","10","0","0","0","0","0","0","0","0","0","18","8","10","0","0","0","1","1","0","0","0","0","0","0","0","0","0","0","-2"
"241739","Universidad Ana G. Mendez-Cupey Campus","2011","Total full-time Instruction/research/public servicey, Non-tenured not on tenure track, Assistant professors","26","13","13","0","0","0","0","0","0","0","0","0","26","13","13","0","0","0","0","0","0","0","0","0","0","0","0","0","0","0","-2"
"241739","Universidad Ana G. Mendez-Cupey Campus","2011","Total full-time Instruction/research/public service, Non-tenured not on tenure track, Instructors","34","6","28","0","0","0","0","0","0","0","0","0","32","6","26","0","0","0","2","0","2","0","0","0","0","0","0","0","0","0","-2"
"241739","Universidad Ana G. Mendez-Cupey Campus","2011","Total full-time Instruction/research/public service, Non-tenured not on tenure track total","90","34","56","0","0","0","0","0","0","0","0","0","87","33","54","0","0","0","3","1","2","0","0","0","0","0","0","0","0","0","-2"
"241766","Conservatory of Music of Puerto Rico","2011","Total full-time Instruction/research/public service, Tenured, Professors","5","3","2","0","0","0","0","0","0","0","0","0","5","3","2","0","0","0","0","0","0","0","0","0","0","0","0","0","0","0","-2"
"241766","Conservatory of Music of Puerto Rico","2011","Total full-time Instruction/research/public service, Tenured, Associate professors","9","7","2","0","0","0","0","0","0","0","0","0","9","7","2","0","0","0","0","0","0","0","0","0","0","0","0","0","0","0","-2"
"241766","Conservatory of Music of Puerto Rico","2011","Total full-time Instruction/research/public service, Tenured, Assistant professors","10","9","1","0","0","0","0","0","0","0","0","0","9","8","1","0","0","0","1","1","0","0","0","0","0","0","0","0","0","0","-2"
"241766","Conservatory of Music of Puerto Rico","2011","Total full-time Instruction/research/public service, Tenured total","24","19","5","0","0","0","0","0","0","0","0","0","23","18","5","0","0","0","1","1","0","0","0","0","0","0","0","0","0","0","-2"
"241766","Conservatory of Music of Puerto Rico","2011","Total full-time Instruction/research/public service, Non-tenured on tenure track, Assistant professors","5","3","2","0","0","0","0","0","0","0","0","0","5","3","2","0","0","0","0","0","0","0","0","0","0","0","0","0","0","0","-2"
"241766","Conservatory of Music of Puerto Rico","2011","Total full-time Instruction/research/public service, Non-tenured on tenure track, Instructors","10","9","1","0","0","0","0","0","0","0","0","0","10","9","1","0","0","0","0","0","0","0","0","0","0","0","0","0","0","0","-2"
"241766","Conservatory of Music of Puerto Rico","2011","Total full-time Instruction/research/public service, Non-tenured on tenure track total","15","12","3","0","0","0","0","0","0","0","0","0","15","12","3","0","0","0","0","0","0","0","0","0","0","0","0","0","0","0","-2"
"241766","Conservatory of Music of Puerto Rico","2011","Total full-time Instruction/research/public service, Non-tenured not on tenure track, No academic rank","11","7","4","0","0","0","0","0","0","0","0","0","9","6","3","0","0","0","2","1","1","0","0","0","0","0","0","0","0","0","-2"
"241766","Conservatory of Music of Puerto Rico","2011","Total full-time Instruction/research/public service, Non-tenured not on tenure track total","11","7","4","0","0","0","0","0","0","0","0","0","9","6","3","0","0","0","2","1","1","0","0","0","0","0","0","0","0","0","-2"
"241836","EDP University of Puerto Rico Inc-San Sebastian","2011","Total full-time Instruction/research/public service, Non-tenured not on tenure track, Instructors","19","6","13","0","0","0","0","0","0","0","0","0","19","6","13","0","0","0","0","0","0","0","0","0","0","0","0","0","0","0","-2"
"241836","EDP University of Puerto Rico Inc-San Sebastian","2011","Total full-time Instruction/research/public service, Non-tenured not on tenure track total","19","6","13","0","0","0","0","0","0","0","0","0","19","6","13","0","0","0","0","0","0","0","0","0","0","0","0","0","0","0","-2"
"241951","Escuela de Artes Plasticas y Diseno de Puerto Rico","2011","Total full-time Instruction/research/public service, Tenured, Professors","1","0","1","0","0","0","0","0","0","0","0","0","1","0","1","0","0","0","0","0","0","0","0","0","0","0","0","0","0","0","-2"
"241951","Escuela de Artes Plasticas y Diseno de Puerto Rico","2011","Total full-time Instruction/research/public service, Tenured, Associate professors","4","3","1","0","0","0","0","0","0","0","0","0","4","3","1","0","0","0","0","0","0","0","0","0","0","0","0","0","0","0","-2"
"241951","Escuela de Artes Plasticas y Diseno de Puerto Rico","2011","Total full-time Instruction/research/public service, Tenured, Assistant professors","3","1","2","0","0","0","0","0","0","0","0","0","3","1","2","0","0","0","0","0","0","0","0","0","0","0","0","0","0","0","-2"
"241951","Escuela de Artes Plasticas y Diseno de Puerto Rico","2011","Total full-time Instruction/research/public service, Tenured, Instructors","7","5","2","0","0","0","0","0","0","0","0","0","7","5","2","0","0","0","0","0","0","0","0","0","0","0","0","0","0","0","-2"
"241951","Escuela de Artes Plasticas y Diseno de Puerto Rico","2011","Total full-time Instruction/research/public service, Tenured total","15","9","6","0","0","0","0","0","0","0","0","0","15","9","6","0","0","0","0","0","0","0","0","0","0","0","0","0","0","0","-2"
"241951","Escuela de Artes Plasticas y Diseno de Puerto Rico","2011","Total full-time Instruction/research/public service, Non-tenured on tenure track, Assistant professors","1","0","1","0","0","0","0","0","0","0","0","0","1","0","1","0","0","0","0","0","0","0","0","0","0","0","0","0","0","0","-2"
"241951","Escuela de Artes Plasticas y Diseno de Puerto Rico","2011","Total full-time Instruction/research/public service, Non-tenured on tenure track, Instructors","1","0","1","0","0","0","0","0","0","0","0","0","1","0","1","0","0","0","0","0","0","0","0","0","0","0","0","0","0","0","-2"
"241951","Escuela de Artes Plasticas y Diseno de Puerto Rico","2011","Total full-time Instruction/research/public service, Non-tenured on tenure track total","2","0","2","0","0","0","0","0","0","0","0","0","2","0","2","0","0","0","0","0","0","0","0","0","0","0","0","0","0","0","-2"
"242121","Humacao Community College","2011","Total full-time Instruction/research/public service, Tenured, Professors","10","3","7","0","0","0","0","0","0","0","0","0","10","3","7","0","0","0","0","0","0","0","0","0","0","0","0","0","0","0","-2"
"242121","Humacao Community College","2011","Total full-time Instruction/research/public service, Tenured total","10","3","7","0","0","0","0","0","0","0","0","0","10","3","7","0","0","0","0","0","0","0","0","0","0","0","0","0","0","0","-2"
"242617","Inter American University of Puerto Rico-San German","2011","Total full-time Instruction/research/public service, Tenured, Professors","23","12","11","0","0","0","0","0","0","0","0","0","23","12","11","0","0","0","0","0","0","0","0","0","0","0","0","0","0","0","-2"
"242617","Inter American University of Puerto Rico-San German","2011","Total full-time Instruction/research/public service, Tenured, Associate professors","38","20","18","0","0","0","0","0","0","0","0","0","38","20","18","0","0","0","0","0","0","0","0","0","0","0","0","0","0","0","-2"
"242617","Inter American University of Puerto Rico-San German","2011","Total full-time Instruction/research/public service, Tenured, Assistant professors","20","5","15","0","0","0","0","0","0","0","0","0","20","5","15","0","0","0","0","0","0","0","0","0","0","0","0","0","0","0","-2"
"242617","Inter American University of Puerto Rico-San German","2011","Total full-time Instruction/research/public service, Tenured total","81","37","44","0","0","0","0","0","0","0","0","0","81","37","44","0","0","0","0","0","0","0","0","0","0","0","0","0","0","0","-2"
"242617","Inter American University of Puerto Rico-San German","2011","Total full-time Instruction/research/public service, Non-tenured on tenure track, Professors","1","1","0","0","0","0","0","0","0","0","0","0","1","1","0","0","0","0","0","0","0","0","0","0","0","0","0","0","0","0","-2"
"242617","Inter American University of Puerto Rico-San German","2011","Total full-time Instruction/research/public service, Non-tenured on tenure track, Associate professors","12","3","9","0","0","0","0","0","0","0","0","0","12","3","9","0","0","0","0","0","0","0","0","0","0","0","0","0","0","0","-2"
"242617","Inter American University of Puerto Rico-San German","2011","Total full-time Instruction/research/public service, Non-tenured on tenure track, Assistant professors","17","6","11","0","0","0","0","0","0","0","0","0","17","6","11","0","0","0","0","0","0","0","0","0","0","0","0","0","0","0","-2"
"242617","Inter American University of Puerto Rico-San German","2011","Total full-time Instruction/research/public service, Non-tenured on tenure track, Instructors","4","2","2","0","0","0","0","0","0","0","0","0","4","2","2","0","0","0","0","0","0","0","0","0","0","0","0","0","0","0","-2"
"242617","Inter American University of Puerto Rico-San German","2011","Total full-time Instruction/research/public service, Non-tenured on tenure track total","34","12","22","0","0","0","0","0","0","0","0","0","34","12","22","0","0","0","0","0","0","0","0","0","0","0","0","0","0","0","-2"
"242617","Inter American University of Puerto Rico-San German","2011","Total full-time Instruction/research/public servicey, Non-tenured not on tenure track, Assistant professors","6","2","4","0","0","0","0","0","0","0","0","0","6","2","4","0","0","0","0","0","0","0","0","0","0","0","0","0","0","0","-2"
"242617","Inter American University of Puerto Rico-San German","2011","Total full-time Instruction/research/public service, Non-tenured not on tenure track, Instructors","4","1","3","0","0","0","0","0","0","0","0","0","4","1","3","0","0","0","0","0","0","0","0","0","0","0","0","0","0","0","-2"
"242617","Inter American University of Puerto Rico-San German","2011","Total full-time Instruction/research/public service, Non-tenured not on tenure track total","10","3","7","0","0","0","0","0","0","0","0","0","10","3","7","0","0","0","0","0","0","0","0","0","0","0","0","0","0","0","-2"
"242626","Inter American University of Puerto Rico-Aguadilla","2011","Total full-time Instruction/research/public service, Tenured, Professors","9","4","5","0","0","0","0","0","0","0","0","0","9","4","5","0","0","0","0","0","0","0","0","0","0","0","0","0","0","0","-2"
"242626","Inter American University of Puerto Rico-Aguadilla","2011","Total full-time Instruction/research/public service, Tenured, Associate professors","27","6","21","0","0","0","0","0","0","1","0","1","26","6","20","0","0","0","0","0","0","0","0","0","0","0","0","0","0","0","-2"
"242626","Inter American University of Puerto Rico-Aguadilla","2011","Total full-time Instruction/research/public service, Tenured, Assistant professors","27","17","10","0","0","0","0","0","0","0","0","0","27","17","10","0","0","0","0","0","0","0","0","0","0","0","0","0","0","0","-2"
"242626","Inter American University of Puerto Rico-Aguadilla","2011","Total full-time Instruction/research/public service, Tenured, Instructors","1","1","0","0","0","0","0","0","0","0","0","0","1","1","0","0","0","0","0","0","0","0","0","0","0","0","0","0","0","0","-2"
"242626","Inter American University of Puerto Rico-Aguadilla","2011","Total full-time Instruction/research/public service, Tenured total","64","28","36","0","0","0","0","0","0","1","0","1","63","28","35","0","0","0","0","0","0","0","0","0","0","0","0","0","0","0","-2"
"242626","Inter American University of Puerto Rico-Aguadilla","2011","Total full-time Instruction/research/public service, Non-tenured on tenure track, Associate professors","3","0","3","0","0","0","0","0","0","0","0","0","3","0","3","0","0","0","0","0","0","0","0","0","0","0","0","0","0","0","-2"
"242626","Inter American University of Puerto Rico-Aguadilla","2011","Total full-time Instruction/research/public service, Non-tenured on tenure track, Assistant professors","2","0","2","0","0","0","0","0","0","0","0","0","2","0","2","0","0","0","0","0","0","0","0","0","0","0","0","0","0","0","-2"
"242626","Inter American University of Puerto Rico-Aguadilla","2011","Total full-time Instruction/research/public service, Non-tenured on tenure track, Instructors","3","2","1","0","0","0","0","0","0","0","0","0","3","2","1","0","0","0","0","0","0","0","0","0","0","0","0","0","0","0","-2"
"242626","Inter American University of Puerto Rico-Aguadilla","2011","Total full-time Instruction/research/public service, Non-tenured on tenure track total","8","2","6","0","0","0","0","0","0","0","0","0","8","2","6","0","0","0","0","0","0","0","0","0","0","0","0","0","0","0","-2"
"242626","Inter American University of Puerto Rico-Aguadilla","2011","Total full-time Instruction/research/public service, Non-tenured not on tenure track, Associate professors","1","0","1","0","0","0","0","0","0","0","0","0","1","0","1","0","0","0","0","0","0","0","0","0","0","0","0","0","0","0","-2"
"242626","Inter American University of Puerto Rico-Aguadilla","2011","Total full-time Instruction/research/public servicey, Non-tenured not on tenure track, Assistant professors","1","0","1","0","0","0","0","0","0","0","0","0","1","0","1","0","0","0","0","0","0","0","0","0","0","0","0","0","0","0","-2"
"242626","Inter American University of Puerto Rico-Aguadilla","2011","Total full-time Instruction/research/public service, Non-tenured not on tenure track, Instructors","6","2","4","0","0","0","0","0","0","0","0","0","6","2","4","0","0","0","0","0","0","0","0","0","0","0","0","0","0","0","-2"
"242626","Inter American University of Puerto Rico-Aguadilla","2011","Total full-time Instruction/research/public service, Non-tenured not on tenure track total","8","2","6","0","0","0","0","0","0","0","0","0","8","2","6","0","0","0","0","0","0","0","0","0","0","0","0","0","0","0","-2"
"242635","Inter American University of Puerto Rico-Arecibo","2011","Total full-time Instruction/research/public service, Tenured, Professors","19","10","9","0","0","0","0","0","0","0","0","0","19","10","9","0","0","0","0","0","0","0","0","0","0","0","0","0","0","0","-2"
"242635","Inter American University of Puerto Rico-Arecibo","2011","Total full-time Instruction/research/public service, Tenured, Associate professors","20","11","9","0","0","0","0","0","0","0","0","0","20","11","9","0","0","0","0","0","0","0","0","0","0","0","0","0","0","0","-2"
"242635","Inter American University of Puerto Rico-Arecibo","2011","Total full-time Instruction/research/public service, Tenured, Assistant professors","21","11","10","0","0","0","0","0","0","0","0","0","21","11","10","0","0","0","0","0","0","0","0","0","0","0","0","0","0","0","-2"
"242635","Inter American University of Puerto Rico-Arecibo","2011","Total full-time Instruction/research/public service, Tenured total","60","32","28","0","0","0","0","0","0","0","0","0","60","32","28","0","0","0","0","0","0","0","0","0","0","0","0","0","0","0","-2"
"242635","Inter American University of Puerto Rico-Arecibo","2011","Total full-time Instruction/research/public service, Non-tenured on tenure track, Associate professors","7","3","4","0","0","0","0","0","0","0","0","0","7","3","4","0","0","0","0","0","0","0","0","0","0","0","0","0","0","0","-2"
"242635","Inter American University of Puerto Rico-Arecibo","2011","Total full-time Instruction/research/public service, Non-tenured on tenure track, Assistant professors","10","5","5","0","0","0","0","0","0","0","0","0","10","5","5","0","0","0","0","0","0","0","0","0","0","0","0","0","0","0","-2"
"242635","Inter American University of Puerto Rico-Arecibo","2011","Total full-time Instruction/research/public service, Non-tenured on tenure track, Instructors","6","3","3","0","0","0","0","0","0","0","0","0","6","3","3","0","0","0","0","0","0","0","0","0","0","0","0","0","0","0","-2"
"242635","Inter American University of Puerto Rico-Arecibo","2011","Total full-time Instruction/research/public service, Non-tenured on tenure track total","23","11","12","0","0","0","0","0","0","0","0","0","23","11","12","0","0","0","0","0","0","0","0","0","0","0","0","0","0","0","-2"
"242635","Inter American University of Puerto Rico-Arecibo","2011","Total full-time Instruction/research/public servicey, Non-tenured not on tenure track, Assistant professors","6","2","4","0","0","0","0","0","0","0","0","0","6","2","4","0","0","0","0","0","0","0","0","0","0","0","0","0","0","0","-2"
"242635","Inter American University of Puerto Rico-Arecibo","2011","Total full-time Instruction/research/public service, Non-tenured not on tenure track, Instructors","10","2","8","0","0","0","0","0","0","0","0","0","10","2","8","0","0","0","0","0","0","0","0","0","0","0","0","0","0","0","-2"
"242635","Inter American University of Puerto Rico-Arecibo","2011","Total full-time Instruction/research/public service, Non-tenured not on tenure track total","16","4","12","0","0","0","0","0","0","0","0","0","16","4","12","0","0","0","0","0","0","0","0","0","0","0","0","0","0","0","-2"
"242644","Inter American University of Puerto Rico-Barranquitas","2011","Total full-time Instruction/research/public service, Tenured, Professors","2","2","0","0","0","0","0","0","0","0","0","0","2","2","0","0","0","0","0","0","0","0","0","0","0","0","0","0","0","0","-2"
"242644","Inter American University of Puerto Rico-Barranquitas","2011","Total full-time Instruction/research/public service, Tenured, Associate professors","8","3","5","0","0","0","0","0","0","0","0","0","8","3","5","0","0","0","0","0","0","0","0","0","0","0","0","0","0","0","-2"
"242644","Inter American University of Puerto Rico-Barranquitas","2011","Total full-time Instruction/research/public service, Tenured, Assistant professors","11","3","8","0","0","0","0","0","0","0","0","0","11","3","8","0","0","0","0","0","0","0","0","0","0","0","0","0","0","0","-2"
"242644","Inter American University of Puerto Rico-Barranquitas","2011","Total full-time Instruction/research/public service, Tenured, No academic rank","1","1","0","0","0","0","0","0","0","0","0","0","1","1","0","0","0","0","0","0","0","0","0","0","0","0","0","0","0","0","-2"
"242644","Inter American University of Puerto Rico-Barranquitas","2011","Total full-time Instruction/research/public service, Tenured total","22","9","13","0","0","0","0","0","0","0","0","0","22","9","13","0","0","0","0","0","0","0","0","0","0","0","0","0","0","0","-2"
"242644","Inter American University of Puerto Rico-Barranquitas","2011","Total full-time Instruction/research/public service, Non-tenured on tenure track, Assistant professors","9","3","6","0","0","0","0","0","0","0","0","0","9","3","6","0","0","0","0","0","0","0","0","0","0","0","0","0","0","0","-2"
"242644","Inter American University of Puerto Rico-Barranquitas","2011","Total full-time Instruction/research/public service, Non-tenured on tenure track, Instructors","1","1","0","0","0","0","0","0","0","0","0","0","1","1","0","0","0","0","0","0","0","0","0","0","0","0","0","0","0","0","-2"
"242644","Inter American University of Puerto Rico-Barranquitas","2011","Total full-time Instruction/research/public service, Non-tenured on tenure track total","10","4","6","0","0","0","0","0","0","0","0","0","10","4","6","0","0","0","0","0","0","0","0","0","0","0","0","0","0","0","-2"
"242644","Inter American University of Puerto Rico-Barranquitas","2011","Total full-time Instruction/research/public servicey, Non-tenured not on tenure track, Assistant professors","2","1","1","0","0","0","0","0","0","0","0","0","2","1","1","0","0","0","0","0","0","0","0","0","0","0","0","0","0","0","-2"
"242644","Inter American University of Puerto Rico-Barranquitas","2011","Total full-time Instruction/research/public service, Non-tenured not on tenure track, Instructors","8","2","6","0","0","0","0","0","0","0","0","0","8","2","6","0","0","0","0","0","0","0","0","0","0","0","0","0","0","0","-2"
"242644","Inter American University of Puerto Rico-Barranquitas","2011","Total full-time Instruction/research/public service, Non-tenured not on tenure track total","10","3","7","0","0","0","0","0","0","0","0","0","10","3","7","0","0","0","0","0","0","0","0","0","0","0","0","0","0","0","-2"
"242653","Inter American University of Puerto Rico-Metro","2011","Total full-time Instruction/research/public service, Tenured, Professors","84","36","48","0","0","0","0","0","0","0","0","0","82","34","48","2","2","0","0","0","0","0","0","0","0","0","0","0","0","0","-2"
"242653","Inter American University of Puerto Rico-Metro","2011","Total full-time Instruction/research/public service, Tenured, Associate professors","82","36","46","0","0","0","0","0","0","1","1","0","81","35","46","0","0","0","0","0","0","0","0","0","0","0","0","0","0","0","-2"
"242653","Inter American University of Puerto Rico-Metro","2011","Total full-time Instruction/research/public service, Tenured, Assistant professors","17","8","9","0","0","0","0","0","0","0","0","0","16","7","9","1","1","0","0","0","0","0","0","0","0","0","0","0","0","0","-2"
"242653","Inter American University of Puerto Rico-Metro","2011","Total full-time Instruction/research/public service, Tenured total","183","80","103","0","0","0","0","0","0","1","1","0","179","76","103","3","3","0","0","0","0","0","0","0","0","0","0","0","0","0","-2"
"242653","Inter American University of Puerto Rico-Metro","2011","Total full-time Instruction/research/public service, Non-tenured on tenure track, Professors","6","4","2","0","0","0","0","0","0","0","0","0","6","4","2","0","0","0","0","0","0","0","0","0","0","0","0","0","0","0","-2"
"242653","Inter American University of Puerto Rico-Metro","2011","Total full-time Instruction/research/public service, Non-tenured on tenure track, Associate professors","6","4","2","0","0","0","0","0","0","0","0","0","6","4","2","0","0","0","0","0","0","0","0","0","0","0","0","0","0","0","-2"
"242653","Inter American University of Puerto Rico-Metro","2011","Total full-time Instruction/research/public service, Non-tenured on tenure track, Assistant professors","8","5","3","0","0","0","0","0","0","0","0","0","8","5","3","0","0","0","0","0","0","0","0","0","0","0","0","0","0","0","-2"
"242653","Inter American University of Puerto Rico-Metro","2011","Total full-time Instruction/research/public service, Non-tenured on tenure track, Instructors","1","0","1","0","0","0","0","0","0","0","0","0","1","0","1","0","0","0","0","0","0","0","0","0","0","0","0","0","0","0","-2"
"242653","Inter American University of Puerto Rico-Metro","2011","Total full-time Instruction/research/public service, Non-tenured on tenure track total","21","13","8","0","0","0","0","0","0","0","0","0","21","13","8","0","0","0","0","0","0","0","0","0","0","0","0","0","0","0","-2"
"242653","Inter American University of Puerto Rico-Metro","2011","Total full-time Instruction/research/public service, Non-tenured not on tenure track, Professors","1","1","0","0","0","0","0","0","0","0","0","0","1","1","0","0","0","0","0","0","0","0","0","0","0","0","0","0","0","0","-2"
"242653","Inter American University of Puerto Rico-Metro","2011","Total full-time Instruction/research/public servicey, Non-tenured not on tenure track, Assistant professors","8","3","5","0","0","0","0","0","0","0","0","0","8","3","5","0","0","0","0","0","0","0","0","0","0","0","0","0","0","0","-2"
"242653","Inter American University of Puerto Rico-Metro","2011","Total full-time Instruction/research/public service, Non-tenured not on tenure track, Instructors","6","2","4","0","0","0","0","0","0","0","0","0","6","2","4","0","0","0","0","0","0","0","0","0","0","0","0","0","0","0","-2"
"242653","Inter American University of Puerto Rico-Metro","2011","Total full-time Instruction/research/public service, Non-tenured not on tenure track total","15","6","9","0","0","0","0","0","0","0","0","0","15","6","9","0","0","0","0","0","0","0","0","0","0","0","0","0","0","0","-2"
"242662","Inter American University of Puerto Rico-Ponce","2011","Total full-time Instruction/research/public service, Tenured, Professors","13","5","8","0","0","0","0","0","0","0","0","0","13","5","8","0","0","0","0","0","0","0","0","0","0","0","0","0","0","0","-2"
"242662","Inter American University of Puerto Rico-Ponce","2011","Total full-time Instruction/research/public service, Tenured, Associate professors","26","16","10","0","0","0","0","0","0","0","0","0","26","16","10","0","0","0","0","0","0","0","0","0","0","0","0","0","0","0","-2"
"242662","Inter American University of Puerto Rico-Ponce","2011","Total full-time Instruction/research/public service, Tenured, Assistant professors","15","8","7","0","0","0","0","0","0","0","0","0","15","8","7","0","0","0","0","0","0","0","0","0","0","0","0","0","0","0","-2"
"242662","Inter American University of Puerto Rico-Ponce","2011","Total full-time Instruction/research/public service, Tenured total","54","29","25","0","0","0","0","0","0","0","0","0","54","29","25","0","0","0","0","0","0","0","0","0","0","0","0","0","0","0","-2"
"242662","Inter American University of Puerto Rico-Ponce","2011","Total full-time Instruction/research/public service, Non-tenured on tenure track, Associate professors","4","1","3","0","0","0","0","0","0","0","0","0","4","1","3","0","0","0","0","0","0","0","0","0","0","0","0","0","0","0","-2"
"242662","Inter American University of Puerto Rico-Ponce","2011","Total full-time Instruction/research/public service, Non-tenured on tenure track, Assistant professors","19","7","12","0","0","0","0","0","0","0","0","0","19","7","12","0","0","0","0","0","0","0","0","0","0","0","0","0","0","0","-2"
"242662","Inter American University of Puerto Rico-Ponce","2011","Total full-time Instruction/research/public service, Non-tenured on tenure track total","23","8","15","0","0","0","0","0","0","0","0","0","23","8","15","0","0","0","0","0","0","0","0","0","0","0","0","0","0","0","-2"
"242662","Inter American University of Puerto Rico-Ponce","2011","Total full-time Instruction/research/public service, Non-tenured not on tenure track, Associate professors","2","2","0","0","0","0","0","0","0","0","0","0","2","2","0","0","0","0","0","0","0","0","0","0","0","0","0","0","0","0","-2"
"242662","Inter American University of Puerto Rico-Ponce","2011","Total full-time Instruction/research/public servicey, Non-tenured not on tenure track, Assistant professors","10","8","2","0","0","0","0","0","0","0","0","0","10","8","2","0","0","0","0","0","0","0","0","0","0","0","0","0","0","0","-2"
"242662","Inter American University of Puerto Rico-Ponce","2011","Total full-time Instruction/research/public service, Non-tenured not on tenure track, Instructors","12","3","9","0","0","0","0","0","0","0","0","0","12","3","9","0","0","0","0","0","0","0","0","0","0","0","0","0","0","0","-2"
"242662","Inter American University of Puerto Rico-Ponce","2011","Total full-time Instruction/research/public service, Non-tenured not on tenure track total","24","13","11","0","0","0","0","0","0","0","0","0","24","13","11","0","0","0","0","0","0","0","0","0","0","0","0","0","0","0","-2"
"242680","Inter American University of Puerto Rico-Fajardo","2011","Total full-time Instruction/research/public service, Tenured, Professors","4","2","2","0","0","0","0","0","0","0","0","0","4","2","2","0","0","0","0","0","0","0","0","0","0","0","0","0","0","0","-2"
"242680","Inter American University of Puerto Rico-Fajardo","2011","Total full-time Instruction/research/public service, Tenured, Associate professors","9","4","5","0","0","0","0","0","0","0","0","0","9","4","5","0","0","0","0","0","0","0","0","0","0","0","0","0","0","0","-2"
"242680","Inter American University of Puerto Rico-Fajardo","2011","Total full-time Instruction/research/public service, Tenured, Assistant professors","10","1","9","0","0","0","0","0","0","0","0","0","10","1","9","0","0","0","0","0","0","0","0","0","0","0","0","0","0","0","-2"
"242680","Inter American University of Puerto Rico-Fajardo","2011","Total full-time Instruction/research/public service, Tenured total","23","7","16","0","0","0","0","0","0","0","0","0","23","7","16","0","0","0","0","0","0","0","0","0","0","0","0","0","0","0","-2"
"242680","Inter American University of Puerto Rico-Fajardo","2011","Total full-time Instruction/research/public service, Non-tenured on tenure track, Assistant professors","8","6","2","0","0","0","0","0","0","0","0","0","8","6","2","0","0","0","0","0","0","0","0","0","0","0","0","0","0","0","-2"
"242680","Inter American University of Puerto Rico-Fajardo","2011","Total full-time Instruction/research/public service, Non-tenured on tenure track, Instructors","1","1","0","0","0","0","0","0","0","0","0","0","1","1","0","0","0","0","0","0","0","0","0","0","0","0","0","0","0","0","-2"
"242680","Inter American University of Puerto Rico-Fajardo","2011","Total full-time Instruction/research/public service, Non-tenured on tenure track total","9","7","2","0","0","0","0","0","0","0","0","0","9","7","2","0","0","0","0","0","0","0","0","0","0","0","0","0","0","0","-2"
"242680","Inter American University of Puerto Rico-Fajardo","2011","Total full-time Instruction/research/public service, Non-tenured not on tenure track, Instructors","8","2","6","0","0","0","0","0","0","0","0","0","8","2","6","0","0","0","0","0","0","0","0","0","0","0","0","0","0","0","-2"
"242680","Inter American University of Puerto Rico-Fajardo","2011","Total full-time Instruction/research/public service, Non-tenured not on tenure track total","8","2","6","0","0","0","0","0","0","0","0","0","8","2","6","0","0","0","0","0","0","0","0","0","0","0","0","0","0","0","-2"
"242699","Inter American University of Puerto Rico-Guayama","2011","Total full-time Instruction/research/public service, Tenured, Professors","6","4","2","0","0","0","0","0","0","0","0","0","6","4","2","0","0","0","0","0","0","0","0","0","0","0","0","0","0","0","-2"
"242699","Inter American University of Puerto Rico-Guayama","2011","Total full-time Instruction/research/public service, Tenured, Associate professors","10","5","5","0","0","0","0","0","0","0","0","0","10","5","5","0","0","0","0","0","0","0","0","0","0","0","0","0","0","0","-2"
"242699","Inter American University of Puerto Rico-Guayama","2011","Total full-time Instruction/research/public service, Tenured, Assistant professors","14","7","7","0","0","0","0","0","0","0","0","0","14","7","7","0","0","0","0","0","0","0","0","0","0","0","0","0","0","0","-2"
"242699","Inter American University of Puerto Rico-Guayama","2011","Total full-time Instruction/research/public service, Tenured total","30","16","14","0","0","0","0","0","0","0","0","0","30","16","14","0","0","0","0","0","0","0","0","0","0","0","0","0","0","0","-2"
"242699","Inter American University of Puerto Rico-Guayama","2011","Total full-time Instruction/research/public service, Non-tenured on tenure track, Associate professors","1","0","1","0","0","0","0","0","0","0","0","0","1","0","1","0","0","0","0","0","0","0","0","0","0","0","0","0","0","0","-2"
"242699","Inter American University of Puerto Rico-Guayama","2011","Total full-time Instruction/research/public service, Non-tenured on tenure track, Assistant professors","7","3","4","0","0","0","0","0","0","0","0","0","7","3","4","0","0","0","0","0","0","0","0","0","0","0","0","0","0","0","-2"
"242699","Inter American University of Puerto Rico-Guayama","2011","Total full-time Instruction/research/public service, Non-tenured on tenure track, Instructors","2","0","2","0","0","0","0","0","0","0","0","0","2","0","2","0","0","0","0","0","0","0","0","0","0","0","0","0","0","0","-2"
"242699","Inter American University of Puerto Rico-Guayama","2011","Total full-time Instruction/research/public service, Non-tenured on tenure track total","10","3","7","0","0","0","0","0","0","0","0","0","10","3","7","0","0","0","0","0","0","0","0","0","0","0","0","0","0","0","-2"
"242699","Inter American University of Puerto Rico-Guayama","2011","Total full-time Instruction/research/public servicey, Non-tenured not on tenure track, Assistant professors","2","0","2","0","0","0","0","0","0","0","0","0","2","0","2","0","0","0","0","0","0","0","0","0","0","0","0","0","0","0","-2"
"242699","Inter American University of Puerto Rico-Guayama","2011","Total full-time Instruction/research/public service, Non-tenured not on tenure track, Instructors","2","1","1","0","0","0","0","0","0","0","0","0","2","1","1","0","0","0","0","0","0","0","0","0","0","0","0","0","0","0","-2"
"242699","Inter American University of Puerto Rico-Guayama","2011","Total full-time Instruction/research/public service, Non-tenured not on tenure track total","4","1","3","0","0","0","0","0","0","0","0","0","4","1","3","0","0","0","0","0","0","0","0","0","0","0","0","0","0","0","-2"
"242705","Inter American University of Puerto Rico-Bayamon","2011","Total full-time Instruction/research/public service, Tenured, Professors","9","7","2","0","0","0","0","0","0","0","0","0","9","7","2","0","0","0","0","0","0","0","0","0","0","0","0","0","0","0","-2"
"242705","Inter American University of Puerto Rico-Bayamon","2011","Total full-time Instruction/research/public service, Tenured, Associate professors","23","9","14","0","0","0","0","0","0","0","0","0","23","9","14","0","0","0","0","0","0","0","0","0","0","0","0","0","0","0","-2"
"242705","Inter American University of Puerto Rico-Bayamon","2011","Total full-time Instruction/research/public service, Tenured, Assistant professors","23","10","13","0","0","0","0","0","0","0","0","0","23","10","13","0","0","0","0","0","0","0","0","0","0","0","0","0","0","0","-2"
"242705","Inter American University of Puerto Rico-Bayamon","2011","Total full-time Instruction/research/public service, Tenured total","55","26","29","0","0","0","0","0","0","0","0","0","55","26","29","0","0","0","0","0","0","0","0","0","0","0","0","0","0","0","-2"
"242705","Inter American University of Puerto Rico-Bayamon","2011","Total full-time Instruction/research/public service, Non-tenured on tenure track, Professors","1","1","0","0","0","0","0","0","0","0","0","0","1","1","0","0","0","0","0","0","0","0","0","0","0","0","0","0","0","0","-2"
"242705","Inter American University of Puerto Rico-Bayamon","2011","Total full-time Instruction/research/public service, Non-tenured on tenure track, Associate professors","4","4","0","0","0","0","0","0","0","0","0","0","4","4","0","0","0","0","0","0","0","0","0","0","0","0","0","0","0","0","-2"
"242705","Inter American University of Puerto Rico-Bayamon","2011","Total full-time Instruction/research/public service, Non-tenured on tenure track, Assistant professors","18","13","5","0","0","0","0","0","0","0","0","0","18","13","5","0","0","0","0","0","0","0","0","0","0","0","0","0","0","0","-2"
"242705","Inter American University of Puerto Rico-Bayamon","2011","Total full-time Instruction/research/public service, Non-tenured on tenure track, Instructors","4","1","3","0","0","0","0","0","0","0","0","0","4","1","3","0","0","0","0","0","0","0","0","0","0","0","0","0","0","0","-2"
"242705","Inter American University of Puerto Rico-Bayamon","2011","Total full-time Instruction/research/public service, Non-tenured on tenure track total","27","19","8","0","0","0","0","0","0","0","0","0","27","19","8","0","0","0","0","0","0","0","0","0","0","0","0","0","0","0","-2"
"242705","Inter American University of Puerto Rico-Bayamon","2011","Total full-time Instruction/research/public service, Non-tenured not on tenure track, Associate professors","1","0","1","0","0","0","0","0","0","0","0","0","1","0","1","0","0","0","0","0","0","0","0","0","0","0","0","0","0","0","-2"
"242705","Inter American University of Puerto Rico-Bayamon","2011","Total full-time Instruction/research/public servicey, Non-tenured not on tenure track, Assistant professors","6","4","2","0","0","0","0","0","0","0","0","0","6","4","2","0","0","0","0","0","0","0","0","0","0","0","0","0","0","0","-2"
"242705","Inter American University of Puerto Rico-Bayamon","2011","Total full-time Instruction/research/public service, Non-tenured not on tenure track, Instructors","15","6","9","0","0","0","0","0","0","0","0","0","15","6","9","0","0","0","0","0","0","0","0","0","0","0","0","0","0","0","-2"
"242705","Inter American University of Puerto Rico-Bayamon","2011","Total full-time Instruction/research/public service, Non-tenured not on tenure track total","22","10","12","0","0","0","0","0","0","0","0","0","22","10","12","0","0","0","0","0","0","0","0","0","0","0","0","0","0","0","-2"
"243106","University of Puerto Rico-Aguadilla","2011","Total full-time Instruction/research/public service, Tenured, Professors","28","11","17","0","0","0","0","0","0","0","0","0","26","9","17","0","0","0","0","0","0","0","0","0","2","2","0","0","0","0","-2"
"243106","University of Puerto Rico-Aguadilla","2011","Total full-time Instruction/research/public service, Tenured, Associate professors","27","16","11","0","0","0","0","0","0","0","0","0","27","16","11","0","0","0","0","0","0","0","0","0","0","0","0","0","0","0","-2"
"243106","University of Puerto Rico-Aguadilla","2011","Total full-time Instruction/research/public service, Tenured, Assistant professors","31","18","13","0","0","0","0","0","0","0","0","0","30","18","12","0","0","0","1","0","1","0","0","0","0","0","0","0","0","0","-2"
"243106","University of Puerto Rico-Aguadilla","2011","Total full-time Instruction/research/public service, Tenured, Instructors","3","1","2","0","0","0","0","0","0","0","0","0","3","1","2","0","0","0","0","0","0","0","0","0","0","0","0","0","0","0","-2"
"243106","University of Puerto Rico-Aguadilla","2011","Total full-time Instruction/research/public service, Tenured total","89","46","43","0","0","0","0","0","0","0","0","0","86","44","42","0","0","0","1","0","1","0","0","0","2","2","0","0","0","0","-2"
"243106","University of Puerto Rico-Aguadilla","2011","Total full-time Instruction/research/public service, Non-tenured on tenure track, Assistant professors","6","3","3","0","0","0","0","0","0","0","0","0","6","3","3","0","0","0","0","0","0","0","0","0","0","0","0","0","0","0","-2"
"243106","University of Puerto Rico-Aguadilla","2011","Total full-time Instruction/research/public service, Non-tenured on tenure track, Instructors","1","0","1","0","0","0","0","0","0","0","0","0","1","0","1","0","0","0","0","0","0","0","0","0","0","0","0","0","0","0","-2"
"243106","University of Puerto Rico-Aguadilla","2011","Total full-time Instruction/research/public service, Non-tenured on tenure track total","7","3","4","0","0","0","0","0","0","0","0","0","7","3","4","0","0","0","0","0","0","0","0","0","0","0","0","0","0","0","-2"
"243106","University of Puerto Rico-Aguadilla","2011","Total full-time Instruction/research/public servicey, Non-tenured not on tenure track, Assistant professors","4","3","1","0","0","0","0","0","0","0","0","0","4","3","1","0","0","0","0","0","0","0","0","0","0","0","0","0","0","0","-2"
"243106","University of Puerto Rico-Aguadilla","2011","Total full-time Instruction/research/public service, Non-tenured not on tenure track, Instructors","11","2","9","0","0","0","0","0","0","0","0","0","10","2","8","0","0","0","1","0","1","0","0","0","0","0","0","0","0","0","-2"
"243106","University of Puerto Rico-Aguadilla","2011","Total full-time Instruction/research/public service, Non-tenured not on tenure track total","15","5","10","0","0","0","0","0","0","0","0","0","14","5","9","0","0","0","1","0","1","0","0","0","0","0","0","0","0","0","-2"
"243115","University of Puerto Rico-Arecibo","2011","Total full-time Instruction/research/public service, Tenured, Professors","53","31","22","0","0","0","0","0","0","0","0","0","53","31","22","0","0","0","0","0","0","0","0","0","0","0","0","0","0","0","-2"
"243115","University of Puerto Rico-Arecibo","2011","Total full-time Instruction/research/public service, Tenured, Associate professors","44","16","28","0","0","0","0","0","0","0","0","0","44","16","28","0","0","0","0","0","0","0","0","0","0","0","0","0","0","0","-2"
"243115","University of Puerto Rico-Arecibo","2011","Total full-time Instruction/research/public service, Tenured, Assistant professors","36","16","20","0","0","0","0","0","0","0","0","0","36","16","20","0","0","0","0","0","0","0","0","0","0","0","0","0","0","0","-2"
"243115","University of Puerto Rico-Arecibo","2011","Total full-time Instruction/research/public service, Tenured, Instructors","4","2","2","0","0","0","0","0","0","0","0","0","4","2","2","0","0","0","0","0","0","0","0","0","0","0","0","0","0","0","-2"
"243115","University of Puerto Rico-Arecibo","2011","Total full-time Instruction/research/public service, Tenured total","137","65","72","0","0","0","0","0","0","0","0","0","137","65","72","0","0","0","0","0","0","0","0","0","0","0","0","0","0","0","-2"
"243115","University of Puerto Rico-Arecibo","2011","Total full-time Instruction/research/public service, Non-tenured on tenure track, Assistant professors","9","3","6","0","0","0","0","0","0","0","0","0","9","3","6","0","0","0","0","0","0","0","0","0","0","0","0","0","0","0","-2"
"243115","University of Puerto Rico-Arecibo","2011","Total full-time Instruction/research/public service, Non-tenured on tenure track, Instructors","7","4","3","0","0","0","0","0","0","0","0","0","7","4","3","0","0","0","0","0","0","0","0","0","0","0","0","0","0","0","-2"
"243115","University of Puerto Rico-Arecibo","2011","Total full-time Instruction/research/public service, Non-tenured on tenure track total","16","7","9","0","0","0","0","0","0","0","0","0","16","7","9","0","0","0","0","0","0","0","0","0","0","0","0","0","0","0","-2"
"243115","University of Puerto Rico-Arecibo","2011","Total full-time Instruction/research/public servicey, Non-tenured not on tenure track, Assistant professors","2","0","2","0","0","0","0","0","0","0","0","0","2","0","2","0","0","0","0","0","0","0","0","0","0","0","0","0","0","0","-2"
"243115","University of Puerto Rico-Arecibo","2011","Total full-time Instruction/research/public service, Non-tenured not on tenure track, Instructors","13","6","7","0","0","0","0","0","0","0","0","0","13","6","7","0","0","0","0","0","0","0","0","0","0","0","0","0","0","0","-2"
"243115","University of Puerto Rico-Arecibo","2011","Total full-time Instruction/research/public service, Non-tenured not on tenure track total","15","6","9","0","0","0","0","0","0","0","0","0","15","6","9","0","0","0","0","0","0","0","0","0","0","0","0","0","0","0","-2"
"243133","University of Puerto Rico-Bayamon","2011","Total full-time Instruction/research/public service, Tenured, Professors","43","23","20","0","0","0","0","0","0","0","0","0","43","23","20","0","0","0","0","0","0","0","0","0","0","0","0","0","0","0","-2"
"243133","University of Puerto Rico-Bayamon","2011","Total full-time Instruction/research/public service, Tenured, Associate professors","53","23","30","0","0","0","0","0","0","0","0","0","53","23","30","0","0","0","0","0","0","0","0","0","0","0","0","0","0","0","-2"
"243133","University of Puerto Rico-Bayamon","2011","Total full-time Instruction/research/public service, Tenured, Assistant professors","36","18","18","0","0","0","0","0","0","0","0","0","36","18","18","0","0","0","0","0","0","0","0","0","0","0","0","0","0","0","-2"
"243133","University of Puerto Rico-Bayamon","2011","Total full-time Instruction/research/public service, Tenured, Instructors","8","3","5","0","0","0","0","0","0","0","0","0","8","3","5","0","0","0","0","0","0","0","0","0","0","0","0","0","0","0","-2"
"243133","University of Puerto Rico-Bayamon","2011","Total full-time Instruction/research/public service, Tenured total","140","67","73","0","0","0","0","0","0","0","0","0","140","67","73","0","0","0","0","0","0","0","0","0","0","0","0","0","0","0","-2"
"243133","University of Puerto Rico-Bayamon","2011","Total full-time Instruction/research/public service, Non-tenured on tenure track, Assistant professors","6","5","1","0","0","0","0","0","0","0","0","0","6","5","1","0","0","0","0","0","0","0","0","0","0","0","0","0","0","0","-2"
"243133","University of Puerto Rico-Bayamon","2011","Total full-time Instruction/research/public service, Non-tenured on tenure track, Instructors","5","3","2","0","0","0","0","0","0","0","0","0","5","3","2","0","0","0","0","0","0","0","0","0","0","0","0","0","0","0","-2"
"243133","University of Puerto Rico-Bayamon","2011","Total full-time Instruction/research/public service, Non-tenured on tenure track total","11","8","3","0","0","0","0","0","0","0","0","0","11","8","3","0","0","0","0","0","0","0","0","0","0","0","0","0","0","0","-2"
"243142","University of Puerto Rico-Carolina","2011","Total full-time Instruction/research/public service, Tenured, Professors","11","5","6","0","0","0","0","0","0","0","0","0","9","3","6","0","0","0","0","0","0","0","0","0","2","2","0","0","0","0","-2"
"243142","University of Puerto Rico-Carolina","2011","Total full-time Instruction/research/public service, Tenured, Associate professors","31","18","13","0","0","0","0","0","0","0","0","0","26","16","10","0","0","0","0","0","0","0","0","0","5","2","3","0","0","0","-2"
"243142","University of Puerto Rico-Carolina","2011","Total full-time Instruction/research/public service, Tenured, Assistant professors","25","15","10","0","0","0","0","0","0","0","0","0","21","13","8","0","0","0","2","2","0","0","0","0","2","0","2","0","0","0","-2"
"243142","University of Puerto Rico-Carolina","2011","Total full-time Instruction/research/public service, Tenured, Instructors","7","4","3","0","0","0","0","0","0","0","0","0","6","4","2","0","0","0","0","0","0","0","0","0","1","0","1","0","0","0","-2"
"243142","University of Puerto Rico-Carolina","2011","Total full-time Instruction/research/public service, Tenured total","74","42","32","0","0","0","0","0","0","0","0","0","62","36","26","0","0","0","2","2","0","0","0","0","10","4","6","0","0","0","-2"
"243142","University of Puerto Rico-Carolina","2011","Total full-time Instruction/research/public service, Non-tenured on tenure track, Associate professors","1","1","0","0","0","0","0","0","0","0","0","0","1","1","0","0","0","0","0","0","0","0","0","0","0","0","0","0","0","0","-2"
"243142","University of Puerto Rico-Carolina","2011","Total full-time Instruction/research/public service, Non-tenured on tenure track, Assistant professors","6","4","2","0","0","0","0","0","0","0","0","0","6","4","2","0","0","0","0","0","0","0","0","0","0","0","0","0","0","0","-2"
"243142","University of Puerto Rico-Carolina","2011","Total full-time Instruction/research/public service, Non-tenured on tenure track, Instructors","5","2","3","0","0","0","0","0","0","0","0","0","4","1","3","0","0","0","0","0","0","0","0","0","1","1","0","0","0","0","-2"
"243142","University of Puerto Rico-Carolina","2011","Total full-time Instruction/research/public service, Non-tenured on tenure track total","12","7","5","0","0","0","0","0","0","0","0","0","11","6","5","0","0","0","0","0","0","0","0","0","1","1","0","0","0","0","-2"
"243142","University of Puerto Rico-Carolina","2011","Total full-time Instruction/research/public servicey, Non-tenured not on tenure track, Assistant professors","4","3","1","0","0","0","0","0","0","0","0","0","4","3","1","0","0","0","0","0","0","0","0","0","0","0","0","0","0","0","-2"
"243142","University of Puerto Rico-Carolina","2011","Total full-time Instruction/research/public service, Non-tenured not on tenure track, Instructors","15","8","7","0","0","0","0","0","0","0","0","0","14","8","6","0","0","0","1","0","1","0","0","0","0","0","0","0","0","0","-2"
"243142","University of Puerto Rico-Carolina","2011","Total full-time Instruction/research/public service, Non-tenured not on tenure track total","19","11","8","0","0","0","0","0","0","0","0","0","18","11","7","0","0","0","1","0","1","0","0","0","0","0","0","0","0","0","-2"
"243151","University of Puerto Rico-Cayey","2011","Total full-time Instruction/research/public service, Tenured, Professors","50","25","25","0","0","0","0","0","0","0","0","0","46","22","24","0","0","0","4","3","1","0","0","0","0","0","0","0","0","0","-2"
"243151","University of Puerto Rico-Cayey","2011","Total full-time Instruction/research/public service, Tenured, Associate professors","25","14","11","0","0","0","0","0","0","0","0","0","25","14","11","0","0","0","0","0","0","0","0","0","0","0","0","0","0","0","-2"
"243151","University of Puerto Rico-Cayey","2011","Total full-time Instruction/research/public service, Tenured, Assistant professors","19","11","8","0","0","0","0","0","0","0","0","0","18","10","8","0","0","0","1","1","0","0","0","0","0","0","0","0","0","0","-2"
"243151","University of Puerto Rico-Cayey","2011","Total full-time Instruction/research/public service, Tenured, Instructors","1","1","0","0","0","0","0","0","0","0","0","0","1","1","0","0","0","0","0","0","0","0","0","0","0","0","0","0","0","0","-2"
"243151","University of Puerto Rico-Cayey","2011","Total full-time Instruction/research/public service, Tenured, No academic rank","3","2","1","0","0","0","0","0","0","0","0","0","3","2","1","0","0","0","0","0","0","0","0","0","0","0","0","0","0","0","-2"
"243151","University of Puerto Rico-Cayey","2011","Total full-time Instruction/research/public service, Tenured total","98","53","45","0","0","0","0","0","0","0","0","0","93","49","44","0","0","0","5","4","1","0","0","0","0","0","0","0","0","0","-2"
"243151","University of Puerto Rico-Cayey","2011","Total full-time Instruction/research/public service, Non-tenured on tenure track, Assistant professors","4","2","2","0","0","0","1","0","1","0","0","0","3","2","1","0","0","0","0","0","0","0","0","0","0","0","0","0","0","0","-2"
"243151","University of Puerto Rico-Cayey","2011","Total full-time Instruction/research/public service, Non-tenured on tenure track total","4","2","2","0","0","0","1","0","1","0","0","0","3","2","1","0","0","0","0","0","0","0","0","0","0","0","0","0","0","0","-2"
"243151","University of Puerto Rico-Cayey","2011","Total full-time Instruction/research/public service, Non-tenured not on tenure track, No academic rank","1","0","1","0","0","0","0","0","0","0","0","0","1","0","1","0","0","0","0","0","0","0","0","0","0","0","0","0","0","0","-2"
"243151","University of Puerto Rico-Cayey","2011","Total full-time Instruction/research/public service, Non-tenured not on tenure track total","1","0","1","0","0","0","0","0","0","0","0","0","1","0","1","0","0","0","0","0","0","0","0","0","0","0","0","0","0","0","-2"
"243179","University of Puerto Rico-Humacao","2011","Total full-time Instruction/research/public service, Tenured, Professors","93","46","47","0","0","0","1","1","0","0","0","0","57","24","33","0","0","0","2","1","1","1","1","0","32","19","13","0","0","0","-2"
"243179","University of Puerto Rico-Humacao","2011","Total full-time Instruction/research/public service, Tenured, Associate professors","47","24","23","0","0","0","0","0","0","0","0","0","31","15","16","0","0","0","0","0","0","1","1","0","14","7","7","1","1","0","-2"
"243179","University of Puerto Rico-Humacao","2011","Total full-time Instruction/research/public service, Tenured, Assistant professors","29","11","18","0","0","0","0","0","0","0","0","0","22","8","14","0","0","0","0","0","0","0","0","0","7","3","4","0","0","0","-2"
"243179","University of Puerto Rico-Humacao","2011","Total full-time Instruction/research/public service, Tenured, Instructors","2","1","1","0","0","0","0","0","0","0","0","0","1","0","1","0","0","0","0","0","0","0","0","0","1","1","0","0","0","0","-2"
"243179","University of Puerto Rico-Humacao","2011","Total full-time Instruction/research/public service, Tenured total","171","82","89","0","0","0","1","1","0","0","0","0","111","47","64","0","0","0","2","1","1","2","2","0","54","30","24","1","1","0","-2"
"243179","University of Puerto Rico-Humacao","2011","Total full-time Instruction/research/public service, Non-tenured on tenure track, Assistant professors","16","10","6","0","0","0","0","0","0","1","0","1","12","9","3","0","0","0","0","0","0","0","0","0","2","0","2","1","1","0","-2"
"243179","University of Puerto Rico-Humacao","2011","Total full-time Instruction/research/public service, Non-tenured on tenure track, Instructors","4","3","1","0","0","0","0","0","0","0","0","0","3","3","0","0","0","0","0","0","0","0","0","0","1","0","1","0","0","0","-2"
"243179","University of Puerto Rico-Humacao","2011","Total full-time Instruction/research/public service, Non-tenured on tenure track total","20","13","7","0","0","0","0","0","0","1","0","1","15","12","3","0","0","0","0","0","0","0","0","0","3","0","3","1","1","0","-2"
"243179","University of Puerto Rico-Humacao","2011","Total full-time Instruction/research/public servicey, Non-tenured not on tenure track, Assistant professors","1","0","1","0","0","0","0","0","0","0","0","0","1","0","1","0","0","0","0","0","0","0","0","0","0","0","0","0","0","0","-2"
"243179","University of Puerto Rico-Humacao","2011","Total full-time Instruction/research/public service, Non-tenured not on tenure track, Instructors","12","2","10","0","0","0","0","0","0","0","0","0","9","0","9","0","0","0","0","0","0","0","0","0","3","2","1","0","0","0","-2"
"243179","University of Puerto Rico-Humacao","2011","Total full-time Instruction/research/public service, Non-tenured not on tenure track total","13","2","11","0","0","0","0","0","0","0","0","0","10","0","10","0","0","0","0","0","0","0","0","0","3","2","1","0","0","0","-2"
"243188","University of Puerto Rico-Utuado","2011","Total full-time Instruction/research/public service, Tenured, Professors","13","8","5","0","0","0","0","0","0","0","0","0","11","6","5","0","0","0","0","0","0","0","0","0","2","2","0","0","0","0","-2"
"243188","University of Puerto Rico-Utuado","2011","Total full-time Instruction/research/public service, Tenured, Associate professors","12","5","7","0","0","0","0","0","0","0","0","0","12","5","7","0","0","0","0","0","0","0","0","0","0","0","0","0","0","0","-2"
"243188","University of Puerto Rico-Utuado","2011","Total full-time Instruction/research/public service, Tenured, Assistant professors","18","11","7","0","0","0","0","0","0","0","0","0","15","9","6","0","0","0","0","0","0","0","0","0","3","2","1","0","0","0","-2"
"243188","University of Puerto Rico-Utuado","2011","Total full-time Instruction/research/public service, Tenured, Instructors","2","2","0","0","0","0","0","0","0","0","0","0","2","2","0","0","0","0","0","0","0","0","0","0","0","0","0","0","0","0","-2"
"243188","University of Puerto Rico-Utuado","2011","Total full-time Instruction/research/public service, Tenured total","45","26","19","0","0","0","0","0","0","0","0","0","40","22","18","0","0","0","0","0","0","0","0","0","5","4","1","0","0","0","-2"
"243188","University of Puerto Rico-Utuado","2011","Total full-time Instruction/research/public service, Non-tenured on tenure track, Assistant professors","10","7","3","0","0","0","0","0","0","0","0","0","9","6","3","0","0","0","0","0","0","0","0","0","1","1","0","0","0","0","-2"
"243188","University of Puerto Rico-Utuado","2011","Total full-time Instruction/research/public service, Non-tenured on tenure track, Instructors","2","0","2","0","0","0","0","0","0","0","0","0","2","0","2","0","0","0","0","0","0","0","0","0","0","0","0","0","0","0","-2"
"243188","University of Puerto Rico-Utuado","2011","Total full-time Instruction/research/public service, Non-tenured on tenure track total","12","7","5","0","0","0","0","0","0","0","0","0","11","6","5","0","0","0","0","0","0","0","0","0","1","1","0","0","0","0","-2"
"243188","University of Puerto Rico-Utuado","2011","Total full-time Instruction/research/public service, Non-tenured not on tenure track, Instructors","5","3","2","0","0","0","0","0","0","0","0","0","4","3","1","0","0","0","0","0","0","0","0","0","1","0","1","0","0","0","-2"
"243188","University of Puerto Rico-Utuado","2011","Total full-time Instruction/research/public service, Non-tenured not on tenure track total","5","3","2","0","0","0","0","0","0","0","0","0","4","3","1","0","0","0","0","0","0","0","0","0","1","0","1","0","0","0","-2"
"243197","University of Puerto Rico-Mayaguez","2011","Total full-time Instruction/research/public service, Tenured, Professors","327","230","97","0","0","0","15","13","2","2","2","0","267","181","86","0","0","0","41","33","8","1","1","0","1","0","1","0","0","0","-2"
"243197","University of Puerto Rico-Mayaguez","2011","Total full-time Instruction/research/public service, Tenured, Associate professors","162","96","66","0","0","0","5","5","0","0","0","0","145","81","64","0","0","0","11","9","2","0","0","0","1","1","0","0","0","0","-2"
"243197","University of Puerto Rico-Mayaguez","2011","Total full-time Instruction/research/public service, Tenured, Assistant professors","53","27","26","0","0","0","3","2","1","0","0","0","44","22","22","0","0","0","6","3","3","0","0","0","0","0","0","0","0","0","-2"
"243197","University of Puerto Rico-Mayaguez","2011","Total full-time Instruction/research/public service, Tenured, Instructors","5","3","2","0","0","0","0","0","0","0","0","0","5","3","2","0","0","0","0","0","0","0","0","0","0","0","0","0","0","0","-2"
"243197","University of Puerto Rico-Mayaguez","2011","Total full-time Instruction/research/public service, Tenured, No academic rank","150","75","75","0","0","0","0","0","0","0","0","0","147","74","73","0","0","0","2","1","1","0","0","0","1","0","1","0","0","0","-2"
"243197","University of Puerto Rico-Mayaguez","2011","Total full-time Instruction/research/public service, Tenured total","697","431","266","0","0","0","23","20","3","2","2","0","608","361","247","0","0","0","60","46","14","1","1","0","3","1","2","0","0","0","-2"
"243197","University of Puerto Rico-Mayaguez","2011","Total full-time Instruction/research/public service, Non-tenured on tenure track, Professors","1","1","0","0","0","0","0","0","0","0","0","0","1","1","0","0","0","0","0","0","0","0","0","0","0","0","0","0","0","0","-2"
"243197","University of Puerto Rico-Mayaguez","2011","Total full-time Instruction/research/public service, Non-tenured on tenure track, Associate professors","1","1","0","0","0","0","0","0","0","0","0","0","0","0","0","0","0","0","1","1","0","0","0","0","0","0","0","0","0","0","-2"
"243197","University of Puerto Rico-Mayaguez","2011","Total full-time Instruction/research/public service, Non-tenured on tenure track, Assistant professors","84","51","33","0","0","0","2","2","0","2","1","1","64","35","29","0","0","0","14","12","2","0","0","0","2","1","1","0","0","0","-2"
"243197","University of Puerto Rico-Mayaguez","2011","Total full-time Instruction/research/public service, Non-tenured on tenure track, Instructors","3","1","2","0","0","0","0","0","0","0","0","0","3","1","2","0","0","0","0","0","0","0","0","0","0","0","0","0","0","0","-2"
"243197","University of Puerto Rico-Mayaguez","2011","Total full-time Instruction/research/public service, Non-tenured on tenure track, No academic rank","2","1","1","0","0","0","0","0","0","0","0","0","2","1","1","0","0","0","0","0","0","0","0","0","0","0","0","0","0","0","-2"
"243197","University of Puerto Rico-Mayaguez","2011","Total full-time Instruction/research/public service, Non-tenured on tenure track total","91","55","36","0","0","0","2","2","0","2","1","1","70","38","32","0","0","0","15","13","2","0","0","0","2","1","1","0","0","0","-2"
"243197","University of Puerto Rico-Mayaguez","2011","Total full-time Instruction/research/public service, Non-tenured not on tenure track, Professors","1","1","0","0","0","0","0","0","0","0","0","0","1","1","0","0","0","0","0","0","0","0","0","0","0","0","0","0","0","0","-2"
"243197","University of Puerto Rico-Mayaguez","2011","Total full-time Instruction/research/public servicey, Non-tenured not on tenure track, Assistant professors","12","3","9","0","0","0","0","0","0","0","0","0","11","3","8","0","0","0","0","0","0","0","0","0","1","0","1","0","0","0","-2"
"243197","University of Puerto Rico-Mayaguez","2011","Total full-time Instruction/research/public service, Non-tenured not on tenure track, Instructors","10","3","7","0","0","0","0","0","0","0","0","0","10","3","7","0","0","0","0","0","0","0","0","0","0","0","0","0","0","0","-2"
"243197","University of Puerto Rico-Mayaguez","2011","Total full-time Instruction/research/public service, Non-tenured not on tenure track, No academic rank","17","6","11","0","0","0","0","0","0","0","0","0","16","5","11","0","0","0","1","1","0","0","0","0","0","0","0","0","0","0","-2"
"243197","University of Puerto Rico-Mayaguez","2011","Total full-time Instruction/research/public service, Non-tenured not on tenure track total","40","13","27","0","0","0","0","0","0","0","0","0","38","12","26","0","0","0","1","1","0","0","0","0","1","0","1","0","0","0","-2"
"243203","University of Puerto Rico-Medical Sciences","2011","Total full-time Instruction/research/public service, Tenured, Professors","228","113","115","0","0","0","1","0","1","0","0","0","217","105","112","0","0","0","10","8","2","0","0","0","0","0","0","0","0","0","-2"
"243203","University of Puerto Rico-Medical Sciences","2011","Total full-time Instruction/research/public service, Tenured, Associate professors","92","32","60","0","0","0","0","0","0","0","0","0","88","30","58","0","0","0","4","2","2","0","0","0","0","0","0","0","0","0","-2"
"243203","University of Puerto Rico-Medical Sciences","2011","Total full-time Instruction/research/public service, Tenured, Assistant professors","39","15","24","0","0","0","0","0","0","0","0","0","39","15","24","0","0","0","0","0","0","0","0","0","0","0","0","0","0","0","-2"
"243203","University of Puerto Rico-Medical Sciences","2011","Total full-time Instruction/research/public service, Tenured, Instructors","3","1","2","0","0","0","0","0","0","0","0","0","3","1","2","0","0","0","0","0","0","0","0","0","0","0","0","0","0","0","-2"
"243203","University of Puerto Rico-Medical Sciences","2011","Total full-time Instruction/research/public service, Tenured, No academic rank","6","3","3","0","0","0","0","0","0","0","0","0","5","2","3","0","0","0","1","1","0","0","0","0","0","0","0","0","0","0","-2"
"243203","University of Puerto Rico-Medical Sciences","2011","Total full-time Instruction/research/public service, Tenured total","368","164","204","0","0","0","1","0","1","0","0","0","352","153","199","0","0","0","15","11","4","0","0","0","0","0","0","0","0","0","-2"
"243203","University of Puerto Rico-Medical Sciences","2011","Total full-time Instruction/research/public service, Non-tenured on tenure track, Professors","19","10","9","0","0","0","1","0","1","0","0","0","18","10","8","0","0","0","0","0","0","0","0","0","0","0","0","0","0","0","-2"
"243203","University of Puerto Rico-Medical Sciences","2011","Total full-time Instruction/research/public service, Non-tenured on tenure track, Associate professors","30","17","13","0","0","0","1","0","1","0","0","0","27","16","11","0","0","0","1","1","0","0","0","0","1","0","1","0","0","0","-2"
"243203","University of Puerto Rico-Medical Sciences","2011","Total full-time Instruction/research/public service, Non-tenured on tenure track, Assistant professors","40","14","26","0","0","0","0","0","0","0","0","0","37","14","23","0","0","0","0","0","0","0","0","0","3","0","3","0","0","0","-2"
"243203","University of Puerto Rico-Medical Sciences","2011","Total full-time Instruction/research/public service, Non-tenured on tenure track, Instructors","8","1","7","0","0","0","0","0","0","0","0","0","8","1","7","0","0","0","0","0","0","0","0","0","0","0","0","0","0","0","-2"
"243203","University of Puerto Rico-Medical Sciences","2011","Total full-time Instruction/research/public service, Non-tenured on tenure track, No academic rank","4","3","1","0","0","0","0","0","0","0","0","0","3","2","1","0","0","0","1","1","0","0","0","0","0","0","0","0","0","0","-2"
"243203","University of Puerto Rico-Medical Sciences","2011","Total full-time Instruction/research/public service, Non-tenured on tenure track total","101","45","56","0","0","0","2","0","2","0","0","0","93","43","50","0","0","0","2","2","0","0","0","0","4","0","4","0","0","0","-2"
"243203","University of Puerto Rico-Medical Sciences","2011","Total full-time Instruction/research/public service, Non-tenured not on tenure track, Associate professors","16","8","8","0","0","0","0","0","0","0","0","0","16","8","8","0","0","0","0","0","0","0","0","0","0","0","0","0","0","0","-2"
"243203","University of Puerto Rico-Medical Sciences","2011","Total full-time Instruction/research/public servicey, Non-tenured not on tenure track, Assistant professors","68","30","38","0","0","0","0","0","0","0","0","0","58","26","32","0","0","0","1","0","1","0","0","0","9","4","5","0","0","0","-2"
"243203","University of Puerto Rico-Medical Sciences","2011","Total full-time Instruction/research/public service, Non-tenured not on tenure track, Instructors","12","2","10","0","0","0","0","0","0","0","0","0","11","1","10","0","0","0","0","0","0","0","0","0","1","1","0","0","0","0","-2"
"243203","University of Puerto Rico-Medical Sciences","2011","Total full-time Instruction/research/public service, Non-tenured not on tenure track, No academic rank","54","16","38","0","0","0","0","0","0","0","0","0","30","8","22","0","0","0","2","1","1","0","0","0","22","7","15","0","0","0","-2"
"243203","University of Puerto Rico-Medical Sciences","2011","Total full-time Instruction/research/public service, Non-tenured not on tenure track total","150","56","94","0","0","0","0","0","0","0","0","0","115","43","72","0","0","0","3","1","2","0","0","0","32","12","20","0","0","0","-2"
"243212","University of Puerto Rico-Ponce","2011","Total full-time Instruction/research/public service, Tenured, Professors","31","13","18","0","0","0","0","0","0","0","0","0","31","13","18","0","0","0","0","0","0","0","0","0","0","0","0","0","0","0","-2"
"243212","University of Puerto Rico-Ponce","2011","Total full-time Instruction/research/public service, Tenured, Associate professors","24","10","14","0","0","0","0","0","0","0","0","0","24","10","14","0","0","0","0","0","0","0","0","0","0","0","0","0","0","0","-2"
"243212","University of Puerto Rico-Ponce","2011","Total full-time Instruction/research/public service, Tenured, Assistant professors","26","8","18","0","0","0","0","0","0","0","0","0","26","8","18","0","0","0","0","0","0","0","0","0","0","0","0","0","0","0","-2"
"243212","University of Puerto Rico-Ponce","2011","Total full-time Instruction/research/public service, Tenured, Instructors","9","7","2","0","0","0","0","0","0","0","0","0","9","7","2","0","0","0","0","0","0","0","0","0","0","0","0","0","0","0","-2"
"243212","University of Puerto Rico-Ponce","2011","Total full-time Instruction/research/public service, Tenured total","90","38","52","0","0","0","0","0","0","0","0","0","90","38","52","0","0","0","0","0","0","0","0","0","0","0","0","0","0","0","-2"
"243212","University of Puerto Rico-Ponce","2011","Total full-time Instruction/research/public service, Non-tenured on tenure track, Associate professors","1","0","1","0","0","0","0","0","0","0","0","0","1","0","1","0","0","0","0","0","0","0","0","0","0","0","0","0","0","0","-2"
"243212","University of Puerto Rico-Ponce","2011","Total full-time Instruction/research/public service, Non-tenured on tenure track, Assistant professors","7","3","4","0","0","0","0","0","0","0","0","0","7","3","4","0","0","0","0","0","0","0","0","0","0","0","0","0","0","0","-2"
"243212","University of Puerto Rico-Ponce","2011","Total full-time Instruction/research/public service, Non-tenured on tenure track, Instructors","1","0","1","0","0","0","0","0","0","0","0","0","1","0","1","0","0","0","0","0","0","0","0","0","0","0","0","0","0","0","-2"
"243212","University of Puerto Rico-Ponce","2011","Total full-time Instruction/research/public service, Non-tenured on tenure track total","9","3","6","0","0","0","0","0","0","0","0","0","9","3","6","0","0","0","0","0","0","0","0","0","0","0","0","0","0","0","-2"
"243212","University of Puerto Rico-Ponce","2011","Total full-time Instruction/research/public service, Non-tenured not on tenure track, Instructors","23","8","15","0","0","0","0","0","0","0","0","0","23","8","15","0","0","0","0","0","0","0","0","0","0","0","0","0","0","0","-2"
"243212","University of Puerto Rico-Ponce","2011","Total full-time Instruction/research/public service, Non-tenured not on tenure track total","23","8","15","0","0","0","0","0","0","0","0","0","23","8","15","0","0","0","0","0","0","0","0","0","0","0","0","0","0","0","-2"
"243221","University of Puerto Rico-Rio Piedras","2011","Total full-time Instruction/research/public service, Tenured, Professors","436","235","201","1","0","1","3","3","0","0","0","0","196","92","104","0","0","0","11","9","2","1","1","0","210","118","92","14","12","2","-2"
"243221","University of Puerto Rico-Rio Piedras","2011","Total full-time Instruction/research/public service, Tenured, Associate professors","186","95","91","0","0","0","0","0","0","0","0","0","91","42","49","0","0","0","9","5","4","1","0","1","72","38","34","13","10","3","-2"
"243221","University of Puerto Rico-Rio Piedras","2011","Total full-time Instruction/research/public service, Tenured, Assistant professors","80","42","38","0","0","0","1","0","1","1","0","1","41","22","19","0","0","0","0","0","0","0","0","0","31","15","16","6","5","1","-2"
"243221","University of Puerto Rico-Rio Piedras","2011","Total full-time Instruction/research/public service, Tenured, Instructors","7","5","2","0","0","0","0","0","0","0","0","0","6","4","2","0","0","0","0","0","0","0","0","0","1","1","0","0","0","0","-2"
"243221","University of Puerto Rico-Rio Piedras","2011","Total full-time Instruction/research/public service, Tenured total","709","377","332","1","0","1","4","3","1","1","0","1","334","160","174","0","0","0","20","14","6","2","1","1","314","172","142","33","27","6","-2"
"243221","University of Puerto Rico-Rio Piedras","2011","Total full-time Instruction/research/public service, Non-tenured on tenure track, Professors","3","0","3","0","0","0","0","0","0","0","0","0","3","0","3","0","0","0","0","0","0","0","0","0","0","0","0","0","0","0","-2"
"243221","University of Puerto Rico-Rio Piedras","2011","Total full-time Instruction/research/public service, Non-tenured on tenure track, Associate professors","5","4","1","0","0","0","0","0","0","0","0","0","0","0","0","0","0","0","0","0","0","0","0","0","3","3","0","2","1","1","-2"
"243221","University of Puerto Rico-Rio Piedras","2011","Total full-time Instruction/research/public service, Non-tenured on tenure track, Assistant professors","69","36","33","0","0","0","0","0","0","0","0","0","29","10","19","0","0","0","4","3","1","1","1","0","21","10","11","14","12","2","-2"
"243221","University of Puerto Rico-Rio Piedras","2011","Total full-time Instruction/research/public service, Non-tenured on tenure track, Instructors","7","3","4","0","0","0","0","0","0","0","0","0","4","2","2","0","0","0","0","0","0","0","0","0","2","1","1","1","0","1","-2"
"243221","University of Puerto Rico-Rio Piedras","2011","Total full-time Instruction/research/public service, Non-tenured on tenure track total","84","43","41","0","0","0","0","0","0","0","0","0","36","12","24","0","0","0","4","3","1","1","1","0","26","14","12","17","13","4","-2"
"243221","University of Puerto Rico-Rio Piedras","2011","Total full-time Instruction/research/public service, Non-tenured not on tenure track, Professors","4","2","2","0","0","0","0","0","0","0","0","0","2","1","1","0","0","0","0","0","0","0","0","0","0","0","0","2","1","1","-2"
"243221","University of Puerto Rico-Rio Piedras","2011","Total full-time Instruction/research/public service, Non-tenured not on tenure track, Associate professors","1","1","0","0","0","0","0","0","0","0","0","0","0","0","0","0","0","0","0","0","0","0","0","0","1","1","0","0","0","0","-2"
"243221","University of Puerto Rico-Rio Piedras","2011","Total full-time Instruction/research/public servicey, Non-tenured not on tenure track, Assistant professors","54","20","34","0","0","0","0","0","0","0","0","0","15","4","11","0","0","0","0","0","0","0","0","0","30","12","18","9","4","5","-2"
"243221","University of Puerto Rico-Rio Piedras","2011","Total full-time Instruction/research/public service, Non-tenured not on tenure track, Instructors","39","23","16","0","0","0","0","0","0","0","0","0","11","5","6","0","0","0","0","0","0","0","0","0","24","15","9","4","3","1","-2"
"243221","University of Puerto Rico-Rio Piedras","2011","Total full-time Instruction/research/public service, Non-tenured not on tenure track, No academic rank","8","5","3","0","0","0","0","0","0","0","0","0","1","0","1","0","0","0","0","0","0","0","0","0","5","3","2","2","2","0","-2"
"243221","University of Puerto Rico-Rio Piedras","2011","Total full-time Instruction/research/public service, Non-tenured not on tenure track total","106","51","55","0","0","0","0","0","0","0","0","0","29","10","19","0","0","0","0","0","0","0","0","0","60","31","29","17","10","7","-2"
"243346","Universidad Ana G. Mendez-Carolina Campus","2011","Total full-time Instruction/research/public service, Tenured, Professors","8","2","6","0","0","0","0","0","0","0","0","0","8","2","6","0","0","0","0","0","0","0","0","0","0","0","0","0","0","0","-2"
"243346","Universidad Ana G. Mendez-Carolina Campus","2011","Total full-time Instruction/research/public service, Tenured, Associate professors","7","3","4","0","0","0","0","0","0","0","0","0","7","3","4","0","0","0","0","0","0","0","0","0","0","0","0","0","0","0","-2"
"243346","Universidad Ana G. Mendez-Carolina Campus","2011","Total full-time Instruction/research/public service, Tenured, Assistant professors","3","1","2","0","0","0","0","0","0","0","0","0","3","1","2","0","0","0","0","0","0","0","0","0","0","0","0","0","0","0","-2"
"243346","Universidad Ana G. Mendez-Carolina Campus","2011","Total full-time Instruction/research/public service, Tenured, Instructors","1","1","0","0","0","0","0","0","0","0","0","0","1","1","0","0","0","0","0","0","0","0","0","0","0","0","0","0","0","0","-2"
"243346","Universidad Ana G. Mendez-Carolina Campus","2011","Total full-time Instruction/research/public service, Tenured total","19","7","12","0","0","0","0","0","0","0","0","0","19","7","12","0","0","0","0","0","0","0","0","0","0","0","0","0","0","0","-2"
"243346","Universidad Ana G. Mendez-Carolina Campus","2011","Total full-time Instruction/research/public service, Non-tenured not on tenure track, Professors","2","1","1","0","0","0","0","0","0","0","0","0","2","1","1","0","0","0","0","0","0","0","0","0","0","0","0","0","0","0","-2"
"243346","Universidad Ana G. Mendez-Carolina Campus","2011","Total full-time Instruction/research/public service, Non-tenured not on tenure track, Associate professors","20","5","15","0","0","0","0","0","0","0","0","0","20","5","15","0","0","0","0","0","0","0","0","0","0","0","0","0","0","0","-2"
"243346","Universidad Ana G. Mendez-Carolina Campus","2011","Total full-time Instruction/research/public servicey, Non-tenured not on tenure track, Assistant professors","32","10","22","0","0","0","0","0","0","0","0","0","31","10","21","0","0","0","1","0","1","0","0","0","0","0","0","0","0","0","-2"
"243346","Universidad Ana G. Mendez-Carolina Campus","2011","Total full-time Instruction/research/public service, Non-tenured not on tenure track, Instructors","32","16","16","0","0","0","0","0","0","1","1","0","30","14","16","0","0","0","0","0","0","0","0","0","1","1","0","0","0","0","-2"
"243346","Universidad Ana G. Mendez-Carolina Campus","2011","Total full-time Instruction/research/public service, Non-tenured not on tenure track total","86","32","54","0","0","0","0","0","0","1","1","0","83","30","53","0","0","0","1","0","1","0","0","0","1","1","0","0","0","0","-2"
"243443","Universidad del Sagrado Corazon","2011","Total full-time Instruction/research/public service, Tenured, Professors","67","21","46","0","0","0","1","1","0","0","0","0","64","20","44","0","0","0","2","0","2","0","0","0","0","0","0","0","0","0","-2"
"243443","Universidad del Sagrado Corazon","2011","Total full-time Instruction/research/public service, Tenured, Associate professors","11","7","4","0","0","0","0","0","0","0","0","0","11","7","4","0","0","0","0","0","0","0","0","0","0","0","0","0","0","0","-2"
"243443","Universidad del Sagrado Corazon","2011","Total full-time Instruction/research/public service, Tenured, Assistant professors","12","4","8","0","0","0","0","0","0","0","0","0","12","4","8","0","0","0","0","0","0","0","0","0","0","0","0","0","0","0","-2"
"243443","Universidad del Sagrado Corazon","2011","Total full-time Instruction/research/public service, Tenured, Instructors","3","2","1","0","0","0","0","0","0","0","0","0","3","2","1","0","0","0","0","0","0","0","0","0","0","0","0","0","0","0","-2"
"243443","Universidad del Sagrado Corazon","2011","Total full-time Instruction/research/public service, Tenured total","93","34","59","0","0","0","1","1","0","0","0","0","90","33","57","0","0","0","2","0","2","0","0","0","0","0","0","0","0","0","-2"
"243443","Universidad del Sagrado Corazon","2011","Total full-time Instruction/research/public service, Non-tenured on tenure track, Associate professors","1","0","1","0","0","0","0","0","0","0","0","0","1","0","1","0","0","0","0","0","0","0","0","0","0","0","0","0","0","0","-2"
"243443","Universidad del Sagrado Corazon","2011","Total full-time Instruction/research/public service, Non-tenured on tenure track, Assistant professors","3","0","3","0","0","0","0","0","0","0","0","0","3","0","3","0","0","0","0","0","0","0","0","0","0","0","0","0","0","0","-2"
"243443","Universidad del Sagrado Corazon","2011","Total full-time Instruction/research/public service, Non-tenured on tenure track, Instructors","4","1","3","0","0","0","0","0","0","0","0","0","4","1","3","0","0","0","0","0","0","0","0","0","0","0","0","0","0","0","-2"
"243443","Universidad del Sagrado Corazon","2011","Total full-time Instruction/research/public service, Non-tenured on tenure track total","8","1","7","0","0","0","0","0","0","0","0","0","8","1","7","0","0","0","0","0","0","0","0","0","0","0","0","0","0","0","-2"
"243568","Universidad Central Del Caribe","2011","Total full-time Instruction/research/public service, Non-tenured not on tenure track, Professors","12","8","4","0","0","0","0","0","0","0","0","0","7","5","2","0","0","0","5","3","2","0","0","0","0","0","0","0","0","0","-2"
"243568","Universidad Central Del Caribe","2011","Total full-time Instruction/research/public service, Non-tenured not on tenure track, Associate professors","18","8","10","0","0","0","2","0","2","0","0","0","15","7","8","0","0","0","1","1","0","0","0","0","0","0","0","0","0","0","-2"
"243568","Universidad Central Del Caribe","2011","Total full-time Instruction/research/public servicey, Non-tenured not on tenure track, Assistant professors","9","3","6","0","0","0","1","0","1","0","0","0","4","0","4","0","0","0","4","3","1","0","0","0","0","0","0","0","0","0","-2"
"243568","Universidad Central Del Caribe","2011","Total full-time Instruction/research/public service, Non-tenured not on tenure track total","39","19","20","0","0","0","3","0","3","0","0","0","26","12","14","0","0","0","10","7","3","0","0","0","0","0","0","0","0","0","-2"
"243577","Universidad Politecnica de Puerto Rico","2011","Total full-time Instruction/research/public service, Tenured, Professors","19","13","6","0","0","0","1","1","0","0","0","0","18","12","6","0","0","0","0","0","0","0","0","0","0","0","0","0","0","0","-2"
"243577","Universidad Politecnica de Puerto Rico","2011","Total full-time Instruction/research/public service, Tenured, Associate professors","11","5","6","0","0","0","0","0","0","0","0","0","11","5","6","0","0","0","0","0","0","0","0","0","0","0","0","0","0","0","-2"
"243577","Universidad Politecnica de Puerto Rico","2011","Total full-time Instruction/research/public service, Tenured total","30","18","12","0","0","0","1","1","0","0","0","0","29","17","12","0","0","0","0","0","0","0","0","0","0","0","0","0","0","0","-2"
"243577","Universidad Politecnica de Puerto Rico","2011","Total full-time Instruction/research/public service, Non-tenured not on tenure track, Professors","18","15","3","0","0","0","0","0","0","0","0","0","16","13","3","0","0","0","2","2","0","0","0","0","0","0","0","0","0","0","-2"
"243577","Universidad Politecnica de Puerto Rico","2011","Total full-time Instruction/research/public service, Non-tenured not on tenure track, Associate professors","75","49","26","0","0","0","0","0","0","0","0","0","74","48","26","0","0","0","1","1","0","0","0","0","0","0","0","0","0","0","-2"
"243577","Universidad Politecnica de Puerto Rico","2011","Total full-time Instruction/research/public servicey, Non-tenured not on tenure track, Assistant professors","28","15","13","0","0","0","0","0","0","0","0","0","28","15","13","0","0","0","0","0","0","0","0","0","0","0","0","0","0","0","-2"
"243577","Universidad Politecnica de Puerto Rico","2011","Total full-time Instruction/research/public service, Non-tenured not on tenure track, Instructors","10","7","3","0","0","0","0","0","0","0","0","0","10","7","3","0","0","0","0","0","0","0","0","0","0","0","0","0","0","0","-2"
"243577","Universidad Politecnica de Puerto Rico","2011","Total full-time Instruction/research/public service, Non-tenured not on tenure track total","131","86","45","0","0","0","0","0","0","0","0","0","128","83","45","0","0","0","3","3","0","0","0","0","0","0","0","0","0","0","-2"
"243586","Pontifical Catholic University of Puerto Rico-Mayaguez","2011","Total full-time Instruction/research/public service, Tenured, Professors","1","1","0","0","0","0","0","0","0","0","0","0","1","1","0","0","0","0","0","0","0","0","0","0","0","0","0","0","0","0","-2"
"243586","Pontifical Catholic University of Puerto Rico-Mayaguez","2011","Total full-time Instruction/research/public service, Tenured, Associate professors","1","1","0","0","0","0","0","0","0","0","0","0","1","1","0","0","0","0","0","0","0","0","0","0","0","0","0","0","0","0","-2"
"243586","Pontifical Catholic University of Puerto Rico-Mayaguez","2011","Total full-time Instruction/research/public service, Tenured, Assistant professors","3","2","1","0","0","0","0","0","0","0","0","0","2","2","0","0","0","0","1","0","1","0","0","0","0","0","0","0","0","0","-2"
"243586","Pontifical Catholic University of Puerto Rico-Mayaguez","2011","Total full-time Instruction/research/public service, Tenured total","5","4","1","0","0","0","0","0","0","0","0","0","4","4","0","0","0","0","1","0","1","0","0","0","0","0","0","0","0","0","-2"
"243586","Pontifical Catholic University of Puerto Rico-Mayaguez","2011","Total full-time Instruction/research/public service, Non-tenured not on tenure track, Professors","3","2","1","0","0","0","0","0","0","0","0","0","3","2","1","0","0","0","0","0","0","0","0","0","0","0","0","0","0","0","-2"
"243586","Pontifical Catholic University of Puerto Rico-Mayaguez","2011","Total full-time Instruction/research/public service, Non-tenured not on tenure track, Associate professors","5","4","1","0","0","0","0","0","0","0","0","0","5","4","1","0","0","0","0","0","0","0","0","0","0","0","0","0","0","0","-2"
"243586","Pontifical Catholic University of Puerto Rico-Mayaguez","2011","Total full-time Instruction/research/public servicey, Non-tenured not on tenure track, Assistant professors","17","10","7","0","0","0","0","0","0","0","0","0","17","10","7","0","0","0","0","0","0","0","0","0","0","0","0","0","0","0","-2"
"243586","Pontifical Catholic University of Puerto Rico-Mayaguez","2011","Total full-time Instruction/research/public service, Non-tenured not on tenure track, Instructors","1","1","0","0","0","0","0","0","0","0","0","0","1","1","0","0","0","0","0","0","0","0","0","0","0","0","0","0","0","0","-2"
"243586","Pontifical Catholic University of Puerto Rico-Mayaguez","2011","Total full-time Instruction/research/public service, Non-tenured not on tenure track, No academic rank","9","3","6","0","0","0","0","0","0","0","0","0","8","2","6","0","0","0","1","1","0","0","0","0","0","0","0","0","0","0","-2"
"243586","Pontifical Catholic University of Puerto Rico-Mayaguez","2011","Total full-time Instruction/research/public service, Non-tenured not on tenure track total","35","20","15","0","0","0","0","0","0","0","0","0","34","19","15","0","0","0","1","1","0","0","0","0","0","0","0","0","0","0","-2"
"243601","Universidad Ana G. Mendez-Gurabo Campus","2011","Total full-time Instruction/research/public service, Tenured, Professors","19","12","7","0","0","0","0","0","0","0","0","0","19","12","7","0","0","0","0","0","0","0","0","0","0","0","0","0","0","0","-2"
"243601","Universidad Ana G. Mendez-Gurabo Campus","2011","Total full-time Instruction/research/public service, Tenured, Associate professors","14","6","8","0","0","0","0","0","0","0","0","0","14","6","8","0","0","0","0","0","0","0","0","0","0","0","0","0","0","0","-2"
"243601","Universidad Ana G. Mendez-Gurabo Campus","2011","Total full-time Instruction/research/public service, Tenured, Assistant professors","1","1","0","0","0","0","0","0","0","0","0","0","1","1","0","0","0","0","0","0","0","0","0","0","0","0","0","0","0","0","-2"
"243601","Universidad Ana G. Mendez-Gurabo Campus","2011","Total full-time Instruction/research/public service, Tenured, Instructors","1","1","0","0","0","0","0","0","0","0","0","0","1","1","0","0","0","0","0","0","0","0","0","0","0","0","0","0","0","0","-2"
"243601","Universidad Ana G. Mendez-Gurabo Campus","2011","Total full-time Instruction/research/public service, Tenured total","35","20","15","0","0","0","0","0","0","0","0","0","35","20","15","0","0","0","0","0","0","0","0","0","0","0","0","0","0","0","-2"
"243601","Universidad Ana G. Mendez-Gurabo Campus","2011","Total full-time Instruction/research/public service, Non-tenured not on tenure track, Professors","11","8","3","0","0","0","0","0","0","0","0","0","7","4","3","0","0","0","1","1","0","0","0","0","3","3","0","0","0","0","-2"
"243601","Universidad Ana G. Mendez-Gurabo Campus","2011","Total full-time Instruction/research/public service, Non-tenured not on tenure track, Associate professors","26","16","10","0","0","0","0","0","0","0","0","0","24","14","10","0","0","0","0","0","0","0","0","0","2","2","0","0","0","0","-2"
"243601","Universidad Ana G. Mendez-Gurabo Campus","2011","Total full-time Instruction/research/public servicey, Non-tenured not on tenure track, Assistant professors","44","18","26","0","0","0","0","0","0","0","0","0","42","17","25","0","0","0","0","0","0","0","0","0","2","1","1","0","0","0","-2"
"243601","Universidad Ana G. Mendez-Gurabo Campus","2011","Total full-time Instruction/research/public service, Non-tenured not on tenure track, Instructors","39","13","26","0","0","0","0","0","0","0","0","0","37","13","24","0","0","0","0","0","0","0","0","0","2","0","2","0","0","0","-2"
"243601","Universidad Ana G. Mendez-Gurabo Campus","2011","Total full-time Instruction/research/public service, Non-tenured not on tenure track total","120","55","65","0","0","0","0","0","0","0","0","0","110","48","62","0","0","0","1","1","0","0","0","0","9","6","3","0","0","0","-2"
"243832","EDP University of Puerto Rico Inc-San Juan","2011","Total full-time Instruction/research/public service, Non-tenured not on tenure track, Instructors","24","9","15","0","0","0","0","0","0","0","0","0","24","9","15","0","0","0","0","0","0","0","0","0","0","0","0","0","0","0","-2"
"243832","EDP University of Puerto Rico Inc-San Juan","2011","Total full-time Instruction/research/public service, Non-tenured not on tenure track total","24","9","15","0","0","0","0","0","0","0","0","0","24","9","15","0","0","0","0","0","0","0","0","0","0","0","0","0","0","0","-2"
"245847","Antioch University-Santa Barbara","2011","Total full-time Instruction/research/public service, Non-tenured not on tenure track, No academic rank","11","2","9","0","0","0","1","1","0","0","0","0","1","1","0","0","0","0","9","0","9","0","0","0","0","0","0","0","0","0","-2"
"245847","Antioch University-Santa Barbara","2011","Total full-time Instruction/research/public service, Non-tenured not on tenure track total","11","2","9","0","0","0","1","1","0","0","0","0","1","1","0","0","0","0","9","0","9","0","0","0","0","0","0","0","0","0","-2"
"245953","Mid-America Christian University","2011","Total full-time Instruction/research/public service, Non-tenured not on tenure track, Professors","3","3","0","0","0","0","0","0","0","0","0","0","0","0","0","0","0","0","2","2","0","1","1","0","0","0","0","0","0","0","-2"
"245953","Mid-America Christian University","2011","Total full-time Instruction/research/public service, Non-tenured not on tenure track, Associate professors","5","3","2","0","0","0","0","0","0","0","0","0","0","0","0","0","0","0","5","3","2","0","0","0","0","0","0","0","0","0","-2"
"245953","Mid-America Christian University","2011","Total full-time Instruction/research/public servicey, Non-tenured not on tenure track, Assistant professors","9","4","5","0","0","0","0","0","0","0","0","0","0","0","0","0","0","0","8","3","5","1","1","0","0","0","0","0","0","0","-2"
"245953","Mid-America Christian University","2011","Total full-time Instruction/research/public service, Non-tenured not on tenure track total","17","10","7","0","0","0","0","0","0","0","0","0","0","0","0","0","0","0","15","8","7","2","2","0","0","0","0","0","0","0","-2"
"363907","Caribbean University-Ponce","2011","Total full-time Instruction/research/public service, Tenured, Assistant professors","9","3","6","0","0","0","0","0","0","0","0","0","9","3","6","0","0","0","0","0","0","0","0","0","0","0","0","0","0","0","-2"
"363907","Caribbean University-Ponce","2011","Total full-time Instruction/research/public service, Tenured, Instructors","17","8","9","0","0","0","0","0","0","0","0","0","16","7","9","0","0","0","0","0","0","0","0","0","0","0","0","1","1","0","-2"
"363907","Caribbean University-Ponce","2011","Total full-time Instruction/research/public service, Tenured total","26","11","15","0","0","0","0","0","0","0","0","0","25","10","15","0","0","0","0","0","0","0","0","0","0","0","0","1","1","0","-2"
"363916","Caribbean University-Vega Baja","2011","Total full-time Instruction/research/public service, Tenured, Assistant professors","6","2","4","0","0","0","0","0","0","0","0","0","6","2","4","0","0","0","0","0","0","0","0","0","0","0","0","0","0","0","-2"
"363916","Caribbean University-Vega Baja","2011","Total full-time Instruction/research/public service, Tenured, Instructors","9","4","5","0","0","0","0","0","0","0","0","0","9","4","5","0","0","0","0","0","0","0","0","0","0","0","0","0","0","0","-2"
"363916","Caribbean University-Vega Baja","2011","Total full-time Instruction/research/public service, Tenured total","15","6","9","0","0","0","0","0","0","0","0","0","15","6","9","0","0","0","0","0","0","0","0","0","0","0","0","0","0","0","-2"
"366711","California State University-San Marcos","2011","Total full-time Instruction/research/public service, Tenured, Professors","90","41","49","0","0","0","11","7","4","2","1","1","12","8","4","0","0","0","63","24","39","1","0","1","1","1","0","0","0","0","-2"
"366711","California State University-San Marcos","2011","Total full-time Instruction/research/public service, Tenured, Associate professors","72","41","31","1","0","1","12","10","2","4","3","1","11","3","8","1","1","0","36","21","15","1","0","1","5","3","2","1","0","1","-2"
"366711","California State University-San Marcos","2011","Total full-time Instruction/research/public service, Tenured, Assistant professors","1","0","1","0","0","0","0","0","0","0","0","0","0","0","0","0","0","0","1","0","1","0","0","0","0","0","0","0","0","0","-2"
"366711","California State University-San Marcos","2011","Total full-time Instruction/research/public service, Tenured total","163","82","81","1","0","1","23","17","6","6","4","2","23","11","12","1","1","0","100","45","55","2","0","2","6","4","2","1","0","1","-2"
"366711","California State University-San Marcos","2011","Total full-time Instruction/research/public service, Non-tenured on tenure track, Associate professors","3","1","2","0","0","0","0","0","0","0","0","0","0","0","0","0","0","0","3","1","2","0","0","0","0","0","0","0","0","0","-2"
"366711","California State University-San Marcos","2011","Total full-time Instruction/research/public service, Non-tenured on tenure track, Assistant professors","59","23","36","2","1","1","8","5","3","1","1","0","13","3","10","0","0","0","29","10","19","0","0","0","3","1","2","3","2","1","-2"
"366711","California State University-San Marcos","2011","Total full-time Instruction/research/public service, Non-tenured on tenure track total","62","24","38","2","1","1","8","5","3","1","1","0","13","3","10","0","0","0","32","11","21","0","0","0","3","1","2","3","2","1","-2"
"366711","California State University-San Marcos","2011","Total full-time Instruction/research/public service, Non-tenured not on tenure track, Lecturers","56","20","36","0","0","0","2","1","1","1","1","0","5","3","2","0","0","0","46","15","31","1","0","1","1","0","1","0","0","0","-2"
"366711","California State University-San Marcos","2011","Total full-time Instruction/research/public service, Non-tenured not on tenure track total","56","20","36","0","0","0","2","1","1","1","1","0","5","3","2","0","0","0","46","15","31","1","0","1","1","0","1","0","0","0","-2"
"367884","Hodges University","2011","Total full-time Instruction/research/public service, Non-tenured not on tenure track, Professors","18","11","7","0","0","0","0","0","0","1","0","1","0","0","0","0","0","0","16","11","5","0","0","0","0","0","0","1","0","1","-2"
"367884","Hodges University","2011","Total full-time Instruction/research/public service, Non-tenured not on tenure track, Associate professors","26","21","5","1","1","0","0","0","0","1","1","0","2","2","0","0","0","0","22","17","5","0","0","0","0","0","0","0","0","0","-2"
"367884","Hodges University","2011","Total full-time Instruction/research/public servicey, Non-tenured not on tenure track, Assistant professors","47","15","32","0","0","0","1","1","0","2","1","1","3","1","2","0","0","0","41","12","29","0","0","0","0","0","0","0","0","0","-2"
"367884","Hodges University","2011","Total full-time Instruction/research/public service, Non-tenured not on tenure track, Instructors","5","3","2","0","0","0","0","0","0","0","0","0","1","1","0","0","0","0","4","2","2","0","0","0","0","0","0","0","0","0","-2"
"367884","Hodges University","2011","Total full-time Instruction/research/public service, Non-tenured not on tenure track total","96","50","46","1","1","0","1","1","0","4","2","2","6","4","2","0","0","0","83","42","41","0","0","0","0","0","0","1","0","1","-2"
"376385","Universal Technology College of Puerto Rico","2011","Total full-time Instruction/research/public service, Tenured, Professors","19","9","10","0","0","0","0","0","0","0","0","0","19","9","10","0","0","0","0","0","0","0","0","0","0","0","0","0","0","0","-2"
"376385","Universal Technology College of Puerto Rico","2011","Total full-time Instruction/research/public service, Tenured total","19","9","10","0","0","0","0","0","0","0","0","0","19","9","10","0","0","0","0","0","0","0","0","0","0","0","0","0","0","0","-2"
"376385","Universal Technology College of Puerto Rico","2011","Total full-time Instruction/research/public service, Non-tenured not on tenure track, Professors","3","1","2","0","0","0","0","0","0","0","0","0","3","1","2","0","0","0","0","0","0","0","0","0","0","0","0","0","0","0","-2"
"376385","Universal Technology College of Puerto Rico","2011","Total full-time Instruction/research/public service, Non-tenured not on tenure track total","3","1","2","0","0","0","0","0","0","0","0","0","3","1","2","0","0","0","0","0","0","0","0","0","0","0","0","0","0","0","-2"
"377111","Remington College-Fort Worth Campus","2011","Total full-time Instruction/research/public service, Non-tenured not on tenure track, Instructors","21","7","14","0","0","0","1","1","0","1","1","0","1","0","1","0","0","0","18","5","13","0","0","0","0","0","0","0","0","0","-2"
"377111","Remington College-Fort Worth Campus","2011","Total full-time Instruction/research/public service, Non-tenured not on tenure track total","21","7","14","0","0","0","1","1","0","1","1","0","1","0","1","0","0","0","18","5","13","0","0","0","0","0","0","0","0","0","-2"
"409315","South Texas College","2011","Total full-time Instruction/research/public service, Non-tenured not on tenure track, Professors","8","6","2","0","0","0","0","0","0","1","1","0","0","0","0","2","1","1","5","4","1","0","0","0","0","0","0","0","0","0","-2"
"409315","South Texas College","2011","Total full-time Instruction/research/public service, Non-tenured not on tenure track, Associate professors","22","15","7","0","0","0","0","0","0","0","0","0","8","5","3","1","1","0","13","9","4","0","0","0","0","0","0","0","0","0","-2"
"409315","South Texas College","2011","Total full-time Instruction/research/public servicey, Non-tenured not on tenure track, Assistant professors","28","16","12","0","0","0","0","0","0","0","0","0","11","8","3","3","1","2","14","7","7","0","0","0","0","0","0","0","0","0","-2"
"409315","South Texas College","2011","Total full-time Instruction/research/public service, Non-tenured not on tenure track, Instructors","468","264","204","3","2","1","0","0","0","8","7","1","241","133","108","36","16","20","180","106","74","0","0","0","0","0","0","0","0","0","-2"
"409315","South Texas College","2011","Total full-time Instruction/research/public service, Non-tenured not on tenure track total","526","301","225","3","2","1","0","0","0","9","8","1","260","146","114","42","19","23","212","126","86","0","0","0","0","0","0","0","0","0","-2"
"409698","California State University-Monterey Bay","2011","Total full-time Instruction/research/public service, Tenured, Professors","49","31","18","1","1","0","12","7","5","2","1","1","9","6","3","1","0","1","24","16","8","0","0","0","0","0","0","0","0","0","-2"
"409698","California State University-Monterey Bay","2011","Total full-time Instruction/research/public service, Tenured, Associate professors","29","11","18","0","0","0","4","1","3","2","1","1","6","1","5","0","0","0","14","5","9","0","0","0","3","3","0","0","0","0","-2"
"409698","California State University-Monterey Bay","2011","Total full-time Instruction/research/public service, Tenured, No academic rank","3","2","1","0","0","0","0","0","0","0","0","0","0","0","0","0","0","0","3","2","1","0","0","0","0","0","0","0","0","0","-2"
"409698","California State University-Monterey Bay","2011","Total full-time Instruction/research/public service, Tenured total","81","44","37","1","1","0","16","8","8","4","2","2","15","7","8","1","0","1","41","23","18","0","0","0","3","3","0","0","0","0","-2"
"409698","California State University-Monterey Bay","2011","Total full-time Instruction/research/public service, Non-tenured on tenure track, Professors","1","1","0","0","0","0","0","0","0","0","0","0","1","1","0","0","0","0","0","0","0","0","0","0","0","0","0","0","0","0","-2"
"409698","California State University-Monterey Bay","2011","Total full-time Instruction/research/public service, Non-tenured on tenure track, Associate professors","1","1","0","0","0","0","0","0","0","1","1","0","0","0","0","0","0","0","0","0","0","0","0","0","0","0","0","0","0","0","-2"
"409698","California State University-Monterey Bay","2011","Total full-time Instruction/research/public service, Non-tenured on tenure track, Assistant professors","34","17","17","0","0","0","6","2","4","1","1","0","6","4","2","0","0","0","17","8","9","0","0","0","4","2","2","0","0","0","-2"
"409698","California State University-Monterey Bay","2011","Total full-time Instruction/research/public service, Non-tenured on tenure track total","36","19","17","0","0","0","6","2","4","2","2","0","7","5","2","0","0","0","17","8","9","0","0","0","4","2","2","0","0","0","-2"
"409698","California State University-Monterey Bay","2011","Total full-time Instruction/research/public service, Non-tenured not on tenure track, Lecturers","40","14","26","0","0","0","3","1","2","1","0","1","6","1","5","0","0","0","28","12","16","0","0","0","2","0","2","0","0","0","-2"
"409698","California State University-Monterey Bay","2011","Total full-time Instruction/research/public service, Non-tenured not on tenure track total","40","14","26","0","0","0","3","1","2","1","0","1","6","1","5","0","0","0","28","12","16","0","0","0","2","0","2","0","0","0","-2"
"414823","Johnson & Wales University-North Miami","2011","Total full-time Instruction/research/public service, Non-tenured not on tenure track, Professors","9","4","5","1","0","1","1","0","1","0","0","0","0","0","0","0","0","0","7","4","3","0","0","0","0","0","0","0","0","0","-2"
"414823","Johnson & Wales University-North Miami","2011","Total full-time Instruction/research/public service, Non-tenured not on tenure track, Associate professors","18","14","4","0","0","0","2","2","0","2","1","1","2","1","1","0","0","0","12","10","2","0","0","0","0","0","0","0","0","0","-2"
"414823","Johnson & Wales University-North Miami","2011","Total full-time Instruction/research/public servicey, Non-tenured not on tenure track, Assistant professors","18","10","8","1","0","1","0","0","0","3","2","1","1","0","1","0","0","0","12","8","4","1","0","1","0","0","0","0","0","0","-2"
"414823","Johnson & Wales University-North Miami","2011","Total full-time Instruction/research/public service, Non-tenured not on tenure track, Instructors","19","14","5","0","0","0","1","0","1","3","2","1","2","2","0","0","0","0","13","10","3","0","0","0","0","0","0","0","0","0","-2"
"414823","Johnson & Wales University-North Miami","2011","Total full-time Instruction/research/public service, Non-tenured not on tenure track total","64","42","22","2","0","2","4","2","2","8","5","3","5","3","2","0","0","0","44","32","12","1","0","1","0","0","0","0","0","0","-2"
"416801","The University of Texas MD Anderson Cancer Center","2011","Total full-time Instruction/research/public service, Tenured, Professors","324","259","65","0","0","0","74","61","13","3","2","1","19","13","6","0","0","0","228","183","45","0","0","0","0","0","0","0","0","0","-2"
"416801","The University of Texas MD Anderson Cancer Center","2011","Total full-time Instruction/research/public service, Tenured, Associate professors","123","70","53","0","0","0","43","25","18","2","0","2","7","3","4","0","0","0","71","42","29","0","0","0","0","0","0","0","0","0","-2"
"416801","The University of Texas MD Anderson Cancer Center","2011","Total full-time Instruction/research/public service, Tenured total","447","329","118","0","0","0","117","86","31","5","2","3","26","16","10","0","0","0","299","225","74","0","0","0","0","0","0","0","0","0","-2"
"416801","The University of Texas MD Anderson Cancer Center","2011","Total full-time Instruction/research/public service, Non-tenured on tenure track, Professors","4","2","2","0","0","0","1","1","0","0","0","0","0","0","0","0","0","0","3","1","2","0","0","0","0","0","0","0","0","0","-2"
"416801","The University of Texas MD Anderson Cancer Center","2011","Total full-time Instruction/research/public service, Non-tenured on tenure track, Associate professors","22","17","5","0","0","0","11","7","4","1","1","0","1","1","0","0","0","0","9","8","1","0","0","0","0","0","0","0","0","0","-2"
"416801","The University of Texas MD Anderson Cancer Center","2011","Total full-time Instruction/research/public service, Non-tenured on tenure track, Assistant professors","126","83","43","0","0","0","50","36","14","1","0","1","8","5","3","0","0","0","67","42","25","0","0","0","0","0","0","0","0","0","-2"
"416801","The University of Texas MD Anderson Cancer Center","2011","Total full-time Instruction/research/public service, Non-tenured on tenure track, Lecturers","1","1","0","0","0","0","1","1","0","0","0","0","0","0","0","0","0","0","0","0","0","0","0","0","0","0","0","0","0","0","-2"
"416801","The University of Texas MD Anderson Cancer Center","2011","Total full-time Instruction/research/public service, Non-tenured on tenure track total","153","103","50","0","0","0","63","45","18","2","1","1","9","6","3","0","0","0","79","51","28","0","0","0","0","0","0","0","0","0","-2"
"416801","The University of Texas MD Anderson Cancer Center","2011","Total full-time Instruction/research/public service, Non-tenured not on tenure track, Lecturers","921","540","381","2","0","2","422","264","158","31","13","18","59","36","23","0","0","0","406","227","179","0","0","0","0","0","0","1","0","1","-2"
"416801","The University of Texas MD Anderson Cancer Center","2011","Total full-time Instruction/research/public service, Non-tenured not on tenure track total","921","540","381","2","0","2","422","264","158","31","13","18","59","36","23","0","0","0","406","227","179","0","0","0","0","0","0","1","0","1","-2"
"430670","San Juan Bautista School of Medicine","2011","Total full-time Instruction/research/public service, Tenured, Professors","4","3","1","0","0","0","0","0","0","0","0","0","4","3","1","0","0","0","0","0","0","0","0","0","0","0","0","0","0","0","-2"
"430670","San Juan Bautista School of Medicine","2011","Total full-time Instruction/research/public service, Tenured, Associate professors","2","2","0","0","0","0","0","0","0","0","0","0","2","2","0","0","0","0","0","0","0","0","0","0","0","0","0","0","0","0","-2"
"430670","San Juan Bautista School of Medicine","2011","Total full-time Instruction/research/public service, Tenured, Assistant professors","5","1","4","0","0","0","0","0","0","0","0","0","5","1","4","0","0","0","0","0","0","0","0","0","0","0","0","0","0","0","-2"
"430670","San Juan Bautista School of Medicine","2011","Total full-time Instruction/research/public service, Tenured total","11","6","5","0","0","0","0","0","0","0","0","0","11","6","5","0","0","0","0","0","0","0","0","0","0","0","0","0","0","0","-2"
"430670","San Juan Bautista School of Medicine","2011","Total full-time Instruction/research/public service, Non-tenured on tenure track, Associate professors","2","1","1","0","0","0","0","0","0","0","0","0","2","1","1","0","0","0","0","0","0","0","0","0","0","0","0","0","0","0","-2"
"430670","San Juan Bautista School of Medicine","2011","Total full-time Instruction/research/public service, Non-tenured on tenure track, Assistant professors","6","4","2","0","0","0","0","0","0","0","0","0","6","4","2","0","0","0","0","0","0","0","0","0","0","0","0","0","0","0","-2"
"430670","San Juan Bautista School of Medicine","2011","Total full-time Instruction/research/public service, Non-tenured on tenure track, Instructors","1","0","1","0","0","0","0","0","0","0","0","0","1","0","1","0","0","0","0","0","0","0","0","0","0","0","0","0","0","0","-2"
"430670","San Juan Bautista School of Medicine","2011","Total full-time Instruction/research/public service, Non-tenured on tenure track total","9","5","4","0","0","0","0","0","0","0","0","0","9","5","4","0","0","0","0","0","0","0","0","0","0","0","0","0","0","0","-2"
"430670","San Juan Bautista School of Medicine","2011","Total full-time Instruction/research/public service, Non-tenured not on tenure track, Professors","1","1","0","0","0","0","0","0","0","0","0","0","1","1","0","0","0","0","0","0","0","0","0","0","0","0","0","0","0","0","-2"
"430670","San Juan Bautista School of Medicine","2011","Total full-time Instruction/research/public service, Non-tenured not on tenure track, Associate professors","2","1","1","0","0","0","0","0","0","0","0","0","2","1","1","0","0","0","0","0","0","0","0","0","0","0","0","0","0","0","-2"
"430670","San Juan Bautista School of Medicine","2011","Total full-time Instruction/research/public servicey, Non-tenured not on tenure track, Assistant professors","8","5","3","0","0","0","0","0","0","0","0","0","8","5","3","0","0","0","0","0","0","0","0","0","0","0","0","0","0","0","-2"
"430670","San Juan Bautista School of Medicine","2011","Total full-time Instruction/research/public service, Non-tenured not on tenure track, Instructors","3","2","1","0","0","0","0","0","0","0","0","0","3","2","1","0","0","0","0","0","0","0","0","0","0","0","0","0","0","0","-2"
"430670","San Juan Bautista School of Medicine","2011","Total full-time Instruction/research/public service, Non-tenured not on tenure track total","14","9","5","0","0","0","0","0","0","0","0","0","14","9","5","0","0","0","0","0","0","0","0","0","0","0","0","0","0","0","-2"
"434539","City College-Miami","2011","Total full-time Instruction/research/public service, Non-tenured not on tenure track, Instructors","4","3","1","0","0","0","0","0","0","0","0","0","2","2","0","0","0","0","2","1","1","0","0","0","0","0","0","0","0","0","-2"
"434539","City College-Miami","2011","Total full-time Instruction/research/public service, Non-tenured not on tenure track total","4","3","1","0","0","0","0","0","0","0","0","0","2","2","0","0","0","0","2","1","1","0","0","0","0","0","0","0","0","0","-2"
"434900","Dewey University-Carolina","2011","Total full-time Instruction/research/public service, Tenured, Professors","41","16","25","0","0","0","0","0","0","0","0","0","41","16","25","0","0","0","0","0","0","0","0","0","0","0","0","0","0","0","-2"
"434900","Dewey University-Carolina","2011","Total full-time Instruction/research/public service, Tenured total","41","16","25","0","0","0","0","0","0","0","0","0","41","16","25","0","0","0","0","0","0","0","0","0","0","0","0","0","0","0","-2"
"439446","Atlantic Institute of Oriental Medicine","2011","Total full-time Instruction/research/public service, Non-tenured not on tenure track, Instructors","7","7","0","0","0","0","6","6","0","0","0","0","0","0","0","0","0","0","0","0","0","0","0","0","1","1","0","0","0","0","-2"
"439446","Atlantic Institute of Oriental Medicine","2011","Total full-time Instruction/research/public service, Non-tenured not on tenure track total","7","7","0","0","0","0","6","6","0","0","0","0","0","0","0","0","0","0","0","0","0","0","0","0","1","1","0","0","0","0","-2"
"440651","Atenas College","2011","Total full-time Instruction/research/public service, Tenured, No academic rank","31","3","28","0","0","0","0","0","0","0","0","0","31","3","28","0","0","0","0","0","0","0","0","0","0","0","0","0","0","0","-2"
"440651","Atenas College","2011","Total full-time Instruction/research/public service, Tenured total","31","3","28","0","0","0","0","0","0","0","0","0","31","3","28","0","0","0","0","0","0","0","0","0","0","0","0","0","0","0","-2"
"440794","Pillar College","2011","Total full-time Instruction/research/public service, Non-tenured not on tenure track, Professors","3","2","1","0","0","0","1","1","0","0","0","0","0","0","0","0","0","0","2","1","1","0","0","0","0","0","0","0","0","0","-2"
"440794","Pillar College","2011","Total full-time Instruction/research/public servicey, Non-tenured not on tenure track, Assistant professors","3","2","1","0","0","0","0","0","0","1","0","1","0","0","0","0","0","0","2","2","0","0","0","0","0","0","0","0","0","0","-2"
"440794","Pillar College","2011","Total full-time Instruction/research/public service, Non-tenured not on tenure track total","6","4","2","0","0","0","1","1","0","1","0","1","0","0","0","0","0","0","4","3","1","0","0","0","0","0","0","0","0","0","-2"
"441690","Universidad Pentecostal Mizpa","2011","Total full-time Instruction/research/public service, Tenured, Instructors","1","0","1","0","0","0","0","0","0","0","0","0","1","0","1","0","0","0","0","0","0","0","0","0","0","0","0","0","0","0","-2"
"441690","Universidad Pentecostal Mizpa","2011","Total full-time Instruction/research/public service, Tenured total","1","0","1","0","0","0","0","0","0","0","0","0","1","0","1","0","0","0","0","0","0","0","0","0","0","0","0","0","0","0","-2"
"441900","Nevada State College","2011","Total full-time Instruction/research/public service, Tenured, Professors","1","1","0","0","0","0","0","0","0","0","0","0","0","0","0","0","0","0","1","1","0","0","0","0","0","0","0","0","0","0","-2"
"441900","Nevada State College","2011","Total full-time Instruction/research/public service, Tenured, Associate professors","6","4","2","0","0","0","1","1","0","1","1","0","1","0","1","0","0","0","3","2","1","0","0","0","0","0","0","0","0","0","-2"
"441900","Nevada State College","2011","Total full-time Instruction/research/public service, Tenured total","7","5","2","0","0","0","1","1","0","1","1","0","1","0","1","0","0","0","4","3","1","0","0","0","0","0","0","0","0","0","-2"
"441900","Nevada State College","2011","Total full-time Instruction/research/public service, Non-tenured on tenure track, Associate professors","1","0","1","0","0","0","0","0","0","0","0","0","0","0","0","0","0","0","1","0","1","0","0","0","0","0","0","0","0","0","-2"
"441900","Nevada State College","2011","Total full-time Instruction/research/public service, Non-tenured on tenure track, Assistant professors","12","5","7","0","0","0","1","1","0","1","1","0","0","0","0","0","0","0","10","3","7","0","0","0","0","0","0","0","0","0","-2"
"441900","Nevada State College","2011","Total full-time Instruction/research/public service, Non-tenured on tenure track total","13","5","8","0","0","0","1","1","0","1","1","0","0","0","0","0","0","0","11","3","8","0","0","0","0","0","0","0","0","0","-2"
"441900","Nevada State College","2011","Total full-time Instruction/research/public service, Non-tenured not on tenure track, Lecturers","16","2","14","0","0","0","5","2","3","0","0","0","0","0","0","0","0","0","11","0","11","0","0","0","0","0","0","0","0","0","-2"
"441900","Nevada State College","2011","Total full-time Instruction/research/public service, Non-tenured not on tenure track total","16","2","14","0","0","0","5","2","3","0","0","0","0","0","0","0","0","0","11","0","11","0","0","0","0","0","0","0","0","0","-2"
"441937","California State University-Channel Islands","2011","Total full-time Instruction/research/public service, Tenured, Professors","31","18","13","0","0","0","1","0","1","0","0","0","2","0","2","0","0","0","25","16","9","2","1","1","1","1","0","0","0","0","-2"
"441937","California State University-Channel Islands","2011","Total full-time Instruction/research/public service, Tenured, Associate professors","32","18","14","0","0","0","2","1","1","1","1","0","10","6","4","0","0","0","17","8","9","0","0","0","1","1","0","1","1","0","-2"
"441937","California State University-Channel Islands","2011","Total full-time Instruction/research/public service, Tenured total","63","36","27","0","0","0","3","1","2","1","1","0","12","6","6","0","0","0","42","24","18","2","1","1","2","2","0","1","1","0","-2"
"441937","California State University-Channel Islands","2011","Total full-time Instruction/research/public service, Non-tenured on tenure track, Professors","1","1","0","0","0","0","1","1","0","0","0","0","0","0","0","0","0","0","0","0","0","0","0","0","0","0","0","0","0","0","-2"
"441937","California State University-Channel Islands","2011","Total full-time Instruction/research/public service, Non-tenured on tenure track, Associate professors","2","1","1","0","0","0","0","0","0","0","0","0","0","0","0","0","0","0","1","0","1","0","0","0","0","0","0","1","1","0","-2"
"441937","California State University-Channel Islands","2011","Total full-time Instruction/research/public service, Non-tenured on tenure track, Assistant professors","11","4","7","0","0","0","2","0","2","0","0","0","1","1","0","0","0","0","6","1","5","0","0","0","2","2","0","0","0","0","-2"
"441937","California State University-Channel Islands","2011","Total full-time Instruction/research/public service, Non-tenured on tenure track total","14","6","8","0","0","0","3","1","2","0","0","0","1","1","0","0","0","0","7","1","6","0","0","0","2","2","0","1","1","0","-2"
"441937","California State University-Channel Islands","2011","Total full-time Instruction/research/public service, Non-tenured not on tenure track, Lecturers","56","30","26","0","0","0","5","2","3","0","0","0","6","4","2","0","0","0","40","20","20","2","2","0","1","1","0","2","1","1","-2"
"441937","California State University-Channel Islands","2011","Total full-time Instruction/research/public service, Non-tenured not on tenure track total","56","30","26","0","0","0","5","2","3","0","0","0","6","4","2","0","0","0","40","20","20","2","2","0","1","1","0","2","1","1","-2"
"443562","Dewey University-Hato Rey","2011","Total full-time Instruction/research/public service, Tenured, Professors","42","18","24","0","0","0","0","0","0","0","0","0","42","18","24","0","0","0","0","0","0","0","0","0","0","0","0","0","0","0","-2"
"443562","Dewey University-Hato Rey","2011","Total full-time Instruction/research/public service, Tenured total","42","18","24","0","0","0","0","0","0","0","0","0","42","18","24","0","0","0","0","0","0","0","0","0","0","0","0","0","0","0","-2"
"444398","Baptist University of the Americas","2011","Total full-time Instruction/research/public service, Tenured, Professors","1","1","0","0","0","0","0","0","0","0","0","0","1","1","0","0","0","0","0","0","0","0","0","0","0","0","0","0","0","0","-2"
"444398","Baptist University of the Americas","2011","Total full-time Instruction/research/public service, Tenured, Associate professors","3","2","1","0","0","0","0","0","0","0","0","0","2","1","1","0","0","0","1","1","0","0","0","0","0","0","0","0","0","0","-2"
"444398","Baptist University of the Americas","2011","Total full-time Instruction/research/public service, Tenured total","4","3","1","0","0","0","0","0","0","0","0","0","3","2","1","0","0","0","1","1","0","0","0","0","0","0","0","0","0","0","-2"
"444398","Baptist University of the Americas","2011","Total full-time Instruction/research/public service, Non-tenured on tenure track, Associate professors","2","0","2","0","0","0","0","0","0","0","0","0","1","0","1","0","0","0","1","0","1","0","0","0","0","0","0","0","0","0","-2"
"444398","Baptist University of the Americas","2011","Total full-time Instruction/research/public service, Non-tenured on tenure track total","2","0","2","0","0","0","0","0","0","0","0","0","1","0","1","0","0","0","1","0","1","0","0","0","0","0","0","0","0","0","-2"
"444398","Baptist University of the Americas","2011","Total full-time Instruction/research/public service, Non-tenured not on tenure track, Instructors","2","0","2","0","0","0","0","0","0","0","0","0","1","0","1","0","0","0","1","0","1","0","0","0","0","0","0","0","0","0","-2"
"444398","Baptist University of the Americas","2011","Total full-time Instruction/research/public service, Non-tenured not on tenure track total","2","0","2","0","0","0","0","0","0","0","0","0","1","0","1","0","0","0","1","0","1","0","0","0","0","0","0","0","0","0","-2"
"445203","Remington College-North Houston Campus","2011","Total full-time Instruction/research/public service, Non-tenured not on tenure track, Instructors","25","7","18","1","1","0","1","0","1","22","5","17","0","0","0","0","0","0","1","1","0","0","0","0","0","0","0","0","0","0","-2"
"445203","Remington College-North Houston Campus","2011","Total full-time Instruction/research/public service, Non-tenured not on tenure track total","25","7","18","1","1","0","1","0","1","22","5","17","0","0","0","0","0","0","1","1","0","0","0","0","0","0","0","0","0","0","-2"
"448752","CollegeAmerica-Colorado Springs","2011","Total full-time Instruction/research/public service, Non-tenured not on tenure track, Instructors","9","4","5","0","0","0","0","0","0","0","0","0","0","0","0","0","0","0","9","4","5","0","0","0","0","0","0","0","0","0","-2"
"448752","CollegeAmerica-Colorado Springs","2011","Total full-time Instruction/research/public service, Non-tenured not on tenure track total","9","4","5","0","0","0","0","0","0","0","0","0","0","0","0","0","0","0","9","4","5","0","0","0","0","0","0","0","0","0","-2"
"449135","Dewey University-Juana Díaz","2011","Total full-time Instruction/research/public service, Tenured, Professors","32","13","19","0","0","0","0","0","0","0","0","0","32","13","19","0","0","0","0","0","0","0","0","0","0","0","0","0","0","0","-2"
"449135","Dewey University-Juana Díaz","2011","Total full-time Instruction/research/public service, Tenured total","32","13","19","0","0","0","0","0","0","0","0","0","32","13","19","0","0","0","0","0","0","0","0","0","0","0","0","0","0","0","-2"
"449870","University of the West","2011","Total full-time Instruction/research/public service, Non-tenured on tenure track, Assistant professors","4","3","1","0","0","0","2","2","0","0","0","0","2","1","1","0","0","0","0","0","0","0","0","0","0","0","0","0","0","0","-2"
"449870","University of the West","2011","Total full-time Instruction/research/public service, Non-tenured on tenure track total","4","3","1","0","0","0","2","2","0","0","0","0","2","1","1","0","0","0","0","0","0","0","0","0","0","0","0","0","0","0","-2"
"449870","University of the West","2011","Total full-time Instruction/research/public service, Non-tenured not on tenure track, Associate professors","2","2","0","0","0","0","2","2","0","0","0","0","0","0","0","0","0","0","0","0","0","0","0","0","0","0","0","0","0","0","-2"
"449870","University of the West","2011","Total full-time Instruction/research/public servicey, Non-tenured not on tenure track, Assistant professors","1","1","0","0","0","0","0","0","0","0","0","0","0","0","0","0","0","0","1","1","0","0","0","0","0","0","0","0","0","0","-2"
"449870","University of the West","2011","Total full-time Instruction/research/public service, Non-tenured not on tenure track, Instructors","5","5","0","0","0","0","1","1","0","0","0","0","1","1","0","0","0","0","2","2","0","0","0","0","0","0","0","1","1","0","-2"
"449870","University of the West","2011","Total full-time Instruction/research/public service, Non-tenured not on tenure track total","8","8","0","0","0","0","3","3","0","0","0","0","1","1","0","0","0","0","3","3","0","0","0","0","0","0","0","1","1","0","-2"
"455770","Providence Christian College","2011","Total full-time Instruction/research/public service, Non-tenured not on tenure track, Associate professors","2","2","0","0","0","0","0","0","0","0","0","0","0","0","0","0","0","0","2","2","0","0","0","0","0","0","0","0","0","0","-2"
"455770","Providence Christian College","2011","Total full-time Instruction/research/public servicey, Non-tenured not on tenure track, Assistant professors","2","2","0","0","0","0","0","0","0","0","0","0","0","0","0","0","0","0","2","2","0","0","0","0","0","0","0","0","0","0","-2"
"455770","Providence Christian College","2011","Total full-time Instruction/research/public service, Non-tenured not on tenure track total","4","4","0","0","0","0","0","0","0","0","0","0","0","0","0","0","0","0","4","4","0","0","0","0","0","0","0","0","0","0","-2"
"462354","John Paul the Great Catholic University","2011","Total full-time Instruction/research/public service, Non-tenured not on tenure track, Professors","13","10","3","0","0","0","0","0","0","0","0","0","0","0","0","0","0","0","13","10","3","0","0","0","0","0","0","0","0","0","-2"
"462354","John Paul the Great Catholic University","2011","Total full-time Instruction/research/public service, Non-tenured not on tenure track total","13","10","3","0","0","0","0","0","0","0","0","0","0","0","0","0","0","0","13","10","3","0","0","0","0","0","0","0","0","0","-2"
"469416","Dewey University-Manati","2011","Total full-time Instruction/research/public service, Tenured, Professors","36","14","22","0","0","0","0","0","0","0","0","0","36","14","22","0","0","0","0","0","0","0","0","0","0","0","0","0","0","0","-2"
"469416","Dewey University-Manati","2011","Total full-time Instruction/research/public service, Tenured total","36","14","22","0","0","0","0","0","0","0","0","0","36","14","22","0","0","0","0","0","0","0","0","0","0","0","0","0","0","0","-2"
"475273","Springfield College-Regional, Online, and Continuing Education","2011","Total full-time Instruction/research/public service, Tenured, Professors","4","3","1","0","0","0","0","0","0","1","1","0","1","1","0","0","0","0","2","1","1","0","0","0","0","0","0","0","0","0","-2"
"475273","Springfield College-Regional, Online, and Continuing Education","2011","Total full-time Instruction/research/public service, Tenured, Associate professors","4","0","4","0","0","0","0","0","0","1","0","1","1","0","1","0","0","0","2","0","2","0","0","0","0","0","0","0","0","0","-2"
"475273","Springfield College-Regional, Online, and Continuing Education","2011","Total full-time Instruction/research/public service, Tenured total","8","3","5","0","0","0","0","0","0","2","1","1","2","1","1","0","0","0","4","1","3","0","0","0","0","0","0","0","0","0","-2"
"475273","Springfield College-Regional, Online, and Continuing Education","2011","Total full-time Instruction/research/public service, Non-tenured not on tenure track, Professors","3","2","1","0","0","0","0","0","0","0","0","0","0","0","0","0","0","0","3","2","1","0","0","0","0","0","0","0","0","0","-2"
"475273","Springfield College-Regional, Online, and Continuing Education","2011","Total full-time Instruction/research/public service, Non-tenured not on tenure track, Associate professors","6","4","2","0","0","0","0","0","0","2","2","0","0","0","0","0","0","0","3","2","1","0","0","0","1","0","1","0","0","0","-2"
"475273","Springfield College-Regional, Online, and Continuing Education","2011","Total full-time Instruction/research/public servicey, Non-tenured not on tenure track, Assistant professors","12","5","7","0","0","0","0","0","0","6","3","3","1","0","1","0","0","0","5","2","3","0","0","0","0","0","0","0","0","0","-2"
"475273","Springfield College-Regional, Online, and Continuing Education","2011","Total full-time Instruction/research/public service, Non-tenured not on tenure track total","21","11","10","0","0","0","0","0","0","8","5","3","1","0","1","0","0","0","11","6","5","0","0","0","1","0","1","0","0","0","-2"
