"unitid","institution name","year","S2016_IS.Instructional staff category","S2016_IS_RV.Grand total","S2016_IS_RV.Grand total men","S2016_IS_RV.Grand total women","S2016_IS_RV.American Indian or Alaska Native total","S2016_IS_RV.American Indian or Alaska Native men","S2016_IS_RV.American Indian or Alaska Native women","S2016_IS_RV.Asian total","S2016_IS_RV.Asian men","S2016_IS_RV.Asian women","S2016_IS_RV.Black or African American total","S2016_IS_RV.Black or African American men","S2016_IS_RV.Black or African American women","S2016_IS_RV.Hispanic or Latino total","S2016_IS_RV.Hispanic or Latino men","S2016_IS_RV.Hispanic or Latino women","S2016_IS_RV.Native Hawaiian or Other Pacific Islander total","S2016_IS_RV.Native Hawaiian or Other Pacific Islander men","S2016_IS_RV.Native Hawaiian or Other Pacific Islander women","S2016_IS_RV.White total","S2016_IS_RV.White men","S2016_IS_RV.White women","S2016_IS_RV.Two or more races total","S2016_IS_RV.Two or more races men","S2016_IS_RV.Two or more races women","S2016_IS_RV.Race/ethnicity unknown total","S2016_IS_RV.Race/ethnicity unknown men","S2016_IS_RV.Race/ethnicity unknown women","S2016_IS_RV.Nonresident alien total","S2016_IS_RV.Nonresident alien men","S2016_IS_RV.Nonresident alien women","IDX_HR"
"104188","Southwest University of Visual Arts-Tucson","2016","Not on tenure track/No tenure system system total","7","4","3","0","0","0","0","0","0","0","0","0","1","1","0","0","0","0","6","3","3","0","0","0","0","0","0","0","0","0","-2"
"104188","Southwest University of Visual Arts-Tucson","2016","Not on tenure/no tenure system, professors","7","4","3","0","0","0","0","0","0","0","0","0","1","1","0","0","0","0","6","3","3","0","0","0","0","0","0","0","0","0","-2"
"105367","Ottawa University-Phoenix","2016","Tenured total","4","1","3","0","0","0","1","0","1","0","0","0","1","1","0","0","0","0","2","0","2","0","0","0","0","0","0","0","0","0","-2"
"105367","Ottawa University-Phoenix","2016","Tenured, professors","2","0","2","0","0","0","1","0","1","0","0","0","0","0","0","0","0","0","1","0","1","0","0","0","0","0","0","0","0","0","-2"
"105367","Ottawa University-Phoenix","2016","Tenured, associate professors","2","1","1","0","0","0","0","0","0","0","0","0","1","1","0","0","0","0","1","0","1","0","0","0","0","0","0","0","0","0","-2"
"105367","Ottawa University-Phoenix","2016","Not on tenure track/No tenure system system total","2","1","1","0","0","0","0","0","0","0","0","0","1","0","1","0","0","0","1","1","0","0","0","0","0","0","0","0","0","0","-2"
"105367","Ottawa University-Phoenix","2016","Not on tenure/no tenure system, associate professors","1","0","1","0","0","0","0","0","0","0","0","0","1","0","1","0","0","0","0","0","0","0","0","0","0","0","0","0","0","0","-2"
"105367","Ottawa University-Phoenix","2016","Not on tenure/no tenure system, assistant professors","1","1","0","0","0","0","0","0","0","0","0","0","0","0","0","0","0","0","1","1","0","0","0","0","0","0","0","0","0","0","-2"
"109350","Antelope Valley College","2016","Tenured total","138","72","66","0","0","0","8","5","3","12","4","8","12","8","4","0","0","0","100","52","48","6","3","3","0","0","0","0","0","0","-2"
"109350","Antelope Valley College","2016","Tenured, professors","65","27","38","0","0","0","2","0","2","4","0","4","6","3","3","0","0","0","48","21","27","5","3","2","0","0","0","0","0","0","-2"
"109350","Antelope Valley College","2016","Tenured, associate professors","15","10","5","0","0","0","1","0","1","1","0","1","2","2","0","0","0","0","11","8","3","0","0","0","0","0","0","0","0","0","-2"
"109350","Antelope Valley College","2016","Tenured, assistant professors","3","1","2","0","0","0","0","0","0","0","0","0","0","0","0","0","0","0","3","1","2","0","0","0","0","0","0","0","0","0","-2"
"109350","Antelope Valley College","2016","Tenured, instructors","1","0","1","0","0","0","0","0","0","0","0","0","0","0","0","0","0","0","1","0","1","0","0","0","0","0","0","0","0","0","-2"
"109350","Antelope Valley College","2016","Tenured, no academic rank","54","34","20","0","0","0","5","5","0","7","4","3","4","3","1","0","0","0","37","22","15","1","0","1","0","0","0","0","0","0","-2"
"109350","Antelope Valley College","2016","On-Tenure track total","26","14","12","0","0","0","2","2","0","3","1","2","3","0","3","0","0","0","14","9","5","4","2","2","0","0","0","0","0","0","-2"
"109350","Antelope Valley College","2016","On-tenure track, no academic rank","26","14","12","0","0","0","2","2","0","3","1","2","3","0","3","0","0","0","14","9","5","4","2","2","0","0","0","0","0","0","-2"
"109785","Azusa Pacific University","2016","Not on tenure track/No tenure system system total","458","222","236","6","3","3","61","25","36","28","10","18","28","13","15","3","2","1","305","153","152","1","0","1","26","16","10","0","0","0","-2"
"109785","Azusa Pacific University","2016","Not on tenure/no tenure system, professors","142","90","52","0","0","0","12","10","2","11","6","5","4","2","2","0","0","0","104","65","39","0","0","0","11","7","4","0","0","0","-2"
"109785","Azusa Pacific University","2016","Not on tenure/no tenure system, associate professors","116","58","58","2","1","1","19","8","11","6","1","5","10","4","6","1","0","1","72","40","32","0","0","0","6","4","2","0","0","0","-2"
"109785","Azusa Pacific University","2016","Not on tenure/no tenure system, assistant professors","184","72","112","4","2","2","29","7","22","11","3","8","13","6","7","2","2","0","116","47","69","1","0","1","8","5","3","0","0","0","-2"
"109785","Azusa Pacific University","2016","Not on tenure/no tenure system, instructors","16","2","14","0","0","0","1","0","1","0","0","0","1","1","0","0","0","0","13","1","12","0","0","0","1","0","1","0","0","0","-2"
"109819","Bakersfield College","2016","Tenured total","183","96","87","2","1","1","8","4","4","10","5","5","16","7","9","1","1","0","134","73","61","0","0","0","12","5","7","0","0","0","-2"
"109819","Bakersfield College","2016","Tenured, instructors","183","96","87","2","1","1","8","4","4","10","5","5","16","7","9","1","1","0","134","73","61","0","0","0","12","5","7","0","0","0","-2"
"109819","Bakersfield College","2016","On-Tenure track total","102","43","59","1","1","0","5","2","3","4","2","2","27","7","20","0","0","0","65","31","34","0","0","0","0","0","0","0","0","0","-2"
"109819","Bakersfield College","2016","On-tenure track, instructors","102","43","59","1","1","0","5","2","3","4","2","2","27","7","20","0","0","0","65","31","34","0","0","0","0","0","0","0","0","0","-2"
"109819","Bakersfield College","2016","Not on tenure track/No tenure system system total","7","2","5","0","0","0","0","0","0","0","0","0","0","0","0","0","0","0","7","2","5","0","0","0","0","0","0","0","0","0","-2"
"109819","Bakersfield College","2016","Not on tenure/no tenure system, instructors","7","2","5","0","0","0","0","0","0","0","0","0","0","0","0","0","0","0","7","2","5","0","0","0","0","0","0","0","0","0","-2"
"110361","California Baptist University","2016","Tenured total","82","48","34","0","0","0","12","8","4","1","0","1","6","2","4","0","0","0","60","37","23","3","1","2","0","0","0","0","0","0","-2"
"110361","California Baptist University","2016","Tenured, professors","62","42","20","0","0","0","10","8","2","0","0","0","5","1","4","0","0","0","45","32","13","2","1","1","0","0","0","0","0","0","-2"
"110361","California Baptist University","2016","Tenured, associate professors","20","6","14","0","0","0","2","0","2","1","0","1","1","1","0","0","0","0","15","5","10","1","0","1","0","0","0","0","0","0","-2"
"110361","California Baptist University","2016","On-Tenure track total","192","101","91","1","0","1","30","16","14","12","7","5","15","8","7","1","0","1","123","69","54","4","1","3","6","0","6","0","0","0","-2"
"110361","California Baptist University","2016","On-tenure track, professors","12","9","3","0","0","0","1","1","0","0","0","0","0","0","0","0","0","0","11","8","3","0","0","0","0","0","0","0","0","0","-2"
"110361","California Baptist University","2016","On-tenure track, associate professors","56","37","19","0","0","0","13","10","3","4","2","2","6","5","1","0","0","0","31","20","11","1","0","1","1","0","1","0","0","0","-2"
"110361","California Baptist University","2016","On-tenure track, assistant professors","124","55","69","1","0","1","16","5","11","8","5","3","9","3","6","1","0","1","81","41","40","3","1","2","5","0","5","0","0","0","-2"
"110361","California Baptist University","2016","Not on tenure track/No tenure system system total","29","10","19","0","0","0","0","0","0","1","0","1","3","0","3","0","0","0","24","9","15","0","0","0","1","1","0","0","0","0","-2"
"110361","California Baptist University","2016","Not on tenure/no tenure system, instructors","15","6","9","0","0","0","0","0","0","0","0","0","2","0","2","0","0","0","12","5","7","0","0","0","1","1","0","0","0","0","-2"
"110361","California Baptist University","2016","Not on tenure/no tenure system, lecturers","14","4","10","0","0","0","0","0","0","1","0","1","1","0","1","0","0","0","12","4","8","0","0","0","0","0","0","0","0","0","-2"
"110413","California Lutheran University","2016","Tenured total","92","49","43","0","0","0","8","3","5","4","2","2","6","2","4","0","0","0","73","42","31","0","0","0","0","0","0","1","0","1","-2"
"110413","California Lutheran University","2016","Tenured, professors","50","32","18","0","0","0","4","2","2","3","2","1","1","1","0","0","0","0","42","27","15","0","0","0","0","0","0","0","0","0","-2"
"110413","California Lutheran University","2016","Tenured, associate professors","38","15","23","0","0","0","4","1","3","1","0","1","4","0","4","0","0","0","28","14","14","0","0","0","0","0","0","1","0","1","-2"
"110413","California Lutheran University","2016","Tenured, assistant professors","4","2","2","0","0","0","0","0","0","0","0","0","1","1","0","0","0","0","3","1","2","0","0","0","0","0","0","0","0","0","-2"
"110413","California Lutheran University","2016","On-Tenure track total","50","22","28","0","0","0","3","1","2","1","0","1","8","2","6","0","0","0","34","16","18","1","1","0","1","0","1","2","2","0","-2"
"110413","California Lutheran University","2016","On-tenure track, professors","4","2","2","0","0","0","0","0","0","0","0","0","0","0","0","0","0","0","4","2","2","0","0","0","0","0","0","0","0","0","-2"
"110413","California Lutheran University","2016","On-tenure track, associate professors","8","4","4","0","0","0","0","0","0","0","0","0","1","1","0","0","0","0","6","2","4","1","1","0","0","0","0","0","0","0","-2"
"110413","California Lutheran University","2016","On-tenure track, assistant professors","38","16","22","0","0","0","3","1","2","1","0","1","7","1","6","0","0","0","24","12","12","0","0","0","1","0","1","2","2","0","-2"
"110413","California Lutheran University","2016","Not on tenure track/No tenure system system total","56","28","28","0","0","0","3","2","1","1","0","1","3","1","2","0","0","0","47","24","23","1","1","0","1","0","1","0","0","0","-2"
"110413","California Lutheran University","2016","Not on tenure/no tenure system, professors","5","3","2","0","0","0","0","0","0","0","0","0","0","0","0","0","0","0","5","3","2","0","0","0","0","0","0","0","0","0","-2"
"110413","California Lutheran University","2016","Not on tenure/no tenure system, assistant professors","8","4","4","0","0","0","0","0","0","0","0","0","2","1","1","0","0","0","6","3","3","0","0","0","0","0","0","0","0","0","-2"
"110413","California Lutheran University","2016","Not on tenure/no tenure system, instructors","1","1","0","0","0","0","0","0","0","0","0","0","0","0","0","0","0","0","1","1","0","0","0","0","0","0","0","0","0","0","-2"
"110413","California Lutheran University","2016","Not on tenure/no tenure system, lecturers","42","20","22","0","0","0","3","2","1","1","0","1","1","0","1","0","0","0","35","17","18","1","1","0","1","0","1","0","0","0","-2"
"110486","California State University-Bakersfield","2016","Tenured total","121","73","48","0","0","0","19","15","4","7","3","4","16","11","5","1","1","0","70","38","32","2","0","2","2","2","0","4","3","1","-2"
"110486","California State University-Bakersfield","2016","Tenured, professors","75","47","28","0","0","0","15","12","3","4","2","2","8","5","3","1","1","0","43","25","18","1","0","1","0","0","0","3","2","1","-2"
"110486","California State University-Bakersfield","2016","Tenured, associate professors","45","25","20","0","0","0","3","2","1","3","1","2","8","6","2","0","0","0","27","13","14","1","0","1","2","2","0","1","1","0","-2"
"110486","California State University-Bakersfield","2016","Tenured, assistant professors","1","1","0","0","0","0","1","1","0","0","0","0","0","0","0","0","0","0","0","0","0","0","0","0","0","0","0","0","0","0","-2"
"110486","California State University-Bakersfield","2016","On-Tenure track total","74","38","36","0","0","0","9","6","3","1","0","1","12","5","7","0","0","0","34","15","19","0","0","0","2","2","0","16","10","6","-2"
"110486","California State University-Bakersfield","2016","On-tenure track, associate professors","5","0","5","0","0","0","2","0","2","0","0","0","1","0","1","0","0","0","2","0","2","0","0","0","0","0","0","0","0","0","-2"
"110486","California State University-Bakersfield","2016","On-tenure track, assistant professors","69","38","31","0","0","0","7","6","1","1","0","1","11","5","6","0","0","0","32","15","17","0","0","0","2","2","0","16","10","6","-2"
"110486","California State University-Bakersfield","2016","Not on tenure track/No tenure system system total","87","32","55","0","0","0","6","1","5","3","0","3","11","5","6","1","0","1","58","20","38","1","1","0","1","0","1","6","5","1","-2"
"110486","California State University-Bakersfield","2016","Not on tenure/no tenure system, lecturers","87","32","55","0","0","0","6","1","5","3","0","3","11","5","6","1","0","1","58","20","38","1","1","0","1","0","1","6","5","1","-2"
"110495","California State University-Stanislaus","2016","Tenured total","161","93","68","1","0","1","25","9","16","7","5","2","16","10","6","0","0","0","106","65","41","0","0","0","6","4","2","0","0","0","-2"
"110495","California State University-Stanislaus","2016","Tenured, professors","118","67","51","1","0","1","16","4","12","3","2","1","12","7","5","0","0","0","81","50","31","0","0","0","5","4","1","0","0","0","-2"
"110495","California State University-Stanislaus","2016","Tenured, associate professors","42","25","17","0","0","0","9","5","4","4","3","1","4","3","1","0","0","0","24","14","10","0","0","0","1","0","1","0","0","0","-2"
"110495","California State University-Stanislaus","2016","Tenured, assistant professors","1","1","0","0","0","0","0","0","0","0","0","0","0","0","0","0","0","0","1","1","0","0","0","0","0","0","0","0","0","0","-2"
"110495","California State University-Stanislaus","2016","On-Tenure track total","84","39","45","0","0","0","10","7","3","3","1","2","10","3","7","0","0","0","47","22","25","1","1","0","2","0","2","11","5","6","-2"
"110495","California State University-Stanislaus","2016","On-tenure track, professors","1","0","1","0","0","0","0","0","0","0","0","0","0","0","0","0","0","0","1","0","1","0","0","0","0","0","0","0","0","0","-2"
"110495","California State University-Stanislaus","2016","On-tenure track, associate professors","4","2","2","0","0","0","1","1","0","0","0","0","0","0","0","0","0","0","3","1","2","0","0","0","0","0","0","0","0","0","-2"
"110495","California State University-Stanislaus","2016","On-tenure track, assistant professors","79","37","42","0","0","0","9","6","3","3","1","2","10","3","7","0","0","0","43","21","22","1","1","0","2","0","2","11","5","6","-2"
"110495","California State University-Stanislaus","2016","Not on tenure track/No tenure system system total","62","34","28","0","0","0","6","2","4","0","0","0","5","2","3","1","0","1","48","29","19","0","0","0","2","1","1","0","0","0","-2"
"110495","California State University-Stanislaus","2016","Not on tenure/no tenure system, lecturers","62","34","28","0","0","0","6","2","4","0","0","0","5","2","3","1","0","1","48","29","19","0","0","0","2","1","1","0","0","0","-2"
"110510","California State University-San Bernardino","2016","Tenured total","262","148","114","1","1","0","49","26","23","10","4","6","25","14","11","0","0","0","166","98","68","1","1","0","9","4","5","1","0","1","-2"
"110510","California State University-San Bernardino","2016","Tenured, professors","197","124","73","1","1","0","34","22","12","5","2","3","18","10","8","0","0","0","132","84","48","1","1","0","6","4","2","0","0","0","-2"
"110510","California State University-San Bernardino","2016","Tenured, associate professors","57","20","37","0","0","0","14","3","11","5","2","3","6","3","3","0","0","0","28","12","16","0","0","0","3","0","3","1","0","1","-2"
"110510","California State University-San Bernardino","2016","Tenured, assistant professors","5","3","2","0","0","0","1","1","0","0","0","0","1","1","0","0","0","0","3","1","2","0","0","0","0","0","0","0","0","0","-2"
"110510","California State University-San Bernardino","2016","Tenured, no academic rank","3","1","2","0","0","0","0","0","0","0","0","0","0","0","0","0","0","0","3","1","2","0","0","0","0","0","0","0","0","0","-2"
"110510","California State University-San Bernardino","2016","On-Tenure track total","124","65","59","0","0","0","20","10","10","9","3","6","15","5","10","0","0","0","58","34","24","0","0","0","13","7","6","9","6","3","-2"
"110510","California State University-San Bernardino","2016","On-tenure track, professors","6","5","1","0","0","0","0","0","0","0","0","0","0","0","0","0","0","0","5","5","0","0","0","0","1","0","1","0","0","0","-2"
"110510","California State University-San Bernardino","2016","On-tenure track, associate professors","7","2","5","0","0","0","0","0","0","3","0","3","0","0","0","0","0","0","2","1","1","0","0","0","2","1","1","0","0","0","-2"
"110510","California State University-San Bernardino","2016","On-tenure track, assistant professors","111","58","53","0","0","0","20","10","10","6","3","3","15","5","10","0","0","0","51","28","23","0","0","0","10","6","4","9","6","3","-2"
"110510","California State University-San Bernardino","2016","Not on tenure track/No tenure system system total","89","28","61","0","0","0","9","1","8","2","2","0","9","2","7","0","0","0","60","19","41","1","1","0","6","2","4","2","1","1","-2"
"110510","California State University-San Bernardino","2016","Not on tenure/no tenure system, lecturers","89","28","61","0","0","0","9","1","8","2","2","0","9","2","7","0","0","0","60","19","41","1","1","0","6","2","4","2","1","1","-2"
"110529","California State Polytechnic University-Pomona","2016","Tenured total","320","190","130","1","0","1","83","51","32","10","6","4","30","20","10","1","1","0","175","103","72","0","0","0","16","9","7","4","0","4","-2"
"110529","California State Polytechnic University-Pomona","2016","Tenured, professors","241","152","89","0","0","0","55","40","15","7","4","3","26","17","9","1","1","0","142","85","57","0","0","0","10","5","5","0","0","0","-2"
"110529","California State Polytechnic University-Pomona","2016","Tenured, associate professors","77","37","40","1","0","1","27","10","17","3","2","1","4","3","1","0","0","0","33","18","15","0","0","0","6","4","2","3","0","3","-2"
"110529","California State Polytechnic University-Pomona","2016","Tenured, assistant professors","2","1","1","0","0","0","1","1","0","0","0","0","0","0","0","0","0","0","0","0","0","0","0","0","0","0","0","1","0","1","-2"
"110529","California State Polytechnic University-Pomona","2016","On-Tenure track total","184","100","84","1","1","0","35","16","19","4","2","2","21","12","9","0","0","0","89","48","41","2","2","0","8","5","3","24","14","10","-2"
"110529","California State Polytechnic University-Pomona","2016","On-tenure track, professors","1","0","1","0","0","0","1","0","1","0","0","0","0","0","0","0","0","0","0","0","0","0","0","0","0","0","0","0","0","0","-2"
"110529","California State Polytechnic University-Pomona","2016","On-tenure track, associate professors","4","3","1","0","0","0","0","0","0","0","0","0","0","0","0","0","0","0","4","3","1","0","0","0","0","0","0","0","0","0","-2"
"110529","California State Polytechnic University-Pomona","2016","On-tenure track, assistant professors","179","97","82","1","1","0","34","16","18","4","2","2","21","12","9","0","0","0","85","45","40","2","2","0","8","5","3","24","14","10","-2"
"110529","California State Polytechnic University-Pomona","2016","Not on tenure track/No tenure system system total","107","65","42","1","1","0","19","10","9","2","1","1","15","10","5","1","1","0","62","35","27","0","0","0","5","5","0","2","2","0","-2"
"110529","California State Polytechnic University-Pomona","2016","Not on tenure/no tenure system, lecturers","107","65","42","1","1","0","19","10","9","2","1","1","15","10","5","1","1","0","62","35","27","0","0","0","5","5","0","2","2","0","-2"
"110547","California State University-Dominguez Hills","2016","Tenured total","141","71","70","1","0","1","25","15","10","11","5","6","15","9","6","0","0","0","76","37","39","4","3","1","9","2","7","0","0","0","-2"
"110547","California State University-Dominguez Hills","2016","Tenured, professors","90","50","40","0","0","0","16","11","5","7","3","4","8","6","2","0","0","0","51","27","24","2","2","0","6","1","5","0","0","0","-2"
"110547","California State University-Dominguez Hills","2016","Tenured, associate professors","49","21","28","1","0","1","9","4","5","4","2","2","6","3","3","0","0","0","25","10","15","2","1","1","2","1","1","0","0","0","-2"
"110547","California State University-Dominguez Hills","2016","Tenured, assistant professors","2","0","2","0","0","0","0","0","0","0","0","0","1","0","1","0","0","0","0","0","0","0","0","0","1","0","1","0","0","0","-2"
"110547","California State University-Dominguez Hills","2016","On-Tenure track total","88","34","54","2","1","1","17","4","13","8","4","4","9","2","7","0","0","0","34","13","21","1","1","0","6","3","3","11","6","5","-2"
"110547","California State University-Dominguez Hills","2016","On-tenure track, professors","10","5","5","0","0","0","2","1","1","1","1","0","0","0","0","0","0","0","6","2","4","0","0","0","1","1","0","0","0","0","-2"
"110547","California State University-Dominguez Hills","2016","On-tenure track, associate professors","7","2","5","0","0","0","3","0","3","1","1","0","0","0","0","0","0","0","2","1","1","0","0","0","0","0","0","1","0","1","-2"
"110547","California State University-Dominguez Hills","2016","On-tenure track, assistant professors","71","27","44","2","1","1","12","3","9","6","2","4","9","2","7","0","0","0","26","10","16","1","1","0","5","2","3","10","6","4","-2"
"110547","California State University-Dominguez Hills","2016","Not on tenure track/No tenure system system total","99","50","49","1","0","1","6","3","3","8","2","6","20","9","11","0","0","0","54","30","24","2","1","1","8","5","3","0","0","0","-2"
"110547","California State University-Dominguez Hills","2016","Not on tenure/no tenure system, lecturers","99","50","49","1","0","1","6","3","3","8","2","6","20","9","11","0","0","0","54","30","24","2","1","1","8","5","3","0","0","0","-2"
"110556","California State University-Fresno","2016","Tenured total","353","218","135","0","0","0","60","44","16","13","7","6","33","22","11","0","0","0","233","137","96","3","3","0","6","2","4","5","3","2","-2"
"110556","California State University-Fresno","2016","Tenured, professors","220","151","69","0","0","0","25","22","3","6","4","2","20","15","5","0","0","0","160","104","56","3","3","0","5","2","3","1","1","0","-2"
"110556","California State University-Fresno","2016","Tenured, associate professors","130","65","65","0","0","0","34","22","12","7","3","4","13","7","6","0","0","0","71","31","40","0","0","0","1","0","1","4","2","2","-2"
"110556","California State University-Fresno","2016","Tenured, assistant professors","2","1","1","0","0","0","1","0","1","0","0","0","0","0","0","0","0","0","1","1","0","0","0","0","0","0","0","0","0","0","-2"
"110556","California State University-Fresno","2016","Tenured, no academic rank","1","1","0","0","0","0","0","0","0","0","0","0","0","0","0","0","0","0","1","1","0","0","0","0","0","0","0","0","0","0","-2"
"110556","California State University-Fresno","2016","On-Tenure track total","196","93","103","1","0","1","28","18","10","10","5","5","31","14","17","0","0","0","99","39","60","4","3","1","7","4","3","16","10","6","-2"
"110556","California State University-Fresno","2016","On-tenure track, associate professors","4","3","1","0","0","0","3","2","1","0","0","0","1","1","0","0","0","0","0","0","0","0","0","0","0","0","0","0","0","0","-2"
"110556","California State University-Fresno","2016","On-tenure track, assistant professors","191","90","101","1","0","1","25","16","9","10","5","5","29","13","16","0","0","0","99","39","60","4","3","1","7","4","3","16","10","6","-2"
"110556","California State University-Fresno","2016","On-tenure track, no academic rank","1","0","1","0","0","0","0","0","0","0","0","0","1","0","1","0","0","0","0","0","0","0","0","0","0","0","0","0","0","0","-2"
"110556","California State University-Fresno","2016","Not on tenure track/No tenure system system total","182","85","97","3","0","3","16","9","7","5","1","4","27","11","16","1","1","0","116","53","63","2","1","1","11","8","3","1","1","0","-2"
"110556","California State University-Fresno","2016","Not on tenure/no tenure system, lecturers","182","85","97","3","0","3","16","9","7","5","1","4","27","11","16","1","1","0","116","53","63","2","1","1","11","8","3","1","1","0","-2"
"110565","California State University-Fullerton","2016","Tenured total","528","288","240","1","1","0","111","63","48","12","5","7","38","22","16","1","1","0","357","192","165","0","0","0","1","1","0","7","3","4","-2"
"110565","California State University-Fullerton","2016","Tenured, professors","319","181","138","1","1","0","70","42","28","6","2","4","23","10","13","1","1","0","217","124","93","0","0","0","0","0","0","1","1","0","-2"
"110565","California State University-Fullerton","2016","Tenured, associate professors","209","107","102","0","0","0","41","21","20","6","3","3","15","12","3","0","0","0","140","68","72","0","0","0","1","1","0","6","2","4","-2"
"110565","California State University-Fullerton","2016","On-Tenure track total","254","125","129","2","1","1","40","14","26","13","4","9","27","11","16","0","0","0","114","62","52","0","0","0","5","2","3","53","31","22","-2"
"110565","California State University-Fullerton","2016","On-tenure track, professors","1","1","0","0","0","0","1","1","0","0","0","0","0","0","0","0","0","0","0","0","0","0","0","0","0","0","0","0","0","0","-2"
"110565","California State University-Fullerton","2016","On-tenure track, associate professors","19","11","8","0","0","0","2","1","1","0","0","0","2","1","1","0","0","0","10","7","3","0","0","0","1","1","0","4","1","3","-2"
"110565","California State University-Fullerton","2016","On-tenure track, assistant professors","234","113","121","2","1","1","37","12","25","13","4","9","25","10","15","0","0","0","104","55","49","0","0","0","4","1","3","49","30","19","-2"
"110565","California State University-Fullerton","2016","Not on tenure track/No tenure system system total","234","94","140","0","0","0","35","14","21","6","4","2","15","4","11","0","0","0","162","65","97","2","0","2","11","6","5","3","1","2","-2"
"110565","California State University-Fullerton","2016","Not on tenure/no tenure system, lecturers","234","94","140","0","0","0","35","14","21","6","4","2","15","4","11","0","0","0","162","65","97","2","0","2","11","6","5","3","1","2","-2"
"110574","California State University-East Bay","2016","Tenured total","201","99","102","0","0","0","40","19","21","11","5","6","21","7","14","2","1","1","113","56","57","0","0","0","9","6","3","5","5","0","-2"
"110574","California State University-East Bay","2016","Tenured, professors","117","57","60","0","0","0","18","9","9","7","4","3","14","4","10","2","1","1","72","36","36","0","0","0","2","1","1","2","2","0","-2"
"110574","California State University-East Bay","2016","Tenured, associate professors","81","40","41","0","0","0","22","10","12","4","1","3","6","3","3","0","0","0","39","18","21","0","0","0","7","5","2","3","3","0","-2"
"110574","California State University-East Bay","2016","Tenured, assistant professors","3","2","1","0","0","0","0","0","0","0","0","0","1","0","1","0","0","0","2","2","0","0","0","0","0","0","0","0","0","0","-2"
"110574","California State University-East Bay","2016","On-Tenure track total","116","58","58","0","0","0","25","12","13","7","3","4","9","6","3","0","0","0","51","26","25","1","1","0","9","3","6","14","7","7","-2"
"110574","California State University-East Bay","2016","On-tenure track, professors","3","2","1","0","0","0","1","0","1","0","0","0","1","1","0","0","0","0","1","1","0","0","0","0","0","0","0","0","0","0","-2"
"110574","California State University-East Bay","2016","On-tenure track, associate professors","10","6","4","0","0","0","3","3","0","0","0","0","2","1","1","0","0","0","3","1","2","0","0","0","1","1","0","1","0","1","-2"
"110574","California State University-East Bay","2016","On-tenure track, assistant professors","103","50","53","0","0","0","21","9","12","7","3","4","6","4","2","0","0","0","47","24","23","1","1","0","8","2","6","13","7","6","-2"
"110574","California State University-East Bay","2016","Not on tenure track/No tenure system system total","48","20","28","1","1","0","3","1","2","5","1","4","4","2","2","1","0","1","30","14","16","0","0","0","4","1","3","0","0","0","-2"
"110574","California State University-East Bay","2016","Not on tenure/no tenure system, lecturers","48","20","28","1","1","0","3","1","2","5","1","4","4","2","2","1","0","1","30","14","16","0","0","0","4","1","3","0","0","0","-2"
"110583","California State University-Long Beach","2016","Tenured total","561","313","248","3","2","1","120","58","62","17","12","5","54","33","21","0","0","0","345","193","152","4","2","2","16","13","3","2","0","2","-2"
"110583","California State University-Long Beach","2016","Tenured, professors","371","217","154","2","2","0","79","42","37","9","8","1","32","21","11","0","0","0","238","136","102","1","1","0","10","7","3","0","0","0","-2"
"110583","California State University-Long Beach","2016","Tenured, associate professors","183","91","92","1","0","1","40","15","25","8","4","4","22","12","10","0","0","0","101","53","48","3","1","2","6","6","0","2","0","2","-2"
"110583","California State University-Long Beach","2016","Tenured, assistant professors","3","1","2","0","0","0","1","1","0","0","0","0","0","0","0","0","0","0","2","0","2","0","0","0","0","0","0","0","0","0","-2"
"110583","California State University-Long Beach","2016","Tenured, no academic rank","4","4","0","0","0","0","0","0","0","0","0","0","0","0","0","0","0","0","4","4","0","0","0","0","0","0","0","0","0","0","-2"
"110583","California State University-Long Beach","2016","On-Tenure track total","227","95","132","3","1","2","45","12","33","9","3","6","21","6","15","1","1","0","97","46","51","3","1","2","13","7","6","35","18","17","-2"
"110583","California State University-Long Beach","2016","On-tenure track, professors","1","1","0","0","0","0","0","0","0","0","0","0","0","0","0","0","0","0","1","1","0","0","0","0","0","0","0","0","0","0","-2"
"110583","California State University-Long Beach","2016","On-tenure track, associate professors","9","1","8","0","0","0","5","0","5","0","0","0","1","0","1","0","0","0","2","0","2","0","0","0","0","0","0","1","1","0","-2"
"110583","California State University-Long Beach","2016","On-tenure track, assistant professors","217","93","124","3","1","2","40","12","28","9","3","6","20","6","14","1","1","0","94","45","49","3","1","2","13","7","6","34","17","17","-2"
"110583","California State University-Long Beach","2016","Not on tenure track/No tenure system system total","263","112","151","1","0","1","28","13","15","10","4","6","31","12","19","0","0","0","174","74","100","7","3","4","11","6","5","1","0","1","-2"
"110583","California State University-Long Beach","2016","Not on tenure/no tenure system, lecturers","263","112","151","1","0","1","28","13","15","10","4","6","31","12","19","0","0","0","174","74","100","7","3","4","11","6","5","1","0","1","-2"
"110592","California State University-Los Angeles","2016","Tenured total","349","193","156","0","0","0","92","49","43","14","8","6","51","33","18","1","1","0","176","92","84","1","0","1","13","9","4","1","1","0","-2"
"110592","California State University-Los Angeles","2016","Tenured, professors","260","148","112","0","0","0","66","36","30","10","6","4","39","25","14","1","1","0","135","74","61","1","0","1","8","6","2","0","0","0","-2"
"110592","California State University-Los Angeles","2016","Tenured, associate professors","87","43","44","0","0","0","26","13","13","4","2","2","12","8","4","0","0","0","39","16","23","0","0","0","5","3","2","1","1","0","-2"
"110592","California State University-Los Angeles","2016","Tenured, assistant professors","2","2","0","0","0","0","0","0","0","0","0","0","0","0","0","0","0","0","2","2","0","0","0","0","0","0","0","0","0","0","-2"
"110592","California State University-Los Angeles","2016","On-Tenure track total","149","55","94","2","0","2","24","6","18","12","3","9","23","7","16","0","0","0","49","23","26","3","0","3","4","0","4","32","16","16","-2"
"110592","California State University-Los Angeles","2016","On-tenure track, professors","21","8","13","1","0","1","4","2","2","2","0","2","2","1","1","0","0","0","12","5","7","0","0","0","0","0","0","0","0","0","-2"
"110592","California State University-Los Angeles","2016","On-tenure track, associate professors","3","1","2","0","0","0","1","1","0","0","0","0","0","0","0","0","0","0","2","0","2","0","0","0","0","0","0","0","0","0","-2"
"110592","California State University-Los Angeles","2016","On-tenure track, assistant professors","125","46","79","1","0","1","19","3","16","10","3","7","21","6","15","0","0","0","35","18","17","3","0","3","4","0","4","32","16","16","-2"
"110592","California State University-Los Angeles","2016","Not on tenure track/No tenure system system total","172","87","85","2","1","1","26","14","12","12","8","4","33","15","18","0","0","0","87","42","45","3","1","2","6","4","2","3","2","1","-2"
"110592","California State University-Los Angeles","2016","Not on tenure/no tenure system, lecturers","172","87","85","2","1","1","26","14","12","12","8","4","33","15","18","0","0","0","87","42","45","3","1","2","6","4","2","3","2","1","-2"
"110608","California State University-Northridge","2016","Tenured total","523","286","237","4","2","2","87","51","36","25","9","16","65","30","35","0","0","0","331","186","145","4","3","1","6","5","1","1","0","1","-2"
"110608","California State University-Northridge","2016","Tenured, professors","381","198","183","3","1","2","58","33","25","15","4","11","50","22","28","0","0","0","249","134","115","4","3","1","2","1","1","0","0","0","-2"
"110608","California State University-Northridge","2016","Tenured, associate professors","131","80","51","1","1","0","27","16","11","10","5","5","12","7","5","0","0","0","76","47","29","0","0","0","4","4","0","1","0","1","-2"
"110608","California State University-Northridge","2016","Tenured, assistant professors","1","1","0","0","0","0","0","0","0","0","0","0","1","1","0","0","0","0","0","0","0","0","0","0","0","0","0","0","0","0","-2"
"110608","California State University-Northridge","2016","Tenured, no academic rank","10","7","3","0","0","0","2","2","0","0","0","0","2","0","2","0","0","0","6","5","1","0","0","0","0","0","0","0","0","0","-2"
"110608","California State University-Northridge","2016","On-Tenure track total","245","100","145","2","0","2","46","16","30","14","3","11","20","13","7","0","0","0","123","49","74","2","0","2","17","9","8","21","10","11","-2"
"110608","California State University-Northridge","2016","On-tenure track, professors","1","0","1","0","0","0","0","0","0","1","0","1","0","0","0","0","0","0","0","0","0","0","0","0","0","0","0","0","0","0","-2"
"110608","California State University-Northridge","2016","On-tenure track, associate professors","33","8","25","0","0","0","7","2","5","2","0","2","2","1","1","0","0","0","18","3","15","0","0","0","2","0","2","2","2","0","-2"
"110608","California State University-Northridge","2016","On-tenure track, assistant professors","211","92","119","2","0","2","39","14","25","11","3","8","18","12","6","0","0","0","105","46","59","2","0","2","15","9","6","19","8","11","-2"
"110608","California State University-Northridge","2016","Not on tenure track/No tenure system system total","157","67","90","1","0","1","10","5","5","6","3","3","27","13","14","0","0","0","102","42","60","2","0","2","8","3","5","1","1","0","-2"
"110608","California State University-Northridge","2016","Not on tenure/no tenure system, lecturers","157","67","90","1","0","1","10","5","5","6","3","3","27","13","14","0","0","0","102","42","60","2","0","2","8","3","5","1","1","0","-2"
"110617","California State University-Sacramento","2016","Tenured total","459","256","203","4","2","2","75","43","32","23","10","13","40","23","17","0","0","0","288","162","126","2","1","1","12","7","5","15","8","7","-2"
"110617","California State University-Sacramento","2016","Tenured, professors","333","189","144","4","2","2","46","23","23","17","7","10","30","18","12","0","0","0","223","133","90","2","1","1","7","4","3","4","1","3","-2"
"110617","California State University-Sacramento","2016","Tenured, associate professors","120","63","57","0","0","0","28","19","9","6","3","3","10","5","5","0","0","0","61","27","34","0","0","0","4","2","2","11","7","4","-2"
"110617","California State University-Sacramento","2016","Tenured, assistant professors","4","2","2","0","0","0","1","1","0","0","0","0","0","0","0","0","0","0","2","0","2","0","0","0","1","1","0","0","0","0","-2"
"110617","California State University-Sacramento","2016","Tenured, no academic rank","2","2","0","0","0","0","0","0","0","0","0","0","0","0","0","0","0","0","2","2","0","0","0","0","0","0","0","0","0","0","-2"
"110617","California State University-Sacramento","2016","On-Tenure track total","150","71","79","1","1","0","17","10","7","8","3","5","6","2","4","0","0","0","96","45","51","3","1","2","19","9","10","0","0","0","-2"
"110617","California State University-Sacramento","2016","On-tenure track, professors","2","0","2","0","0","0","0","0","0","0","0","0","0","0","0","0","0","0","2","0","2","0","0","0","0","0","0","0","0","0","-2"
"110617","California State University-Sacramento","2016","On-tenure track, associate professors","6","3","3","0","0","0","3","1","2","1","1","0","0","0","0","0","0","0","2","1","1","0","0","0","0","0","0","0","0","0","-2"
"110617","California State University-Sacramento","2016","On-tenure track, assistant professors","141","68","73","1","1","0","14","9","5","7","2","5","6","2","4","0","0","0","91","44","47","3","1","2","19","9","10","0","0","0","-2"
"110617","California State University-Sacramento","2016","On-tenure track, no academic rank","1","0","1","0","0","0","0","0","0","0","0","0","0","0","0","0","0","0","1","0","1","0","0","0","0","0","0","0","0","0","-2"
"110617","California State University-Sacramento","2016","Not on tenure track/No tenure system system total","116","45","71","1","0","1","7","5","2","1","1","0","3","1","2","0","0","0","94","32","62","1","1","0","7","3","4","2","2","0","-2"
"110617","California State University-Sacramento","2016","Not on tenure/no tenure system, lecturers","116","45","71","1","0","1","7","5","2","1","1","0","3","1","2","0","0","0","94","32","62","1","1","0","7","3","4","2","2","0","-2"
"110671","University of California-Riverside","2016","Tenured total","521","356","165","5","3","2","112","75","37","17","11","6","31","20","11","0","0","0","345","242","103","0","0","0","9","4","5","2","1","1","-2"
"110671","University of California-Riverside","2016","Tenured, professors","330","250","80","2","2","0","63","50","13","10","6","4","14","10","4","0","0","0","236","180","56","0","0","0","5","2","3","0","0","0","-2"
"110671","University of California-Riverside","2016","Tenured, associate professors","187","104","83","3","1","2","47","24","23","7","5","2","17","10","7","0","0","0","107","61","46","0","0","0","4","2","2","2","1","1","-2"
"110671","University of California-Riverside","2016","Tenured, lecturers","4","2","2","0","0","0","2","1","1","0","0","0","0","0","0","0","0","0","2","1","1","0","0","0","0","0","0","0","0","0","-2"
"110671","University of California-Riverside","2016","On-Tenure track total","230","147","83","1","1","0","59","40","19","10","4","6","20","12","8","1","1","0","94","57","37","2","0","2","13","10","3","30","22","8","-2"
"110671","University of California-Riverside","2016","On-tenure track, assistant professors","221","142","79","1","1","0","58","40","18","9","3","6","20","12","8","1","1","0","87","53","34","2","0","2","13","10","3","30","22","8","-2"
"110671","University of California-Riverside","2016","On-tenure track, lecturers","9","5","4","0","0","0","1","0","1","1","1","0","0","0","0","0","0","0","7","4","3","0","0","0","0","0","0","0","0","0","-2"
"110671","University of California-Riverside","2016","Not on tenure track/No tenure system system total","197","113","84","1","1","0","35","18","17","7","3","4","13","4","9","0","0","0","114","67","47","3","2","1","10","7","3","14","11","3","-2"
"110671","University of California-Riverside","2016","Not on tenure/no tenure system, professors","12","9","3","0","0","0","4","4","0","1","0","1","0","0","0","0","0","0","7","5","2","0","0","0","0","0","0","0","0","0","-2"
"110671","University of California-Riverside","2016","Not on tenure/no tenure system, associate professors","11","7","4","0","0","0","3","1","2","1","1","0","0","0","0","0","0","0","6","5","1","0","0","0","1","0","1","0","0","0","-2"
"110671","University of California-Riverside","2016","Not on tenure/no tenure system, assistant professors","66","41","25","0","0","0","16","8","8","4","2","2","3","2","1","0","0","0","26","15","11","2","2","0","1","1","0","14","11","3","-2"
"110671","University of California-Riverside","2016","Not on tenure/no tenure system, instructors","1","0","1","0","0","0","0","0","0","0","0","0","0","0","0","0","0","0","1","0","1","0","0","0","0","0","0","0","0","0","-2"
"110671","University of California-Riverside","2016","Not on tenure/no tenure system, lecturers","105","55","50","1","1","0","11","4","7","1","0","1","9","2","7","0","0","0","74","42","32","1","0","1","8","6","2","0","0","0","-2"
"110671","University of California-Riverside","2016","Not on tenure/no tenure system, no academic rank","2","1","1","0","0","0","1","1","0","0","0","0","1","0","1","0","0","0","0","0","0","0","0","0","0","0","0","0","0","0","-2"
"110705","University of California-Santa Barbara","2016","Tenured total","700","465","235","5","0","5","72","46","26","16","10","6","45","28","17","0","0","0","526","358","168","0","0","0","11","7","4","25","16","9","-2"
"110705","University of California-Santa Barbara","2016","Tenured, professors","518","366","152","2","0","2","56","36","20","7","4","3","27","18","9","0","0","0","400","289","111","0","0","0","8","6","2","18","13","5","-2"
"110705","University of California-Santa Barbara","2016","Tenured, associate professors","154","86","68","3","0","3","16","10","6","8","5","3","15","9","6","0","0","0","103","58","45","0","0","0","3","1","2","6","3","3","-2"
"110705","University of California-Santa Barbara","2016","Tenured, lecturers","28","13","15","0","0","0","0","0","0","1","1","0","3","1","2","0","0","0","23","11","12","0","0","0","0","0","0","1","0","1","-2"
"110705","University of California-Santa Barbara","2016","On-Tenure track total","134","72","62","2","1","1","11","6","5","6","3","3","9","4","5","0","0","0","59","30","29","3","1","2","21","14","7","23","13","10","-2"
"110705","University of California-Santa Barbara","2016","On-tenure track, professors","2","2","0","0","0","0","0","0","0","0","0","0","0","0","0","0","0","0","0","0","0","0","0","0","0","0","0","2","2","0","-2"
"110705","University of California-Santa Barbara","2016","On-tenure track, assistant professors","125","66","59","2","1","1","11","6","5","6","3","3","9","4","5","0","0","0","54","27","27","3","1","2","19","13","6","21","11","10","-2"
"110705","University of California-Santa Barbara","2016","On-tenure track, lecturers","7","4","3","0","0","0","0","0","0","0","0","0","0","0","0","0","0","0","5","3","2","0","0","0","2","1","1","0","0","0","-2"
"110705","University of California-Santa Barbara","2016","Not on tenure track/No tenure system system total","133","63","70","1","1","0","12","3","9","0","0","0","6","3","3","0","0","0","83","36","47","0","0","0","12","7","5","19","13","6","-2"
"110705","University of California-Santa Barbara","2016","Not on tenure/no tenure system, professors","1","1","0","0","0","0","0","0","0","0","0","0","0","0","0","0","0","0","0","0","0","0","0","0","0","0","0","1","1","0","-2"
"110705","University of California-Santa Barbara","2016","Not on tenure/no tenure system, associate professors","1","1","0","0","0","0","0","0","0","0","0","0","0","0","0","0","0","0","1","1","0","0","0","0","0","0","0","0","0","0","-2"
"110705","University of California-Santa Barbara","2016","Not on tenure/no tenure system, assistant professors","19","12","7","0","0","0","3","1","2","0","0","0","1","1","0","0","0","0","3","0","3","0","0","0","3","2","1","9","8","1","-2"
"110705","University of California-Santa Barbara","2016","Not on tenure/no tenure system, lecturers","112","49","63","1","1","0","9","2","7","0","0","0","5","2","3","0","0","0","79","35","44","0","0","0","9","5","4","9","4","5","-2"
"110714","University of California-Santa Cruz","2016","Tenured total","428","266","162","7","1","6","67","39","28","9","8","1","40","18","22","0","0","0","297","195","102","1","1","0","7","4","3","0","0","0","-2"
"110714","University of California-Santa Cruz","2016","Tenured, professors","283","189","94","3","1","2","43","28","15","5","5","0","20","10","10","0","0","0","206","142","64","0","0","0","6","3","3","0","0","0","-2"
"110714","University of California-Santa Cruz","2016","Tenured, associate professors","134","71","63","4","0","4","23","10","13","4","3","1","18","8","10","0","0","0","84","49","35","1","1","0","0","0","0","0","0","0","-2"
"110714","University of California-Santa Cruz","2016","Tenured, lecturers","11","6","5","0","0","0","1","1","0","0","0","0","2","0","2","0","0","0","7","4","3","0","0","0","1","1","0","0","0","0","-2"
"110714","University of California-Santa Cruz","2016","On-Tenure track total","108","63","45","2","1","1","16","9","7","5","3","2","10","8","2","0","0","0","51","27","24","1","0","1","5","2","3","18","13","5","-2"
"110714","University of California-Santa Cruz","2016","On-tenure track, associate professors","2","1","1","0","0","0","1","0","1","0","0","0","0","0","0","0","0","0","1","1","0","0","0","0","0","0","0","0","0","0","-2"
"110714","University of California-Santa Cruz","2016","On-tenure track, assistant professors","104","60","44","2","1","1","15","9","6","4","2","2","10","8","2","0","0","0","49","25","24","1","0","1","5","2","3","18","13","5","-2"
"110714","University of California-Santa Cruz","2016","On-tenure track, lecturers","2","2","0","0","0","0","0","0","0","1","1","0","0","0","0","0","0","0","1","1","0","0","0","0","0","0","0","0","0","0","-2"
"110714","University of California-Santa Cruz","2016","Not on tenure track/No tenure system system total","53","26","27","1","0","1","3","1","2","1","0","1","8","3","5","0","0","0","36","20","16","0","0","0","1","0","1","3","2","1","-2"
"110714","University of California-Santa Cruz","2016","Not on tenure/no tenure system, professors","3","2","1","0","0","0","0","0","0","0","0","0","0","0","0","0","0","0","3","2","1","0","0","0","0","0","0","0","0","0","-2"
"110714","University of California-Santa Cruz","2016","Not on tenure/no tenure system, associate professors","2","2","0","0","0","0","0","0","0","0","0","0","0","0","0","0","0","0","1","1","0","0","0","0","0","0","0","1","1","0","-2"
"110714","University of California-Santa Cruz","2016","Not on tenure/no tenure system, assistant professors","5","3","2","0","0","0","1","1","0","0","0","0","0","0","0","0","0","0","4","2","2","0","0","0","0","0","0","0","0","0","-2"
"110714","University of California-Santa Cruz","2016","Not on tenure/no tenure system, lecturers","37","15","22","1","0","1","2","0","2","1","0","1","7","2","5","0","0","0","23","12","11","0","0","0","1","0","1","2","1","1","-2"
"110714","University of California-Santa Cruz","2016","Not on tenure/no tenure system, no academic rank","6","4","2","0","0","0","0","0","0","0","0","0","1","1","0","0","0","0","5","3","2","0","0","0","0","0","0","0","0","0","-2"
"111966","Charles R Drew University of Medicine and Science","2016","Not on tenure track/No tenure system system total","38","14","24","0","0","0","9","4","5","9","3","6","6","2","4","0","0","0","12","5","7","1","0","1","1","0","1","0","0","0","-2"
"111966","Charles R Drew University of Medicine and Science","2016","Not on tenure/no tenure system, professors","2","1","1","0","0","0","0","0","0","0","0","0","0","0","0","0","0","0","2","1","1","0","0","0","0","0","0","0","0","0","-2"
"111966","Charles R Drew University of Medicine and Science","2016","Not on tenure/no tenure system, associate professors","10","5","5","0","0","0","1","1","0","2","1","1","3","2","1","0","0","0","4","1","3","0","0","0","0","0","0","0","0","0","-2"
"111966","Charles R Drew University of Medicine and Science","2016","Not on tenure/no tenure system, assistant professors","18","6","12","0","0","0","7","2","5","4","1","3","1","0","1","0","0","0","6","3","3","0","0","0","0","0","0","0","0","0","-2"
"111966","Charles R Drew University of Medicine and Science","2016","Not on tenure/no tenure system, instructors","8","2","6","0","0","0","1","1","0","3","1","2","2","0","2","0","0","0","0","0","0","1","0","1","1","0","1","0","0","0","-2"
"112075","Concordia University-Irvine","2016","Not on tenure track/No tenure system system total","79","38","41","0","0","0","5","2","3","2","0","2","6","3","3","0","0","0","66","33","33","0","0","0","0","0","0","0","0","0","-2"
"112075","Concordia University-Irvine","2016","Not on tenure/no tenure system, professors","26","20","6","0","0","0","0","0","0","0","0","0","3","3","0","0","0","0","23","17","6","0","0","0","0","0","0","0","0","0","-2"
"112075","Concordia University-Irvine","2016","Not on tenure/no tenure system, associate professors","12","5","7","0","0","0","1","1","0","1","0","1","0","0","0","0","0","0","10","4","6","0","0","0","0","0","0","0","0","0","-2"
"112075","Concordia University-Irvine","2016","Not on tenure/no tenure system, assistant professors","41","13","28","0","0","0","4","1","3","1","0","1","3","0","3","0","0","0","33","12","21","0","0","0","0","0","0","0","0","0","-2"
"112084","San Diego Christian College","2016","Not on tenure track/No tenure system system total","19","10","9","0","0","0","0","0","0","1","0","1","0","0","0","1","1","0","17","9","8","0","0","0","0","0","0","0","0","0","-2"
"112084","San Diego Christian College","2016","Not on tenure/no tenure system, professors","3","3","0","0","0","0","0","0","0","0","0","0","0","0","0","0","0","0","3","3","0","0","0","0","0","0","0","0","0","0","-2"
"112084","San Diego Christian College","2016","Not on tenure/no tenure system, associate professors","8","4","4","0","0","0","0","0","0","1","0","1","0","0","0","0","0","0","7","4","3","0","0","0","0","0","0","0","0","0","-2"
"112084","San Diego Christian College","2016","Not on tenure/no tenure system, assistant professors","8","3","5","0","0","0","0","0","0","0","0","0","0","0","0","1","1","0","7","2","5","0","0","0","0","0","0","0","0","0","-2"
"113236","Cypress College","2016","Tenured total","165","71","94","0","0","0","19","5","14","6","0","6","24","13","11","1","0","1","89","43","46","6","2","4","18","8","10","2","0","2","-2"
"113236","Cypress College","2016","Tenured, instructors","165","71","94","0","0","0","19","5","14","6","0","6","24","13","11","1","0","1","89","43","46","6","2","4","18","8","10","2","0","2","-2"
"113236","Cypress College","2016","On-Tenure track total","59","27","32","0","0","0","10","3","7","1","1","0","11","5","6","0","0","0","26","13","13","3","0","3","6","5","1","2","0","2","-2"
"113236","Cypress College","2016","On-tenure track, instructors","59","27","32","0","0","0","10","3","7","1","1","0","11","5","6","0","0","0","26","13","13","3","0","3","6","5","1","2","0","2","-2"
"113236","Cypress College","2016","Not on tenure track/No tenure system system total","1","0","1","0","0","0","1","0","1","0","0","0","0","0","0","0","0","0","0","0","0","0","0","0","0","0","0","0","0","0","-2"
"113236","Cypress College","2016","Not on tenure/no tenure system, instructors","1","0","1","0","0","0","1","0","1","0","0","0","0","0","0","0","0","0","0","0","0","0","0","0","0","0","0","0","0","0","-2"
"113698","Dominican University of California","2016","Tenured total","44","20","24","0","0","0","3","1","2","4","3","1","0","0","0","0","0","0","35","15","20","0","0","0","2","1","1","0","0","0","-2"
"113698","Dominican University of California","2016","Tenured, professors","31","14","17","0","0","0","1","0","1","3","2","1","0","0","0","0","0","0","25","11","14","0","0","0","2","1","1","0","0","0","-2"
"113698","Dominican University of California","2016","Tenured, associate professors","13","6","7","0","0","0","2","1","1","1","1","0","0","0","0","0","0","0","10","4","6","0","0","0","0","0","0","0","0","0","-2"
"113698","Dominican University of California","2016","On-Tenure track total","29","10","19","0","0","0","5","2","3","0","0","0","0","0","0","0","0","0","21","6","15","0","0","0","3","2","1","0","0","0","-2"
"113698","Dominican University of California","2016","On-tenure track, associate professors","4","2","2","0","0","0","1","1","0","0","0","0","0","0","0","0","0","0","3","1","2","0","0","0","0","0","0","0","0","0","-2"
"113698","Dominican University of California","2016","On-tenure track, assistant professors","25","8","17","0","0","0","4","1","3","0","0","0","0","0","0","0","0","0","18","5","13","0","0","0","3","2","1","0","0","0","-2"
"113698","Dominican University of California","2016","Not on tenure track/No tenure system system total","26","12","14","0","0","0","2","0","2","1","1","0","2","1","1","0","0","0","19","9","10","0","0","0","2","1","1","0","0","0","-2"
"113698","Dominican University of California","2016","Not on tenure/no tenure system, professors","1","0","1","0","0","0","0","0","0","0","0","0","1","0","1","0","0","0","0","0","0","0","0","0","0","0","0","0","0","0","-2"
"113698","Dominican University of California","2016","Not on tenure/no tenure system, assistant professors","25","12","13","0","0","0","2","0","2","1","1","0","1","1","0","0","0","0","19","9","10","0","0","0","2","1","1","0","0","0","-2"
"114433","Feather River Community College District","2016","Tenured total","17","10","7","0","0","0","0","0","0","0","0","0","0","0","0","0","0","0","17","10","7","0","0","0","0","0","0","0","0","0","-2"
"114433","Feather River Community College District","2016","Tenured, professors","17","10","7","0","0","0","0","0","0","0","0","0","0","0","0","0","0","0","17","10","7","0","0","0","0","0","0","0","0","0","-2"
"114433","Feather River Community College District","2016","On-Tenure track total","8","6","2","0","0","0","0","0","0","0","0","0","0","0","0","0","0","0","7","5","2","0","0","0","0","0","0","1","1","0","-2"
"114433","Feather River Community College District","2016","On-tenure track, professors","8","6","2","0","0","0","0","0","0","0","0","0","0","0","0","0","0","0","7","5","2","0","0","0","0","0","0","1","1","0","-2"
"114716","Foothill College","2016","Tenured total","142","57","85","0","0","0","21","6","15","5","3","2","23","9","14","0","0","0","91","37","54","1","1","0","1","1","0","0","0","0","-2"
"114716","Foothill College","2016","Tenured, instructors","142","57","85","0","0","0","21","6","15","5","3","2","23","9","14","0","0","0","91","37","54","1","1","0","1","1","0","0","0","0","-2"
"114716","Foothill College","2016","On-Tenure track total","42","19","23","0","0","0","3","2","1","4","1","3","3","2","1","0","0","0","25","10","15","6","4","2","1","0","1","0","0","0","-2"
"114716","Foothill College","2016","On-tenure track, instructors","42","19","23","0","0","0","3","2","1","4","1","3","3","2","1","0","0","0","25","10","15","6","4","2","1","0","1","0","0","0","-2"
"114716","Foothill College","2016","Not on tenure track/No tenure system system total","5","0","5","0","0","0","0","0","0","0","0","0","2","0","2","0","0","0","3","0","3","0","0","0","0","0","0","0","0","0","-2"
"114716","Foothill College","2016","Not on tenure/no tenure system, instructors","5","0","5","0","0","0","0","0","0","0","0","0","2","0","2","0","0","0","3","0","3","0","0","0","0","0","0","0","0","0","-2"
"114813","Fresno Pacific University","2016","Tenured total","46","31","15","0","0","0","3","3","0","0","0","0","1","0","1","0","0","0","38","26","12","3","1","2","1","1","0","0","0","0","-2"
"114813","Fresno Pacific University","2016","Tenured, professors","15","13","2","0","0","0","1","1","0","0","0","0","0","0","0","0","0","0","14","12","2","0","0","0","0","0","0","0","0","0","-2"
"114813","Fresno Pacific University","2016","Tenured, associate professors","30","17","13","0","0","0","1","1","0","0","0","0","1","0","1","0","0","0","24","14","10","3","1","2","1","1","0","0","0","0","-2"
"114813","Fresno Pacific University","2016","Tenured, assistant professors","1","1","0","0","0","0","1","1","0","0","0","0","0","0","0","0","0","0","0","0","0","0","0","0","0","0","0","0","0","0","-2"
"114813","Fresno Pacific University","2016","On-Tenure track total","35","15","20","0","0","0","4","1","3","1","1","0","1","0","1","0","0","0","25","10","15","0","0","0","4","3","1","0","0","0","-2"
"114813","Fresno Pacific University","2016","On-tenure track, associate professors","2","1","1","0","0","0","0","0","0","0","0","0","1","0","1","0","0","0","0","0","0","0","0","0","1","1","0","0","0","0","-2"
"114813","Fresno Pacific University","2016","On-tenure track, assistant professors","32","13","19","0","0","0","4","1","3","1","1","0","0","0","0","0","0","0","24","9","15","0","0","0","3","2","1","0","0","0","-2"
"114813","Fresno Pacific University","2016","On-tenure track, instructors","1","1","0","0","0","0","0","0","0","0","0","0","0","0","0","0","0","0","1","1","0","0","0","0","0","0","0","0","0","0","-2"
"114813","Fresno Pacific University","2016","Not on tenure track/No tenure system system total","26","10","16","0","0","0","1","1","0","0","0","0","3","0","3","0","0","0","18","8","10","0","0","0","4","1","3","0","0","0","-2"
"114813","Fresno Pacific University","2016","Not on tenure/no tenure system, professors","2","2","0","0","0","0","0","0","0","0","0","0","0","0","0","0","0","0","2","2","0","0","0","0","0","0","0","0","0","0","-2"
"114813","Fresno Pacific University","2016","Not on tenure/no tenure system, associate professors","3","2","1","0","0","0","0","0","0","0","0","0","0","0","0","0","0","0","2","2","0","0","0","0","1","0","1","0","0","0","-2"
"114813","Fresno Pacific University","2016","Not on tenure/no tenure system, assistant professors","16","6","10","0","0","0","1","1","0","0","0","0","1","0","1","0","0","0","12","4","8","0","0","0","2","1","1","0","0","0","-2"
"114813","Fresno Pacific University","2016","Not on tenure/no tenure system, instructors","5","0","5","0","0","0","0","0","0","0","0","0","2","0","2","0","0","0","2","0","2","0","0","0","1","0","1","0","0","0","-2"
"115728","Holy Names University","2016","Tenured total","13","6","7","0","0","0","3","1","2","1","0","1","1","0","1","0","0","0","8","5","3","0","0","0","0","0","0","0","0","0","-2"
"115728","Holy Names University","2016","Tenured, professors","6","3","3","0","0","0","0","0","0","0","0","0","1","0","1","0","0","0","5","3","2","0","0","0","0","0","0","0","0","0","-2"
"115728","Holy Names University","2016","Tenured, associate professors","7","3","4","0","0","0","3","1","2","1","0","1","0","0","0","0","0","0","3","2","1","0","0","0","0","0","0","0","0","0","-2"
"115728","Holy Names University","2016","On-Tenure track total","13","5","8","0","0","0","3","2","1","1","1","0","0","0","0","0","0","0","9","2","7","0","0","0","0","0","0","0","0","0","-2"
"115728","Holy Names University","2016","On-tenure track, associate professors","3","3","0","0","0","0","1","1","0","0","0","0","0","0","0","0","0","0","2","2","0","0","0","0","0","0","0","0","0","0","-2"
"115728","Holy Names University","2016","On-tenure track, assistant professors","10","2","8","0","0","0","2","1","1","1","1","0","0","0","0","0","0","0","7","0","7","0","0","0","0","0","0","0","0","0","-2"
"115728","Holy Names University","2016","Not on tenure track/No tenure system system total","19","4","15","0","0","0","1","1","0","4","0","4","0","0","0","0","0","0","14","3","11","0","0","0","0","0","0","0","0","0","-2"
"115728","Holy Names University","2016","Not on tenure/no tenure system, professors","1","1","0","0","0","0","0","0","0","0","0","0","0","0","0","0","0","0","1","1","0","0","0","0","0","0","0","0","0","0","-2"
"115728","Holy Names University","2016","Not on tenure/no tenure system, associate professors","3","0","3","0","0","0","0","0","0","1","0","1","0","0","0","0","0","0","2","0","2","0","0","0","0","0","0","0","0","0","-2"
"115728","Holy Names University","2016","Not on tenure/no tenure system, assistant professors","8","1","7","0","0","0","0","0","0","3","0","3","0","0","0","0","0","0","5","1","4","0","0","0","0","0","0","0","0","0","-2"
"115728","Holy Names University","2016","Not on tenure/no tenure system, instructors","7","2","5","0","0","0","1","1","0","0","0","0","0","0","0","0","0","0","6","1","5","0","0","0","0","0","0","0","0","0","-2"
"115773","Humphreys University-Stockton and Modesto Campuses","2016","Not on tenure track/No tenure system system total","20","5","15","0","0","0","0","0","0","0","0","0","4","1","3","0","0","0","16","4","12","0","0","0","0","0","0","0","0","0","-2"
"115773","Humphreys University-Stockton and Modesto Campuses","2016","Not on tenure/no tenure system, professors","2","2","0","0","0","0","0","0","0","0","0","0","0","0","0","0","0","0","2","2","0","0","0","0","0","0","0","0","0","0","-2"
"115773","Humphreys University-Stockton and Modesto Campuses","2016","Not on tenure/no tenure system, associate professors","3","2","1","0","0","0","0","0","0","0","0","0","1","1","0","0","0","0","2","1","1","0","0","0","0","0","0","0","0","0","-2"
"115773","Humphreys University-Stockton and Modesto Campuses","2016","Not on tenure/no tenure system, assistant professors","9","1","8","0","0","0","0","0","0","0","0","0","3","0","3","0","0","0","6","1","5","0","0","0","0","0","0","0","0","0","-2"
"115773","Humphreys University-Stockton and Modesto Campuses","2016","Not on tenure/no tenure system, instructors","5","0","5","0","0","0","0","0","0","0","0","0","0","0","0","0","0","0","5","0","5","0","0","0","0","0","0","0","0","0","-2"
"115773","Humphreys University-Stockton and Modesto Campuses","2016","Not on tenure/no tenure system, no academic rank","1","0","1","0","0","0","0","0","0","0","0","0","0","0","0","0","0","0","1","0","1","0","0","0","0","0","0","0","0","0","-2"
"117104","Life Pacific University","2016","Not on tenure track/No tenure system system total","14","9","5","0","0","0","0","0","0","1","1","0","2","1","1","0","0","0","11","7","4","0","0","0","0","0","0","0","0","0","-2"
"117104","Life Pacific University","2016","Not on tenure/no tenure system, professors","4","3","1","0","0","0","0","0","0","0","0","0","0","0","0","0","0","0","4","3","1","0","0","0","0","0","0","0","0","0","-2"
"117104","Life Pacific University","2016","Not on tenure/no tenure system, associate professors","5","4","1","0","0","0","0","0","0","1","1","0","0","0","0","0","0","0","4","3","1","0","0","0","0","0","0","0","0","0","-2"
"117104","Life Pacific University","2016","Not on tenure/no tenure system, assistant professors","4","1","3","0","0","0","0","0","0","0","0","0","2","1","1","0","0","0","2","0","2","0","0","0","0","0","0","0","0","0","-2"
"117104","Life Pacific University","2016","Not on tenure/no tenure system, instructors","1","1","0","0","0","0","0","0","0","0","0","0","0","0","0","0","0","0","1","1","0","0","0","0","0","0","0","0","0","0","-2"
"117140","University of La Verne","2016","Tenured total","133","79","54","0","0","0","9","3","6","4","3","1","11","7","4","0","0","0","104","63","41","0","0","0","5","3","2","0","0","0","-2"
"117140","University of La Verne","2016","Tenured, professors","93","59","34","0","0","0","7","3","4","2","2","0","5","4","1","0","0","0","77","49","28","0","0","0","2","1","1","0","0","0","-2"
"117140","University of La Verne","2016","Tenured, associate professors","40","20","20","0","0","0","2","0","2","2","1","1","6","3","3","0","0","0","27","14","13","0","0","0","3","2","1","0","0","0","-2"
"117140","University of La Verne","2016","On-Tenure track total","68","23","45","0","0","0","4","3","1","3","0","3","5","4","1","0","0","0","20","8","12","0","0","0","26","8","18","10","0","10","-2"
"117140","University of La Verne","2016","On-tenure track, professors","1","0","1","0","0","0","0","0","0","0","0","0","0","0","0","0","0","0","0","0","0","0","0","0","1","0","1","0","0","0","-2"
"117140","University of La Verne","2016","On-tenure track, associate professors","13","4","9","0","0","0","1","0","1","1","0","1","2","2","0","0","0","0","8","2","6","0","0","0","1","0","1","0","0","0","-2"
"117140","University of La Verne","2016","On-tenure track, assistant professors","54","19","35","0","0","0","3","3","0","2","0","2","3","2","1","0","0","0","12","6","6","0","0","0","24","8","16","10","0","10","-2"
"117140","University of La Verne","2016","Not on tenure track/No tenure system system total","74","25","49","0","0","0","3","1","2","4","3","1","10","3","7","0","0","0","42","12","30","0","0","0","15","6","9","0","0","0","-2"
"117140","University of La Verne","2016","Not on tenure/no tenure system, professors","6","2","4","0","0","0","0","0","0","0","0","0","0","0","0","0","0","0","6","2","4","0","0","0","0","0","0","0","0","0","-2"
"117140","University of La Verne","2016","Not on tenure/no tenure system, associate professors","8","1","7","0","0","0","1","0","1","1","0","1","0","0","0","0","0","0","5","1","4","0","0","0","1","0","1","0","0","0","-2"
"117140","University of La Verne","2016","Not on tenure/no tenure system, assistant professors","32","11","21","0","0","0","1","1","0","1","1","0","6","1","5","0","0","0","16","4","12","0","0","0","8","4","4","0","0","0","-2"
"117140","University of La Verne","2016","Not on tenure/no tenure system, instructors","28","11","17","0","0","0","1","0","1","2","2","0","4","2","2","0","0","0","15","5","10","0","0","0","6","2","4","0","0","0","-2"
"117627","La Sierra University","2016","Tenured total","40","27","13","0","0","0","3","2","1","1","1","0","2","1","1","0","0","0","24","15","9","2","1","1","0","0","0","8","7","1","-2"
"117627","La Sierra University","2016","Tenured, professors","20","16","4","0","0","0","0","0","0","0","0","0","2","1","1","0","0","0","12","10","2","0","0","0","0","0","0","6","5","1","-2"
"117627","La Sierra University","2016","Tenured, associate professors","20","11","9","0","0","0","3","2","1","1","1","0","0","0","0","0","0","0","12","5","7","2","1","1","0","0","0","2","2","0","-2"
"117627","La Sierra University","2016","On-Tenure track total","31","18","13","0","0","0","5","2","3","2","2","0","4","4","0","0","0","0","19","10","9","0","0","0","0","0","0","1","0","1","-2"
"117627","La Sierra University","2016","On-tenure track, professors","5","4","1","0","0","0","1","0","1","0","0","0","1","1","0","0","0","0","3","3","0","0","0","0","0","0","0","0","0","0","-2"
"117627","La Sierra University","2016","On-tenure track, associate professors","14","8","6","0","0","0","2","1","1","1","1","0","1","1","0","0","0","0","10","5","5","0","0","0","0","0","0","0","0","0","-2"
"117627","La Sierra University","2016","On-tenure track, assistant professors","12","6","6","0","0","0","2","1","1","1","1","0","2","2","0","0","0","0","6","2","4","0","0","0","0","0","0","1","0","1","-2"
"117627","La Sierra University","2016","Not on tenure track/No tenure system system total","42","19","23","0","0","0","4","3","1","1","0","1","8","5","3","0","0","0","21","7","14","0","0","0","0","0","0","8","4","4","-2"
"117627","La Sierra University","2016","Not on tenure/no tenure system, professors","4","1","3","0","0","0","1","0","1","1","0","1","0","0","0","0","0","0","2","1","1","0","0","0","0","0","0","0","0","0","-2"
"117627","La Sierra University","2016","Not on tenure/no tenure system, associate professors","6","2","4","0","0","0","0","0","0","0","0","0","0","0","0","0","0","0","6","2","4","0","0","0","0","0","0","0","0","0","-2"
"117627","La Sierra University","2016","Not on tenure/no tenure system, assistant professors","21","12","9","0","0","0","2","2","0","0","0","0","6","3","3","0","0","0","7","3","4","0","0","0","0","0","0","6","4","2","-2"
"117627","La Sierra University","2016","Not on tenure/no tenure system, instructors","1","1","0","0","0","0","0","0","0","0","0","0","1","1","0","0","0","0","0","0","0","0","0","0","0","0","0","0","0","0","-2"
"117627","La Sierra University","2016","Not on tenure/no tenure system, lecturers","10","3","7","0","0","0","1","1","0","0","0","0","1","1","0","0","0","0","6","1","5","0","0","0","0","0","0","2","0","2","-2"
"117636","Loma Linda University","2016","Tenured total","18","13","5","0","0","0","3","2","1","1","1","0","1","1","0","0","0","0","13","9","4","0","0","0","0","0","0","0","0","0","-2"
"117636","Loma Linda University","2016","Tenured, professors","17","12","5","0","0","0","3","2","1","1","1","0","1","1","0","0","0","0","12","8","4","0","0","0","0","0","0","0","0","0","-2"
"117636","Loma Linda University","2016","Tenured, associate professors","1","1","0","0","0","0","0","0","0","0","0","0","0","0","0","0","0","0","1","1","0","0","0","0","0","0","0","0","0","0","-2"
"117636","Loma Linda University","2016","On-Tenure track total","52","27","25","0","0","0","8","3","5","6","2","4","7","4","3","1","1","0","29","16","13","0","0","0","0","0","0","1","1","0","-2"
"117636","Loma Linda University","2016","On-tenure track, professors","13","11","2","0","0","0","3","2","1","0","0","0","2","2","0","0","0","0","8","7","1","0","0","0","0","0","0","0","0","0","-2"
"117636","Loma Linda University","2016","On-tenure track, associate professors","16","6","10","0","0","0","4","1","3","1","1","0","2","0","2","0","0","0","9","4","5","0","0","0","0","0","0","0","0","0","-2"
"117636","Loma Linda University","2016","On-tenure track, assistant professors","21","9","12","0","0","0","1","0","1","5","1","4","3","2","1","1","1","0","11","5","6","0","0","0","0","0","0","0","0","0","-2"
"117636","Loma Linda University","2016","On-tenure track, instructors","2","1","1","0","0","0","0","0","0","0","0","0","0","0","0","0","0","0","1","0","1","0","0","0","0","0","0","1","1","0","-2"
"117636","Loma Linda University","2016","Not on tenure track/No tenure system system total","346","147","199","0","0","0","62","22","40","27","12","15","23","10","13","1","1","0","225","97","128","5","2","3","0","0","0","3","3","0","-2"
"117636","Loma Linda University","2016","Not on tenure/no tenure system, professors","40","24","16","0","0","0","5","4","1","4","3","1","2","1","1","0","0","0","29","16","13","0","0","0","0","0","0","0","0","0","-2"
"117636","Loma Linda University","2016","Not on tenure/no tenure system, associate professors","70","34","36","0","0","0","6","2","4","9","5","4","2","1","1","0","0","0","51","24","27","0","0","0","0","0","0","2","2","0","-2"
"117636","Loma Linda University","2016","Not on tenure/no tenure system, assistant professors","182","73","109","0","0","0","33","11","22","12","3","9","16","8","8","0","0","0","118","50","68","2","0","2","0","0","0","1","1","0","-2"
"117636","Loma Linda University","2016","Not on tenure/no tenure system, instructors","54","16","38","0","0","0","18","5","13","2","1","1","3","0","3","1","1","0","27","7","20","3","2","1","0","0","0","0","0","0","-2"
"118541","Marymount California University","2016","Not on tenure track/No tenure system system total","30","15","15","0","0","0","2","1","1","3","2","1","2","1","1","0","0","0","23","11","12","0","0","0","0","0","0","0","0","0","-2"
"118541","Marymount California University","2016","Not on tenure/no tenure system, professors","15","9","6","0","0","0","0","0","0","2","1","1","0","0","0","0","0","0","13","8","5","0","0","0","0","0","0","0","0","0","-2"
"118541","Marymount California University","2016","Not on tenure/no tenure system, associate professors","7","3","4","0","0","0","1","0","1","1","1","0","0","0","0","0","0","0","5","2","3","0","0","0","0","0","0","0","0","0","-2"
"118541","Marymount California University","2016","Not on tenure/no tenure system, assistant professors","8","3","5","0","0","0","1","1","0","0","0","0","2","1","1","0","0","0","5","1","4","0","0","0","0","0","0","0","0","0","-2"
"118693","Menlo College","2016","Not on tenure track/No tenure system system total","30","14","16","0","0","0","8","4","4","3","0","3","0","0","0","0","0","0","19","10","9","0","0","0","0","0","0","0","0","0","-2"
"118693","Menlo College","2016","Not on tenure/no tenure system, professors","12","6","6","0","0","0","3","2","1","1","0","1","0","0","0","0","0","0","8","4","4","0","0","0","0","0","0","0","0","0","-2"
"118693","Menlo College","2016","Not on tenure/no tenure system, associate professors","9","4","5","0","0","0","2","1","1","1","0","1","0","0","0","0","0","0","6","3","3","0","0","0","0","0","0","0","0","0","-2"
"118693","Menlo College","2016","Not on tenure/no tenure system, assistant professors","4","1","3","0","0","0","2","1","1","1","0","1","0","0","0","0","0","0","1","0","1","0","0","0","0","0","0","0","0","0","-2"
"118693","Menlo College","2016","Not on tenure/no tenure system, instructors","1","1","0","0","0","0","0","0","0","0","0","0","0","0","0","0","0","0","1","1","0","0","0","0","0","0","0","0","0","0","-2"
"118693","Menlo College","2016","Not on tenure/no tenure system, lecturers","4","2","2","0","0","0","1","0","1","0","0","0","0","0","0","0","0","0","3","2","1","0","0","0","0","0","0","0","0","0","-2"
"118888","Mills College","2016","Tenured total","60","21","39","0","0","0","8","3","5","3","0","3","5","1","4","0","0","0","38","15","23","4","1","3","2","1","1","0","0","0","-2"
"118888","Mills College","2016","Tenured, professors","44","17","27","0","0","0","3","1","2","3","0","3","3","1","2","0","0","0","31","14","17","2","0","2","2","1","1","0","0","0","-2"
"118888","Mills College","2016","Tenured, associate professors","16","4","12","0","0","0","5","2","3","0","0","0","2","0","2","0","0","0","7","1","6","2","1","1","0","0","0","0","0","0","-2"
"118888","Mills College","2016","On-Tenure track total","13","4","9","1","1","0","1","0","1","1","0","1","2","1","1","0","0","0","8","2","6","0","0","0","0","0","0","0","0","0","-2"
"118888","Mills College","2016","On-tenure track, assistant professors","13","4","9","1","1","0","1","0","1","1","0","1","2","1","1","0","0","0","8","2","6","0","0","0","0","0","0","0","0","0","-2"
"118888","Mills College","2016","Not on tenure track/No tenure system system total","18","5","13","1","0","1","1","1","0","3","1","2","1","0","1","0","0","0","12","3","9","0","0","0","0","0","0","0","0","0","-2"
"118888","Mills College","2016","Not on tenure/no tenure system, professors","8","3","5","0","0","0","0","0","0","2","1","1","0","0","0","0","0","0","6","2","4","0","0","0","0","0","0","0","0","0","-2"
"118888","Mills College","2016","Not on tenure/no tenure system, associate professors","2","0","2","0","0","0","0","0","0","0","0","0","1","0","1","0","0","0","1","0","1","0","0","0","0","0","0","0","0","0","-2"
"118888","Mills College","2016","Not on tenure/no tenure system, assistant professors","6","1","5","1","0","1","0","0","0","1","0","1","0","0","0","0","0","0","4","1","3","0","0","0","0","0","0","0","0","0","-2"
"118888","Mills College","2016","Not on tenure/no tenure system, no academic rank","2","1","1","0","0","0","1","1","0","0","0","0","0","0","0","0","0","0","1","0","1","0","0","0","0","0","0","0","0","0","-2"
"118912","MiraCosta College","2016","Tenured total","143","67","76","0","0","0","9","5","4","7","6","1","26","14","12","0","0","0","94","41","53","6","1","5","1","0","1","0","0","0","-2"
"118912","MiraCosta College","2016","Tenured, instructors","143","67","76","0","0","0","9","5","4","7","6","1","26","14","12","0","0","0","94","41","53","6","1","5","1","0","1","0","0","0","-2"
"118912","MiraCosta College","2016","On-Tenure track total","44","14","30","1","0","1","4","1","3","0","0","0","10","2","8","1","1","0","25","9","16","1","0","1","2","1","1","0","0","0","-2"
"118912","MiraCosta College","2016","On-tenure track, instructors","44","14","30","1","0","1","4","1","3","0","0","0","10","2","8","1","1","0","25","9","16","1","0","1","2","1","1","0","0","0","-2"
"118912","MiraCosta College","2016","Not on tenure track/No tenure system system total","6","5","1","0","0","0","2","2","0","3","3","0","1","0","1","0","0","0","0","0","0","0","0","0","0","0","0","0","0","0","-2"
"118912","MiraCosta College","2016","Not on tenure/no tenure system, instructors","6","5","1","0","0","0","2","2","0","3","3","0","1","0","1","0","0","0","0","0","0","0","0","0","0","0","0","0","0","0","-2"
"118976","Modesto Junior College","2016","Tenured total","120","52","68","1","0","1","4","1","3","5","2","3","13","8","5","0","0","0","84","37","47","0","0","0","12","4","8","1","0","1","-2"
"118976","Modesto Junior College","2016","Tenured, instructors","120","52","68","1","0","1","4","1","3","5","2","3","13","8","5","0","0","0","84","37","47","0","0","0","12","4","8","1","0","1","-2"
"118976","Modesto Junior College","2016","On-Tenure track total","53","35","18","0","0","0","1","0","1","4","1","3","4","3","1","0","0","0","41","29","12","0","0","0","3","2","1","0","0","0","-2"
"118976","Modesto Junior College","2016","On-tenure track, instructors","53","35","18","0","0","0","1","0","1","4","1","3","4","3","1","0","0","0","41","29","12","0","0","0","3","2","1","0","0","0","-2"
"118976","Modesto Junior College","2016","Not on tenure track/No tenure system system total","75","28","47","1","1","0","3","0","3","5","2","3","12","3","9","1","0","1","48","21","27","0","0","0","4","1","3","1","0","1","-2"
"118976","Modesto Junior College","2016","Not on tenure/no tenure system, instructors","75","28","47","1","1","0","3","0","3","5","2","3","12","3","9","1","0","1","48","21","27","0","0","0","4","1","3","1","0","1","-2"
"119173","Mount Saint Mary's University","2016","Tenured total","57","15","42","0","0","0","5","2","3","4","0","4","4","2","2","0","0","0","43","11","32","1","0","1","0","0","0","0","0","0","-2"
"119173","Mount Saint Mary's University","2016","Tenured, professors","21","6","15","0","0","0","2","0","2","0","0","0","2","1","1","0","0","0","16","5","11","1","0","1","0","0","0","0","0","0","-2"
"119173","Mount Saint Mary's University","2016","Tenured, associate professors","26","6","20","0","0","0","3","2","1","2","0","2","1","0","1","0","0","0","20","4","16","0","0","0","0","0","0","0","0","0","-2"
"119173","Mount Saint Mary's University","2016","Tenured, assistant professors","10","3","7","0","0","0","0","0","0","2","0","2","1","1","0","0","0","0","7","2","5","0","0","0","0","0","0","0","0","0","-2"
"119173","Mount Saint Mary's University","2016","On-Tenure track total","26","8","18","0","0","0","6","2","4","5","1","4","3","1","2","0","0","0","11","4","7","1","0","1","0","0","0","0","0","0","-2"
"119173","Mount Saint Mary's University","2016","On-tenure track, professors","1","1","0","0","0","0","0","0","0","0","0","0","0","0","0","0","0","0","1","1","0","0","0","0","0","0","0","0","0","0","-2"
"119173","Mount Saint Mary's University","2016","On-tenure track, associate professors","6","2","4","0","0","0","1","1","0","1","0","1","1","0","1","0","0","0","3","1","2","0","0","0","0","0","0","0","0","0","-2"
"119173","Mount Saint Mary's University","2016","On-tenure track, assistant professors","17","5","12","0","0","0","5","1","4","3","1","2","1","1","0","0","0","0","7","2","5","1","0","1","0","0","0","0","0","0","-2"
"119173","Mount Saint Mary's University","2016","On-tenure track, instructors","2","0","2","0","0","0","0","0","0","1","0","1","1","0","1","0","0","0","0","0","0","0","0","0","0","0","0","0","0","0","-2"
"119173","Mount Saint Mary's University","2016","Not on tenure track/No tenure system system total","43","11","32","0","0","0","3","0","3","3","1","2","5","2","3","0","0","0","27","7","20","3","1","2","2","0","2","0","0","0","-2"
"119173","Mount Saint Mary's University","2016","Not on tenure/no tenure system, professors","1","0","1","0","0","0","0","0","0","0","0","0","0","0","0","0","0","0","1","0","1","0","0","0","0","0","0","0","0","0","-2"
"119173","Mount Saint Mary's University","2016","Not on tenure/no tenure system, associate professors","2","1","1","0","0","0","0","0","0","0","0","0","1","1","0","0","0","0","1","0","1","0","0","0","0","0","0","0","0","0","-2"
"119173","Mount Saint Mary's University","2016","Not on tenure/no tenure system, assistant professors","28","7","21","0","0","0","2","0","2","2","1","1","3","0","3","0","0","0","19","6","13","1","0","1","1","0","1","0","0","0","-2"
"119173","Mount Saint Mary's University","2016","Not on tenure/no tenure system, instructors","6","2","4","0","0","0","1","0","1","1","0","1","1","1","0","0","0","0","2","0","2","1","1","0","0","0","0","0","0","0","-2"
"119173","Mount Saint Mary's University","2016","Not on tenure/no tenure system, no academic rank","6","1","5","0","0","0","0","0","0","0","0","0","0","0","0","0","0","0","4","1","3","1","0","1","1","0","1","0","0","0","-2"
"119605","National University","2016","Not on tenure track/No tenure system system total","304","143","161","2","1","1","32","19","13","17","7","10","23","10","13","0","0","0","206","100","106","0","0","0","24","6","18","0","0","0","-2"
"119605","National University","2016","Not on tenure/no tenure system, professors","111","69","42","1","1","0","13","10","3","6","3","3","6","2","4","0","0","0","77","49","28","0","0","0","8","4","4","0","0","0","-2"
"119605","National University","2016","Not on tenure/no tenure system, associate professors","93","38","55","1","0","1","7","4","3","5","2","3","7","4","3","0","0","0","67","27","40","0","0","0","6","1","5","0","0","0","-2"
"119605","National University","2016","Not on tenure/no tenure system, assistant professors","82","29","53","0","0","0","10","4","6","5","1","4","8","3","5","0","0","0","50","20","30","0","0","0","9","1","8","0","0","0","-2"
"119605","National University","2016","Not on tenure/no tenure system, instructors","16","6","10","0","0","0","2","1","1","0","0","0","2","1","1","0","0","0","11","4","7","0","0","0","1","0","1","0","0","0","-2"
"119605","National University","2016","Not on tenure/no tenure system, no academic rank","2","1","1","0","0","0","0","0","0","1","1","0","0","0","0","0","0","0","1","0","1","0","0","0","0","0","0","0","0","0","-2"
"120184","Notre Dame de Namur University","2016","Tenured total","33","18","15","1","1","0","5","2","3","1","1","0","1","1","0","0","0","0","25","13","12","0","0","0","0","0","0","0","0","0","-2"
"120184","Notre Dame de Namur University","2016","Tenured, professors","31","18","13","1","1","0","4","2","2","1","1","0","1","1","0","0","0","0","24","13","11","0","0","0","0","0","0","0","0","0","-2"
"120184","Notre Dame de Namur University","2016","Tenured, associate professors","2","0","2","0","0","0","1","0","1","0","0","0","0","0","0","0","0","0","1","0","1","0","0","0","0","0","0","0","0","0","-2"
"120184","Notre Dame de Namur University","2016","On-Tenure track total","10","1","9","0","0","0","2","0","2","1","0","1","0","0","0","0","0","0","6","1","5","1","0","1","0","0","0","0","0","0","-2"
"120184","Notre Dame de Namur University","2016","On-tenure track, associate professors","2","0","2","0","0","0","0","0","0","0","0","0","0","0","0","0","0","0","2","0","2","0","0","0","0","0","0","0","0","0","-2"
"120184","Notre Dame de Namur University","2016","On-tenure track, assistant professors","8","1","7","0","0","0","2","0","2","1","0","1","0","0","0","0","0","0","4","1","3","1","0","1","0","0","0","0","0","0","-2"
"120184","Notre Dame de Namur University","2016","Not on tenure track/No tenure system system total","11","3","8","0","0","0","4","1","3","1","0","1","0","0","0","1","0","1","5","2","3","0","0","0","0","0","0","0","0","0","-2"
"120184","Notre Dame de Namur University","2016","Not on tenure/no tenure system, associate professors","2","1","1","0","0","0","2","1","1","0","0","0","0","0","0","0","0","0","0","0","0","0","0","0","0","0","0","0","0","0","-2"
"120184","Notre Dame de Namur University","2016","Not on tenure/no tenure system, assistant professors","7","1","6","0","0","0","2","0","2","1","0","1","0","0","0","1","0","1","3","1","2","0","0","0","0","0","0","0","0","0","-2"
"120184","Notre Dame de Namur University","2016","Not on tenure/no tenure system, instructors","2","1","1","0","0","0","0","0","0","0","0","0","0","0","0","0","0","0","2","1","1","0","0","0","0","0","0","0","0","0","-2"
"120537","Hope International University","2016","Not on tenure track/No tenure system system total","39","21","18","0","0","0","1","1","0","2","0","2","2","2","0","0","0","0","33","18","15","0","0","0","1","0","1","0","0","0","-2"
"120537","Hope International University","2016","Not on tenure/no tenure system, professors","9","6","3","0","0","0","1","1","0","1","0","1","0","0","0","0","0","0","7","5","2","0","0","0","0","0","0","0","0","0","-2"
"120537","Hope International University","2016","Not on tenure/no tenure system, associate professors","23","12","11","0","0","0","0","0","0","1","0","1","2","2","0","0","0","0","19","10","9","0","0","0","1","0","1","0","0","0","-2"
"120537","Hope International University","2016","Not on tenure/no tenure system, assistant professors","7","3","4","0","0","0","0","0","0","0","0","0","0","0","0","0","0","0","7","3","4","0","0","0","0","0","0","0","0","0","-2"
"120768","Pacific Oaks College","2016","Not on tenure track/No tenure system system total","20","5","15","0","0","0","1","0","1","6","1","5","4","1","3","1","1","0","8","2","6","0","0","0","0","0","0","0","0","0","-2"
"120768","Pacific Oaks College","2016","Not on tenure/no tenure system, professors","20","5","15","0","0","0","1","0","1","6","1","5","4","1","3","1","1","0","8","2","6","0","0","0","0","0","0","0","0","0","-2"
"120865","Pacific Union College","2016","Tenured total","34","20","14","0","0","0","2","1","1","0","0","0","1","0","1","0","0","0","28","17","11","0","0","0","3","2","1","0","0","0","-2"
"120865","Pacific Union College","2016","Tenured, professors","27","17","10","0","0","0","2","1","1","0","0","0","0","0","0","0","0","0","22","14","8","0","0","0","3","2","1","0","0","0","-2"
"120865","Pacific Union College","2016","Tenured, associate professors","7","3","4","0","0","0","0","0","0","0","0","0","1","0","1","0","0","0","6","3","3","0","0","0","0","0","0","0","0","0","-2"
"120865","Pacific Union College","2016","On-Tenure track total","35","13","22","0","0","0","5","4","1","1","0","1","2","1","1","0","0","0","18","6","12","3","1","2","6","1","5","0","0","0","-2"
"120865","Pacific Union College","2016","On-tenure track, professors","6","2","4","0","0","0","1","1","0","0","0","0","0","0","0","0","0","0","3","0","3","1","0","1","1","1","0","0","0","0","-2"
"120865","Pacific Union College","2016","On-tenure track, associate professors","9","5","4","0","0","0","2","2","0","0","0","0","0","0","0","0","0","0","6","3","3","0","0","0","1","0","1","0","0","0","-2"
"120865","Pacific Union College","2016","On-tenure track, assistant professors","17","4","13","0","0","0","2","1","1","1","0","1","1","0","1","0","0","0","7","2","5","2","1","1","4","0","4","0","0","0","-2"
"120865","Pacific Union College","2016","On-tenure track, instructors","3","2","1","0","0","0","0","0","0","0","0","0","1","1","0","0","0","0","2","1","1","0","0","0","0","0","0","0","0","0","-2"
"120865","Pacific Union College","2016","Not on tenure track/No tenure system system total","21","10","11","0","0","0","3","1","2","2","1","1","4","1","3","0","0","0","10","7","3","0","0","0","2","0","2","0","0","0","-2"
"120865","Pacific Union College","2016","Not on tenure/no tenure system, professors","1","1","0","0","0","0","1","1","0","0","0","0","0","0","0","0","0","0","0","0","0","0","0","0","0","0","0","0","0","0","-2"
"120865","Pacific Union College","2016","Not on tenure/no tenure system, associate professors","3","3","0","0","0","0","0","0","0","0","0","0","0","0","0","0","0","0","3","3","0","0","0","0","0","0","0","0","0","0","-2"
"120865","Pacific Union College","2016","Not on tenure/no tenure system, assistant professors","13","5","8","0","0","0","2","0","2","1","1","0","4","1","3","0","0","0","4","3","1","0","0","0","2","0","2","0","0","0","-2"
"120865","Pacific Union College","2016","Not on tenure/no tenure system, instructors","4","1","3","0","0","0","0","0","0","1","0","1","0","0","0","0","0","0","3","1","2","0","0","0","0","0","0","0","0","0","-2"
"121619","Santa Ana College","2016","Tenured total","123","57","66","3","2","1","12","6","6","2","0","2","26","10","16","0","0","0","78","38","40","0","0","0","1","0","1","1","1","0","-2"
"121619","Santa Ana College","2016","Tenured, instructors","123","57","66","3","2","1","12","6","6","2","0","2","26","10","16","0","0","0","78","38","40","0","0","0","1","0","1","1","1","0","-2"
"121619","Santa Ana College","2016","On-Tenure track total","129","58","71","0","0","0","23","10","13","4","2","2","36","15","21","0","0","0","55","25","30","0","0","0","8","5","3","3","1","2","-2"
"121619","Santa Ana College","2016","On-tenure track, instructors","129","58","71","0","0","0","23","10","13","4","2","2","36","15","21","0","0","0","55","25","30","0","0","0","8","5","3","3","1","2","-2"
"121619","Santa Ana College","2016","Not on tenure track/No tenure system system total","14","5","9","0","0","0","1","1","0","0","0","0","5","1","4","0","0","0","6","2","4","0","0","0","1","0","1","1","1","0","-2"
"121619","Santa Ana College","2016","Not on tenure/no tenure system, instructors","14","5","9","0","0","0","1","1","0","0","0","0","5","1","4","0","0","0","6","2","4","0","0","0","1","0","1","1","1","0","-2"
"121691","University of Redlands","2016","Tenured total","157","79","78","1","1","0","20","11","9","4","1","3","6","3","3","0","0","0","125","62","63","0","0","0","1","1","0","0","0","0","-2"
"121691","University of Redlands","2016","Tenured, professors","112","60","52","0","0","0","11","8","3","2","1","1","4","2","2","0","0","0","94","48","46","0","0","0","1","1","0","0","0","0","-2"
"121691","University of Redlands","2016","Tenured, associate professors","45","19","26","1","1","0","9","3","6","2","0","2","2","1","1","0","0","0","31","14","17","0","0","0","0","0","0","0","0","0","-2"
"121691","University of Redlands","2016","On-Tenure track total","16","9","7","0","0","0","1","0","1","1","0","1","2","0","2","0","0","0","11","8","3","0","0","0","1","1","0","0","0","0","-2"
"121691","University of Redlands","2016","On-tenure track, associate professors","3","1","2","0","0","0","0","0","0","0","0","0","1","0","1","0","0","0","2","1","1","0","0","0","0","0","0","0","0","0","-2"
"121691","University of Redlands","2016","On-tenure track, assistant professors","13","8","5","0","0","0","1","0","1","1","0","1","1","0","1","0","0","0","9","7","2","0","0","0","1","1","0","0","0","0","-2"
"121691","University of Redlands","2016","Not on tenure track/No tenure system system total","45","21","24","0","0","0","6","2","4","1","1","0","1","1","0","0","0","0","33","14","19","0","0","0","4","3","1","0","0","0","-2"
"121691","University of Redlands","2016","Not on tenure/no tenure system, professors","2","2","0","0","0","0","1","1","0","0","0","0","0","0","0","0","0","0","1","1","0","0","0","0","0","0","0","0","0","0","-2"
"121691","University of Redlands","2016","Not on tenure/no tenure system, lecturers","12","5","7","0","0","0","0","0","0","0","0","0","1","1","0","0","0","0","11","4","7","0","0","0","0","0","0","0","0","0","-2"
"121691","University of Redlands","2016","Not on tenure/no tenure system, no academic rank","31","14","17","0","0","0","5","1","4","1","1","0","0","0","0","0","0","0","21","9","12","0","0","0","4","3","1","0","0","0","-2"
"121886","Rio Hondo College","2016","Tenured total","150","76","74","3","3","0","15","7","8","4","2","2","47","21","26","0","0","0","78","40","38","2","2","0","0","0","0","1","1","0","-2"
"121886","Rio Hondo College","2016","Tenured, instructors","150","76","74","3","3","0","15","7","8","4","2","2","47","21","26","0","0","0","78","40","38","2","2","0","0","0","0","1","1","0","-2"
"121886","Rio Hondo College","2016","On-Tenure track total","50","17","33","0","0","0","8","2","6","2","0","2","24","7","17","0","0","0","11","8","3","1","0","1","4","0","4","0","0","0","-2"
"121886","Rio Hondo College","2016","On-tenure track, instructors","50","17","33","0","0","0","8","2","6","2","0","2","24","7","17","0","0","0","11","8","3","1","0","1","4","0","4","0","0","0","-2"
"122375","San Diego Mesa College","2016","Tenured total","162","85","77","0","0","0","14","4","10","13","8","5","21","10","11","1","1","0","92","51","41","1","1","0","20","10","10","0","0","0","-2"
"122375","San Diego Mesa College","2016","Tenured, instructors","162","85","77","0","0","0","14","4","10","13","8","5","21","10","11","1","1","0","92","51","41","1","1","0","20","10","10","0","0","0","-2"
"122375","San Diego Mesa College","2016","On-Tenure track total","94","34","60","0","0","0","3","0","3","6","0","6","8","4","4","0","0","0","55","19","36","0","0","0","21","11","10","1","0","1","-2"
"122375","San Diego Mesa College","2016","On-tenure track, instructors","94","34","60","0","0","0","3","0","3","6","0","6","8","4","4","0","0","0","55","19","36","0","0","0","21","11","10","1","0","1","-2"
"122375","San Diego Mesa College","2016","Not on tenure track/No tenure system system total","3","1","2","0","0","0","0","0","0","1","0","1","0","0","0","0","0","0","1","1","0","0","0","0","1","0","1","0","0","0","-2"
"122375","San Diego Mesa College","2016","Not on tenure/no tenure system, instructors","3","1","2","0","0","0","0","0","0","1","0","1","0","0","0","0","0","0","1","1","0","0","0","0","1","0","1","0","0","0","-2"
"122977","Santa Monica College","2016","Tenured total","248","112","136","0","0","0","28","12","16","30","14","16","29","10","19","1","0","1","142","70","72","1","0","1","1","1","0","16","5","11","-2"
"122977","Santa Monica College","2016","Tenured, instructors","248","112","136","0","0","0","28","12","16","30","14","16","29","10","19","1","0","1","142","70","72","1","0","1","1","1","0","16","5","11","-2"
"122977","Santa Monica College","2016","On-Tenure track total","82","31","51","0","0","0","5","0","5","8","1","7","7","5","2","0","0","0","37","16","21","1","0","1","0","0","0","24","9","15","-2"
"122977","Santa Monica College","2016","On-tenure track, instructors","82","31","51","0","0","0","5","0","5","8","1","7","7","5","2","0","0","0","37","16","21","1","0","1","0","0","0","24","9","15","-2"
"122977","Santa Monica College","2016","Not on tenure track/No tenure system system total","8","1","7","0","0","0","1","0","1","1","0","1","2","0","2","0","0","0","2","1","1","0","0","0","1","0","1","1","0","1","-2"
"122977","Santa Monica College","2016","Not on tenure/no tenure system, instructors","8","1","7","0","0","0","1","0","1","1","0","1","2","0","2","0","0","0","2","1","1","0","0","0","1","0","1","1","0","1","-2"
"123509","Skyline College","2016","Tenured total","86","43","43","0","0","0","20","9","11","5","5","0","12","5","7","0","0","0","42","21","21","0","0","0","6","3","3","1","0","1","-2"
"123509","Skyline College","2016","Tenured, instructors","86","43","43","0","0","0","20","9","11","5","5","0","12","5","7","0","0","0","42","21","21","0","0","0","6","3","3","1","0","1","-2"
"123509","Skyline College","2016","On-Tenure track total","45","21","24","0","0","0","8","2","6","5","3","2","7","4","3","0","0","0","14","9","5","0","0","0","10","3","7","1","0","1","-2"
"123509","Skyline College","2016","On-tenure track, instructors","45","21","24","0","0","0","8","2","6","5","3","2","7","4","3","0","0","0","14","9","5","0","0","0","10","3","7","1","0","1","-2"
"123509","Skyline College","2016","Not on tenure track/No tenure system system total","14","7","7","0","0","0","6","3","3","1","1","0","2","0","2","0","0","0","3","3","0","0","0","0","2","0","2","0","0","0","-2"
"123509","Skyline College","2016","Not on tenure/no tenure system, instructors","14","7","7","0","0","0","6","3","3","1","1","0","2","0","2","0","0","0","3","3","0","0","0","0","2","0","2","0","0","0","-2"
"123554","Saint Mary's College of California","2016","Tenured total","130","70","60","1","0","1","15","7","8","3","1","2","7","4","3","0","0","0","91","52","39","0","0","0","9","5","4","4","1","3","-2"
"123554","Saint Mary's College of California","2016","Tenured, professors","76","45","31","1","0","1","9","4","5","1","0","1","5","3","2","0","0","0","58","37","21","0","0","0","2","1","1","0","0","0","-2"
"123554","Saint Mary's College of California","2016","Tenured, associate professors","54","25","29","0","0","0","6","3","3","2","1","1","2","1","1","0","0","0","33","15","18","0","0","0","7","4","3","4","1","3","-2"
"123554","Saint Mary's College of California","2016","On-Tenure track total","58","19","39","0","0","0","8","1","7","4","1","3","10","2","8","0","0","0","16","7","9","0","0","0","15","7","8","5","1","4","-2"
"123554","Saint Mary's College of California","2016","On-tenure track, associate professors","13","3","10","0","0","0","4","1","3","0","0","0","1","0","1","0","0","0","3","0","3","0","0","0","4","2","2","1","0","1","-2"
"123554","Saint Mary's College of California","2016","On-tenure track, assistant professors","45","16","29","0","0","0","4","0","4","4","1","3","9","2","7","0","0","0","13","7","6","0","0","0","11","5","6","4","1","3","-2"
"123554","Saint Mary's College of California","2016","Not on tenure track/No tenure system system total","26","13","13","0","0","0","3","1","2","0","0","0","1","1","0","0","0","0","16","8","8","0","0","0","4","2","2","2","1","1","-2"
"123554","Saint Mary's College of California","2016","Not on tenure/no tenure system, associate professors","14","7","7","0","0","0","1","0","1","0","0","0","0","0","0","0","0","0","8","4","4","0","0","0","4","2","2","1","1","0","-2"
"123554","Saint Mary's College of California","2016","Not on tenure/no tenure system, assistant professors","12","6","6","0","0","0","2","1","1","0","0","0","1","1","0","0","0","0","8","4","4","0","0","0","0","0","0","1","0","1","-2"
"123563","Solano Community College","2016","Tenured total","97","44","53","0","0","0","5","3","2","7","3","4","10","3","7","0","0","0","75","35","40","0","0","0","0","0","0","0","0","0","-2"
"123563","Solano Community College","2016","Tenured, instructors","97","44","53","0","0","0","5","3","2","7","3","4","10","3","7","0","0","0","75","35","40","0","0","0","0","0","0","0","0","0","-2"
"123563","Solano Community College","2016","On-Tenure track total","38","12","26","0","0","0","2","0","2","7","3","4","3","2","1","0","0","0","26","7","19","0","0","0","0","0","0","0","0","0","-2"
"123563","Solano Community College","2016","On-tenure track, instructors","38","12","26","0","0","0","2","0","2","7","3","4","3","2","1","0","0","0","26","7","19","0","0","0","0","0","0","0","0","0","-2"
"123563","Solano Community College","2016","Not on tenure track/No tenure system system total","3","0","3","0","0","0","0","0","0","0","0","0","0","0","0","0","0","0","3","0","3","0","0","0","0","0","0","0","0","0","-2"
"123563","Solano Community College","2016","Not on tenure/no tenure system, instructors","3","0","3","0","0","0","0","0","0","0","0","0","0","0","0","0","0","0","3","0","3","0","0","0","0","0","0","0","0","0","-2"
"123572","Sonoma State University","2016","Tenured total","173","94","79","0","0","0","14","12","2","3","0","3","13","7","6","0","0","0","135","70","65","2","2","0","6","3","3","0","0","0","-2"
"123572","Sonoma State University","2016","Tenured, professors","127","66","61","0","0","0","9","8","1","2","0","2","9","4","5","0","0","0","102","51","51","1","1","0","4","2","2","0","0","0","-2"
"123572","Sonoma State University","2016","Tenured, associate professors","45","27","18","0","0","0","4","3","1","1","0","1","4","3","1","0","0","0","33","19","14","1","1","0","2","1","1","0","0","0","-2"
"123572","Sonoma State University","2016","Tenured, assistant professors","1","1","0","0","0","0","1","1","0","0","0","0","0","0","0","0","0","0","0","0","0","0","0","0","0","0","0","0","0","0","-2"
"123572","Sonoma State University","2016","On-Tenure track total","49","23","26","1","0","1","3","1","2","0","0","0","4","2","2","0","0","0","28","13","15","1","0","1","9","4","5","3","3","0","-2"
"123572","Sonoma State University","2016","On-tenure track, associate professors","2","2","0","0","0","0","0","0","0","0","0","0","0","0","0","0","0","0","1","1","0","0","0","0","0","0","0","1","1","0","-2"
"123572","Sonoma State University","2016","On-tenure track, assistant professors","47","21","26","1","0","1","3","1","2","0","0","0","4","2","2","0","0","0","27","12","15","1","0","1","9","4","5","2","2","0","-2"
"123572","Sonoma State University","2016","Not on tenure track/No tenure system system total","36","13","23","0","0","0","3","2","1","1","0","1","2","1","1","0","0","0","24","8","16","1","0","1","5","2","3","0","0","0","-2"
"123572","Sonoma State University","2016","Not on tenure/no tenure system, lecturers","36","13","23","0","0","0","3","2","1","1","0","1","2","1","1","0","0","0","24","8","16","1","0","1","5","2","3","0","0","0","-2"
"123651","Vanguard University of Southern California","2016","Tenured total","49","26","23","0","0","0","3","2","1","1","1","0","0","0","0","0","0","0","40","21","19","5","2","3","0","0","0","0","0","0","-2"
"123651","Vanguard University of Southern California","2016","Tenured, professors","34","21","13","0","0","0","0","0","0","0","0","0","0","0","0","0","0","0","30","19","11","4","2","2","0","0","0","0","0","0","-2"
"123651","Vanguard University of Southern California","2016","Tenured, associate professors","13","4","9","0","0","0","2","1","1","1","1","0","0","0","0","0","0","0","9","2","7","1","0","1","0","0","0","0","0","0","-2"
"123651","Vanguard University of Southern California","2016","Tenured, assistant professors","2","1","1","0","0","0","1","1","0","0","0","0","0","0","0","0","0","0","1","0","1","0","0","0","0","0","0","0","0","0","-2"
"123651","Vanguard University of Southern California","2016","On-Tenure track total","21","8","13","0","0","0","6","2","4","1","1","0","2","0","2","0","0","0","10","4","6","2","1","1","0","0","0","0","0","0","-2"
"123651","Vanguard University of Southern California","2016","On-tenure track, professors","1","1","0","0","0","0","0","0","0","0","0","0","0","0","0","0","0","0","0","0","0","1","1","0","0","0","0","0","0","0","-2"
"123651","Vanguard University of Southern California","2016","On-tenure track, associate professors","5","1","4","0","0","0","1","1","0","0","0","0","1","0","1","0","0","0","3","0","3","0","0","0","0","0","0","0","0","0","-2"
"123651","Vanguard University of Southern California","2016","On-tenure track, assistant professors","15","6","9","0","0","0","5","1","4","1","1","0","1","0","1","0","0","0","7","4","3","1","0","1","0","0","0","0","0","0","-2"
"123651","Vanguard University of Southern California","2016","Not on tenure track/No tenure system system total","10","3","7","0","0","0","0","0","0","0","0","0","0","0","0","0","0","0","9","2","7","1","1","0","0","0","0","0","0","0","-2"
"123651","Vanguard University of Southern California","2016","Not on tenure/no tenure system, professors","1","1","0","0","0","0","0","0","0","0","0","0","0","0","0","0","0","0","1","1","0","0","0","0","0","0","0","0","0","0","-2"
"123651","Vanguard University of Southern California","2016","Not on tenure/no tenure system, associate professors","1","1","0","0","0","0","0","0","0","0","0","0","0","0","0","0","0","0","0","0","0","1","1","0","0","0","0","0","0","0","-2"
"123651","Vanguard University of Southern California","2016","Not on tenure/no tenure system, assistant professors","7","1","6","0","0","0","0","0","0","0","0","0","0","0","0","0","0","0","7","1","6","0","0","0","0","0","0","0","0","0","-2"
"123651","Vanguard University of Southern California","2016","Not on tenure/no tenure system, instructors","1","0","1","0","0","0","0","0","0","0","0","0","0","0","0","0","0","0","1","0","1","0","0","0","0","0","0","0","0","0","-2"
"125471","West Los Angeles College","2016","Tenured total","84","36","48","0","0","0","14","6","8","13","5","8","11","4","7","0","0","0","37","17","20","0","0","0","9","4","5","0","0","0","-2"
"125471","West Los Angeles College","2016","Tenured, instructors","84","36","48","0","0","0","14","6","8","13","5","8","11","4","7","0","0","0","37","17","20","0","0","0","9","4","5","0","0","0","-2"
"125471","West Los Angeles College","2016","On-Tenure track total","41","16","25","0","0","0","2","1","1","1","1","0","4","2","2","1","0","1","6","3","3","0","0","0","26","9","17","1","0","1","-2"
"125471","West Los Angeles College","2016","On-tenure track, instructors","41","16","25","0","0","0","2","1","1","1","1","0","4","2","2","1","0","1","6","3","3","0","0","0","26","9","17","1","0","1","-2"
"125471","West Los Angeles College","2016","Not on tenure track/No tenure system system total","10","4","6","0","0","0","0","0","0","2","1","1","0","0","0","0","0","0","1","0","1","1","1","0","6","2","4","0","0","0","-2"
"125471","West Los Angeles College","2016","Not on tenure/no tenure system, instructors","10","4","6","0","0","0","0","0","0","2","1","1","0","0","0","0","0","0","1","0","1","1","1","0","6","2","4","0","0","0","-2"
"125763","Whittier College","2016","Tenured total","97","58","39","0","0","0","5","3","2","3","1","2","12","8","4","0","0","0","68","39","29","3","2","1","0","0","0","6","5","1","-2"
"125763","Whittier College","2016","Tenured, professors","45","29","16","0","0","0","2","2","0","1","0","1","1","1","0","0","0","0","37","24","13","1","0","1","0","0","0","3","2","1","-2"
"125763","Whittier College","2016","Tenured, associate professors","40","19","21","0","0","0","2","0","2","1","0","1","11","7","4","0","0","0","25","11","14","0","0","0","0","0","0","1","1","0","-2"
"125763","Whittier College","2016","Tenured, assistant professors","12","10","2","0","0","0","1","1","0","1","1","0","0","0","0","0","0","0","6","4","2","2","2","0","0","0","0","2","2","0","-2"
"125763","Whittier College","2016","On-Tenure track total","8","0","8","0","0","0","1","0","1","0","0","0","2","0","2","0","0","0","4","0","4","0","0","0","0","0","0","1","0","1","-2"
"125763","Whittier College","2016","On-tenure track, assistant professors","8","0","8","0","0","0","1","0","1","0","0","0","2","0","2","0","0","0","4","0","4","0","0","0","0","0","0","1","0","1","-2"
"125763","Whittier College","2016","Not on tenure track/No tenure system system total","41","15","26","0","0","0","4","0","4","1","0","1","8","1","7","0","0","0","26","13","13","2","1","1","0","0","0","0","0","0","-2"
"125763","Whittier College","2016","Not on tenure/no tenure system, professors","6","0","6","0","0","0","1","0","1","0","0","0","0","0","0","0","0","0","5","0","5","0","0","0","0","0","0","0","0","0","-2"
"125763","Whittier College","2016","Not on tenure/no tenure system, associate professors","3","2","1","0","0","0","0","0","0","0","0","0","0","0","0","0","0","0","3","2","1","0","0","0","0","0","0","0","0","0","-2"
"125763","Whittier College","2016","Not on tenure/no tenure system, assistant professors","21","10","11","0","0","0","3","0","3","0","0","0","4","1","3","0","0","0","12","8","4","2","1","1","0","0","0","0","0","0","-2"
"125763","Whittier College","2016","Not on tenure/no tenure system, instructors","7","2","5","0","0","0","0","0","0","1","0","1","1","0","1","0","0","0","5","2","3","0","0","0","0","0","0","0","0","0","-2"
"125763","Whittier College","2016","Not on tenure/no tenure system, lecturers","4","1","3","0","0","0","0","0","0","0","0","0","3","0","3","0","0","0","1","1","0","0","0","0","0","0","0","0","0","0","-2"
"125897","Woodbury University","2016","Not on tenure track/No tenure system system total","87","52","35","0","0","0","9","6","3","3","1","2","3","3","0","0","0","0","68","39","29","0","0","0","4","3","1","0","0","0","-2"
"125897","Woodbury University","2016","Not on tenure/no tenure system, professors","23","14","9","0","0","0","3","2","1","1","0","1","0","0","0","0","0","0","18","11","7","0","0","0","1","1","0","0","0","0","-2"
"125897","Woodbury University","2016","Not on tenure/no tenure system, associate professors","29","16","13","0","0","0","1","1","0","0","0","0","2","2","0","0","0","0","25","13","12","0","0","0","1","0","1","0","0","0","-2"
"125897","Woodbury University","2016","Not on tenure/no tenure system, assistant professors","24","16","8","0","0","0","4","2","2","1","1","0","1","1","0","0","0","0","16","10","6","0","0","0","2","2","0","0","0","0","-2"
"125897","Woodbury University","2016","Not on tenure/no tenure system, instructors","9","4","5","0","0","0","1","1","0","1","0","1","0","0","0","0","0","0","7","3","4","0","0","0","0","0","0","0","0","0","-2"
"125897","Woodbury University","2016","Not on tenure/no tenure system, lecturers","2","2","0","0","0","0","0","0","0","0","0","0","0","0","0","0","0","0","2","2","0","0","0","0","0","0","0","0","0","0","-2"
"126182","Adams State University","2016","Tenured total","58","35","23","0","0","0","0","0","0","0","0","0","10","6","4","0","0","0","45","27","18","0","0","0","3","2","1","0","0","0","-2"
"126182","Adams State University","2016","Tenured, professors","38","26","12","0","0","0","0","0","0","0","0","0","5","4","1","0","0","0","32","21","11","0","0","0","1","1","0","0","0","0","-2"
"126182","Adams State University","2016","Tenured, associate professors","13","5","8","0","0","0","0","0","0","0","0","0","3","1","2","0","0","0","9","3","6","0","0","0","1","1","0","0","0","0","-2"
"126182","Adams State University","2016","Tenured, assistant professors","7","4","3","0","0","0","0","0","0","0","0","0","2","1","1","0","0","0","4","3","1","0","0","0","1","0","1","0","0","0","-2"
"126182","Adams State University","2016","On-Tenure track total","27","18","9","0","0","0","0","0","0","0","0","0","4","2","2","0","0","0","19","13","6","1","1","0","3","2","1","0","0","0","-2"
"126182","Adams State University","2016","On-tenure track, professors","1","0","1","0","0","0","0","0","0","0","0","0","0","0","0","0","0","0","1","0","1","0","0","0","0","0","0","0","0","0","-2"
"126182","Adams State University","2016","On-tenure track, assistant professors","26","18","8","0","0","0","0","0","0","0","0","0","4","2","2","0","0","0","18","13","5","1","1","0","3","2","1","0","0","0","-2"
"126182","Adams State University","2016","Not on tenure track/No tenure system system total","23","8","15","0","0","0","0","0","0","0","0","0","5","2","3","0","0","0","18","6","12","0","0","0","0","0","0","0","0","0","-2"
"126182","Adams State University","2016","Not on tenure/no tenure system, no academic rank","23","8","15","0","0","0","0","0","0","0","0","0","5","2","3","0","0","0","18","6","12","0","0","0","0","0","0","0","0","0","-2"
"126562","University of Colorado Denver/Anschutz Medical Campus","2016","Tenured total","591","413","178","4","2","2","54","37","17","7","4","3","33","25","8","0","0","0","477","336","141","1","0","1","15","9","6","0","0","0","-2"
"126562","University of Colorado Denver/Anschutz Medical Campus","2016","Tenured, professors","384","286","98","1","0","1","31","22","9","3","3","0","16","12","4","0","0","0","327","246","81","0","0","0","6","3","3","0","0","0","-2"
"126562","University of Colorado Denver/Anschutz Medical Campus","2016","Tenured, associate professors","207","127","80","3","2","1","23","15","8","4","1","3","17","13","4","0","0","0","150","90","60","1","0","1","9","6","3","0","0","0","-2"
"126562","University of Colorado Denver/Anschutz Medical Campus","2016","On-Tenure track total","1739","852","887","5","3","2","149","73","76","22","8","14","76","39","37","4","1","3","1209","596","613","9","4","5","247","118","129","18","10","8","-2"
"126562","University of Colorado Denver/Anschutz Medical Campus","2016","On-tenure track, professors","204","135","69","1","1","0","16","11","5","0","0","0","6","5","1","0","0","0","158","103","55","3","0","3","20","15","5","0","0","0","-2"
"126562","University of Colorado Denver/Anschutz Medical Campus","2016","On-tenure track, associate professors","568","298","270","4","2","2","50","30","20","5","3","2","25","13","12","1","0","1","416","212","204","3","2","1","62","34","28","2","2","0","-2"
"126562","University of Colorado Denver/Anschutz Medical Campus","2016","On-tenure track, assistant professors","967","419","548","0","0","0","83","32","51","17","5","12","45","21","24","3","1","2","635","281","354","3","2","1","165","69","96","16","8","8","-2"
"126562","University of Colorado Denver/Anschutz Medical Campus","2016","Not on tenure track/No tenure system system total","1505","450","1055","8","2","6","70","32","38","10","4","6","68","27","41","1","0","1","1060","306","754","9","4","5","261","65","196","18","10","8","-2"
"126562","University of Colorado Denver/Anschutz Medical Campus","2016","Not on tenure/no tenure system, professors","13","5","8","0","0","0","0","0","0","0","0","0","0","0","0","0","0","0","13","5","8","0","0","0","0","0","0","0","0","0","-2"
"126562","University of Colorado Denver/Anschutz Medical Campus","2016","Not on tenure/no tenure system, associate professors","52","30","22","1","1","0","3","1","2","0","0","0","3","2","1","0","0","0","42","23","19","0","0","0","3","3","0","0","0","0","-2"
"126562","University of Colorado Denver/Anschutz Medical Campus","2016","Not on tenure/no tenure system, assistant professors","94","38","56","0","0","0","10","4","6","1","1","0","7","5","2","0","0","0","61","21","40","1","1","0","10","4","6","4","2","2","-2"
"126562","University of Colorado Denver/Anschutz Medical Campus","2016","Not on tenure/no tenure system, instructors","1345","376","969","7","1","6","57","27","30","9","3","6","58","20","38","1","0","1","943","256","687","8","3","5","248","58","190","14","8","6","-2"
"126562","University of Colorado Denver/Anschutz Medical Campus","2016","Not on tenure/no tenure system, lecturers","1","1","0","0","0","0","0","0","0","0","0","0","0","0","0","0","0","0","1","1","0","0","0","0","0","0","0","0","0","0","-2"
"126711","Colorado Mountain College","2016","Not on tenure track/No tenure system system total","115","60","55","1","1","0","2","1","1","0","0","0","6","2","4","0","0","0","101","53","48","1","1","0","4","2","2","0","0","0","-2"
"126711","Colorado Mountain College","2016","Not on tenure/no tenure system, professors","43","20","23","0","0","0","1","1","0","0","0","0","2","1","1","0","0","0","40","18","22","0","0","0","0","0","0","0","0","0","-2"
"126711","Colorado Mountain College","2016","Not on tenure/no tenure system, associate professors","50","27","23","1","1","0","0","0","0","0","0","0","2","1","1","0","0","0","43","23","20","0","0","0","4","2","2","0","0","0","-2"
"126711","Colorado Mountain College","2016","Not on tenure/no tenure system, assistant professors","19","10","9","0","0","0","1","0","1","0","0","0","2","0","2","0","0","0","15","9","6","1","1","0","0","0","0","0","0","0","-2"
"126711","Colorado Mountain College","2016","Not on tenure/no tenure system, instructors","3","3","0","0","0","0","0","0","0","0","0","0","0","0","0","0","0","0","3","3","0","0","0","0","0","0","0","0","0","0","-2"
"126942","Community College of Denver","2016","Not on tenure track/No tenure system system total","104","49","55","0","0","0","5","2","3","6","3","3","4","1","3","0","0","0","87","43","44","1","0","1","1","0","1","0","0","0","-2"
"126942","Community College of Denver","2016","Not on tenure/no tenure system, professors","34","15","19","0","0","0","4","2","2","3","1","2","2","0","2","0","0","0","25","12","13","0","0","0","0","0","0","0","0","0","-2"
"126942","Community College of Denver","2016","Not on tenure/no tenure system, associate professors","32","15","17","0","0","0","1","0","1","0","0","0","0","0","0","0","0","0","30","15","15","0","0","0","1","0","1","0","0","0","-2"
"126942","Community College of Denver","2016","Not on tenure/no tenure system, assistant professors","16","6","10","0","0","0","0","0","0","1","1","0","0","0","0","0","0","0","14","5","9","1","0","1","0","0","0","0","0","0","-2"
"126942","Community College of Denver","2016","Not on tenure/no tenure system, instructors","22","13","9","0","0","0","0","0","0","2","1","1","2","1","1","0","0","0","18","11","7","0","0","0","0","0","0","0","0","0","-2"
"127617","Morgan Community College","2016","Not on tenure track/No tenure system system total","31","10","21","0","0","0","0","0","0","0","0","0","0","0","0","0","0","0","31","10","21","0","0","0","0","0","0","0","0","0","-2"
"127617","Morgan Community College","2016","Not on tenure/no tenure system, no academic rank","31","10","21","0","0","0","0","0","0","0","0","0","0","0","0","0","0","0","31","10","21","0","0","0","0","0","0","0","0","0","-2"
"127884","Pueblo Community College","2016","Not on tenure track/No tenure system system total","98","44","54","0","0","0","0","0","0","0","0","0","17","9","8","0","0","0","81","35","46","0","0","0","0","0","0","0","0","0","-2"
"127884","Pueblo Community College","2016","Not on tenure/no tenure system, no academic rank","98","44","54","0","0","0","0","0","0","0","0","0","17","9","8","0","0","0","81","35","46","0","0","0","0","0","0","0","0","0","-2"
"128106","Colorado State University Pueblo","2016","Tenured total","95","57","38","0","0","0","7","4","3","4","3","1","14","6","8","0","0","0","63","41","22","1","0","1","6","3","3","0","0","0","-2"
"128106","Colorado State University Pueblo","2016","Tenured, professors","44","29","15","0","0","0","4","2","2","3","3","0","7","4","3","0","0","0","28","18","10","0","0","0","2","2","0","0","0","0","-2"
"128106","Colorado State University Pueblo","2016","Tenured, associate professors","45","25","20","0","0","0","3","2","1","0","0","0","7","2","5","0","0","0","30","20","10","1","0","1","4","1","3","0","0","0","-2"
"128106","Colorado State University Pueblo","2016","Tenured, assistant professors","6","3","3","0","0","0","0","0","0","1","0","1","0","0","0","0","0","0","5","3","2","0","0","0","0","0","0","0","0","0","-2"
"128106","Colorado State University Pueblo","2016","On-Tenure track total","26","11","15","0","0","0","1","0","1","0","0","0","4","2","2","0","0","0","14","5","9","0","0","0","4","2","2","3","2","1","-2"
"128106","Colorado State University Pueblo","2016","On-tenure track, assistant professors","26","11","15","0","0","0","1","0","1","0","0","0","4","2","2","0","0","0","14","5","9","0","0","0","4","2","2","3","2","1","-2"
"128106","Colorado State University Pueblo","2016","Not on tenure track/No tenure system system total","54","25","29","0","0","0","2","1","1","1","0","1","6","3","3","0","0","0","39","16","23","0","0","0","5","4","1","1","1","0","-2"
"128106","Colorado State University Pueblo","2016","Not on tenure/no tenure system, assistant professors","20","9","11","0","0","0","1","0","1","0","0","0","1","0","1","0","0","0","14","5","9","0","0","0","3","3","0","1","1","0","-2"
"128106","Colorado State University Pueblo","2016","Not on tenure/no tenure system, instructors","1","0","1","0","0","0","0","0","0","0","0","0","0","0","0","0","0","0","1","0","1","0","0","0","0","0","0","0","0","0","-2"
"128106","Colorado State University Pueblo","2016","Not on tenure/no tenure system, lecturers","29","12","17","0","0","0","0","0","0","1","0","1","5","3","2","0","0","0","21","8","13","0","0","0","2","1","1","0","0","0","-2"
"128106","Colorado State University Pueblo","2016","Not on tenure/no tenure system, no academic rank","4","4","0","0","0","0","1","1","0","0","0","0","0","0","0","0","0","0","3","3","0","0","0","0","0","0","0","0","0","0","-2"
"128744","University of Bridgeport","2016","Tenured total","55","37","18","0","0","0","13","10","3","2","2","0","1","0","1","0","0","0","39","25","14","0","0","0","0","0","0","0","0","0","-2"
"128744","University of Bridgeport","2016","Tenured, professors","19","14","5","0","0","0","7","5","2","0","0","0","0","0","0","0","0","0","12","9","3","0","0","0","0","0","0","0","0","0","-2"
"128744","University of Bridgeport","2016","Tenured, associate professors","35","23","12","0","0","0","6","5","1","2","2","0","1","0","1","0","0","0","26","16","10","0","0","0","0","0","0","0","0","0","-2"
"128744","University of Bridgeport","2016","Tenured, assistant professors","1","0","1","0","0","0","0","0","0","0","0","0","0","0","0","0","0","0","1","0","1","0","0","0","0","0","0","0","0","0","-2"
"128744","University of Bridgeport","2016","On-Tenure track total","38","14","24","0","0","0","3","1","2","2","1","1","0","0","0","0","0","0","33","12","21","0","0","0","0","0","0","0","0","0","-2"
"128744","University of Bridgeport","2016","On-tenure track, associate professors","12","7","5","0","0","0","1","1","0","0","0","0","0","0","0","0","0","0","11","6","5","0","0","0","0","0","0","0","0","0","-2"
"128744","University of Bridgeport","2016","On-tenure track, assistant professors","24","6","18","0","0","0","2","0","2","2","1","1","0","0","0","0","0","0","20","5","15","0","0","0","0","0","0","0","0","0","-2"
"128744","University of Bridgeport","2016","On-tenure track, lecturers","2","1","1","0","0","0","0","0","0","0","0","0","0","0","0","0","0","0","2","1","1","0","0","0","0","0","0","0","0","0","-2"
"128744","University of Bridgeport","2016","Not on tenure track/No tenure system system total","37","19","18","0","0","0","5","3","2","1","1","0","1","1","0","0","0","0","30","14","16","0","0","0","0","0","0","0","0","0","-2"
"128744","University of Bridgeport","2016","Not on tenure/no tenure system, associate professors","3","2","1","0","0","0","0","0","0","0","0","0","0","0","0","0","0","0","3","2","1","0","0","0","0","0","0","0","0","0","-2"
"128744","University of Bridgeport","2016","Not on tenure/no tenure system, assistant professors","14","8","6","0","0","0","3","2","1","1","1","0","1","1","0","0","0","0","9","4","5","0","0","0","0","0","0","0","0","0","-2"
"128744","University of Bridgeport","2016","Not on tenure/no tenure system, lecturers","20","9","11","0","0","0","2","1","1","0","0","0","0","0","0","0","0","0","18","8","10","0","0","0","0","0","0","0","0","0","-2"
"131876","Trinity Washington University","2016","Tenured total","27","7","20","0","0","0","3","2","1","5","2","3","2","1","1","0","0","0","17","2","15","0","0","0","0","0","0","0","0","0","-2"
"131876","Trinity Washington University","2016","Tenured, professors","4","0","4","0","0","0","0","0","0","0","0","0","0","0","0","0","0","0","4","0","4","0","0","0","0","0","0","0","0","0","-2"
"131876","Trinity Washington University","2016","Tenured, associate professors","23","7","16","0","0","0","3","2","1","5","2","3","2","1","1","0","0","0","13","2","11","0","0","0","0","0","0","0","0","0","-2"
"131876","Trinity Washington University","2016","On-Tenure track total","11","2","9","0","0","0","2","0","2","5","0","5","0","0","0","0","0","0","4","2","2","0","0","0","0","0","0","0","0","0","-2"
"131876","Trinity Washington University","2016","On-tenure track, associate professors","1","0","1","0","0","0","1","0","1","0","0","0","0","0","0","0","0","0","0","0","0","0","0","0","0","0","0","0","0","0","-2"
"131876","Trinity Washington University","2016","On-tenure track, assistant professors","10","2","8","0","0","0","1","0","1","5","0","5","0","0","0","0","0","0","4","2","2","0","0","0","0","0","0","0","0","0","-2"
"131876","Trinity Washington University","2016","Not on tenure track/No tenure system system total","20","6","14","0","0","0","1","0","1","9","2","7","1","1","0","0","0","0","9","3","6","0","0","0","0","0","0","0","0","0","-2"
"131876","Trinity Washington University","2016","Not on tenure/no tenure system, assistant professors","20","6","14","0","0","0","1","0","1","9","2","7","1","1","0","0","0","0","9","3","6","0","0","0","0","0","0","0","0","0","-2"
"132471","Barry University","2016","Tenured total","21","11","10","1","0","1","2","0","2","2","2","0","1","1","0","0","0","0","14","7","7","0","0","0","1","1","0","0","0","0","-2"
"132471","Barry University","2016","Tenured, professors","11","6","5","0","0","0","0","0","0","2","2","0","0","0","0","0","0","0","9","4","5","0","0","0","0","0","0","0","0","0","-2"
"132471","Barry University","2016","Tenured, associate professors","9","4","5","1","0","1","2","0","2","0","0","0","1","1","0","0","0","0","5","3","2","0","0","0","0","0","0","0","0","0","-2"
"132471","Barry University","2016","Tenured, assistant professors","1","1","0","0","0","0","0","0","0","0","0","0","0","0","0","0","0","0","0","0","0","0","0","0","1","1","0","0","0","0","-2"
"132471","Barry University","2016","On-Tenure track total","10","4","6","1","0","1","1","0","1","1","1","0","0","0","0","0","0","0","5","2","3","0","0","0","2","1","1","0","0","0","-2"
"132471","Barry University","2016","On-tenure track, associate professors","2","0","2","1","0","1","0","0","0","0","0","0","0","0","0","0","0","0","1","0","1","0","0","0","0","0","0","0","0","0","-2"
"132471","Barry University","2016","On-tenure track, assistant professors","8","4","4","0","0","0","1","0","1","1","1","0","0","0","0","0","0","0","4","2","2","0","0","0","2","1","1","0","0","0","-2"
"132471","Barry University","2016","Not on tenure track/No tenure system system total","315","138","177","1","0","1","20","10","10","29","4","25","50","26","24","0","0","0","181","85","96","2","1","1","24","11","13","8","1","7","-2"
"132471","Barry University","2016","Not on tenure/no tenure system, professors","69","42","27","0","0","0","6","5","1","4","0","4","7","4","3","0","0","0","49","30","19","1","1","0","2","2","0","0","0","0","-2"
"132471","Barry University","2016","Not on tenure/no tenure system, associate professors","101","41","60","1","0","1","5","2","3","6","1","5","16","4","12","0","0","0","64","29","35","0","0","0","8","4","4","1","1","0","-2"
"132471","Barry University","2016","Not on tenure/no tenure system, assistant professors","111","41","70","0","0","0","7","3","4","18","3","15","15","11","4","0","0","0","52","19","33","1","0","1","11","5","6","7","0","7","-2"
"132471","Barry University","2016","Not on tenure/no tenure system, instructors","34","14","20","0","0","0","2","0","2","1","0","1","12","7","5","0","0","0","16","7","9","0","0","0","3","0","3","0","0","0","-2"
"132709","Broward College","2016","Tenured total","321","149","172","5","0","5","17","13","4","55","18","37","62","32","30","0","0","0","174","81","93","0","0","0","8","5","3","0","0","0","-2"
"132709","Broward College","2016","Tenured, professors","61","35","26","2","0","2","5","3","2","5","2","3","10","6","4","0","0","0","38","23","15","0","0","0","1","1","0","0","0","0","-2"
"132709","Broward College","2016","Tenured, associate professors","25","9","16","1","0","1","1","1","0","5","1","4","4","2","2","0","0","0","13","5","8","0","0","0","1","0","1","0","0","0","-2"
"132709","Broward College","2016","Tenured, assistant professors","213","96","117","2","0","2","11","9","2","43","15","28","45","22","23","0","0","0","106","46","60","0","0","0","6","4","2","0","0","0","-2"
"132709","Broward College","2016","Tenured, instructors","22","9","13","0","0","0","0","0","0","2","0","2","3","2","1","0","0","0","17","7","10","0","0","0","0","0","0","0","0","0","-2"
"132709","Broward College","2016","On-Tenure track total","69","33","36","1","0","1","3","0","3","12","3","9","11","4","7","0","0","0","31","19","12","0","0","0","11","7","4","0","0","0","-2"
"132709","Broward College","2016","On-tenure track, assistant professors","62","30","32","1","0","1","3","0","3","12","3","9","8","3","5","0","0","0","27","17","10","0","0","0","11","7","4","0","0","0","-2"
"132709","Broward College","2016","On-tenure track, instructors","7","3","4","0","0","0","0","0","0","0","0","0","3","1","2","0","0","0","4","2","2","0","0","0","0","0","0","0","0","0","-2"
"132903","University of Central Florida","2016","Tenured total","579","406","173","3","3","0","103","85","18","27","16","11","35","24","11","0","0","0","405","274","131","1","0","1","0","0","0","5","4","1","-2"
"132903","University of Central Florida","2016","Tenured, professors","249","189","60","1","1","0","50","43","7","5","2","3","15","13","2","0","0","0","174","127","47","1","0","1","0","0","0","3","3","0","-2"
"132903","University of Central Florida","2016","Tenured, associate professors","327","214","113","2","2","0","53","42","11","22","14","8","20","11","9","0","0","0","228","144","84","0","0","0","0","0","0","2","1","1","-2"
"132903","University of Central Florida","2016","Tenured, assistant professors","3","3","0","0","0","0","0","0","0","0","0","0","0","0","0","0","0","0","3","3","0","0","0","0","0","0","0","0","0","0","-2"
"132903","University of Central Florida","2016","On-Tenure track total","285","154","131","0","0","0","41","24","17","12","4","8","19","11","8","0","0","0","165","81","84","3","1","2","0","0","0","45","33","12","-2"
"132903","University of Central Florida","2016","On-tenure track, associate professors","11","8","3","0","0","0","1","1","0","0","0","0","0","0","0","0","0","0","8","6","2","0","0","0","0","0","0","2","1","1","-2"
"132903","University of Central Florida","2016","On-tenure track, assistant professors","274","146","128","0","0","0","40","23","17","12","4","8","19","11","8","0","0","0","157","75","82","3","1","2","0","0","0","43","32","11","-2"
"132903","University of Central Florida","2016","Not on tenure track/No tenure system system total","521","221","300","1","1","0","21","9","12","16","3","13","43","17","26","0","0","0","423","186","237","5","1","4","0","0","0","12","4","8","-2"
"132903","University of Central Florida","2016","Not on tenure/no tenure system, professors","5","3","2","0","0","0","1","1","0","0","0","0","1","0","1","0","0","0","3","2","1","0","0","0","0","0","0","0","0","0","-2"
"132903","University of Central Florida","2016","Not on tenure/no tenure system, associate professors","15","8","7","0","0","0","2","1","1","0","0","0","3","2","1","0","0","0","10","5","5","0","0","0","0","0","0","0","0","0","-2"
"132903","University of Central Florida","2016","Not on tenure/no tenure system, assistant professors","46","20","26","0","0","0","5","1","4","0","0","0","5","3","2","0","0","0","32","15","17","0","0","0","0","0","0","4","1","3","-2"
"132903","University of Central Florida","2016","Not on tenure/no tenure system, instructors","211","80","131","0","0","0","5","2","3","7","1","6","14","4","10","0","0","0","182","73","109","3","0","3","0","0","0","0","0","0","-2"
"132903","University of Central Florida","2016","Not on tenure/no tenure system, lecturers","241","109","132","1","1","0","8","4","4","9","2","7","20","8","12","0","0","0","193","90","103","2","1","1","0","0","0","8","3","5","-2"
"132903","University of Central Florida","2016","Not on tenure/no tenure system, no academic rank","3","1","2","0","0","0","0","0","0","0","0","0","0","0","0","0","0","0","3","1","2","0","0","0","0","0","0","0","0","0","-2"
"133508","Florida SouthWestern State College","2016","Tenured total","118","54","64","1","0","1","2","1","1","5","2","3","3","2","1","0","0","0","102","45","57","0","0","0","1","1","0","4","3","1","-2"
"133508","Florida SouthWestern State College","2016","Tenured, no academic rank","118","54","64","1","0","1","2","1","1","5","2","3","3","2","1","0","0","0","102","45","57","0","0","0","1","1","0","4","3","1","-2"
"133508","Florida SouthWestern State College","2016","On-Tenure track total","54","23","31","1","1","0","2","1","1","3","1","2","3","2","1","0","0","0","44","17","27","0","0","0","0","0","0","1","1","0","-2"
"133508","Florida SouthWestern State College","2016","On-tenure track, no academic rank","54","23","31","1","1","0","2","1","1","3","1","2","3","2","1","0","0","0","44","17","27","0","0","0","0","0","0","1","1","0","-2"
"133508","Florida SouthWestern State College","2016","Not on tenure track/No tenure system system total","1","1","0","0","0","0","0","0","0","0","0","0","0","0","0","0","0","0","1","1","0","0","0","0","0","0","0","0","0","0","-2"
"133508","Florida SouthWestern State College","2016","Not on tenure/no tenure system, no academic rank","1","1","0","0","0","0","0","0","0","0","0","0","0","0","0","0","0","0","1","1","0","0","0","0","0","0","0","0","0","0","-2"
"133669","Florida Atlantic University","2016","Tenured total","431","279","152","0","0","0","76","61","15","25","9","16","24","13","11","1","1","0","299","191","108","1","0","1","0","0","0","5","4","1","-2"
"133669","Florida Atlantic University","2016","Tenured, professors","215","158","57","0","0","0","42","38","4","10","5","5","7","4","3","1","1","0","153","108","45","0","0","0","0","0","0","2","2","0","-2"
"133669","Florida Atlantic University","2016","Tenured, associate professors","216","121","95","0","0","0","34","23","11","15","4","11","17","9","8","0","0","0","146","83","63","1","0","1","0","0","0","3","2","1","-2"
"133669","Florida Atlantic University","2016","On-Tenure track total","136","63","73","0","0","0","12","9","3","3","0","3","8","4","4","0","0","0","86","30","56","2","1","1","0","0","0","25","19","6","-2"
"133669","Florida Atlantic University","2016","On-tenure track, associate professors","12","3","9","0","0","0","1","0","1","1","0","1","0","0","0","0","0","0","9","3","6","1","0","1","0","0","0","0","0","0","-2"
"133669","Florida Atlantic University","2016","On-tenure track, assistant professors","124","60","64","0","0","0","11","9","2","2","0","2","8","4","4","0","0","0","77","27","50","1","1","0","0","0","0","25","19","6","-2"
"133669","Florida Atlantic University","2016","Not on tenure track/No tenure system system total","238","103","135","0","0","0","13","4","9","26","11","15","28","8","20","0","0","0","157","72","85","1","1","0","0","0","0","13","7","6","-2"
"133669","Florida Atlantic University","2016","Not on tenure/no tenure system, professors","1","1","0","0","0","0","1","1","0","0","0","0","0","0","0","0","0","0","0","0","0","0","0","0","0","0","0","0","0","0","-2"
"133669","Florida Atlantic University","2016","Not on tenure/no tenure system, associate professors","15","12","3","0","0","0","0","0","0","0","0","0","2","2","0","0","0","0","11","9","2","0","0","0","0","0","0","2","1","1","-2"
"133669","Florida Atlantic University","2016","Not on tenure/no tenure system, assistant professors","21","8","13","0","0","0","3","1","2","2","0","2","1","1","0","0","0","0","11","5","6","0","0","0","0","0","0","4","1","3","-2"
"133669","Florida Atlantic University","2016","Not on tenure/no tenure system, instructors","196","81","115","0","0","0","8","1","7","24","11","13","24","5","19","0","0","0","132","58","74","1","1","0","0","0","0","7","5","2","-2"
"133669","Florida Atlantic University","2016","Not on tenure/no tenure system, lecturers","3","0","3","0","0","0","0","0","0","0","0","0","0","0","0","0","0","0","3","0","3","0","0","0","0","0","0","0","0","0","-2"
"133669","Florida Atlantic University","2016","Not on tenure/no tenure system, no academic rank","2","1","1","0","0","0","1","1","0","0","0","0","1","0","1","0","0","0","0","0","0","0","0","0","0","0","0","0","0","0","-2"
"133872","AdventHealth University","2016","Not on tenure track/No tenure system system total","84","23","61","0","0","0","5","0","5","14","3","11","10","5","5","0","0","0","55","15","40","0","0","0","0","0","0","0","0","0","-2"
"133872","AdventHealth University","2016","Not on tenure/no tenure system, professors","14","6","8","0","0","0","0","0","0","3","0","3","2","2","0","0","0","0","9","4","5","0","0","0","0","0","0","0","0","0","-2"
"133872","AdventHealth University","2016","Not on tenure/no tenure system, associate professors","17","4","13","0","0","0","0","0","0","3","1","2","2","0","2","0","0","0","12","3","9","0","0","0","0","0","0","0","0","0","-2"
"133872","AdventHealth University","2016","Not on tenure/no tenure system, assistant professors","40","11","29","0","0","0","4","0","4","7","2","5","4","2","2","0","0","0","25","7","18","0","0","0","0","0","0","0","0","0","-2"
"133872","AdventHealth University","2016","Not on tenure/no tenure system, instructors","12","1","11","0","0","0","1","0","1","1","0","1","1","0","1","0","0","0","9","1","8","0","0","0","0","0","0","0","0","0","-2"
"133872","AdventHealth University","2016","Not on tenure/no tenure system, no academic rank","1","1","0","0","0","0","0","0","0","0","0","0","1","1","0","0","0","0","0","0","0","0","0","0","0","0","0","0","0","0","-2"
"133960","The College of the Florida Keys","2016","Tenured total","9","3","6","0","0","0","0","0","0","0","0","0","0","0","0","0","0","0","7","3","4","0","0","0","2","0","2","0","0","0","-2"
"133960","The College of the Florida Keys","2016","Tenured, professors","2","1","1","0","0","0","0","0","0","0","0","0","0","0","0","0","0","0","1","1","0","0","0","0","1","0","1","0","0","0","-2"
"133960","The College of the Florida Keys","2016","Tenured, associate professors","3","1","2","0","0","0","0","0","0","0","0","0","0","0","0","0","0","0","2","1","1","0","0","0","1","0","1","0","0","0","-2"
"133960","The College of the Florida Keys","2016","Tenured, assistant professors","4","1","3","0","0","0","0","0","0","0","0","0","0","0","0","0","0","0","4","1","3","0","0","0","0","0","0","0","0","0","-2"
"133960","The College of the Florida Keys","2016","On-Tenure track total","11","5","6","0","0","0","0","0","0","0","0","0","0","0","0","0","0","0","8","3","5","0","0","0","3","2","1","0","0","0","-2"
"133960","The College of the Florida Keys","2016","On-tenure track, professors","1","0","1","0","0","0","0","0","0","0","0","0","0","0","0","0","0","0","0","0","0","0","0","0","1","0","1","0","0","0","-2"
"133960","The College of the Florida Keys","2016","On-tenure track, associate professors","2","0","2","0","0","0","0","0","0","0","0","0","0","0","0","0","0","0","2","0","2","0","0","0","0","0","0","0","0","0","-2"
"133960","The College of the Florida Keys","2016","On-tenure track, assistant professors","5","3","2","0","0","0","0","0","0","0","0","0","0","0","0","0","0","0","3","1","2","0","0","0","2","2","0","0","0","0","-2"
"133960","The College of the Florida Keys","2016","On-tenure track, instructors","3","2","1","0","0","0","0","0","0","0","0","0","0","0","0","0","0","0","3","2","1","0","0","0","0","0","0","0","0","0","-2"
"133960","The College of the Florida Keys","2016","Not on tenure track/No tenure system system total","6","4","2","0","0","0","0","0","0","0","0","0","1","1","0","0","0","0","4","2","2","0","0","0","0","0","0","1","1","0","-2"
"133960","The College of the Florida Keys","2016","Not on tenure/no tenure system, associate professors","2","2","0","0","0","0","0","0","0","0","0","0","1","1","0","0","0","0","1","1","0","0","0","0","0","0","0","0","0","0","-2"
"133960","The College of the Florida Keys","2016","Not on tenure/no tenure system, assistant professors","2","1","1","0","0","0","0","0","0","0","0","0","0","0","0","0","0","0","1","0","1","0","0","0","0","0","0","1","1","0","-2"
"133960","The College of the Florida Keys","2016","Not on tenure/no tenure system, instructors","2","1","1","0","0","0","0","0","0","0","0","0","0","0","0","0","0","0","2","1","1","0","0","0","0","0","0","0","0","0","-2"
"134608","Indian River State College","2016","Tenured total","154","72","82","2","0","2","6","3","3","16","8","8","7","2","5","1","0","1","122","59","63","0","0","0","0","0","0","0","0","0","-2"
"134608","Indian River State College","2016","Tenured, professors","39","17","22","1","0","1","2","1","1","6","3","3","1","1","0","0","0","0","29","12","17","0","0","0","0","0","0","0","0","0","-2"
"134608","Indian River State College","2016","Tenured, associate professors","48","28","20","0","0","0","4","2","2","6","4","2","3","1","2","1","0","1","34","21","13","0","0","0","0","0","0","0","0","0","-2"
"134608","Indian River State College","2016","Tenured, assistant professors","59","25","34","1","0","1","0","0","0","3","1","2","3","0","3","0","0","0","52","24","28","0","0","0","0","0","0","0","0","0","-2"
"134608","Indian River State College","2016","Tenured, instructors","8","2","6","0","0","0","0","0","0","1","0","1","0","0","0","0","0","0","7","2","5","0","0","0","0","0","0","0","0","0","-2"
"134608","Indian River State College","2016","On-Tenure track total","36","17","19","1","1","0","3","1","2","5","1","4","2","1","1","0","0","0","25","13","12","0","0","0","0","0","0","0","0","0","-2"
"134608","Indian River State College","2016","On-tenure track, associate professors","1","0","1","0","0","0","0","0","0","0","0","0","0","0","0","0","0","0","1","0","1","0","0","0","0","0","0","0","0","0","-2"
"134608","Indian River State College","2016","On-tenure track, assistant professors","28","14","14","1","1","0","2","1","1","5","1","4","2","1","1","0","0","0","18","10","8","0","0","0","0","0","0","0","0","0","-2"
"134608","Indian River State College","2016","On-tenure track, instructors","7","3","4","0","0","0","1","0","1","0","0","0","0","0","0","0","0","0","6","3","3","0","0","0","0","0","0","0","0","0","-2"
"134608","Indian River State College","2016","Not on tenure track/No tenure system system total","53","26","27","0","0","0","1","0","1","5","3","2","3","1","2","0","0","0","44","22","22","0","0","0","0","0","0","0","0","0","-2"
"134608","Indian River State College","2016","Not on tenure/no tenure system, professors","1","0","1","0","0","0","0","0","0","0","0","0","0","0","0","0","0","0","1","0","1","0","0","0","0","0","0","0","0","0","-2"
"134608","Indian River State College","2016","Not on tenure/no tenure system, associate professors","8","1","7","0","0","0","0","0","0","0","0","0","0","0","0","0","0","0","8","1","7","0","0","0","0","0","0","0","0","0","-2"
"134608","Indian River State College","2016","Not on tenure/no tenure system, assistant professors","11","8","3","0","0","0","0","0","0","3","1","2","1","1","0","0","0","0","7","6","1","0","0","0","0","0","0","0","0","0","-2"
"134608","Indian River State College","2016","Not on tenure/no tenure system, instructors","24","11","13","0","0","0","1","0","1","1","1","0","2","0","2","0","0","0","20","10","10","0","0","0","0","0","0","0","0","0","-2"
"134608","Indian River State College","2016","Not on tenure/no tenure system, no academic rank","9","6","3","0","0","0","0","0","0","1","1","0","0","0","0","0","0","0","8","5","3","0","0","0","0","0","0","0","0","0","-2"
"135081","Keiser University-Ft Lauderdale","2016","Not on tenure track/No tenure system system total","1025","415","610","3","1","2","45","19","26","125","49","76","157","70","87","1","0","1","672","268","404","22","8","14","0","0","0","0","0","0","-2"
"135081","Keiser University-Ft Lauderdale","2016","Not on tenure/no tenure system, instructors","1025","415","610","3","1","2","45","19","26","125","49","76","157","70","87","1","0","1","672","268","404","22","8","14","0","0","0","0","0","0","-2"
"135610","Trinity International University-Florida","2016","Tenured total","2","0","2","0","0","0","0","0","0","0","0","0","1","0","1","0","0","0","1","0","1","0","0","0","0","0","0","0","0","0","-2"
"135610","Trinity International University-Florida","2016","Tenured, professors","2","0","2","0","0","0","0","0","0","0","0","0","1","0","1","0","0","0","1","0","1","0","0","0","0","0","0","0","0","0","-2"
"135717","Miami Dade College","2016","Tenured total","544","268","276","2","0","2","29","12","17","70","30","40","244","121","123","0","0","0","190","100","90","6","2","4","3","3","0","0","0","0","-2"
"135717","Miami Dade College","2016","Tenured, professors","169","87","82","0","0","0","12","6","6","15","8","7","71","34","37","0","0","0","66","35","31","3","2","1","2","2","0","0","0","0","-2"
"135717","Miami Dade College","2016","Tenured, associate professors","258","119","139","0","0","0","13","5","8","36","15","21","120","52","68","0","0","0","86","46","40","2","0","2","1","1","0","0","0","0","-2"
"135717","Miami Dade College","2016","Tenured, assistant professors","103","51","52","1","0","1","4","1","3","19","7","12","43","27","16","0","0","0","35","16","19","1","0","1","0","0","0","0","0","0","-2"
"135717","Miami Dade College","2016","Tenured, instructors","14","11","3","1","0","1","0","0","0","0","0","0","10","8","2","0","0","0","3","3","0","0","0","0","0","0","0","0","0","0","-2"
"135717","Miami Dade College","2016","On-Tenure track total","210","95","115","1","1","0","6","2","4","58","17","41","83","47","36","0","0","0","57","27","30","3","0","3","0","0","0","2","1","1","-2"
"135717","Miami Dade College","2016","On-tenure track, professors","10","4","6","1","1","0","0","0","0","4","0","4","1","0","1","0","0","0","4","3","1","0","0","0","0","0","0","0","0","0","-2"
"135717","Miami Dade College","2016","On-tenure track, associate professors","14","5","9","0","0","0","0","0","0","3","2","1","5","2","3","0","0","0","6","1","5","0","0","0","0","0","0","0","0","0","-2"
"135717","Miami Dade College","2016","On-tenure track, assistant professors","68","35","33","0","0","0","3","0","3","15","8","7","29","17","12","0","0","0","18","10","8","3","0","3","0","0","0","0","0","0","-2"
"135717","Miami Dade College","2016","On-tenure track, instructors","118","51","67","0","0","0","3","2","1","36","7","29","48","28","20","0","0","0","29","13","16","0","0","0","0","0","0","2","1","1","-2"
"136215","Nova Southeastern University","2016","Tenured total","25","17","8","0","0","0","1","1","0","2","1","1","0","0","0","0","0","0","22","15","7","0","0","0","0","0","0","0","0","0","-2"
"136215","Nova Southeastern University","2016","Tenured, professors","25","17","8","0","0","0","1","1","0","2","1","1","0","0","0","0","0","0","22","15","7","0","0","0","0","0","0","0","0","0","-2"
"136215","Nova Southeastern University","2016","Not on tenure track/No tenure system system total","795","373","422","2","1","1","60","34","26","57","20","37","121","45","76","4","3","1","521","259","262","3","1","2","17","4","13","10","6","4","-2"
"136215","Nova Southeastern University","2016","Not on tenure/no tenure system, professors","157","100","57","0","0","0","18","15","3","5","3","2","11","6","5","3","2","1","118","72","46","0","0","0","0","0","0","2","2","0","-2"
"136215","Nova Southeastern University","2016","Not on tenure/no tenure system, associate professors","269","125","144","0","0","0","21","11","10","26","9","17","38","15","23","0","0","0","176","87","89","0","0","0","7","2","5","1","1","0","-2"
"136215","Nova Southeastern University","2016","Not on tenure/no tenure system, assistant professors","326","131","195","1","0","1","18","7","11","23","7","16","61","18","43","1","1","0","205","93","112","3","1","2","8","1","7","6","3","3","-2"
"136215","Nova Southeastern University","2016","Not on tenure/no tenure system, instructors","25","7","18","1","1","0","2","0","2","2","0","2","6","4","2","0","0","0","13","2","11","0","0","0","1","0","1","0","0","0","-2"
"136215","Nova Southeastern University","2016","Not on tenure/no tenure system, lecturers","4","2","2","0","0","0","0","0","0","0","0","0","1","0","1","0","0","0","3","2","1","0","0","0","0","0","0","0","0","0","-2"
"136215","Nova Southeastern University","2016","Not on tenure/no tenure system, no academic rank","14","8","6","0","0","0","1","1","0","1","1","0","4","2","2","0","0","0","6","3","3","0","0","0","1","1","0","1","0","1","-2"
"136358","Palm Beach State College","2016","Tenured total","183","74","109","0","0","0","7","6","1","24","11","13","20","5","15","0","0","0","123","48","75","1","1","0","8","3","5","0","0","0","-2"
"136358","Palm Beach State College","2016","Tenured, professors","39","20","19","0","0","0","4","3","1","4","3","1","6","2","4","0","0","0","25","12","13","0","0","0","0","0","0","0","0","0","-2"
"136358","Palm Beach State College","2016","Tenured, associate professors","25","8","17","0","0","0","0","0","0","4","2","2","4","0","4","0","0","0","16","6","10","0","0","0","1","0","1","0","0","0","-2"
"136358","Palm Beach State College","2016","Tenured, assistant professors","29","7","22","0","0","0","1","1","0","4","1","3","2","0","2","0","0","0","19","4","15","0","0","0","3","1","2","0","0","0","-2"
"136358","Palm Beach State College","2016","Tenured, instructors","90","39","51","0","0","0","2","2","0","12","5","7","8","3","5","0","0","0","63","26","37","1","1","0","4","2","2","0","0","0","-2"
"136358","Palm Beach State College","2016","On-Tenure track total","110","48","62","2","0","2","4","2","2","12","4","8","11","3","8","0","0","0","76","36","40","0","0","0","4","3","1","1","0","1","-2"
"136358","Palm Beach State College","2016","On-tenure track, professors","5","0","5","0","0","0","1","0","1","0","0","0","0","0","0","0","0","0","4","0","4","0","0","0","0","0","0","0","0","0","-2"
"136358","Palm Beach State College","2016","On-tenure track, associate professors","15","8","7","0","0","0","2","1","1","2","1","1","1","0","1","0","0","0","10","6","4","0","0","0","0","0","0","0","0","0","-2"
"136358","Palm Beach State College","2016","On-tenure track, assistant professors","30","13","17","1","0","1","1","1","0","6","1","5","4","1","3","0","0","0","18","10","8","0","0","0","0","0","0","0","0","0","-2"
"136358","Palm Beach State College","2016","On-tenure track, instructors","60","27","33","1","0","1","0","0","0","4","2","2","6","2","4","0","0","0","44","20","24","0","0","0","4","3","1","1","0","1","-2"
"136358","Palm Beach State College","2016","Not on tenure track/No tenure system system total","7","4","3","0","0","0","2","0","2","2","1","1","1","1","0","0","0","0","2","2","0","0","0","0","0","0","0","0","0","0","-2"
"136358","Palm Beach State College","2016","Not on tenure/no tenure system, associate professors","1","0","1","0","0","0","0","0","0","1","0","1","0","0","0","0","0","0","0","0","0","0","0","0","0","0","0","0","0","0","-2"
"136358","Palm Beach State College","2016","Not on tenure/no tenure system, assistant professors","1","0","1","0","0","0","1","0","1","0","0","0","0","0","0","0","0","0","0","0","0","0","0","0","0","0","0","0","0","0","-2"
"136358","Palm Beach State College","2016","Not on tenure/no tenure system, no academic rank","5","4","1","0","0","0","1","0","1","1","1","0","1","1","0","0","0","0","2","2","0","0","0","0","0","0","0","0","0","0","-2"
"136516","Polk State College","2016","Tenured total","113","50","63","1","0","1","1","1","0","8","4","4","5","2","3","0","0","0","97","42","55","0","0","0","0","0","0","1","1","0","-2"
"136516","Polk State College","2016","Tenured, no academic rank","113","50","63","1","0","1","1","1","0","8","4","4","5","2","3","0","0","0","97","42","55","0","0","0","0","0","0","1","1","0","-2"
"136516","Polk State College","2016","On-Tenure track total","44","24","20","0","0","0","1","1","0","3","2","1","2","1","1","0","0","0","37","19","18","0","0","0","1","1","0","0","0","0","-2"
"136516","Polk State College","2016","On-tenure track, no academic rank","44","24","20","0","0","0","1","1","0","3","2","1","2","1","1","0","0","0","37","19","18","0","0","0","1","1","0","0","0","0","-2"
"136516","Polk State College","2016","Not on tenure track/No tenure system system total","5","1","4","0","0","0","0","0","0","2","1","1","0","0","0","0","0","0","3","0","3","0","0","0","0","0","0","0","0","0","-2"
"136516","Polk State College","2016","Not on tenure/no tenure system, no academic rank","5","1","4","0","0","0","0","0","0","2","1","1","0","0","0","0","0","0","3","0","3","0","0","0","0","0","0","0","0","0","-2"
"137209","Seminole State College of Florida","2016","Tenured total","150","56","94","0","0","0","6","4","2","9","3","6","12","4","8","1","1","0","120","43","77","2","1","1","0","0","0","0","0","0","-2"
"137209","Seminole State College of Florida","2016","Tenured, no academic rank","150","56","94","0","0","0","6","4","2","9","3","6","12","4","8","1","1","0","120","43","77","2","1","1","0","0","0","0","0","0","-2"
"137209","Seminole State College of Florida","2016","On-Tenure track total","54","22","32","0","0","0","2","1","1","5","1","4","5","4","1","0","0","0","42","16","26","0","0","0","0","0","0","0","0","0","-2"
"137209","Seminole State College of Florida","2016","On-tenure track, no academic rank","54","22","32","0","0","0","2","1","1","5","1","4","5","4","1","0","0","0","42","16","26","0","0","0","0","0","0","0","0","0","-2"
"137315","South Florida State College","2016","Tenured total","46","18","28","0","0","0","1","0","1","2","0","2","0","0","0","0","0","0","43","18","25","0","0","0","0","0","0","0","0","0","-2"
"137315","South Florida State College","2016","Tenured, instructors","46","18","28","0","0","0","1","0","1","2","0","2","0","0","0","0","0","0","43","18","25","0","0","0","0","0","0","0","0","0","-2"
"137315","South Florida State College","2016","On-Tenure track total","16","5","11","0","0","0","1","0","1","1","0","1","2","0","2","0","0","0","12","5","7","0","0","0","0","0","0","0","0","0","-2"
"137315","South Florida State College","2016","On-tenure track, instructors","16","5","11","0","0","0","1","0","1","1","0","1","2","0","2","0","0","0","12","5","7","0","0","0","0","0","0","0","0","0","-2"
"137476","St. Thomas University","2016","Tenured total","23","14","9","0","0","0","1","1","0","2","1","1","0","0","0","0","0","0","20","12","8","0","0","0","0","0","0","0","0","0","-2"
"137476","St. Thomas University","2016","Tenured, professors","23","14","9","0","0","0","1","1","0","2","1","1","0","0","0","0","0","0","20","12","8","0","0","0","0","0","0","0","0","0","-2"
"137476","St. Thomas University","2016","On-Tenure track total","4","3","1","0","0","0","0","0","0","2","1","1","1","1","0","0","0","0","1","1","0","0","0","0","0","0","0","0","0","0","-2"
"137476","St. Thomas University","2016","On-tenure track, associate professors","4","3","1","0","0","0","0","0","0","2","1","1","1","1","0","0","0","0","1","1","0","0","0","0","0","0","0","0","0","0","-2"
"137476","St. Thomas University","2016","Not on tenure track/No tenure system system total","68","37","31","0","0","0","4","2","2","9","5","4","15","8","7","0","0","0","40","22","18","0","0","0","0","0","0","0","0","0","-2"
"137476","St. Thomas University","2016","Not on tenure/no tenure system, professors","21","16","5","0","0","0","1","1","0","0","0","0","4","2","2","0","0","0","16","13","3","0","0","0","0","0","0","0","0","0","-2"
"137476","St. Thomas University","2016","Not on tenure/no tenure system, associate professors","27","10","17","0","0","0","2","1","1","6","2","4","4","2","2","0","0","0","15","5","10","0","0","0","0","0","0","0","0","0","-2"
"137476","St. Thomas University","2016","Not on tenure/no tenure system, assistant professors","18","9","9","0","0","0","1","0","1","1","1","0","7","4","3","0","0","0","9","4","5","0","0","0","0","0","0","0","0","0","-2"
"137476","St. Thomas University","2016","Not on tenure/no tenure system, instructors","1","1","0","0","0","0","0","0","0","1","1","0","0","0","0","0","0","0","0","0","0","0","0","0","0","0","0","0","0","0","-2"
"137476","St. Thomas University","2016","Not on tenure/no tenure system, lecturers","1","1","0","0","0","0","0","0","0","1","1","0","0","0","0","0","0","0","0","0","0","0","0","0","0","0","0","0","0","0","-2"
"138187","Valencia College","2016","Tenured total","306","132","174","3","1","2","16","7","9","24","13","11","30","11","19","0","0","0","229","97","132","0","0","0","4","3","1","0","0","0","-2"
"138187","Valencia College","2016","Tenured, no academic rank","306","132","174","3","1","2","16","7","9","24","13","11","30","11","19","0","0","0","229","97","132","0","0","0","4","3","1","0","0","0","-2"
"138187","Valencia College","2016","On-Tenure track total","124","50","74","1","1","0","6","2","4","14","4","10","12","6","6","0","0","0","85","35","50","0","0","0","6","2","4","0","0","0","-2"
"138187","Valencia College","2016","On-tenure track, no academic rank","124","50","74","1","1","0","6","2","4","14","4","10","12","6","6","0","0","0","85","35","50","0","0","0","6","2","4","0","0","0","-2"
"138187","Valencia College","2016","Not on tenure track/No tenure system system total","130","53","77","0","0","0","9","3","6","17","4","13","11","8","3","0","0","0","87","35","52","0","0","0","5","3","2","1","0","1","-2"
"138187","Valencia College","2016","Not on tenure/no tenure system, no academic rank","130","53","77","0","0","0","9","3","6","17","4","13","11","8","3","0","0","0","87","35","52","0","0","0","5","3","2","1","0","1","-2"
"139463","Dalton State College","2016","Tenured total","95","47","48","0","0","0","2","2","0","3","2","1","0","0","0","0","0","0","87","41","46","1","1","0","1","1","0","1","0","1","-2"
"139463","Dalton State College","2016","Tenured, professors","27","16","11","0","0","0","1","1","0","0","0","0","0","0","0","0","0","0","26","15","11","0","0","0","0","0","0","0","0","0","-2"
"139463","Dalton State College","2016","Tenured, associate professors","65","30","35","0","0","0","1","1","0","3","2","1","0","0","0","0","0","0","58","25","33","1","1","0","1","1","0","1","0","1","-2"
"139463","Dalton State College","2016","Tenured, assistant professors","3","1","2","0","0","0","0","0","0","0","0","0","0","0","0","0","0","0","3","1","2","0","0","0","0","0","0","0","0","0","-2"
"139463","Dalton State College","2016","On-Tenure track total","45","15","30","0","0","0","1","0","1","1","0","1","1","1","0","0","0","0","40","12","28","0","0","0","0","0","0","2","2","0","-2"
"139463","Dalton State College","2016","On-tenure track, professors","1","0","1","0","0","0","0","0","0","0","0","0","0","0","0","0","0","0","1","0","1","0","0","0","0","0","0","0","0","0","-2"
"139463","Dalton State College","2016","On-tenure track, associate professors","7","2","5","0","0","0","0","0","0","0","0","0","0","0","0","0","0","0","7","2","5","0","0","0","0","0","0","0","0","0","-2"
"139463","Dalton State College","2016","On-tenure track, assistant professors","36","13","23","0","0","0","1","0","1","1","0","1","1","1","0","0","0","0","31","10","21","0","0","0","0","0","0","2","2","0","-2"
"139463","Dalton State College","2016","On-tenure track, lecturers","1","0","1","0","0","0","0","0","0","0","0","0","0","0","0","0","0","0","1","0","1","0","0","0","0","0","0","0","0","0","-2"
"139463","Dalton State College","2016","Not on tenure track/No tenure system system total","24","8","16","0","0","0","2","1","1","0","0","0","1","0","1","0","0","0","21","7","14","0","0","0","0","0","0","0","0","0","-2"
"139463","Dalton State College","2016","Not on tenure/no tenure system, assistant professors","1","0","1","0","0","0","0","0","0","0","0","0","0","0","0","0","0","0","1","0","1","0","0","0","0","0","0","0","0","0","-2"
"139463","Dalton State College","2016","Not on tenure/no tenure system, instructors","8","3","5","0","0","0","0","0","0","0","0","0","0","0","0","0","0","0","8","3","5","0","0","0","0","0","0","0","0","0","-2"
"139463","Dalton State College","2016","Not on tenure/no tenure system, lecturers","15","5","10","0","0","0","2","1","1","0","0","0","1","0","1","0","0","0","12","4","8","0","0","0","0","0","0","0","0","0","-2"
"142887","American Academy of Art","2016","Not on tenure track/No tenure system system total","23","12","11","0","0","0","1","1","0","1","0","1","0","0","0","0","0","0","21","11","10","0","0","0","0","0","0","0","0","0","-2"
"142887","American Academy of Art","2016","Not on tenure/no tenure system, instructors","23","12","11","0","0","0","1","1","0","1","0","1","0","0","0","0","0","0","21","11","10","0","0","0","0","0","0","0","0","0","-2"
"143118","Aurora University","2016","Tenured total","48","24","24","0","0","0","1","0","1","1","1","0","2","1","1","0","0","0","44","22","22","0","0","0","0","0","0","0","0","0","-2"
"143118","Aurora University","2016","Tenured, professors","20","11","9","0","0","0","1","0","1","1","1","0","0","0","0","0","0","0","18","10","8","0","0","0","0","0","0","0","0","0","-2"
"143118","Aurora University","2016","Tenured, associate professors","28","13","15","0","0","0","0","0","0","0","0","0","2","1","1","0","0","0","26","12","14","0","0","0","0","0","0","0","0","0","-2"
"143118","Aurora University","2016","On-Tenure track total","40","18","22","0","0","0","1","1","0","0","0","0","3","0","3","0","0","0","35","16","19","0","0","0","1","1","0","0","0","0","-2"
"143118","Aurora University","2016","On-tenure track, associate professors","1","0","1","0","0","0","0","0","0","0","0","0","0","0","0","0","0","0","1","0","1","0","0","0","0","0","0","0","0","0","-2"
"143118","Aurora University","2016","On-tenure track, assistant professors","38","18","20","0","0","0","1","1","0","0","0","0","3","0","3","0","0","0","33","16","17","0","0","0","1","1","0","0","0","0","-2"
"143118","Aurora University","2016","On-tenure track, instructors","1","0","1","0","0","0","0","0","0","0","0","0","0","0","0","0","0","0","1","0","1","0","0","0","0","0","0","0","0","0","-2"
"143118","Aurora University","2016","Not on tenure track/No tenure system system total","66","29","37","0","0","0","5","2","3","3","3","0","2","1","1","0","0","0","54","22","32","0","0","0","2","1","1","0","0","0","-2"
"143118","Aurora University","2016","Not on tenure/no tenure system, professors","2","2","0","0","0","0","0","0","0","0","0","0","0","0","0","0","0","0","2","2","0","0","0","0","0","0","0","0","0","0","-2"
"143118","Aurora University","2016","Not on tenure/no tenure system, associate professors","13","6","7","0","0","0","1","0","1","0","0","0","1","1","0","0","0","0","11","5","6","0","0","0","0","0","0","0","0","0","-2"
"143118","Aurora University","2016","Not on tenure/no tenure system, assistant professors","15","6","9","0","0","0","1","1","0","0","0","0","0","0","0","0","0","0","14","5","9","0","0","0","0","0","0","0","0","0","-2"
"143118","Aurora University","2016","Not on tenure/no tenure system, lecturers","36","15","21","0","0","0","3","1","2","3","3","0","1","0","1","0","0","0","27","10","17","0","0","0","2","1","1","0","0","0","-2"
"143978","The Chicago School of Professional Psychology at Chicago","2016","Not on tenure track/No tenure system system total","94","38","56","2","0","2","5","2","3","10","3","7","6","2","4","0","0","0","65","29","36","1","0","1","5","2","3","0","0","0","-2"
"143978","The Chicago School of Professional Psychology at Chicago","2016","Not on tenure/no tenure system, professors","15","9","6","1","0","1","0","0","0","0","0","0","0","0","0","0","0","0","13","8","5","0","0","0","1","1","0","0","0","0","-2"
"143978","The Chicago School of Professional Psychology at Chicago","2016","Not on tenure/no tenure system, associate professors","48","20","28","1","0","1","3","2","1","7","2","5","3","1","2","0","0","0","30","14","16","1","0","1","3","1","2","0","0","0","-2"
"143978","The Chicago School of Professional Psychology at Chicago","2016","Not on tenure/no tenure system, assistant professors","31","9","22","0","0","0","2","0","2","3","1","2","3","1","2","0","0","0","22","7","15","0","0","0","1","0","1","0","0","0","-2"
"144351","Concordia University-Chicago","2016","Tenured total","54","22","32","0","0","0","2","1","1","2","0","2","0","0","0","0","0","0","50","21","29","0","0","0","0","0","0","0","0","0","-2"
"144351","Concordia University-Chicago","2016","Tenured, professors","36","14","22","0","0","0","0","0","0","1","0","1","0","0","0","0","0","0","35","14","21","0","0","0","0","0","0","0","0","0","-2"
"144351","Concordia University-Chicago","2016","Tenured, associate professors","18","8","10","0","0","0","2","1","1","1","0","1","0","0","0","0","0","0","15","7","8","0","0","0","0","0","0","0","0","0","-2"
"144351","Concordia University-Chicago","2016","On-Tenure track total","81","38","43","0","0","0","3","2","1","1","0","1","3","2","1","0","0","0","66","27","39","2","2","0","2","1","1","4","4","0","-2"
"144351","Concordia University-Chicago","2016","On-tenure track, professors","4","2","2","0","0","0","0","0","0","0","0","0","0","0","0","0","0","0","4","2","2","0","0","0","0","0","0","0","0","0","-2"
"144351","Concordia University-Chicago","2016","On-tenure track, associate professors","35","16","19","0","0","0","2","1","1","0","0","0","2","1","1","0","0","0","28","11","17","0","0","0","1","1","0","2","2","0","-2"
"144351","Concordia University-Chicago","2016","On-tenure track, assistant professors","42","20","22","0","0","0","1","1","0","1","0","1","1","1","0","0","0","0","34","14","20","2","2","0","1","0","1","2","2","0","-2"
"144351","Concordia University-Chicago","2016","Not on tenure track/No tenure system system total","149","61","88","1","0","1","3","1","2","16","6","10","3","1","2","0","0","0","116","47","69","0","0","0","10","6","4","0","0","0","-2"
"144351","Concordia University-Chicago","2016","Not on tenure/no tenure system, professors","1","1","0","0","0","0","0","0","0","0","0","0","0","0","0","0","0","0","1","1","0","0","0","0","0","0","0","0","0","0","-2"
"144351","Concordia University-Chicago","2016","Not on tenure/no tenure system, associate professors","3","2","1","0","0","0","0","0","0","1","1","0","1","0","1","0","0","0","1","1","0","0","0","0","0","0","0","0","0","0","-2"
"144351","Concordia University-Chicago","2016","Not on tenure/no tenure system, assistant professors","11","3","8","0","0","0","0","0","0","1","0","1","1","1","0","0","0","0","8","1","7","0","0","0","1","1","0","0","0","0","-2"
"144351","Concordia University-Chicago","2016","Not on tenure/no tenure system, instructors","134","55","79","1","0","1","3","1","2","14","5","9","1","0","1","0","0","0","106","44","62","0","0","0","9","5","4","0","0","0","-2"
"145600","University of Illinois Chicago","2016","Tenured total","841","518","323","2","0","2","161","110","51","34","15","19","59","28","31","0","0","0","557","346","211","4","1","3","17","12","5","7","6","1","-2"
"145600","University of Illinois Chicago","2016","Tenured, professors","445","301","144","0","0","0","75","56","19","14","6","8","23","13","10","0","0","0","325","219","106","0","0","0","5","4","1","3","3","0","-2"
"145600","University of Illinois Chicago","2016","Tenured, associate professors","378","206","172","2","0","2","81","50","31","19","9","10","34","14","20","0","0","0","223","122","101","4","1","3","11","7","4","4","3","1","-2"
"145600","University of Illinois Chicago","2016","Tenured, assistant professors","17","10","7","0","0","0","4","3","1","1","0","1","2","1","1","0","0","0","9","5","4","0","0","0","1","1","0","0","0","0","-2"
"145600","University of Illinois Chicago","2016","Tenured, no academic rank","1","1","0","0","0","0","1","1","0","0","0","0","0","0","0","0","0","0","0","0","0","0","0","0","0","0","0","0","0","0","-2"
"145600","University of Illinois Chicago","2016","On-Tenure track total","394","222","172","0","0","0","90","56","34","32","18","14","35","16","19","1","0","1","187","105","82","6","2","4","10","3","7","33","22","11","-2"
"145600","University of Illinois Chicago","2016","On-tenure track, professors","12","9","3","0","0","0","4","3","1","0","0","0","0","0","0","0","0","0","8","6","2","0","0","0","0","0","0","0","0","0","-2"
"145600","University of Illinois Chicago","2016","On-tenure track, associate professors","44","24","20","0","0","0","9","6","3","4","2","2","3","2","1","0","0","0","25","13","12","1","1","0","2","0","2","0","0","0","-2"
"145600","University of Illinois Chicago","2016","On-tenure track, assistant professors","338","189","149","0","0","0","77","47","30","28","16","12","32","14","18","1","0","1","154","86","68","5","1","4","8","3","5","33","22","11","-2"
"145600","University of Illinois Chicago","2016","Not on tenure track/No tenure system system total","751","299","452","1","0","1","133","45","88","41","15","26","33","14","19","0","0","0","487","199","288","7","1","6","15","8","7","34","17","17","-2"
"145600","University of Illinois Chicago","2016","Not on tenure/no tenure system, professors","27","17","10","0","0","0","4","4","0","0","0","0","0","0","0","0","0","0","22","13","9","0","0","0","1","0","1","0","0","0","-2"
"145600","University of Illinois Chicago","2016","Not on tenure/no tenure system, associate professors","81","32","49","0","0","0","11","2","9","2","1","1","1","0","1","0","0","0","64","29","35","1","0","1","2","0","2","0","0","0","-2"
"145600","University of Illinois Chicago","2016","Not on tenure/no tenure system, assistant professors","347","134","213","0","0","0","60","14","46","24","10","14","17","6","11","0","0","0","215","87","128","3","0","3","9","6","3","19","11","8","-2"
"145600","University of Illinois Chicago","2016","Not on tenure/no tenure system, instructors","147","47","100","1","0","1","48","21","27","8","0","8","5","3","2","0","0","0","73","18","55","0","0","0","1","0","1","11","5","6","-2"
"145600","University of Illinois Chicago","2016","Not on tenure/no tenure system, lecturers","134","68","66","0","0","0","10","4","6","7","4","3","10","5","5","0","0","0","99","51","48","2","1","1","2","2","0","4","1","3","-2"
"145600","University of Illinois Chicago","2016","Not on tenure/no tenure system, no academic rank","15","1","14","0","0","0","0","0","0","0","0","0","0","0","0","0","0","0","14","1","13","1","0","1","0","0","0","0","0","0","-2"
"147536","National Louis University","2016","Tenured total","58","24","34","0","0","0","4","0","4","4","4","0","1","1","0","0","0","0","48","18","30","1","1","0","0","0","0","0","0","0","-2"
"147536","National Louis University","2016","Tenured, professors","15","6","9","0","0","0","0","0","0","0","0","0","0","0","0","0","0","0","15","6","9","0","0","0","0","0","0","0","0","0","-2"
"147536","National Louis University","2016","Tenured, associate professors","36","13","23","0","0","0","4","0","4","3","3","0","1","1","0","0","0","0","28","9","19","0","0","0","0","0","0","0","0","0","-2"
"147536","National Louis University","2016","Tenured, assistant professors","7","5","2","0","0","0","0","0","0","1","1","0","0","0","0","0","0","0","5","3","2","1","1","0","0","0","0","0","0","0","-2"
"147536","National Louis University","2016","On-Tenure track total","9","1","8","0","0","0","1","0","1","1","0","1","1","0","1","0","0","0","4","1","3","0","0","0","0","0","0","2","0","2","-2"
"147536","National Louis University","2016","On-tenure track, associate professors","1","0","1","0","0","0","0","0","0","1","0","1","0","0","0","0","0","0","0","0","0","0","0","0","0","0","0","0","0","0","-2"
"147536","National Louis University","2016","On-tenure track, assistant professors","8","1","7","0","0","0","1","0","1","0","0","0","1","0","1","0","0","0","4","1","3","0","0","0","0","0","0","2","0","2","-2"
"147536","National Louis University","2016","Not on tenure track/No tenure system system total","59","18","41","1","0","1","0","0","0","8","1","7","4","2","2","0","0","0","46","15","31","0","0","0","0","0","0","0","0","0","-2"
"147536","National Louis University","2016","Not on tenure/no tenure system, professors","2","1","1","0","0","0","0","0","0","0","0","0","0","0","0","0","0","0","2","1","1","0","0","0","0","0","0","0","0","0","-2"
"147536","National Louis University","2016","Not on tenure/no tenure system, associate professors","7","2","5","0","0","0","0","0","0","0","0","0","0","0","0","0","0","0","7","2","5","0","0","0","0","0","0","0","0","0","-2"
"147536","National Louis University","2016","Not on tenure/no tenure system, assistant professors","40","11","29","1","0","1","0","0","0","8","1","7","3","2","1","0","0","0","28","8","20","0","0","0","0","0","0","0","0","0","-2"
"147536","National Louis University","2016","Not on tenure/no tenure system, instructors","10","4","6","0","0","0","0","0","0","0","0","0","1","0","1","0","0","0","9","4","5","0","0","0","0","0","0","0","0","0","-2"
"147679","North Park University","2016","Tenured total","67","34","33","0","0","0","7","5","2","4","1","3","1","0","1","0","0","0","55","28","27","0","0","0","0","0","0","0","0","0","-2"
"147679","North Park University","2016","Tenured, professors","53","29","24","0","0","0","4","3","1","4","1","3","1","0","1","0","0","0","44","25","19","0","0","0","0","0","0","0","0","0","-2"
"147679","North Park University","2016","Tenured, associate professors","11","3","8","0","0","0","2","1","1","0","0","0","0","0","0","0","0","0","9","2","7","0","0","0","0","0","0","0","0","0","-2"
"147679","North Park University","2016","Tenured, assistant professors","3","2","1","0","0","0","1","1","0","0","0","0","0","0","0","0","0","0","2","1","1","0","0","0","0","0","0","0","0","0","-2"
"147679","North Park University","2016","On-Tenure track total","21","11","10","0","0","0","1","0","1","1","1","0","0","0","0","0","0","0","17","9","8","2","1","1","0","0","0","0","0","0","-2"
"147679","North Park University","2016","On-tenure track, professors","3","2","1","0","0","0","0","0","0","0","0","0","0","0","0","0","0","0","3","2","1","0","0","0","0","0","0","0","0","0","-2"
"147679","North Park University","2016","On-tenure track, associate professors","7","4","3","0","0","0","0","0","0","1","1","0","0","0","0","0","0","0","5","2","3","1","1","0","0","0","0","0","0","0","-2"
"147679","North Park University","2016","On-tenure track, assistant professors","11","5","6","0","0","0","1","0","1","0","0","0","0","0","0","0","0","0","9","5","4","1","0","1","0","0","0","0","0","0","-2"
"147679","North Park University","2016","Not on tenure track/No tenure system system total","28","6","22","0","0","0","0","0","0","3","0","3","0","0","0","0","0","0","25","6","19","0","0","0","0","0","0","0","0","0","-2"
"147679","North Park University","2016","Not on tenure/no tenure system, professors","4","1","3","0","0","0","0","0","0","0","0","0","0","0","0","0","0","0","4","1","3","0","0","0","0","0","0","0","0","0","-2"
"147679","North Park University","2016","Not on tenure/no tenure system, associate professors","10","2","8","0","0","0","0","0","0","1","0","1","0","0","0","0","0","0","9","2","7","0","0","0","0","0","0","0","0","0","-2"
"147679","North Park University","2016","Not on tenure/no tenure system, assistant professors","14","3","11","0","0","0","0","0","0","2","0","2","0","0","0","0","0","0","12","3","9","0","0","0","0","0","0","0","0","0","-2"
"147776","Northeastern Illinois University","2016","Tenured total","139","60","79","0","0","0","18","9","9","15","8","7","13","4","9","0","0","0","85","35","50","0","0","0","6","4","2","2","0","2","-2"
"147776","Northeastern Illinois University","2016","Tenured, professors","57","27","30","0","0","0","12","5","7","4","3","1","5","3","2","0","0","0","36","16","20","0","0","0","0","0","0","0","0","0","-2"
"147776","Northeastern Illinois University","2016","Tenured, associate professors","81","33","48","0","0","0","6","4","2","11","5","6","8","1","7","0","0","0","48","19","29","0","0","0","6","4","2","2","0","2","-2"
"147776","Northeastern Illinois University","2016","Tenured, assistant professors","1","0","1","0","0","0","0","0","0","0","0","0","0","0","0","0","0","0","1","0","1","0","0","0","0","0","0","0","0","0","-2"
"147776","Northeastern Illinois University","2016","On-Tenure track total","87","40","47","1","1","0","18","6","12","4","2","2","10","6","4","0","0","0","43","16","27","0","0","0","11","9","2","0","0","0","-2"
"147776","Northeastern Illinois University","2016","On-tenure track, associate professors","17","8","9","0","0","0","2","0","2","1","0","1","4","2","2","0","0","0","8","4","4","0","0","0","2","2","0","0","0","0","-2"
"147776","Northeastern Illinois University","2016","On-tenure track, assistant professors","70","32","38","1","1","0","16","6","10","3","2","1","6","4","2","0","0","0","35","12","23","0","0","0","9","7","2","0","0","0","-2"
"147776","Northeastern Illinois University","2016","Not on tenure track/No tenure system system total","98","44","54","0","0","0","5","3","2","3","3","0","8","4","4","0","0","0","73","29","44","0","0","0","9","5","4","0","0","0","-2"
"147776","Northeastern Illinois University","2016","Not on tenure/no tenure system, instructors","97","44","53","0","0","0","5","3","2","3","3","0","8","4","4","0","0","0","72","29","43","0","0","0","9","5","4","0","0","0","-2"
"147776","Northeastern Illinois University","2016","Not on tenure/no tenure system, no academic rank","1","0","1","0","0","0","0","0","0","0","0","0","0","0","0","0","0","0","1","0","1","0","0","0","0","0","0","0","0","0","-2"
"148335","Robert Morris University Illinois","2016","Not on tenure track/No tenure system system total","71","40","31","0","0","0","12","9","3","7","3","4","2","2","0","0","0","0","50","26","24","0","0","0","0","0","0","0","0","0","-2"
"148335","Robert Morris University Illinois","2016","Not on tenure/no tenure system, professors","71","40","31","0","0","0","12","9","3","7","3","4","2","2","0","0","0","0","50","26","24","0","0","0","0","0","0","0","0","0","-2"
"148487","Roosevelt University","2016","Tenured total","148","83","65","1","1","0","6","3","3","8","3","5","4","3","1","0","0","0","102","54","48","4","2","2","10","8","2","13","9","4","-2"
"148487","Roosevelt University","2016","Tenured, professors","45","32","13","0","0","0","3","2","1","4","2","2","2","2","0","0","0","0","30","21","9","1","1","0","3","2","1","2","2","0","-2"
"148487","Roosevelt University","2016","Tenured, associate professors","99","49","50","1","1","0","3","1","2","3","1","2","2","1","1","0","0","0","69","31","38","3","1","2","7","6","1","11","7","4","-2"
"148487","Roosevelt University","2016","Tenured, assistant professors","4","2","2","0","0","0","0","0","0","1","0","1","0","0","0","0","0","0","3","2","1","0","0","0","0","0","0","0","0","0","-2"
"148487","Roosevelt University","2016","On-Tenure track total","43","29","14","0","0","0","1","1","0","3","1","2","2","1","1","0","0","0","26","20","6","0","0","0","0","0","0","11","6","5","-2"
"148487","Roosevelt University","2016","On-tenure track, associate professors","5","5","0","0","0","0","0","0","0","0","0","0","0","0","0","0","0","0","4","4","0","0","0","0","0","0","0","1","1","0","-2"
"148487","Roosevelt University","2016","On-tenure track, assistant professors","38","24","14","0","0","0","1","1","0","3","1","2","2","1","1","0","0","0","22","16","6","0","0","0","0","0","0","10","5","5","-2"
"148487","Roosevelt University","2016","Not on tenure track/No tenure system system total","47","25","22","0","0","0","3","1","2","2","2","0","2","1","1","0","0","0","33","17","16","1","0","1","2","1","1","4","3","1","-2"
"148487","Roosevelt University","2016","Not on tenure/no tenure system, professors","2","1","1","0","0","0","0","0","0","1","1","0","0","0","0","0","0","0","1","0","1","0","0","0","0","0","0","0","0","0","-2"
"148487","Roosevelt University","2016","Not on tenure/no tenure system, associate professors","2","1","1","0","0","0","0","0","0","0","0","0","0","0","0","0","0","0","2","1","1","0","0","0","0","0","0","0","0","0","-2"
"148487","Roosevelt University","2016","Not on tenure/no tenure system, assistant professors","17","9","8","0","0","0","2","1","1","0","0","0","0","0","0","0","0","0","13","6","7","0","0","0","0","0","0","2","2","0","-2"
"148487","Roosevelt University","2016","Not on tenure/no tenure system, instructors","1","0","1","0","0","0","0","0","0","0","0","0","1","0","1","0","0","0","0","0","0","0","0","0","0","0","0","0","0","0","-2"
"148487","Roosevelt University","2016","Not on tenure/no tenure system, lecturers","22","12","10","0","0","0","1","0","1","1","1","0","1","1","0","0","0","0","16","9","7","1","0","1","1","0","1","1","1","0","-2"
"148487","Roosevelt University","2016","Not on tenure/no tenure system, no academic rank","3","2","1","0","0","0","0","0","0","0","0","0","0","0","0","0","0","0","1","1","0","0","0","0","1","1","0","1","0","1","-2"
"148496","Dominican University","2016","Tenured total","95","39","56","0","0","0","6","3","3","6","3","3","7","2","5","0","0","0","76","31","45","0","0","0","0","0","0","0","0","0","-2"
"148496","Dominican University","2016","Tenured, professors","50","26","24","0","0","0","3","2","1","1","1","0","2","1","1","0","0","0","44","22","22","0","0","0","0","0","0","0","0","0","-2"
"148496","Dominican University","2016","Tenured, associate professors","36","11","25","0","0","0","3","1","2","3","2","1","5","1","4","0","0","0","25","7","18","0","0","0","0","0","0","0","0","0","-2"
"148496","Dominican University","2016","Tenured, assistant professors","9","2","7","0","0","0","0","0","0","2","0","2","0","0","0","0","0","0","7","2","5","0","0","0","0","0","0","0","0","0","-2"
"148496","Dominican University","2016","On-Tenure track total","40","22","18","0","0","0","7","2","5","2","1","1","3","2","1","0","0","0","25","14","11","1","1","0","2","2","0","0","0","0","-2"
"148496","Dominican University","2016","On-tenure track, associate professors","11","5","6","0","0","0","1","0","1","0","0","0","1","1","0","0","0","0","8","3","5","1","1","0","0","0","0","0","0","0","-2"
"148496","Dominican University","2016","On-tenure track, assistant professors","27","15","12","0","0","0","6","2","4","2","1","1","1","0","1","0","0","0","16","10","6","0","0","0","2","2","0","0","0","0","-2"
"148496","Dominican University","2016","On-tenure track, instructors","1","1","0","0","0","0","0","0","0","0","0","0","1","1","0","0","0","0","0","0","0","0","0","0","0","0","0","0","0","0","-2"
"148496","Dominican University","2016","On-tenure track, lecturers","1","1","0","0","0","0","0","0","0","0","0","0","0","0","0","0","0","0","1","1","0","0","0","0","0","0","0","0","0","0","-2"
"148496","Dominican University","2016","Not on tenure track/No tenure system system total","30","10","20","0","0","0","1","1","0","2","1","1","2","0","2","0","0","0","24","8","16","0","0","0","1","0","1","0","0","0","-2"
"148496","Dominican University","2016","Not on tenure/no tenure system, professors","1","0","1","0","0","0","0","0","0","0","0","0","0","0","0","0","0","0","1","0","1","0","0","0","0","0","0","0","0","0","-2"
"148496","Dominican University","2016","Not on tenure/no tenure system, associate professors","2","1","1","0","0","0","0","0","0","0","0","0","0","0","0","0","0","0","2","1","1","0","0","0","0","0","0","0","0","0","-2"
"148496","Dominican University","2016","Not on tenure/no tenure system, assistant professors","1","1","0","0","0","0","0","0","0","0","0","0","0","0","0","0","0","0","1","1","0","0","0","0","0","0","0","0","0","0","-2"
"148496","Dominican University","2016","Not on tenure/no tenure system, instructors","1","0","1","0","0","0","0","0","0","1","0","1","0","0","0","0","0","0","0","0","0","0","0","0","0","0","0","0","0","0","-2"
"148496","Dominican University","2016","Not on tenure/no tenure system, lecturers","25","8","17","0","0","0","1","1","0","1","1","0","2","0","2","0","0","0","20","6","14","0","0","0","1","0","1","0","0","0","-2"
"148511","Rush University","2016","Tenured total","225","138","87","0","0","0","47","27","20","3","3","0","8","5","3","3","0","3","163","102","61","1","1","0","0","0","0","0","0","0","-2"
"148511","Rush University","2016","Tenured, professors","98","67","31","0","0","0","17","12","5","1","1","0","3","3","0","1","0","1","76","51","25","0","0","0","0","0","0","0","0","0","-2"
"148511","Rush University","2016","Tenured, associate professors","127","71","56","0","0","0","30","15","15","2","2","0","5","2","3","2","0","2","87","51","36","1","1","0","0","0","0","0","0","0","-2"
"148511","Rush University","2016","On-Tenure track total","718","312","406","0","0","0","205","95","110","27","8","19","23","9","14","0","0","0","456","198","258","2","2","0","5","0","5","0","0","0","-2"
"148511","Rush University","2016","On-tenure track, assistant professors","563","259","304","0","0","0","166","73","93","22","6","16","17","7","10","0","0","0","352","172","180","1","1","0","5","0","5","0","0","0","-2"
"148511","Rush University","2016","On-tenure track, instructors","155","53","102","0","0","0","39","22","17","5","2","3","6","2","4","0","0","0","104","26","78","1","1","0","0","0","0","0","0","0","-2"
"148511","Rush University","2016","Not on tenure track/No tenure system system total","110","14","96","0","0","0","2","0","2","8","1","7","1","0","1","0","0","0","99","13","86","0","0","0","0","0","0","0","0","0","-2"
"148511","Rush University","2016","Not on tenure/no tenure system, professors","10","0","10","0","0","0","0","0","0","0","0","0","0","0","0","0","0","0","10","0","10","0","0","0","0","0","0","0","0","0","-2"
"148511","Rush University","2016","Not on tenure/no tenure system, associate professors","19","2","17","0","0","0","0","0","0","0","0","0","0","0","0","0","0","0","19","2","17","0","0","0","0","0","0","0","0","0","-2"
"148511","Rush University","2016","Not on tenure/no tenure system, assistant professors","44","7","37","0","0","0","1","0","1","5","1","4","0","0","0","0","0","0","38","6","32","0","0","0","0","0","0","0","0","0","-2"
"148511","Rush University","2016","Not on tenure/no tenure system, instructors","37","5","32","0","0","0","1","0","1","3","0","3","1","0","1","0","0","0","32","5","27","0","0","0","0","0","0","0","0","0","-2"
"148627","Saint Xavier University","2016","Tenured total","90","40","50","0","0","0","9","5","4","3","2","1","2","0","2","0","0","0","65","29","36","0","0","0","11","4","7","0","0","0","-2"
"148627","Saint Xavier University","2016","Tenured, professors","26","14","12","0","0","0","1","1","0","1","1","0","1","0","1","0","0","0","22","12","10","0","0","0","1","0","1","0","0","0","-2"
"148627","Saint Xavier University","2016","Tenured, associate professors","64","26","38","0","0","0","8","4","4","2","1","1","1","0","1","0","0","0","43","17","26","0","0","0","10","4","6","0","0","0","-2"
"148627","Saint Xavier University","2016","On-Tenure track total","33","9","24","1","0","1","1","1","0","2","0","2","1","1","0","0","0","0","22","4","18","0","0","0","6","3","3","0","0","0","-2"
"148627","Saint Xavier University","2016","On-tenure track, professors","1","0","1","0","0","0","0","0","0","0","0","0","0","0","0","0","0","0","1","0","1","0","0","0","0","0","0","0","0","0","-2"
"148627","Saint Xavier University","2016","On-tenure track, associate professors","4","2","2","0","0","0","0","0","0","0","0","0","0","0","0","0","0","0","4","2","2","0","0","0","0","0","0","0","0","0","-2"
"148627","Saint Xavier University","2016","On-tenure track, assistant professors","28","7","21","1","0","1","1","1","0","2","0","2","1","1","0","0","0","0","17","2","15","0","0","0","6","3","3","0","0","0","-2"
"148627","Saint Xavier University","2016","Not on tenure track/No tenure system system total","29","6","23","0","0","0","0","0","0","2","0","2","0","0","0","0","0","0","17","3","14","0","0","0","10","3","7","0","0","0","-2"
"148627","Saint Xavier University","2016","Not on tenure/no tenure system, associate professors","1","0","1","0","0","0","0","0","0","0","0","0","0","0","0","0","0","0","1","0","1","0","0","0","0","0","0","0","0","0","-2"
"148627","Saint Xavier University","2016","Not on tenure/no tenure system, assistant professors","10","4","6","0","0","0","0","0","0","1","0","1","0","0","0","0","0","0","2","1","1","0","0","0","7","3","4","0","0","0","-2"
"148627","Saint Xavier University","2016","Not on tenure/no tenure system, instructors","4","0","4","0","0","0","0","0","0","0","0","0","0","0","0","0","0","0","4","0","4","0","0","0","0","0","0","0","0","0","-2"
"148627","Saint Xavier University","2016","Not on tenure/no tenure system, lecturers","8","2","6","0","0","0","0","0","0","1","0","1","0","0","0","0","0","0","4","2","2","0","0","0","3","0","3","0","0","0","-2"
"148627","Saint Xavier University","2016","Not on tenure/no tenure system, no academic rank","6","0","6","0","0","0","0","0","0","0","0","0","0","0","0","0","0","0","6","0","6","0","0","0","0","0","0","0","0","0","-2"
"148876","Saint Augustine College","2016","Not on tenure track/No tenure system system total","27","12","15","0","0","0","2","1","1","1","0","1","14","10","4","0","0","0","10","1","9","0","0","0","0","0","0","0","0","0","-2"
"148876","Saint Augustine College","2016","Not on tenure/no tenure system, associate professors","4","2","2","0","0","0","0","0","0","0","0","0","2","2","0","0","0","0","2","0","2","0","0","0","0","0","0","0","0","0","-2"
"148876","Saint Augustine College","2016","Not on tenure/no tenure system, assistant professors","19","6","13","0","0","0","1","0","1","1","0","1","10","6","4","0","0","0","7","0","7","0","0","0","0","0","0","0","0","0","-2"
"148876","Saint Augustine College","2016","Not on tenure/no tenure system, instructors","4","4","0","0","0","0","1","1","0","0","0","0","2","2","0","0","0","0","1","1","0","0","0","0","0","0","0","0","0","0","-2"
"149639","VanderCook College of Music","2016","Not on tenure track/No tenure system system total","12","4","8","0","0","0","2","0","2","1","1","0","0","0","0","0","0","0","9","3","6","0","0","0","0","0","0","0","0","0","-2"
"149639","VanderCook College of Music","2016","Not on tenure/no tenure system, professors","2","1","1","0","0","0","0","0","0","0","0","0","0","0","0","0","0","0","2","1","1","0","0","0","0","0","0","0","0","0","-2"
"149639","VanderCook College of Music","2016","Not on tenure/no tenure system, associate professors","6","2","4","0","0","0","0","0","0","1","1","0","0","0","0","0","0","0","5","1","4","0","0","0","0","0","0","0","0","0","-2"
"149639","VanderCook College of Music","2016","Not on tenure/no tenure system, assistant professors","4","1","3","0","0","0","2","0","2","0","0","0","0","0","0","0","0","0","2","1","1","0","0","0","0","0","0","0","0","0","-2"
"150172","Calumet College of Saint Joseph","2016","Tenured total","17","12","5","0","0","0","0","0","0","0","0","0","1","1","0","0","0","0","16","11","5","0","0","0","0","0","0","0","0","0","-2"
"150172","Calumet College of Saint Joseph","2016","Tenured, professors","2","2","0","0","0","0","0","0","0","0","0","0","0","0","0","0","0","0","2","2","0","0","0","0","0","0","0","0","0","0","-2"
"150172","Calumet College of Saint Joseph","2016","Tenured, associate professors","14","9","5","0","0","0","0","0","0","0","0","0","1","1","0","0","0","0","13","8","5","0","0","0","0","0","0","0","0","0","-2"
"150172","Calumet College of Saint Joseph","2016","Tenured, assistant professors","1","1","0","0","0","0","0","0","0","0","0","0","0","0","0","0","0","0","1","1","0","0","0","0","0","0","0","0","0","0","-2"
"150172","Calumet College of Saint Joseph","2016","On-Tenure track total","10","4","6","0","0","0","1","1","0","1","0","1","2","0","2","0","0","0","6","3","3","0","0","0","0","0","0","0","0","0","-2"
"150172","Calumet College of Saint Joseph","2016","On-tenure track, assistant professors","10","4","6","0","0","0","1","1","0","1","0","1","2","0","2","0","0","0","6","3","3","0","0","0","0","0","0","0","0","0","-2"
"150172","Calumet College of Saint Joseph","2016","Not on tenure track/No tenure system system total","3","2","1","0","0","0","0","0","0","0","0","0","0","0","0","0","0","0","3","2","1","0","0","0","0","0","0","0","0","0","-2"
"150172","Calumet College of Saint Joseph","2016","Not on tenure/no tenure system, instructors","3","2","1","0","0","0","0","0","0","0","0","0","0","0","0","0","0","0","3","2","1","0","0","0","0","0","0","0","0","0","-2"
"151360","Indiana University-Northwest","2016","Tenured total","63","38","25","0","0","0","9","5","4","4","4","0","6","4","2","0","0","0","43","24","19","1","1","0","0","0","0","0","0","0","-2"
"151360","Indiana University-Northwest","2016","Tenured, professors","27","16","11","0","0","0","2","2","0","2","2","0","2","0","2","0","0","0","20","11","9","1","1","0","0","0","0","0","0","0","-2"
"151360","Indiana University-Northwest","2016","Tenured, associate professors","36","22","14","0","0","0","7","3","4","2","2","0","4","4","0","0","0","0","23","13","10","0","0","0","0","0","0","0","0","0","-2"
"151360","Indiana University-Northwest","2016","On-Tenure track total","40","16","24","1","0","1","9","5","4","6","0","6","0","0","0","0","0","0","24","11","13","0","0","0","0","0","0","0","0","0","-2"
"151360","Indiana University-Northwest","2016","On-tenure track, associate professors","9","4","5","1","0","1","1","1","0","1","0","1","0","0","0","0","0","0","6","3","3","0","0","0","0","0","0","0","0","0","-2"
"151360","Indiana University-Northwest","2016","On-tenure track, assistant professors","31","12","19","0","0","0","8","4","4","5","0","5","0","0","0","0","0","0","18","8","10","0","0","0","0","0","0","0","0","0","-2"
"151360","Indiana University-Northwest","2016","Not on tenure track/No tenure system system total","50","13","37","0","0","0","1","0","1","2","0","2","4","3","1","0","0","0","42","10","32","1","0","1","0","0","0","0","0","0","-2"
"151360","Indiana University-Northwest","2016","Not on tenure/no tenure system, associate professors","6","0","6","0","0","0","0","0","0","0","0","0","0","0","0","0","0","0","6","0","6","0","0","0","0","0","0","0","0","0","-2"
"151360","Indiana University-Northwest","2016","Not on tenure/no tenure system, assistant professors","26","5","21","0","0","0","0","0","0","2","0","2","3","2","1","0","0","0","21","3","18","0","0","0","0","0","0","0","0","0","-2"
"151360","Indiana University-Northwest","2016","Not on tenure/no tenure system, lecturers","18","8","10","0","0","0","1","0","1","0","0","0","1","1","0","0","0","0","15","7","8","1","0","1","0","0","0","0","0","0","-2"
"155007","Donnelly College","2016","Not on tenure track/No tenure system system total","15","3","12","0","0","0","0","0","0","1","0","1","2","1","1","0","0","0","11","2","9","0","0","0","1","0","1","0","0","0","-2"
"155007","Donnelly College","2016","Not on tenure/no tenure system, professors","1","0","1","0","0","0","0","0","0","0","0","0","0","0","0","0","0","0","1","0","1","0","0","0","0","0","0","0","0","0","-2"
"155007","Donnelly College","2016","Not on tenure/no tenure system, assistant professors","12","2","10","0","0","0","0","0","0","1","0","1","1","0","1","0","0","0","9","2","7","0","0","0","1","0","1","0","0","0","-2"
"155007","Donnelly College","2016","Not on tenure/no tenure system, instructors","2","1","1","0","0","0","0","0","0","0","0","0","1","1","0","0","0","0","1","0","1","0","0","0","0","0","0","0","0","0","-2"
"160409","Saint Joseph Seminary College","2016","Not on tenure track/No tenure system system total","23","19","4","0","0","0","1","1","0","0","0","0","1","1","0","0","0","0","21","17","4","0","0","0","0","0","0","0","0","0","-2"
"160409","Saint Joseph Seminary College","2016","Not on tenure/no tenure system, professors","23","19","4","0","0","0","1","1","0","0","0","0","1","1","0","0","0","0","21","17","4","0","0","0","0","0","0","0","0","0","-2"
"165167","Cambridge College","2016","Not on tenure track/No tenure system system total","22","11","11","0","0","0","0","0","0","6","3","3","0","0","0","0","0","0","14","8","6","2","0","2","0","0","0","0","0","0","-2"
"165167","Cambridge College","2016","Not on tenure/no tenure system, professors","15","9","6","0","0","0","0","0","0","5","2","3","0","0","0","0","0","0","9","7","2","1","0","1","0","0","0","0","0","0","-2"
"165167","Cambridge College","2016","Not on tenure/no tenure system, associate professors","4","0","4","0","0","0","0","0","0","0","0","0","0","0","0","0","0","0","3","0","3","1","0","1","0","0","0","0","0","0","-2"
"165167","Cambridge College","2016","Not on tenure/no tenure system, assistant professors","2","1","1","0","0","0","0","0","0","0","0","0","0","0","0","0","0","0","2","1","1","0","0","0","0","0","0","0","0","0","-2"
"165167","Cambridge College","2016","Not on tenure/no tenure system, lecturers","1","1","0","0","0","0","0","0","0","1","1","0","0","0","0","0","0","0","0","0","0","0","0","0","0","0","0","0","0","0","-2"
"165884","Benjamin Franklin Institute of Technology","2016","Not on tenure track/No tenure system system total","35","26","9","0","0","0","1","1","0","1","1","0","2","2","0","0","0","0","31","22","9","0","0","0","0","0","0","0","0","0","-2"
"165884","Benjamin Franklin Institute of Technology","2016","Not on tenure/no tenure system, professors","3","1","2","0","0","0","0","0","0","0","0","0","0","0","0","0","0","0","3","1","2","0","0","0","0","0","0","0","0","0","-2"
"165884","Benjamin Franklin Institute of Technology","2016","Not on tenure/no tenure system, associate professors","9","7","2","0","0","0","0","0","0","0","0","0","0","0","0","0","0","0","9","7","2","0","0","0","0","0","0","0","0","0","-2"
"165884","Benjamin Franklin Institute of Technology","2016","Not on tenure/no tenure system, assistant professors","10","8","2","0","0","0","1","1","0","1","1","0","0","0","0","0","0","0","8","6","2","0","0","0","0","0","0","0","0","0","-2"
"165884","Benjamin Franklin Institute of Technology","2016","Not on tenure/no tenure system, instructors","13","10","3","0","0","0","0","0","0","0","0","0","2","2","0","0","0","0","11","8","3","0","0","0","0","0","0","0","0","0","-2"
"182005","College of Southern Nevada","2016","Tenured total","353","194","159","3","2","1","30","14","16","15","7","8","23","9","14","0","0","0","278","158","120","2","2","0","0","0","0","2","2","0","-2"
"182005","College of Southern Nevada","2016","Tenured, professors","353","194","159","3","2","1","30","14","16","15","7","8","23","9","14","0","0","0","278","158","120","2","2","0","0","0","0","2","2","0","-2"
"182005","College of Southern Nevada","2016","On-Tenure track total","97","40","57","1","0","1","4","3","1","6","1","5","9","5","4","0","0","0","75","30","45","2","1","1","0","0","0","0","0","0","-2"
"182005","College of Southern Nevada","2016","On-tenure track, instructors","97","40","57","1","0","1","4","3","1","6","1","5","9","5","4","0","0","0","75","30","45","2","1","1","0","0","0","0","0","0","-2"
"182005","College of Southern Nevada","2016","Not on tenure track/No tenure system system total","54","29","25","0","0","0","1","1","0","4","1","3","7","6","1","0","0","0","41","21","20","1","0","1","0","0","0","0","0","0","-2"
"182005","College of Southern Nevada","2016","Not on tenure/no tenure system, instructors","54","29","25","0","0","0","1","1","0","4","1","3","7","6","1","0","0","0","41","21","20","1","0","1","0","0","0","0","0","0","-2"
"182500","Truckee Meadows Community College","2016","Tenured total","101","50","51","1","1","0","4","0","4","1","0","1","6","3","3","0","0","0","88","46","42","1","0","1","0","0","0","0","0","0","-2"
"182500","Truckee Meadows Community College","2016","Tenured, professors","101","50","51","1","1","0","4","0","4","1","0","1","6","3","3","0","0","0","88","46","42","1","0","1","0","0","0","0","0","0","-2"
"182500","Truckee Meadows Community College","2016","On-Tenure track total","35","18","17","1","1","0","3","3","0","0","0","0","4","2","2","0","0","0","27","12","15","0","0","0","0","0","0","0","0","0","-2"
"182500","Truckee Meadows Community College","2016","On-tenure track, instructors","35","18","17","1","1","0","3","3","0","0","0","0","4","2","2","0","0","0","27","12","15","0","0","0","0","0","0","0","0","0","-2"
"182500","Truckee Meadows Community College","2016","Not on tenure track/No tenure system system total","23","18","5","0","0","0","0","0","0","0","0","0","2","2","0","0","0","0","21","16","5","0","0","0","0","0","0","0","0","0","-2"
"182500","Truckee Meadows Community College","2016","Not on tenure/no tenure system, instructors","23","18","5","0","0","0","0","0","0","0","0","0","2","2","0","0","0","0","21","16","5","0","0","0","0","0","0","0","0","0","-2"
"183822","Bloomfield College","2016","Tenured total","46","17","29","0","0","0","2","1","1","7","3","4","2","0","2","0","0","0","35","13","22","0","0","0","0","0","0","0","0","0","-2"
"183822","Bloomfield College","2016","Tenured, professors","30","11","19","0","0","0","0","0","0","5","1","4","1","0","1","0","0","0","24","10","14","0","0","0","0","0","0","0","0","0","-2"
"183822","Bloomfield College","2016","Tenured, associate professors","16","6","10","0","0","0","2","1","1","2","2","0","1","0","1","0","0","0","11","3","8","0","0","0","0","0","0","0","0","0","-2"
"183822","Bloomfield College","2016","On-Tenure track total","19","7","12","0","0","0","0","0","0","3","0","3","3","1","2","0","0","0","13","6","7","0","0","0","0","0","0","0","0","0","-2"
"183822","Bloomfield College","2016","On-tenure track, associate professors","3","1","2","0","0","0","0","0","0","0","0","0","1","0","1","0","0","0","2","1","1","0","0","0","0","0","0","0","0","0","-2"
"183822","Bloomfield College","2016","On-tenure track, assistant professors","14","6","8","0","0","0","0","0","0","3","0","3","2","1","1","0","0","0","9","5","4","0","0","0","0","0","0","0","0","0","-2"
"183822","Bloomfield College","2016","On-tenure track, instructors","2","0","2","0","0","0","0","0","0","0","0","0","0","0","0","0","0","0","2","0","2","0","0","0","0","0","0","0","0","0","-2"
"183822","Bloomfield College","2016","Not on tenure track/No tenure system system total","5","4","1","0","0","0","1","1","0","0","0","0","1","1","0","0","0","0","3","2","1","0","0","0","0","0","0","0","0","0","-2"
"183822","Bloomfield College","2016","Not on tenure/no tenure system, associate professors","1","1","0","0","0","0","0","0","0","0","0","0","0","0","0","0","0","0","1","1","0","0","0","0","0","0","0","0","0","0","-2"
"183822","Bloomfield College","2016","Not on tenure/no tenure system, assistant professors","2","2","0","0","0","0","0","0","0","0","0","0","1","1","0","0","0","0","1","1","0","0","0","0","0","0","0","0","0","0","-2"
"183822","Bloomfield College","2016","Not on tenure/no tenure system, instructors","2","1","1","0","0","0","1","1","0","0","0","0","0","0","0","0","0","0","1","0","1","0","0","0","0","0","0","0","0","0","-2"
"183910","Caldwell University","2016","Tenured total","46","21","25","0","0","0","2","1","1","1","0","1","1","1","0","0","0","0","41","19","22","0","0","0","1","0","1","0","0","0","-2"
"183910","Caldwell University","2016","Tenured, professors","36","17","19","0","0","0","1","0","1","1","0","1","1","1","0","0","0","0","33","16","17","0","0","0","0","0","0","0","0","0","-2"
"183910","Caldwell University","2016","Tenured, associate professors","9","4","5","0","0","0","1","1","0","0","0","0","0","0","0","0","0","0","7","3","4","0","0","0","1","0","1","0","0","0","-2"
"183910","Caldwell University","2016","Tenured, assistant professors","1","0","1","0","0","0","0","0","0","0","0","0","0","0","0","0","0","0","1","0","1","0","0","0","0","0","0","0","0","0","-2"
"183910","Caldwell University","2016","On-Tenure track total","28","8","20","0","0","0","3","2","1","1","0","1","2","0","2","0","0","0","22","6","16","0","0","0","0","0","0","0","0","0","-2"
"183910","Caldwell University","2016","On-tenure track, professors","1","0","1","0","0","0","0","0","0","0","0","0","0","0","0","0","0","0","1","0","1","0","0","0","0","0","0","0","0","0","-2"
"183910","Caldwell University","2016","On-tenure track, associate professors","6","3","3","0","0","0","1","1","0","0","0","0","0","0","0","0","0","0","5","2","3","0","0","0","0","0","0","0","0","0","-2"
"183910","Caldwell University","2016","On-tenure track, assistant professors","21","5","16","0","0","0","2","1","1","1","0","1","2","0","2","0","0","0","16","4","12","0","0","0","0","0","0","0","0","0","-2"
"183910","Caldwell University","2016","Not on tenure track/No tenure system system total","5","1","4","0","0","0","1","0","1","1","0","1","0","0","0","0","0","0","3","1","2","0","0","0","0","0","0","0","0","0","-2"
"183910","Caldwell University","2016","Not on tenure/no tenure system, assistant professors","2","1","1","0","0","0","1","0","1","0","0","0","0","0","0","0","0","0","1","1","0","0","0","0","0","0","0","0","0","0","-2"
"183910","Caldwell University","2016","Not on tenure/no tenure system, instructors","3","0","3","0","0","0","0","0","0","1","0","1","0","0","0","0","0","0","2","0","2","0","0","0","0","0","0","0","0","0","-2"
"184603","Fairleigh Dickinson University-Metropolitan Campus","2016","Tenured total","88","58","30","0","0","0","15","9","6","5","5","0","1","1","0","0","0","0","67","43","24","0","0","0","0","0","0","0","0","0","-2"
"184603","Fairleigh Dickinson University-Metropolitan Campus","2016","Tenured, professors","54","34","20","0","0","0","7","4","3","2","2","0","1","1","0","0","0","0","44","27","17","0","0","0","0","0","0","0","0","0","-2"
"184603","Fairleigh Dickinson University-Metropolitan Campus","2016","Tenured, associate professors","32","23","9","0","0","0","8","5","3","3","3","0","0","0","0","0","0","0","21","15","6","0","0","0","0","0","0","0","0","0","-2"
"184603","Fairleigh Dickinson University-Metropolitan Campus","2016","Tenured, assistant professors","2","1","1","0","0","0","0","0","0","0","0","0","0","0","0","0","0","0","2","1","1","0","0","0","0","0","0","0","0","0","-2"
"184603","Fairleigh Dickinson University-Metropolitan Campus","2016","On-Tenure track total","43","18","25","0","0","0","7","3","4","0","0","0","5","2","3","0","0","0","31","13","18","0","0","0","0","0","0","0","0","0","-2"
"184603","Fairleigh Dickinson University-Metropolitan Campus","2016","On-tenure track, professors","1","0","1","0","0","0","0","0","0","0","0","0","0","0","0","0","0","0","1","0","1","0","0","0","0","0","0","0","0","0","-2"
"184603","Fairleigh Dickinson University-Metropolitan Campus","2016","On-tenure track, associate professors","6","1","5","0","0","0","2","1","1","0","0","0","0","0","0","0","0","0","4","0","4","0","0","0","0","0","0","0","0","0","-2"
"184603","Fairleigh Dickinson University-Metropolitan Campus","2016","On-tenure track, assistant professors","34","16","18","0","0","0","5","2","3","0","0","0","5","2","3","0","0","0","24","12","12","0","0","0","0","0","0","0","0","0","-2"
"184603","Fairleigh Dickinson University-Metropolitan Campus","2016","On-tenure track, lecturers","2","1","1","0","0","0","0","0","0","0","0","0","0","0","0","0","0","0","2","1","1","0","0","0","0","0","0","0","0","0","-2"
"184603","Fairleigh Dickinson University-Metropolitan Campus","2016","Not on tenure track/No tenure system system total","55","28","27","0","0","0","6","2","4","3","1","2","12","6","6","0","0","0","34","19","15","0","0","0","0","0","0","0","0","0","-2"
"184603","Fairleigh Dickinson University-Metropolitan Campus","2016","Not on tenure/no tenure system, assistant professors","10","4","6","0","0","0","2","1","1","2","1","1","3","1","2","0","0","0","3","1","2","0","0","0","0","0","0","0","0","0","-2"
"184603","Fairleigh Dickinson University-Metropolitan Campus","2016","Not on tenure/no tenure system, instructors","5","2","3","0","0","0","1","1","0","0","0","0","1","1","0","0","0","0","3","0","3","0","0","0","0","0","0","0","0","0","-2"
"184603","Fairleigh Dickinson University-Metropolitan Campus","2016","Not on tenure/no tenure system, lecturers","40","22","18","0","0","0","3","0","3","1","0","1","8","4","4","0","0","0","28","18","10","0","0","0","0","0","0","0","0","0","-2"
"184612","Felician University","2016","Not on tenure track/No tenure system system total","85","31","54","0","0","0","3","2","1","4","0","4","3","1","2","0","0","0","75","28","47","0","0","0","0","0","0","0","0","0","-2"
"184612","Felician University","2016","Not on tenure/no tenure system, professors","15","5","10","0","0","0","0","0","0","1","0","1","0","0","0","0","0","0","14","5","9","0","0","0","0","0","0","0","0","0","-2"
"184612","Felician University","2016","Not on tenure/no tenure system, associate professors","31","15","16","0","0","0","1","0","1","0","0","0","2","1","1","0","0","0","28","14","14","0","0","0","0","0","0","0","0","0","-2"
"184612","Felician University","2016","Not on tenure/no tenure system, assistant professors","22","9","13","0","0","0","1","1","0","2","0","2","0","0","0","0","0","0","19","8","11","0","0","0","0","0","0","0","0","0","-2"
"184612","Felician University","2016","Not on tenure/no tenure system, instructors","17","2","15","0","0","0","1","1","0","1","0","1","1","0","1","0","0","0","14","1","13","0","0","0","0","0","0","0","0","0","-2"
"185129","New Jersey City University","2016","Tenured total","183","89","94","0","0","0","21","9","12","28","9","19","20","8","12","0","0","0","114","63","51","0","0","0","0","0","0","0","0","0","-2"
"185129","New Jersey City University","2016","Tenured, professors","91","46","45","0","0","0","14","6","8","13","4","9","10","5","5","0","0","0","54","31","23","0","0","0","0","0","0","0","0","0","-2"
"185129","New Jersey City University","2016","Tenured, associate professors","65","33","32","0","0","0","4","3","1","9","3","6","7","3","4","0","0","0","45","24","21","0","0","0","0","0","0","0","0","0","-2"
"185129","New Jersey City University","2016","Tenured, assistant professors","27","10","17","0","0","0","3","0","3","6","2","4","3","0","3","0","0","0","15","8","7","0","0","0","0","0","0","0","0","0","-2"
"185129","New Jersey City University","2016","On-Tenure track total","69","36","33","0","0","0","16","11","5","4","1","3","6","4","2","0","0","0","42","19","23","0","0","0","1","1","0","0","0","0","-2"
"185129","New Jersey City University","2016","On-tenure track, professors","1","1","0","0","0","0","0","0","0","0","0","0","1","1","0","0","0","0","0","0","0","0","0","0","0","0","0","0","0","0","-2"
"185129","New Jersey City University","2016","On-tenure track, associate professors","13","6","7","0","0","0","3","1","2","0","0","0","0","0","0","0","0","0","9","4","5","0","0","0","1","1","0","0","0","0","-2"
"185129","New Jersey City University","2016","On-tenure track, assistant professors","55","29","26","0","0","0","13","10","3","4","1","3","5","3","2","0","0","0","33","15","18","0","0","0","0","0","0","0","0","0","-2"
"185129","New Jersey City University","2016","Not on tenure track/No tenure system system total","4","3","1","0","0","0","0","0","0","0","0","0","1","0","1","0","0","0","3","3","0","0","0","0","0","0","0","0","0","0","-2"
"185129","New Jersey City University","2016","Not on tenure/no tenure system, assistant professors","4","3","1","0","0","0","0","0","0","0","0","0","1","0","1","0","0","0","3","3","0","0","0","0","0","0","0","0","0","0","-2"
"185590","Montclair State University","2016","Tenured total","416","217","199","0","0","0","62","32","30","32","15","17","30","16","14","0","0","0","279","145","134","7","6","1","3","2","1","3","1","2","-2"
"185590","Montclair State University","2016","Tenured, professors","174","97","77","0","0","0","25","14","11","13","6","7","13","8","5","0","0","0","121","67","54","2","2","0","0","0","0","0","0","0","-2"
"185590","Montclair State University","2016","Tenured, associate professors","220","108","112","0","0","0","35","17","18","16","9","7","16","7","9","0","0","0","143","69","74","5","4","1","3","2","1","2","0","2","-2"
"185590","Montclair State University","2016","Tenured, assistant professors","22","12","10","0","0","0","2","1","1","3","0","3","1","1","0","0","0","0","15","9","6","0","0","0","0","0","0","1","1","0","-2"
"185590","Montclair State University","2016","On-Tenure track total","112","58","54","0","0","0","10","6","4","6","4","2","4","3","1","0","0","0","61","30","31","1","0","1","20","9","11","10","6","4","-2"
"185590","Montclair State University","2016","On-tenure track, professors","1","1","0","0","0","0","0","0","0","0","0","0","0","0","0","0","0","0","1","1","0","0","0","0","0","0","0","0","0","0","-2"
"185590","Montclair State University","2016","On-tenure track, associate professors","14","9","5","0","0","0","2","0","2","2","2","0","2","2","0","0","0","0","6","3","3","0","0","0","1","1","0","1","1","0","-2"
"185590","Montclair State University","2016","On-tenure track, assistant professors","97","48","49","0","0","0","8","6","2","4","2","2","2","1","1","0","0","0","54","26","28","1","0","1","19","8","11","9","5","4","-2"
"185590","Montclair State University","2016","Not on tenure track/No tenure system system total","92","39","53","0","0","0","5","4","1","2","0","2","7","2","5","0","0","0","60","27","33","1","0","1","17","6","11","0","0","0","-2"
"185590","Montclair State University","2016","Not on tenure/no tenure system, assistant professors","11","8","3","0","0","0","3","2","1","0","0","0","0","0","0","0","0","0","5","5","0","0","0","0","3","1","2","0","0","0","-2"
"185590","Montclair State University","2016","Not on tenure/no tenure system, instructors","6","1","5","0","0","0","0","0","0","1","0","1","1","0","1","0","0","0","2","1","1","0","0","0","2","0","2","0","0","0","-2"
"185590","Montclair State University","2016","Not on tenure/no tenure system, no academic rank","75","30","45","0","0","0","2","2","0","1","0","1","6","2","4","0","0","0","53","21","32","1","0","1","12","5","7","0","0","0","-2"
"186399","Rutgers University-Newark","2016","Tenured total","283","193","90","1","0","1","36","27","9","21","12","9","9","7","2","0","0","0","177","122","55","1","1","0","17","11","6","21","13","8","-2"
"186399","Rutgers University-Newark","2016","Tenured, professors","168","126","42","0","0","0","23","19","4","7","5","2","4","4","0","0","0","0","123","91","32","0","0","0","4","3","1","7","4","3","-2"
"186399","Rutgers University-Newark","2016","Tenured, associate professors","115","67","48","1","0","1","13","8","5","14","7","7","5","3","2","0","0","0","54","31","23","1","1","0","13","8","5","14","9","5","-2"
"186399","Rutgers University-Newark","2016","On-Tenure track total","104","64","40","0","0","0","7","5","2","3","0","3","3","2","1","0","0","0","27","18","9","3","1","2","32","16","16","29","22","7","-2"
"186399","Rutgers University-Newark","2016","On-tenure track, professors","3","1","2","0","0","0","0","0","0","1","0","1","0","0","0","0","0","0","2","1","1","0","0","0","0","0","0","0","0","0","-2"
"186399","Rutgers University-Newark","2016","On-tenure track, associate professors","13","8","5","0","0","0","0","0","0","0","0","0","0","0","0","0","0","0","3","2","1","0","0","0","5","3","2","5","3","2","-2"
"186399","Rutgers University-Newark","2016","On-tenure track, assistant professors","88","55","33","0","0","0","7","5","2","2","0","2","3","2","1","0","0","0","22","15","7","3","1","2","27","13","14","24","19","5","-2"
"186399","Rutgers University-Newark","2016","Not on tenure track/No tenure system system total","144","90","54","0","0","0","9","4","5","14","9","5","4","3","1","0","0","0","76","50","26","0","0","0","38","22","16","3","2","1","-2"
"186399","Rutgers University-Newark","2016","Not on tenure/no tenure system, professors","12","7","5","0","0","0","0","0","0","2","1","1","1","1","0","0","0","0","8","4","4","0","0","0","1","1","0","0","0","0","-2"
"186399","Rutgers University-Newark","2016","Not on tenure/no tenure system, associate professors","16","12","4","0","0","0","0","0","0","1","1","0","0","0","0","0","0","0","11","9","2","0","0","0","4","2","2","0","0","0","-2"
"186399","Rutgers University-Newark","2016","Not on tenure/no tenure system, assistant professors","62","44","18","0","0","0","4","2","2","4","3","1","1","1","0","0","0","0","34","26","8","0","0","0","17","11","6","2","1","1","-2"
"186399","Rutgers University-Newark","2016","Not on tenure/no tenure system, instructors","52","26","26","0","0","0","4","2","2","7","4","3","2","1","1","0","0","0","22","10","12","0","0","0","16","8","8","1","1","0","-2"
"186399","Rutgers University-Newark","2016","Not on tenure/no tenure system, lecturers","2","1","1","0","0","0","1","0","1","0","0","0","0","0","0","0","0","0","1","1","0","0","0","0","0","0","0","0","0","0","-2"
"186432","Saint Peter's University","2016","Tenured total","67","37","30","0","0","0","3","2","1","3","1","2","3","1","2","0","0","0","58","33","25","0","0","0","0","0","0","0","0","0","-2"
"186432","Saint Peter's University","2016","Tenured, professors","31","18","13","0","0","0","0","0","0","0","0","0","1","0","1","0","0","0","30","18","12","0","0","0","0","0","0","0","0","0","-2"
"186432","Saint Peter's University","2016","Tenured, associate professors","29","14","15","0","0","0","2","2","0","1","0","1","2","1","1","0","0","0","24","11","13","0","0","0","0","0","0","0","0","0","-2"
"186432","Saint Peter's University","2016","Tenured, assistant professors","5","4","1","0","0","0","0","0","0","2","1","1","0","0","0","0","0","0","3","3","0","0","0","0","0","0","0","0","0","0","-2"
"186432","Saint Peter's University","2016","Tenured, lecturers","2","1","1","0","0","0","1","0","1","0","0","0","0","0","0","0","0","0","1","1","0","0","0","0","0","0","0","0","0","0","-2"
"186432","Saint Peter's University","2016","On-Tenure track total","33","19","14","0","0","0","2","1","1","3","2","1","5","3","2","0","0","0","23","13","10","0","0","0","0","0","0","0","0","0","-2"
"186432","Saint Peter's University","2016","On-tenure track, professors","1","1","0","0","0","0","0","0","0","0","0","0","1","1","0","0","0","0","0","0","0","0","0","0","0","0","0","0","0","0","-2"
"186432","Saint Peter's University","2016","On-tenure track, associate professors","4","2","2","0","0","0","0","0","0","0","0","0","0","0","0","0","0","0","4","2","2","0","0","0","0","0","0","0","0","0","-2"
"186432","Saint Peter's University","2016","On-tenure track, assistant professors","28","16","12","0","0","0","2","1","1","3","2","1","4","2","2","0","0","0","19","11","8","0","0","0","0","0","0","0","0","0","-2"
"186432","Saint Peter's University","2016","Not on tenure track/No tenure system system total","18","6","12","0","0","0","0","0","0","2","0","2","0","0","0","0","0","0","16","6","10","0","0","0","0","0","0","0","0","0","-2"
"186432","Saint Peter's University","2016","Not on tenure/no tenure system, instructors","6","3","3","0","0","0","0","0","0","1","0","1","0","0","0","0","0","0","5","3","2","0","0","0","0","0","0","0","0","0","-2"
"186432","Saint Peter's University","2016","Not on tenure/no tenure system, lecturers","7","3","4","0","0","0","0","0","0","1","0","1","0","0","0","0","0","0","6","3","3","0","0","0","0","0","0","0","0","0","-2"
"186432","Saint Peter's University","2016","Not on tenure/no tenure system, no academic rank","5","0","5","0","0","0","0","0","0","0","0","0","0","0","0","0","0","0","5","0","5","0","0","0","0","0","0","0","0","0","-2"
"187444","William Paterson University of New Jersey","2016","Tenured total","308","163","145","1","0","1","55","32","23","26","19","7","24","10","14","0","0","0","192","99","93","4","1","3","2","1","1","4","1","3","-2"
"187444","William Paterson University of New Jersey","2016","Tenured, professors","174","106","68","1","0","1","38","27","11","14","10","4","11","6","5","0","0","0","104","60","44","3","1","2","2","1","1","1","1","0","-2"
"187444","William Paterson University of New Jersey","2016","Tenured, associate professors","119","52","67","0","0","0","15","5","10","10","8","2","11","4","7","0","0","0","79","35","44","1","0","1","0","0","0","3","0","3","-2"
"187444","William Paterson University of New Jersey","2016","Tenured, assistant professors","15","5","10","0","0","0","2","0","2","2","1","1","2","0","2","0","0","0","9","4","5","0","0","0","0","0","0","0","0","0","-2"
"187444","William Paterson University of New Jersey","2016","On-Tenure track total","83","35","48","0","0","0","17","6","11","8","3","5","3","2","1","0","0","0","48","19","29","0","0","0","0","0","0","7","5","2","-2"
"187444","William Paterson University of New Jersey","2016","On-tenure track, professors","1","1","0","0","0","0","0","0","0","0","0","0","0","0","0","0","0","0","1","1","0","0","0","0","0","0","0","0","0","0","-2"
"187444","William Paterson University of New Jersey","2016","On-tenure track, associate professors","8","4","4","0","0","0","3","3","0","0","0","0","0","0","0","0","0","0","5","1","4","0","0","0","0","0","0","0","0","0","-2"
"187444","William Paterson University of New Jersey","2016","On-tenure track, assistant professors","71","29","42","0","0","0","14","3","11","7","3","4","3","2","1","0","0","0","40","16","24","0","0","0","0","0","0","7","5","2","-2"
"187444","William Paterson University of New Jersey","2016","On-tenure track, instructors","3","1","2","0","0","0","0","0","0","1","0","1","0","0","0","0","0","0","2","1","1","0","0","0","0","0","0","0","0","0","-2"
"187444","William Paterson University of New Jersey","2016","Not on tenure track/No tenure system system total","19","9","10","0","0","0","2","0","2","2","0","2","1","0","1","0","0","0","12","8","4","0","0","0","2","1","1","0","0","0","-2"
"187444","William Paterson University of New Jersey","2016","Not on tenure/no tenure system, assistant professors","10","5","5","0","0","0","2","0","2","1","0","1","1","0","1","0","0","0","5","4","1","0","0","0","1","1","0","0","0","0","-2"
"187444","William Paterson University of New Jersey","2016","Not on tenure/no tenure system, instructors","9","4","5","0","0","0","0","0","0","1","0","1","0","0","0","0","0","0","7","4","3","0","0","0","1","0","1","0","0","0","-2"
"187648","Eastern New Mexico University-Main Campus","2016","Tenured total","63","35","28","0","0","0","2","2","0","0","0","0","4","2","2","0","0","0","50","27","23","0","0","0","0","0","0","7","4","3","-2"
"187648","Eastern New Mexico University-Main Campus","2016","Tenured, professors","35","23","12","0","0","0","2","2","0","0","0","0","2","1","1","0","0","0","29","18","11","0","0","0","0","0","0","2","2","0","-2"
"187648","Eastern New Mexico University-Main Campus","2016","Tenured, associate professors","23","10","13","0","0","0","0","0","0","0","0","0","2","1","1","0","0","0","16","7","9","0","0","0","0","0","0","5","2","3","-2"
"187648","Eastern New Mexico University-Main Campus","2016","Tenured, instructors","5","2","3","0","0","0","0","0","0","0","0","0","0","0","0","0","0","0","5","2","3","0","0","0","0","0","0","0","0","0","-2"
"187648","Eastern New Mexico University-Main Campus","2016","On-Tenure track total","60","33","27","0","0","0","1","0","1","1","1","0","4","1","3","0","0","0","41","21","20","0","0","0","3","2","1","10","8","2","-2"
"187648","Eastern New Mexico University-Main Campus","2016","On-tenure track, associate professors","2","2","0","0","0","0","0","0","0","1","1","0","0","0","0","0","0","0","1","1","0","0","0","0","0","0","0","0","0","0","-2"
"187648","Eastern New Mexico University-Main Campus","2016","On-tenure track, assistant professors","55","31","24","0","0","0","1","0","1","0","0","0","3","1","2","0","0","0","38","20","18","0","0","0","3","2","1","10","8","2","-2"
"187648","Eastern New Mexico University-Main Campus","2016","On-tenure track, instructors","3","0","3","0","0","0","0","0","0","0","0","0","1","0","1","0","0","0","2","0","2","0","0","0","0","0","0","0","0","0","-2"
"187648","Eastern New Mexico University-Main Campus","2016","Not on tenure track/No tenure system system total","38","13","25","0","0","0","0","0","0","0","0","0","4","1","3","0","0","0","31","11","20","1","0","1","2","1","1","0","0","0","-2"
"187648","Eastern New Mexico University-Main Campus","2016","Not on tenure/no tenure system, assistant professors","3","2","1","0","0","0","0","0","0","0","0","0","0","0","0","0","0","0","3","2","1","0","0","0","0","0","0","0","0","0","-2"
"187648","Eastern New Mexico University-Main Campus","2016","Not on tenure/no tenure system, instructors","35","11","24","0","0","0","0","0","0","0","0","0","4","1","3","0","0","0","28","9","19","1","0","1","2","1","1","0","0","0","-2"
"187897","New Mexico Highlands University","2016","Tenured total","52","34","18","0","0","0","2","1","1","2","1","1","9","7","2","0","0","0","33","22","11","2","1","1","2","1","1","2","1","1","-2"
"187897","New Mexico Highlands University","2016","Tenured, professors","25","14","11","0","0","0","0","0","0","0","0","0","3","3","0","0","0","0","20","11","9","0","0","0","1","0","1","1","0","1","-2"
"187897","New Mexico Highlands University","2016","Tenured, associate professors","26","19","7","0","0","0","2","1","1","2","1","1","5","3","2","0","0","0","13","11","2","2","1","1","1","1","0","1","1","0","-2"
"187897","New Mexico Highlands University","2016","Tenured, assistant professors","1","1","0","0","0","0","0","0","0","0","0","0","1","1","0","0","0","0","0","0","0","0","0","0","0","0","0","0","0","0","-2"
"187897","New Mexico Highlands University","2016","On-Tenure track total","41","19","22","2","2","0","1","1","0","0","0","0","9","5","4","0","0","0","22","9","13","0","0","0","2","0","2","5","2","3","-2"
"187897","New Mexico Highlands University","2016","On-tenure track, associate professors","7","3","4","1","1","0","1","1","0","0","0","0","3","1","2","0","0","0","2","0","2","0","0","0","0","0","0","0","0","0","-2"
"187897","New Mexico Highlands University","2016","On-tenure track, assistant professors","34","16","18","1","1","0","0","0","0","0","0","0","6","4","2","0","0","0","20","9","11","0","0","0","2","0","2","5","2","3","-2"
"187897","New Mexico Highlands University","2016","Not on tenure track/No tenure system system total","40","17","23","1","0","1","2","1","1","0","0","0","11","4","7","0","0","0","22","10","12","0","0","0","1","0","1","3","2","1","-2"
"187897","New Mexico Highlands University","2016","Not on tenure/no tenure system, assistant professors","4","3","1","0","0","0","0","0","0","0","0","0","2","2","0","0","0","0","2","1","1","0","0","0","0","0","0","0","0","0","-2"
"187897","New Mexico Highlands University","2016","Not on tenure/no tenure system, instructors","12","6","6","0","0","0","2","1","1","0","0","0","4","2","2","0","0","0","6","3","3","0","0","0","0","0","0","0","0","0","-2"
"187897","New Mexico Highlands University","2016","Not on tenure/no tenure system, no academic rank","24","8","16","1","0","1","0","0","0","0","0","0","5","0","5","0","0","0","14","6","8","0","0","0","1","0","1","3","2","1","-2"
"187985","University of New Mexico-Main Campus","2016","Tenured total","600","341","259","18","6","12","63","43","20","9","4","5","75","32","43","0","0","0","405","240","165","2","0","2","24","12","12","4","4","0","-2"
"187985","University of New Mexico-Main Campus","2016","Tenured, professors","314","206","108","9","4","5","36","26","10","2","1","1","30","15","15","0","0","0","230","156","74","0","0","0","6","3","3","1","1","0","-2"
"187985","University of New Mexico-Main Campus","2016","Tenured, associate professors","285","134","151","9","2","7","27","17","10","7","3","4","44","16","28","0","0","0","175","84","91","2","0","2","18","9","9","3","3","0","-2"
"187985","University of New Mexico-Main Campus","2016","Tenured, assistant professors","1","1","0","0","0","0","0","0","0","0","0","0","1","1","0","0","0","0","0","0","0","0","0","0","0","0","0","0","0","0","-2"
"187985","University of New Mexico-Main Campus","2016","On-Tenure track total","292","149","143","10","2","8","27","16","11","7","3","4","38","17","21","0","0","0","134","67","67","2","2","0","39","21","18","35","21","14","-2"
"187985","University of New Mexico-Main Campus","2016","On-tenure track, professors","3","3","0","0","0","0","1","1","0","0","0","0","0","0","0","0","0","0","2","2","0","0","0","0","0","0","0","0","0","0","-2"
"187985","University of New Mexico-Main Campus","2016","On-tenure track, associate professors","17","9","8","0","0","0","1","1","0","2","2","0","2","0","2","0","0","0","10","5","5","1","1","0","1","0","1","0","0","0","-2"
"187985","University of New Mexico-Main Campus","2016","On-tenure track, assistant professors","271","136","135","10","2","8","25","14","11","5","1","4","36","17","19","0","0","0","122","60","62","1","1","0","37","20","17","35","21","14","-2"
"187985","University of New Mexico-Main Campus","2016","On-tenure track, no academic rank","1","1","0","0","0","0","0","0","0","0","0","0","0","0","0","0","0","0","0","0","0","0","0","0","1","1","0","0","0","0","-2"
"187985","University of New Mexico-Main Campus","2016","Not on tenure track/No tenure system system total","837","378","459","5","2","3","67","43","24","14","3","11","117","46","71","1","0","1","553","246","307","13","3","10","26","12","14","41","23","18","-2"
"187985","University of New Mexico-Main Campus","2016","Not on tenure/no tenure system, professors","102","61","41","1","1","0","8","5","3","0","0","0","4","3","1","0","0","0","84","49","35","1","1","0","4","2","2","0","0","0","-2"
"187985","University of New Mexico-Main Campus","2016","Not on tenure/no tenure system, associate professors","144","66","78","1","0","1","16","9","7","3","0","3","20","6","14","1","0","1","98","47","51","1","1","0","2","1","1","2","2","0","-2"
"187985","University of New Mexico-Main Campus","2016","Not on tenure/no tenure system, assistant professors","331","153","178","0","0","0","35","24","11","5","1","4","50","23","27","0","0","0","192","85","107","8","1","7","9","3","6","32","16","16","-2"
"187985","University of New Mexico-Main Campus","2016","Not on tenure/no tenure system, instructors","64","27","37","0","0","0","5","4","1","0","0","0","6","2","4","0","0","0","49","18","31","0","0","0","3","2","1","1","1","0","-2"
"187985","University of New Mexico-Main Campus","2016","Not on tenure/no tenure system, lecturers","192","69","123","2","1","1","3","1","2","6","2","4","36","11","25","0","0","0","129","47","82","3","0","3","8","4","4","5","3","2","-2"
"187985","University of New Mexico-Main Campus","2016","Not on tenure/no tenure system, no academic rank","4","2","2","1","0","1","0","0","0","0","0","0","1","1","0","0","0","0","1","0","1","0","0","0","0","0","0","1","1","0","-2"
"188030","New Mexico State University-Main Campus","2016","Tenured total","385","245","140","4","3","1","45","34","11","5","5","0","50","24","26","0","0","0","272","172","100","2","1","1","0","0","0","7","6","1","-2"
"188030","New Mexico State University-Main Campus","2016","Tenured, professors","197","143","54","2","2","0","21","17","4","3","3","0","14","9","5","0","0","0","155","110","45","0","0","0","0","0","0","2","2","0","-2"
"188030","New Mexico State University-Main Campus","2016","Tenured, associate professors","181","99","82","1","0","1","24","17","7","2","2","0","35","15","20","0","0","0","112","60","52","2","1","1","0","0","0","5","4","1","-2"
"188030","New Mexico State University-Main Campus","2016","Tenured, assistant professors","7","3","4","1","1","0","0","0","0","0","0","0","1","0","1","0","0","0","5","2","3","0","0","0","0","0","0","0","0","0","-2"
"188030","New Mexico State University-Main Campus","2016","On-Tenure track total","148","78","70","2","2","0","12","6","6","5","1","4","28","14","14","0","0","0","77","40","37","2","1","1","2","1","1","20","13","7","-2"
"188030","New Mexico State University-Main Campus","2016","On-tenure track, associate professors","5","3","2","1","1","0","0","0","0","0","0","0","0","0","0","0","0","0","4","2","2","0","0","0","0","0","0","0","0","0","-2"
"188030","New Mexico State University-Main Campus","2016","On-tenure track, assistant professors","143","75","68","1","1","0","12","6","6","5","1","4","28","14","14","0","0","0","73","38","35","2","1","1","2","1","1","20","13","7","-2"
"188030","New Mexico State University-Main Campus","2016","Not on tenure track/No tenure system system total","117","44","73","1","1","0","2","1","1","2","0","2","23","4","19","0","0","0","74","30","44","4","1","3","8","5","3","3","2","1","-2"
"188030","New Mexico State University-Main Campus","2016","Not on tenure/no tenure system, professors","15","7","8","0","0","0","0","0","0","0","0","0","0","0","0","0","0","0","15","7","8","0","0","0","0","0","0","0","0","0","-2"
"188030","New Mexico State University-Main Campus","2016","Not on tenure/no tenure system, associate professors","24","7","17","1","1","0","0","0","0","1","0","1","5","0","5","0","0","0","16","5","11","1","1","0","0","0","0","0","0","0","-2"
"188030","New Mexico State University-Main Campus","2016","Not on tenure/no tenure system, assistant professors","52","16","36","0","0","0","1","0","1","0","0","0","13","2","11","0","0","0","33","12","21","2","0","2","1","1","0","2","1","1","-2"
"188030","New Mexico State University-Main Campus","2016","Not on tenure/no tenure system, instructors","8","4","4","0","0","0","1","1","0","0","0","0","2","0","2","0","0","0","5","3","2","0","0","0","0","0","0","0","0","0","-2"
"188030","New Mexico State University-Main Campus","2016","Not on tenure/no tenure system, no academic rank","18","10","8","0","0","0","0","0","0","1","0","1","3","2","1","0","0","0","5","3","2","1","0","1","7","4","3","1","1","0","-2"
"188058","Northern New Mexico College","2016","Tenured total","16","6","10","1","1","0","1","1","0","0","0","0","9","2","7","0","0","0","4","2","2","0","0","0","1","0","1","0","0","0","-2"
"188058","Northern New Mexico College","2016","Tenured, associate professors","16","6","10","1","1","0","1","1","0","0","0","0","9","2","7","0","0","0","4","2","2","0","0","0","1","0","1","0","0","0","-2"
"188058","Northern New Mexico College","2016","On-Tenure track total","19","8","11","0","0","0","3","2","1","0","0","0","8","3","5","0","0","0","6","2","4","0","0","0","2","1","1","0","0","0","-2"
"188058","Northern New Mexico College","2016","On-tenure track, assistant professors","19","8","11","0","0","0","3","2","1","0","0","0","8","3","5","0","0","0","6","2","4","0","0","0","2","1","1","0","0","0","-2"
"188058","Northern New Mexico College","2016","Not on tenure track/No tenure system system total","4","3","1","0","0","0","0","0","0","0","0","0","0","0","0","0","0","0","3","2","1","0","0","0","1","1","0","0","0","0","-2"
"188058","Northern New Mexico College","2016","Not on tenure/no tenure system, assistant professors","2","1","1","0","0","0","0","0","0","0","0","0","0","0","0","0","0","0","2","1","1","0","0","0","0","0","0","0","0","0","-2"
"188058","Northern New Mexico College","2016","Not on tenure/no tenure system, instructors","2","2","0","0","0","0","0","0","0","0","0","0","0","0","0","0","0","0","1","1","0","0","0","0","1","1","0","0","0","0","-2"
"188182","University of the Southwest","2016","Not on tenure track/No tenure system system total","35","16","19","0","0","0","2","1","1","3","1","2","3","1","2","0","0","0","27","13","14","0","0","0","0","0","0","0","0","0","-2"
"188182","University of the Southwest","2016","Not on tenure/no tenure system, professors","4","1","3","0","0","0","0","0","0","0","0","0","0","0","0","0","0","0","4","1","3","0","0","0","0","0","0","0","0","0","-2"
"188182","University of the Southwest","2016","Not on tenure/no tenure system, associate professors","5","2","3","0","0","0","0","0","0","0","0","0","1","0","1","0","0","0","4","2","2","0","0","0","0","0","0","0","0","0","-2"
"188182","University of the Southwest","2016","Not on tenure/no tenure system, assistant professors","18","8","10","0","0","0","2","1","1","2","0","2","2","1","1","0","0","0","12","6","6","0","0","0","0","0","0","0","0","0","-2"
"188182","University of the Southwest","2016","Not on tenure/no tenure system, instructors","4","2","2","0","0","0","0","0","0","0","0","0","0","0","0","0","0","0","4","2","2","0","0","0","0","0","0","0","0","0","-2"
"188182","University of the Southwest","2016","Not on tenure/no tenure system, lecturers","4","3","1","0","0","0","0","0","0","1","1","0","0","0","0","0","0","0","3","2","1","0","0","0","0","0","0","0","0","0","-2"
"188304","Western New Mexico University","2016","Tenured total","29","13","16","0","0","0","0","0","0","0","0","0","1","0","1","0","0","0","21","9","12","0","0","0","7","4","3","0","0","0","-2"
"188304","Western New Mexico University","2016","Tenured, professors","25","13","12","0","0","0","0","0","0","0","0","0","0","0","0","0","0","0","19","9","10","0","0","0","6","4","2","0","0","0","-2"
"188304","Western New Mexico University","2016","Tenured, associate professors","4","0","4","0","0","0","0","0","0","0","0","0","1","0","1","0","0","0","2","0","2","0","0","0","1","0","1","0","0","0","-2"
"188304","Western New Mexico University","2016","On-Tenure track total","53","19","34","0","0","0","5","3","2","1","1","0","8","4","4","0","0","0","31","8","23","0","0","0","8","3","5","0","0","0","-2"
"188304","Western New Mexico University","2016","On-tenure track, associate professors","4","1","3","0","0","0","0","0","0","0","0","0","1","1","0","0","0","0","1","0","1","0","0","0","2","0","2","0","0","0","-2"
"188304","Western New Mexico University","2016","On-tenure track, assistant professors","47","18","29","0","0","0","5","3","2","1","1","0","6","3","3","0","0","0","30","8","22","0","0","0","5","3","2","0","0","0","-2"
"188304","Western New Mexico University","2016","On-tenure track, instructors","2","0","2","0","0","0","0","0","0","0","0","0","1","0","1","0","0","0","0","0","0","0","0","0","1","0","1","0","0","0","-2"
"188304","Western New Mexico University","2016","Not on tenure track/No tenure system system total","15","6","9","0","0","0","1","0","1","0","0","0","2","0","2","0","0","0","8","3","5","0","0","0","4","3","1","0","0","0","-2"
"188304","Western New Mexico University","2016","Not on tenure/no tenure system, assistant professors","11","2","9","0","0","0","1","0","1","0","0","0","2","0","2","0","0","0","7","2","5","0","0","0","1","0","1","0","0","0","-2"
"188304","Western New Mexico University","2016","Not on tenure/no tenure system, lecturers","4","4","0","0","0","0","0","0","0","0","0","0","0","0","0","0","0","0","1","1","0","0","0","0","3","3","0","0","0","0","-2"
"188340","Vaughn College of Aeronautics and Technology","2016","Tenured total","20","16","4","0","0","0","0","0","0","1","0","1","0","0","0","3","3","0","16","13","3","0","0","0","0","0","0","0","0","0","-2"
"188340","Vaughn College of Aeronautics and Technology","2016","Tenured, professors","12","10","2","0","0","0","0","0","0","1","0","1","0","0","0","2","2","0","9","8","1","0","0","0","0","0","0","0","0","0","-2"
"188340","Vaughn College of Aeronautics and Technology","2016","Tenured, associate professors","8","6","2","0","0","0","0","0","0","0","0","0","0","0","0","1","1","0","7","5","2","0","0","0","0","0","0","0","0","0","-2"
"188340","Vaughn College of Aeronautics and Technology","2016","On-Tenure track total","11","7","4","0","0","0","4","2","2","0","0","0","1","1","0","1","1","0","5","3","2","0","0","0","0","0","0","0","0","0","-2"
"188340","Vaughn College of Aeronautics and Technology","2016","On-tenure track, associate professors","1","0","1","0","0","0","1","0","1","0","0","0","0","0","0","0","0","0","0","0","0","0","0","0","0","0","0","0","0","0","-2"
"188340","Vaughn College of Aeronautics and Technology","2016","On-tenure track, assistant professors","10","7","3","0","0","0","3","2","1","0","0","0","1","1","0","1","1","0","5","3","2","0","0","0","0","0","0","0","0","0","-2"
"188340","Vaughn College of Aeronautics and Technology","2016","Not on tenure track/No tenure system system total","9","8","1","0","0","0","0","0","0","2","2","0","0","0","0","2","2","0","5","4","1","0","0","0","0","0","0","0","0","0","-2"
"188340","Vaughn College of Aeronautics and Technology","2016","Not on tenure/no tenure system, associate professors","2","2","0","0","0","0","0","0","0","1","1","0","0","0","0","0","0","0","1","1","0","0","0","0","0","0","0","0","0","0","-2"
"188340","Vaughn College of Aeronautics and Technology","2016","Not on tenure/no tenure system, assistant professors","4","3","1","0","0","0","0","0","0","0","0","0","0","0","0","1","1","0","3","2","1","0","0","0","0","0","0","0","0","0","-2"
"188340","Vaughn College of Aeronautics and Technology","2016","Not on tenure/no tenure system, instructors","3","3","0","0","0","0","0","0","0","1","1","0","0","0","0","1","1","0","1","1","0","0","0","0","0","0","0","0","0","0","-2"
"189413","Boricua College","2016","Not on tenure track/No tenure system system total","44","20","24","0","0","0","0","0","0","3","1","2","36","19","17","0","0","0","5","0","5","0","0","0","0","0","0","0","0","0","-2"
"189413","Boricua College","2016","Not on tenure/no tenure system, professors","6","3","3","0","0","0","0","0","0","1","1","0","5","2","3","0","0","0","0","0","0","0","0","0","0","0","0","0","0","0","-2"
"189413","Boricua College","2016","Not on tenure/no tenure system, associate professors","10","5","5","0","0","0","0","0","0","0","0","0","8","5","3","0","0","0","2","0","2","0","0","0","0","0","0","0","0","0","-2"
"189413","Boricua College","2016","Not on tenure/no tenure system, assistant professors","18","10","8","0","0","0","0","0","0","0","0","0","17","10","7","0","0","0","1","0","1","0","0","0","0","0","0","0","0","0","-2"
"189413","Boricua College","2016","Not on tenure/no tenure system, instructors","10","2","8","0","0","0","0","0","0","2","0","2","6","2","4","0","0","0","2","0","2","0","0","0","0","0","0","0","0","0","-2"
"190114","Metropolitan College of New York","2016","Not on tenure track/No tenure system system total","23","14","9","0","0","0","2","1","1","4","2","2","1","0","1","0","0","0","15","11","4","0","0","0","1","0","1","0","0","0","-2"
"190114","Metropolitan College of New York","2016","Not on tenure/no tenure system, professors","12","8","4","0","0","0","1","0","1","0","0","0","1","0","1","0","0","0","10","8","2","0","0","0","0","0","0","0","0","0","-2"
"190114","Metropolitan College of New York","2016","Not on tenure/no tenure system, associate professors","8","6","2","0","0","0","1","1","0","3","2","1","0","0","0","0","0","0","4","3","1","0","0","0","0","0","0","0","0","0","-2"
"190114","Metropolitan College of New York","2016","Not on tenure/no tenure system, assistant professors","3","0","3","0","0","0","0","0","0","1","0","1","0","0","0","0","0","0","1","0","1","0","0","0","1","0","1","0","0","0","-2"
"190558","College of Staten Island CUNY","2016","Tenured total","271","159","112","1","1","0","41","23","18","9","6","3","17","10","7","0","0","0","203","119","84","0","0","0","0","0","0","0","0","0","-2"
"190558","College of Staten Island CUNY","2016","Tenured, professors","111","76","35","0","0","0","17","11","6","2","1","1","8","6","2","0","0","0","84","58","26","0","0","0","0","0","0","0","0","0","-2"
"190558","College of Staten Island CUNY","2016","Tenured, associate professors","123","67","56","1","1","0","22","12","10","6","4","2","7","4","3","0","0","0","87","46","41","0","0","0","0","0","0","0","0","0","-2"
"190558","College of Staten Island CUNY","2016","Tenured, assistant professors","19","9","10","0","0","0","1","0","1","1","1","0","0","0","0","0","0","0","17","8","9","0","0","0","0","0","0","0","0","0","-2"
"190558","College of Staten Island CUNY","2016","Tenured, lecturers","18","7","11","0","0","0","1","0","1","0","0","0","2","0","2","0","0","0","15","7","8","0","0","0","0","0","0","0","0","0","-2"
"190558","College of Staten Island CUNY","2016","On-Tenure track total","105","46","59","0","0","0","14","3","11","5","0","5","7","4","3","0","0","0","55","24","31","1","0","1","0","0","0","23","15","8","-2"
"190558","College of Staten Island CUNY","2016","On-tenure track, professors","1","1","0","0","0","0","1","1","0","0","0","0","0","0","0","0","0","0","0","0","0","0","0","0","0","0","0","0","0","0","-2"
"190558","College of Staten Island CUNY","2016","On-tenure track, associate professors","7","4","3","0","0","0","1","0","1","1","0","1","1","1","0","0","0","0","3","2","1","0","0","0","0","0","0","1","1","0","-2"
"190558","College of Staten Island CUNY","2016","On-tenure track, assistant professors","88","39","49","0","0","0","10","2","8","3","0","3","5","3","2","0","0","0","47","20","27","1","0","1","0","0","0","22","14","8","-2"
"190558","College of Staten Island CUNY","2016","On-tenure track, lecturers","9","2","7","0","0","0","2","0","2","1","0","1","1","0","1","0","0","0","5","2","3","0","0","0","0","0","0","0","0","0","-2"
"190558","College of Staten Island CUNY","2016","Not on tenure track/No tenure system system total","7","2","5","0","0","0","1","1","0","1","0","1","0","0","0","0","0","0","5","1","4","0","0","0","0","0","0","0","0","0","-2"
"190558","College of Staten Island CUNY","2016","Not on tenure/no tenure system, professors","2","0","2","0","0","0","0","0","0","0","0","0","0","0","0","0","0","0","2","0","2","0","0","0","0","0","0","0","0","0","-2"
"190558","College of Staten Island CUNY","2016","Not on tenure/no tenure system, assistant professors","1","0","1","0","0","0","0","0","0","1","0","1","0","0","0","0","0","0","0","0","0","0","0","0","0","0","0","0","0","0","-2"
"190558","College of Staten Island CUNY","2016","Not on tenure/no tenure system, lecturers","4","2","2","0","0","0","1","1","0","0","0","0","0","0","0","0","0","0","3","1","2","0","0","0","0","0","0","0","0","0","-2"
"190594","CUNY Hunter College","2016","Tenured total","477","243","234","0","0","0","47","20","27","47","24","23","51","19","32","0","0","0","324","178","146","3","1","2","0","0","0","5","1","4","-2"
"190594","CUNY Hunter College","2016","Tenured, professors","238","130","108","0","0","0","17","10","7","18","10","8","19","9","10","0","0","0","181","100","81","1","1","0","0","0","0","2","0","2","-2"
"190594","CUNY Hunter College","2016","Tenured, associate professors","189","92","97","0","0","0","25","10","15","22","12","10","25","7","18","0","0","0","114","62","52","2","0","2","0","0","0","1","1","0","-2"
"190594","CUNY Hunter College","2016","Tenured, assistant professors","17","7","10","0","0","0","3","0","3","2","1","1","2","2","0","0","0","0","10","4","6","0","0","0","0","0","0","0","0","0","-2"
"190594","CUNY Hunter College","2016","Tenured, lecturers","33","14","19","0","0","0","2","0","2","5","1","4","5","1","4","0","0","0","19","12","7","0","0","0","0","0","0","2","0","2","-2"
"190594","CUNY Hunter College","2016","On-Tenure track total","123","53","70","1","0","1","19","7","12","6","2","4","9","4","5","0","0","0","78","34","44","1","1","0","0","0","0","9","5","4","-2"
"190594","CUNY Hunter College","2016","On-tenure track, professors","3","0","3","0","0","0","1","0","1","0","0","0","0","0","0","0","0","0","2","0","2","0","0","0","0","0","0","0","0","0","-2"
"190594","CUNY Hunter College","2016","On-tenure track, associate professors","17","12","5","0","0","0","5","2","3","1","1","0","2","2","0","0","0","0","7","6","1","0","0","0","0","0","0","2","1","1","-2"
"190594","CUNY Hunter College","2016","On-tenure track, assistant professors","80","31","49","1","0","1","10","3","7","5","1","4","5","1","4","0","0","0","52","21","31","1","1","0","0","0","0","6","4","2","-2"
"190594","CUNY Hunter College","2016","On-tenure track, lecturers","23","10","13","0","0","0","3","2","1","0","0","0","2","1","1","0","0","0","17","7","10","0","0","0","0","0","0","1","0","1","-2"
"190594","CUNY Hunter College","2016","Not on tenure track/No tenure system system total","77","36","41","0","0","0","3","1","2","5","1","4","4","4","0","0","0","0","59","25","34","2","1","1","0","0","0","4","4","0","-2"
"190594","CUNY Hunter College","2016","Not on tenure/no tenure system, professors","46","15","31","0","0","0","2","0","2","1","0","1","2","2","0","0","0","0","38","11","27","1","0","1","0","0","0","2","2","0","-2"
"190594","CUNY Hunter College","2016","Not on tenure/no tenure system, associate professors","1","1","0","0","0","0","0","0","0","0","0","0","1","1","0","0","0","0","0","0","0","0","0","0","0","0","0","0","0","0","-2"
"190594","CUNY Hunter College","2016","Not on tenure/no tenure system, assistant professors","16","11","5","0","0","0","0","0","0","1","0","1","0","0","0","0","0","0","14","10","4","1","1","0","0","0","0","0","0","0","-2"
"190594","CUNY Hunter College","2016","Not on tenure/no tenure system, instructors","1","1","0","0","0","0","0","0","0","0","0","0","0","0","0","0","0","0","1","1","0","0","0","0","0","0","0","0","0","0","-2"
"190594","CUNY Hunter College","2016","Not on tenure/no tenure system, lecturers","13","8","5","0","0","0","1","1","0","3","1","2","1","1","0","0","0","0","6","3","3","0","0","0","0","0","0","2","2","0","-2"
"190600","CUNY John Jay College of Criminal Justice","2016","Tenured total","302","161","141","0","0","0","24","9","15","36","19","17","27","11","16","2","0","2","199","117","82","0","0","0","0","0","0","14","5","9","-2"
"190600","CUNY John Jay College of Criminal Justice","2016","Tenured, professors","104","62","42","0","0","0","5","1","4","8","2","6","6","3","3","0","0","0","84","56","28","0","0","0","0","0","0","1","0","1","-2"
"190600","CUNY John Jay College of Criminal Justice","2016","Tenured, associate professors","150","79","71","0","0","0","15","7","8","20","13","7","15","6","9","1","0","1","87","49","38","0","0","0","0","0","0","12","4","8","-2"
"190600","CUNY John Jay College of Criminal Justice","2016","Tenured, assistant professors","25","8","17","0","0","0","3","1","2","4","1","3","3","2","1","0","0","0","15","4","11","0","0","0","0","0","0","0","0","0","-2"
"190600","CUNY John Jay College of Criminal Justice","2016","Tenured, lecturers","23","12","11","0","0","0","1","0","1","4","3","1","3","0","3","1","0","1","13","8","5","0","0","0","0","0","0","1","1","0","-2"
"190600","CUNY John Jay College of Criminal Justice","2016","On-Tenure track total","80","36","44","0","0","0","4","2","2","7","2","5","9","6","3","2","1","1","51","22","29","1","1","0","0","0","0","6","2","4","-2"
"190600","CUNY John Jay College of Criminal Justice","2016","On-tenure track, associate professors","6","1","5","0","0","0","1","0","1","0","0","0","0","0","0","0","0","0","5","1","4","0","0","0","0","0","0","0","0","0","-2"
"190600","CUNY John Jay College of Criminal Justice","2016","On-tenure track, assistant professors","64","30","34","0","0","0","3","2","1","5","1","4","7","4","3","1","1","0","41","19","22","1","1","0","0","0","0","6","2","4","-2"
"190600","CUNY John Jay College of Criminal Justice","2016","On-tenure track, lecturers","10","5","5","0","0","0","0","0","0","2","1","1","2","2","0","1","0","1","5","2","3","0","0","0","0","0","0","0","0","0","-2"
"190600","CUNY John Jay College of Criminal Justice","2016","Not on tenure track/No tenure system system total","15","9","6","0","0","0","0","0","0","0","0","0","2","2","0","0","0","0","10","6","4","1","0","1","0","0","0","2","1","1","-2"
"190600","CUNY John Jay College of Criminal Justice","2016","Not on tenure/no tenure system, professors","5","4","1","0","0","0","0","0","0","0","0","0","0","0","0","0","0","0","5","4","1","0","0","0","0","0","0","0","0","0","-2"
"190600","CUNY John Jay College of Criminal Justice","2016","Not on tenure/no tenure system, associate professors","1","1","0","0","0","0","0","0","0","0","0","0","0","0","0","0","0","0","1","1","0","0","0","0","0","0","0","0","0","0","-2"
"190600","CUNY John Jay College of Criminal Justice","2016","Not on tenure/no tenure system, assistant professors","7","2","5","0","0","0","0","0","0","0","0","0","1","1","0","0","0","0","4","1","3","1","0","1","0","0","0","1","0","1","-2"
"190600","CUNY John Jay College of Criminal Justice","2016","Not on tenure/no tenure system, lecturers","2","2","0","0","0","0","0","0","0","0","0","0","1","1","0","0","0","0","0","0","0","0","0","0","0","0","0","1","1","0","-2"
"190637","CUNY Lehman College","2016","Tenured total","249","127","122","2","0","2","14","9","5","25","10","15","32","21","11","0","0","0","175","87","88","0","0","0","0","0","0","1","0","1","-2"
"190637","CUNY Lehman College","2016","Tenured, professors","90","57","33","1","0","1","3","2","1","3","2","1","10","8","2","0","0","0","73","45","28","0","0","0","0","0","0","0","0","0","-2"
"190637","CUNY Lehman College","2016","Tenured, associate professors","114","49","65","1","0","1","8","4","4","13","7","6","15","7","8","0","0","0","77","31","46","0","0","0","0","0","0","0","0","0","-2"
"190637","CUNY Lehman College","2016","Tenured, assistant professors","17","7","10","0","0","0","3","3","0","4","0","4","1","1","0","0","0","0","9","3","6","0","0","0","0","0","0","0","0","0","-2"
"190637","CUNY Lehman College","2016","Tenured, lecturers","28","14","14","0","0","0","0","0","0","5","1","4","6","5","1","0","0","0","16","8","8","0","0","0","0","0","0","1","0","1","-2"
"190637","CUNY Lehman College","2016","On-Tenure track total","107","38","69","0","0","0","13","5","8","13","3","10","13","5","8","0","0","0","59","20","39","1","1","0","1","1","0","7","3","4","-2"
"190637","CUNY Lehman College","2016","On-tenure track, associate professors","6","4","2","0","0","0","2","2","0","0","0","0","1","1","0","0","0","0","3","1","2","0","0","0","0","0","0","0","0","0","-2"
"190637","CUNY Lehman College","2016","On-tenure track, assistant professors","80","28","52","0","0","0","8","2","6","10","3","7","11","4","7","0","0","0","44","16","28","0","0","0","1","1","0","6","2","4","-2"
"190637","CUNY Lehman College","2016","On-tenure track, lecturers","21","6","15","0","0","0","3","1","2","3","0","3","1","0","1","0","0","0","12","3","9","1","1","0","0","0","0","1","1","0","-2"
"190637","CUNY Lehman College","2016","Not on tenure track/No tenure system system total","17","10","7","0","0","0","0","0","0","2","0","2","4","3","1","0","0","0","11","7","4","0","0","0","0","0","0","0","0","0","-2"
"190637","CUNY Lehman College","2016","Not on tenure/no tenure system, professors","3","2","1","0","0","0","0","0","0","0","0","0","2","2","0","0","0","0","1","0","1","0","0","0","0","0","0","0","0","0","-2"
"190637","CUNY Lehman College","2016","Not on tenure/no tenure system, assistant professors","3","3","0","0","0","0","0","0","0","0","0","0","0","0","0","0","0","0","3","3","0","0","0","0","0","0","0","0","0","0","-2"
"190637","CUNY Lehman College","2016","Not on tenure/no tenure system, instructors","2","1","1","0","0","0","0","0","0","0","0","0","0","0","0","0","0","0","2","1","1","0","0","0","0","0","0","0","0","0","-2"
"190637","CUNY Lehman College","2016","Not on tenure/no tenure system, lecturers","9","4","5","0","0","0","0","0","0","2","0","2","2","1","1","0","0","0","5","3","2","0","0","0","0","0","0","0","0","0","-2"
"190655","CUNY New York City College of Technology","2016","Tenured total","274","145","129","2","1","1","35","16","19","40","22","18","18","11","7","0","0","0","168","88","80","0","0","0","1","1","0","10","6","4","-2"
"190655","CUNY New York City College of Technology","2016","Tenured, professors","72","43","29","0","0","0","8","2","6","10","6","4","5","3","2","0","0","0","46","29","17","0","0","0","1","1","0","2","2","0","-2"
"190655","CUNY New York City College of Technology","2016","Tenured, associate professors","115","53","62","0","0","0","17","7","10","13","7","6","7","5","2","0","0","0","72","31","41","0","0","0","0","0","0","6","3","3","-2"
"190655","CUNY New York City College of Technology","2016","Tenured, assistant professors","64","38","26","2","1","1","10","7","3","7","4","3","5","3","2","0","0","0","38","22","16","0","0","0","0","0","0","2","1","1","-2"
"190655","CUNY New York City College of Technology","2016","Tenured, lecturers","23","11","12","0","0","0","0","0","0","10","5","5","1","0","1","0","0","0","12","6","6","0","0","0","0","0","0","0","0","0","-2"
"190655","CUNY New York City College of Technology","2016","On-Tenure track total","136","66","70","0","0","0","29","17","12","12","2","10","13","6","7","0","0","0","74","34","40","0","0","0","0","0","0","8","7","1","-2"
"190655","CUNY New York City College of Technology","2016","On-tenure track, associate professors","6","6","0","0","0","0","2","2","0","0","0","0","0","0","0","0","0","0","3","3","0","0","0","0","0","0","0","1","1","0","-2"
"190655","CUNY New York City College of Technology","2016","On-tenure track, assistant professors","130","60","70","0","0","0","27","15","12","12","2","10","13","6","7","0","0","0","71","31","40","0","0","0","0","0","0","7","6","1","-2"
"190655","CUNY New York City College of Technology","2016","Not on tenure track/No tenure system system total","7","3","4","0","0","0","2","1","1","0","0","0","0","0","0","0","0","0","5","2","3","0","0","0","0","0","0","0","0","0","-2"
"190655","CUNY New York City College of Technology","2016","Not on tenure/no tenure system, assistant professors","3","1","2","0","0","0","1","0","1","0","0","0","0","0","0","0","0","0","2","1","1","0","0","0","0","0","0","0","0","0","-2"
"190655","CUNY New York City College of Technology","2016","Not on tenure/no tenure system, lecturers","4","2","2","0","0","0","1","1","0","0","0","0","0","0","0","0","0","0","3","1","2","0","0","0","0","0","0","0","0","0","-2"
"190664","CUNY Queens College","2016","Tenured total","462","260","202","0","0","0","49","22","27","16","11","5","26","11","15","0","0","0","346","207","139","3","3","0","0","0","0","22","6","16","-2"
"190664","CUNY Queens College","2016","Tenured, professors","203","136","67","0","0","0","20","11","9","9","6","3","10","5","5","0","0","0","159","110","49","2","2","0","0","0","0","3","2","1","-2"
"190664","CUNY Queens College","2016","Tenured, associate professors","181","89","92","0","0","0","23","10","13","5","3","2","13","4","9","0","0","0","122","67","55","1","1","0","0","0","0","17","4","13","-2"
"190664","CUNY Queens College","2016","Tenured, assistant professors","16","7","9","0","0","0","3","1","2","1","1","0","0","0","0","0","0","0","11","5","6","0","0","0","0","0","0","1","0","1","-2"
"190664","CUNY Queens College","2016","Tenured, lecturers","62","28","34","0","0","0","3","0","3","1","1","0","3","2","1","0","0","0","54","25","29","0","0","0","0","0","0","1","0","1","-2"
"190664","CUNY Queens College","2016","On-Tenure track total","114","49","65","0","0","0","10","2","8","12","4","8","11","7","4","0","0","0","59","26","33","2","1","1","0","0","0","20","9","11","-2"
"190664","CUNY Queens College","2016","On-tenure track, professors","1","0","1","0","0","0","0","0","0","0","0","0","0","0","0","0","0","0","1","0","1","0","0","0","0","0","0","0","0","0","-2"
"190664","CUNY Queens College","2016","On-tenure track, associate professors","4","3","1","0","0","0","0","0","0","0","0","0","1","1","0","0","0","0","3","2","1","0","0","0","0","0","0","0","0","0","-2"
"190664","CUNY Queens College","2016","On-tenure track, assistant professors","88","39","49","0","0","0","7","2","5","10","3","7","10","6","4","0","0","0","40","18","22","2","1","1","0","0","0","19","9","10","-2"
"190664","CUNY Queens College","2016","On-tenure track, lecturers","21","7","14","0","0","0","3","0","3","2","1","1","0","0","0","0","0","0","15","6","9","0","0","0","0","0","0","1","0","1","-2"
"190664","CUNY Queens College","2016","Not on tenure track/No tenure system system total","35","21","14","0","0","0","2","2","0","5","1","4","1","1","0","0","0","0","27","17","10","0","0","0","0","0","0","0","0","0","-2"
"190664","CUNY Queens College","2016","Not on tenure/no tenure system, professors","9","4","5","0","0","0","0","0","0","4","1","3","0","0","0","0","0","0","5","3","2","0","0","0","0","0","0","0","0","0","-2"
"190664","CUNY Queens College","2016","Not on tenure/no tenure system, associate professors","2","2","0","0","0","0","0","0","0","0","0","0","0","0","0","0","0","0","2","2","0","0","0","0","0","0","0","0","0","0","-2"
"190664","CUNY Queens College","2016","Not on tenure/no tenure system, assistant professors","6","3","3","0","0","0","1","1","0","1","0","1","0","0","0","0","0","0","4","2","2","0","0","0","0","0","0","0","0","0","-2"
"190664","CUNY Queens College","2016","Not on tenure/no tenure system, instructors","2","2","0","0","0","0","0","0","0","0","0","0","0","0","0","0","0","0","2","2","0","0","0","0","0","0","0","0","0","0","-2"
"190664","CUNY Queens College","2016","Not on tenure/no tenure system, lecturers","16","10","6","0","0","0","1","1","0","0","0","0","1","1","0","0","0","0","14","8","6","0","0","0","0","0","0","0","0","0","-2"
"190691","CUNY York College","2016","Tenured total","133","73","60","0","0","0","17","12","5","26","13","13","12","5","7","0","0","0","75","42","33","0","0","0","0","0","0","3","1","2","-2"
"190691","CUNY York College","2016","Tenured, professors","38","22","16","0","0","0","4","4","0","2","2","0","3","1","2","0","0","0","29","15","14","0","0","0","0","0","0","0","0","0","-2"
"190691","CUNY York College","2016","Tenured, associate professors","67","36","31","0","0","0","11","7","4","14","6","8","8","4","4","0","0","0","31","18","13","0","0","0","0","0","0","3","1","2","-2"
"190691","CUNY York College","2016","Tenured, assistant professors","7","6","1","0","0","0","0","0","0","3","2","1","0","0","0","0","0","0","4","4","0","0","0","0","0","0","0","0","0","0","-2"
"190691","CUNY York College","2016","Tenured, lecturers","21","9","12","0","0","0","2","1","1","7","3","4","1","0","1","0","0","0","11","5","6","0","0","0","0","0","0","0","0","0","-2"
"190691","CUNY York College","2016","On-Tenure track total","49","23","26","0","0","0","9","5","4","10","2","8","3","2","1","0","0","0","26","13","13","0","0","0","0","0","0","1","1","0","-2"
"190691","CUNY York College","2016","On-tenure track, professors","1","1","0","0","0","0","1","1","0","0","0","0","0","0","0","0","0","0","0","0","0","0","0","0","0","0","0","0","0","0","-2"
"190691","CUNY York College","2016","On-tenure track, associate professors","8","2","6","0","0","0","2","1","1","2","0","2","0","0","0","0","0","0","4","1","3","0","0","0","0","0","0","0","0","0","-2"
"190691","CUNY York College","2016","On-tenure track, assistant professors","38","19","19","0","0","0","6","3","3","7","2","5","3","2","1","0","0","0","21","11","10","0","0","0","0","0","0","1","1","0","-2"
"190691","CUNY York College","2016","On-tenure track, lecturers","2","1","1","0","0","0","0","0","0","1","0","1","0","0","0","0","0","0","1","1","0","0","0","0","0","0","0","0","0","0","-2"
"190691","CUNY York College","2016","Not on tenure track/No tenure system system total","6","1","5","0","0","0","0","0","0","3","1","2","0","0","0","0","0","0","2","0","2","0","0","0","0","0","0","1","0","1","-2"
"190691","CUNY York College","2016","Not on tenure/no tenure system, professors","6","1","5","0","0","0","0","0","0","3","1","2","0","0","0","0","0","0","2","0","2","0","0","0","0","0","0","1","0","1","-2"
"190761","Dominican College of Blauvelt","2016","Tenured total","28","10","18","0","0","0","1","1","0","0","0","0","0","0","0","0","0","0","27","9","18","0","0","0","0","0","0","0","0","0","-2"
"190761","Dominican College of Blauvelt","2016","Tenured, professors","3","0","3","0","0","0","0","0","0","0","0","0","0","0","0","0","0","0","3","0","3","0","0","0","0","0","0","0","0","0","-2"
"190761","Dominican College of Blauvelt","2016","Tenured, associate professors","12","4","8","0","0","0","1","1","0","0","0","0","0","0","0","0","0","0","11","3","8","0","0","0","0","0","0","0","0","0","-2"
"190761","Dominican College of Blauvelt","2016","Tenured, assistant professors","13","6","7","0","0","0","0","0","0","0","0","0","0","0","0","0","0","0","13","6","7","0","0","0","0","0","0","0","0","0","-2"
"190761","Dominican College of Blauvelt","2016","On-Tenure track total","27","9","18","0","0","0","3","2","1","2","0","2","5","1","4","0","0","0","17","6","11","0","0","0","0","0","0","0","0","0","-2"
"190761","Dominican College of Blauvelt","2016","On-tenure track, associate professors","3","2","1","0","0","0","1","1","0","0","0","0","1","0","1","0","0","0","1","1","0","0","0","0","0","0","0","0","0","0","-2"
"190761","Dominican College of Blauvelt","2016","On-tenure track, assistant professors","23","7","16","0","0","0","2","1","1","2","0","2","4","1","3","0","0","0","15","5","10","0","0","0","0","0","0","0","0","0","-2"
"190761","Dominican College of Blauvelt","2016","On-tenure track, instructors","1","0","1","0","0","0","0","0","0","0","0","0","0","0","0","0","0","0","1","0","1","0","0","0","0","0","0","0","0","0","-2"
"190761","Dominican College of Blauvelt","2016","Not on tenure track/No tenure system system total","20","6","14","0","0","0","0","0","0","0","0","0","0","0","0","0","0","0","20","6","14","0","0","0","0","0","0","0","0","0","-2"
"190761","Dominican College of Blauvelt","2016","Not on tenure/no tenure system, assistant professors","14","5","9","0","0","0","0","0","0","0","0","0","0","0","0","0","0","0","14","5","9","0","0","0","0","0","0","0","0","0","-2"
"190761","Dominican College of Blauvelt","2016","Not on tenure/no tenure system, instructors","6","1","5","0","0","0","0","0","0","0","0","0","0","0","0","0","0","0","6","1","5","0","0","0","0","0","0","0","0","0","-2"
"192749","Manhattanville College","2016","Tenured total","61","31","30","0","0","0","5","1","4","3","3","0","1","0","1","1","0","1","50","27","23","0","0","0","1","0","1","0","0","0","-2"
"192749","Manhattanville College","2016","Tenured, professors","42","24","18","0","0","0","3","1","2","3","3","0","1","0","1","0","0","0","35","20","15","0","0","0","0","0","0","0","0","0","-2"
"192749","Manhattanville College","2016","Tenured, associate professors","15","5","10","0","0","0","1","0","1","0","0","0","0","0","0","0","0","0","13","5","8","0","0","0","1","0","1","0","0","0","-2"
"192749","Manhattanville College","2016","Tenured, assistant professors","4","2","2","0","0","0","1","0","1","0","0","0","0","0","0","1","0","1","2","2","0","0","0","0","0","0","0","0","0","0","-2"
"192749","Manhattanville College","2016","On-Tenure track total","32","12","20","0","0","0","3","2","1","1","0","1","0","0","0","0","0","0","24","7","17","0","0","0","4","3","1","0","0","0","-2"
"192749","Manhattanville College","2016","On-tenure track, professors","3","2","1","0","0","0","1","1","0","0","0","0","0","0","0","0","0","0","2","1","1","0","0","0","0","0","0","0","0","0","-2"
"192749","Manhattanville College","2016","On-tenure track, associate professors","10","4","6","0","0","0","1","0","1","0","0","0","0","0","0","0","0","0","9","4","5","0","0","0","0","0","0","0","0","0","-2"
"192749","Manhattanville College","2016","On-tenure track, assistant professors","19","6","13","0","0","0","1","1","0","1","0","1","0","0","0","0","0","0","13","2","11","0","0","0","4","3","1","0","0","0","-2"
"192749","Manhattanville College","2016","Not on tenure track/No tenure system system total","20","11","9","0","0","0","1","0","1","0","0","0","2","1","1","0","0","0","16","10","6","1","0","1","0","0","0","0","0","0","-2"
"192749","Manhattanville College","2016","Not on tenure/no tenure system, professors","3","1","2","0","0","0","0","0","0","0","0","0","0","0","0","0","0","0","2","1","1","1","0","1","0","0","0","0","0","0","-2"
"192749","Manhattanville College","2016","Not on tenure/no tenure system, associate professors","2","2","0","0","0","0","0","0","0","0","0","0","0","0","0","0","0","0","2","2","0","0","0","0","0","0","0","0","0","0","-2"
"192749","Manhattanville College","2016","Not on tenure/no tenure system, assistant professors","7","4","3","0","0","0","0","0","0","0","0","0","0","0","0","0","0","0","7","4","3","0","0","0","0","0","0","0","0","0","-2"
"192749","Manhattanville College","2016","Not on tenure/no tenure system, instructors","1","0","1","0","0","0","0","0","0","0","0","0","0","0","0","0","0","0","1","0","1","0","0","0","0","0","0","0","0","0","-2"
"192749","Manhattanville College","2016","Not on tenure/no tenure system, lecturers","7","4","3","0","0","0","1","0","1","0","0","0","2","1","1","0","0","0","4","3","1","0","0","0","0","0","0","0","0","0","-2"
"193016","Mercy College","2016","Tenured total","58","25","33","0","0","0","8","3","5","4","2","2","2","1","1","0","0","0","40","17","23","1","1","0","0","0","0","3","1","2","-2"
"193016","Mercy College","2016","Tenured, professors","18","11","7","0","0","0","2","2","0","1","1","0","0","0","0","0","0","0","14","7","7","1","1","0","0","0","0","0","0","0","-2"
"193016","Mercy College","2016","Tenured, associate professors","30","9","21","0","0","0","3","0","3","3","1","2","1","0","1","0","0","0","20","7","13","0","0","0","0","0","0","3","1","2","-2"
"193016","Mercy College","2016","Tenured, assistant professors","10","5","5","0","0","0","3","1","2","0","0","0","1","1","0","0","0","0","6","3","3","0","0","0","0","0","0","0","0","0","-2"
"193016","Mercy College","2016","On-Tenure track total","39","15","24","0","0","0","4","3","1","2","0","2","3","1","2","0","0","0","26","9","17","0","0","0","0","0","0","4","2","2","-2"
"193016","Mercy College","2016","On-tenure track, professors","3","2","1","0","0","0","0","0","0","0","0","0","1","1","0","0","0","0","2","1","1","0","0","0","0","0","0","0","0","0","-2"
"193016","Mercy College","2016","On-tenure track, associate professors","10","2","8","0","0","0","0","0","0","1","0","1","2","0","2","0","0","0","7","2","5","0","0","0","0","0","0","0","0","0","-2"
"193016","Mercy College","2016","On-tenure track, assistant professors","26","11","15","0","0","0","4","3","1","1","0","1","0","0","0","0","0","0","17","6","11","0","0","0","0","0","0","4","2","2","-2"
"193016","Mercy College","2016","Not on tenure track/No tenure system system total","113","43","70","0","0","0","6","4","2","11","2","9","6","2","4","0","0","0","88","34","54","0","0","0","0","0","0","2","1","1","-2"
"193016","Mercy College","2016","Not on tenure/no tenure system, professors","3","1","2","0","0","0","0","0","0","0","0","0","0","0","0","0","0","0","3","1","2","0","0","0","0","0","0","0","0","0","-2"
"193016","Mercy College","2016","Not on tenure/no tenure system, associate professors","34","14","20","0","0","0","3","2","1","0","0","0","1","0","1","0","0","0","29","12","17","0","0","0","0","0","0","1","0","1","-2"
"193016","Mercy College","2016","Not on tenure/no tenure system, assistant professors","61","22","39","0","0","0","2","1","1","10","1","9","5","2","3","0","0","0","43","17","26","0","0","0","0","0","0","1","1","0","-2"
"193016","Mercy College","2016","Not on tenure/no tenure system, instructors","15","6","9","0","0","0","1","1","0","1","1","0","0","0","0","0","0","0","13","4","9","0","0","0","0","0","0","0","0","0","-2"
"193399","College of Mount Saint Vincent","2016","Tenured total","34","19","15","0","0","0","1","0","1","0","0","0","0","0","0","0","0","0","32","18","14","1","1","0","0","0","0","0","0","0","-2"
"193399","College of Mount Saint Vincent","2016","Tenured, professors","10","6","4","0","0","0","0","0","0","0","0","0","0","0","0","0","0","0","9","5","4","1","1","0","0","0","0","0","0","0","-2"
"193399","College of Mount Saint Vincent","2016","Tenured, associate professors","22","11","11","0","0","0","1","0","1","0","0","0","0","0","0","0","0","0","21","11","10","0","0","0","0","0","0","0","0","0","-2"
"193399","College of Mount Saint Vincent","2016","Tenured, assistant professors","2","2","0","0","0","0","0","0","0","0","0","0","0","0","0","0","0","0","2","2","0","0","0","0","0","0","0","0","0","0","-2"
"193399","College of Mount Saint Vincent","2016","On-Tenure track total","34","11","23","0","0","0","2","0","2","0","0","0","3","0","3","0","0","0","25","9","16","4","2","2","0","0","0","0","0","0","-2"
"193399","College of Mount Saint Vincent","2016","On-tenure track, associate professors","14","4","10","0","0","0","1","0","1","0","0","0","1","0","1","0","0","0","10","3","7","2","1","1","0","0","0","0","0","0","-2"
"193399","College of Mount Saint Vincent","2016","On-tenure track, assistant professors","19","7","12","0","0","0","1","0","1","0","0","0","2","0","2","0","0","0","14","6","8","2","1","1","0","0","0","0","0","0","-2"
"193399","College of Mount Saint Vincent","2016","On-tenure track, instructors","1","0","1","0","0","0","0","0","0","0","0","0","0","0","0","0","0","0","1","0","1","0","0","0","0","0","0","0","0","0","-2"
"193399","College of Mount Saint Vincent","2016","Not on tenure track/No tenure system system total","13","5","8","0","0","0","0","0","0","0","0","0","1","0","1","0","0","0","11","5","6","0","0","0","1","0","1","0","0","0","-2"
"193399","College of Mount Saint Vincent","2016","Not on tenure/no tenure system, professors","1","1","0","0","0","0","0","0","0","0","0","0","0","0","0","0","0","0","1","1","0","0","0","0","0","0","0","0","0","0","-2"
"193399","College of Mount Saint Vincent","2016","Not on tenure/no tenure system, associate professors","1","0","1","0","0","0","0","0","0","0","0","0","0","0","0","0","0","0","1","0","1","0","0","0","0","0","0","0","0","0","-2"
"193399","College of Mount Saint Vincent","2016","Not on tenure/no tenure system, assistant professors","1","1","0","0","0","0","0","0","0","0","0","0","0","0","0","0","0","0","1","1","0","0","0","0","0","0","0","0","0","0","-2"
"193399","College of Mount Saint Vincent","2016","Not on tenure/no tenure system, instructors","10","3","7","0","0","0","0","0","0","0","0","0","1","0","1","0","0","0","8","3","5","0","0","0","1","0","1","0","0","0","-2"
"194161","Nyack College","2016","Tenured total","39","24","15","0","0","0","6","4","2","5","3","2","2","0","2","0","0","0","26","17","9","0","0","0","0","0","0","0","0","0","-2"
"194161","Nyack College","2016","Tenured, professors","34","22","12","0","0","0","6","4","2","4","2","2","2","0","2","0","0","0","22","16","6","0","0","0","0","0","0","0","0","0","-2"
"194161","Nyack College","2016","Tenured, associate professors","5","2","3","0","0","0","0","0","0","1","1","0","0","0","0","0","0","0","4","1","3","0","0","0","0","0","0","0","0","0","-2"
"194161","Nyack College","2016","On-Tenure track total","49","28","21","0","0","0","11","5","6","6","2","4","6","4","2","0","0","0","24","15","9","0","0","0","0","0","0","2","2","0","-2"
"194161","Nyack College","2016","On-tenure track, professors","8","4","4","0","0","0","1","0","1","1","0","1","0","0","0","0","0","0","6","4","2","0","0","0","0","0","0","0","0","0","-2"
"194161","Nyack College","2016","On-tenure track, associate professors","13","8","5","0","0","0","2","0","2","1","0","1","1","1","0","0","0","0","8","6","2","0","0","0","0","0","0","1","1","0","-2"
"194161","Nyack College","2016","On-tenure track, assistant professors","28","16","12","0","0","0","8","5","3","4","2","2","5","3","2","0","0","0","10","5","5","0","0","0","0","0","0","1","1","0","-2"
"194161","Nyack College","2016","Not on tenure track/No tenure system system total","6","2","4","0","0","0","0","0","0","5","1","4","0","0","0","0","0","0","1","1","0","0","0","0","0","0","0","0","0","0","-2"
"194161","Nyack College","2016","Not on tenure/no tenure system, lecturers","6","2","4","0","0","0","0","0","0","5","1","4","0","0","0","0","0","0","1","1","0","0","0","0","0","0","0","0","0","0","-2"
"195173","St Francis College","2016","Tenured total","50","24","26","0","0","0","2","1","1","3","0","3","3","1","2","0","0","0","42","22","20","0","0","0","0","0","0","0","0","0","-2"
"195173","St Francis College","2016","Tenured, professors","27","15","12","0","0","0","1","1","0","1","0","1","1","0","1","0","0","0","24","14","10","0","0","0","0","0","0","0","0","0","-2"
"195173","St Francis College","2016","Tenured, associate professors","23","9","14","0","0","0","1","0","1","2","0","2","2","1","1","0","0","0","18","8","10","0","0","0","0","0","0","0","0","0","-2"
"195173","St Francis College","2016","On-Tenure track total","22","9","13","0","0","0","3","2","1","2","0","2","0","0","0","0","0","0","17","7","10","0","0","0","0","0","0","0","0","0","-2"
"195173","St Francis College","2016","On-tenure track, associate professors","1","0","1","0","0","0","0","0","0","0","0","0","0","0","0","0","0","0","1","0","1","0","0","0","0","0","0","0","0","0","-2"
"195173","St Francis College","2016","On-tenure track, assistant professors","21","9","12","0","0","0","3","2","1","2","0","2","0","0","0","0","0","0","16","7","9","0","0","0","0","0","0","0","0","0","-2"
"195173","St Francis College","2016","Not on tenure track/No tenure system system total","14","9","5","0","0","0","0","0","0","1","0","1","1","0","1","0","0","0","12","9","3","0","0","0","0","0","0","0","0","0","-2"
"195173","St Francis College","2016","Not on tenure/no tenure system, assistant professors","1","1","0","0","0","0","0","0","0","0","0","0","0","0","0","0","0","0","1","1","0","0","0","0","0","0","0","0","0","0","-2"
"195173","St Francis College","2016","Not on tenure/no tenure system, lecturers","13","8","5","0","0","0","0","0","0","1","0","1","1","0","1","0","0","0","11","8","3","0","0","0","0","0","0","0","0","0","-2"
"196219","SUNY at Purchase College","2016","Tenured total","87","42","45","0","0","0","4","2","2","3","2","1","2","2","0","0","0","0","75","35","40","3","1","2","0","0","0","0","0","0","-2"
"196219","SUNY at Purchase College","2016","Tenured, professors","29","15","14","0","0","0","1","1","0","1","1","0","0","0","0","0","0","0","27","13","14","0","0","0","0","0","0","0","0","0","-2"
"196219","SUNY at Purchase College","2016","Tenured, associate professors","58","27","31","0","0","0","3","1","2","2","1","1","2","2","0","0","0","0","48","22","26","3","1","2","0","0","0","0","0","0","-2"
"196219","SUNY at Purchase College","2016","On-Tenure track total","56","26","30","0","0","0","5","2","3","4","0","4","2","2","0","0","0","0","38","18","20","1","1","0","0","0","0","6","3","3","-2"
"196219","SUNY at Purchase College","2016","On-tenure track, associate professors","4","2","2","0","0","0","0","0","0","0","0","0","0","0","0","0","0","0","4","2","2","0","0","0","0","0","0","0","0","0","-2"
"196219","SUNY at Purchase College","2016","On-tenure track, assistant professors","52","24","28","0","0","0","5","2","3","4","0","4","2","2","0","0","0","0","34","16","18","1","1","0","0","0","0","6","3","3","-2"
"196219","SUNY at Purchase College","2016","Not on tenure track/No tenure system system total","31","12","19","0","0","0","3","0","3","2","1","1","1","0","1","0","0","0","22","9","13","0","0","0","0","0","0","3","2","1","-2"
"196219","SUNY at Purchase College","2016","Not on tenure/no tenure system, associate professors","4","1","3","0","0","0","0","0","0","0","0","0","0","0","0","0","0","0","4","1","3","0","0","0","0","0","0","0","0","0","-2"
"196219","SUNY at Purchase College","2016","Not on tenure/no tenure system, assistant professors","24","11","13","0","0","0","2","0","2","2","1","1","1","0","1","0","0","0","16","8","8","0","0","0","0","0","0","3","2","1","-2"
"196219","SUNY at Purchase College","2016","Not on tenure/no tenure system, lecturers","3","0","3","0","0","0","1","0","1","0","0","0","0","0","0","0","0","0","2","0","2","0","0","0","0","0","0","0","0","0","-2"
"196237","SUNY College at Old Westbury","2016","Tenured total","83","40","43","0","0","0","14","5","9","10","6","4","9","7","2","0","0","0","50","22","28","0","0","0","0","0","0","0","0","0","-2"
"196237","SUNY College at Old Westbury","2016","Tenured, professors","26","13","13","0","0","0","7","4","3","1","1","0","5","4","1","0","0","0","13","4","9","0","0","0","0","0","0","0","0","0","-2"
"196237","SUNY College at Old Westbury","2016","Tenured, associate professors","56","26","30","0","0","0","7","1","6","9","5","4","4","3","1","0","0","0","36","17","19","0","0","0","0","0","0","0","0","0","-2"
"196237","SUNY College at Old Westbury","2016","Tenured, instructors","1","1","0","0","0","0","0","0","0","0","0","0","0","0","0","0","0","0","1","1","0","0","0","0","0","0","0","0","0","0","-2"
"196237","SUNY College at Old Westbury","2016","On-Tenure track total","55","24","31","1","1","0","9","3","6","7","4","3","4","2","2","0","0","0","30","12","18","1","0","1","0","0","0","3","2","1","-2"
"196237","SUNY College at Old Westbury","2016","On-tenure track, associate professors","2","0","2","0","0","0","2","0","2","0","0","0","0","0","0","0","0","0","0","0","0","0","0","0","0","0","0","0","0","0","-2"
"196237","SUNY College at Old Westbury","2016","On-tenure track, assistant professors","53","24","29","1","1","0","7","3","4","7","4","3","4","2","2","0","0","0","30","12","18","1","0","1","0","0","0","3","2","1","-2"
"196237","SUNY College at Old Westbury","2016","Not on tenure track/No tenure system system total","22","8","14","0","0","0","3","1","2","4","1","3","2","0","2","0","0","0","12","6","6","0","0","0","0","0","0","1","0","1","-2"
"196237","SUNY College at Old Westbury","2016","Not on tenure/no tenure system, associate professors","2","1","1","0","0","0","0","0","0","2","1","1","0","0","0","0","0","0","0","0","0","0","0","0","0","0","0","0","0","0","-2"
"196237","SUNY College at Old Westbury","2016","Not on tenure/no tenure system, assistant professors","8","2","6","0","0","0","2","1","1","1","0","1","1","0","1","0","0","0","4","1","3","0","0","0","0","0","0","0","0","0","-2"
"196237","SUNY College at Old Westbury","2016","Not on tenure/no tenure system, instructors","3","1","2","0","0","0","0","0","0","1","0","1","0","0","0","0","0","0","2","1","1","0","0","0","0","0","0","0","0","0","-2"
"196237","SUNY College at Old Westbury","2016","Not on tenure/no tenure system, lecturers","9","4","5","0","0","0","1","0","1","0","0","0","1","0","1","0","0","0","6","4","2","0","0","0","0","0","0","1","0","1","-2"
"206279","Union Institute & University","2016","Not on tenure track/No tenure system system total","35","17","18","0","0","0","1","0","1","5","1","4","2","1","1","0","0","0","26","15","11","0","0","0","1","0","1","0","0","0","-2"
"206279","Union Institute & University","2016","Not on tenure/no tenure system, no academic rank","35","17","18","0","0","0","1","0","1","5","1","4","2","1","1","0","0","0","26","15","11","0","0","0","1","0","1","0","0","0","-2"
"207351","Oklahoma Panhandle State University","2016","Tenured total","8","5","3","0","0","0","0","0","0","0","0","0","0","0","0","0","0","0","8","5","3","0","0","0","0","0","0","0","0","0","-2"
"207351","Oklahoma Panhandle State University","2016","Tenured, professors","3","2","1","0","0","0","0","0","0","0","0","0","0","0","0","0","0","0","3","2","1","0","0","0","0","0","0","0","0","0","-2"
"207351","Oklahoma Panhandle State University","2016","Tenured, associate professors","5","3","2","0","0","0","0","0","0","0","0","0","0","0","0","0","0","0","5","3","2","0","0","0","0","0","0","0","0","0","-2"
"207351","Oklahoma Panhandle State University","2016","On-Tenure track total","24","11","13","1","1","0","1","0","1","0","0","0","0","0","0","0","0","0","22","10","12","0","0","0","0","0","0","0","0","0","-2"
"207351","Oklahoma Panhandle State University","2016","On-tenure track, associate professors","4","4","0","1","1","0","0","0","0","0","0","0","0","0","0","0","0","0","3","3","0","0","0","0","0","0","0","0","0","0","-2"
"207351","Oklahoma Panhandle State University","2016","On-tenure track, assistant professors","20","7","13","0","0","0","1","0","1","0","0","0","0","0","0","0","0","0","19","7","12","0","0","0","0","0","0","0","0","0","-2"
"207351","Oklahoma Panhandle State University","2016","Not on tenure track/No tenure system system total","15","10","5","0","0","0","0","0","0","0","0","0","0","0","0","0","0","0","14","9","5","1","1","0","0","0","0","0","0","0","-2"
"207351","Oklahoma Panhandle State University","2016","Not on tenure/no tenure system, instructors","15","10","5","0","0","0","0","0","0","0","0","0","0","0","0","0","0","0","14","9","5","1","1","0","0","0","0","0","0","0","-2"
"209241","Mount Angel Seminary","2016","Not on tenure track/No tenure system system total","26","20","6","0","0","0","1","0","1","0","0","0","0","0","0","0","0","0","25","20","5","0","0","0","0","0","0","0","0","0","-2"
"209241","Mount Angel Seminary","2016","Not on tenure/no tenure system, professors","13","9","4","0","0","0","0","0","0","0","0","0","0","0","0","0","0","0","13","9","4","0","0","0","0","0","0","0","0","0","-2"
"209241","Mount Angel Seminary","2016","Not on tenure/no tenure system, associate professors","4","3","1","0","0","0","1","0","1","0","0","0","0","0","0","0","0","0","3","3","0","0","0","0","0","0","0","0","0","0","-2"
"209241","Mount Angel Seminary","2016","Not on tenure/no tenure system, assistant professors","7","6","1","0","0","0","0","0","0","0","0","0","0","0","0","0","0","0","7","6","1","0","0","0","0","0","0","0","0","0","-2"
"209241","Mount Angel Seminary","2016","Not on tenure/no tenure system, instructors","2","2","0","0","0","0","0","0","0","0","0","0","0","0","0","0","0","0","2","2","0","0","0","0","0","0","0","0","0","0","-2"
"210304","Warner Pacific University","2016","Not on tenure track/No tenure system system total","27","14","13","0","0","0","0","0","0","0","0","0","4","2","2","0","0","0","23","12","11","0","0","0","0","0","0","0","0","0","-2"
"210304","Warner Pacific University","2016","Not on tenure/no tenure system, professors","8","6","2","0","0","0","0","0","0","0","0","0","1","1","0","0","0","0","7","5","2","0","0","0","0","0","0","0","0","0","-2"
"210304","Warner Pacific University","2016","Not on tenure/no tenure system, associate professors","10","5","5","0","0","0","0","0","0","0","0","0","1","1","0","0","0","0","9","4","5","0","0","0","0","0","0","0","0","0","-2"
"210304","Warner Pacific University","2016","Not on tenure/no tenure system, assistant professors","9","3","6","0","0","0","0","0","0","0","0","0","2","0","2","0","0","0","7","3","4","0","0","0","0","0","0","0","0","0","-2"
"222831","Angelo State University","2016","Tenured total","123","80","43","2","1","1","6","4","2","5","2","3","8","3","5","0","0","0","102","70","32","0","0","0","0","0","0","0","0","0","-2"
"222831","Angelo State University","2016","Tenured, professors","74","52","22","1","1","0","3","2","1","1","1","0","4","2","2","0","0","0","65","46","19","0","0","0","0","0","0","0","0","0","-2"
"222831","Angelo State University","2016","Tenured, associate professors","47","27","20","1","0","1","3","2","1","4","1","3","3","1","2","0","0","0","36","23","13","0","0","0","0","0","0","0","0","0","-2"
"222831","Angelo State University","2016","Tenured, assistant professors","2","1","1","0","0","0","0","0","0","0","0","0","1","0","1","0","0","0","1","1","0","0","0","0","0","0","0","0","0","0","-2"
"222831","Angelo State University","2016","On-Tenure track total","65","39","26","0","0","0","4","3","1","0","0","0","7","4","3","0","0","0","51","29","22","0","0","0","3","3","0","0","0","0","-2"
"222831","Angelo State University","2016","On-tenure track, assistant professors","65","39","26","0","0","0","4","3","1","0","0","0","7","4","3","0","0","0","51","29","22","0","0","0","3","3","0","0","0","0","-2"
"222831","Angelo State University","2016","Not on tenure track/No tenure system system total","82","33","49","2","0","2","1","0","1","1","0","1","8","5","3","0","0","0","69","27","42","0","0","0","1","1","0","0","0","0","-2"
"222831","Angelo State University","2016","Not on tenure/no tenure system, instructors","55","27","28","0","0","0","0","0","0","0","0","0","5","4","1","0","0","0","49","22","27","0","0","0","1","1","0","0","0","0","-2"
"222831","Angelo State University","2016","Not on tenure/no tenure system, no academic rank","27","6","21","2","0","2","1","0","1","1","0","1","3","1","2","0","0","0","20","5","15","0","0","0","0","0","0","0","0","0","-2"
"222992","Austin Community College District","2016","Not on tenure track/No tenure system system total","559","252","307","2","0","2","23","8","15","36","16","20","77","40","37","2","2","0","411","183","228","8","3","5","0","0","0","0","0","0","-2"
"222992","Austin Community College District","2016","Not on tenure/no tenure system, professors","335","170","165","2","0","2","10","4","6","20","10","10","45","25","20","1","1","0","254","130","124","3","0","3","0","0","0","0","0","0","-2"
"222992","Austin Community College District","2016","Not on tenure/no tenure system, associate professors","154","52","102","0","0","0","11","3","8","12","5","7","23","10","13","0","0","0","107","33","74","1","1","0","0","0","0","0","0","0","-2"
"222992","Austin Community College District","2016","Not on tenure/no tenure system, assistant professors","49","22","27","0","0","0","2","1","1","2","1","1","7","4","3","1","1","0","34","14","20","3","1","2","0","0","0","0","0","0","-2"
"222992","Austin Community College District","2016","Not on tenure/no tenure system, instructors","4","2","2","0","0","0","0","0","0","0","0","0","1","1","0","0","0","0","3","1","2","0","0","0","0","0","0","0","0","0","-2"
"222992","Austin Community College District","2016","Not on tenure/no tenure system, no academic rank","17","6","11","0","0","0","0","0","0","2","0","2","1","0","1","0","0","0","13","5","8","1","1","0","0","0","0","0","0","0","-2"
"223506","Brazosport College","2016","Tenured total","56","31","25","1","1","0","2","0","2","2","2","0","3","1","2","0","0","0","48","27","21","0","0","0","0","0","0","0","0","0","-2"
"223506","Brazosport College","2016","Tenured, professors","19","12","7","0","0","0","1","0","1","0","0","0","0","0","0","0","0","0","18","12","6","0","0","0","0","0","0","0","0","0","-2"
"223506","Brazosport College","2016","Tenured, associate professors","21","12","9","1","1","0","1","0","1","2","2","0","0","0","0","0","0","0","17","9","8","0","0","0","0","0","0","0","0","0","-2"
"223506","Brazosport College","2016","Tenured, assistant professors","15","7","8","0","0","0","0","0","0","0","0","0","3","1","2","0","0","0","12","6","6","0","0","0","0","0","0","0","0","0","-2"
"223506","Brazosport College","2016","Tenured, instructors","1","0","1","0","0","0","0","0","0","0","0","0","0","0","0","0","0","0","1","0","1","0","0","0","0","0","0","0","0","0","-2"
"223506","Brazosport College","2016","On-Tenure track total","1","0","1","0","0","0","0","0","0","1","0","1","0","0","0","0","0","0","0","0","0","0","0","0","0","0","0","0","0","0","-2"
"223506","Brazosport College","2016","On-tenure track, assistant professors","1","0","1","0","0","0","0","0","0","1","0","1","0","0","0","0","0","0","0","0","0","0","0","0","0","0","0","0","0","0","-2"
"223506","Brazosport College","2016","Not on tenure track/No tenure system system total","40","24","16","1","1","0","1","1","0","2","0","2","4","3","1","0","0","0","32","19","13","0","0","0","0","0","0","0","0","0","-2"
"223506","Brazosport College","2016","Not on tenure/no tenure system, assistant professors","6","3","3","0","0","0","0","0","0","0","0","0","1","1","0","0","0","0","5","2","3","0","0","0","0","0","0","0","0","0","-2"
"223506","Brazosport College","2016","Not on tenure/no tenure system, instructors","34","21","13","1","1","0","1","1","0","2","0","2","3","2","1","0","0","0","27","17","10","0","0","0","0","0","0","0","0","0","-2"
"224004","Concordia University Texas","2016","Tenured total","12","8","4","0","0","0","0","0","0","0","0","0","0","0","0","0","0","0","12","8","4","0","0","0","0","0","0","0","0","0","-2"
"224004","Concordia University Texas","2016","Tenured, professors","9","6","3","0","0","0","0","0","0","0","0","0","0","0","0","0","0","0","9","6","3","0","0","0","0","0","0","0","0","0","-2"
"224004","Concordia University Texas","2016","Tenured, associate professors","3","2","1","0","0","0","0","0","0","0","0","0","0","0","0","0","0","0","3","2","1","0","0","0","0","0","0","0","0","0","-2"
"224004","Concordia University Texas","2016","On-Tenure track total","43","22","21","1","0","1","1","1","0","2","1","1","0","0","0","0","0","0","36","19","17","0","0","0","1","1","0","2","0","2","-2"
"224004","Concordia University Texas","2016","On-tenure track, associate professors","8","4","4","0","0","0","0","0","0","0","0","0","0","0","0","0","0","0","8","4","4","0","0","0","0","0","0","0","0","0","-2"
"224004","Concordia University Texas","2016","On-tenure track, assistant professors","35","18","17","1","0","1","1","1","0","2","1","1","0","0","0","0","0","0","28","15","13","0","0","0","1","1","0","2","0","2","-2"
"224961","Galveston College","2016","Tenured total","23","12","11","1","1","0","1","1","0","3","1","2","3","1","2","0","0","0","15","8","7","0","0","0","0","0","0","0","0","0","-2"
"224961","Galveston College","2016","Tenured, professors","4","3","1","0","0","0","0","0","0","1","1","0","0","0","0","0","0","0","3","2","1","0","0","0","0","0","0","0","0","0","-2"
"224961","Galveston College","2016","Tenured, associate professors","7","4","3","0","0","0","0","0","0","0","0","0","2","1","1","0","0","0","5","3","2","0","0","0","0","0","0","0","0","0","-2"
"224961","Galveston College","2016","Tenured, assistant professors","6","2","4","0","0","0","1","1","0","2","0","2","0","0","0","0","0","0","3","1","2","0","0","0","0","0","0","0","0","0","-2"
"224961","Galveston College","2016","Tenured, instructors","6","3","3","1","1","0","0","0","0","0","0","0","1","0","1","0","0","0","4","2","2","0","0","0","0","0","0","0","0","0","-2"
"224961","Galveston College","2016","On-Tenure track total","29","14","15","1","0","1","1","0","1","4","2","2","3","2","1","0","0","0","20","10","10","0","0","0","0","0","0","0","0","0","-2"
"224961","Galveston College","2016","On-tenure track, associate professors","2","1","1","0","0","0","0","0","0","1","0","1","0","0","0","0","0","0","1","1","0","0","0","0","0","0","0","0","0","0","-2"
"224961","Galveston College","2016","On-tenure track, assistant professors","3","3","0","0","0","0","0","0","0","0","0","0","0","0","0","0","0","0","3","3","0","0","0","0","0","0","0","0","0","0","-2"
"224961","Galveston College","2016","On-tenure track, instructors","24","10","14","1","0","1","1","0","1","3","2","1","3","2","1","0","0","0","16","6","10","0","0","0","0","0","0","0","0","0","-2"
"224961","Galveston College","2016","Not on tenure track/No tenure system system total","4","1","3","0","0","0","0","0","0","0","0","0","0","0","0","0","0","0","4","1","3","0","0","0","0","0","0","0","0","0","-2"
"224961","Galveston College","2016","Not on tenure/no tenure system, instructors","4","1","3","0","0","0","0","0","0","0","0","0","0","0","0","0","0","0","4","1","3","0","0","0","0","0","0","0","0","0","-2"
"225201","Hallmark University","2016","Not on tenure track/No tenure system system total","29","17","12","0","0","0","1","1","0","4","2","2","6","6","0","0","0","0","14","6","8","4","2","2","0","0","0","0","0","0","-2"
"225201","Hallmark University","2016","Not on tenure/no tenure system, instructors","29","17","12","0","0","0","1","1","0","4","2","2","6","6","0","0","0","0","14","6","8","4","2","2","0","0","0","0","0","0","-2"
"225399","Houston Baptist University","2016","Not on tenure track/No tenure system system total","136","73","63","1","1","0","2","2","0","9","2","7","10","7","3","0","0","0","104","54","50","2","2","0","4","2","2","4","3","1","-2"
"225399","Houston Baptist University","2016","Not on tenure/no tenure system, professors","34","22","12","0","0","0","0","0","0","4","1","3","0","0","0","0","0","0","28","19","9","1","1","0","0","0","0","1","1","0","-2"
"225399","Houston Baptist University","2016","Not on tenure/no tenure system, associate professors","34","23","11","0","0","0","1","1","0","2","1","1","6","5","1","0","0","0","24","16","8","0","0","0","1","0","1","0","0","0","-2"
"225399","Houston Baptist University","2016","Not on tenure/no tenure system, assistant professors","66","26","40","1","1","0","1","1","0","3","0","3","4","2","2","0","0","0","50","17","33","1","1","0","3","2","1","3","2","1","-2"
"225399","Houston Baptist University","2016","Not on tenure/no tenure system, instructors","2","2","0","0","0","0","0","0","0","0","0","0","0","0","0","0","0","0","2","2","0","0","0","0","0","0","0","0","0","0","-2"
"225414","University of Houston-Clear Lake","2016","Tenured total","146","92","54","0","0","0","23","17","6","8","4","4","3","0","3","0","0","0","112","71","41","0","0","0","0","0","0","0","0","0","-2"
"225414","University of Houston-Clear Lake","2016","Tenured, professors","49","34","15","0","0","0","10","7","3","1","1","0","1","0","1","0","0","0","37","26","11","0","0","0","0","0","0","0","0","0","-2"
"225414","University of Houston-Clear Lake","2016","Tenured, associate professors","95","57","38","0","0","0","13","10","3","7","3","4","2","0","2","0","0","0","73","44","29","0","0","0","0","0","0","0","0","0","-2"
"225414","University of Houston-Clear Lake","2016","Tenured, assistant professors","2","1","1","0","0","0","0","0","0","0","0","0","0","0","0","0","0","0","2","1","1","0","0","0","0","0","0","0","0","0","-2"
"225414","University of Houston-Clear Lake","2016","On-Tenure track total","99","49","50","1","0","1","28","17","11","8","2","6","6","1","5","1","0","1","54","29","25","0","0","0","1","0","1","0","0","0","-2"
"225414","University of Houston-Clear Lake","2016","On-tenure track, associate professors","7","5","2","0","0","0","2","1","1","0","0","0","0","0","0","0","0","0","5","4","1","0","0","0","0","0","0","0","0","0","-2"
"225414","University of Houston-Clear Lake","2016","On-tenure track, assistant professors","92","44","48","1","0","1","26","16","10","8","2","6","6","1","5","1","0","1","49","25","24","0","0","0","1","0","1","0","0","0","-2"
"225414","University of Houston-Clear Lake","2016","Not on tenure track/No tenure system system total","53","21","32","0","0","0","8","4","4","4","0","4","3","0","3","0","0","0","38","17","21","0","0","0","0","0","0","0","0","0","-2"
"225414","University of Houston-Clear Lake","2016","Not on tenure/no tenure system, assistant professors","2","2","0","0","0","0","1","1","0","0","0","0","0","0","0","0","0","0","1","1","0","0","0","0","0","0","0","0","0","0","-2"
"225414","University of Houston-Clear Lake","2016","Not on tenure/no tenure system, lecturers","36","11","25","0","0","0","4","1","3","3","0","3","2","0","2","0","0","0","27","10","17","0","0","0","0","0","0","0","0","0","-2"
"225414","University of Houston-Clear Lake","2016","Not on tenure/no tenure system, no academic rank","15","8","7","0","0","0","3","2","1","1","0","1","1","0","1","0","0","0","10","6","4","0","0","0","0","0","0","0","0","0","-2"
"225432","University of Houston-Downtown","2016","Tenured total","161","90","71","1","0","1","29","19","10","12","4","8","10","6","4","0","0","0","106","58","48","2","2","0","0","0","0","1","1","0","-2"
"225432","University of Houston-Downtown","2016","Tenured, professors","53","30","23","0","0","0","11","8","3","6","2","4","3","3","0","0","0","0","32","16","16","1","1","0","0","0","0","0","0","0","-2"
"225432","University of Houston-Downtown","2016","Tenured, associate professors","108","60","48","1","0","1","18","11","7","6","2","4","7","3","4","0","0","0","74","42","32","1","1","0","0","0","0","1","1","0","-2"
"225432","University of Houston-Downtown","2016","On-Tenure track total","73","34","39","0","0","0","12","7","5","11","2","9","8","5","3","0","0","0","36","18","18","0","0","0","0","0","0","6","2","4","-2"
"225432","University of Houston-Downtown","2016","On-tenure track, associate professors","4","3","1","0","0","0","1","1","0","0","0","0","1","0","1","0","0","0","2","2","0","0","0","0","0","0","0","0","0","0","-2"
"225432","University of Houston-Downtown","2016","On-tenure track, assistant professors","66","29","37","0","0","0","11","6","5","11","2","9","6","4","2","0","0","0","33","15","18","0","0","0","0","0","0","5","2","3","-2"
"225432","University of Houston-Downtown","2016","On-tenure track, instructors","3","2","1","0","0","0","0","0","0","0","0","0","1","1","0","0","0","0","1","1","0","0","0","0","0","0","0","1","0","1","-2"
"225432","University of Houston-Downtown","2016","Not on tenure track/No tenure system system total","122","58","64","0","0","0","19","8","11","16","8","8","10","5","5","0","0","0","69","32","37","5","3","2","0","0","0","3","2","1","-2"
"225432","University of Houston-Downtown","2016","Not on tenure/no tenure system, lecturers","108","48","60","0","0","0","17","7","10","11","5","6","9","4","5","0","0","0","64","27","37","4","3","1","0","0","0","3","2","1","-2"
"225432","University of Houston-Downtown","2016","Not on tenure/no tenure system, no academic rank","14","10","4","0","0","0","2","1","1","5","3","2","1","1","0","0","0","0","5","5","0","1","0","1","0","0","0","0","0","0","-2"
"225502","University of Houston-Victoria","2016","Tenured total","48","29","19","0","0","0","15","12","3","0","0","0","5","2","3","1","1","0","25","13","12","0","0","0","0","0","0","2","1","1","-2"
"225502","University of Houston-Victoria","2016","Tenured, professors","20","14","6","0","0","0","6","4","2","0","0","0","2","1","1","1","1","0","11","8","3","0","0","0","0","0","0","0","0","0","-2"
"225502","University of Houston-Victoria","2016","Tenured, associate professors","28","15","13","0","0","0","9","8","1","0","0","0","3","1","2","0","0","0","14","5","9","0","0","0","0","0","0","2","1","1","-2"
"225502","University of Houston-Victoria","2016","On-Tenure track total","35","19","16","0","0","0","3","2","1","1","1","0","3","1","2","0","0","0","17","10","7","0","0","0","0","0","0","11","5","6","-2"
"225502","University of Houston-Victoria","2016","On-tenure track, assistant professors","35","19","16","0","0","0","3","2","1","1","1","0","3","1","2","0","0","0","17","10","7","0","0","0","0","0","0","11","5","6","-2"
"225502","University of Houston-Victoria","2016","Not on tenure track/No tenure system system total","25","11","14","0","0","0","2","2","0","0","0","0","4","3","1","0","0","0","14","4","10","0","0","0","0","0","0","5","2","3","-2"
"225502","University of Houston-Victoria","2016","Not on tenure/no tenure system, instructors","6","3","3","0","0","0","1","1","0","0","0","0","1","1","0","0","0","0","3","1","2","0","0","0","0","0","0","1","0","1","-2"
"225502","University of Houston-Victoria","2016","Not on tenure/no tenure system, lecturers","9","6","3","0","0","0","1","1","0","0","0","0","2","1","1","0","0","0","3","2","1","0","0","0","0","0","0","3","2","1","-2"
"225502","University of Houston-Victoria","2016","Not on tenure/no tenure system, no academic rank","10","2","8","0","0","0","0","0","0","0","0","0","1","1","0","0","0","0","8","1","7","0","0","0","0","0","0","1","0","1","-2"
"225548","Howard Payne University","2016","Tenured total","2","1","1","0","0","0","0","0","0","0","0","0","0","0","0","0","0","0","2","1","1","0","0","0","0","0","0","0","0","0","-2"
"225548","Howard Payne University","2016","Tenured, professors","2","1","1","0","0","0","0","0","0","0","0","0","0","0","0","0","0","0","2","1","1","0","0","0","0","0","0","0","0","0","-2"
"225548","Howard Payne University","2016","Not on tenure track/No tenure system system total","79","50","29","0","0","0","1","1","0","1","1","0","5","4","1","0","0","0","72","44","28","0","0","0","0","0","0","0","0","0","-2"
"225548","Howard Payne University","2016","Not on tenure/no tenure system, professors","20","13","7","0","0","0","0","0","0","0","0","0","1","0","1","0","0","0","19","13","6","0","0","0","0","0","0","0","0","0","-2"
"225548","Howard Payne University","2016","Not on tenure/no tenure system, associate professors","27","19","8","0","0","0","0","0","0","0","0","0","3","3","0","0","0","0","24","16","8","0","0","0","0","0","0","0","0","0","-2"
"225548","Howard Payne University","2016","Not on tenure/no tenure system, assistant professors","18","12","6","0","0","0","1","1","0","1","1","0","0","0","0","0","0","0","16","10","6","0","0","0","0","0","0","0","0","0","-2"
"225548","Howard Payne University","2016","Not on tenure/no tenure system, instructors","14","6","8","0","0","0","0","0","0","0","0","0","1","1","0","0","0","0","13","5","8","0","0","0","0","0","0","0","0","0","-2"
"225575","Huston-Tillotson University","2016","Tenured total","11","5","6","0","0","0","0","0","0","5","1","4","0","0","0","0","0","0","6","4","2","0","0","0","0","0","0","0","0","0","-2"
"225575","Huston-Tillotson University","2016","Tenured, professors","10","4","6","0","0","0","0","0","0","5","1","4","0","0","0","0","0","0","5","3","2","0","0","0","0","0","0","0","0","0","-2"
"225575","Huston-Tillotson University","2016","Tenured, associate professors","1","1","0","0","0","0","0","0","0","0","0","0","0","0","0","0","0","0","1","1","0","0","0","0","0","0","0","0","0","0","-2"
"225575","Huston-Tillotson University","2016","On-Tenure track total","25","13","12","0","0","0","3","1","2","11","5","6","7","4","3","0","0","0","3","2","1","0","0","0","0","0","0","1","1","0","-2"
"225575","Huston-Tillotson University","2016","On-tenure track, professors","2","2","0","0","0","0","0","0","0","0","0","0","1","1","0","0","0","0","1","1","0","0","0","0","0","0","0","0","0","0","-2"
"225575","Huston-Tillotson University","2016","On-tenure track, associate professors","4","1","3","0","0","0","0","0","0","3","1","2","0","0","0","0","0","0","1","0","1","0","0","0","0","0","0","0","0","0","-2"
"225575","Huston-Tillotson University","2016","On-tenure track, assistant professors","19","10","9","0","0","0","3","1","2","8","4","4","6","3","3","0","0","0","1","1","0","0","0","0","0","0","0","1","1","0","-2"
"225575","Huston-Tillotson University","2016","Not on tenure track/No tenure system system total","16","7","9","0","0","0","0","0","0","9","4","5","2","1","1","0","0","0","5","2","3","0","0","0","0","0","0","0","0","0","-2"
"225575","Huston-Tillotson University","2016","Not on tenure/no tenure system, associate professors","3","1","2","0","0","0","0","0","0","1","1","0","1","0","1","0","0","0","1","0","1","0","0","0","0","0","0","0","0","0","-2"
"225575","Huston-Tillotson University","2016","Not on tenure/no tenure system, assistant professors","7","3","4","0","0","0","0","0","0","4","2","2","0","0","0","0","0","0","3","1","2","0","0","0","0","0","0","0","0","0","-2"
"225575","Huston-Tillotson University","2016","Not on tenure/no tenure system, instructors","4","2","2","0","0","0","0","0","0","3","1","2","0","0","0","0","0","0","1","1","0","0","0","0","0","0","0","0","0","0","-2"
"225575","Huston-Tillotson University","2016","Not on tenure/no tenure system, lecturers","2","1","1","0","0","0","0","0","0","1","0","1","1","1","0","0","0","0","0","0","0","0","0","0","0","0","0","0","0","0","-2"
"226134","Laredo College","2016","Tenured total","125","71","54","1","0","1","2","1","1","1","0","1","99","56","43","0","0","0","20","12","8","1","1","0","1","1","0","0","0","0","-2"
"226134","Laredo College","2016","Tenured, instructors","125","71","54","1","0","1","2","1","1","1","0","1","99","56","43","0","0","0","20","12","8","1","1","0","1","1","0","0","0","0","-2"
"226134","Laredo College","2016","On-Tenure track total","43","26","17","0","0","0","5","4","1","0","0","0","34","20","14","0","0","0","4","2","2","0","0","0","0","0","0","0","0","0","-2"
"226134","Laredo College","2016","On-tenure track, instructors","43","26","17","0","0","0","5","4","1","0","0","0","34","20","14","0","0","0","4","2","2","0","0","0","0","0","0","0","0","0","-2"
"226134","Laredo College","2016","Not on tenure track/No tenure system system total","13","7","6","0","0","0","0","0","0","0","0","0","13","7","6","0","0","0","0","0","0","0","0","0","0","0","0","0","0","0","-2"
"226134","Laredo College","2016","Not on tenure/no tenure system, instructors","13","7","6","0","0","0","0","0","0","0","0","0","13","7","6","0","0","0","0","0","0","0","0","0","0","0","0","0","0","0","-2"
"226152","Texas A & M International University","2016","Tenured total","70","50","20","0","0","0","15","11","4","1","1","0","23","18","5","0","0","0","30","19","11","0","0","0","0","0","0","1","1","0","-2"
"226152","Texas A & M International University","2016","Tenured, professors","23","20","3","0","0","0","4","4","0","1","1","0","10","10","0","0","0","0","8","5","3","0","0","0","0","0","0","0","0","0","-2"
"226152","Texas A & M International University","2016","Tenured, associate professors","45","29","16","0","0","0","11","7","4","0","0","0","12","8","4","0","0","0","21","13","8","0","0","0","0","0","0","1","1","0","-2"
"226152","Texas A & M International University","2016","Tenured, assistant professors","2","1","1","0","0","0","0","0","0","0","0","0","1","0","1","0","0","0","1","1","0","0","0","0","0","0","0","0","0","0","-2"
"226152","Texas A & M International University","2016","On-Tenure track total","69","34","35","0","0","0","13","5","8","1","1","0","11","5","6","0","0","0","31","15","16","0","0","0","0","0","0","13","8","5","-2"
"226152","Texas A & M International University","2016","On-tenure track, professors","1","0","1","0","0","0","0","0","0","0","0","0","0","0","0","0","0","0","1","0","1","0","0","0","0","0","0","0","0","0","-2"
"226152","Texas A & M International University","2016","On-tenure track, associate professors","7","4","3","0","0","0","4","2","2","1","1","0","0","0","0","0","0","0","1","0","1","0","0","0","0","0","0","1","1","0","-2"
"226152","Texas A & M International University","2016","On-tenure track, assistant professors","61","30","31","0","0","0","9","3","6","0","0","0","11","5","6","0","0","0","29","15","14","0","0","0","0","0","0","12","7","5","-2"
"226152","Texas A & M International University","2016","Not on tenure track/No tenure system system total","85","32","53","0","0","0","3","0","3","4","3","1","44","16","28","0","0","0","29","10","19","0","0","0","0","0","0","5","3","2","-2"
"226152","Texas A & M International University","2016","Not on tenure/no tenure system, professors","1","1","0","0","0","0","0","0","0","0","0","0","0","0","0","0","0","0","0","0","0","0","0","0","0","0","0","1","1","0","-2"
"226152","Texas A & M International University","2016","Not on tenure/no tenure system, associate professors","8","4","4","0","0","0","1","0","1","1","1","0","3","1","2","0","0","0","3","2","1","0","0","0","0","0","0","0","0","0","-2"
"226152","Texas A & M International University","2016","Not on tenure/no tenure system, assistant professors","42","10","32","0","0","0","2","0","2","0","0","0","20","4","16","0","0","0","17","5","12","0","0","0","0","0","0","3","1","2","-2"
"226152","Texas A & M International University","2016","Not on tenure/no tenure system, instructors","26","11","15","0","0","0","0","0","0","0","0","0","19","9","10","0","0","0","6","1","5","0","0","0","0","0","0","1","1","0","-2"
"226152","Texas A & M International University","2016","Not on tenure/no tenure system, lecturers","8","6","2","0","0","0","0","0","0","3","2","1","2","2","0","0","0","0","3","2","1","0","0","0","0","0","0","0","0","0","-2"
"226587","McMurry University","2016","Tenured total","46","32","14","1","1","0","1","0","1","0","0","0","4","1","3","0","0","0","40","30","10","0","0","0","0","0","0","0","0","0","-2"
"226587","McMurry University","2016","Tenured, professors","26","20","6","1","1","0","0","0","0","0","0","0","0","0","0","0","0","0","25","19","6","0","0","0","0","0","0","0","0","0","-2"
"226587","McMurry University","2016","Tenured, associate professors","19","12","7","0","0","0","1","0","1","0","0","0","4","1","3","0","0","0","14","11","3","0","0","0","0","0","0","0","0","0","-2"
"226587","McMurry University","2016","Tenured, assistant professors","1","0","1","0","0","0","0","0","0","0","0","0","0","0","0","0","0","0","1","0","1","0","0","0","0","0","0","0","0","0","-2"
"226587","McMurry University","2016","On-Tenure track total","10","4","6","0","0","0","0","0","0","0","0","0","0","0","0","0","0","0","9","3","6","0","0","0","0","0","0","1","1","0","-2"
"226587","McMurry University","2016","On-tenure track, assistant professors","9","4","5","0","0","0","0","0","0","0","0","0","0","0","0","0","0","0","8","3","5","0","0","0","0","0","0","1","1","0","-2"
"226587","McMurry University","2016","On-tenure track, instructors","1","0","1","0","0","0","0","0","0","0","0","0","0","0","0","0","0","0","1","0","1","0","0","0","0","0","0","0","0","0","-2"
"226587","McMurry University","2016","Not on tenure track/No tenure system system total","19","7","12","0","0","0","0","0","0","0","0","0","1","1","0","0","0","0","17","6","11","0","0","0","0","0","0","1","0","1","-2"
"226587","McMurry University","2016","Not on tenure/no tenure system, assistant professors","3","3","0","0","0","0","0","0","0","0","0","0","1","1","0","0","0","0","2","2","0","0","0","0","0","0","0","0","0","0","-2"
"226587","McMurry University","2016","Not on tenure/no tenure system, instructors","16","4","12","0","0","0","0","0","0","0","0","0","0","0","0","0","0","0","15","4","11","0","0","0","0","0","0","1","0","1","-2"
"226806","Midland College","2016","Not on tenure track/No tenure system system total","135","62","73","0","0","0","1","1","0","4","2","2","19","9","10","0","0","0","110","50","60","0","0","0","1","0","1","0","0","0","-2"
"226806","Midland College","2016","Not on tenure/no tenure system, professors","48","21","27","0","0","0","1","1","0","1","1","0","6","2","4","0","0","0","39","17","22","0","0","0","1","0","1","0","0","0","-2"
"226806","Midland College","2016","Not on tenure/no tenure system, associate professors","42","17","25","0","0","0","0","0","0","0","0","0","9","6","3","0","0","0","33","11","22","0","0","0","0","0","0","0","0","0","-2"
"226806","Midland College","2016","Not on tenure/no tenure system, assistant professors","12","7","5","0","0","0","0","0","0","0","0","0","1","0","1","0","0","0","11","7","4","0","0","0","0","0","0","0","0","0","-2"
"226806","Midland College","2016","Not on tenure/no tenure system, instructors","33","17","16","0","0","0","0","0","0","3","1","2","3","1","2","0","0","0","27","15","12","0","0","0","0","0","0","0","0","0","-2"
"227216","University of North Texas","2016","Tenured total","609","410","199","1","1","0","92","65","27","21","10","11","34","22","12","0","0","0","425","289","136","7","5","2","16","12","4","13","6","7","-2"
"227216","University of North Texas","2016","Tenured, professors","312","233","79","1","1","0","34","30","4","9","5","4","17","11","6","0","0","0","235","173","62","3","2","1","10","8","2","3","3","0","-2"
"227216","University of North Texas","2016","Tenured, associate professors","296","176","120","0","0","0","58","35","23","12","5","7","17","11","6","0","0","0","189","115","74","4","3","1","6","4","2","10","3","7","-2"
"227216","University of North Texas","2016","Tenured, assistant professors","1","1","0","0","0","0","0","0","0","0","0","0","0","0","0","0","0","0","1","1","0","0","0","0","0","0","0","0","0","0","-2"
"227216","University of North Texas","2016","On-Tenure track total","138","63","75","0","0","0","27","13","14","12","4","8","13","5","8","0","0","0","73","37","36","2","1","1","7","1","6","4","2","2","-2"
"227216","University of North Texas","2016","On-tenure track, associate professors","4","4","0","0","0","0","1","1","0","0","0","0","0","0","0","0","0","0","3","3","0","0","0","0","0","0","0","0","0","0","-2"
"227216","University of North Texas","2016","On-tenure track, assistant professors","134","59","75","0","0","0","26","12","14","12","4","8","13","5","8","0","0","0","70","34","36","2","1","1","7","1","6","4","2","2","-2"
"227216","University of North Texas","2016","Not on tenure track/No tenure system system total","348","129","219","1","0","1","23","6","17","21","6","15","25","8","17","1","0","1","254","102","152","8","0","8","9","4","5","6","3","3","-2"
"227216","University of North Texas","2016","Not on tenure/no tenure system, professors","1","0","1","0","0","0","0","0","0","0","0","0","0","0","0","0","0","0","1","0","1","0","0","0","0","0","0","0","0","0","-2"
"227216","University of North Texas","2016","Not on tenure/no tenure system, associate professors","2","0","2","0","0","0","0","0","0","0","0","0","0","0","0","0","0","0","2","0","2","0","0","0","0","0","0","0","0","0","-2"
"227216","University of North Texas","2016","Not on tenure/no tenure system, assistant professors","1","1","0","0","0","0","0","0","0","0","0","0","0","0","0","0","0","0","1","1","0","0","0","0","0","0","0","0","0","0","-2"
"227216","University of North Texas","2016","Not on tenure/no tenure system, instructors","87","27","60","0","0","0","2","0","2","3","0","3","9","3","6","0","0","0","66","21","45","3","0","3","3","2","1","1","1","0","-2"
"227216","University of North Texas","2016","Not on tenure/no tenure system, lecturers","254","100","154","1","0","1","20","5","15","18","6","12","16","5","11","1","0","1","182","80","102","5","0","5","6","2","4","5","2","3","-2"
"227216","University of North Texas","2016","Not on tenure/no tenure system, no academic rank","3","1","2","0","0","0","1","1","0","0","0","0","0","0","0","0","0","0","2","0","2","0","0","0","0","0","0","0","0","0","-2"
"227331","Our Lady of the Lake University","2016","Tenured total","37","15","22","0","0","0","1","1","0","2","1","1","8","3","5","0","0","0","26","10","16","0","0","0","0","0","0","0","0","0","-2"
"227331","Our Lady of the Lake University","2016","Tenured, professors","21","8","13","0","0","0","1","1","0","1","0","1","4","1","3","0","0","0","15","6","9","0","0","0","0","0","0","0","0","0","-2"
"227331","Our Lady of the Lake University","2016","Tenured, associate professors","16","7","9","0","0","0","0","0","0","1","1","0","4","2","2","0","0","0","11","4","7","0","0","0","0","0","0","0","0","0","-2"
"227331","Our Lady of the Lake University","2016","On-Tenure track total","29","7","22","0","0","0","2","0","2","3","1","2","11","3","8","0","0","0","11","1","10","0","0","0","0","0","0","2","2","0","-2"
"227331","Our Lady of the Lake University","2016","On-tenure track, associate professors","1","1","0","0","0","0","0","0","0","0","0","0","1","1","0","0","0","0","0","0","0","0","0","0","0","0","0","0","0","0","-2"
"227331","Our Lady of the Lake University","2016","On-tenure track, assistant professors","28","6","22","0","0","0","2","0","2","3","1","2","10","2","8","0","0","0","11","1","10","0","0","0","0","0","0","2","2","0","-2"
"227331","Our Lady of the Lake University","2016","Not on tenure track/No tenure system system total","34","15","19","0","0","0","1","1","0","0","0","0","14","5","9","0","0","0","19","9","10","0","0","0","0","0","0","0","0","0","-2"
"227331","Our Lady of the Lake University","2016","Not on tenure/no tenure system, professors","3","0","3","0","0","0","0","0","0","0","0","0","1","0","1","0","0","0","2","0","2","0","0","0","0","0","0","0","0","0","-2"
"227331","Our Lady of the Lake University","2016","Not on tenure/no tenure system, associate professors","5","3","2","0","0","0","0","0","0","0","0","0","2","1","1","0","0","0","3","2","1","0","0","0","0","0","0","0","0","0","-2"
"227331","Our Lady of the Lake University","2016","Not on tenure/no tenure system, assistant professors","25","11","14","0","0","0","1","1","0","0","0","0","11","4","7","0","0","0","13","6","7","0","0","0","0","0","0","0","0","0","-2"
"227331","Our Lady of the Lake University","2016","Not on tenure/no tenure system, instructors","1","1","0","0","0","0","0","0","0","0","0","0","0","0","0","0","0","0","1","1","0","0","0","0","0","0","0","0","0","0","-2"
"227368","The University of Texas Rio Grande Valley","2016","Tenured total","434","299","135","2","1","1","77","58","19","13","11","2","99","50","49","0","0","0","216","158","58","14","12","2","7","5","2","6","4","2","-2"
"227368","The University of Texas Rio Grande Valley","2016","Tenured, professors","156","119","37","1","1","0","26","23","3","3","3","0","29","16","13","0","0","0","83","64","19","10","8","2","4","4","0","0","0","0","-2"
"227368","The University of Texas Rio Grande Valley","2016","Tenured, associate professors","278","180","98","1","0","1","51","35","16","10","8","2","70","34","36","0","0","0","133","94","39","4","4","0","3","1","2","6","4","2","-2"
"227368","The University of Texas Rio Grande Valley","2016","On-Tenure track total","241","147","94","1","1","0","32","20","12","10","7","3","65","36","29","0","0","0","96","57","39","2","1","1","5","4","1","30","21","9","-2"
"227368","The University of Texas Rio Grande Valley","2016","On-tenure track, professors","8","6","2","0","0","0","1","1","0","0","0","0","2","1","1","0","0","0","1","1","0","0","0","0","4","3","1","0","0","0","-2"
"227368","The University of Texas Rio Grande Valley","2016","On-tenure track, assistant professors","233","141","92","1","1","0","31","19","12","10","7","3","63","35","28","0","0","0","95","56","39","2","1","1","1","1","0","30","21","9","-2"
"227368","The University of Texas Rio Grande Valley","2016","Not on tenure track/No tenure system system total","476","221","255","1","0","1","44","19","25","6","1","5","233","104","129","0","0","0","143","68","75","6","2","4","21","13","8","22","14","8","-2"
"227368","The University of Texas Rio Grande Valley","2016","Not on tenure/no tenure system, professors","5","4","1","0","0","0","1","1","0","0","0","0","0","0","0","0","0","0","4","3","1","0","0","0","0","0","0","0","0","0","-2"
"227368","The University of Texas Rio Grande Valley","2016","Not on tenure/no tenure system, associate professors","11","6","5","0","0","0","2","1","1","0","0","0","3","2","1","0","0","0","4","2","2","0","0","0","2","1","1","0","0","0","-2"
"227368","The University of Texas Rio Grande Valley","2016","Not on tenure/no tenure system, assistant professors","15","7","8","0","0","0","1","0","1","1","0","1","8","4","4","0","0","0","4","2","2","0","0","0","0","0","0","1","1","0","-2"
"227368","The University of Texas Rio Grande Valley","2016","Not on tenure/no tenure system, lecturers","381","189","192","1","0","1","32","16","16","3","1","2","187","89","98","0","0","0","114","57","57","6","2","4","19","12","7","19","12","7","-2"
"227368","The University of Texas Rio Grande Valley","2016","Not on tenure/no tenure system, no academic rank","64","15","49","0","0","0","8","1","7","2","0","2","35","9","26","0","0","0","17","4","13","0","0","0","0","0","0","2","1","1","-2"
"227845","Saint Edward's University","2016","Tenured total","79","37","42","0","0","0","1","1","0","2","0","2","5","1","4","0","0","0","70","34","36","1","1","0","0","0","0","0","0","0","-2"
"227845","Saint Edward's University","2016","Tenured, professors","32","16","16","0","0","0","0","0","0","1","0","1","2","0","2","0","0","0","28","15","13","1","1","0","0","0","0","0","0","0","-2"
"227845","Saint Edward's University","2016","Tenured, associate professors","47","21","26","0","0","0","1","1","0","1","0","1","3","1","2","0","0","0","42","19","23","0","0","0","0","0","0","0","0","0","-2"
"227845","Saint Edward's University","2016","On-Tenure track total","81","36","45","0","0","0","4","3","1","2","0","2","7","2","5","0","0","0","63","29","34","1","0","1","3","2","1","1","0","1","-2"
"227845","Saint Edward's University","2016","On-tenure track, professors","1","0","1","0","0","0","0","0","0","0","0","0","0","0","0","0","0","0","1","0","1","0","0","0","0","0","0","0","0","0","-2"
"227845","Saint Edward's University","2016","On-tenure track, associate professors","34","18","16","0","0","0","1","1","0","0","0","0","3","1","2","0","0","0","28","16","12","0","0","0","1","0","1","1","0","1","-2"
"227845","Saint Edward's University","2016","On-tenure track, assistant professors","46","18","28","0","0","0","3","2","1","2","0","2","4","1","3","0","0","0","34","13","21","1","0","1","2","2","0","0","0","0","-2"
"227845","Saint Edward's University","2016","Not on tenure track/No tenure system system total","36","19","17","0","0","0","2","2","0","0","0","0","2","2","0","0","0","0","30","14","16","0","0","0","1","1","0","1","0","1","-2"
"227845","Saint Edward's University","2016","Not on tenure/no tenure system, assistant professors","32","17","15","0","0","0","1","1","0","0","0","0","2","2","0","0","0","0","27","13","14","0","0","0","1","1","0","1","0","1","-2"
"227845","Saint Edward's University","2016","Not on tenure/no tenure system, instructors","4","2","2","0","0","0","1","1","0","0","0","0","0","0","0","0","0","0","3","1","2","0","0","0","0","0","0","0","0","0","-2"
"227863","University of St Thomas","2016","Tenured total","79","50","29","0","0","0","4","2","2","2","2","0","8","3","5","0","0","0","59","40","19","3","3","0","1","0","1","2","0","2","-2"
"227863","University of St Thomas","2016","Tenured, professors","35","22","13","0","0","0","2","1","1","0","0","0","2","1","1","0","0","0","31","20","11","0","0","0","0","0","0","0","0","0","-2"
"227863","University of St Thomas","2016","Tenured, associate professors","43","27","16","0","0","0","2","1","1","2","2","0","5","1","4","0","0","0","28","20","8","3","3","0","1","0","1","2","0","2","-2"
"227863","University of St Thomas","2016","Tenured, assistant professors","1","1","0","0","0","0","0","0","0","0","0","0","1","1","0","0","0","0","0","0","0","0","0","0","0","0","0","0","0","0","-2"
"227863","University of St Thomas","2016","On-Tenure track total","38","20","18","0","0","0","5","3","2","2","1","1","8","6","2","0","0","0","15","8","7","0","0","0","2","1","1","6","1","5","-2"
"227863","University of St Thomas","2016","On-tenure track, associate professors","4","3","1","0","0","0","0","0","0","0","0","0","2","2","0","0","0","0","2","1","1","0","0","0","0","0","0","0","0","0","-2"
"227863","University of St Thomas","2016","On-tenure track, assistant professors","34","17","17","0","0","0","5","3","2","2","1","1","6","4","2","0","0","0","13","7","6","0","0","0","2","1","1","6","1","5","-2"
"227863","University of St Thomas","2016","Not on tenure track/No tenure system system total","61","27","34","0","0","0","6","2","4","13","2","11","7","3","4","0","0","0","31","17","14","0","0","0","0","0","0","4","3","1","-2"
"227863","University of St Thomas","2016","Not on tenure/no tenure system, professors","5","2","3","0","0","0","0","0","0","2","0","2","1","1","0","0","0","0","2","1","1","0","0","0","0","0","0","0","0","0","-2"
"227863","University of St Thomas","2016","Not on tenure/no tenure system, associate professors","4","3","1","0","0","0","0","0","0","0","0","0","0","0","0","0","0","0","4","3","1","0","0","0","0","0","0","0","0","0","-2"
"227863","University of St Thomas","2016","Not on tenure/no tenure system, assistant professors","40","14","26","0","0","0","5","2","3","11","2","9","6","2","4","0","0","0","16","7","9","0","0","0","0","0","0","2","1","1","-2"
"227863","University of St Thomas","2016","Not on tenure/no tenure system, instructors","12","8","4","0","0","0","1","0","1","0","0","0","0","0","0","0","0","0","9","6","3","0","0","0","0","0","0","2","2","0","-2"
"228042","Schreiner University","2016","Tenured total","22","13","9","0","0","0","0","0","0","0","0","0","0","0","0","0","0","0","22","13","9","0","0","0","0","0","0","0","0","0","-2"
"228042","Schreiner University","2016","Tenured, professors","13","7","6","0","0","0","0","0","0","0","0","0","0","0","0","0","0","0","13","7","6","0","0","0","0","0","0","0","0","0","-2"
"228042","Schreiner University","2016","Tenured, associate professors","6","4","2","0","0","0","0","0","0","0","0","0","0","0","0","0","0","0","6","4","2","0","0","0","0","0","0","0","0","0","-2"
"228042","Schreiner University","2016","Tenured, assistant professors","3","2","1","0","0","0","0","0","0","0","0","0","0","0","0","0","0","0","3","2","1","0","0","0","0","0","0","0","0","0","-2"
"228042","Schreiner University","2016","On-Tenure track total","20","11","9","0","0","0","1","0","1","0","0","0","2","2","0","0","0","0","17","9","8","0","0","0","0","0","0","0","0","0","-2"
"228042","Schreiner University","2016","On-tenure track, assistant professors","20","11","9","0","0","0","1","0","1","0","0","0","2","2","0","0","0","0","17","9","8","0","0","0","0","0","0","0","0","0","-2"
"228042","Schreiner University","2016","Not on tenure track/No tenure system system total","21","7","14","0","0","0","1","0","1","1","1","0","4","1","3","0","0","0","15","5","10","0","0","0","0","0","0","0","0","0","-2"
"228042","Schreiner University","2016","Not on tenure/no tenure system, assistant professors","8","4","4","0","0","0","0","0","0","0","0","0","1","1","0","0","0","0","7","3","4","0","0","0","0","0","0","0","0","0","-2"
"228042","Schreiner University","2016","Not on tenure/no tenure system, instructors","13","3","10","0","0","0","1","0","1","1","1","0","3","0","3","0","0","0","8","2","6","0","0","0","0","0","0","0","0","0","-2"
"228149","St. Mary's University","2016","Tenured total","131","86","45","1","1","0","10","9","1","4","3","1","16","11","5","1","1","0","99","61","38","0","0","0","0","0","0","0","0","0","-2"
"228149","St. Mary's University","2016","Tenured, professors","82","56","26","0","0","0","8","8","0","3","3","0","8","4","4","1","1","0","62","40","22","0","0","0","0","0","0","0","0","0","-2"
"228149","St. Mary's University","2016","Tenured, associate professors","46","27","19","1","1","0","2","1","1","1","0","1","8","7","1","0","0","0","34","18","16","0","0","0","0","0","0","0","0","0","-2"
"228149","St. Mary's University","2016","Tenured, assistant professors","3","3","0","0","0","0","0","0","0","0","0","0","0","0","0","0","0","0","3","3","0","0","0","0","0","0","0","0","0","0","-2"
"228149","St. Mary's University","2016","On-Tenure track total","36","22","14","0","0","0","3","2","1","2","2","0","7","6","1","0","0","0","20","9","11","0","0","0","2","1","1","2","2","0","-2"
"228149","St. Mary's University","2016","On-tenure track, associate professors","2","1","1","0","0","0","0","0","0","1","1","0","0","0","0","0","0","0","1","0","1","0","0","0","0","0","0","0","0","0","-2"
"228149","St. Mary's University","2016","On-tenure track, assistant professors","34","21","13","0","0","0","3","2","1","1","1","0","7","6","1","0","0","0","19","9","10","0","0","0","2","1","1","2","2","0","-2"
"228149","St. Mary's University","2016","Not on tenure track/No tenure system system total","49","27","22","1","1","0","0","0","0","2","1","1","12","6","6","0","0","0","33","18","15","0","0","0","1","1","0","0","0","0","-2"
"228149","St. Mary's University","2016","Not on tenure/no tenure system, professors","8","2","6","0","0","0","0","0","0","0","0","0","2","1","1","0","0","0","6","1","5","0","0","0","0","0","0","0","0","0","-2"
"228149","St. Mary's University","2016","Not on tenure/no tenure system, associate professors","1","1","0","0","0","0","0","0","0","0","0","0","0","0","0","0","0","0","1","1","0","0","0","0","0","0","0","0","0","0","-2"
"228149","St. Mary's University","2016","Not on tenure/no tenure system, assistant professors","14","11","3","1","1","0","0","0","0","1","1","0","2","1","1","0","0","0","10","8","2","0","0","0","0","0","0","0","0","0","-2"
"228149","St. Mary's University","2016","Not on tenure/no tenure system, instructors","18","10","8","0","0","0","0","0","0","1","0","1","4","3","1","0","0","0","12","6","6","0","0","0","1","1","0","0","0","0","-2"
"228149","St. Mary's University","2016","Not on tenure/no tenure system, lecturers","8","3","5","0","0","0","0","0","0","0","0","0","4","1","3","0","0","0","4","2","2","0","0","0","0","0","0","0","0","0","-2"
"228468","Southwestern Adventist University","2016","Not on tenure track/No tenure system system total","50","31","19","0","0","0","2","1","1","4","4","0","5","4","1","1","0","1","35","20","15","0","0","0","0","0","0","3","2","1","-2"
"228468","Southwestern Adventist University","2016","Not on tenure/no tenure system, professors","14","13","1","0","0","0","0","0","0","3","3","0","1","1","0","0","0","0","10","9","1","0","0","0","0","0","0","0","0","0","-2"
"228468","Southwestern Adventist University","2016","Not on tenure/no tenure system, associate professors","12","9","3","0","0","0","1","1","0","1","1","0","1","1","0","0","0","0","8","5","3","0","0","0","0","0","0","1","1","0","-2"
"228468","Southwestern Adventist University","2016","Not on tenure/no tenure system, assistant professors","23","9","14","0","0","0","1","0","1","0","0","0","3","2","1","1","0","1","16","6","10","0","0","0","0","0","0","2","1","1","-2"
"228468","Southwestern Adventist University","2016","Not on tenure/no tenure system, instructors","1","0","1","0","0","0","0","0","0","0","0","0","0","0","0","0","0","0","1","0","1","0","0","0","0","0","0","0","0","0","-2"
"228501","Sul Ross State University","2016","Tenured total","52","32","20","1","1","0","1","1","0","2","2","0","9","6","3","0","0","0","37","22","15","1","0","1","0","0","0","1","0","1","-2"
"228501","Sul Ross State University","2016","Tenured, professors","38","24","14","0","0","0","1","1","0","2","2","0","5","3","2","0","0","0","28","18","10","1","0","1","0","0","0","1","0","1","-2"
"228501","Sul Ross State University","2016","Tenured, associate professors","13","7","6","1","1","0","0","0","0","0","0","0","4","3","1","0","0","0","8","3","5","0","0","0","0","0","0","0","0","0","-2"
"228501","Sul Ross State University","2016","Tenured, assistant professors","1","1","0","0","0","0","0","0","0","0","0","0","0","0","0","0","0","0","1","1","0","0","0","0","0","0","0","0","0","0","-2"
"228501","Sul Ross State University","2016","On-Tenure track total","42","23","19","0","0","0","1","1","0","0","0","0","11","4","7","0","0","0","26","14","12","0","0","0","0","0","0","4","4","0","-2"
"228501","Sul Ross State University","2016","On-tenure track, associate professors","6","4","2","0","0","0","0","0","0","0","0","0","2","2","0","0","0","0","4","2","2","0","0","0","0","0","0","0","0","0","-2"
"228501","Sul Ross State University","2016","On-tenure track, assistant professors","34","19","15","0","0","0","1","1","0","0","0","0","8","2","6","0","0","0","21","12","9","0","0","0","0","0","0","4","4","0","-2"
"228501","Sul Ross State University","2016","On-tenure track, instructors","2","0","2","0","0","0","0","0","0","0","0","0","1","0","1","0","0","0","1","0","1","0","0","0","0","0","0","0","0","0","-2"
"228501","Sul Ross State University","2016","Not on tenure track/No tenure system system total","26","14","12","0","0","0","0","0","0","1","1","0","6","3","3","0","0","0","18","9","9","0","0","0","0","0","0","1","1","0","-2"
"228501","Sul Ross State University","2016","Not on tenure/no tenure system, assistant professors","1","1","0","0","0","0","0","0","0","0","0","0","0","0","0","0","0","0","0","0","0","0","0","0","0","0","0","1","1","0","-2"
"228501","Sul Ross State University","2016","Not on tenure/no tenure system, instructors","2","1","1","0","0","0","0","0","0","0","0","0","0","0","0","0","0","0","2","1","1","0","0","0","0","0","0","0","0","0","-2"
"228501","Sul Ross State University","2016","Not on tenure/no tenure system, lecturers","23","12","11","0","0","0","0","0","0","1","1","0","6","3","3","0","0","0","16","8","8","0","0","0","0","0","0","0","0","0","-2"
"228644","The University of Texas Health Science Center at San Antonio","2016","Tenured total","255","179","76","1","0","1","41","31","10","5","4","1","29","15","14","0","0","0","176","126","50","0","0","0","3","3","0","0","0","0","-2"
"228644","The University of Texas Health Science Center at San Antonio","2016","Tenured, professors","173","130","43","0","0","0","26","22","4","2","2","0","18","12","6","0","0","0","125","92","33","0","0","0","2","2","0","0","0","0","-2"
"228644","The University of Texas Health Science Center at San Antonio","2016","Tenured, associate professors","76","49","27","1","0","1","13","9","4","2","2","0","10","3","7","0","0","0","49","34","15","0","0","0","1","1","0","0","0","0","-2"
"228644","The University of Texas Health Science Center at San Antonio","2016","Tenured, assistant professors","6","0","6","0","0","0","2","0","2","1","0","1","1","0","1","0","0","0","2","0","2","0","0","0","0","0","0","0","0","0","-2"
"228644","The University of Texas Health Science Center at San Antonio","2016","On-Tenure track total","58","33","25","1","1","0","18","8","10","2","2","0","9","5","4","0","0","0","27","16","11","0","0","0","1","1","0","0","0","0","-2"
"228644","The University of Texas Health Science Center at San Antonio","2016","On-tenure track, professors","1","1","0","0","0","0","0","0","0","0","0","0","0","0","0","0","0","0","1","1","0","0","0","0","0","0","0","0","0","0","-2"
"228644","The University of Texas Health Science Center at San Antonio","2016","On-tenure track, associate professors","8","5","3","0","0","0","1","1","0","0","0","0","1","0","1","0","0","0","6","4","2","0","0","0","0","0","0","0","0","0","-2"
"228644","The University of Texas Health Science Center at San Antonio","2016","On-tenure track, assistant professors","49","27","22","1","1","0","17","7","10","2","2","0","8","5","3","0","0","0","20","11","9","0","0","0","1","1","0","0","0","0","-2"
"228644","The University of Texas Health Science Center at San Antonio","2016","Not on tenure track/No tenure system system total","506","247","259","1","0","1","85","44","41","14","4","10","86","38","48","1","0","1","295","150","145","0","0","0","24","11","13","0","0","0","-2"
"228644","The University of Texas Health Science Center at San Antonio","2016","Not on tenure/no tenure system, professors","56","37","19","0","0","0","6","3","3","1","1","0","4","3","1","0","0","0","45","30","15","0","0","0","0","0","0","0","0","0","-2"
"228644","The University of Texas Health Science Center at San Antonio","2016","Not on tenure/no tenure system, associate professors","115","69","46","0","0","0","21","13","8","1","0","1","13","6","7","1","0","1","78","49","29","0","0","0","1","1","0","0","0","0","-2"
"228644","The University of Texas Health Science Center at San Antonio","2016","Not on tenure/no tenure system, assistant professors","283","121","162","1","0","1","56","27","29","10","2","8","57","25","32","0","0","0","137","57","80","0","0","0","22","10","12","0","0","0","-2"
"228644","The University of Texas Health Science Center at San Antonio","2016","Not on tenure/no tenure system, instructors","30","10","20","0","0","0","2","1","1","0","0","0","10","3","7","0","0","0","17","6","11","0","0","0","1","0","1","0","0","0","-2"
"228644","The University of Texas Health Science Center at San Antonio","2016","Not on tenure/no tenure system, lecturers","3","1","2","0","0","0","0","0","0","0","0","0","0","0","0","0","0","0","3","1","2","0","0","0","0","0","0","0","0","0","-2"
"228644","The University of Texas Health Science Center at San Antonio","2016","Not on tenure/no tenure system, no academic rank","19","9","10","0","0","0","0","0","0","2","1","1","2","1","1","0","0","0","15","7","8","0","0","0","0","0","0","0","0","0","-2"
"228705","Texas A & M University-Kingsville","2016","Tenured total","164","118","46","2","2","0","24","20","4","6","6","0","26","18","8","0","0","0","103","71","32","0","0","0","0","0","0","3","1","2","-2"
"228705","Texas A & M University-Kingsville","2016","Tenured, professors","97","75","22","1","1","0","17","15","2","4","4","0","13","9","4","0","0","0","61","46","15","0","0","0","0","0","0","1","0","1","-2"
"228705","Texas A & M University-Kingsville","2016","Tenured, associate professors","63","43","20","1","1","0","6","5","1","2","2","0","13","9","4","0","0","0","39","25","14","0","0","0","0","0","0","2","1","1","-2"
"228705","Texas A & M University-Kingsville","2016","Tenured, assistant professors","4","0","4","0","0","0","1","0","1","0","0","0","0","0","0","0","0","0","3","0","3","0","0","0","0","0","0","0","0","0","-2"
"228705","Texas A & M University-Kingsville","2016","On-Tenure track total","127","84","43","1","1","0","15","12","3","2","1","1","11","4","7","0","0","0","62","40","22","1","1","0","3","2","1","32","23","9","-2"
"228705","Texas A & M University-Kingsville","2016","On-tenure track, professors","2","2","0","0","0","0","0","0","0","0","0","0","0","0","0","0","0","0","2","2","0","0","0","0","0","0","0","0","0","0","-2"
"228705","Texas A & M University-Kingsville","2016","On-tenure track, associate professors","10","9","1","0","0","0","0","0","0","0","0","0","2","2","0","0","0","0","7","6","1","0","0","0","1","1","0","0","0","0","-2"
"228705","Texas A & M University-Kingsville","2016","On-tenure track, assistant professors","115","73","42","1","1","0","15","12","3","2","1","1","9","2","7","0","0","0","53","32","21","1","1","0","2","1","1","32","23","9","-2"
"228705","Texas A & M University-Kingsville","2016","Not on tenure track/No tenure system system total","107","60","47","3","2","1","8","7","1","4","4","0","26","9","17","0","0","0","49","24","25","2","2","0","0","0","0","15","12","3","-2"
"228705","Texas A & M University-Kingsville","2016","Not on tenure/no tenure system, professors","1","1","0","0","0","0","0","0","0","0","0","0","0","0","0","0","0","0","0","0","0","0","0","0","0","0","0","1","1","0","-2"
"228705","Texas A & M University-Kingsville","2016","Not on tenure/no tenure system, associate professors","1","1","0","0","0","0","0","0","0","0","0","0","0","0","0","0","0","0","1","1","0","0","0","0","0","0","0","0","0","0","-2"
"228705","Texas A & M University-Kingsville","2016","Not on tenure/no tenure system, assistant professors","11","8","3","0","0","0","2","2","0","0","0","0","2","1","1","0","0","0","2","1","1","0","0","0","0","0","0","5","4","1","-2"
"228705","Texas A & M University-Kingsville","2016","Not on tenure/no tenure system, instructors","1","0","1","0","0","0","0","0","0","0","0","0","0","0","0","0","0","0","0","0","0","0","0","0","0","0","0","1","0","1","-2"
"228705","Texas A & M University-Kingsville","2016","Not on tenure/no tenure system, lecturers","78","43","35","3","2","1","3","3","0","3","3","0","21","8","13","0","0","0","38","18","20","2","2","0","0","0","0","8","7","1","-2"
"228705","Texas A & M University-Kingsville","2016","Not on tenure/no tenure system, no academic rank","15","7","8","0","0","0","3","2","1","1","1","0","3","0","3","0","0","0","8","4","4","0","0","0","0","0","0","0","0","0","-2"
"228981","Texas Lutheran University","2016","Tenured total","48","28","20","0","0","0","1","0","1","1","1","0","1","0","1","0","0","0","44","26","18","0","0","0","1","1","0","0","0","0","-2"
"228981","Texas Lutheran University","2016","Tenured, professors","28","17","11","0","0","0","0","0","0","0","0","0","0","0","0","0","0","0","28","17","11","0","0","0","0","0","0","0","0","0","-2"
"228981","Texas Lutheran University","2016","Tenured, associate professors","17","8","9","0","0","0","1","0","1","0","0","0","1","0","1","0","0","0","14","7","7","0","0","0","1","1","0","0","0","0","-2"
"228981","Texas Lutheran University","2016","Tenured, assistant professors","3","3","0","0","0","0","0","0","0","1","1","0","0","0","0","0","0","0","2","2","0","0","0","0","0","0","0","0","0","0","-2"
"228981","Texas Lutheran University","2016","On-Tenure track total","27","9","18","0","0","0","0","0","0","0","0","0","4","1","3","0","0","0","21","7","14","0","0","0","1","0","1","1","1","0","-2"
"228981","Texas Lutheran University","2016","On-tenure track, associate professors","4","0","4","0","0","0","0","0","0","0","0","0","0","0","0","0","0","0","4","0","4","0","0","0","0","0","0","0","0","0","-2"
"228981","Texas Lutheran University","2016","On-tenure track, assistant professors","20","9","11","0","0","0","0","0","0","0","0","0","3","1","2","0","0","0","15","7","8","0","0","0","1","0","1","1","1","0","-2"
"228981","Texas Lutheran University","2016","On-tenure track, instructors","3","0","3","0","0","0","0","0","0","0","0","0","1","0","1","0","0","0","2","0","2","0","0","0","0","0","0","0","0","0","-2"
"228981","Texas Lutheran University","2016","Not on tenure track/No tenure system system total","7","2","5","0","0","0","0","0","0","0","0","0","1","1","0","0","0","0","6","1","5","0","0","0","0","0","0","0","0","0","-2"
"228981","Texas Lutheran University","2016","Not on tenure/no tenure system, assistant professors","3","2","1","0","0","0","0","0","0","0","0","0","1","1","0","0","0","0","2","1","1","0","0","0","0","0","0","0","0","0","-2"
"228981","Texas Lutheran University","2016","Not on tenure/no tenure system, lecturers","4","0","4","0","0","0","0","0","0","0","0","0","0","0","0","0","0","0","4","0","4","0","0","0","0","0","0","0","0","0","-2"
"229018","The University of Texas Permian Basin","2016","Tenured total","53","36","17","1","0","1","6","5","1","0","0","0","3","1","2","0","0","0","41","29","12","0","0","0","0","0","0","2","1","1","-2"
"229018","The University of Texas Permian Basin","2016","Tenured, professors","16","12","4","0","0","0","2","1","1","0","0","0","0","0","0","0","0","0","14","11","3","0","0","0","0","0","0","0","0","0","-2"
"229018","The University of Texas Permian Basin","2016","Tenured, associate professors","37","24","13","1","0","1","4","4","0","0","0","0","3","1","2","0","0","0","27","18","9","0","0","0","0","0","0","2","1","1","-2"
"229018","The University of Texas Permian Basin","2016","On-Tenure track total","36","20","16","0","0","0","4","4","0","1","0","1","5","2","3","0","0","0","23","12","11","0","0","0","0","0","0","3","2","1","-2"
"229018","The University of Texas Permian Basin","2016","On-tenure track, professors","3","2","1","0","0","0","0","0","0","0","0","0","0","0","0","0","0","0","3","2","1","0","0","0","0","0","0","0","0","0","-2"
"229018","The University of Texas Permian Basin","2016","On-tenure track, associate professors","4","3","1","0","0","0","1","1","0","0","0","0","0","0","0","0","0","0","3","2","1","0","0","0","0","0","0","0","0","0","-2"
"229018","The University of Texas Permian Basin","2016","On-tenure track, assistant professors","29","15","14","0","0","0","3","3","0","1","0","1","5","2","3","0","0","0","17","8","9","0","0","0","0","0","0","3","2","1","-2"
"229018","The University of Texas Permian Basin","2016","Not on tenure track/No tenure system system total","50","16","34","0","0","0","1","0","1","2","0","2","2","1","1","0","0","0","43","13","30","0","0","0","0","0","0","2","2","0","-2"
"229018","The University of Texas Permian Basin","2016","Not on tenure/no tenure system, professors","1","1","0","0","0","0","0","0","0","0","0","0","0","0","0","0","0","0","1","1","0","0","0","0","0","0","0","0","0","0","-2"
"229018","The University of Texas Permian Basin","2016","Not on tenure/no tenure system, associate professors","2","1","1","0","0","0","0","0","0","0","0","0","0","0","0","0","0","0","2","1","1","0","0","0","0","0","0","0","0","0","-2"
"229018","The University of Texas Permian Basin","2016","Not on tenure/no tenure system, assistant professors","1","0","1","0","0","0","0","0","0","0","0","0","0","0","0","0","0","0","1","0","1","0","0","0","0","0","0","0","0","0","-2"
"229018","The University of Texas Permian Basin","2016","Not on tenure/no tenure system, instructors","4","0","4","0","0","0","0","0","0","2","0","2","0","0","0","0","0","0","2","0","2","0","0","0","0","0","0","0","0","0","-2"
"229018","The University of Texas Permian Basin","2016","Not on tenure/no tenure system, lecturers","42","14","28","0","0","0","1","0","1","0","0","0","2","1","1","0","0","0","37","11","26","0","0","0","0","0","0","2","2","0","-2"
"229027","The University of Texas at San Antonio","2016","Tenured total","455","319","136","4","3","1","89","73","16","22","13","9","49","25","24","0","0","0","255","181","74","33","22","11","0","0","0","3","2","1","-2"
"229027","The University of Texas at San Antonio","2016","Tenured, professors","229","182","47","2","2","0","54","47","7","10","6","4","16","10","6","0","0","0","129","104","25","18","13","5","0","0","0","0","0","0","-2"
"229027","The University of Texas at San Antonio","2016","Tenured, associate professors","226","137","89","2","1","1","35","26","9","12","7","5","33","15","18","0","0","0","126","77","49","15","9","6","0","0","0","3","2","1","-2"
"229027","The University of Texas at San Antonio","2016","On-Tenure track total","166","103","63","0","0","0","26","18","8","4","3","1","12","7","5","0","0","0","72","42","30","19","8","11","0","0","0","33","25","8","-2"
"229027","The University of Texas at San Antonio","2016","On-tenure track, associate professors","9","8","1","0","0","0","3","3","0","0","0","0","0","0","0","0","0","0","4","4","0","2","1","1","0","0","0","0","0","0","-2"
"229027","The University of Texas at San Antonio","2016","On-tenure track, assistant professors","157","95","62","0","0","0","23","15","8","4","3","1","12","7","5","0","0","0","68","38","30","17","7","10","0","0","0","33","25","8","-2"
"229027","The University of Texas at San Antonio","2016","Not on tenure track/No tenure system system total","290","145","145","2","1","1","14","9","5","10","4","6","41","18","23","0","0","0","183","96","87","35","14","21","0","0","0","5","3","2","-2"
"229027","The University of Texas at San Antonio","2016","Not on tenure/no tenure system, professors","1","1","0","0","0","0","0","0","0","0","0","0","0","0","0","0","0","0","0","0","0","0","0","0","0","0","0","1","1","0","-2"
"229027","The University of Texas at San Antonio","2016","Not on tenure/no tenure system, associate professors","1","1","0","0","0","0","0","0","0","0","0","0","0","0","0","0","0","0","1","1","0","0","0","0","0","0","0","0","0","0","-2"
"229027","The University of Texas at San Antonio","2016","Not on tenure/no tenure system, assistant professors","14","3","11","0","0","0","1","1","0","2","0","2","2","0","2","0","0","0","3","1","2","6","1","5","0","0","0","0","0","0","-2"
"229027","The University of Texas at San Antonio","2016","Not on tenure/no tenure system, lecturers","274","140","134","2","1","1","13","8","5","8","4","4","39","18","21","0","0","0","179","94","85","29","13","16","0","0","0","4","2","2","-2"
"229160","Texas Wesleyan University","2016","Tenured total","77","38","39","0","0","0","5","3","2","1","1","0","5","3","2","0","0","0","65","30","35","1","1","0","0","0","0","0","0","0","-2"
"229160","Texas Wesleyan University","2016","Tenured, professors","37","21","16","0","0","0","2","2","0","1","1","0","4","3","1","0","0","0","29","14","15","1","1","0","0","0","0","0","0","0","-2"
"229160","Texas Wesleyan University","2016","Tenured, associate professors","39","17","22","0","0","0","3","1","2","0","0","0","1","0","1","0","0","0","35","16","19","0","0","0","0","0","0","0","0","0","-2"
"229160","Texas Wesleyan University","2016","Tenured, assistant professors","1","0","1","0","0","0","0","0","0","0","0","0","0","0","0","0","0","0","1","0","1","0","0","0","0","0","0","0","0","0","-2"
"229160","Texas Wesleyan University","2016","On-Tenure track total","35","17","18","0","0","0","1","0","1","1","0","1","5","3","2","0","0","0","26","12","14","2","2","0","0","0","0","0","0","0","-2"
"229160","Texas Wesleyan University","2016","On-tenure track, professors","1","0","1","0","0","0","0","0","0","0","0","0","0","0","0","0","0","0","1","0","1","0","0","0","0","0","0","0","0","0","-2"
"229160","Texas Wesleyan University","2016","On-tenure track, associate professors","4","1","3","0","0","0","0","0","0","0","0","0","1","0","1","0","0","0","2","0","2","1","1","0","0","0","0","0","0","0","-2"
"229160","Texas Wesleyan University","2016","On-tenure track, assistant professors","30","16","14","0","0","0","1","0","1","1","0","1","4","3","1","0","0","0","23","12","11","1","1","0","0","0","0","0","0","0","-2"
"229160","Texas Wesleyan University","2016","Not on tenure track/No tenure system system total","23","10","13","0","0","0","1","1","0","1","0","1","1","1","0","0","0","0","19","8","11","1","0","1","0","0","0","0","0","0","-2"
"229160","Texas Wesleyan University","2016","Not on tenure/no tenure system, professors","3","3","0","0","0","0","1","1","0","0","0","0","0","0","0","0","0","0","2","2","0","0","0","0","0","0","0","0","0","0","-2"
"229160","Texas Wesleyan University","2016","Not on tenure/no tenure system, associate professors","1","0","1","0","0","0","0","0","0","0","0","0","0","0","0","0","0","0","1","0","1","0","0","0","0","0","0","0","0","0","-2"
"229160","Texas Wesleyan University","2016","Not on tenure/no tenure system, assistant professors","8","3","5","0","0","0","0","0","0","0","0","0","1","1","0","0","0","0","6","2","4","1","0","1","0","0","0","0","0","0","-2"
"229160","Texas Wesleyan University","2016","Not on tenure/no tenure system, instructors","11","4","7","0","0","0","0","0","0","1","0","1","0","0","0","0","0","0","10","4","6","0","0","0","0","0","0","0","0","0","-2"
"229179","Texas Woman's University","2016","Tenured total","209","59","150","1","0","1","23","10","13","7","1","6","6","2","4","2","1","1","170","45","125","0","0","0","0","0","0","0","0","0","-2"
"229179","Texas Woman's University","2016","Tenured, professors","41","17","24","0","0","0","5","3","2","0","0","0","0","0","0","0","0","0","36","14","22","0","0","0","0","0","0","0","0","0","-2"
"229179","Texas Woman's University","2016","Tenured, associate professors","105","30","75","0","0","0","14","6","8","5","1","4","5","2","3","2","1","1","79","20","59","0","0","0","0","0","0","0","0","0","-2"
"229179","Texas Woman's University","2016","Tenured, assistant professors","60","11","49","1","0","1","3","0","3","2","0","2","1","0","1","0","0","0","53","11","42","0","0","0","0","0","0","0","0","0","-2"
"229179","Texas Woman's University","2016","Tenured, instructors","1","0","1","0","0","0","0","0","0","0","0","0","0","0","0","0","0","0","1","0","1","0","0","0","0","0","0","0","0","0","-2"
"229179","Texas Woman's University","2016","Tenured, lecturers","2","1","1","0","0","0","1","1","0","0","0","0","0","0","0","0","0","0","1","0","1","0","0","0","0","0","0","0","0","0","-2"
"229179","Texas Woman's University","2016","On-Tenure track total","113","33","80","1","0","1","10","2","8","9","2","7","7","1","6","0","0","0","78","24","54","7","3","4","1","1","0","0","0","0","-2"
"229179","Texas Woman's University","2016","On-tenure track, professors","1","0","1","0","0","0","0","0","0","0","0","0","0","0","0","0","0","0","1","0","1","0","0","0","0","0","0","0","0","0","-2"
"229179","Texas Woman's University","2016","On-tenure track, associate professors","9","1","8","0","0","0","1","0","1","0","0","0","0","0","0","0","0","0","7","1","6","1","0","1","0","0","0","0","0","0","-2"
"229179","Texas Woman's University","2016","On-tenure track, assistant professors","102","32","70","1","0","1","9","2","7","9","2","7","6","1","5","0","0","0","70","23","47","6","3","3","1","1","0","0","0","0","-2"
"229179","Texas Woman's University","2016","On-tenure track, lecturers","1","0","1","0","0","0","0","0","0","0","0","0","1","0","1","0","0","0","0","0","0","0","0","0","0","0","0","0","0","0","-2"
"229179","Texas Woman's University","2016","Not on tenure track/No tenure system system total","133","21","112","1","0","1","11","3","8","7","0","7","3","2","1","0","0","0","109","14","95","1","1","0","1","1","0","0","0","0","-2"
"229179","Texas Woman's University","2016","Not on tenure/no tenure system, professors","6","3","3","0","0","0","0","0","0","0","0","0","0","0","0","0","0","0","6","3","3","0","0","0","0","0","0","0","0","0","-2"
"229179","Texas Woman's University","2016","Not on tenure/no tenure system, associate professors","27","4","23","0","0","0","2","1","1","2","0","2","1","1","0","0","0","0","22","2","20","0","0","0","0","0","0","0","0","0","-2"
"229179","Texas Woman's University","2016","Not on tenure/no tenure system, assistant professors","82","11","71","1","0","1","8","2","6","4","0","4","2","1","1","0","0","0","65","6","59","1","1","0","1","1","0","0","0","0","-2"
"229179","Texas Woman's University","2016","Not on tenure/no tenure system, instructors","5","0","5","0","0","0","1","0","1","0","0","0","0","0","0","0","0","0","4","0","4","0","0","0","0","0","0","0","0","0","-2"
"229179","Texas Woman's University","2016","Not on tenure/no tenure system, lecturers","13","3","10","0","0","0","0","0","0","1","0","1","0","0","0","0","0","0","12","3","9","0","0","0","0","0","0","0","0","0","-2"
"229300","The University of Texas Health Science Center at Houston","2016","Tenured total","272","180","92","0","0","0","56","41","15","5","5","0","17","11","6","0","0","0","188","118","70","1","1","0","5","4","1","0","0","0","-2"
"229300","The University of Texas Health Science Center at Houston","2016","Tenured, professors","198","139","59","0","0","0","35","28","7","3","3","0","10","9","1","0","0","0","144","94","50","1","1","0","5","4","1","0","0","0","-2"
"229300","The University of Texas Health Science Center at Houston","2016","Tenured, associate professors","74","41","33","0","0","0","21","13","8","2","2","0","7","2","5","0","0","0","44","24","20","0","0","0","0","0","0","0","0","0","-2"
"229300","The University of Texas Health Science Center at Houston","2016","On-Tenure track total","162","93","69","0","0","0","52","36","16","9","4","5","14","6","8","0","0","0","77","41","36","0","0","0","1","0","1","9","6","3","-2"
"229300","The University of Texas Health Science Center at Houston","2016","On-tenure track, professors","21","18","3","0","0","0","5","5","0","1","1","0","1","1","0","0","0","0","14","11","3","0","0","0","0","0","0","0","0","0","-2"
"229300","The University of Texas Health Science Center at Houston","2016","On-tenure track, associate professors","34","19","15","0","0","0","12","9","3","2","1","1","5","1","4","0","0","0","15","8","7","0","0","0","0","0","0","0","0","0","-2"
"229300","The University of Texas Health Science Center at Houston","2016","On-tenure track, assistant professors","107","56","51","0","0","0","35","22","13","6","2","4","8","4","4","0","0","0","48","22","26","0","0","0","1","0","1","9","6","3","-2"
"229300","The University of Texas Health Science Center at Houston","2016","Not on tenure track/No tenure system system total","1251","682","569","5","5","0","351","206","145","93","25","68","117","57","60","19","19","0","562","304","258","9","4","5","31","16","15","64","46","18","-2"
"229300","The University of Texas Health Science Center at Houston","2016","Not on tenure/no tenure system, professors","109","72","37","0","0","0","18","11","7","3","0","3","6","3","3","0","0","0","77","54","23","0","0","0","3","3","0","2","1","1","-2"
"229300","The University of Texas Health Science Center at Houston","2016","Not on tenure/no tenure system, associate professors","233","133","100","3","3","0","68","40","28","6","3","3","25","13","12","0","0","0","124","70","54","3","1","2","3","3","0","1","0","1","-2"
"229300","The University of Texas Health Science Center at Houston","2016","Not on tenure/no tenure system, assistant professors","818","442","376","2","2","0","237","139","98","78","22","56","83","41","42","19","19","0","319","169","150","6","3","3","25","10","15","49","37","12","-2"
"229300","The University of Texas Health Science Center at Houston","2016","Not on tenure/no tenure system, instructors","76","33","43","0","0","0","28","16","12","4","0","4","2","0","2","0","0","0","31","9","22","0","0","0","0","0","0","11","8","3","-2"
"229300","The University of Texas Health Science Center at Houston","2016","Not on tenure/no tenure system, lecturers","15","2","13","0","0","0","0","0","0","2","0","2","1","0","1","0","0","0","11","2","9","0","0","0","0","0","0","1","0","1","-2"
"229337","Texas Tech University Health Sciences Center","2016","Tenured total","149","102","47","0","0","0","26","17","9","2","1","1","10","9","1","0","0","0","111","75","36","0","0","0","0","0","0","0","0","0","-2"
"229337","Texas Tech University Health Sciences Center","2016","Tenured, professors","107","79","28","0","0","0","23","16","7","1","0","1","6","6","0","0","0","0","77","57","20","0","0","0","0","0","0","0","0","0","-2"
"229337","Texas Tech University Health Sciences Center","2016","Tenured, associate professors","42","23","19","0","0","0","3","1","2","1","1","0","4","3","1","0","0","0","34","18","16","0","0","0","0","0","0","0","0","0","-2"
"229337","Texas Tech University Health Sciences Center","2016","On-Tenure track total","91","56","35","0","0","0","26","16","10","1","1","0","9","5","4","0","0","0","55","34","21","0","0","0","0","0","0","0","0","0","-2"
"229337","Texas Tech University Health Sciences Center","2016","On-tenure track, professors","16","14","2","0","0","0","6","5","1","0","0","0","1","1","0","0","0","0","9","8","1","0","0","0","0","0","0","0","0","0","-2"
"229337","Texas Tech University Health Sciences Center","2016","On-tenure track, associate professors","28","18","10","0","0","0","9","6","3","1","1","0","2","1","1","0","0","0","16","10","6","0","0","0","0","0","0","0","0","0","-2"
"229337","Texas Tech University Health Sciences Center","2016","On-tenure track, assistant professors","47","24","23","0","0","0","11","5","6","0","0","0","6","3","3","0","0","0","30","16","14","0","0","0","0","0","0","0","0","0","-2"
"229337","Texas Tech University Health Sciences Center","2016","Not on tenure track/No tenure system system total","744","349","395","2","2","0","132","83","49","42","15","27","124","59","65","0","0","0","443","189","254","0","0","0","1","1","0","0","0","0","-2"
"229337","Texas Tech University Health Sciences Center","2016","Not on tenure/no tenure system, professors","52","34","18","0","0","0","7","4","3","2","0","2","2","2","0","0","0","0","41","28","13","0","0","0","0","0","0","0","0","0","-2"
"229337","Texas Tech University Health Sciences Center","2016","Not on tenure/no tenure system, associate professors","181","95","86","2","2","0","28","19","9","10","4","6","23","14","9","0","0","0","117","55","62","0","0","0","1","1","0","0","0","0","-2"
"229337","Texas Tech University Health Sciences Center","2016","Not on tenure/no tenure system, assistant professors","380","180","200","0","0","0","79","51","28","24","9","15","69","33","36","0","0","0","208","87","121","0","0","0","0","0","0","0","0","0","-2"
"229337","Texas Tech University Health Sciences Center","2016","Not on tenure/no tenure system, instructors","65","14","51","0","0","0","7","4","3","6","2","4","9","2","7","0","0","0","43","6","37","0","0","0","0","0","0","0","0","0","-2"
"229337","Texas Tech University Health Sciences Center","2016","Not on tenure/no tenure system, no academic rank","66","26","40","0","0","0","11","5","6","0","0","0","21","8","13","0","0","0","34","13","21","0","0","0","0","0","0","0","0","0","-2"
"229355","Tyler Junior College","2016","Not on tenure track/No tenure system system total","311","133","178","3","1","2","0","0","0","16","4","12","8","3","5","0","0","0","281","124","157","0","0","0","2","1","1","1","0","1","-2"
"229355","Tyler Junior College","2016","Not on tenure/no tenure system, professors","311","133","178","3","1","2","0","0","0","16","4","12","8","3","5","0","0","0","281","124","157","0","0","0","2","1","1","1","0","1","-2"
"229780","Wayland Baptist University","2016","Not on tenure track/No tenure system system total","141","95","46","2","1","1","5","3","2","8","4","4","6","5","1","0","0","0","106","75","31","4","1","3","10","6","4","0","0","0","-2"
"229780","Wayland Baptist University","2016","Not on tenure/no tenure system, professors","38","32","6","1","1","0","0","0","0","0","0","0","1","1","0","0","0","0","36","30","6","0","0","0","0","0","0","0","0","0","-2"
"229780","Wayland Baptist University","2016","Not on tenure/no tenure system, associate professors","38","26","12","0","0","0","2","1","1","4","2","2","1","1","0","0","0","0","29","20","9","0","0","0","2","2","0","0","0","0","-2"
"229780","Wayland Baptist University","2016","Not on tenure/no tenure system, assistant professors","52","28","24","1","0","1","3","2","1","4","2","2","3","2","1","0","0","0","31","17","14","3","1","2","7","4","3","0","0","0","-2"
"229780","Wayland Baptist University","2016","Not on tenure/no tenure system, instructors","8","7","1","0","0","0","0","0","0","0","0","0","0","0","0","0","0","0","7","7","0","0","0","0","1","0","1","0","0","0","-2"
"229780","Wayland Baptist University","2016","Not on tenure/no tenure system, lecturers","5","2","3","0","0","0","0","0","0","0","0","0","1","1","0","0","0","0","3","1","2","1","0","1","0","0","0","0","0","0","-2"
"229814","West Texas A & M University","2016","Tenured total","115","79","36","3","3","0","11","7","4","1","1","0","3","2","1","0","0","0","96","66","30","0","0","0","1","0","1","0","0","0","-2"
"229814","West Texas A & M University","2016","Tenured, professors","55","39","16","2","2","0","4","4","0","0","0","0","1","1","0","0","0","0","48","32","16","0","0","0","0","0","0","0","0","0","-2"
"229814","West Texas A & M University","2016","Tenured, associate professors","58","39","19","1","1","0","7","3","4","1","1","0","2","1","1","0","0","0","46","33","13","0","0","0","1","0","1","0","0","0","-2"
"229814","West Texas A & M University","2016","Tenured, assistant professors","2","1","1","0","0","0","0","0","0","0","0","0","0","0","0","0","0","0","2","1","1","0","0","0","0","0","0","0","0","0","-2"
"229814","West Texas A & M University","2016","On-Tenure track total","57","29","28","0","0","0","0","0","0","1","1","0","3","1","2","0","0","0","50","24","26","0","0","0","0","0","0","3","3","0","-2"
"229814","West Texas A & M University","2016","On-tenure track, professors","1","0","1","0","0","0","0","0","0","0","0","0","0","0","0","0","0","0","1","0","1","0","0","0","0","0","0","0","0","0","-2"
"229814","West Texas A & M University","2016","On-tenure track, associate professors","8","2","6","0","0","0","0","0","0","0","0","0","1","0","1","0","0","0","7","2","5","0","0","0","0","0","0","0","0","0","-2"
"229814","West Texas A & M University","2016","On-tenure track, assistant professors","47","27","20","0","0","0","0","0","0","1","1","0","2","1","1","0","0","0","41","22","19","0","0","0","0","0","0","3","3","0","-2"
"229814","West Texas A & M University","2016","On-tenure track, instructors","1","0","1","0","0","0","0","0","0","0","0","0","0","0","0","0","0","0","1","0","1","0","0","0","0","0","0","0","0","0","-2"
"229814","West Texas A & M University","2016","Not on tenure track/No tenure system system total","148","57","91","0","0","0","1","0","1","1","1","0","10","2","8","0","0","0","121","47","74","1","0","1","0","0","0","14","7","7","-2"
"229814","West Texas A & M University","2016","Not on tenure/no tenure system, professors","1","1","0","0","0","0","0","0","0","0","0","0","0","0","0","0","0","0","1","1","0","0","0","0","0","0","0","0","0","0","-2"
"229814","West Texas A & M University","2016","Not on tenure/no tenure system, assistant professors","47","23","24","0","0","0","1","0","1","0","0","0","1","0","1","0","0","0","36","19","17","0","0","0","0","0","0","9","4","5","-2"
"229814","West Texas A & M University","2016","Not on tenure/no tenure system, instructors","99","33","66","0","0","0","0","0","0","1","1","0","9","2","7","0","0","0","83","27","56","1","0","1","0","0","0","5","3","2","-2"
"229814","West Texas A & M University","2016","Not on tenure/no tenure system, no academic rank","1","0","1","0","0","0","0","0","0","0","0","0","0","0","0","0","0","0","1","0","1","0","0","0","0","0","0","0","0","0","-2"
"234979","Columbia Basin College","2016","Tenured total","77","38","39","0","0","0","8","4","4","2","1","1","4","1","3","0","0","0","63","32","31","0","0","0","0","0","0","0","0","0","-2"
"234979","Columbia Basin College","2016","Tenured, no academic rank","77","38","39","0","0","0","8","4","4","2","1","1","4","1","3","0","0","0","63","32","31","0","0","0","0","0","0","0","0","0","-2"
"234979","Columbia Basin College","2016","On-Tenure track total","30","13","17","1","1","0","0","0","0","1","1","0","3","1","2","0","0","0","25","10","15","0","0","0","0","0","0","0","0","0","-2"
"234979","Columbia Basin College","2016","On-tenure track, no academic rank","30","13","17","1","1","0","0","0","0","1","1","0","3","1","2","0","0","0","25","10","15","0","0","0","0","0","0","0","0","0","-2"
"234979","Columbia Basin College","2016","Not on tenure track/No tenure system system total","20","7","13","0","0","0","1","0","1","0","0","0","3","2","1","1","0","1","15","5","10","0","0","0","0","0","0","0","0","0","-2"
"234979","Columbia Basin College","2016","Not on tenure/no tenure system, no academic rank","20","7","13","0","0","0","1","0","1","0","0","0","3","2","1","1","0","1","15","5","10","0","0","0","0","0","0","0","0","0","-2"
"235422","Heritage University","2016","Not on tenure track/No tenure system system total","71","32","39","7","2","5","1","1","0","3","2","1","7","2","5","1","1","0","51","23","28","1","1","0","0","0","0","0","0","0","-2"
"235422","Heritage University","2016","Not on tenure/no tenure system, professors","3","2","1","0","0","0","0","0","0","0","0","0","0","0","0","0","0","0","2","1","1","1","1","0","0","0","0","0","0","0","-2"
"235422","Heritage University","2016","Not on tenure/no tenure system, associate professors","19","10","9","2","0","2","0","0","0","1","1","0","3","0","3","1","1","0","12","8","4","0","0","0","0","0","0","0","0","0","-2"
"235422","Heritage University","2016","Not on tenure/no tenure system, assistant professors","42","18","24","5","2","3","1","1","0","2","1","1","3","2","1","0","0","0","31","12","19","0","0","0","0","0","0","0","0","0","-2"
"235422","Heritage University","2016","Not on tenure/no tenure system, instructors","7","2","5","0","0","0","0","0","0","0","0","0","1","0","1","0","0","0","6","2","4","0","0","0","0","0","0","0","0","0","-2"
"236975","Wenatchee Valley College","2016","Tenured total","49","29","20","0","0","0","1","0","1","1","0","1","3","3","0","0","0","0","42","25","17","2","1","1","0","0","0","0","0","0","-2"
"236975","Wenatchee Valley College","2016","Tenured, no academic rank","49","29","20","0","0","0","1","0","1","1","0","1","3","3","0","0","0","0","42","25","17","2","1","1","0","0","0","0","0","0","-2"
"236975","Wenatchee Valley College","2016","On-Tenure track total","19","8","11","0","0","0","1","0","1","0","0","0","1","1","0","0","0","0","15","5","10","2","2","0","0","0","0","0","0","0","-2"
"236975","Wenatchee Valley College","2016","On-tenure track, no academic rank","19","8","11","0","0","0","1","0","1","0","0","0","1","1","0","0","0","0","15","5","10","2","2","0","0","0","0","0","0","0","-2"
"236975","Wenatchee Valley College","2016","Not on tenure track/No tenure system system total","4","3","1","0","0","0","0","0","0","0","0","0","0","0","0","0","0","0","4","3","1","0","0","0","0","0","0","0","0","0","-2"
"236975","Wenatchee Valley College","2016","Not on tenure/no tenure system, no academic rank","4","3","1","0","0","0","0","0","0","0","0","0","0","0","0","0","0","0","4","3","1","0","0","0","0","0","0","0","0","0","-2"
"237109","Yakima Valley College","2016","Tenured total","68","27","41","1","1","0","2","1","1","0","0","0","3","1","2","0","0","0","62","24","38","0","0","0","0","0","0","0","0","0","-2"
"237109","Yakima Valley College","2016","Tenured, instructors","68","27","41","1","1","0","2","1","1","0","0","0","3","1","2","0","0","0","62","24","38","0","0","0","0","0","0","0","0","0","-2"
"237109","Yakima Valley College","2016","On-Tenure track total","17","7","10","0","0","0","0","0","0","0","0","0","3","0","3","0","0","0","14","7","7","0","0","0","0","0","0","0","0","0","-2"
"237109","Yakima Valley College","2016","On-tenure track, instructors","17","7","10","0","0","0","0","0","0","0","0","0","3","0","3","0","0","0","14","7","7","0","0","0","0","0","0","0","0","0","-2"
"237109","Yakima Valley College","2016","Not on tenure track/No tenure system system total","44","21","23","0","0","0","1","0","1","1","0","1","1","1","0","0","0","0","41","20","21","0","0","0","0","0","0","0","0","0","-2"
"237109","Yakima Valley College","2016","Not on tenure/no tenure system, instructors","44","21","23","0","0","0","1","0","1","1","0","1","1","1","0","0","0","0","41","20","21","0","0","0","0","0","0","0","0","0","-2"
"238193","Alverno College","2016","Tenured total","63","16","47","0","0","0","1","0","1","3","0","3","0","0","0","0","0","0","58","15","43","0","0","0","1","1","0","0","0","0","-2"
"238193","Alverno College","2016","Tenured, professors","36","10","26","0","0","0","1","0","1","0","0","0","0","0","0","0","0","0","35","10","25","0","0","0","0","0","0","0","0","0","-2"
"238193","Alverno College","2016","Tenured, associate professors","21","4","17","0","0","0","0","0","0","2","0","2","0","0","0","0","0","0","18","3","15","0","0","0","1","1","0","0","0","0","-2"
"238193","Alverno College","2016","Tenured, assistant professors","6","2","4","0","0","0","0","0","0","1","0","1","0","0","0","0","0","0","5","2","3","0","0","0","0","0","0","0","0","0","-2"
"238193","Alverno College","2016","On-Tenure track total","31","4","27","0","0","0","0","0","0","2","0","2","2","0","2","0","0","0","27","4","23","0","0","0","0","0","0","0","0","0","-2"
"238193","Alverno College","2016","On-tenure track, associate professors","4","0","4","0","0","0","0","0","0","1","0","1","0","0","0","0","0","0","3","0","3","0","0","0","0","0","0","0","0","0","-2"
"238193","Alverno College","2016","On-tenure track, assistant professors","27","4","23","0","0","0","0","0","0","1","0","1","2","0","2","0","0","0","24","4","20","0","0","0","0","0","0","0","0","0","-2"
"239390","Mount Mary University","2016","Tenured total","30","4","26","0","0","0","0","0","0","1","0","1","0","0","0","0","0","0","29","4","25","0","0","0","0","0","0","0","0","0","-2"
"239390","Mount Mary University","2016","Tenured, professors","10","2","8","0","0","0","0","0","0","0","0","0","0","0","0","0","0","0","10","2","8","0","0","0","0","0","0","0","0","0","-2"
"239390","Mount Mary University","2016","Tenured, associate professors","16","1","15","0","0","0","0","0","0","1","0","1","0","0","0","0","0","0","15","1","14","0","0","0","0","0","0","0","0","0","-2"
"239390","Mount Mary University","2016","Tenured, assistant professors","4","1","3","0","0","0","0","0","0","0","0","0","0","0","0","0","0","0","4","1","3","0","0","0","0","0","0","0","0","0","-2"
"239390","Mount Mary University","2016","On-Tenure track total","23","3","20","0","0","0","1","0","1","0","0","0","1","1","0","0","0","0","21","2","19","0","0","0","0","0","0","0","0","0","-2"
"239390","Mount Mary University","2016","On-tenure track, associate professors","2","0","2","0","0","0","0","0","0","0","0","0","0","0","0","0","0","0","2","0","2","0","0","0","0","0","0","0","0","0","-2"
"239390","Mount Mary University","2016","On-tenure track, assistant professors","21","3","18","0","0","0","1","0","1","0","0","0","1","1","0","0","0","0","19","2","17","0","0","0","0","0","0","0","0","0","-2"
"239390","Mount Mary University","2016","Not on tenure track/No tenure system system total","10","2","8","0","0","0","0","0","0","1","0","1","1","1","0","0","0","0","8","1","7","0","0","0","0","0","0","0","0","0","-2"
"239390","Mount Mary University","2016","Not on tenure/no tenure system, assistant professors","4","1","3","0","0","0","0","0","0","1","0","1","1","1","0","0","0","0","2","0","2","0","0","0","0","0","0","0","0","0","-2"
"239390","Mount Mary University","2016","Not on tenure/no tenure system, instructors","6","1","5","0","0","0","0","0","0","0","0","0","0","0","0","0","0","0","6","1","5","0","0","0","0","0","0","0","0","0","-2"
"241100","American University of Puerto Rico","2016","Tenured total","13","6","7","0","0","0","0","0","0","0","0","0","13","6","7","0","0","0","0","0","0","0","0","0","0","0","0","0","0","0","-2"
"241100","American University of Puerto Rico","2016","Tenured, associate professors","3","1","2","0","0","0","0","0","0","0","0","0","3","1","2","0","0","0","0","0","0","0","0","0","0","0","0","0","0","0","-2"
"241100","American University of Puerto Rico","2016","Tenured, assistant professors","7","4","3","0","0","0","0","0","0","0","0","0","7","4","3","0","0","0","0","0","0","0","0","0","0","0","0","0","0","0","-2"
"241100","American University of Puerto Rico","2016","Tenured, instructors","3","1","2","0","0","0","0","0","0","0","0","0","3","1","2","0","0","0","0","0","0","0","0","0","0","0","0","0","0","0","-2"
"241128","American University of Puerto Rico","2016","Tenured total","13","7","6","0","0","0","0","0","0","0","0","0","12","6","6","0","0","0","1","1","0","0","0","0","0","0","0","0","0","0","-2"
"241128","American University of Puerto Rico","2016","Tenured, associate professors","2","0","2","0","0","0","0","0","0","0","0","0","2","0","2","0","0","0","0","0","0","0","0","0","0","0","0","0","0","0","-2"
"241128","American University of Puerto Rico","2016","Tenured, assistant professors","3","1","2","0","0","0","0","0","0","0","0","0","2","0","2","0","0","0","1","1","0","0","0","0","0","0","0","0","0","0","-2"
"241128","American University of Puerto Rico","2016","Tenured, instructors","8","6","2","0","0","0","0","0","0","0","0","0","8","6","2","0","0","0","0","0","0","0","0","0","0","0","0","0","0","0","-2"
"241191","Universidad Adventista de las Antillas","2016","Tenured total","37","17","20","0","0","0","0","0","0","0","0","0","36","17","19","0","0","0","1","0","1","0","0","0","0","0","0","0","0","0","-2"
"241191","Universidad Adventista de las Antillas","2016","Tenured, professors","2","0","2","0","0","0","0","0","0","0","0","0","2","0","2","0","0","0","0","0","0","0","0","0","0","0","0","0","0","0","-2"
"241191","Universidad Adventista de las Antillas","2016","Tenured, associate professors","9","5","4","0","0","0","0","0","0","0","0","0","9","5","4","0","0","0","0","0","0","0","0","0","0","0","0","0","0","0","-2"
"241191","Universidad Adventista de las Antillas","2016","Tenured, assistant professors","19","10","9","0","0","0","0","0","0","0","0","0","19","10","9","0","0","0","0","0","0","0","0","0","0","0","0","0","0","0","-2"
"241191","Universidad Adventista de las Antillas","2016","Tenured, instructors","7","2","5","0","0","0","0","0","0","0","0","0","6","2","4","0","0","0","1","0","1","0","0","0","0","0","0","0","0","0","-2"
"241191","Universidad Adventista de las Antillas","2016","Not on tenure track/No tenure system system total","6","4","2","0","0","0","0","0","0","0","0","0","6","4","2","0","0","0","0","0","0","0","0","0","0","0","0","0","0","0","-2"
"241191","Universidad Adventista de las Antillas","2016","Not on tenure/no tenure system, no academic rank","6","4","2","0","0","0","0","0","0","0","0","0","6","4","2","0","0","0","0","0","0","0","0","0","0","0","0","0","0","0","-2"
"241216","Atlantic University College","2016","Not on tenure track/No tenure system system total","50","31","19","0","0","0","0","0","0","0","0","0","50","31","19","0","0","0","0","0","0","0","0","0","0","0","0","0","0","0","-2"
"241216","Atlantic University College","2016","Not on tenure/no tenure system, professors","50","31","19","0","0","0","0","0","0","0","0","0","50","31","19","0","0","0","0","0","0","0","0","0","0","0","0","0","0","0","-2"
"241225","Universidad Central de Bayamon","2016","On-Tenure track total","27","8","19","0","0","0","0","0","0","0","0","0","27","8","19","0","0","0","0","0","0","0","0","0","0","0","0","0","0","0","-2"
"241225","Universidad Central de Bayamon","2016","On-tenure track, professors","2","1","1","0","0","0","0","0","0","0","0","0","2","1","1","0","0","0","0","0","0","0","0","0","0","0","0","0","0","0","-2"
"241225","Universidad Central de Bayamon","2016","On-tenure track, associate professors","14","5","9","0","0","0","0","0","0","0","0","0","14","5","9","0","0","0","0","0","0","0","0","0","0","0","0","0","0","0","-2"
"241225","Universidad Central de Bayamon","2016","On-tenure track, assistant professors","7","2","5","0","0","0","0","0","0","0","0","0","7","2","5","0","0","0","0","0","0","0","0","0","0","0","0","0","0","0","-2"
"241225","Universidad Central de Bayamon","2016","On-tenure track, instructors","4","0","4","0","0","0","0","0","0","0","0","0","4","0","4","0","0","0","0","0","0","0","0","0","0","0","0","0","0","0","-2"
"241225","Universidad Central de Bayamon","2016","Not on tenure track/No tenure system system total","9","1","8","0","0","0","0","0","0","0","0","0","9","1","8","0","0","0","0","0","0","0","0","0","0","0","0","0","0","0","-2"
"241225","Universidad Central de Bayamon","2016","Not on tenure/no tenure system, instructors","8","1","7","0","0","0","0","0","0","0","0","0","8","1","7","0","0","0","0","0","0","0","0","0","0","0","0","0","0","0","-2"
"241225","Universidad Central de Bayamon","2016","Not on tenure/no tenure system, no academic rank","1","0","1","0","0","0","0","0","0","0","0","0","1","0","1","0","0","0","0","0","0","0","0","0","0","0","0","0","0","0","-2"
"241377","Caribbean University-Bayamon","2016","Not on tenure track/No tenure system system total","38","25","13","0","0","0","0","0","0","0","0","0","38","25","13","0","0","0","0","0","0","0","0","0","0","0","0","0","0","0","-2"
"241377","Caribbean University-Bayamon","2016","Not on tenure/no tenure system, professors","1","1","0","0","0","0","0","0","0","0","0","0","1","1","0","0","0","0","0","0","0","0","0","0","0","0","0","0","0","0","-2"
"241377","Caribbean University-Bayamon","2016","Not on tenure/no tenure system, associate professors","2","1","1","0","0","0","0","0","0","0","0","0","2","1","1","0","0","0","0","0","0","0","0","0","0","0","0","0","0","0","-2"
"241377","Caribbean University-Bayamon","2016","Not on tenure/no tenure system, assistant professors","8","5","3","0","0","0","0","0","0","0","0","0","8","5","3","0","0","0","0","0","0","0","0","0","0","0","0","0","0","0","-2"
"241377","Caribbean University-Bayamon","2016","Not on tenure/no tenure system, instructors","27","18","9","0","0","0","0","0","0","0","0","0","27","18","9","0","0","0","0","0","0","0","0","0","0","0","0","0","0","0","-2"
"241386","Caribbean University-Carolina","2016","Not on tenure track/No tenure system system total","8","5","3","0","0","0","0","0","0","0","0","0","8","5","3","0","0","0","0","0","0","0","0","0","0","0","0","0","0","0","-2"
"241386","Caribbean University-Carolina","2016","Not on tenure/no tenure system, assistant professors","3","2","1","0","0","0","0","0","0","0","0","0","3","2","1","0","0","0","0","0","0","0","0","0","0","0","0","0","0","0","-2"
"241386","Caribbean University-Carolina","2016","Not on tenure/no tenure system, instructors","5","3","2","0","0","0","0","0","0","0","0","0","5","3","2","0","0","0","0","0","0","0","0","0","0","0","0","0","0","0","-2"
"241395","Pontifical Catholic University of Puerto Rico-Arecibo","2016","Not on tenure track/No tenure system system total","24","11","13","0","0","0","0","0","0","0","0","0","24","11","13","0","0","0","0","0","0","0","0","0","0","0","0","0","0","0","-2"
"241395","Pontifical Catholic University of Puerto Rico-Arecibo","2016","Not on tenure/no tenure system, professors","2","1","1","0","0","0","0","0","0","0","0","0","2","1","1","0","0","0","0","0","0","0","0","0","0","0","0","0","0","0","-2"
"241395","Pontifical Catholic University of Puerto Rico-Arecibo","2016","Not on tenure/no tenure system, associate professors","3","2","1","0","0","0","0","0","0","0","0","0","3","2","1","0","0","0","0","0","0","0","0","0","0","0","0","0","0","0","-2"
"241395","Pontifical Catholic University of Puerto Rico-Arecibo","2016","Not on tenure/no tenure system, assistant professors","6","2","4","0","0","0","0","0","0","0","0","0","6","2","4","0","0","0","0","0","0","0","0","0","0","0","0","0","0","0","-2"
"241395","Pontifical Catholic University of Puerto Rico-Arecibo","2016","Not on tenure/no tenure system, instructors","2","2","0","0","0","0","0","0","0","0","0","0","2","2","0","0","0","0","0","0","0","0","0","0","0","0","0","0","0","0","-2"
"241395","Pontifical Catholic University of Puerto Rico-Arecibo","2016","Not on tenure/no tenure system, no academic rank","11","4","7","0","0","0","0","0","0","0","0","0","11","4","7","0","0","0","0","0","0","0","0","0","0","0","0","0","0","0","-2"
"241410","Pontifical Catholic University of Puerto Rico-Ponce","2016","Not on tenure track/No tenure system system total","234","93","141","0","0","0","4","0","4","0","0","0","220","86","134","0","0","0","8","6","2","0","0","0","2","1","1","0","0","0","-2"
"241410","Pontifical Catholic University of Puerto Rico-Ponce","2016","Not on tenure/no tenure system, professors","36","16","20","0","0","0","0","0","0","0","0","0","34","14","20","0","0","0","2","2","0","0","0","0","0","0","0","0","0","0","-2"
"241410","Pontifical Catholic University of Puerto Rico-Ponce","2016","Not on tenure/no tenure system, associate professors","56","27","29","0","0","0","2","0","2","0","0","0","51","24","27","0","0","0","3","3","0","0","0","0","0","0","0","0","0","0","-2"
"241410","Pontifical Catholic University of Puerto Rico-Ponce","2016","Not on tenure/no tenure system, assistant professors","72","28","44","0","0","0","2","0","2","0","0","0","69","27","42","0","0","0","0","0","0","0","0","0","1","1","0","0","0","0","-2"
"241410","Pontifical Catholic University of Puerto Rico-Ponce","2016","Not on tenure/no tenure system, instructors","22","7","15","0","0","0","0","0","0","0","0","0","21","7","14","0","0","0","1","0","1","0","0","0","0","0","0","0","0","0","-2"
"241410","Pontifical Catholic University of Puerto Rico-Ponce","2016","Not on tenure/no tenure system, no academic rank","48","15","33","0","0","0","0","0","0","0","0","0","45","14","31","0","0","0","2","1","1","0","0","0","1","0","1","0","0","0","-2"
"241614","Universidad Teologica del Caribe","2016","Tenured total","2","0","2","0","0","0","0","0","0","0","0","0","2","0","2","0","0","0","0","0","0","0","0","0","0","0","0","0","0","0","-2"
"241614","Universidad Teologica del Caribe","2016","Tenured, professors","1","0","1","0","0","0","0","0","0","0","0","0","1","0","1","0","0","0","0","0","0","0","0","0","0","0","0","0","0","0","-2"
"241614","Universidad Teologica del Caribe","2016","Tenured, instructors","1","0","1","0","0","0","0","0","0","0","0","0","1","0","1","0","0","0","0","0","0","0","0","0","0","0","0","0","0","0","-2"
"241614","Universidad Teologica del Caribe","2016","Not on tenure track/No tenure system system total","11","7","4","0","0","0","0","0","0","0","0","0","11","7","4","0","0","0","0","0","0","0","0","0","0","0","0","0","0","0","-2"
"241614","Universidad Teologica del Caribe","2016","Not on tenure/no tenure system, instructors","11","7","4","0","0","0","0","0","0","0","0","0","11","7","4","0","0","0","0","0","0","0","0","0","0","0","0","0","0","0","-2"
"241720","Colegio Universitario de San Juan","2016","Tenured total","27","10","17","0","0","0","0","0","0","0","0","0","27","10","17","0","0","0","0","0","0","0","0","0","0","0","0","0","0","0","-2"
"241720","Colegio Universitario de San Juan","2016","Tenured, professors","1","1","0","0","0","0","0","0","0","0","0","0","1","1","0","0","0","0","0","0","0","0","0","0","0","0","0","0","0","0","-2"
"241720","Colegio Universitario de San Juan","2016","Tenured, associate professors","3","1","2","0","0","0","0","0","0","0","0","0","3","1","2","0","0","0","0","0","0","0","0","0","0","0","0","0","0","0","-2"
"241720","Colegio Universitario de San Juan","2016","Tenured, assistant professors","7","4","3","0","0","0","0","0","0","0","0","0","7","4","3","0","0","0","0","0","0","0","0","0","0","0","0","0","0","0","-2"
"241720","Colegio Universitario de San Juan","2016","Tenured, instructors","16","4","12","0","0","0","0","0","0","0","0","0","16","4","12","0","0","0","0","0","0","0","0","0","0","0","0","0","0","0","-2"
"241739","Universidad Ana G. Mendez-Cupey Campus","2016","Tenured total","23","4","19","0","0","0","0","0","0","0","0","0","23","4","19","0","0","0","0","0","0","0","0","0","0","0","0","0","0","0","-2"
"241739","Universidad Ana G. Mendez-Cupey Campus","2016","Tenured, professors","16","2","14","0","0","0","0","0","0","0","0","0","16","2","14","0","0","0","0","0","0","0","0","0","0","0","0","0","0","0","-2"
"241739","Universidad Ana G. Mendez-Cupey Campus","2016","Tenured, associate professors","6","2","4","0","0","0","0","0","0","0","0","0","6","2","4","0","0","0","0","0","0","0","0","0","0","0","0","0","0","0","-2"
"241739","Universidad Ana G. Mendez-Cupey Campus","2016","Tenured, assistant professors","1","0","1","0","0","0","0","0","0","0","0","0","1","0","1","0","0","0","0","0","0","0","0","0","0","0","0","0","0","0","-2"
"241739","Universidad Ana G. Mendez-Cupey Campus","2016","Not on tenure track/No tenure system system total","171","54","117","0","0","0","0","0","0","0","0","0","166","50","116","0","0","0","4","3","1","0","0","0","1","1","0","0","0","0","-2"
"241739","Universidad Ana G. Mendez-Cupey Campus","2016","Not on tenure/no tenure system, professors","16","9","7","0","0","0","0","0","0","0","0","0","15","8","7","0","0","0","1","1","0","0","0","0","0","0","0","0","0","0","-2"
"241739","Universidad Ana G. Mendez-Cupey Campus","2016","Not on tenure/no tenure system, associate professors","17","7","10","0","0","0","0","0","0","0","0","0","16","6","10","0","0","0","1","1","0","0","0","0","0","0","0","0","0","0","-2"
"241739","Universidad Ana G. Mendez-Cupey Campus","2016","Not on tenure/no tenure system, assistant professors","49","18","31","0","0","0","0","0","0","0","0","0","47","17","30","0","0","0","1","0","1","0","0","0","1","1","0","0","0","0","-2"
"241739","Universidad Ana G. Mendez-Cupey Campus","2016","Not on tenure/no tenure system, instructors","89","20","69","0","0","0","0","0","0","0","0","0","88","19","69","0","0","0","1","1","0","0","0","0","0","0","0","0","0","0","-2"
"241766","Conservatory of Music of Puerto Rico","2016","Tenured total","32","23","9","0","0","0","0","0","0","0","0","0","31","23","8","0","0","0","1","0","1","0","0","0","0","0","0","0","0","0","-2"
"241766","Conservatory of Music of Puerto Rico","2016","Tenured, professors","8","4","4","0","0","0","0","0","0","0","0","0","7","4","3","0","0","0","1","0","1","0","0","0","0","0","0","0","0","0","-2"
"241766","Conservatory of Music of Puerto Rico","2016","Tenured, associate professors","14","11","3","0","0","0","0","0","0","0","0","0","14","11","3","0","0","0","0","0","0","0","0","0","0","0","0","0","0","0","-2"
"241766","Conservatory of Music of Puerto Rico","2016","Tenured, assistant professors","8","7","1","0","0","0","0","0","0","0","0","0","8","7","1","0","0","0","0","0","0","0","0","0","0","0","0","0","0","0","-2"
"241766","Conservatory of Music of Puerto Rico","2016","Tenured, instructors","2","1","1","0","0","0","0","0","0","0","0","0","2","1","1","0","0","0","0","0","0","0","0","0","0","0","0","0","0","0","-2"
"241766","Conservatory of Music of Puerto Rico","2016","On-Tenure track total","6","4","2","0","0","0","0","0","0","0","0","0","6","4","2","0","0","0","0","0","0","0","0","0","0","0","0","0","0","0","-2"
"241766","Conservatory of Music of Puerto Rico","2016","On-tenure track, assistant professors","5","3","2","0","0","0","0","0","0","0","0","0","5","3","2","0","0","0","0","0","0","0","0","0","0","0","0","0","0","0","-2"
"241766","Conservatory of Music of Puerto Rico","2016","On-tenure track, instructors","1","1","0","0","0","0","0","0","0","0","0","0","1","1","0","0","0","0","0","0","0","0","0","0","0","0","0","0","0","0","-2"
"241766","Conservatory of Music of Puerto Rico","2016","Not on tenure track/No tenure system system total","7","7","0","0","0","0","0","0","0","0","0","0","6","6","0","0","0","0","1","1","0","0","0","0","0","0","0","0","0","0","-2"
"241766","Conservatory of Music of Puerto Rico","2016","Not on tenure/no tenure system, instructors","1","1","0","0","0","0","0","0","0","0","0","0","0","0","0","0","0","0","1","1","0","0","0","0","0","0","0","0","0","0","-2"
"241766","Conservatory of Music of Puerto Rico","2016","Not on tenure/no tenure system, no academic rank","6","6","0","0","0","0","0","0","0","0","0","0","6","6","0","0","0","0","0","0","0","0","0","0","0","0","0","0","0","0","-2"
"241836","EDP University of Puerto Rico Inc-San Sebastian","2016","Not on tenure track/No tenure system system total","27","8","19","0","0","0","0","0","0","0","0","0","27","8","19","0","0","0","0","0","0","0","0","0","0","0","0","0","0","0","-2"
"241836","EDP University of Puerto Rico Inc-San Sebastian","2016","Not on tenure/no tenure system, instructors","27","8","19","0","0","0","0","0","0","0","0","0","27","8","19","0","0","0","0","0","0","0","0","0","0","0","0","0","0","0","-2"
"241951","Escuela de Artes Plasticas y Diseno de Puerto Rico","2016","Tenured total","13","8","5","0","0","0","0","0","0","0","0","0","13","8","5","0","0","0","0","0","0","0","0","0","0","0","0","0","0","0","-2"
"241951","Escuela de Artes Plasticas y Diseno de Puerto Rico","2016","Tenured, professors","3","2","1","0","0","0","0","0","0","0","0","0","3","2","1","0","0","0","0","0","0","0","0","0","0","0","0","0","0","0","-2"
"241951","Escuela de Artes Plasticas y Diseno de Puerto Rico","2016","Tenured, associate professors","1","0","1","0","0","0","0","0","0","0","0","0","1","0","1","0","0","0","0","0","0","0","0","0","0","0","0","0","0","0","-2"
"241951","Escuela de Artes Plasticas y Diseno de Puerto Rico","2016","Tenured, assistant professors","1","1","0","0","0","0","0","0","0","0","0","0","1","1","0","0","0","0","0","0","0","0","0","0","0","0","0","0","0","0","-2"
"241951","Escuela de Artes Plasticas y Diseno de Puerto Rico","2016","Tenured, instructors","8","5","3","0","0","0","0","0","0","0","0","0","8","5","3","0","0","0","0","0","0","0","0","0","0","0","0","0","0","0","-2"
"241951","Escuela de Artes Plasticas y Diseno de Puerto Rico","2016","On-Tenure track total","3","3","0","0","0","0","0","0","0","0","0","0","3","3","0","0","0","0","0","0","0","0","0","0","0","0","0","0","0","0","-2"
"241951","Escuela de Artes Plasticas y Diseno de Puerto Rico","2016","On-tenure track, instructors","3","3","0","0","0","0","0","0","0","0","0","0","3","3","0","0","0","0","0","0","0","0","0","0","0","0","0","0","0","0","-2"
"242121","Humacao Community College","2016","Not on tenure track/No tenure system system total","9","4","5","0","0","0","0","0","0","0","0","0","9","4","5","0","0","0","0","0","0","0","0","0","0","0","0","0","0","0","-2"
"242121","Humacao Community College","2016","Not on tenure/no tenure system, professors","9","4","5","0","0","0","0","0","0","0","0","0","9","4","5","0","0","0","0","0","0","0","0","0","0","0","0","0","0","0","-2"
"242617","Inter American University of Puerto Rico-San German","2016","Tenured total","79","36","43","0","0","0","0","0","0","0","0","0","78","35","43","1","1","0","0","0","0","0","0","0","0","0","0","0","0","0","-2"
"242617","Inter American University of Puerto Rico-San German","2016","Tenured, professors","27","15","12","0","0","0","0","0","0","0","0","0","26","14","12","1","1","0","0","0","0","0","0","0","0","0","0","0","0","0","-2"
"242617","Inter American University of Puerto Rico-San German","2016","Tenured, associate professors","35","16","19","0","0","0","0","0","0","0","0","0","35","16","19","0","0","0","0","0","0","0","0","0","0","0","0","0","0","0","-2"
"242617","Inter American University of Puerto Rico-San German","2016","Tenured, assistant professors","16","4","12","0","0","0","0","0","0","0","0","0","16","4","12","0","0","0","0","0","0","0","0","0","0","0","0","0","0","0","-2"
"242617","Inter American University of Puerto Rico-San German","2016","Tenured, instructors","1","1","0","0","0","0","0","0","0","0","0","0","1","1","0","0","0","0","0","0","0","0","0","0","0","0","0","0","0","0","-2"
"242617","Inter American University of Puerto Rico-San German","2016","On-Tenure track total","22","7","15","0","0","0","0","0","0","0","0","0","22","7","15","0","0","0","0","0","0","0","0","0","0","0","0","0","0","0","-2"
"242617","Inter American University of Puerto Rico-San German","2016","On-tenure track, associate professors","5","1","4","0","0","0","0","0","0","0","0","0","5","1","4","0","0","0","0","0","0","0","0","0","0","0","0","0","0","0","-2"
"242617","Inter American University of Puerto Rico-San German","2016","On-tenure track, assistant professors","15","5","10","0","0","0","0","0","0","0","0","0","15","5","10","0","0","0","0","0","0","0","0","0","0","0","0","0","0","0","-2"
"242617","Inter American University of Puerto Rico-San German","2016","On-tenure track, instructors","2","1","1","0","0","0","0","0","0","0","0","0","2","1","1","0","0","0","0","0","0","0","0","0","0","0","0","0","0","0","-2"
"242617","Inter American University of Puerto Rico-San German","2016","Not on tenure track/No tenure system system total","5","4","1","0","0","0","0","0","0","0","0","0","5","4","1","0","0","0","0","0","0","0","0","0","0","0","0","0","0","0","-2"
"242617","Inter American University of Puerto Rico-San German","2016","Not on tenure/no tenure system, assistant professors","4","4","0","0","0","0","0","0","0","0","0","0","4","4","0","0","0","0","0","0","0","0","0","0","0","0","0","0","0","0","-2"
"242617","Inter American University of Puerto Rico-San German","2016","Not on tenure/no tenure system, instructors","1","0","1","0","0","0","0","0","0","0","0","0","1","0","1","0","0","0","0","0","0","0","0","0","0","0","0","0","0","0","-2"
"242626","Inter American University of Puerto Rico-Aguadilla","2016","Tenured total","59","25","34","0","0","0","0","0","0","1","0","1","58","25","33","0","0","0","0","0","0","0","0","0","0","0","0","0","0","0","-2"
"242626","Inter American University of Puerto Rico-Aguadilla","2016","Tenured, professors","10","2","8","0","0","0","0","0","0","1","0","1","9","2","7","0","0","0","0","0","0","0","0","0","0","0","0","0","0","0","-2"
"242626","Inter American University of Puerto Rico-Aguadilla","2016","Tenured, associate professors","23","7","16","0","0","0","0","0","0","0","0","0","23","7","16","0","0","0","0","0","0","0","0","0","0","0","0","0","0","0","-2"
"242626","Inter American University of Puerto Rico-Aguadilla","2016","Tenured, assistant professors","26","16","10","0","0","0","0","0","0","0","0","0","26","16","10","0","0","0","0","0","0","0","0","0","0","0","0","0","0","0","-2"
"242626","Inter American University of Puerto Rico-Aguadilla","2016","On-Tenure track total","11","2","9","0","0","0","0","0","0","0","0","0","11","2","9","0","0","0","0","0","0","0","0","0","0","0","0","0","0","0","-2"
"242626","Inter American University of Puerto Rico-Aguadilla","2016","On-tenure track, associate professors","2","0","2","0","0","0","0","0","0","0","0","0","2","0","2","0","0","0","0","0","0","0","0","0","0","0","0","0","0","0","-2"
"242626","Inter American University of Puerto Rico-Aguadilla","2016","On-tenure track, assistant professors","5","1","4","0","0","0","0","0","0","0","0","0","5","1","4","0","0","0","0","0","0","0","0","0","0","0","0","0","0","0","-2"
"242626","Inter American University of Puerto Rico-Aguadilla","2016","On-tenure track, instructors","4","1","3","0","0","0","0","0","0","0","0","0","4","1","3","0","0","0","0","0","0","0","0","0","0","0","0","0","0","0","-2"
"242626","Inter American University of Puerto Rico-Aguadilla","2016","Not on tenure track/No tenure system system total","8","2","6","0","0","0","0","0","0","0","0","0","8","2","6","0","0","0","0","0","0","0","0","0","0","0","0","0","0","0","-2"
"242626","Inter American University of Puerto Rico-Aguadilla","2016","Not on tenure/no tenure system, assistant professors","2","0","2","0","0","0","0","0","0","0","0","0","2","0","2","0","0","0","0","0","0","0","0","0","0","0","0","0","0","0","-2"
"242626","Inter American University of Puerto Rico-Aguadilla","2016","Not on tenure/no tenure system, instructors","6","2","4","0","0","0","0","0","0","0","0","0","6","2","4","0","0","0","0","0","0","0","0","0","0","0","0","0","0","0","-2"
"242635","Inter American University of Puerto Rico-Arecibo","2016","Tenured total","54","29","25","0","0","0","0","0","0","0","0","0","54","29","25","0","0","0","0","0","0","0","0","0","0","0","0","0","0","0","-2"
"242635","Inter American University of Puerto Rico-Arecibo","2016","Tenured, professors","21","11","10","0","0","0","0","0","0","0","0","0","21","11","10","0","0","0","0","0","0","0","0","0","0","0","0","0","0","0","-2"
"242635","Inter American University of Puerto Rico-Arecibo","2016","Tenured, associate professors","14","8","6","0","0","0","0","0","0","0","0","0","14","8","6","0","0","0","0","0","0","0","0","0","0","0","0","0","0","0","-2"
"242635","Inter American University of Puerto Rico-Arecibo","2016","Tenured, assistant professors","19","10","9","0","0","0","0","0","0","0","0","0","19","10","9","0","0","0","0","0","0","0","0","0","0","0","0","0","0","0","-2"
"242635","Inter American University of Puerto Rico-Arecibo","2016","On-Tenure track total","15","4","11","0","0","0","0","0","0","0","0","0","15","4","11","0","0","0","0","0","0","0","0","0","0","0","0","0","0","0","-2"
"242635","Inter American University of Puerto Rico-Arecibo","2016","On-tenure track, associate professors","1","0","1","0","0","0","0","0","0","0","0","0","1","0","1","0","0","0","0","0","0","0","0","0","0","0","0","0","0","0","-2"
"242635","Inter American University of Puerto Rico-Arecibo","2016","On-tenure track, assistant professors","9","3","6","0","0","0","0","0","0","0","0","0","9","3","6","0","0","0","0","0","0","0","0","0","0","0","0","0","0","0","-2"
"242635","Inter American University of Puerto Rico-Arecibo","2016","On-tenure track, instructors","5","1","4","0","0","0","0","0","0","0","0","0","5","1","4","0","0","0","0","0","0","0","0","0","0","0","0","0","0","0","-2"
"242635","Inter American University of Puerto Rico-Arecibo","2016","Not on tenure track/No tenure system system total","14","7","7","0","0","0","0","0","0","0","0","0","14","7","7","0","0","0","0","0","0","0","0","0","0","0","0","0","0","0","-2"
"242635","Inter American University of Puerto Rico-Arecibo","2016","Not on tenure/no tenure system, assistant professors","5","3","2","0","0","0","0","0","0","0","0","0","5","3","2","0","0","0","0","0","0","0","0","0","0","0","0","0","0","0","-2"
"242635","Inter American University of Puerto Rico-Arecibo","2016","Not on tenure/no tenure system, instructors","9","4","5","0","0","0","0","0","0","0","0","0","9","4","5","0","0","0","0","0","0","0","0","0","0","0","0","0","0","0","-2"
"242644","Inter American University of Puerto Rico-Barranquitas","2016","Tenured total","14","5","9","0","0","0","0","0","0","0","0","0","14","5","9","0","0","0","0","0","0","0","0","0","0","0","0","0","0","0","-2"
"242644","Inter American University of Puerto Rico-Barranquitas","2016","Tenured, professors","2","1","1","0","0","0","0","0","0","0","0","0","2","1","1","0","0","0","0","0","0","0","0","0","0","0","0","0","0","0","-2"
"242644","Inter American University of Puerto Rico-Barranquitas","2016","Tenured, associate professors","4","1","3","0","0","0","0","0","0","0","0","0","4","1","3","0","0","0","0","0","0","0","0","0","0","0","0","0","0","0","-2"
"242644","Inter American University of Puerto Rico-Barranquitas","2016","Tenured, assistant professors","8","3","5","0","0","0","0","0","0","0","0","0","8","3","5","0","0","0","0","0","0","0","0","0","0","0","0","0","0","0","-2"
"242644","Inter American University of Puerto Rico-Barranquitas","2016","On-Tenure track total","10","5","5","0","0","0","0","0","0","0","0","0","10","5","5","0","0","0","0","0","0","0","0","0","0","0","0","0","0","0","-2"
"242644","Inter American University of Puerto Rico-Barranquitas","2016","On-tenure track, associate professors","2","1","1","0","0","0","0","0","0","0","0","0","2","1","1","0","0","0","0","0","0","0","0","0","0","0","0","0","0","0","-2"
"242644","Inter American University of Puerto Rico-Barranquitas","2016","On-tenure track, assistant professors","5","3","2","0","0","0","0","0","0","0","0","0","5","3","2","0","0","0","0","0","0","0","0","0","0","0","0","0","0","0","-2"
"242644","Inter American University of Puerto Rico-Barranquitas","2016","On-tenure track, instructors","3","1","2","0","0","0","0","0","0","0","0","0","3","1","2","0","0","0","0","0","0","0","0","0","0","0","0","0","0","0","-2"
"242644","Inter American University of Puerto Rico-Barranquitas","2016","Not on tenure track/No tenure system system total","6","3","3","0","0","0","1","1","0","0","0","0","5","2","3","0","0","0","0","0","0","0","0","0","0","0","0","0","0","0","-2"
"242644","Inter American University of Puerto Rico-Barranquitas","2016","Not on tenure/no tenure system, assistant professors","3","3","0","0","0","0","1","1","0","0","0","0","2","2","0","0","0","0","0","0","0","0","0","0","0","0","0","0","0","0","-2"
"242644","Inter American University of Puerto Rico-Barranquitas","2016","Not on tenure/no tenure system, instructors","3","0","3","0","0","0","0","0","0","0","0","0","3","0","3","0","0","0","0","0","0","0","0","0","0","0","0","0","0","0","-2"
"242653","Inter American University of Puerto Rico-Metro","2016","Tenured total","146","65","81","0","0","0","0","0","0","0","0","0","145","64","81","0","0","0","1","1","0","0","0","0","0","0","0","0","0","0","-2"
"242653","Inter American University of Puerto Rico-Metro","2016","Tenured, professors","60","25","35","0","0","0","0","0","0","0","0","0","59","24","35","0","0","0","1","1","0","0","0","0","0","0","0","0","0","0","-2"
"242653","Inter American University of Puerto Rico-Metro","2016","Tenured, associate professors","70","33","37","0","0","0","0","0","0","0","0","0","70","33","37","0","0","0","0","0","0","0","0","0","0","0","0","0","0","0","-2"
"242653","Inter American University of Puerto Rico-Metro","2016","Tenured, assistant professors","16","7","9","0","0","0","0","0","0","0","0","0","16","7","9","0","0","0","0","0","0","0","0","0","0","0","0","0","0","0","-2"
"242653","Inter American University of Puerto Rico-Metro","2016","On-Tenure track total","17","9","8","0","0","0","0","0","0","0","0","0","17","9","8","0","0","0","0","0","0","0","0","0","0","0","0","0","0","0","-2"
"242653","Inter American University of Puerto Rico-Metro","2016","On-tenure track, professors","3","3","0","0","0","0","0","0","0","0","0","0","3","3","0","0","0","0","0","0","0","0","0","0","0","0","0","0","0","0","-2"
"242653","Inter American University of Puerto Rico-Metro","2016","On-tenure track, associate professors","3","3","0","0","0","0","0","0","0","0","0","0","3","3","0","0","0","0","0","0","0","0","0","0","0","0","0","0","0","0","-2"
"242653","Inter American University of Puerto Rico-Metro","2016","On-tenure track, assistant professors","8","3","5","0","0","0","0","0","0","0","0","0","8","3","5","0","0","0","0","0","0","0","0","0","0","0","0","0","0","0","-2"
"242653","Inter American University of Puerto Rico-Metro","2016","On-tenure track, instructors","3","0","3","0","0","0","0","0","0","0","0","0","3","0","3","0","0","0","0","0","0","0","0","0","0","0","0","0","0","0","-2"
"242653","Inter American University of Puerto Rico-Metro","2016","Not on tenure track/No tenure system system total","23","7","16","0","0","0","0","0","0","0","0","0","23","7","16","0","0","0","0","0","0","0","0","0","0","0","0","0","0","0","-2"
"242653","Inter American University of Puerto Rico-Metro","2016","Not on tenure/no tenure system, professors","2","1","1","0","0","0","0","0","0","0","0","0","2","1","1","0","0","0","0","0","0","0","0","0","0","0","0","0","0","0","-2"
"242653","Inter American University of Puerto Rico-Metro","2016","Not on tenure/no tenure system, assistant professors","14","3","11","0","0","0","0","0","0","0","0","0","14","3","11","0","0","0","0","0","0","0","0","0","0","0","0","0","0","0","-2"
"242653","Inter American University of Puerto Rico-Metro","2016","Not on tenure/no tenure system, instructors","7","3","4","0","0","0","0","0","0","0","0","0","7","3","4","0","0","0","0","0","0","0","0","0","0","0","0","0","0","0","-2"
"242662","Inter American University of Puerto Rico-Ponce","2016","Tenured total","60","26","34","0","0","0","0","0","0","0","0","0","60","26","34","0","0","0","0","0","0","0","0","0","0","0","0","0","0","0","-2"
"242662","Inter American University of Puerto Rico-Ponce","2016","Tenured, professors","13","4","9","0","0","0","0","0","0","0","0","0","13","4","9","0","0","0","0","0","0","0","0","0","0","0","0","0","0","0","-2"
"242662","Inter American University of Puerto Rico-Ponce","2016","Tenured, associate professors","29","17","12","0","0","0","0","0","0","0","0","0","29","17","12","0","0","0","0","0","0","0","0","0","0","0","0","0","0","0","-2"
"242662","Inter American University of Puerto Rico-Ponce","2016","Tenured, assistant professors","18","5","13","0","0","0","0","0","0","0","0","0","18","5","13","0","0","0","0","0","0","0","0","0","0","0","0","0","0","0","-2"
"242662","Inter American University of Puerto Rico-Ponce","2016","On-Tenure track total","23","11","12","0","0","0","0","0","0","0","0","0","22","10","12","0","0","0","1","1","0","0","0","0","0","0","0","0","0","0","-2"
"242662","Inter American University of Puerto Rico-Ponce","2016","On-tenure track, associate professors","6","4","2","0","0","0","0","0","0","0","0","0","5","3","2","0","0","0","1","1","0","0","0","0","0","0","0","0","0","0","-2"
"242662","Inter American University of Puerto Rico-Ponce","2016","On-tenure track, assistant professors","11","5","6","0","0","0","0","0","0","0","0","0","11","5","6","0","0","0","0","0","0","0","0","0","0","0","0","0","0","0","-2"
"242662","Inter American University of Puerto Rico-Ponce","2016","On-tenure track, instructors","6","2","4","0","0","0","0","0","0","0","0","0","6","2","4","0","0","0","0","0","0","0","0","0","0","0","0","0","0","0","-2"
"242662","Inter American University of Puerto Rico-Ponce","2016","Not on tenure track/No tenure system system total","14","2","12","0","0","0","0","0","0","0","0","0","13","2","11","1","0","1","0","0","0","0","0","0","0","0","0","0","0","0","-2"
"242662","Inter American University of Puerto Rico-Ponce","2016","Not on tenure/no tenure system, assistant professors","10","1","9","0","0","0","0","0","0","0","0","0","9","1","8","1","0","1","0","0","0","0","0","0","0","0","0","0","0","0","-2"
"242662","Inter American University of Puerto Rico-Ponce","2016","Not on tenure/no tenure system, instructors","4","1","3","0","0","0","0","0","0","0","0","0","4","1","3","0","0","0","0","0","0","0","0","0","0","0","0","0","0","0","-2"
"242680","Inter American University of Puerto Rico-Fajardo","2016","Tenured total","26","10","16","0","0","0","0","0","0","0","0","0","26","10","16","0","0","0","0","0","0","0","0","0","0","0","0","0","0","0","-2"
"242680","Inter American University of Puerto Rico-Fajardo","2016","Tenured, professors","4","2","2","0","0","0","0","0","0","0","0","0","4","2","2","0","0","0","0","0","0","0","0","0","0","0","0","0","0","0","-2"
"242680","Inter American University of Puerto Rico-Fajardo","2016","Tenured, associate professors","11","5","6","0","0","0","0","0","0","0","0","0","11","5","6","0","0","0","0","0","0","0","0","0","0","0","0","0","0","0","-2"
"242680","Inter American University of Puerto Rico-Fajardo","2016","Tenured, assistant professors","11","3","8","0","0","0","0","0","0","0","0","0","11","3","8","0","0","0","0","0","0","0","0","0","0","0","0","0","0","0","-2"
"242680","Inter American University of Puerto Rico-Fajardo","2016","On-Tenure track total","11","4","7","0","0","0","0","0","0","0","0","0","11","4","7","0","0","0","0","0","0","0","0","0","0","0","0","0","0","0","-2"
"242680","Inter American University of Puerto Rico-Fajardo","2016","On-tenure track, assistant professors","11","4","7","0","0","0","0","0","0","0","0","0","11","4","7","0","0","0","0","0","0","0","0","0","0","0","0","0","0","0","-2"
"242680","Inter American University of Puerto Rico-Fajardo","2016","Not on tenure track/No tenure system system total","5","1","4","0","0","0","0","0","0","0","0","0","5","1","4","0","0","0","0","0","0","0","0","0","0","0","0","0","0","0","-2"
"242680","Inter American University of Puerto Rico-Fajardo","2016","Not on tenure/no tenure system, assistant professors","3","0","3","0","0","0","0","0","0","0","0","0","3","0","3","0","0","0","0","0","0","0","0","0","0","0","0","0","0","0","-2"
"242680","Inter American University of Puerto Rico-Fajardo","2016","Not on tenure/no tenure system, instructors","2","1","1","0","0","0","0","0","0","0","0","0","2","1","1","0","0","0","0","0","0","0","0","0","0","0","0","0","0","0","-2"
"242699","Inter American University of Puerto Rico-Guayama","2016","Tenured total","33","16","17","0","0","0","0","0","0","0","0","0","33","16","17","0","0","0","0","0","0","0","0","0","0","0","0","0","0","0","-2"
"242699","Inter American University of Puerto Rico-Guayama","2016","Tenured, professors","7","5","2","0","0","0","0","0","0","0","0","0","7","5","2","0","0","0","0","0","0","0","0","0","0","0","0","0","0","0","-2"
"242699","Inter American University of Puerto Rico-Guayama","2016","Tenured, associate professors","11","4","7","0","0","0","0","0","0","0","0","0","11","4","7","0","0","0","0","0","0","0","0","0","0","0","0","0","0","0","-2"
"242699","Inter American University of Puerto Rico-Guayama","2016","Tenured, assistant professors","15","7","8","0","0","0","0","0","0","0","0","0","15","7","8","0","0","0","0","0","0","0","0","0","0","0","0","0","0","0","-2"
"242699","Inter American University of Puerto Rico-Guayama","2016","On-Tenure track total","4","3","1","0","0","0","0","0","0","0","0","0","4","3","1","0","0","0","0","0","0","0","0","0","0","0","0","0","0","0","-2"
"242699","Inter American University of Puerto Rico-Guayama","2016","On-tenure track, associate professors","1","1","0","0","0","0","0","0","0","0","0","0","1","1","0","0","0","0","0","0","0","0","0","0","0","0","0","0","0","0","-2"
"242699","Inter American University of Puerto Rico-Guayama","2016","On-tenure track, assistant professors","2","1","1","0","0","0","0","0","0","0","0","0","2","1","1","0","0","0","0","0","0","0","0","0","0","0","0","0","0","0","-2"
"242699","Inter American University of Puerto Rico-Guayama","2016","On-tenure track, instructors","1","1","0","0","0","0","0","0","0","0","0","0","1","1","0","0","0","0","0","0","0","0","0","0","0","0","0","0","0","0","-2"
"242699","Inter American University of Puerto Rico-Guayama","2016","Not on tenure track/No tenure system system total","8","2","6","0","0","0","0","0","0","0","0","0","8","2","6","0","0","0","0","0","0","0","0","0","0","0","0","0","0","0","-2"
"242699","Inter American University of Puerto Rico-Guayama","2016","Not on tenure/no tenure system, assistant professors","2","1","1","0","0","0","0","0","0","0","0","0","2","1","1","0","0","0","0","0","0","0","0","0","0","0","0","0","0","0","-2"
"242699","Inter American University of Puerto Rico-Guayama","2016","Not on tenure/no tenure system, instructors","6","1","5","0","0","0","0","0","0","0","0","0","6","1","5","0","0","0","0","0","0","0","0","0","0","0","0","0","0","0","-2"
"242705","Inter American University of Puerto Rico-Bayamon","2016","Tenured total","50","30","20","0","0","0","0","0","0","0","0","0","50","30","20","0","0","0","0","0","0","0","0","0","0","0","0","0","0","0","-2"
"242705","Inter American University of Puerto Rico-Bayamon","2016","Tenured, professors","11","10","1","0","0","0","0","0","0","0","0","0","11","10","1","0","0","0","0","0","0","0","0","0","0","0","0","0","0","0","-2"
"242705","Inter American University of Puerto Rico-Bayamon","2016","Tenured, associate professors","18","8","10","0","0","0","0","0","0","0","0","0","18","8","10","0","0","0","0","0","0","0","0","0","0","0","0","0","0","0","-2"
"242705","Inter American University of Puerto Rico-Bayamon","2016","Tenured, assistant professors","21","12","9","0","0","0","0","0","0","0","0","0","21","12","9","0","0","0","0","0","0","0","0","0","0","0","0","0","0","0","-2"
"242705","Inter American University of Puerto Rico-Bayamon","2016","On-Tenure track total","32","20","12","0","0","0","0","0","0","0","0","0","32","20","12","0","0","0","0","0","0","0","0","0","0","0","0","0","0","0","-2"
"242705","Inter American University of Puerto Rico-Bayamon","2016","On-tenure track, professors","2","2","0","0","0","0","0","0","0","0","0","0","2","2","0","0","0","0","0","0","0","0","0","0","0","0","0","0","0","0","-2"
"242705","Inter American University of Puerto Rico-Bayamon","2016","On-tenure track, associate professors","10","8","2","0","0","0","0","0","0","0","0","0","10","8","2","0","0","0","0","0","0","0","0","0","0","0","0","0","0","0","-2"
"242705","Inter American University of Puerto Rico-Bayamon","2016","On-tenure track, assistant professors","13","6","7","0","0","0","0","0","0","0","0","0","13","6","7","0","0","0","0","0","0","0","0","0","0","0","0","0","0","0","-2"
"242705","Inter American University of Puerto Rico-Bayamon","2016","On-tenure track, instructors","7","4","3","0","0","0","0","0","0","0","0","0","7","4","3","0","0","0","0","0","0","0","0","0","0","0","0","0","0","0","-2"
"242705","Inter American University of Puerto Rico-Bayamon","2016","Not on tenure track/No tenure system system total","15","7","8","0","0","0","0","0","0","0","0","0","14","6","8","1","1","0","0","0","0","0","0","0","0","0","0","0","0","0","-2"
"242705","Inter American University of Puerto Rico-Bayamon","2016","Not on tenure/no tenure system, assistant professors","7","3","4","0","0","0","0","0","0","0","0","0","6","2","4","1","1","0","0","0","0","0","0","0","0","0","0","0","0","0","-2"
"242705","Inter American University of Puerto Rico-Bayamon","2016","Not on tenure/no tenure system, instructors","8","4","4","0","0","0","0","0","0","0","0","0","8","4","4","0","0","0","0","0","0","0","0","0","0","0","0","0","0","0","-2"
"243106","University of Puerto Rico-Aguadilla","2016","Tenured total","90","47","43","0","0","0","0","0","0","0","0","0","90","47","43","0","0","0","0","0","0","0","0","0","0","0","0","0","0","0","-2"
"243106","University of Puerto Rico-Aguadilla","2016","Tenured, professors","38","21","17","0","0","0","0","0","0","0","0","0","38","21","17","0","0","0","0","0","0","0","0","0","0","0","0","0","0","0","-2"
"243106","University of Puerto Rico-Aguadilla","2016","Tenured, associate professors","33","19","14","0","0","0","0","0","0","0","0","0","33","19","14","0","0","0","0","0","0","0","0","0","0","0","0","0","0","0","-2"
"243106","University of Puerto Rico-Aguadilla","2016","Tenured, assistant professors","16","6","10","0","0","0","0","0","0","0","0","0","16","6","10","0","0","0","0","0","0","0","0","0","0","0","0","0","0","0","-2"
"243106","University of Puerto Rico-Aguadilla","2016","Tenured, instructors","3","1","2","0","0","0","0","0","0","0","0","0","3","1","2","0","0","0","0","0","0","0","0","0","0","0","0","0","0","0","-2"
"243106","University of Puerto Rico-Aguadilla","2016","On-Tenure track total","5","3","2","0","0","0","0","0","0","0","0","0","4","2","2","0","0","0","1","1","0","0","0","0","0","0","0","0","0","0","-2"
"243106","University of Puerto Rico-Aguadilla","2016","On-tenure track, assistant professors","4","2","2","0","0","0","0","0","0","0","0","0","3","1","2","0","0","0","1","1","0","0","0","0","0","0","0","0","0","0","-2"
"243106","University of Puerto Rico-Aguadilla","2016","On-tenure track, instructors","1","1","0","0","0","0","0","0","0","0","0","0","1","1","0","0","0","0","0","0","0","0","0","0","0","0","0","0","0","0","-2"
"243106","University of Puerto Rico-Aguadilla","2016","Not on tenure track/No tenure system system total","29","14","15","0","0","0","0","0","0","0","0","0","29","14","15","0","0","0","0","0","0","0","0","0","0","0","0","0","0","0","-2"
"243106","University of Puerto Rico-Aguadilla","2016","Not on tenure/no tenure system, assistant professors","11","3","8","0","0","0","0","0","0","0","0","0","11","3","8","0","0","0","0","0","0","0","0","0","0","0","0","0","0","0","-2"
"243106","University of Puerto Rico-Aguadilla","2016","Not on tenure/no tenure system, instructors","18","11","7","0","0","0","0","0","0","0","0","0","18","11","7","0","0","0","0","0","0","0","0","0","0","0","0","0","0","0","-2"
"243115","University of Puerto Rico-Arecibo","2016","Tenured total","119","59","60","0","0","0","0","0","0","1","0","1","118","59","59","0","0","0","0","0","0","0","0","0","0","0","0","0","0","0","-2"
"243115","University of Puerto Rico-Arecibo","2016","Tenured, professors","65","31","34","0","0","0","0","0","0","0","0","0","65","31","34","0","0","0","0","0","0","0","0","0","0","0","0","0","0","0","-2"
"243115","University of Puerto Rico-Arecibo","2016","Tenured, associate professors","30","14","16","0","0","0","0","0","0","0","0","0","30","14","16","0","0","0","0","0","0","0","0","0","0","0","0","0","0","0","-2"
"243115","University of Puerto Rico-Arecibo","2016","Tenured, assistant professors","23","13","10","0","0","0","0","0","0","1","0","1","22","13","9","0","0","0","0","0","0","0","0","0","0","0","0","0","0","0","-2"
"243115","University of Puerto Rico-Arecibo","2016","Tenured, instructors","1","1","0","0","0","0","0","0","0","0","0","0","1","1","0","0","0","0","0","0","0","0","0","0","0","0","0","0","0","0","-2"
"243115","University of Puerto Rico-Arecibo","2016","On-Tenure track total","12","5","7","0","0","0","0","0","0","0","0","0","12","5","7","0","0","0","0","0","0","0","0","0","0","0","0","0","0","0","-2"
"243115","University of Puerto Rico-Arecibo","2016","On-tenure track, associate professors","1","0","1","0","0","0","0","0","0","0","0","0","1","0","1","0","0","0","0","0","0","0","0","0","0","0","0","0","0","0","-2"
"243115","University of Puerto Rico-Arecibo","2016","On-tenure track, assistant professors","10","5","5","0","0","0","0","0","0","0","0","0","10","5","5","0","0","0","0","0","0","0","0","0","0","0","0","0","0","0","-2"
"243115","University of Puerto Rico-Arecibo","2016","On-tenure track, instructors","1","0","1","0","0","0","0","0","0","0","0","0","1","0","1","0","0","0","0","0","0","0","0","0","0","0","0","0","0","0","-2"
"243115","University of Puerto Rico-Arecibo","2016","Not on tenure track/No tenure system system total","24","10","14","0","0","0","0","0","0","0","0","0","24","10","14","0","0","0","0","0","0","0","0","0","0","0","0","0","0","0","-2"
"243115","University of Puerto Rico-Arecibo","2016","Not on tenure/no tenure system, assistant professors","2","0","2","0","0","0","0","0","0","0","0","0","2","0","2","0","0","0","0","0","0","0","0","0","0","0","0","0","0","0","-2"
"243115","University of Puerto Rico-Arecibo","2016","Not on tenure/no tenure system, instructors","22","10","12","0","0","0","0","0","0","0","0","0","22","10","12","0","0","0","0","0","0","0","0","0","0","0","0","0","0","0","-2"
"243133","University of Puerto Rico-Bayamon","2016","Tenured total","127","64","63","0","0","0","0","0","0","0","0","0","127","64","63","0","0","0","0","0","0","0","0","0","0","0","0","0","0","0","-2"
"243133","University of Puerto Rico-Bayamon","2016","Tenured, professors","63","35","28","0","0","0","0","0","0","0","0","0","63","35","28","0","0","0","0","0","0","0","0","0","0","0","0","0","0","0","-2"
"243133","University of Puerto Rico-Bayamon","2016","Tenured, associate professors","40","17","23","0","0","0","0","0","0","0","0","0","40","17","23","0","0","0","0","0","0","0","0","0","0","0","0","0","0","0","-2"
"243133","University of Puerto Rico-Bayamon","2016","Tenured, assistant professors","23","11","12","0","0","0","0","0","0","0","0","0","23","11","12","0","0","0","0","0","0","0","0","0","0","0","0","0","0","0","-2"
"243133","University of Puerto Rico-Bayamon","2016","Tenured, instructors","1","1","0","0","0","0","0","0","0","0","0","0","1","1","0","0","0","0","0","0","0","0","0","0","0","0","0","0","0","0","-2"
"243133","University of Puerto Rico-Bayamon","2016","On-Tenure track total","15","5","10","0","0","0","0","0","0","0","0","0","15","5","10","0","0","0","0","0","0","0","0","0","0","0","0","0","0","0","-2"
"243133","University of Puerto Rico-Bayamon","2016","On-tenure track, associate professors","3","1","2","0","0","0","0","0","0","0","0","0","3","1","2","0","0","0","0","0","0","0","0","0","0","0","0","0","0","0","-2"
"243133","University of Puerto Rico-Bayamon","2016","On-tenure track, assistant professors","10","4","6","0","0","0","0","0","0","0","0","0","10","4","6","0","0","0","0","0","0","0","0","0","0","0","0","0","0","0","-2"
"243133","University of Puerto Rico-Bayamon","2016","On-tenure track, instructors","2","0","2","0","0","0","0","0","0","0","0","0","2","0","2","0","0","0","0","0","0","0","0","0","0","0","0","0","0","0","-2"
"243133","University of Puerto Rico-Bayamon","2016","Not on tenure track/No tenure system system total","54","25","29","0","0","0","0","0","0","0","0","0","54","25","29","0","0","0","0","0","0","0","0","0","0","0","0","0","0","0","-2"
"243133","University of Puerto Rico-Bayamon","2016","Not on tenure/no tenure system, assistant professors","28","11","17","0","0","0","0","0","0","0","0","0","28","11","17","0","0","0","0","0","0","0","0","0","0","0","0","0","0","0","-2"
"243133","University of Puerto Rico-Bayamon","2016","Not on tenure/no tenure system, instructors","26","14","12","0","0","0","0","0","0","0","0","0","26","14","12","0","0","0","0","0","0","0","0","0","0","0","0","0","0","0","-2"
"243142","University of Puerto Rico-Carolina","2016","Tenured total","67","41","26","0","0","0","0","0","0","7","3","4","37","28","9","0","0","0","19","7","12","4","3","1","0","0","0","0","0","0","-2"
"243142","University of Puerto Rico-Carolina","2016","Tenured, professors","20","13","7","0","0","0","0","0","0","2","1","1","7","6","1","0","0","0","10","5","5","1","1","0","0","0","0","0","0","0","-2"
"243142","University of Puerto Rico-Carolina","2016","Tenured, associate professors","30","17","13","0","0","0","0","0","0","3","0","3","21","15","6","0","0","0","6","2","4","0","0","0","0","0","0","0","0","0","-2"
"243142","University of Puerto Rico-Carolina","2016","Tenured, assistant professors","15","9","6","0","0","0","0","0","0","2","2","0","9","7","2","0","0","0","3","0","3","1","0","1","0","0","0","0","0","0","-2"
"243142","University of Puerto Rico-Carolina","2016","Tenured, instructors","2","2","0","0","0","0","0","0","0","0","0","0","0","0","0","0","0","0","0","0","0","2","2","0","0","0","0","0","0","0","-2"
"243142","University of Puerto Rico-Carolina","2016","On-Tenure track total","15","8","7","0","0","0","0","0","0","2","2","0","8","4","4","0","0","0","5","2","3","0","0","0","0","0","0","0","0","0","-2"
"243142","University of Puerto Rico-Carolina","2016","On-tenure track, assistant professors","5","4","1","0","0","0","0","0","0","2","2","0","3","2","1","0","0","0","0","0","0","0","0","0","0","0","0","0","0","0","-2"
"243142","University of Puerto Rico-Carolina","2016","On-tenure track, instructors","10","4","6","0","0","0","0","0","0","0","0","0","5","2","3","0","0","0","5","2","3","0","0","0","0","0","0","0","0","0","-2"
"243142","University of Puerto Rico-Carolina","2016","Not on tenure track/No tenure system system total","14","9","5","0","0","0","0","0","0","1","0","1","7","4","3","0","0","0","6","5","1","0","0","0","0","0","0","0","0","0","-2"
"243142","University of Puerto Rico-Carolina","2016","Not on tenure/no tenure system, assistant professors","2","1","1","0","0","0","0","0","0","0","0","0","2","1","1","0","0","0","0","0","0","0","0","0","0","0","0","0","0","0","-2"
"243142","University of Puerto Rico-Carolina","2016","Not on tenure/no tenure system, instructors","12","8","4","0","0","0","0","0","0","1","0","1","5","3","2","0","0","0","6","5","1","0","0","0","0","0","0","0","0","0","-2"
"243151","University of Puerto Rico-Cayey","2016","Tenured total","86","49","37","0","0","0","0","0","0","0","0","0","86","49","37","0","0","0","0","0","0","0","0","0","0","0","0","0","0","0","-2"
"243151","University of Puerto Rico-Cayey","2016","Tenured, professors","50","27","23","0","0","0","0","0","0","0","0","0","50","27","23","0","0","0","0","0","0","0","0","0","0","0","0","0","0","0","-2"
"243151","University of Puerto Rico-Cayey","2016","Tenured, associate professors","13","8","5","0","0","0","0","0","0","0","0","0","13","8","5","0","0","0","0","0","0","0","0","0","0","0","0","0","0","0","-2"
"243151","University of Puerto Rico-Cayey","2016","Tenured, assistant professors","22","13","9","0","0","0","0","0","0","0","0","0","22","13","9","0","0","0","0","0","0","0","0","0","0","0","0","0","0","0","-2"
"243151","University of Puerto Rico-Cayey","2016","Tenured, instructors","1","1","0","0","0","0","0","0","0","0","0","0","1","1","0","0","0","0","0","0","0","0","0","0","0","0","0","0","0","0","-2"
"243151","University of Puerto Rico-Cayey","2016","On-Tenure track total","16","8","8","0","0","0","0","0","0","0","0","0","16","8","8","0","0","0","0","0","0","0","0","0","0","0","0","0","0","0","-2"
"243151","University of Puerto Rico-Cayey","2016","On-tenure track, associate professors","16","8","8","0","0","0","0","0","0","0","0","0","16","8","8","0","0","0","0","0","0","0","0","0","0","0","0","0","0","0","-2"
"243151","University of Puerto Rico-Cayey","2016","Not on tenure track/No tenure system system total","41","17","24","0","0","0","0","0","0","0","0","0","41","17","24","0","0","0","0","0","0","0","0","0","0","0","0","0","0","0","-2"
"243151","University of Puerto Rico-Cayey","2016","Not on tenure/no tenure system, associate professors","31","14","17","0","0","0","0","0","0","0","0","0","31","14","17","0","0","0","0","0","0","0","0","0","0","0","0","0","0","0","-2"
"243151","University of Puerto Rico-Cayey","2016","Not on tenure/no tenure system, instructors","10","3","7","0","0","0","0","0","0","0","0","0","10","3","7","0","0","0","0","0","0","0","0","0","0","0","0","0","0","0","-2"
"243179","University of Puerto Rico-Humacao","2016","Tenured total","134","70","64","1","1","0","0","0","0","0","0","0","127","66","61","0","0","0","5","2","3","0","0","0","0","0","0","1","1","0","-2"
"243179","University of Puerto Rico-Humacao","2016","Tenured, professors","85","47","38","1","1","0","0","0","0","0","0","0","80","45","35","0","0","0","4","1","3","0","0","0","0","0","0","0","0","0","-2"
"243179","University of Puerto Rico-Humacao","2016","Tenured, associate professors","39","15","24","0","0","0","0","0","0","0","0","0","37","13","24","0","0","0","1","1","0","0","0","0","0","0","0","1","1","0","-2"
"243179","University of Puerto Rico-Humacao","2016","Tenured, assistant professors","9","7","2","0","0","0","0","0","0","0","0","0","9","7","2","0","0","0","0","0","0","0","0","0","0","0","0","0","0","0","-2"
"243179","University of Puerto Rico-Humacao","2016","Tenured, instructors","1","1","0","0","0","0","0","0","0","0","0","0","1","1","0","0","0","0","0","0","0","0","0","0","0","0","0","0","0","0","-2"
"243179","University of Puerto Rico-Humacao","2016","On-Tenure track total","14","5","9","0","0","0","0","0","0","0","0","0","14","5","9","0","0","0","0","0","0","0","0","0","0","0","0","0","0","0","-2"
"243179","University of Puerto Rico-Humacao","2016","On-tenure track, assistant professors","12","5","7","0","0","0","0","0","0","0","0","0","12","5","7","0","0","0","0","0","0","0","0","0","0","0","0","0","0","0","-2"
"243179","University of Puerto Rico-Humacao","2016","On-tenure track, instructors","2","0","2","0","0","0","0","0","0","0","0","0","2","0","2","0","0","0","0","0","0","0","0","0","0","0","0","0","0","0","-2"
"243179","University of Puerto Rico-Humacao","2016","Not on tenure track/No tenure system system total","1","1","0","0","0","0","0","0","0","0","0","0","0","0","0","0","0","0","0","0","0","0","0","0","0","0","0","1","1","0","-2"
"243179","University of Puerto Rico-Humacao","2016","Not on tenure/no tenure system, assistant professors","1","1","0","0","0","0","0","0","0","0","0","0","0","0","0","0","0","0","0","0","0","0","0","0","0","0","0","1","1","0","-2"
"243188","University of Puerto Rico-Utuado","2016","Tenured total","48","27","21","0","0","0","0","0","0","0","0","0","48","27","21","0","0","0","0","0","0","0","0","0","0","0","0","0","0","0","-2"
"243188","University of Puerto Rico-Utuado","2016","Tenured, professors","21","11","10","0","0","0","0","0","0","0","0","0","21","11","10","0","0","0","0","0","0","0","0","0","0","0","0","0","0","0","-2"
"243188","University of Puerto Rico-Utuado","2016","Tenured, associate professors","14","7","7","0","0","0","0","0","0","0","0","0","14","7","7","0","0","0","0","0","0","0","0","0","0","0","0","0","0","0","-2"
"243188","University of Puerto Rico-Utuado","2016","Tenured, assistant professors","11","7","4","0","0","0","0","0","0","0","0","0","11","7","4","0","0","0","0","0","0","0","0","0","0","0","0","0","0","0","-2"
"243188","University of Puerto Rico-Utuado","2016","Tenured, instructors","2","2","0","0","0","0","0","0","0","0","0","0","2","2","0","0","0","0","0","0","0","0","0","0","0","0","0","0","0","0","-2"
"243188","University of Puerto Rico-Utuado","2016","On-Tenure track total","4","2","2","0","0","0","0","0","0","0","0","0","4","2","2","0","0","0","0","0","0","0","0","0","0","0","0","0","0","0","-2"
"243188","University of Puerto Rico-Utuado","2016","On-tenure track, assistant professors","4","2","2","0","0","0","0","0","0","0","0","0","4","2","2","0","0","0","0","0","0","0","0","0","0","0","0","0","0","0","-2"
"243188","University of Puerto Rico-Utuado","2016","Not on tenure track/No tenure system system total","21","10","11","0","0","0","0","0","0","0","0","0","21","10","11","0","0","0","0","0","0","0","0","0","0","0","0","0","0","0","-2"
"243188","University of Puerto Rico-Utuado","2016","Not on tenure/no tenure system, assistant professors","7","3","4","0","0","0","0","0","0","0","0","0","7","3","4","0","0","0","0","0","0","0","0","0","0","0","0","0","0","0","-2"
"243188","University of Puerto Rico-Utuado","2016","Not on tenure/no tenure system, instructors","14","7","7","0","0","0","0","0","0","0","0","0","14","7","7","0","0","0","0","0","0","0","0","0","0","0","0","0","0","0","-2"
"243197","University of Puerto Rico-Mayaguez","2016","Tenured total","447","281","166","0","0","0","0","0","0","0","0","0","446","280","166","0","0","0","1","1","0","0","0","0","0","0","0","0","0","0","-2"
"243197","University of Puerto Rico-Mayaguez","2016","Tenured, professors","338","225","113","0","0","0","0","0","0","0","0","0","337","224","113","0","0","0","1","1","0","0","0","0","0","0","0","0","0","0","-2"
"243197","University of Puerto Rico-Mayaguez","2016","Tenured, associate professors","89","45","44","0","0","0","0","0","0","0","0","0","89","45","44","0","0","0","0","0","0","0","0","0","0","0","0","0","0","0","-2"
"243197","University of Puerto Rico-Mayaguez","2016","Tenured, assistant professors","19","10","9","0","0","0","0","0","0","0","0","0","19","10","9","0","0","0","0","0","0","0","0","0","0","0","0","0","0","0","-2"
"243197","University of Puerto Rico-Mayaguez","2016","Tenured, instructors","1","1","0","0","0","0","0","0","0","0","0","0","1","1","0","0","0","0","0","0","0","0","0","0","0","0","0","0","0","0","-2"
"243197","University of Puerto Rico-Mayaguez","2016","On-Tenure track total","71","39","32","0","0","0","0","0","0","0","0","0","69","37","32","0","0","0","0","0","0","0","0","0","2","2","0","0","0","0","-2"
"243197","University of Puerto Rico-Mayaguez","2016","On-tenure track, professors","1","0","1","0","0","0","0","0","0","0","0","0","1","0","1","0","0","0","0","0","0","0","0","0","0","0","0","0","0","0","-2"
"243197","University of Puerto Rico-Mayaguez","2016","On-tenure track, associate professors","10","4","6","0","0","0","0","0","0","0","0","0","10","4","6","0","0","0","0","0","0","0","0","0","0","0","0","0","0","0","-2"
"243197","University of Puerto Rico-Mayaguez","2016","On-tenure track, assistant professors","60","35","25","0","0","0","0","0","0","0","0","0","58","33","25","0","0","0","0","0","0","0","0","0","2","2","0","0","0","0","-2"
"243197","University of Puerto Rico-Mayaguez","2016","Not on tenure track/No tenure system system total","51","22","29","0","0","0","0","0","0","0","0","0","46","21","25","0","0","0","1","0","1","0","0","0","4","1","3","0","0","0","-2"
"243197","University of Puerto Rico-Mayaguez","2016","Not on tenure/no tenure system, professors","1","1","0","0","0","0","0","0","0","0","0","0","1","1","0","0","0","0","0","0","0","0","0","0","0","0","0","0","0","0","-2"
"243197","University of Puerto Rico-Mayaguez","2016","Not on tenure/no tenure system, associate professors","1","1","0","0","0","0","0","0","0","0","0","0","1","1","0","0","0","0","0","0","0","0","0","0","0","0","0","0","0","0","-2"
"243197","University of Puerto Rico-Mayaguez","2016","Not on tenure/no tenure system, assistant professors","17","9","8","0","0","0","0","0","0","0","0","0","15","9","6","0","0","0","1","0","1","0","0","0","1","0","1","0","0","0","-2"
"243197","University of Puerto Rico-Mayaguez","2016","Not on tenure/no tenure system, instructors","32","11","21","0","0","0","0","0","0","0","0","0","29","10","19","0","0","0","0","0","0","0","0","0","3","1","2","0","0","0","-2"
"243203","University of Puerto Rico-Medical Sciences","2016","Tenured total","371","160","211","0","0","0","3","1","2","0","0","0","350","146","204","0","0","0","18","13","5","0","0","0","0","0","0","0","0","0","-2"
"243203","University of Puerto Rico-Medical Sciences","2016","Tenured, professors","260","119","141","0","0","0","3","1","2","0","0","0","240","105","135","0","0","0","17","13","4","0","0","0","0","0","0","0","0","0","-2"
"243203","University of Puerto Rico-Medical Sciences","2016","Tenured, associate professors","81","32","49","0","0","0","0","0","0","0","0","0","80","32","48","0","0","0","1","0","1","0","0","0","0","0","0","0","0","0","-2"
"243203","University of Puerto Rico-Medical Sciences","2016","Tenured, assistant professors","30","9","21","0","0","0","0","0","0","0","0","0","30","9","21","0","0","0","0","0","0","0","0","0","0","0","0","0","0","0","-2"
"243203","University of Puerto Rico-Medical Sciences","2016","On-Tenure track total","95","44","51","0","0","0","1","0","1","0","0","0","93","43","50","0","0","0","1","1","0","0","0","0","0","0","0","0","0","0","-2"
"243203","University of Puerto Rico-Medical Sciences","2016","On-tenure track, professors","18","11","7","0","0","0","0","0","0","0","0","0","18","11","7","0","0","0","0","0","0","0","0","0","0","0","0","0","0","0","-2"
"243203","University of Puerto Rico-Medical Sciences","2016","On-tenure track, associate professors","29","14","15","0","0","0","1","0","1","0","0","0","28","14","14","0","0","0","0","0","0","0","0","0","0","0","0","0","0","0","-2"
"243203","University of Puerto Rico-Medical Sciences","2016","On-tenure track, assistant professors","38","18","20","0","0","0","0","0","0","0","0","0","37","17","20","0","0","0","1","1","0","0","0","0","0","0","0","0","0","0","-2"
"243203","University of Puerto Rico-Medical Sciences","2016","On-tenure track, instructors","10","1","9","0","0","0","0","0","0","0","0","0","10","1","9","0","0","0","0","0","0","0","0","0","0","0","0","0","0","0","-2"
"243203","University of Puerto Rico-Medical Sciences","2016","Not on tenure track/No tenure system system total","166","51","115","0","0","0","0","0","0","1","0","1","163","50","113","0","0","0","2","1","1","0","0","0","0","0","0","0","0","0","-2"
"243203","University of Puerto Rico-Medical Sciences","2016","Not on tenure/no tenure system, professors","8","4","4","0","0","0","0","0","0","0","0","0","8","4","4","0","0","0","0","0","0","0","0","0","0","0","0","0","0","0","-2"
"243203","University of Puerto Rico-Medical Sciences","2016","Not on tenure/no tenure system, associate professors","27","10","17","0","0","0","0","0","0","1","0","1","26","10","16","0","0","0","0","0","0","0","0","0","0","0","0","0","0","0","-2"
"243203","University of Puerto Rico-Medical Sciences","2016","Not on tenure/no tenure system, assistant professors","84","29","55","0","0","0","0","0","0","0","0","0","83","28","55","0","0","0","1","1","0","0","0","0","0","0","0","0","0","0","-2"
"243203","University of Puerto Rico-Medical Sciences","2016","Not on tenure/no tenure system, instructors","15","3","12","0","0","0","0","0","0","0","0","0","15","3","12","0","0","0","0","0","0","0","0","0","0","0","0","0","0","0","-2"
"243203","University of Puerto Rico-Medical Sciences","2016","Not on tenure/no tenure system, no academic rank","32","5","27","0","0","0","0","0","0","0","0","0","31","5","26","0","0","0","1","0","1","0","0","0","0","0","0","0","0","0","-2"
"243212","University of Puerto Rico-Ponce","2016","Tenured total","74","35","39","0","0","0","0","0","0","0","0","0","74","35","39","0","0","0","0","0","0","0","0","0","0","0","0","0","0","0","-2"
"243212","University of Puerto Rico-Ponce","2016","Tenured, professors","30","14","16","0","0","0","0","0","0","0","0","0","30","14","16","0","0","0","0","0","0","0","0","0","0","0","0","0","0","0","-2"
"243212","University of Puerto Rico-Ponce","2016","Tenured, associate professors","13","5","8","0","0","0","0","0","0","0","0","0","13","5","8","0","0","0","0","0","0","0","0","0","0","0","0","0","0","0","-2"
"243212","University of Puerto Rico-Ponce","2016","Tenured, assistant professors","23","9","14","0","0","0","0","0","0","0","0","0","23","9","14","0","0","0","0","0","0","0","0","0","0","0","0","0","0","0","-2"
"243212","University of Puerto Rico-Ponce","2016","Tenured, instructors","8","7","1","0","0","0","0","0","0","0","0","0","8","7","1","0","0","0","0","0","0","0","0","0","0","0","0","0","0","0","-2"
"243212","University of Puerto Rico-Ponce","2016","On-Tenure track total","7","2","5","0","0","0","0","0","0","0","0","0","7","2","5","0","0","0","0","0","0","0","0","0","0","0","0","0","0","0","-2"
"243212","University of Puerto Rico-Ponce","2016","On-tenure track, assistant professors","7","2","5","0","0","0","0","0","0","0","0","0","7","2","5","0","0","0","0","0","0","0","0","0","0","0","0","0","0","0","-2"
"243212","University of Puerto Rico-Ponce","2016","Not on tenure track/No tenure system system total","13","5","8","0","0","0","0","0","0","0","0","0","13","5","8","0","0","0","0","0","0","0","0","0","0","0","0","0","0","0","-2"
"243212","University of Puerto Rico-Ponce","2016","Not on tenure/no tenure system, assistant professors","6","1","5","0","0","0","0","0","0","0","0","0","6","1","5","0","0","0","0","0","0","0","0","0","0","0","0","0","0","0","-2"
"243212","University of Puerto Rico-Ponce","2016","Not on tenure/no tenure system, instructors","7","4","3","0","0","0","0","0","0","0","0","0","7","4","3","0","0","0","0","0","0","0","0","0","0","0","0","0","0","0","-2"
"243221","University of Puerto Rico-Rio Piedras","2016","Tenured total","673","335","338","0","0","0","4","4","0","0","0","0","657","322","335","0","0","0","9","6","3","0","0","0","3","3","0","0","0","0","-2"
"243221","University of Puerto Rico-Rio Piedras","2016","Tenured, professors","460","245","215","0","0","0","3","3","0","0","0","0","450","237","213","0","0","0","6","4","2","0","0","0","1","1","0","0","0","0","-2"
"243221","University of Puerto Rico-Rio Piedras","2016","Tenured, associate professors","151","73","78","0","0","0","1","1","0","0","0","0","146","69","77","0","0","0","2","1","1","0","0","0","2","2","0","0","0","0","-2"
"243221","University of Puerto Rico-Rio Piedras","2016","Tenured, assistant professors","42","14","28","0","0","0","0","0","0","0","0","0","41","13","28","0","0","0","1","1","0","0","0","0","0","0","0","0","0","0","-2"
"243221","University of Puerto Rico-Rio Piedras","2016","Tenured, instructors","13","2","11","0","0","0","0","0","0","0","0","0","13","2","11","0","0","0","0","0","0","0","0","0","0","0","0","0","0","0","-2"
"243221","University of Puerto Rico-Rio Piedras","2016","Tenured, no academic rank","7","1","6","0","0","0","0","0","0","0","0","0","7","1","6","0","0","0","0","0","0","0","0","0","0","0","0","0","0","0","-2"
"243221","University of Puerto Rico-Rio Piedras","2016","On-Tenure track total","71","39","32","0","0","0","1","1","0","0","0","0","61","32","29","0","0","0","5","3","2","0","0","0","4","3","1","0","0","0","-2"
"243221","University of Puerto Rico-Rio Piedras","2016","On-tenure track, professors","1","1","0","0","0","0","0","0","0","0","0","0","1","1","0","0","0","0","0","0","0","0","0","0","0","0","0","0","0","0","-2"
"243221","University of Puerto Rico-Rio Piedras","2016","On-tenure track, associate professors","14","8","6","0","0","0","1","1","0","0","0","0","12","7","5","0","0","0","1","0","1","0","0","0","0","0","0","0","0","0","-2"
"243221","University of Puerto Rico-Rio Piedras","2016","On-tenure track, assistant professors","52","26","26","0","0","0","0","0","0","0","0","0","44","20","24","0","0","0","4","3","1","0","0","0","4","3","1","0","0","0","-2"
"243221","University of Puerto Rico-Rio Piedras","2016","On-tenure track, instructors","4","4","0","0","0","0","0","0","0","0","0","0","4","4","0","0","0","0","0","0","0","0","0","0","0","0","0","0","0","0","-2"
"243221","University of Puerto Rico-Rio Piedras","2016","Not on tenure track/No tenure system system total","245","115","130","0","0","0","2","0","2","1","1","0","228","107","121","0","0","0","3","3","0","0","0","0","11","4","7","0","0","0","-2"
"243221","University of Puerto Rico-Rio Piedras","2016","Not on tenure/no tenure system, professors","1","0","1","0","0","0","0","0","0","0","0","0","1","0","1","0","0","0","0","0","0","0","0","0","0","0","0","0","0","0","-2"
"243221","University of Puerto Rico-Rio Piedras","2016","Not on tenure/no tenure system, associate professors","3","1","2","0","0","0","0","0","0","0","0","0","3","1","2","0","0","0","0","0","0","0","0","0","0","0","0","0","0","0","-2"
"243221","University of Puerto Rico-Rio Piedras","2016","Not on tenure/no tenure system, assistant professors","130","64","66","0","0","0","0","0","0","1","1","0","119","59","60","0","0","0","1","1","0","0","0","0","9","3","6","0","0","0","-2"
"243221","University of Puerto Rico-Rio Piedras","2016","Not on tenure/no tenure system, instructors","102","46","56","0","0","0","1","0","1","0","0","0","99","45","54","0","0","0","0","0","0","0","0","0","2","1","1","0","0","0","-2"
"243221","University of Puerto Rico-Rio Piedras","2016","Not on tenure/no tenure system, no academic rank","9","4","5","0","0","0","1","0","1","0","0","0","6","2","4","0","0","0","2","2","0","0","0","0","0","0","0","0","0","0","-2"
"243346","Universidad Ana G. Mendez-Carolina Campus","2016","Tenured total","18","6","12","0","0","0","0","0","0","0","0","0","18","6","12","0","0","0","0","0","0","0","0","0","0","0","0","0","0","0","-2"
"243346","Universidad Ana G. Mendez-Carolina Campus","2016","Tenured, professors","8","2","6","0","0","0","0","0","0","0","0","0","8","2","6","0","0","0","0","0","0","0","0","0","0","0","0","0","0","0","-2"
"243346","Universidad Ana G. Mendez-Carolina Campus","2016","Tenured, associate professors","6","2","4","0","0","0","0","0","0","0","0","0","6","2","4","0","0","0","0","0","0","0","0","0","0","0","0","0","0","0","-2"
"243346","Universidad Ana G. Mendez-Carolina Campus","2016","Tenured, assistant professors","4","2","2","0","0","0","0","0","0","0","0","0","4","2","2","0","0","0","0","0","0","0","0","0","0","0","0","0","0","0","-2"
"243346","Universidad Ana G. Mendez-Carolina Campus","2016","Not on tenure track/No tenure system system total","146","59","87","0","0","0","0","0","0","1","1","0","141","55","86","0","0","0","3","2","1","0","0","0","1","1","0","0","0","0","-2"
"243346","Universidad Ana G. Mendez-Carolina Campus","2016","Not on tenure/no tenure system, professors","10","3","7","0","0","0","0","0","0","0","0","0","10","3","7","0","0","0","0","0","0","0","0","0","0","0","0","0","0","0","-2"
"243346","Universidad Ana G. Mendez-Carolina Campus","2016","Not on tenure/no tenure system, associate professors","26","8","18","0","0","0","0","0","0","0","0","0","24","7","17","0","0","0","1","0","1","0","0","0","1","1","0","0","0","0","-2"
"243346","Universidad Ana G. Mendez-Carolina Campus","2016","Not on tenure/no tenure system, assistant professors","39","18","21","0","0","0","0","0","0","1","1","0","38","17","21","0","0","0","0","0","0","0","0","0","0","0","0","0","0","0","-2"
"243346","Universidad Ana G. Mendez-Carolina Campus","2016","Not on tenure/no tenure system, instructors","71","30","41","0","0","0","0","0","0","0","0","0","69","28","41","0","0","0","2","2","0","0","0","0","0","0","0","0","0","0","-2"
"243443","Universidad del Sagrado Corazon","2016","Tenured total","73","26","47","0","0","0","1","1","0","0","0","0","71","24","47","0","0","0","1","1","0","0","0","0","0","0","0","0","0","0","-2"
"243443","Universidad del Sagrado Corazon","2016","Tenured, professors","49","19","30","0","0","0","1","1","0","0","0","0","47","17","30","0","0","0","1","1","0","0","0","0","0","0","0","0","0","0","-2"
"243443","Universidad del Sagrado Corazon","2016","Tenured, associate professors","10","2","8","0","0","0","0","0","0","0","0","0","10","2","8","0","0","0","0","0","0","0","0","0","0","0","0","0","0","0","-2"
"243443","Universidad del Sagrado Corazon","2016","Tenured, assistant professors","9","4","5","0","0","0","0","0","0","0","0","0","9","4","5","0","0","0","0","0","0","0","0","0","0","0","0","0","0","0","-2"
"243443","Universidad del Sagrado Corazon","2016","Tenured, instructors","5","1","4","0","0","0","0","0","0","0","0","0","5","1","4","0","0","0","0","0","0","0","0","0","0","0","0","0","0","0","-2"
"243443","Universidad del Sagrado Corazon","2016","On-Tenure track total","14","6","8","0","0","0","0","0","0","0","0","0","14","6","8","0","0","0","0","0","0","0","0","0","0","0","0","0","0","0","-2"
"243443","Universidad del Sagrado Corazon","2016","On-tenure track, assistant professors","4","2","2","0","0","0","0","0","0","0","0","0","4","2","2","0","0","0","0","0","0","0","0","0","0","0","0","0","0","0","-2"
"243443","Universidad del Sagrado Corazon","2016","On-tenure track, instructors","10","4","6","0","0","0","0","0","0","0","0","0","10","4","6","0","0","0","0","0","0","0","0","0","0","0","0","0","0","0","-2"
"243568","Universidad Central Del Caribe","2016","Not on tenure track/No tenure system system total","46","22","24","0","0","0","0","0","0","0","0","0","34","15","19","0","0","0","12","7","5","0","0","0","0","0","0","0","0","0","-2"
"243568","Universidad Central Del Caribe","2016","Not on tenure/no tenure system, professors","17","11","6","0","0","0","0","0","0","0","0","0","11","8","3","0","0","0","6","3","3","0","0","0","0","0","0","0","0","0","-2"
"243568","Universidad Central Del Caribe","2016","Not on tenure/no tenure system, associate professors","16","5","11","0","0","0","0","0","0","0","0","0","13","4","9","0","0","0","3","1","2","0","0","0","0","0","0","0","0","0","-2"
"243568","Universidad Central Del Caribe","2016","Not on tenure/no tenure system, assistant professors","12","6","6","0","0","0","0","0","0","0","0","0","9","3","6","0","0","0","3","3","0","0","0","0","0","0","0","0","0","0","-2"
"243568","Universidad Central Del Caribe","2016","Not on tenure/no tenure system, instructors","1","0","1","0","0","0","0","0","0","0","0","0","1","0","1","0","0","0","0","0","0","0","0","0","0","0","0","0","0","0","-2"
"243577","Universidad Politecnica de Puerto Rico","2016","Tenured total","27","16","11","0","0","0","1","1","0","0","0","0","26","15","11","0","0","0","0","0","0","0","0","0","0","0","0","0","0","0","-2"
"243577","Universidad Politecnica de Puerto Rico","2016","Tenured, professors","19","14","5","0","0","0","1","1","0","0","0","0","18","13","5","0","0","0","0","0","0","0","0","0","0","0","0","0","0","0","-2"
"243577","Universidad Politecnica de Puerto Rico","2016","Tenured, associate professors","8","2","6","0","0","0","0","0","0","0","0","0","8","2","6","0","0","0","0","0","0","0","0","0","0","0","0","0","0","0","-2"
"243577","Universidad Politecnica de Puerto Rico","2016","Not on tenure track/No tenure system system total","105","70","35","0","0","0","0","0","0","0","0","0","98","63","35","0","0","0","3","3","0","0","0","0","4","4","0","0","0","0","-2"
"243577","Universidad Politecnica de Puerto Rico","2016","Not on tenure/no tenure system, professors","17","15","2","0","0","0","0","0","0","0","0","0","16","14","2","0","0","0","1","1","0","0","0","0","0","0","0","0","0","0","-2"
"243577","Universidad Politecnica de Puerto Rico","2016","Not on tenure/no tenure system, associate professors","63","42","21","0","0","0","0","0","0","0","0","0","58","37","21","0","0","0","2","2","0","0","0","0","3","3","0","0","0","0","-2"
"243577","Universidad Politecnica de Puerto Rico","2016","Not on tenure/no tenure system, assistant professors","21","12","9","0","0","0","0","0","0","0","0","0","20","11","9","0","0","0","0","0","0","0","0","0","1","1","0","0","0","0","-2"
"243577","Universidad Politecnica de Puerto Rico","2016","Not on tenure/no tenure system, instructors","4","1","3","0","0","0","0","0","0","0","0","0","4","1","3","0","0","0","0","0","0","0","0","0","0","0","0","0","0","0","-2"
"243586","Pontifical Catholic University of Puerto Rico-Mayaguez","2016","Not on tenure track/No tenure system system total","37","19","18","0","0","0","0","0","0","0","0","0","36","18","18","0","0","0","1","1","0","0","0","0","0","0","0","0","0","0","-2"
"243586","Pontifical Catholic University of Puerto Rico-Mayaguez","2016","Not on tenure/no tenure system, professors","2","1","1","0","0","0","0","0","0","0","0","0","2","1","1","0","0","0","0","0","0","0","0","0","0","0","0","0","0","0","-2"
"243586","Pontifical Catholic University of Puerto Rico-Mayaguez","2016","Not on tenure/no tenure system, associate professors","7","6","1","0","0","0","0","0","0","0","0","0","7","6","1","0","0","0","0","0","0","0","0","0","0","0","0","0","0","0","-2"
"243586","Pontifical Catholic University of Puerto Rico-Mayaguez","2016","Not on tenure/no tenure system, assistant professors","20","9","11","0","0","0","0","0","0","0","0","0","20","9","11","0","0","0","0","0","0","0","0","0","0","0","0","0","0","0","-2"
"243586","Pontifical Catholic University of Puerto Rico-Mayaguez","2016","Not on tenure/no tenure system, instructors","3","2","1","0","0","0","0","0","0","0","0","0","2","1","1","0","0","0","1","1","0","0","0","0","0","0","0","0","0","0","-2"
"243586","Pontifical Catholic University of Puerto Rico-Mayaguez","2016","Not on tenure/no tenure system, no academic rank","5","1","4","0","0","0","0","0","0","0","0","0","5","1","4","0","0","0","0","0","0","0","0","0","0","0","0","0","0","0","-2"
"243601","Universidad Ana G. Mendez-Gurabo Campus","2016","Tenured total","35","17","18","0","0","0","0","0","0","0","0","0","35","17","18","0","0","0","0","0","0","0","0","0","0","0","0","0","0","0","-2"
"243601","Universidad Ana G. Mendez-Gurabo Campus","2016","Tenured, professors","20","10","10","0","0","0","0","0","0","0","0","0","20","10","10","0","0","0","0","0","0","0","0","0","0","0","0","0","0","0","-2"
"243601","Universidad Ana G. Mendez-Gurabo Campus","2016","Tenured, associate professors","14","6","8","0","0","0","0","0","0","0","0","0","14","6","8","0","0","0","0","0","0","0","0","0","0","0","0","0","0","0","-2"
"243601","Universidad Ana G. Mendez-Gurabo Campus","2016","Tenured, assistant professors","1","1","0","0","0","0","0","0","0","0","0","0","1","1","0","0","0","0","0","0","0","0","0","0","0","0","0","0","0","0","-2"
"243601","Universidad Ana G. Mendez-Gurabo Campus","2016","Not on tenure track/No tenure system system total","159","76","83","0","0","0","0","0","0","1","1","0","149","69","80","0","0","0","3","2","1","0","0","0","6","4","2","0","0","0","-2"
"243601","Universidad Ana G. Mendez-Gurabo Campus","2016","Not on tenure/no tenure system, professors","19","15","4","0","0","0","0","0","0","0","0","0","15","11","4","0","0","0","1","1","0","0","0","0","3","3","0","0","0","0","-2"
"243601","Universidad Ana G. Mendez-Gurabo Campus","2016","Not on tenure/no tenure system, associate professors","34","14","20","0","0","0","0","0","0","1","1","0","31","13","18","0","0","0","0","0","0","0","0","0","2","0","2","0","0","0","-2"
"243601","Universidad Ana G. Mendez-Gurabo Campus","2016","Not on tenure/no tenure system, assistant professors","63","29","34","0","0","0","0","0","0","0","0","0","62","28","34","0","0","0","0","0","0","0","0","0","1","1","0","0","0","0","-2"
"243601","Universidad Ana G. Mendez-Gurabo Campus","2016","Not on tenure/no tenure system, instructors","43","18","25","0","0","0","0","0","0","0","0","0","41","17","24","0","0","0","2","1","1","0","0","0","0","0","0","0","0","0","-2"
"243832","EDP University of Puerto Rico Inc-San Juan","2016","Not on tenure track/No tenure system system total","41","12","29","0","0","0","0","0","0","0","0","0","41","12","29","0","0","0","0","0","0","0","0","0","0","0","0","0","0","0","-2"
"243832","EDP University of Puerto Rico Inc-San Juan","2016","Not on tenure/no tenure system, instructors","41","12","29","0","0","0","0","0","0","0","0","0","41","12","29","0","0","0","0","0","0","0","0","0","0","0","0","0","0","0","-2"
"245953","Mid-America Christian University","2016","Not on tenure track/No tenure system system total","32","17","15","3","3","0","0","0","0","1","0","1","1","1","0","0","0","0","23","11","12","1","1","0","3","1","2","0","0","0","-2"
"245953","Mid-America Christian University","2016","Not on tenure/no tenure system, professors","6","5","1","2","2","0","0","0","0","1","0","1","0","0","0","0","0","0","3","3","0","0","0","0","0","0","0","0","0","0","-2"
"245953","Mid-America Christian University","2016","Not on tenure/no tenure system, associate professors","9","4","5","1","1","0","0","0","0","0","0","0","0","0","0","0","0","0","7","3","4","0","0","0","1","0","1","0","0","0","-2"
"245953","Mid-America Christian University","2016","Not on tenure/no tenure system, assistant professors","12","6","6","0","0","0","0","0","0","0","0","0","1","1","0","0","0","0","8","3","5","1","1","0","2","1","1","0","0","0","-2"
"245953","Mid-America Christian University","2016","Not on tenure/no tenure system, instructors","5","2","3","0","0","0","0","0","0","0","0","0","0","0","0","0","0","0","5","2","3","0","0","0","0","0","0","0","0","0","-2"
"363907","Caribbean University-Ponce","2016","Not on tenure track/No tenure system system total","28","11","17","0","0","0","0","0","0","0","0","0","28","11","17","0","0","0","0","0","0","0","0","0","0","0","0","0","0","0","-2"
"363907","Caribbean University-Ponce","2016","Not on tenure/no tenure system, professors","1","1","0","0","0","0","0","0","0","0","0","0","1","1","0","0","0","0","0","0","0","0","0","0","0","0","0","0","0","0","-2"
"363907","Caribbean University-Ponce","2016","Not on tenure/no tenure system, assistant professors","7","3","4","0","0","0","0","0","0","0","0","0","7","3","4","0","0","0","0","0","0","0","0","0","0","0","0","0","0","0","-2"
"363907","Caribbean University-Ponce","2016","Not on tenure/no tenure system, instructors","20","7","13","0","0","0","0","0","0","0","0","0","20","7","13","0","0","0","0","0","0","0","0","0","0","0","0","0","0","0","-2"
"363916","Caribbean University-Vega Baja","2016","Not on tenure track/No tenure system system total","11","3","8","0","0","0","0","0","0","0","0","0","11","3","8","0","0","0","0","0","0","0","0","0","0","0","0","0","0","0","-2"
"363916","Caribbean University-Vega Baja","2016","Not on tenure/no tenure system, assistant professors","2","0","2","0","0","0","0","0","0","0","0","0","2","0","2","0","0","0","0","0","0","0","0","0","0","0","0","0","0","0","-2"
"363916","Caribbean University-Vega Baja","2016","Not on tenure/no tenure system, instructors","9","3","6","0","0","0","0","0","0","0","0","0","9","3","6","0","0","0","0","0","0","0","0","0","0","0","0","0","0","0","-2"
"366711","California State University-San Marcos","2016","Tenured total","185","94","91","2","1","1","27","19","8","6","5","1","29","14","15","1","1","0","109","47","62","4","1","3","5","4","1","2","2","0","-2"
"366711","California State University-San Marcos","2016","Tenured, professors","111","53","58","1","0","1","14","10","4","2","1","1","16","9","7","0","0","0","71","29","42","2","0","2","3","2","1","2","2","0","-2"
"366711","California State University-San Marcos","2016","Tenured, associate professors","74","41","33","1","1","0","13","9","4","4","4","0","13","5","8","1","1","0","38","18","20","2","1","1","2","2","0","0","0","0","-2"
"366711","California State University-San Marcos","2016","On-Tenure track total","73","28","45","2","1","1","13","6","7","1","0","1","13","6","7","0","0","0","35","12","23","1","0","1","2","0","2","6","3","3","-2"
"366711","California State University-San Marcos","2016","On-tenure track, assistant professors","73","28","45","2","1","1","13","6","7","1","0","1","13","6","7","0","0","0","35","12","23","1","0","1","2","0","2","6","3","3","-2"
"366711","California State University-San Marcos","2016","Not on tenure track/No tenure system system total","101","28","73","0","0","0","8","3","5","2","0","2","11","2","9","0","0","0","76","22","54","2","0","2","1","1","0","1","0","1","-2"
"366711","California State University-San Marcos","2016","Not on tenure/no tenure system, lecturers","101","28","73","0","0","0","8","3","5","2","0","2","11","2","9","0","0","0","76","22","54","2","0","2","1","1","0","1","0","1","-2"
"367884","Hodges University","2016","Not on tenure track/No tenure system system total","46","19","27","0","0","0","0","0","0","0","0","0","5","4","1","0","0","0","40","15","25","1","0","1","0","0","0","0","0","0","-2"
"367884","Hodges University","2016","Not on tenure/no tenure system, professors","7","3","4","0","0","0","0","0","0","0","0","0","0","0","0","0","0","0","7","3","4","0","0","0","0","0","0","0","0","0","-2"
"367884","Hodges University","2016","Not on tenure/no tenure system, associate professors","14","8","6","0","0","0","0","0","0","0","0","0","2","2","0","0","0","0","12","6","6","0","0","0","0","0","0","0","0","0","-2"
"367884","Hodges University","2016","Not on tenure/no tenure system, assistant professors","23","7","16","0","0","0","0","0","0","0","0","0","3","2","1","0","0","0","19","5","14","1","0","1","0","0","0","0","0","0","-2"
"367884","Hodges University","2016","Not on tenure/no tenure system, no academic rank","2","1","1","0","0","0","0","0","0","0","0","0","0","0","0","0","0","0","2","1","1","0","0","0","0","0","0","0","0","0","-2"
"376385","Universal Technology College of Puerto Rico","2016","Not on tenure track/No tenure system system total","25","10","15","0","0","0","0","0","0","0","0","0","25","10","15","0","0","0","0","0","0","0","0","0","0","0","0","0","0","0","-2"
"376385","Universal Technology College of Puerto Rico","2016","Not on tenure/no tenure system, professors","25","10","15","0","0","0","0","0","0","0","0","0","25","10","15","0","0","0","0","0","0","0","0","0","0","0","0","0","0","0","-2"
"407009","Arizona State University-West","2016","Tenured total","102","60","42","0","0","0","9","5","4","2","1","1","15","8","7","0","0","0","75","45","30","0","0","0","1","1","0","0","0","0","-2"
"407009","Arizona State University-West","2016","Tenured, professors","31","20","11","0","0","0","4","2","2","0","0","0","3","2","1","0","0","0","24","16","8","0","0","0","0","0","0","0","0","0","-2"
"407009","Arizona State University-West","2016","Tenured, associate professors","71","40","31","0","0","0","5","3","2","2","1","1","12","6","6","0","0","0","51","29","22","0","0","0","1","1","0","0","0","0","-2"
"407009","Arizona State University-West","2016","On-Tenure track total","26","7","19","1","1","0","4","1","3","1","0","1","3","1","2","0","0","0","15","3","12","2","1","1","0","0","0","0","0","0","-2"
"407009","Arizona State University-West","2016","On-tenure track, associate professors","2","1","1","0","0","0","1","0","1","0","0","0","0","0","0","0","0","0","1","1","0","0","0","0","0","0","0","0","0","0","-2"
"407009","Arizona State University-West","2016","On-tenure track, assistant professors","24","6","18","1","1","0","3","1","2","1","0","1","3","1","2","0","0","0","14","2","12","2","1","1","0","0","0","0","0","0","-2"
"407009","Arizona State University-West","2016","Not on tenure track/No tenure system system total","127","41","86","1","0","1","6","1","5","5","2","3","15","4","11","1","0","1","94","31","63","0","0","0","3","1","2","2","2","0","-2"
"407009","Arizona State University-West","2016","Not on tenure/no tenure system, professors","3","3","0","0","0","0","0","0","0","0","0","0","1","1","0","0","0","0","1","1","0","0","0","0","1","1","0","0","0","0","-2"
"407009","Arizona State University-West","2016","Not on tenure/no tenure system, associate professors","9","3","6","0","0","0","0","0","0","0","0","0","1","0","1","0","0","0","8","3","5","0","0","0","0","0","0","0","0","0","-2"
"407009","Arizona State University-West","2016","Not on tenure/no tenure system, assistant professors","41","8","33","0","0","0","2","0","2","2","1","1","5","2","3","1","0","1","30","4","26","0","0","0","0","0","0","1","1","0","-2"
"407009","Arizona State University-West","2016","Not on tenure/no tenure system, instructors","26","9","17","0","0","0","1","1","0","0","0","0","4","0","4","0","0","0","19","8","11","0","0","0","2","0","2","0","0","0","-2"
"407009","Arizona State University-West","2016","Not on tenure/no tenure system, lecturers","48","18","30","1","0","1","3","0","3","3","1","2","4","1","3","0","0","0","36","15","21","0","0","0","0","0","0","1","1","0","-2"
"409315","South Texas College","2016","Not on tenure track/No tenure system system total","582","350","232","4","3","1","51","25","26","14","13","1","336","198","138","0","0","0","175","110","65","0","0","0","2","1","1","0","0","0","-2"
"409315","South Texas College","2016","Not on tenure/no tenure system, professors","10","7","3","0","0","0","1","1","0","1","1","0","1","1","0","0","0","0","7","4","3","0","0","0","0","0","0","0","0","0","-2"
"409315","South Texas College","2016","Not on tenure/no tenure system, associate professors","25","17","8","0","0","0","1","1","0","0","0","0","11","8","3","0","0","0","13","8","5","0","0","0","0","0","0","0","0","0","-2"
"409315","South Texas College","2016","Not on tenure/no tenure system, assistant professors","38","22","16","0","0","0","4","2","2","0","0","0","18","9","9","0","0","0","16","11","5","0","0","0","0","0","0","0","0","0","-2"
"409315","South Texas College","2016","Not on tenure/no tenure system, instructors","509","304","205","4","3","1","45","21","24","13","12","1","306","180","126","0","0","0","139","87","52","0","0","0","2","1","1","0","0","0","-2"
"409698","California State University-Monterey Bay","2016","Tenured total","86","45","41","1","1","0","19","7","12","5","4","1","18","10","8","1","0","1","38","21","17","0","0","0","4","2","2","0","0","0","-2"
"409698","California State University-Monterey Bay","2016","Tenured, professors","52","31","21","1","1","0","13","6","7","3","2","1","9","6","3","1","0","1","25","16","9","0","0","0","0","0","0","0","0","0","-2"
"409698","California State University-Monterey Bay","2016","Tenured, associate professors","33","14","19","0","0","0","6","1","5","2","2","0","9","4","5","0","0","0","12","5","7","0","0","0","4","2","2","0","0","0","-2"
"409698","California State University-Monterey Bay","2016","Tenured, no academic rank","1","0","1","0","0","0","0","0","0","0","0","0","0","0","0","0","0","0","1","0","1","0","0","0","0","0","0","0","0","0","-2"
"409698","California State University-Monterey Bay","2016","On-Tenure track total","64","30","34","2","1","1","7","3","4","2","1","1","7","4","3","0","0","0","38","15","23","1","1","0","2","2","0","5","3","2","-2"
"409698","California State University-Monterey Bay","2016","On-tenure track, associate professors","4","4","0","0","0","0","0","0","0","0","0","0","0","0","0","0","0","0","3","3","0","0","0","0","0","0","0","1","1","0","-2"
"409698","California State University-Monterey Bay","2016","On-tenure track, assistant professors","60","26","34","2","1","1","7","3","4","2","1","1","7","4","3","0","0","0","35","12","23","1","1","0","2","2","0","4","2","2","-2"
"409698","California State University-Monterey Bay","2016","Not on tenure track/No tenure system system total","75","33","42","0","0","0","2","1","1","4","1","3","8","4","4","0","0","0","50","20","30","1","1","0","7","4","3","3","2","1","-2"
"409698","California State University-Monterey Bay","2016","Not on tenure/no tenure system, lecturers","75","33","42","0","0","0","2","1","1","4","1","3","8","4","4","0","0","0","50","20","30","1","1","0","7","4","3","3","2","1","-2"
"414823","Johnson & Wales University-North Miami","2016","Not on tenure track/No tenure system system total","54","35","19","0","0","0","3","1","2","7","4","3","4","2","2","0","0","0","37","27","10","3","1","2","0","0","0","0","0","0","-2"
"414823","Johnson & Wales University-North Miami","2016","Not on tenure/no tenure system, professors","12","6","6","0","0","0","1","0","1","2","1","1","1","0","1","0","0","0","8","5","3","0","0","0","0","0","0","0","0","0","-2"
"414823","Johnson & Wales University-North Miami","2016","Not on tenure/no tenure system, associate professors","17","10","7","0","0","0","1","1","0","3","2","1","1","0","1","0","0","0","10","7","3","2","0","2","0","0","0","0","0","0","-2"
"414823","Johnson & Wales University-North Miami","2016","Not on tenure/no tenure system, assistant professors","13","11","2","0","0","0","0","0","0","1","1","0","0","0","0","0","0","0","12","10","2","0","0","0","0","0","0","0","0","0","-2"
"414823","Johnson & Wales University-North Miami","2016","Not on tenure/no tenure system, instructors","12","8","4","0","0","0","1","0","1","1","0","1","2","2","0","0","0","0","7","5","2","1","1","0","0","0","0","0","0","0","-2"
"416801","The University of Texas MD Anderson Cancer Center","2016","On-Tenure track total","1","1","0","0","0","0","1","1","0","0","0","0","0","0","0","0","0","0","0","0","0","0","0","0","0","0","0","0","0","0","-2"
"416801","The University of Texas MD Anderson Cancer Center","2016","On-tenure track, associate professors","1","1","0","0","0","0","1","1","0","0","0","0","0","0","0","0","0","0","0","0","0","0","0","0","0","0","0","0","0","0","-2"
"416801","The University of Texas MD Anderson Cancer Center","2016","Not on tenure track/No tenure system system total","18","7","11","0","0","0","3","3","0","3","1","2","0","0","0","0","0","0","12","3","9","0","0","0","0","0","0","0","0","0","-2"
"416801","The University of Texas MD Anderson Cancer Center","2016","Not on tenure/no tenure system, lecturers","18","7","11","0","0","0","3","3","0","3","1","2","0","0","0","0","0","0","12","3","9","0","0","0","0","0","0","0","0","0","-2"
"430670","San Juan Bautista School of Medicine","2016","Tenured total","11","6","5","0","0","0","0","0","0","0","0","0","11","6","5","0","0","0","0","0","0","0","0","0","0","0","0","0","0","0","-2"
"430670","San Juan Bautista School of Medicine","2016","Tenured, associate professors","5","5","0","0","0","0","0","0","0","0","0","0","5","5","0","0","0","0","0","0","0","0","0","0","0","0","0","0","0","0","-2"
"430670","San Juan Bautista School of Medicine","2016","Tenured, assistant professors","5","1","4","0","0","0","0","0","0","0","0","0","5","1","4","0","0","0","0","0","0","0","0","0","0","0","0","0","0","0","-2"
"430670","San Juan Bautista School of Medicine","2016","Tenured, instructors","1","0","1","0","0","0","0","0","0","0","0","0","1","0","1","0","0","0","0","0","0","0","0","0","0","0","0","0","0","0","-2"
"430670","San Juan Bautista School of Medicine","2016","On-Tenure track total","10","3","7","0","0","0","0","0","0","0","0","0","10","3","7","0","0","0","0","0","0","0","0","0","0","0","0","0","0","0","-2"
"430670","San Juan Bautista School of Medicine","2016","On-tenure track, associate professors","1","0","1","0","0","0","0","0","0","0","0","0","1","0","1","0","0","0","0","0","0","0","0","0","0","0","0","0","0","0","-2"
"430670","San Juan Bautista School of Medicine","2016","On-tenure track, assistant professors","3","0","3","0","0","0","0","0","0","0","0","0","3","0","3","0","0","0","0","0","0","0","0","0","0","0","0","0","0","0","-2"
"430670","San Juan Bautista School of Medicine","2016","On-tenure track, instructors","6","3","3","0","0","0","0","0","0","0","0","0","6","3","3","0","0","0","0","0","0","0","0","0","0","0","0","0","0","0","-2"
"430670","San Juan Bautista School of Medicine","2016","Not on tenure track/No tenure system system total","20","16","4","0","0","0","0","0","0","0","0","0","20","16","4","0","0","0","0","0","0","0","0","0","0","0","0","0","0","0","-2"
"430670","San Juan Bautista School of Medicine","2016","Not on tenure/no tenure system, professors","1","1","0","0","0","0","0","0","0","0","0","0","1","1","0","0","0","0","0","0","0","0","0","0","0","0","0","0","0","0","-2"
"430670","San Juan Bautista School of Medicine","2016","Not on tenure/no tenure system, associate professors","2","2","0","0","0","0","0","0","0","0","0","0","2","2","0","0","0","0","0","0","0","0","0","0","0","0","0","0","0","0","-2"
"430670","San Juan Bautista School of Medicine","2016","Not on tenure/no tenure system, assistant professors","15","12","3","0","0","0","0","0","0","0","0","0","15","12","3","0","0","0","0","0","0","0","0","0","0","0","0","0","0","0","-2"
"430670","San Juan Bautista School of Medicine","2016","Not on tenure/no tenure system, instructors","2","1","1","0","0","0","0","0","0","0","0","0","2","1","1","0","0","0","0","0","0","0","0","0","0","0","0","0","0","0","-2"
"434539","City College-Miami","2016","Not on tenure track/No tenure system system total","5","2","3","0","0","0","0","0","0","0","0","0","1","1","0","0","0","0","1","1","0","0","0","0","3","0","3","0","0","0","-2"
"434539","City College-Miami","2016","Not on tenure/no tenure system, instructors","5","2","3","0","0","0","0","0","0","0","0","0","1","1","0","0","0","0","1","1","0","0","0","0","3","0","3","0","0","0","-2"
"434900","Dewey University-Carolina","2016","Not on tenure track/No tenure system system total","50","22","28","0","0","0","0","0","0","0","0","0","50","22","28","0","0","0","0","0","0","0","0","0","0","0","0","0","0","0","-2"
"434900","Dewey University-Carolina","2016","Not on tenure/no tenure system, professors","50","22","28","0","0","0","0","0","0","0","0","0","50","22","28","0","0","0","0","0","0","0","0","0","0","0","0","0","0","0","-2"
"439446","Atlantic Institute of Oriental Medicine","2016","Not on tenure track/No tenure system system total","5","4","1","0","0","0","2","2","0","1","1","0","0","0","0","0","0","0","2","1","1","0","0","0","0","0","0","0","0","0","-2"
"439446","Atlantic Institute of Oriental Medicine","2016","Not on tenure/no tenure system, instructors","5","4","1","0","0","0","2","2","0","1","1","0","0","0","0","0","0","0","2","1","1","0","0","0","0","0","0","0","0","0","-2"
"440651","Atenas College","2016","Tenured total","17","1","16","0","0","0","0","0","0","0","0","0","17","1","16","0","0","0","0","0","0","0","0","0","0","0","0","0","0","0","-2"
"440651","Atenas College","2016","Tenured, professors","17","1","16","0","0","0","0","0","0","0","0","0","17","1","16","0","0","0","0","0","0","0","0","0","0","0","0","0","0","0","-2"
"440651","Atenas College","2016","Not on tenure track/No tenure system system total","7","3","4","0","0","0","0","0","0","0","0","0","7","3","4","0","0","0","0","0","0","0","0","0","0","0","0","0","0","0","-2"
"440651","Atenas College","2016","Not on tenure/no tenure system, professors","7","3","4","0","0","0","0","0","0","0","0","0","7","3","4","0","0","0","0","0","0","0","0","0","0","0","0","0","0","0","-2"
"440794","Pillar College","2016","Tenured total","1","1","0","0","0","0","0","0","0","0","0","0","0","0","0","0","0","0","1","1","0","0","0","0","0","0","0","0","0","0","-2"
"440794","Pillar College","2016","Tenured, professors","1","1","0","0","0","0","0","0","0","0","0","0","0","0","0","0","0","0","1","1","0","0","0","0","0","0","0","0","0","0","-2"
"440794","Pillar College","2016","On-Tenure track total","1","1","0","0","0","0","1","1","0","0","0","0","0","0","0","0","0","0","0","0","0","0","0","0","0","0","0","0","0","0","-2"
"440794","Pillar College","2016","On-tenure track, assistant professors","1","1","0","0","0","0","1","1","0","0","0","0","0","0","0","0","0","0","0","0","0","0","0","0","0","0","0","0","0","0","-2"
"440794","Pillar College","2016","Not on tenure track/No tenure system system total","7","4","3","0","0","0","0","0","0","3","0","3","0","0","0","0","0","0","4","4","0","0","0","0","0","0","0","0","0","0","-2"
"440794","Pillar College","2016","Not on tenure/no tenure system, professors","2","1","1","0","0","0","0","0","0","1","0","1","0","0","0","0","0","0","1","1","0","0","0","0","0","0","0","0","0","0","-2"
"440794","Pillar College","2016","Not on tenure/no tenure system, associate professors","3","1","2","0","0","0","0","0","0","2","0","2","0","0","0","0","0","0","1","1","0","0","0","0","0","0","0","0","0","0","-2"
"440794","Pillar College","2016","Not on tenure/no tenure system, assistant professors","2","2","0","0","0","0","0","0","0","0","0","0","0","0","0","0","0","0","2","2","0","0","0","0","0","0","0","0","0","0","-2"
"441690","Universidad Pentecostal Mizpa","2016","Tenured total","3","3","0","0","0","0","0","0","0","0","0","0","3","3","0","0","0","0","0","0","0","0","0","0","0","0","0","0","0","0","-2"
"441690","Universidad Pentecostal Mizpa","2016","Tenured, professors","3","3","0","0","0","0","0","0","0","0","0","0","3","3","0","0","0","0","0","0","0","0","0","0","0","0","0","0","0","0","-2"
"441690","Universidad Pentecostal Mizpa","2016","Not on tenure track/No tenure system system total","13","9","4","0","0","0","0","0","0","0","0","0","13","9","4","0","0","0","0","0","0","0","0","0","0","0","0","0","0","0","-2"
"441690","Universidad Pentecostal Mizpa","2016","Not on tenure/no tenure system, professors","13","9","4","0","0","0","0","0","0","0","0","0","13","9","4","0","0","0","0","0","0","0","0","0","0","0","0","0","0","0","-2"
"441900","Nevada State College","2016","Tenured total","12","8","4","0","0","0","1","1","0","2","2","0","1","0","1","0","0","0","8","5","3","0","0","0","0","0","0","0","0","0","-2"
"441900","Nevada State College","2016","Tenured, professors","3","2","1","0","0","0","0","0","0","0","0","0","0","0","0","0","0","0","3","2","1","0","0","0","0","0","0","0","0","0","-2"
"441900","Nevada State College","2016","Tenured, associate professors","9","6","3","0","0","0","1","1","0","2","2","0","1","0","1","0","0","0","5","3","2","0","0","0","0","0","0","0","0","0","-2"
"441900","Nevada State College","2016","On-Tenure track total","36","12","24","0","0","0","1","0","1","1","0","1","3","1","2","0","0","0","28","11","17","3","0","3","0","0","0","0","0","0","-2"
"441900","Nevada State College","2016","On-tenure track, associate professors","2","1","1","0","0","0","0","0","0","0","0","0","0","0","0","0","0","0","2","1","1","0","0","0","0","0","0","0","0","0","-2"
"441900","Nevada State College","2016","On-tenure track, assistant professors","34","11","23","0","0","0","1","0","1","1","0","1","3","1","2","0","0","0","26","10","16","3","0","3","0","0","0","0","0","0","-2"
"441900","Nevada State College","2016","Not on tenure track/No tenure system system total","23","5","18","0","0","0","4","1","3","0","0","0","2","1","1","0","0","0","16","2","14","1","1","0","0","0","0","0","0","0","-2"
"441900","Nevada State College","2016","Not on tenure/no tenure system, lecturers","23","5","18","0","0","0","4","1","3","0","0","0","2","1","1","0","0","0","16","2","14","1","1","0","0","0","0","0","0","0","-2"
"441937","California State University-Channel Islands","2016","Tenured total","71","35","36","0","0","0","5","1","4","2","1","1","14","8","6","0","0","0","43","21","22","0","0","0","4","3","1","3","1","2","-2"
"441937","California State University-Channel Islands","2016","Tenured, professors","49","28","21","0","0","0","2","1","1","1","1","0","12","6","6","0","0","0","31","17","14","0","0","0","2","2","0","1","1","0","-2"
"441937","California State University-Channel Islands","2016","Tenured, associate professors","13","5","8","0","0","0","2","0","2","0","0","0","1","1","0","0","0","0","7","3","4","0","0","0","2","1","1","1","0","1","-2"
"441937","California State University-Channel Islands","2016","Tenured, assistant professors","9","2","7","0","0","0","1","0","1","1","0","1","1","1","0","0","0","0","5","1","4","0","0","0","0","0","0","1","0","1","-2"
"441937","California State University-Channel Islands","2016","On-Tenure track total","51","21","30","0","0","0","3","1","2","1","0","1","14","5","9","0","0","0","25","11","14","2","0","2","2","2","0","4","2","2","-2"
"441937","California State University-Channel Islands","2016","On-tenure track, associate professors","4","0","4","0","0","0","0","0","0","0","0","0","0","0","0","0","0","0","3","0","3","1","0","1","0","0","0","0","0","0","-2"
"441937","California State University-Channel Islands","2016","On-tenure track, assistant professors","47","21","26","0","0","0","3","1","2","1","0","1","14","5","9","0","0","0","22","11","11","1","0","1","2","2","0","4","2","2","-2"
"441937","California State University-Channel Islands","2016","Not on tenure track/No tenure system system total","78","39","39","0","0","0","6","4","2","1","0","1","9","6","3","0","0","0","55","25","30","3","3","0","3","1","2","1","0","1","-2"
"441937","California State University-Channel Islands","2016","Not on tenure/no tenure system, lecturers","78","39","39","0","0","0","6","4","2","1","0","1","9","6","3","0","0","0","55","25","30","3","3","0","3","1","2","1","0","1","-2"
"443562","Dewey University-Hato Rey","2016","Not on tenure track/No tenure system system total","269","118","151","0","0","0","0","0","0","0","0","0","269","118","151","0","0","0","0","0","0","0","0","0","0","0","0","0","0","0","-2"
"443562","Dewey University-Hato Rey","2016","Not on tenure/no tenure system, professors","269","118","151","0","0","0","0","0","0","0","0","0","269","118","151","0","0","0","0","0","0","0","0","0","0","0","0","0","0","0","-2"
"444398","Baptist University of the Americas","2016","Tenured total","2","1","1","0","0","0","0","0","0","0","0","0","2","1","1","0","0","0","0","0","0","0","0","0","0","0","0","0","0","0","-2"
"444398","Baptist University of the Americas","2016","Tenured, professors","2","1","1","0","0","0","0","0","0","0","0","0","2","1","1","0","0","0","0","0","0","0","0","0","0","0","0","0","0","0","-2"
"444398","Baptist University of the Americas","2016","On-Tenure track total","1","1","0","0","0","0","0","0","0","0","0","0","1","1","0","0","0","0","0","0","0","0","0","0","0","0","0","0","0","0","-2"
"444398","Baptist University of the Americas","2016","On-tenure track, assistant professors","1","1","0","0","0","0","0","0","0","0","0","0","1","1","0","0","0","0","0","0","0","0","0","0","0","0","0","0","0","0","-2"
"444398","Baptist University of the Americas","2016","Not on tenure track/No tenure system system total","6","2","4","0","0","0","0","0","0","0","0","0","4","0","4","0","0","0","2","2","0","0","0","0","0","0","0","0","0","0","-2"
"444398","Baptist University of the Americas","2016","Not on tenure/no tenure system, assistant professors","3","2","1","0","0","0","0","0","0","0","0","0","1","0","1","0","0","0","2","2","0","0","0","0","0","0","0","0","0","0","-2"
"444398","Baptist University of the Americas","2016","Not on tenure/no tenure system, instructors","3","0","3","0","0","0","0","0","0","0","0","0","3","0","3","0","0","0","0","0","0","0","0","0","0","0","0","0","0","0","-2"
"448752","CollegeAmerica-Colorado Springs","2016","Not on tenure track/No tenure system system total","6","4","2","0","0","0","0","0","0","1","1","0","0","0","0","0","0","0","5","3","2","0","0","0","0","0","0","0","0","0","-2"
"448752","CollegeAmerica-Colorado Springs","2016","Not on tenure/no tenure system, no academic rank","6","4","2","0","0","0","0","0","0","1","1","0","0","0","0","0","0","0","5","3","2","0","0","0","0","0","0","0","0","0","-2"
"448886","Arizona State University-Downtown Phoenix","2016","Tenured total","143","72","71","0","0","0","11","4","7","4","2","2","10","5","5","0","0","0","112","58","54","3","2","1","2","0","2","1","1","0","-2"
"448886","Arizona State University-Downtown Phoenix","2016","Tenured, professors","77","50","27","0","0","0","3","2","1","1","1","0","6","5","1","0","0","0","64","40","24","2","2","0","1","0","1","0","0","0","-2"
"448886","Arizona State University-Downtown Phoenix","2016","Tenured, associate professors","66","22","44","0","0","0","8","2","6","3","1","2","4","0","4","0","0","0","48","18","30","1","0","1","1","0","1","1","1","0","-2"
"448886","Arizona State University-Downtown Phoenix","2016","On-Tenure track total","63","27","36","0","0","0","12","6","6","0","0","0","8","2","6","0","0","0","34","17","17","3","0","3","3","1","2","3","1","2","-2"
"448886","Arizona State University-Downtown Phoenix","2016","On-tenure track, associate professors","7","2","5","0","0","0","1","1","0","0","0","0","0","0","0","0","0","0","4","1","3","0","0","0","2","0","2","0","0","0","-2"
"448886","Arizona State University-Downtown Phoenix","2016","On-tenure track, assistant professors","56","25","31","0","0","0","11","5","6","0","0","0","8","2","6","0","0","0","30","16","14","3","0","3","1","1","0","3","1","2","-2"
"448886","Arizona State University-Downtown Phoenix","2016","Not on tenure track/No tenure system system total","292","90","202","1","0","1","8","2","6","16","3","13","22","5","17","0","0","0","234","75","159","2","0","2","7","4","3","2","1","1","-2"
"448886","Arizona State University-Downtown Phoenix","2016","Not on tenure/no tenure system, professors","37","18","19","0","0","0","0","0","0","3","0","3","3","0","3","0","0","0","29","17","12","0","0","0","2","1","1","0","0","0","-2"
"448886","Arizona State University-Downtown Phoenix","2016","Not on tenure/no tenure system, associate professors","35","5","30","0","0","0","0","0","0","2","0","2","2","0","2","0","0","0","30","5","25","1","0","1","0","0","0","0","0","0","-2"
"448886","Arizona State University-Downtown Phoenix","2016","Not on tenure/no tenure system, assistant professors","42","7","35","0","0","0","3","1","2","1","0","1","4","0","4","0","0","0","33","5","28","0","0","0","0","0","0","1","1","0","-2"
"448886","Arizona State University-Downtown Phoenix","2016","Not on tenure/no tenure system, instructors","86","32","54","1","0","1","2","1","1","8","3","5","9","3","6","0","0","0","63","23","40","0","0","0","3","2","1","0","0","0","-2"
"448886","Arizona State University-Downtown Phoenix","2016","Not on tenure/no tenure system, lecturers","91","28","63","0","0","0","3","0","3","2","0","2","4","2","2","0","0","0","78","25","53","1","0","1","2","1","1","1","0","1","-2"
"448886","Arizona State University-Downtown Phoenix","2016","Not on tenure/no tenure system, no academic rank","1","0","1","0","0","0","0","0","0","0","0","0","0","0","0","0","0","0","1","0","1","0","0","0","0","0","0","0","0","0","-2"
"449870","University of the West","2016","Tenured total","4","3","1","0","0","0","4","3","1","0","0","0","0","0","0","0","0","0","0","0","0","0","0","0","0","0","0","0","0","0","-2"
"449870","University of the West","2016","Tenured, professors","2","2","0","0","0","0","2","2","0","0","0","0","0","0","0","0","0","0","0","0","0","0","0","0","0","0","0","0","0","0","-2"
"449870","University of the West","2016","Tenured, associate professors","2","1","1","0","0","0","2","1","1","0","0","0","0","0","0","0","0","0","0","0","0","0","0","0","0","0","0","0","0","0","-2"
"449870","University of the West","2016","On-Tenure track total","9","5","4","0","0","0","3","3","0","2","0","2","0","0","0","0","0","0","3","1","2","1","1","0","0","0","0","0","0","0","-2"
"449870","University of the West","2016","On-tenure track, associate professors","1","1","0","0","0","0","0","0","0","0","0","0","0","0","0","0","0","0","1","1","0","0","0","0","0","0","0","0","0","0","-2"
"449870","University of the West","2016","On-tenure track, assistant professors","8","4","4","0","0","0","3","3","0","2","0","2","0","0","0","0","0","0","2","0","2","1","1","0","0","0","0","0","0","0","-2"
"449870","University of the West","2016","Not on tenure track/No tenure system system total","2","2","0","0","0","0","0","0","0","0","0","0","1","1","0","0","0","0","1","1","0","0","0","0","0","0","0","0","0","0","-2"
"449870","University of the West","2016","Not on tenure/no tenure system, assistant professors","1","1","0","0","0","0","0","0","0","0","0","0","0","0","0","0","0","0","1","1","0","0","0","0","0","0","0","0","0","0","-2"
"449870","University of the West","2016","Not on tenure/no tenure system, instructors","1","1","0","0","0","0","0","0","0","0","0","0","1","1","0","0","0","0","0","0","0","0","0","0","0","0","0","0","0","0","-2"
"455770","Providence Christian College","2016","Not on tenure track/No tenure system system total","5","4","1","0","0","0","0","0","0","0","0","0","0","0","0","0","0","0","5","4","1","0","0","0","0","0","0","0","0","0","-2"
"455770","Providence Christian College","2016","Not on tenure/no tenure system, professors","3","3","0","0","0","0","0","0","0","0","0","0","0","0","0","0","0","0","3","3","0","0","0","0","0","0","0","0","0","0","-2"
"455770","Providence Christian College","2016","Not on tenure/no tenure system, assistant professors","2","1","1","0","0","0","0","0","0","0","0","0","0","0","0","0","0","0","2","1","1","0","0","0","0","0","0","0","0","0","-2"
"456490","Polytechnic University of Puerto Rico-Orlando","2016","Not on tenure track/No tenure system system total","5","3","2","0","0","0","0","0","0","0","0","0","5","3","2","0","0","0","0","0","0","0","0","0","0","0","0","0","0","0","-2"
"456490","Polytechnic University of Puerto Rico-Orlando","2016","Not on tenure/no tenure system, professors","2","0","2","0","0","0","0","0","0","0","0","0","2","0","2","0","0","0","0","0","0","0","0","0","0","0","0","0","0","0","-2"
"456490","Polytechnic University of Puerto Rico-Orlando","2016","Not on tenure/no tenure system, associate professors","3","3","0","0","0","0","0","0","0","0","0","0","3","3","0","0","0","0","0","0","0","0","0","0","0","0","0","0","0","0","-2"
"459949","Texas A&M University-San Antonio","2016","Tenured total","41","19","22","0","0","0","3","3","0","1","0","1","8","3","5","0","0","0","29","13","16","0","0","0","0","0","0","0","0","0","-2"
"459949","Texas A&M University-San Antonio","2016","Tenured, professors","13","6","7","0","0","0","2","2","0","0","0","0","4","1","3","0","0","0","7","3","4","0","0","0","0","0","0","0","0","0","-2"
"459949","Texas A&M University-San Antonio","2016","Tenured, associate professors","28","13","15","0","0","0","1","1","0","1","0","1","4","2","2","0","0","0","22","10","12","0","0","0","0","0","0","0","0","0","-2"
"459949","Texas A&M University-San Antonio","2016","On-Tenure track total","53","20","33","0","0","0","13","5","8","0","0","0","11","3","8","0","0","0","29","12","17","0","0","0","0","0","0","0","0","0","-2"
"459949","Texas A&M University-San Antonio","2016","On-tenure track, associate professors","3","1","2","0","0","0","1","1","0","0","0","0","0","0","0","0","0","0","2","0","2","0","0","0","0","0","0","0","0","0","-2"
"459949","Texas A&M University-San Antonio","2016","On-tenure track, assistant professors","50","19","31","0","0","0","12","4","8","0","0","0","11","3","8","0","0","0","27","12","15","0","0","0","0","0","0","0","0","0","-2"
"459949","Texas A&M University-San Antonio","2016","Not on tenure track/No tenure system system total","55","32","23","0","0","0","3","2","1","7","4","3","12","10","2","0","0","0","33","16","17","0","0","0","0","0","0","0","0","0","-2"
"459949","Texas A&M University-San Antonio","2016","Not on tenure/no tenure system, associate professors","5","4","1","0","0","0","0","0","0","1","1","0","1","1","0","0","0","0","3","2","1","0","0","0","0","0","0","0","0","0","-2"
"459949","Texas A&M University-San Antonio","2016","Not on tenure/no tenure system, assistant professors","16","14","2","0","0","0","1","0","1","2","2","0","5","5","0","0","0","0","8","7","1","0","0","0","0","0","0","0","0","0","-2"
"459949","Texas A&M University-San Antonio","2016","Not on tenure/no tenure system, lecturers","34","14","20","0","0","0","2","2","0","4","1","3","6","4","2","0","0","0","22","7","15","0","0","0","0","0","0","0","0","0","-2"
"462354","John Paul the Great Catholic University","2016","Not on tenure track/No tenure system system total","8","8","0","0","0","0","0","0","0","0","0","0","0","0","0","0","0","0","8","8","0","0","0","0","0","0","0","0","0","0","-2"
"462354","John Paul the Great Catholic University","2016","Not on tenure/no tenure system, professors","8","8","0","0","0","0","0","0","0","0","0","0","0","0","0","0","0","0","8","8","0","0","0","0","0","0","0","0","0","0","-2"
"474863","Los Angeles Pacific University","2016","Not on tenure track/No tenure system system total","11","9","2","0","0","0","0","0","0","1","1","0","0","0","0","0","0","0","10","8","2","0","0","0","0","0","0","0","0","0","-2"
"474863","Los Angeles Pacific University","2016","Not on tenure/no tenure system, assistant professors","3","3","0","0","0","0","0","0","0","0","0","0","0","0","0","0","0","0","3","3","0","0","0","0","0","0","0","0","0","0","-2"
"474863","Los Angeles Pacific University","2016","Not on tenure/no tenure system, lecturers","8","6","2","0","0","0","0","0","0","1","1","0","0","0","0","0","0","0","7","5","2","0","0","0","0","0","0","0","0","0","-2"
"474906","Stevens-Henager College","2016","Not on tenure track/No tenure system system total","3","1","2","0","0","0","0","0","0","0","0","0","0","0","0","0","0","0","3","1","2","0","0","0","0","0","0","0","0","0","-2"
"474906","Stevens-Henager College","2016","Not on tenure/no tenure system, no academic rank","3","1","2","0","0","0","0","0","0","0","0","0","0","0","0","0","0","0","3","1","2","0","0","0","0","0","0","0","0","0","-2"
"475273","Springfield College-Regional, Online, and Continuing Education","2016","Tenured total","5","3","2","0","0","0","0","0","0","2","1","1","1","1","0","0","0","0","2","1","1","0","0","0","0","0","0","0","0","0","-2"
"475273","Springfield College-Regional, Online, and Continuing Education","2016","Tenured, professors","5","3","2","0","0","0","0","0","0","2","1","1","1","1","0","0","0","0","2","1","1","0","0","0","0","0","0","0","0","0","-2"
"475273","Springfield College-Regional, Online, and Continuing Education","2016","Not on tenure track/No tenure system system total","12","6","6","0","0","0","1","1","0","2","1","1","2","0","2","0","0","0","5","4","1","1","0","1","1","0","1","0","0","0","-2"
"475273","Springfield College-Regional, Online, and Continuing Education","2016","Not on tenure/no tenure system, professors","3","2","1","0","0","0","0","0","0","0","0","0","0","0","0","0","0","0","2","2","0","0","0","0","1","0","1","0","0","0","-2"
"475273","Springfield College-Regional, Online, and Continuing Education","2016","Not on tenure/no tenure system, associate professors","3","1","2","0","0","0","0","0","0","1","1","0","2","0","2","0","0","0","0","0","0","0","0","0","0","0","0","0","0","0","-2"
"475273","Springfield College-Regional, Online, and Continuing Education","2016","Not on tenure/no tenure system, assistant professors","6","3","3","0","0","0","1","1","0","1","0","1","0","0","0","0","0","0","3","2","1","1","0","1","0","0","0","0","0","0","-2"
"478634","California College San Diego","2016","Not on tenure track/No tenure system system total","8","6","2","0","0","0","1","0","1","1","1","0","1","1","0","0","0","0","5","4","1","0","0","0","0","0","0","0","0","0","-2"
"478634","California College San Diego","2016","Not on tenure/no tenure system, no academic rank","8","6","2","0","0","0","1","0","1","1","1","0","1","1","0","0","0","0","5","4","1","0","0","0","0","0","0","0","0","0","-2"
"483036","Texas A&M University-Central Texas","2016","Tenured total","11","6","5","0","0","0","0","0","0","0","0","0","1","0","1","0","0","0","10","6","4","0","0","0","0","0","0","0","0","0","-2"
"483036","Texas A&M University-Central Texas","2016","Tenured, professors","3","1","2","0","0","0","0","0","0","0","0","0","0","0","0","0","0","0","3","1","2","0","0","0","0","0","0","0","0","0","-2"
"483036","Texas A&M University-Central Texas","2016","Tenured, associate professors","5","3","2","0","0","0","0","0","0","0","0","0","0","0","0","0","0","0","5","3","2","0","0","0","0","0","0","0","0","0","-2"
"483036","Texas A&M University-Central Texas","2016","Tenured, assistant professors","3","2","1","0","0","0","0","0","0","0","0","0","1","0","1","0","0","0","2","2","0","0","0","0","0","0","0","0","0","0","-2"
"483036","Texas A&M University-Central Texas","2016","On-Tenure track total","20","13","7","0","0","0","1","0","1","0","0","0","0","0","0","0","0","0","19","13","6","0","0","0","0","0","0","0","0","0","-2"
"483036","Texas A&M University-Central Texas","2016","On-tenure track, associate professors","15","8","7","0","0","0","1","0","1","0","0","0","0","0","0","0","0","0","14","8","6","0","0","0","0","0","0","0","0","0","-2"
"483036","Texas A&M University-Central Texas","2016","On-tenure track, assistant professors","1","1","0","0","0","0","0","0","0","0","0","0","0","0","0","0","0","0","1","1","0","0","0","0","0","0","0","0","0","0","-2"
"483036","Texas A&M University-Central Texas","2016","On-tenure track, lecturers","4","4","0","0","0","0","0","0","0","0","0","0","0","0","0","0","0","0","4","4","0","0","0","0","0","0","0","0","0","0","-2"
"483036","Texas A&M University-Central Texas","2016","Not on tenure track/No tenure system system total","67","28","39","0","0","0","3","1","2","6","2","4","7","1","6","1","1","0","44","20","24","0","0","0","1","0","1","5","3","2","-2"
"483036","Texas A&M University-Central Texas","2016","Not on tenure/no tenure system, professors","1","1","0","0","0","0","0","0","0","0","0","0","0","0","0","0","0","0","1","1","0","0","0","0","0","0","0","0","0","0","-2"
"483036","Texas A&M University-Central Texas","2016","Not on tenure/no tenure system, associate professors","4","2","2","0","0","0","0","0","0","0","0","0","0","0","0","0","0","0","4","2","2","0","0","0","0","0","0","0","0","0","-2"
"483036","Texas A&M University-Central Texas","2016","Not on tenure/no tenure system, assistant professors","45","20","25","0","0","0","3","1","2","3","1","2","4","1","3","1","1","0","28","13","15","0","0","0","1","0","1","5","3","2","-2"
"483036","Texas A&M University-Central Texas","2016","Not on tenure/no tenure system, lecturers","17","5","12","0","0","0","0","0","0","3","1","2","3","0","3","0","0","0","11","4","7","0","0","0","0","0","0","0","0","0","-2"
"484905","University of North Texas at Dallas","2016","Tenured total","14","6","8","0","0","0","4","3","1","1","0","1","3","2","1","0","0","0","6","1","5","0","0","0","0","0","0","0","0","0","-2"
"484905","University of North Texas at Dallas","2016","Tenured, professors","8","4","4","0","0","0","2","2","0","1","0","1","2","1","1","0","0","0","3","1","2","0","0","0","0","0","0","0","0","0","-2"
"484905","University of North Texas at Dallas","2016","Tenured, associate professors","6","2","4","0","0","0","2","1","1","0","0","0","1","1","0","0","0","0","3","0","3","0","0","0","0","0","0","0","0","0","-2"
"484905","University of North Texas at Dallas","2016","On-Tenure track total","30","19","11","0","0","0","4","2","2","5","4","1","3","1","2","0","0","0","14","10","4","0","0","0","2","1","1","2","1","1","-2"
"484905","University of North Texas at Dallas","2016","On-tenure track, associate professors","2","2","0","0","0","0","0","0","0","0","0","0","1","1","0","0","0","0","1","1","0","0","0","0","0","0","0","0","0","0","-2"
"484905","University of North Texas at Dallas","2016","On-tenure track, assistant professors","28","17","11","0","0","0","4","2","2","5","4","1","2","0","2","0","0","0","13","9","4","0","0","0","2","1","1","2","1","1","-2"
"484905","University of North Texas at Dallas","2016","Not on tenure track/No tenure system system total","42","19","23","1","1","0","3","2","1","5","0","5","2","0","2","0","0","0","28","16","12","2","0","2","1","0","1","0","0","0","-2"
"484905","University of North Texas at Dallas","2016","Not on tenure/no tenure system, professors","2","2","0","0","0","0","0","0","0","0","0","0","0","0","0","0","0","0","2","2","0","0","0","0","0","0","0","0","0","0","-2"
"484905","University of North Texas at Dallas","2016","Not on tenure/no tenure system, instructors","17","5","12","1","1","0","0","0","0","4","0","4","1","0","1","0","0","0","9","4","5","2","0","2","0","0","0","0","0","0","-2"
"484905","University of North Texas at Dallas","2016","Not on tenure/no tenure system, lecturers","22","12","10","0","0","0","3","2","1","1","0","1","1","0","1","0","0","0","16","10","6","0","0","0","1","0","1","0","0","0","-2"
"484905","University of North Texas at Dallas","2016","Not on tenure/no tenure system, no academic rank","1","0","1","0","0","0","0","0","0","0","0","0","0","0","0","0","0","0","1","0","1","0","0","0","0","0","0","0","0","0","-2"
"485263","California College San Diego","2016","Not on tenure track/No tenure system system total","13","8","5","0","0","0","6","5","1","0","0","0","3","2","1","0","0","0","4","1","3","0","0","0","0","0","0","0","0","0","-2"
"485263","California College San Diego","2016","Not on tenure/no tenure system, no academic rank","13","8","5","0","0","0","6","5","1","0","0","0","3","2","1","0","0","0","4","1","3","0","0","0","0","0","0","0","0","0","-2"
"487296","University of Arizona-Sierra Vista","2016","Tenured total","6","3","3","0","0","0","1","0","1","0","0","0","1","1","0","0","0","0","4","2","2","0","0","0","0","0","0","0","0","0","-2"
"487296","University of Arizona-Sierra Vista","2016","Tenured, professors","1","0","1","0","0","0","1","0","1","0","0","0","0","0","0","0","0","0","0","0","0","0","0","0","0","0","0","0","0","0","-2"
"487296","University of Arizona-Sierra Vista","2016","Tenured, associate professors","5","3","2","0","0","0","0","0","0","0","0","0","1","1","0","0","0","0","4","2","2","0","0","0","0","0","0","0","0","0","-2"
"487296","University of Arizona-Sierra Vista","2016","On-Tenure track total","3","1","2","1","0","1","0","0","0","0","0","0","1","1","0","0","0","0","1","0","1","0","0","0","0","0","0","0","0","0","-2"
"487296","University of Arizona-Sierra Vista","2016","On-tenure track, assistant professors","3","1","2","1","0","1","0","0","0","0","0","0","1","1","0","0","0","0","1","0","1","0","0","0","0","0","0","0","0","0","-2"
"487296","University of Arizona-Sierra Vista","2016","Not on tenure track/No tenure system system total","16","9","7","1","0","1","0","0","0","0","0","0","2","1","1","0","0","0","12","7","5","0","0","0","1","1","0","0","0","0","-2"
"487296","University of Arizona-Sierra Vista","2016","Not on tenure/no tenure system, professors","2","2","0","0","0","0","0","0","0","0","0","0","0","0","0","0","0","0","2","2","0","0","0","0","0","0","0","0","0","0","-2"
"487296","University of Arizona-Sierra Vista","2016","Not on tenure/no tenure system, associate professors","1","1","0","0","0","0","0","0","0","0","0","0","0","0","0","0","0","0","1","1","0","0","0","0","0","0","0","0","0","0","-2"
"487296","University of Arizona-Sierra Vista","2016","Not on tenure/no tenure system, assistant professors","8","3","5","1","0","1","0","0","0","0","0","0","2","1","1","0","0","0","4","1","3","0","0","0","1","1","0","0","0","0","-2"
"487296","University of Arizona-Sierra Vista","2016","Not on tenure/no tenure system, lecturers","5","3","2","0","0","0","0","0","0","0","0","0","0","0","0","0","0","0","5","3","2","0","0","0","0","0","0","0","0","0","-2"
