"unitid","institution name","year","S2018_IS.Instructional staff category","S2018_IS_RV.Grand total","S2018_IS_RV.Grand total men","S2018_IS_RV.Grand total women","S2018_IS_RV.American Indian or Alaska Native total","S2018_IS_RV.American Indian or Alaska Native men","S2018_IS_RV.American Indian or Alaska Native women","S2018_IS_RV.Asian total","S2018_IS_RV.Asian men","S2018_IS_RV.Asian women","S2018_IS_RV.Black or African American total","S2018_IS_RV.Black or African American men","S2018_IS_RV.Black or African American women","S2018_IS_RV.Hispanic or Latino total","S2018_IS_RV.Hispanic or Latino men","S2018_IS_RV.Hispanic or Latino women","S2018_IS_RV.Native Hawaiian or Other Pacific Islander total","S2018_IS_RV.Native Hawaiian or Other Pacific Islander men","S2018_IS_RV.Native Hawaiian or Other Pacific Islander women","S2018_IS_RV.White total","S2018_IS_RV.White men","S2018_IS_RV.White women","S2018_IS_RV.Two or more races total","S2018_IS_RV.Two or more races men","S2018_IS_RV.Two or more races women","S2018_IS_RV.Race/ethnicity unknown total","S2018_IS_RV.Race/ethnicity unknown men","S2018_IS_RV.Race/ethnicity unknown women","S2018_IS_RV.Nonresident alien total","S2018_IS_RV.Nonresident alien men","S2018_IS_RV.Nonresident alien women","IDX_HR"
"104188","Southwest University of Visual Arts-Tucson","2018","Not on tenure track/No tenure system system total","8","5","3","0","0","0","0","0","0","0","0","0","1","1","0","0","0","0","7","4","3","0","0","0","0","0","0","0","0","0","-2"
"104188","Southwest University of Visual Arts-Tucson","2018","Not on tenure/no tenure system, professors","8","5","3","0","0","0","0","0","0","0","0","0","1","1","0","0","0","0","7","4","3","0","0","0","0","0","0","0","0","0","-2"
"105367","Ottawa University-Phoenix","2018","Tenured total","2","0","2","0","0","0","1","0","1","0","0","0","0","0","0","0","0","0","1","0","1","0","0","0","0","0","0","0","0","0","-2"
"105367","Ottawa University-Phoenix","2018","Tenured, professors","2","0","2","0","0","0","1","0","1","0","0","0","0","0","0","0","0","0","1","0","1","0","0","0","0","0","0","0","0","0","-2"
"105367","Ottawa University-Phoenix","2018","Not on tenure track/No tenure system system total","2","0","2","0","0","0","0","0","0","0","0","0","0","0","0","0","0","0","2","0","2","0","0","0","0","0","0","0","0","0","-2"
"105367","Ottawa University-Phoenix","2018","Not on tenure/no tenure system, associate professors","1","0","1","0","0","0","0","0","0","0","0","0","0","0","0","0","0","0","1","0","1","0","0","0","0","0","0","0","0","0","-2"
"105367","Ottawa University-Phoenix","2018","Not on tenure/no tenure system, assistant professors","1","0","1","0","0","0","0","0","0","0","0","0","0","0","0","0","0","0","1","0","1","0","0","0","0","0","0","0","0","0","-2"
"109350","Antelope Valley College","2018","Not on tenure track/No tenure system system total","161","91","70","1","1","0","11","7","4","12","5","7","14","9","5","0","0","0","112","63","49","9","5","4","2","1","1","0","0","0","-2"
"109350","Antelope Valley College","2018","Not on tenure/no tenure system, professors","57","26","31","1","1","0","2","0","2","4","0","4","5","3","2","0","0","0","41","20","21","4","2","2","0","0","0","0","0","0","-2"
"109350","Antelope Valley College","2018","Not on tenure/no tenure system, associate professors","13","8","5","0","0","0","1","0","1","1","0","1","2","2","0","0","0","0","9","6","3","0","0","0","0","0","0","0","0","0","-2"
"109350","Antelope Valley College","2018","Not on tenure/no tenure system, assistant professors","6","3","3","0","0","0","0","0","0","0","0","0","0","0","0","0","0","0","6","3","3","0","0","0","0","0","0","0","0","0","-2"
"109350","Antelope Valley College","2018","Not on tenure/no tenure system, instructors","1","0","1","0","0","0","0","0","0","0","0","0","0","0","0","0","0","0","1","0","1","0","0","0","0","0","0","0","0","0","-2"
"109350","Antelope Valley College","2018","Not on tenure/no tenure system, no academic rank","84","54","30","0","0","0","8","7","1","7","5","2","7","4","3","0","0","0","55","34","21","5","3","2","2","1","1","0","0","0","-2"
"109785","Azusa Pacific University","2018","Not on tenure track/No tenure system system total","498","224","274","4","3","1","64","25","39","33","11","22","32","16","16","3","2","1","327","146","181","3","2","1","32","19","13","0","0","0","-2"
"109785","Azusa Pacific University","2018","Not on tenure/no tenure system, professors","141","87","54","1","1","0","17","11","6","10","6","4","5","2","3","0","0","0","97","59","38","0","0","0","11","8","3","0","0","0","-2"
"109785","Azusa Pacific University","2018","Not on tenure/no tenure system, associate professors","118","59","59","1","0","1","17","7","10","9","3","6","8","4","4","1","0","1","74","41","33","0","0","0","8","4","4","0","0","0","-2"
"109785","Azusa Pacific University","2018","Not on tenure/no tenure system, assistant professors","205","68","137","2","2","0","26","7","19","12","2","10","15","7","8","2","2","0","134","40","94","3","2","1","11","6","5","0","0","0","-2"
"109785","Azusa Pacific University","2018","Not on tenure/no tenure system, instructors","24","4","20","0","0","0","4","0","4","1","0","1","4","3","1","0","0","0","14","1","13","0","0","0","1","0","1","0","0","0","-2"
"109785","Azusa Pacific University","2018","Not on tenure/no tenure system, lecturers","1","0","1","0","0","0","0","0","0","0","0","0","0","0","0","0","0","0","1","0","1","0","0","0","0","0","0","0","0","0","-2"
"109785","Azusa Pacific University","2018","Not on tenure/no tenure system, no academic rank","9","6","3","0","0","0","0","0","0","1","0","1","0","0","0","0","0","0","7","5","2","0","0","0","1","1","0","0","0","0","-2"
"109819","Bakersfield College","2018","Tenured total","188","101","87","0","0","0","9","4","5","11","7","4","19","10","9","3","2","1","134","73","61","0","0","0","12","5","7","0","0","0","-2"
"109819","Bakersfield College","2018","Tenured, instructors","188","101","87","0","0","0","9","4","5","11","7","4","19","10","9","3","2","1","134","73","61","0","0","0","12","5","7","0","0","0","-2"
"109819","Bakersfield College","2018","On-Tenure track total","132","63","69","0","0","0","6","3","3","5","3","2","37","12","25","1","1","0","83","44","39","0","0","0","0","0","0","0","0","0","-2"
"109819","Bakersfield College","2018","On-tenure track, instructors","132","63","69","0","0","0","6","3","3","5","3","2","37","12","25","1","1","0","83","44","39","0","0","0","0","0","0","0","0","0","-2"
"109819","Bakersfield College","2018","Not on tenure track/No tenure system system total","42","20","22","0","0","0","3","0","3","0","0","0","10","7","3","0","0","0","27","12","15","0","0","0","2","1","1","0","0","0","-2"
"109819","Bakersfield College","2018","Not on tenure/no tenure system, instructors","42","20","22","0","0","0","3","0","3","0","0","0","10","7","3","0","0","0","27","12","15","0","0","0","2","1","1","0","0","0","-2"
"110361","California Baptist University","2018","Tenured total","114","69","45","0","0","0","19","14","5","1","0","1","4","1","3","0","0","0","84","52","32","6","2","4","0","0","0","0","0","0","-2"
"110361","California Baptist University","2018","Tenured, professors","85","54","31","0","0","0","14","12","2","1","0","1","3","0","3","0","0","0","61","40","21","6","2","4","0","0","0","0","0","0","-2"
"110361","California Baptist University","2018","Tenured, associate professors","29","15","14","0","0","0","5","2","3","0","0","0","1","1","0","0","0","0","23","12","11","0","0","0","0","0","0","0","0","0","-2"
"110361","California Baptist University","2018","On-Tenure track total","204","104","100","2","0","2","31","16","15","24","11","13","18","6","12","1","0","1","117","68","49","4","2","2","7","1","6","0","0","0","-2"
"110361","California Baptist University","2018","On-tenure track, professors","15","12","3","0","0","0","2","2","0","1","1","0","1","1","0","0","0","0","11","8","3","0","0","0","0","0","0","0","0","0","-2"
"110361","California Baptist University","2018","On-tenure track, associate professors","64","37","27","1","0","1","13","8","5","5","3","2","6","3","3","0","0","0","39","23","16","0","0","0","0","0","0","0","0","0","-2"
"110361","California Baptist University","2018","On-tenure track, assistant professors","125","55","70","1","0","1","16","6","10","18","7","11","11","2","9","1","0","1","67","37","30","4","2","2","7","1","6","0","0","0","-2"
"110361","California Baptist University","2018","Not on tenure track/No tenure system system total","22","10","12","0","0","0","0","0","0","1","0","1","1","0","1","0","0","0","20","10","10","0","0","0","0","0","0","0","0","0","-2"
"110361","California Baptist University","2018","Not on tenure/no tenure system, instructors","10","3","7","0","0","0","0","0","0","1","0","1","0","0","0","0","0","0","9","3","6","0","0","0","0","0","0","0","0","0","-2"
"110361","California Baptist University","2018","Not on tenure/no tenure system, lecturers","12","7","5","0","0","0","0","0","0","0","0","0","1","0","1","0","0","0","11","7","4","0","0","0","0","0","0","0","0","0","-2"
"110413","California Lutheran University","2018","Tenured total","104","56","48","0","0","0","9","5","4","4","2","2","11","4","7","0","0","0","78","44","34","1","1","0","1","0","1","0","0","0","-2"
"110413","California Lutheran University","2018","Tenured, professors","52","30","22","0","0","0","5","2","3","3","2","1","2","2","0","0","0","0","41","24","17","0","0","0","1","0","1","0","0","0","-2"
"110413","California Lutheran University","2018","Tenured, associate professors","46","21","25","0","0","0","3","2","1","1","0","1","7","0","7","0","0","0","34","18","16","1","1","0","0","0","0","0","0","0","-2"
"110413","California Lutheran University","2018","Tenured, assistant professors","6","5","1","0","0","0","1","1","0","0","0","0","2","2","0","0","0","0","3","2","1","0","0","0","0","0","0","0","0","0","-2"
"110413","California Lutheran University","2018","On-Tenure track total","43","18","25","0","0","0","7","5","2","5","2","3","8","3","5","0","0","0","21","8","13","1","0","1","1","0","1","0","0","0","-2"
"110413","California Lutheran University","2018","On-tenure track, professors","2","0","2","0","0","0","0","0","0","0","0","0","0","0","0","0","0","0","2","0","2","0","0","0","0","0","0","0","0","0","-2"
"110413","California Lutheran University","2018","On-tenure track, associate professors","1","0","1","0","0","0","0","0","0","0","0","0","0","0","0","0","0","0","1","0","1","0","0","0","0","0","0","0","0","0","-2"
"110413","California Lutheran University","2018","On-tenure track, assistant professors","38","17","21","0","0","0","6","5","1","4","1","3","8","3","5","0","0","0","18","8","10","1","0","1","1","0","1","0","0","0","-2"
"110413","California Lutheran University","2018","On-tenure track, instructors","2","1","1","0","0","0","1","0","1","1","1","0","0","0","0","0","0","0","0","0","0","0","0","0","0","0","0","0","0","0","-2"
"110413","California Lutheran University","2018","Not on tenure track/No tenure system system total","48","22","26","0","0","0","2","1","1","2","1","1","2","1","1","0","0","0","40","18","22","1","0","1","1","1","0","0","0","0","-2"
"110413","California Lutheran University","2018","Not on tenure/no tenure system, professors","5","3","2","0","0","0","0","0","0","0","0","0","0","0","0","0","0","0","5","3","2","0","0","0","0","0","0","0","0","0","-2"
"110413","California Lutheran University","2018","Not on tenure/no tenure system, assistant professors","9","3","6","0","0","0","0","0","0","0","0","0","1","0","1","0","0","0","8","3","5","0","0","0","0","0","0","0","0","0","-2"
"110413","California Lutheran University","2018","Not on tenure/no tenure system, instructors","1","1","0","0","0","0","0","0","0","0","0","0","0","0","0","0","0","0","1","1","0","0","0","0","0","0","0","0","0","0","-2"
"110413","California Lutheran University","2018","Not on tenure/no tenure system, lecturers","33","15","18","0","0","0","2","1","1","2","1","1","1","1","0","0","0","0","26","11","15","1","0","1","1","1","0","0","0","0","-2"
"110486","California State University-Bakersfield","2018","Tenured total","119","75","44","0","0","0","18","13","5","5","3","2","20","14","6","1","1","0","65","38","27","2","0","2","5","4","1","3","2","1","-2"
"110486","California State University-Bakersfield","2018","Tenured, professors","83","49","34","0","0","0","16","13","3","3","2","1","10","6","4","1","1","0","48","25","23","2","0","2","2","2","0","1","0","1","-2"
"110486","California State University-Bakersfield","2018","Tenured, associate professors","36","26","10","0","0","0","2","0","2","2","1","1","10","8","2","0","0","0","17","13","4","0","0","0","3","2","1","2","2","0","-2"
"110486","California State University-Bakersfield","2018","On-Tenure track total","101","56","45","1","1","0","20","13","7","4","1","3","12","5","7","0","0","0","46","25","21","0","0","0","1","1","0","17","10","7","-2"
"110486","California State University-Bakersfield","2018","On-tenure track, associate professors","3","0","3","0","0","0","1","0","1","0","0","0","1","0","1","0","0","0","1","0","1","0","0","0","0","0","0","0","0","0","-2"
"110486","California State University-Bakersfield","2018","On-tenure track, assistant professors","98","56","42","1","1","0","19","13","6","4","1","3","11","5","6","0","0","0","45","25","20","0","0","0","1","1","0","17","10","7","-2"
"110486","California State University-Bakersfield","2018","Not on tenure track/No tenure system system total","90","36","54","0","0","0","6","2","4","2","1","1","13","5","8","1","0","1","62","24","38","2","2","0","1","0","1","3","2","1","-2"
"110486","California State University-Bakersfield","2018","Not on tenure/no tenure system, lecturers","90","36","54","0","0","0","6","2","4","2","1","1","13","5","8","1","0","1","62","24","38","2","2","0","1","0","1","3","2","1","-2"
"110495","California State University-Stanislaus","2018","Tenured total","171","100","71","1","0","1","31","14","17","8","6","2","16","10","6","0","0","0","108","66","42","1","1","0","6","3","3","0","0","0","-2"
"110495","California State University-Stanislaus","2018","Tenured, professors","129","76","53","1","0","1","18","5","13","3","3","0","13","9","4","0","0","0","89","56","33","0","0","0","5","3","2","0","0","0","-2"
"110495","California State University-Stanislaus","2018","Tenured, associate professors","42","24","18","0","0","0","13","9","4","5","3","2","3","1","2","0","0","0","19","10","9","1","1","0","1","0","1","0","0","0","-2"
"110495","California State University-Stanislaus","2018","On-Tenure track total","90","43","47","1","0","1","10","7","3","5","1","4","12","4","8","0","0","0","48","23","25","0","0","0","6","2","4","8","6","2","-2"
"110495","California State University-Stanislaus","2018","On-tenure track, associate professors","3","0","3","0","0","0","0","0","0","0","0","0","0","0","0","0","0","0","3","0","3","0","0","0","0","0","0","0","0","0","-2"
"110495","California State University-Stanislaus","2018","On-tenure track, assistant professors","87","43","44","1","0","1","10","7","3","5","1","4","12","4","8","0","0","0","45","23","22","0","0","0","6","2","4","8","6","2","-2"
"110495","California State University-Stanislaus","2018","Not on tenure track/No tenure system system total","79","40","39","0","0","0","6","2","4","1","0","1","7","1","6","1","0","1","59","35","24","0","0","0","5","2","3","0","0","0","-2"
"110495","California State University-Stanislaus","2018","Not on tenure/no tenure system, lecturers","79","40","39","0","0","0","6","2","4","1","0","1","7","1","6","1","0","1","59","35","24","0","0","0","5","2","3","0","0","0","-2"
"110510","California State University-San Bernardino","2018","Tenured total","245","144","101","1","1","0","48","27","21","8","3","5","23","12","11","0","0","0","148","92","56","1","1","0","14","8","6","2","0","2","-2"
"110510","California State University-San Bernardino","2018","Tenured, professors","190","115","75","1","1","0","36","22","14","7","2","5","16","10","6","0","0","0","120","75","45","1","1","0","9","4","5","0","0","0","-2"
"110510","California State University-San Bernardino","2018","Tenured, associate professors","52","27","25","0","0","0","11","4","7","1","1","0","7","2","5","0","0","0","26","16","10","0","0","0","5","4","1","2","0","2","-2"
"110510","California State University-San Bernardino","2018","Tenured, assistant professors","3","2","1","0","0","0","1","1","0","0","0","0","0","0","0","0","0","0","2","1","1","0","0","0","0","0","0","0","0","0","-2"
"110510","California State University-San Bernardino","2018","On-Tenure track total","127","60","67","0","0","0","19","10","9","12","5","7","21","9","12","0","0","0","54","27","27","1","0","1","6","3","3","14","6","8","-2"
"110510","California State University-San Bernardino","2018","On-tenure track, professors","4","2","2","0","0","0","0","0","0","1","0","1","0","0","0","0","0","0","3","2","1","0","0","0","0","0","0","0","0","0","-2"
"110510","California State University-San Bernardino","2018","On-tenure track, associate professors","9","2","7","0","0","0","1","0","1","4","1","3","0","0","0","0","0","0","4","1","3","0","0","0","0","0","0","0","0","0","-2"
"110510","California State University-San Bernardino","2018","On-tenure track, assistant professors","114","56","58","0","0","0","18","10","8","7","4","3","21","9","12","0","0","0","47","24","23","1","0","1","6","3","3","14","6","8","-2"
"110510","California State University-San Bernardino","2018","Not on tenure track/No tenure system system total","102","32","70","1","0","1","11","1","10","3","1","2","14","6","8","0","0","0","65","21","44","2","0","2","5","2","3","1","1","0","-2"
"110510","California State University-San Bernardino","2018","Not on tenure/no tenure system, lecturers","102","32","70","1","0","1","11","1","10","3","1","2","14","6","8","0","0","0","65","21","44","2","0","2","5","2","3","1","1","0","-2"
"110529","California State Polytechnic University-Pomona","2018","Tenured total","336","201","135","1","0","1","100","59","41","10","6","4","31","19","12","1","1","0","174","106","68","0","0","0","16","10","6","3","0","3","-2"
"110529","California State Polytechnic University-Pomona","2018","Tenured, professors","258","158","100","1","0","1","77","48","29","6","4","2","23","14","9","1","1","0","142","86","56","0","0","0","8","5","3","0","0","0","-2"
"110529","California State Polytechnic University-Pomona","2018","Tenured, associate professors","75","42","33","0","0","0","22","11","11","4","2","2","8","5","3","0","0","0","31","19","12","0","0","0","8","5","3","2","0","2","-2"
"110529","California State Polytechnic University-Pomona","2018","Tenured, assistant professors","3","1","2","0","0","0","1","0","1","0","0","0","0","0","0","0","0","0","1","1","0","0","0","0","0","0","0","1","0","1","-2"
"110529","California State Polytechnic University-Pomona","2018","On-Tenure track total","171","96","75","1","1","0","27","14","13","3","2","1","16","9","7","0","0","0","88","49","39","2","2","0","9","4","5","25","15","10","-2"
"110529","California State Polytechnic University-Pomona","2018","On-tenure track, associate professors","1","1","0","0","0","0","0","0","0","0","0","0","0","0","0","0","0","0","0","0","0","0","0","0","1","1","0","0","0","0","-2"
"110529","California State Polytechnic University-Pomona","2018","On-tenure track, assistant professors","170","95","75","1","1","0","27","14","13","3","2","1","16","9","7","0","0","0","88","49","39","2","2","0","8","3","5","25","15","10","-2"
"110529","California State Polytechnic University-Pomona","2018","Not on tenure track/No tenure system system total","113","63","50","1","1","0","18","9","9","4","3","1","14","9","5","1","1","0","70","37","33","0","0","0","3","3","0","2","0","2","-2"
"110529","California State Polytechnic University-Pomona","2018","Not on tenure/no tenure system, lecturers","113","63","50","1","1","0","18","9","9","4","3","1","14","9","5","1","1","0","70","37","33","0","0","0","3","3","0","2","0","2","-2"
"110547","California State University-Dominguez Hills","2018","Tenured total","149","75","74","0","0","0","33","18","15","13","6","7","15","10","5","0","0","0","76","35","41","5","3","2","7","3","4","0","0","0","-2"
"110547","California State University-Dominguez Hills","2018","Tenured, professors","103","58","45","0","0","0","22","14","8","9","4","5","10","6","4","0","0","0","55","29","26","2","2","0","5","3","2","0","0","0","-2"
"110547","California State University-Dominguez Hills","2018","Tenured, associate professors","46","17","29","0","0","0","11","4","7","4","2","2","5","4","1","0","0","0","21","6","15","3","1","2","2","0","2","0","0","0","-2"
"110547","California State University-Dominguez Hills","2018","On-Tenure track total","106","42","64","2","1","1","17","4","13","9","5","4","13","4","9","0","0","0","42","16","26","4","2","2","6","2","4","13","8","5","-2"
"110547","California State University-Dominguez Hills","2018","On-tenure track, professors","4","3","1","0","0","0","0","0","0","0","0","0","0","0","0","0","0","0","4","3","1","0","0","0","0","0","0","0","0","0","-2"
"110547","California State University-Dominguez Hills","2018","On-tenure track, associate professors","8","4","4","1","1","0","3","1","2","2","2","0","0","0","0","0","0","0","2","0","2","0","0","0","0","0","0","0","0","0","-2"
"110547","California State University-Dominguez Hills","2018","On-tenure track, assistant professors","94","35","59","1","0","1","14","3","11","7","3","4","13","4","9","0","0","0","36","13","23","4","2","2","6","2","4","13","8","5","-2"
"110547","California State University-Dominguez Hills","2018","Not on tenure track/No tenure system system total","120","54","66","2","1","1","12","4","8","13","6","7","25","11","14","0","0","0","58","29","29","1","0","1","7","3","4","2","0","2","-2"
"110547","California State University-Dominguez Hills","2018","Not on tenure/no tenure system, lecturers","120","54","66","2","1","1","12","4","8","13","6","7","25","11","14","0","0","0","58","29","29","1","0","1","7","3","4","2","0","2","-2"
"110556","California State University-Fresno","2018","Tenured total","342","208","134","0","0","0","61","45","16","11","6","5","34","20","14","0","0","0","218","126","92","4","3","1","6","3","3","8","5","3","-2"
"110556","California State University-Fresno","2018","Tenured, professors","227","150","77","0","0","0","33","27","6","7","3","4","20","15","5","0","0","0","157","98","59","3","3","0","4","2","2","3","2","1","-2"
"110556","California State University-Fresno","2018","Tenured, associate professors","111","54","57","0","0","0","28","18","10","4","3","1","14","5","9","0","0","0","58","25","33","1","0","1","2","1","1","4","2","2","-2"
"110556","California State University-Fresno","2018","Tenured, assistant professors","2","2","0","0","0","0","0","0","0","0","0","0","0","0","0","0","0","0","1","1","0","0","0","0","0","0","0","1","1","0","-2"
"110556","California State University-Fresno","2018","Tenured, no academic rank","2","2","0","0","0","0","0","0","0","0","0","0","0","0","0","0","0","0","2","2","0","0","0","0","0","0","0","0","0","0","-2"
"110556","California State University-Fresno","2018","On-Tenure track total","256","125","131","3","1","2","37","23","14","15","7","8","41","22","19","0","0","0","121","52","69","4","3","1","9","5","4","26","12","14","-2"
"110556","California State University-Fresno","2018","On-tenure track, professors","1","1","0","0","0","0","1","1","0","0","0","0","0","0","0","0","0","0","0","0","0","0","0","0","0","0","0","0","0","0","-2"
"110556","California State University-Fresno","2018","On-tenure track, associate professors","7","4","3","0","0","0","3","2","1","0","0","0","2","1","1","0","0","0","1","1","0","0","0","0","0","0","0","1","0","1","-2"
"110556","California State University-Fresno","2018","On-tenure track, assistant professors","246","119","127","3","1","2","33","20","13","15","7","8","38","21","17","0","0","0","119","50","69","4","3","1","9","5","4","25","12","13","-2"
"110556","California State University-Fresno","2018","On-tenure track, no academic rank","2","1","1","0","0","0","0","0","0","0","0","0","1","0","1","0","0","0","1","1","0","0","0","0","0","0","0","0","0","0","-2"
"110556","California State University-Fresno","2018","Not on tenure track/No tenure system system total","207","81","126","3","0","3","18","7","11","4","0","4","29","10","19","1","1","0","126","53","73","3","1","2","20","7","13","3","2","1","-2"
"110556","California State University-Fresno","2018","Not on tenure/no tenure system, lecturers","207","81","126","3","0","3","18","7","11","4","0","4","29","10","19","1","1","0","126","53","73","3","1","2","20","7","13","3","2","1","-2"
"110565","California State University-Fullerton","2018","Tenured total","532","293","239","1","1","0","119","67","52","12","5","7","41","24","17","1","1","0","351","191","160","0","0","0","1","1","0","6","3","3","-2"
"110565","California State University-Fullerton","2018","Tenured, professors","337","194","143","1","1","0","74","43","31","5","2","3","23","12","11","1","1","0","233","135","98","0","0","0","0","0","0","0","0","0","-2"
"110565","California State University-Fullerton","2018","Tenured, associate professors","195","99","96","0","0","0","45","24","21","7","3","4","18","12","6","0","0","0","118","56","62","0","0","0","1","1","0","6","3","3","-2"
"110565","California State University-Fullerton","2018","On-Tenure track total","239","115","124","2","1","1","42","18","24","13","5","8","32","11","21","0","0","0","100","54","46","0","0","0","5","2","3","45","24","21","-2"
"110565","California State University-Fullerton","2018","On-tenure track, associate professors","20","13","7","0","0","0","4","2","2","0","0","0","3","2","1","0","0","0","9","7","2","0","0","0","1","1","0","3","1","2","-2"
"110565","California State University-Fullerton","2018","On-tenure track, assistant professors","219","102","117","2","1","1","38","16","22","13","5","8","29","9","20","0","0","0","91","47","44","0","0","0","4","1","3","42","23","19","-2"
"110565","California State University-Fullerton","2018","Not on tenure track/No tenure system system total","226","97","129","1","0","1","37","17","20","7","4","3","19","5","14","0","0","0","140","60","80","3","1","2","15","8","7","4","2","2","-2"
"110565","California State University-Fullerton","2018","Not on tenure/no tenure system, lecturers","226","97","129","1","0","1","37","17","20","7","4","3","19","5","14","0","0","0","140","60","80","3","1","2","15","8","7","4","2","2","-2"
"110574","California State University-East Bay","2018","Tenured total","192","98","94","0","0","0","45","20","25","12","5","7","20","10","10","1","0","1","103","57","46","2","1","1","7","4","3","2","1","1","-2"
"110574","California State University-East Bay","2018","Tenured, professors","123","66","57","0","0","0","29","13","16","8","5","3","12","5","7","1","0","1","67","39","28","2","1","1","3","2","1","1","1","0","-2"
"110574","California State University-East Bay","2018","Tenured, associate professors","67","31","36","0","0","0","16","7","9","4","0","4","7","5","2","0","0","0","35","17","18","0","0","0","4","2","2","1","0","1","-2"
"110574","California State University-East Bay","2018","Tenured, assistant professors","2","1","1","0","0","0","0","0","0","0","0","0","1","0","1","0","0","0","1","1","0","0","0","0","0","0","0","0","0","0","-2"
"110574","California State University-East Bay","2018","On-Tenure track total","132","67","65","0","0","0","24","13","11","7","1","6","9","7","2","0","0","0","59","26","33","2","2","0","16","8","8","15","10","5","-2"
"110574","California State University-East Bay","2018","On-tenure track, professors","2","1","1","0","0","0","0","0","0","1","0","1","0","0","0","0","0","0","1","1","0","0","0","0","0","0","0","0","0","0","-2"
"110574","California State University-East Bay","2018","On-tenure track, associate professors","6","5","1","0","0","0","3","3","0","0","0","0","1","0","1","0","0","0","1","1","0","0","0","0","1","1","0","0","0","0","-2"
"110574","California State University-East Bay","2018","On-tenure track, assistant professors","124","61","63","0","0","0","21","10","11","6","1","5","8","7","1","0","0","0","57","24","33","2","2","0","15","7","8","15","10","5","-2"
"110574","California State University-East Bay","2018","Not on tenure track/No tenure system system total","47","16","31","0","0","0","2","1","1","6","1","5","3","2","1","2","0","2","30","11","19","0","0","0","4","1","3","0","0","0","-2"
"110574","California State University-East Bay","2018","Not on tenure/no tenure system, lecturers","47","16","31","0","0","0","2","1","1","6","1","5","3","2","1","2","0","2","30","11","19","0","0","0","4","1","3","0","0","0","-2"
"110583","California State University-Long Beach","2018","Tenured total","547","294","253","4","2","2","126","58","68","18","12","6","53","30","23","0","0","0","321","175","146","4","1","3","20","16","4","1","0","1","-2"
"110583","California State University-Long Beach","2018","Tenured, professors","378","216","162","2","2","0","81","41","40","10","8","2","32","19","13","0","0","0","239","136","103","2","1","1","11","9","2","1","0","1","-2"
"110583","California State University-Long Beach","2018","Tenured, associate professors","165","78","87","2","0","2","45","17","28","8","4","4","20","11","9","0","0","0","79","39","40","2","0","2","9","7","2","0","0","0","-2"
"110583","California State University-Long Beach","2018","Tenured, assistant professors","2","0","2","0","0","0","0","0","0","0","0","0","0","0","0","0","0","0","2","0","2","0","0","0","0","0","0","0","0","0","-2"
"110583","California State University-Long Beach","2018","Tenured, no academic rank","2","0","2","0","0","0","0","0","0","0","0","0","1","0","1","0","0","0","1","0","1","0","0","0","0","0","0","0","0","0","-2"
"110583","California State University-Long Beach","2018","On-Tenure track total","252","108","144","2","1","1","50","15","35","13","5","8","25","8","17","0","0","0","124","59","65","6","1","5","8","3","5","24","16","8","-2"
"110583","California State University-Long Beach","2018","On-tenure track, professors","9","4","5","0","0","0","2","0","2","0","0","0","1","1","0","0","0","0","6","3","3","0","0","0","0","0","0","0","0","0","-2"
"110583","California State University-Long Beach","2018","On-tenure track, associate professors","10","3","7","0","0","0","4","1","3","2","0","2","2","0","2","0","0","0","1","1","0","0","0","0","0","0","0","1","1","0","-2"
"110583","California State University-Long Beach","2018","On-tenure track, assistant professors","233","101","132","2","1","1","44","14","30","11","5","6","22","7","15","0","0","0","117","55","62","6","1","5","8","3","5","23","15","8","-2"
"110583","California State University-Long Beach","2018","Not on tenure track/No tenure system system total","277","118","159","2","0","2","32","15","17","13","4","9","35","13","22","0","0","0","176","77","99","8","3","5","10","5","5","1","1","0","-2"
"110583","California State University-Long Beach","2018","Not on tenure/no tenure system, lecturers","277","118","159","2","0","2","32","15","17","13","4","9","35","13","22","0","0","0","176","77","99","8","3","5","10","5","5","1","1","0","-2"
"110592","California State University-Los Angeles","2018","Tenured total","339","182","157","1","0","1","92","51","41","13","7","6","50","33","17","1","1","0","167","82","85","1","0","1","12","7","5","2","1","1","-2"
"110592","California State University-Los Angeles","2018","Tenured, professors","268","150","118","1","0","1","76","43","33","11","6","5","40","26","14","1","1","0","130","69","61","1","0","1","8","5","3","0","0","0","-2"
"110592","California State University-Los Angeles","2018","Tenured, associate professors","71","32","39","0","0","0","16","8","8","2","1","1","10","7","3","0","0","0","37","13","24","0","0","0","4","2","2","2","1","1","-2"
"110592","California State University-Los Angeles","2018","On-Tenure track total","173","73","100","2","0","2","34","12","22","16","9","7","23","7","16","0","0","0","53","27","26","4","0","4","7","2","5","34","16","18","-2"
"110592","California State University-Los Angeles","2018","On-tenure track, professors","2","1","1","0","0","0","0","0","0","0","0","0","0","0","0","0","0","0","1","1","0","0","0","0","1","0","1","0","0","0","-2"
"110592","California State University-Los Angeles","2018","On-tenure track, associate professors","3","1","2","0","0","0","1","1","0","0","0","0","0","0","0","0","0","0","1","0","1","0","0","0","1","0","1","0","0","0","-2"
"110592","California State University-Los Angeles","2018","On-tenure track, assistant professors","168","71","97","2","0","2","33","11","22","16","9","7","23","7","16","0","0","0","51","26","25","4","0","4","5","2","3","34","16","18","-2"
"110592","California State University-Los Angeles","2018","Not on tenure track/No tenure system system total","197","92","105","0","0","0","32","15","17","13","9","4","46","18","28","0","0","0","90","41","49","4","3","1","9","4","5","3","2","1","-2"
"110592","California State University-Los Angeles","2018","Not on tenure/no tenure system, lecturers","197","92","105","0","0","0","32","15","17","13","9","4","46","18","28","0","0","0","90","41","49","4","3","1","9","4","5","3","2","1","-2"
"110608","California State University-Northridge","2018","Tenured total","564","295","269","3","1","2","96","55","41","26","8","18","65","33","32","0","0","0","353","185","168","6","3","3","14","9","5","1","1","0","-2"
"110608","California State University-Northridge","2018","Tenured, professors","387","209","178","3","1","2","63","38","25","17","5","12","51","25","26","0","0","0","245","133","112","4","3","1","4","4","0","0","0","0","-2"
"110608","California State University-Northridge","2018","Tenured, associate professors","163","77","86","0","0","0","31","15","16","9","3","6","12","8","4","0","0","0","98","45","53","2","0","2","10","5","5","1","1","0","-2"
"110608","California State University-Northridge","2018","Tenured, assistant professors","1","1","0","0","0","0","0","0","0","0","0","0","0","0","0","0","0","0","1","1","0","0","0","0","0","0","0","0","0","0","-2"
"110608","California State University-Northridge","2018","Tenured, no academic rank","13","8","5","0","0","0","2","2","0","0","0","0","2","0","2","0","0","0","9","6","3","0","0","0","0","0","0","0","0","0","-2"
"110608","California State University-Northridge","2018","On-Tenure track total","226","100","126","2","0","2","41","12","29","15","5","10","20","11","9","0","0","0","108","53","55","7","4","3","14","8","6","19","7","12","-2"
"110608","California State University-Northridge","2018","On-tenure track, professors","2","0","2","0","0","0","0","0","0","1","0","1","0","0","0","0","0","0","1","0","1","0","0","0","0","0","0","0","0","0","-2"
"110608","California State University-Northridge","2018","On-tenure track, associate professors","14","4","10","0","0","0","5","0","5","0","0","0","0","0","0","0","0","0","8","3","5","0","0","0","0","0","0","1","1","0","-2"
"110608","California State University-Northridge","2018","On-tenure track, assistant professors","209","96","113","2","0","2","36","12","24","14","5","9","20","11","9","0","0","0","98","50","48","7","4","3","14","8","6","18","6","12","-2"
"110608","California State University-Northridge","2018","On-tenure track, no academic rank","1","0","1","0","0","0","0","0","0","0","0","0","0","0","0","0","0","0","1","0","1","0","0","0","0","0","0","0","0","0","-2"
"110608","California State University-Northridge","2018","Not on tenure track/No tenure system system total","157","67","90","1","0","1","15","7","8","8","4","4","21","12","9","0","0","0","102","41","61","0","0","0","10","3","7","0","0","0","-2"
"110608","California State University-Northridge","2018","Not on tenure/no tenure system, lecturers","157","67","90","1","0","1","15","7","8","8","4","4","21","12","9","0","0","0","102","41","61","0","0","0","10","3","7","0","0","0","-2"
"110617","California State University-Sacramento","2018","Tenured total","428","236","192","4","2","2","73","45","28","21","9","12","36","21","15","0","0","0","268","143","125","2","1","1","10","7","3","14","8","6","-2"
"110617","California State University-Sacramento","2018","Tenured, professors","329","185","144","3","1","2","53","32","21","16","6","10","29","18","11","0","0","0","212","119","93","2","1","1","6","4","2","8","4","4","-2"
"110617","California State University-Sacramento","2018","Tenured, associate professors","95","48","47","1","1","0","19","12","7","5","3","2","7","3","4","0","0","0","53","22","31","0","0","0","4","3","1","6","4","2","-2"
"110617","California State University-Sacramento","2018","Tenured, assistant professors","2","1","1","0","0","0","1","1","0","0","0","0","0","0","0","0","0","0","1","0","1","0","0","0","0","0","0","0","0","0","-2"
"110617","California State University-Sacramento","2018","Tenured, no academic rank","2","2","0","0","0","0","0","0","0","0","0","0","0","0","0","0","0","0","2","2","0","0","0","0","0","0","0","0","0","0","-2"
"110617","California State University-Sacramento","2018","On-Tenure track total","242","112","130","3","2","1","21","12","9","13","4","9","12","4","8","0","0","0","123","60","63","5","2","3","61","26","35","4","2","2","-2"
"110617","California State University-Sacramento","2018","On-tenure track, professors","5","4","1","0","0","0","0","0","0","0","0","0","1","0","1","0","0","0","4","4","0","0","0","0","0","0","0","0","0","0","-2"
"110617","California State University-Sacramento","2018","On-tenure track, associate professors","2","2","0","0","0","0","0","0","0","0","0","0","0","0","0","0","0","0","0","0","0","1","1","0","1","1","0","0","0","0","-2"
"110617","California State University-Sacramento","2018","On-tenure track, assistant professors","233","106","127","3","2","1","21","12","9","13","4","9","11","4","7","0","0","0","117","56","61","4","1","3","60","25","35","4","2","2","-2"
"110617","California State University-Sacramento","2018","On-tenure track, no academic rank","2","0","2","0","0","0","0","0","0","0","0","0","0","0","0","0","0","0","2","0","2","0","0","0","0","0","0","0","0","0","-2"
"110617","California State University-Sacramento","2018","Not on tenure track/No tenure system system total","121","41","80","2","0","2","5","3","2","2","1","1","3","1","2","0","0","0","100","34","66","3","1","2","5","0","5","1","1","0","-2"
"110617","California State University-Sacramento","2018","Not on tenure/no tenure system, lecturers","121","41","80","2","0","2","5","3","2","2","1","1","3","1","2","0","0","0","100","34","66","3","1","2","5","0","5","1","1","0","-2"
"110671","University of California-Riverside","2018","Tenured total","562","392","170","4","2","2","74","52","22","12","9","3","26","18","8","0","0","0","291","204","87","2","1","1","12","6","6","141","100","41","-2"
"110671","University of California-Riverside","2018","Tenured, professors","352","267","85","1","1","0","45","36","9","8","5","3","9","7","2","0","0","0","203","152","51","1","1","0","9","5","4","76","60","16","-2"
"110671","University of California-Riverside","2018","Tenured, associate professors","204","121","83","3","1","2","29","16","13","4","4","0","16","10","6","0","0","0","85","50","35","1","0","1","3","1","2","63","39","24","-2"
"110671","University of California-Riverside","2018","Tenured, lecturers","6","4","2","0","0","0","0","0","0","0","0","0","1","1","0","0","0","0","3","2","1","0","0","0","0","0","0","2","1","1","-2"
"110671","University of California-Riverside","2018","On-Tenure track total","274","166","108","3","2","1","24","10","14","13","3","10","18","11","7","0","0","0","87","50","37","7","4","3","17","12","5","105","74","31","-2"
"110671","University of California-Riverside","2018","On-tenure track, assistant professors","254","155","99","3","2","1","23","10","13","12","2","10","17","11","6","0","0","0","75","44","31","6","3","3","15","10","5","103","73","30","-2"
"110671","University of California-Riverside","2018","On-tenure track, lecturers","20","11","9","0","0","0","1","0","1","1","1","0","1","0","1","0","0","0","12","6","6","1","1","0","2","2","0","2","1","1","-2"
"110671","University of California-Riverside","2018","Not on tenure track/No tenure system system total","198","105","93","1","1","0","21","15","6","9","4","5","17","8","9","0","0","0","106","59","47","4","2","2","12","7","5","28","9","19","-2"
"110671","University of California-Riverside","2018","Not on tenure/no tenure system, professors","12","10","2","0","0","0","4","4","0","1","0","1","0","0","0","0","0","0","7","6","1","0","0","0","0","0","0","0","0","0","-2"
"110671","University of California-Riverside","2018","Not on tenure/no tenure system, associate professors","9","7","2","0","0","0","2","1","1","2","2","0","0","0","0","0","0","0","4","4","0","0","0","0","1","0","1","0","0","0","-2"
"110671","University of California-Riverside","2018","Not on tenure/no tenure system, assistant professors","65","36","29","0","0","0","11","8","3","4","2","2","5","4","1","0","0","0","27","12","15","2","2","0","5","3","2","11","5","6","-2"
"110671","University of California-Riverside","2018","Not on tenure/no tenure system, instructors","1","1","0","0","0","0","1","1","0","0","0","0","0","0","0","0","0","0","0","0","0","0","0","0","0","0","0","0","0","0","-2"
"110671","University of California-Riverside","2018","Not on tenure/no tenure system, lecturers","111","51","60","1","1","0","3","1","2","2","0","2","12","4","8","0","0","0","68","37","31","2","0","2","6","4","2","17","4","13","-2"
"110705","University of California-Santa Barbara","2018","Tenured total","688","446","242","6","1","5","66","43","23","15","7","8","48","28","20","0","0","0","502","334","168","4","2","2","23","15","8","24","16","8","-2"
"110705","University of California-Santa Barbara","2018","Tenured, professors","508","350","158","1","0","1","54","35","19","7","4","3","34","21","13","0","0","0","377","267","110","4","2","2","14","8","6","17","13","4","-2"
"110705","University of California-Santa Barbara","2018","Tenured, associate professors","150","79","71","5","1","4","12","8","4","7","2","5","11","6","5","0","0","0","100","52","48","0","0","0","9","7","2","6","3","3","-2"
"110705","University of California-Santa Barbara","2018","Tenured, lecturers","30","17","13","0","0","0","0","0","0","1","1","0","3","1","2","0","0","0","25","15","10","0","0","0","0","0","0","1","0","1","-2"
"110705","University of California-Santa Barbara","2018","On-Tenure track total","177","97","80","0","0","0","17","7","10","2","1","1","15","5","10","0","0","0","65","33","32","3","1","2","37","21","16","38","29","9","-2"
"110705","University of California-Santa Barbara","2018","On-tenure track, professors","1","1","0","0","0","0","0","0","0","0","0","0","0","0","0","0","0","0","0","0","0","0","0","0","0","0","0","1","1","0","-2"
"110705","University of California-Santa Barbara","2018","On-tenure track, assistant professors","162","89","73","0","0","0","16","7","9","2","1","1","14","5","9","0","0","0","59","30","29","3","1","2","34","19","15","34","26","8","-2"
"110705","University of California-Santa Barbara","2018","On-tenure track, lecturers","14","7","7","0","0","0","1","0","1","0","0","0","1","0","1","0","0","0","6","3","3","0","0","0","3","2","1","3","2","1","-2"
"110705","University of California-Santa Barbara","2018","Not on tenure track/No tenure system system total","162","67","95","1","1","0","12","2","10","3","2","1","5","2","3","1","0","1","99","36","63","0","0","0","21","13","8","20","11","9","-2"
"110705","University of California-Santa Barbara","2018","Not on tenure/no tenure system, assistant professors","18","10","8","0","0","0","1","0","1","1","0","1","0","0","0","0","0","0","0","0","0","0","0","0","3","2","1","13","8","5","-2"
"110705","University of California-Santa Barbara","2018","Not on tenure/no tenure system, lecturers","144","57","87","1","1","0","11","2","9","2","2","0","5","2","3","1","0","1","99","36","63","0","0","0","18","11","7","7","3","4","-2"
"110714","University of California-Santa Cruz","2018","Tenured total","427","263","164","8","1","7","69","44","25","9","7","2","40","20","20","0","0","0","293","186","107","1","1","0","7","4","3","0","0","0","-2"
"110714","University of California-Santa Cruz","2018","Tenured, professors","290","190","100","5","1","4","44","29","15","4","4","0","20","12","8","0","0","0","212","141","71","0","0","0","5","3","2","0","0","0","-2"
"110714","University of California-Santa Cruz","2018","Tenured, associate professors","125","68","57","3","0","3","24","14","10","5","3","2","18","8","10","0","0","0","73","42","31","1","1","0","1","0","1","0","0","0","-2"
"110714","University of California-Santa Cruz","2018","Tenured, lecturers","12","5","7","0","0","0","1","1","0","0","0","0","2","0","2","0","0","0","8","3","5","0","0","0","1","1","0","0","0","0","-2"
"110714","University of California-Santa Cruz","2018","On-Tenure track total","140","76","64","1","1","0","17","9","8","8","3","5","15","8","7","0","0","0","58","35","23","2","0","2","8","4","4","31","16","15","-2"
"110714","University of California-Santa Cruz","2018","On-tenure track, professors","3","3","0","0","0","0","0","0","0","0","0","0","0","0","0","0","0","0","0","0","0","0","0","0","0","0","0","3","3","0","-2"
"110714","University of California-Santa Cruz","2018","On-tenure track, associate professors","1","0","1","0","0","0","1","0","1","0","0","0","0","0","0","0","0","0","0","0","0","0","0","0","0","0","0","0","0","0","-2"
"110714","University of California-Santa Cruz","2018","On-tenure track, assistant professors","129","70","59","1","1","0","16","9","7","7","2","5","14","8","6","0","0","0","56","34","22","2","0","2","7","4","3","26","12","14","-2"
"110714","University of California-Santa Cruz","2018","On-tenure track, lecturers","7","3","4","0","0","0","0","0","0","1","1","0","1","0","1","0","0","0","2","1","1","0","0","0","1","0","1","2","1","1","-2"
"110714","University of California-Santa Cruz","2018","Not on tenure track/No tenure system system total","98","40","58","1","0","1","5","1","4","2","1","1","13","3","10","0","0","0","63","29","34","2","0","2","8","4","4","4","2","2","-2"
"110714","University of California-Santa Cruz","2018","Not on tenure/no tenure system, professors","2","2","0","0","0","0","0","0","0","0","0","0","0","0","0","0","0","0","1","1","0","0","0","0","0","0","0","1","1","0","-2"
"110714","University of California-Santa Cruz","2018","Not on tenure/no tenure system, assistant professors","3","2","1","0","0","0","0","0","0","0","0","0","1","1","0","0","0","0","1","1","0","0","0","0","0","0","0","1","0","1","-2"
"110714","University of California-Santa Cruz","2018","Not on tenure/no tenure system, lecturers","89","34","55","1","0","1","5","1","4","2","1","1","11","2","9","0","0","0","58","25","33","2","0","2","8","4","4","2","1","1","-2"
"110714","University of California-Santa Cruz","2018","Not on tenure/no tenure system, no academic rank","4","2","2","0","0","0","0","0","0","0","0","0","1","0","1","0","0","0","3","2","1","0","0","0","0","0","0","0","0","0","-2"
"111966","Charles R Drew University of Medicine and Science","2018","Not on tenure track/No tenure system system total","52","20","32","0","0","0","7","4","3","17","5","12","8","4","4","1","0","1","18","7","11","1","0","1","0","0","0","0","0","0","-2"
"111966","Charles R Drew University of Medicine and Science","2018","Not on tenure/no tenure system, professors","4","3","1","0","0","0","0","0","0","0","0","0","0","0","0","0","0","0","4","3","1","0","0","0","0","0","0","0","0","0","-2"
"111966","Charles R Drew University of Medicine and Science","2018","Not on tenure/no tenure system, associate professors","11","4","7","0","0","0","0","0","0","3","1","2","3","2","1","0","0","0","5","1","4","0","0","0","0","0","0","0","0","0","-2"
"111966","Charles R Drew University of Medicine and Science","2018","Not on tenure/no tenure system, assistant professors","27","8","19","0","0","0","5","2","3","9","2","7","3","2","1","1","0","1","8","2","6","1","0","1","0","0","0","0","0","0","-2"
"111966","Charles R Drew University of Medicine and Science","2018","Not on tenure/no tenure system, instructors","10","5","5","0","0","0","2","2","0","5","2","3","2","0","2","0","0","0","1","1","0","0","0","0","0","0","0","0","0","0","-2"
"112075","Concordia University-Irvine","2018","Not on tenure track/No tenure system system total","110","57","53","1","1","0","7","5","2","2","0","2","7","3","4","0","0","0","91","48","43","0","0","0","2","0","2","0","0","0","-2"
"112075","Concordia University-Irvine","2018","Not on tenure/no tenure system, professors","37","25","12","0","0","0","1","1","0","0","0","0","3","3","0","0","0","0","33","21","12","0","0","0","0","0","0","0","0","0","-2"
"112075","Concordia University-Irvine","2018","Not on tenure/no tenure system, associate professors","20","10","10","0","0","0","1","1","0","1","0","1","2","0","2","0","0","0","16","9","7","0","0","0","0","0","0","0","0","0","-2"
"112075","Concordia University-Irvine","2018","Not on tenure/no tenure system, assistant professors","53","22","31","1","1","0","5","3","2","1","0","1","2","0","2","0","0","0","42","18","24","0","0","0","2","0","2","0","0","0","-2"
"112084","San Diego Christian College","2018","Not on tenure track/No tenure system system total","12","7","5","0","0","0","0","0","0","1","0","1","0","0","0","0","0","0","11","7","4","0","0","0","0","0","0","0","0","0","-2"
"112084","San Diego Christian College","2018","Not on tenure/no tenure system, professors","2","2","0","0","0","0","0","0","0","0","0","0","0","0","0","0","0","0","2","2","0","0","0","0","0","0","0","0","0","0","-2"
"112084","San Diego Christian College","2018","Not on tenure/no tenure system, associate professors","2","1","1","0","0","0","0","0","0","0","0","0","0","0","0","0","0","0","2","1","1","0","0","0","0","0","0","0","0","0","-2"
"112084","San Diego Christian College","2018","Not on tenure/no tenure system, assistant professors","8","4","4","0","0","0","0","0","0","1","0","1","0","0","0","0","0","0","7","4","3","0","0","0","0","0","0","0","0","0","-2"
"113236","Cypress College","2018","Tenured total","141","64","77","0","0","0","19","5","14","7","0","7","27","17","10","1","0","1","66","33","33","5","1","4","14","8","6","2","0","2","-2"
"113236","Cypress College","2018","Tenured, instructors","141","64","77","0","0","0","19","5","14","7","0","7","27","17","10","1","0","1","66","33","33","5","1","4","14","8","6","2","0","2","-2"
"113236","Cypress College","2018","On-Tenure track total","63","26","37","0","0","0","11","2","9","1","1","0","12","7","5","0","0","0","28","13","15","4","0","4","4","3","1","3","0","3","-2"
"113236","Cypress College","2018","On-tenure track, instructors","63","26","37","0","0","0","11","2","9","1","1","0","12","7","5","0","0","0","28","13","15","4","0","4","4","3","1","3","0","3","-2"
"113236","Cypress College","2018","Not on tenure track/No tenure system system total","2","1","1","0","0","0","0","0","0","0","0","0","0","0","0","0","0","0","2","1","1","0","0","0","0","0","0","0","0","0","-2"
"113236","Cypress College","2018","Not on tenure/no tenure system, instructors","2","1","1","0","0","0","0","0","0","0","0","0","0","0","0","0","0","0","2","1","1","0","0","0","0","0","0","0","0","0","-2"
"113698","Dominican University of California","2018","Tenured total","46","19","27","0","0","0","5","2","3","3","2","1","1","0","1","0","0","0","37","15","22","0","0","0","0","0","0","0","0","0","-2"
"113698","Dominican University of California","2018","Tenured, professors","28","12","16","0","0","0","2","0","2","3","2","1","1","0","1","0","0","0","22","10","12","0","0","0","0","0","0","0","0","0","-2"
"113698","Dominican University of California","2018","Tenured, associate professors","18","7","11","0","0","0","3","2","1","0","0","0","0","0","0","0","0","0","15","5","10","0","0","0","0","0","0","0","0","0","-2"
"113698","Dominican University of California","2018","On-Tenure track total","32","15","17","0","0","0","5","2","3","2","1","1","2","2","0","0","0","0","17","7","10","1","1","0","5","2","3","0","0","0","-2"
"113698","Dominican University of California","2018","On-tenure track, assistant professors","32","15","17","0","0","0","5","2","3","2","1","1","2","2","0","0","0","0","17","7","10","1","1","0","5","2","3","0","0","0","-2"
"113698","Dominican University of California","2018","Not on tenure track/No tenure system system total","28","13","15","0","0","0","3","1","2","0","0","0","2","2","0","0","0","0","19","7","12","0","0","0","4","3","1","0","0","0","-2"
"113698","Dominican University of California","2018","Not on tenure/no tenure system, professors","1","1","0","0","0","0","0","0","0","0","0","0","0","0","0","0","0","0","0","0","0","0","0","0","1","1","0","0","0","0","-2"
"113698","Dominican University of California","2018","Not on tenure/no tenure system, associate professors","1","1","0","0","0","0","0","0","0","0","0","0","0","0","0","0","0","0","0","0","0","0","0","0","1","1","0","0","0","0","-2"
"113698","Dominican University of California","2018","Not on tenure/no tenure system, assistant professors","26","11","15","0","0","0","3","1","2","0","0","0","2","2","0","0","0","0","19","7","12","0","0","0","2","1","1","0","0","0","-2"
"114433","Feather River Community College District","2018","Tenured total","16","10","6","0","0","0","0","0","0","0","0","0","0","0","0","0","0","0","15","10","5","0","0","0","0","0","0","1","0","1","-2"
"114433","Feather River Community College District","2018","Tenured, instructors","16","10","6","0","0","0","0","0","0","0","0","0","0","0","0","0","0","0","15","10","5","0","0","0","0","0","0","1","0","1","-2"
"114433","Feather River Community College District","2018","On-Tenure track total","9","7","2","0","0","0","0","0","0","0","0","0","0","0","0","0","0","0","7","5","2","0","0","0","1","1","0","1","1","0","-2"
"114433","Feather River Community College District","2018","On-tenure track, instructors","9","7","2","0","0","0","0","0","0","0","0","0","0","0","0","0","0","0","7","5","2","0","0","0","1","1","0","1","1","0","-2"
"114716","Foothill College","2018","Tenured total","141","57","84","0","0","0","22","6","16","6","3","3","22","9","13","0","0","0","90","38","52","1","1","0","0","0","0","0","0","0","-2"
"114716","Foothill College","2018","Tenured, instructors","141","57","84","0","0","0","22","6","16","6","3","3","22","9","13","0","0","0","90","38","52","1","1","0","0","0","0","0","0","0","-2"
"114716","Foothill College","2018","On-Tenure track total","38","18","20","0","0","0","6","4","2","4","1","3","6","3","3","0","0","0","17","7","10","4","3","1","1","0","1","0","0","0","-2"
"114716","Foothill College","2018","On-tenure track, instructors","38","18","20","0","0","0","6","4","2","4","1","3","6","3","3","0","0","0","17","7","10","4","3","1","1","0","1","0","0","0","-2"
"114716","Foothill College","2018","Not on tenure track/No tenure system system total","3","1","2","0","0","0","0","0","0","0","0","0","0","0","0","0","0","0","2","1","1","1","0","1","0","0","0","0","0","0","-2"
"114716","Foothill College","2018","Not on tenure/no tenure system, instructors","3","1","2","0","0","0","0","0","0","0","0","0","0","0","0","0","0","0","2","1","1","1","0","1","0","0","0","0","0","0","-2"
"114813","Fresno Pacific University","2018","Tenured total","52","37","15","0","0","0","3","2","1","0","0","0","0","0","0","0","0","0","47","34","13","2","1","1","0","0","0","0","0","0","-2"
"114813","Fresno Pacific University","2018","Tenured, professors","16","13","3","0","0","0","1","1","0","0","0","0","0","0","0","0","0","0","15","12","3","0","0","0","0","0","0","0","0","0","-2"
"114813","Fresno Pacific University","2018","Tenured, associate professors","35","24","11","0","0","0","2","1","1","0","0","0","0","0","0","0","0","0","31","22","9","2","1","1","0","0","0","0","0","0","-2"
"114813","Fresno Pacific University","2018","Tenured, assistant professors","1","0","1","0","0","0","0","0","0","0","0","0","0","0","0","0","0","0","1","0","1","0","0","0","0","0","0","0","0","0","-2"
"114813","Fresno Pacific University","2018","On-Tenure track total","35","13","22","0","0","0","4","2","2","2","1","1","4","0","4","0","0","0","25","10","15","0","0","0","0","0","0","0","0","0","-2"
"114813","Fresno Pacific University","2018","On-tenure track, associate professors","3","1","2","0","0","0","1","1","0","0","0","0","1","0","1","0","0","0","1","0","1","0","0","0","0","0","0","0","0","0","-2"
"114813","Fresno Pacific University","2018","On-tenure track, assistant professors","30","10","20","0","0","0","3","1","2","2","1","1","3","0","3","0","0","0","22","8","14","0","0","0","0","0","0","0","0","0","-2"
"114813","Fresno Pacific University","2018","On-tenure track, instructors","2","2","0","0","0","0","0","0","0","0","0","0","0","0","0","0","0","0","2","2","0","0","0","0","0","0","0","0","0","0","-2"
"114813","Fresno Pacific University","2018","Not on tenure track/No tenure system system total","19","5","14","0","0","0","0","0","0","0","0","0","4","0","4","0","0","0","15","5","10","0","0","0","0","0","0","0","0","0","-2"
"114813","Fresno Pacific University","2018","Not on tenure/no tenure system, professors","1","1","0","0","0","0","0","0","0","0","0","0","0","0","0","0","0","0","1","1","0","0","0","0","0","0","0","0","0","0","-2"
"114813","Fresno Pacific University","2018","Not on tenure/no tenure system, associate professors","3","2","1","0","0","0","0","0","0","0","0","0","0","0","0","0","0","0","3","2","1","0","0","0","0","0","0","0","0","0","-2"
"114813","Fresno Pacific University","2018","Not on tenure/no tenure system, assistant professors","11","2","9","0","0","0","0","0","0","0","0","0","2","0","2","0","0","0","9","2","7","0","0","0","0","0","0","0","0","0","-2"
"114813","Fresno Pacific University","2018","Not on tenure/no tenure system, instructors","4","0","4","0","0","0","0","0","0","0","0","0","2","0","2","0","0","0","2","0","2","0","0","0","0","0","0","0","0","0","-2"
"115728","Holy Names University","2018","Tenured total","17","9","8","0","0","0","4","2","2","1","1","0","2","0","2","0","0","0","10","6","4","0","0","0","0","0","0","0","0","0","-2"
"115728","Holy Names University","2018","Tenured, professors","5","3","2","0","0","0","0","0","0","0","0","0","1","0","1","0","0","0","4","3","1","0","0","0","0","0","0","0","0","0","-2"
"115728","Holy Names University","2018","Tenured, associate professors","12","6","6","0","0","0","4","2","2","1","1","0","1","0","1","0","0","0","6","3","3","0","0","0","0","0","0","0","0","0","-2"
"115728","Holy Names University","2018","On-Tenure track total","7","3","4","0","0","0","5","2","3","1","1","0","0","0","0","0","0","0","0","0","0","1","0","1","0","0","0","0","0","0","-2"
"115728","Holy Names University","2018","On-tenure track, assistant professors","7","3","4","0","0","0","5","2","3","1","1","0","0","0","0","0","0","0","0","0","0","1","0","1","0","0","0","0","0","0","-2"
"115728","Holy Names University","2018","Not on tenure track/No tenure system system total","21","4","17","0","0","0","3","1","2","3","0","3","1","0","1","0","0","0","14","3","11","0","0","0","0","0","0","0","0","0","-2"
"115728","Holy Names University","2018","Not on tenure/no tenure system, professors","1","1","0","0","0","0","0","0","0","0","0","0","0","0","0","0","0","0","1","1","0","0","0","0","0","0","0","0","0","0","-2"
"115728","Holy Names University","2018","Not on tenure/no tenure system, associate professors","3","0","3","0","0","0","0","0","0","0","0","0","0","0","0","0","0","0","3","0","3","0","0","0","0","0","0","0","0","0","-2"
"115728","Holy Names University","2018","Not on tenure/no tenure system, assistant professors","14","2","12","0","0","0","2","0","2","3","0","3","1","0","1","0","0","0","8","2","6","0","0","0","0","0","0","0","0","0","-2"
"115728","Holy Names University","2018","Not on tenure/no tenure system, instructors","3","1","2","0","0","0","1","1","0","0","0","0","0","0","0","0","0","0","2","0","2","0","0","0","0","0","0","0","0","0","-2"
"115773","Humphreys University-Stockton and Modesto Campuses","2018","Not on tenure track/No tenure system system total","18","5","13","0","0","0","0","0","0","0","0","0","2","0","2","0","0","0","16","5","11","0","0","0","0","0","0","0","0","0","-2"
"115773","Humphreys University-Stockton and Modesto Campuses","2018","Not on tenure/no tenure system, professors","4","4","0","0","0","0","0","0","0","0","0","0","0","0","0","0","0","0","4","4","0","0","0","0","0","0","0","0","0","0","-2"
"115773","Humphreys University-Stockton and Modesto Campuses","2018","Not on tenure/no tenure system, associate professors","7","1","6","0","0","0","0","0","0","0","0","0","0","0","0","0","0","0","7","1","6","0","0","0","0","0","0","0","0","0","-2"
"115773","Humphreys University-Stockton and Modesto Campuses","2018","Not on tenure/no tenure system, assistant professors","5","0","5","0","0","0","0","0","0","0","0","0","2","0","2","0","0","0","3","0","3","0","0","0","0","0","0","0","0","0","-2"
"115773","Humphreys University-Stockton and Modesto Campuses","2018","Not on tenure/no tenure system, instructors","2","0","2","0","0","0","0","0","0","0","0","0","0","0","0","0","0","0","2","0","2","0","0","0","0","0","0","0","0","0","-2"
"117104","Life Pacific University","2018","Not on tenure track/No tenure system system total","15","10","5","0","0","0","1","1","0","1","1","0","4","3","1","0","0","0","9","5","4","0","0","0","0","0","0","0","0","0","-2"
"117104","Life Pacific University","2018","Not on tenure/no tenure system, professors","4","4","0","0","0","0","1","1","0","0","0","0","0","0","0","0","0","0","3","3","0","0","0","0","0","0","0","0","0","0","-2"
"117104","Life Pacific University","2018","Not on tenure/no tenure system, associate professors","5","3","2","0","0","0","0","0","0","1","1","0","0","0","0","0","0","0","4","2","2","0","0","0","0","0","0","0","0","0","-2"
"117104","Life Pacific University","2018","Not on tenure/no tenure system, assistant professors","5","3","2","0","0","0","0","0","0","0","0","0","4","3","1","0","0","0","1","0","1","0","0","0","0","0","0","0","0","0","-2"
"117104","Life Pacific University","2018","Not on tenure/no tenure system, instructors","1","0","1","0","0","0","0","0","0","0","0","0","0","0","0","0","0","0","1","0","1","0","0","0","0","0","0","0","0","0","-2"
"117140","University of La Verne","2018","Tenured total","135","69","66","0","0","0","16","5","11","4","1","3","14","9","5","0","0","0","90","52","38","0","0","0","11","2","9","0","0","0","-2"
"117140","University of La Verne","2018","Tenured, professors","82","48","34","0","0","0","9","3","6","1","1","0","5","4","1","0","0","0","63","39","24","0","0","0","4","1","3","0","0","0","-2"
"117140","University of La Verne","2018","Tenured, associate professors","52","20","32","0","0","0","7","2","5","3","0","3","9","5","4","0","0","0","26","12","14","0","0","0","7","1","6","0","0","0","-2"
"117140","University of La Verne","2018","Tenured, assistant professors","1","1","0","0","0","0","0","0","0","0","0","0","0","0","0","0","0","0","1","1","0","0","0","0","0","0","0","0","0","0","-2"
"117140","University of La Verne","2018","On-Tenure track total","65","28","37","0","0","0","10","2","8","7","5","2","4","3","1","0","0","0","14","5","9","0","0","0","30","13","17","0","0","0","-2"
"117140","University of La Verne","2018","On-tenure track, professors","4","2","2","0","0","0","0","0","0","1","1","0","0","0","0","0","0","0","1","1","0","0","0","0","2","0","2","0","0","0","-2"
"117140","University of La Verne","2018","On-tenure track, associate professors","12","5","7","0","0","0","0","0","0","0","0","0","2","1","1","0","0","0","3","1","2","0","0","0","7","3","4","0","0","0","-2"
"117140","University of La Verne","2018","On-tenure track, assistant professors","49","21","28","0","0","0","10","2","8","6","4","2","2","2","0","0","0","0","10","3","7","0","0","0","21","10","11","0","0","0","-2"
"117140","University of La Verne","2018","Not on tenure track/No tenure system system total","59","20","39","1","1","0","2","1","1","4","0","4","7","2","5","0","0","0","34","12","22","0","0","0","11","4","7","0","0","0","-2"
"117140","University of La Verne","2018","Not on tenure/no tenure system, professors","7","3","4","1","1","0","0","0","0","2","0","2","0","0","0","0","0","0","3","2","1","0","0","0","1","0","1","0","0","0","-2"
"117140","University of La Verne","2018","Not on tenure/no tenure system, associate professors","3","1","2","0","0","0","0","0","0","0","0","0","0","0","0","0","0","0","3","1","2","0","0","0","0","0","0","0","0","0","-2"
"117140","University of La Verne","2018","Not on tenure/no tenure system, assistant professors","22","5","17","0","0","0","0","0","0","1","0","1","4","0","4","0","0","0","13","3","10","0","0","0","4","2","2","0","0","0","-2"
"117140","University of La Verne","2018","Not on tenure/no tenure system, instructors","27","11","16","0","0","0","2","1","1","1","0","1","3","2","1","0","0","0","15","6","9","0","0","0","6","2","4","0","0","0","-2"
"117627","La Sierra University","2018","Tenured total","33","24","9","1","1","0","1","1","0","1","1","0","2","2","0","0","0","0","14","6","8","1","1","0","6","5","1","7","7","0","-2"
"117627","La Sierra University","2018","Tenured, professors","16","13","3","1","1","0","0","0","0","0","0","0","1","1","0","0","0","0","3","0","3","1","1","0","5","5","0","5","5","0","-2"
"117627","La Sierra University","2018","Tenured, associate professors","17","11","6","0","0","0","1","1","0","1","1","0","1","1","0","0","0","0","11","6","5","0","0","0","1","0","1","2","2","0","-2"
"117627","La Sierra University","2018","On-Tenure track total","30","15","15","0","0","0","5","2","3","0","0","0","7","5","2","0","0","0","10","5","5","0","0","0","2","1","1","6","2","4","-2"
"117627","La Sierra University","2018","On-tenure track, professors","5","3","2","0","0","0","1","0","1","0","0","0","1","1","0","0","0","0","3","2","1","0","0","0","0","0","0","0","0","0","-2"
"117627","La Sierra University","2018","On-tenure track, associate professors","12","9","3","0","0","0","1","0","1","0","0","0","5","4","1","0","0","0","4","3","1","0","0","0","1","1","0","1","1","0","-2"
"117627","La Sierra University","2018","On-tenure track, assistant professors","10","3","7","0","0","0","3","2","1","0","0","0","1","0","1","0","0","0","2","0","2","0","0","0","1","0","1","3","1","2","-2"
"117627","La Sierra University","2018","On-tenure track, lecturers","3","0","3","0","0","0","0","0","0","0","0","0","0","0","0","0","0","0","1","0","1","0","0","0","0","0","0","2","0","2","-2"
"117627","La Sierra University","2018","Not on tenure track/No tenure system system total","32","14","18","0","0","0","5","2","3","0","0","0","6","3","3","0","0","0","15","5","10","0","0","0","0","0","0","6","4","2","-2"
"117627","La Sierra University","2018","Not on tenure/no tenure system, professors","2","1","1","0","0","0","1","0","1","0","0","0","0","0","0","0","0","0","1","1","0","0","0","0","0","0","0","0","0","0","-2"
"117627","La Sierra University","2018","Not on tenure/no tenure system, associate professors","5","1","4","0","0","0","1","1","0","0","0","0","0","0","0","0","0","0","3","0","3","0","0","0","0","0","0","1","0","1","-2"
"117627","La Sierra University","2018","Not on tenure/no tenure system, assistant professors","17","9","8","0","0","0","0","0","0","0","0","0","6","3","3","0","0","0","8","4","4","0","0","0","0","0","0","3","2","1","-2"
"117627","La Sierra University","2018","Not on tenure/no tenure system, instructors","1","0","1","0","0","0","1","0","1","0","0","0","0","0","0","0","0","0","0","0","0","0","0","0","0","0","0","0","0","0","-2"
"117627","La Sierra University","2018","Not on tenure/no tenure system, lecturers","7","3","4","0","0","0","2","1","1","0","0","0","0","0","0","0","0","0","3","0","3","0","0","0","0","0","0","2","2","0","-2"
"117636","Loma Linda University","2018","Tenured total","20","14","6","0","0","0","2","0","2","1","1","0","1","1","0","0","0","0","14","11","3","0","0","0","0","0","0","2","1","1","-2"
"117636","Loma Linda University","2018","Tenured, professors","14","11","3","0","0","0","1","0","1","1","1","0","1","1","0","0","0","0","11","9","2","0","0","0","0","0","0","0","0","0","-2"
"117636","Loma Linda University","2018","Tenured, associate professors","1","1","0","0","0","0","0","0","0","0","0","0","0","0","0","0","0","0","1","1","0","0","0","0","0","0","0","0","0","0","-2"
"117636","Loma Linda University","2018","Tenured, assistant professors","5","2","3","0","0","0","1","0","1","0","0","0","0","0","0","0","0","0","2","1","1","0","0","0","0","0","0","2","1","1","-2"
"117636","Loma Linda University","2018","On-Tenure track total","50","25","25","0","0","0","6","2","4","4","2","2","5","4","1","1","1","0","34","16","18","0","0","0","0","0","0","0","0","0","-2"
"117636","Loma Linda University","2018","On-tenure track, professors","12","10","2","0","0","0","3","2","1","0","0","0","1","1","0","0","0","0","8","7","1","0","0","0","0","0","0","0","0","0","-2"
"117636","Loma Linda University","2018","On-tenure track, associate professors","16","6","10","0","0","0","2","0","2","1","1","0","0","0","0","0","0","0","13","5","8","0","0","0","0","0","0","0","0","0","-2"
"117636","Loma Linda University","2018","On-tenure track, assistant professors","21","9","12","0","0","0","1","0","1","3","1","2","4","3","1","1","1","0","12","4","8","0","0","0","0","0","0","0","0","0","-2"
"117636","Loma Linda University","2018","On-tenure track, instructors","1","0","1","0","0","0","0","0","0","0","0","0","0","0","0","0","0","0","1","0","1","0","0","0","0","0","0","0","0","0","-2"
"117636","Loma Linda University","2018","Not on tenure track/No tenure system system total","327","137","190","0","0","0","59","22","37","26","10","16","28","15","13","0","0","0","199","80","119","6","3","3","0","0","0","9","7","2","-2"
"117636","Loma Linda University","2018","Not on tenure/no tenure system, professors","33","21","12","0","0","0","4","4","0","3","2","1","3","2","1","0","0","0","23","13","10","0","0","0","0","0","0","0","0","0","-2"
"117636","Loma Linda University","2018","Not on tenure/no tenure system, associate professors","66","32","34","0","0","0","13","6","7","6","4","2","2","2","0","0","0","0","44","20","24","1","0","1","0","0","0","0","0","0","-2"
"117636","Loma Linda University","2018","Not on tenure/no tenure system, assistant professors","194","74","120","0","0","0","37","9","28","15","3","12","17","9","8","0","0","0","113","44","69","4","2","2","0","0","0","8","7","1","-2"
"117636","Loma Linda University","2018","Not on tenure/no tenure system, instructors","34","10","24","0","0","0","5","3","2","2","1","1","6","2","4","0","0","0","19","3","16","1","1","0","0","0","0","1","0","1","-2"
"118541","Marymount California University","2018","Not on tenure track/No tenure system system total","33","18","15","0","0","0","3","2","1","3","2","1","1","1","0","0","0","0","26","13","13","0","0","0","0","0","0","0","0","0","-2"
"118541","Marymount California University","2018","Not on tenure/no tenure system, professors","15","9","6","0","0","0","1","1","0","2","1","1","0","0","0","0","0","0","12","7","5","0","0","0","0","0","0","0","0","0","-2"
"118541","Marymount California University","2018","Not on tenure/no tenure system, associate professors","13","6","7","0","0","0","1","0","1","1","1","0","1","1","0","0","0","0","10","4","6","0","0","0","0","0","0","0","0","0","-2"
"118541","Marymount California University","2018","Not on tenure/no tenure system, assistant professors","5","3","2","0","0","0","1","1","0","0","0","0","0","0","0","0","0","0","4","2","2","0","0","0","0","0","0","0","0","0","-2"
"118693","Menlo College","2018","Not on tenure track/No tenure system system total","25","13","12","0","0","0","6","3","3","1","0","1","0","0","0","0","0","0","17","9","8","1","1","0","0","0","0","0","0","0","-2"
"118693","Menlo College","2018","Not on tenure/no tenure system, professors","11","5","6","0","0","0","3","1","2","1","0","1","0","0","0","0","0","0","7","4","3","0","0","0","0","0","0","0","0","0","-2"
"118693","Menlo College","2018","Not on tenure/no tenure system, associate professors","6","4","2","0","0","0","2","2","0","0","0","0","0","0","0","0","0","0","4","2","2","0","0","0","0","0","0","0","0","0","-2"
"118693","Menlo College","2018","Not on tenure/no tenure system, assistant professors","4","1","3","0","0","0","1","0","1","0","0","0","0","0","0","0","0","0","2","0","2","1","1","0","0","0","0","0","0","0","-2"
"118693","Menlo College","2018","Not on tenure/no tenure system, instructors","1","1","0","0","0","0","0","0","0","0","0","0","0","0","0","0","0","0","1","1","0","0","0","0","0","0","0","0","0","0","-2"
"118693","Menlo College","2018","Not on tenure/no tenure system, lecturers","3","2","1","0","0","0","0","0","0","0","0","0","0","0","0","0","0","0","3","2","1","0","0","0","0","0","0","0","0","0","-2"
"118888","Mills College","2018","Tenured total","41","9","32","0","0","0","4","2","2","2","0","2","5","1","4","0","0","0","24","5","19","4","1","3","1","0","1","1","0","1","-2"
"118888","Mills College","2018","Tenured, professors","29","6","23","0","0","0","2","1","1","2","0","2","4","1","3","0","0","0","17","4","13","2","0","2","1","0","1","1","0","1","-2"
"118888","Mills College","2018","Tenured, associate professors","12","3","9","0","0","0","2","1","1","0","0","0","1","0","1","0","0","0","7","1","6","2","1","1","0","0","0","0","0","0","-2"
"118888","Mills College","2018","On-Tenure track total","11","5","6","1","0","1","1","1","0","2","0","2","1","1","0","1","1","0","5","2","3","0","0","0","0","0","0","0","0","0","-2"
"118888","Mills College","2018","On-tenure track, professors","1","0","1","0","0","0","0","0","0","1","0","1","0","0","0","0","0","0","0","0","0","0","0","0","0","0","0","0","0","0","-2"
"118888","Mills College","2018","On-tenure track, assistant professors","10","5","5","1","0","1","1","1","0","1","0","1","1","1","0","1","1","0","5","2","3","0","0","0","0","0","0","0","0","0","-2"
"118888","Mills College","2018","Not on tenure track/No tenure system system total","25","5","20","0","0","0","3","0","3","2","1","1","1","0","1","0","0","0","16","4","12","2","0","2","0","0","0","1","0","1","-2"
"118888","Mills College","2018","Not on tenure/no tenure system, professors","10","4","6","0","0","0","1","0","1","1","1","0","0","0","0","0","0","0","7","3","4","1","0","1","0","0","0","0","0","0","-2"
"118888","Mills College","2018","Not on tenure/no tenure system, associate professors","2","0","2","0","0","0","0","0","0","0","0","0","0","0","0","0","0","0","2","0","2","0","0","0","0","0","0","0","0","0","-2"
"118888","Mills College","2018","Not on tenure/no tenure system, assistant professors","12","1","11","0","0","0","2","0","2","1","0","1","1","0","1","0","0","0","6","1","5","1","0","1","0","0","0","1","0","1","-2"
"118888","Mills College","2018","Not on tenure/no tenure system, no academic rank","1","0","1","0","0","0","0","0","0","0","0","0","0","0","0","0","0","0","1","0","1","0","0","0","0","0","0","0","0","0","-2"
"118912","MiraCosta College","2018","Tenured total","145","65","80","0","0","0","1","0","1","8","5","3","29","10","19","0","0","0","92","43","49","1","0","1","14","7","7","0","0","0","-2"
"118912","MiraCosta College","2018","Tenured, instructors","145","65","80","0","0","0","1","0","1","8","5","3","29","10","19","0","0","0","92","43","49","1","0","1","14","7","7","0","0","0","-2"
"118912","MiraCosta College","2018","On-Tenure track total","50","18","32","1","0","1","2","0","2","1","0","1","10","3","7","0","0","0","27","9","18","1","1","0","8","5","3","0","0","0","-2"
"118912","MiraCosta College","2018","On-tenure track, instructors","50","18","32","1","0","1","2","0","2","1","0","1","10","3","7","0","0","0","27","9","18","1","1","0","8","5","3","0","0","0","-2"
"118976","Modesto Junior College","2018","Tenured total","101","43","58","1","0","1","4","1","3","7","2","5","10","6","4","0","0","0","70","32","38","0","0","0","9","2","7","0","0","0","-2"
"118976","Modesto Junior College","2018","Tenured, instructors","101","43","58","1","0","1","4","1","3","7","2","5","10","6","4","0","0","0","70","32","38","0","0","0","9","2","7","0","0","0","-2"
"118976","Modesto Junior College","2018","On-Tenure track total","58","39","19","0","0","0","3","1","2","1","1","0","8","3","5","0","0","0","42","31","11","0","0","0","4","3","1","0","0","0","-2"
"118976","Modesto Junior College","2018","On-tenure track, instructors","58","39","19","0","0","0","3","1","2","1","1","0","8","3","5","0","0","0","42","31","11","0","0","0","4","3","1","0","0","0","-2"
"118976","Modesto Junior College","2018","Not on tenure track/No tenure system system total","99","37","62","2","1","1","4","0","4","7","3","4","19","7","12","1","0","1","62","26","36","1","0","1","2","0","2","1","0","1","-2"
"118976","Modesto Junior College","2018","Not on tenure/no tenure system, instructors","99","37","62","2","1","1","4","0","4","7","3","4","19","7","12","1","0","1","62","26","36","1","0","1","2","0","2","1","0","1","-2"
"119173","Mount Saint Mary's University","2018","Tenured total","56","15","41","0","0","0","5","2","3","5","0","5","5","2","3","0","0","0","41","11","30","0","0","0","0","0","0","0","0","0","-2"
"119173","Mount Saint Mary's University","2018","Tenured, professors","29","9","20","0","0","0","3","1","2","0","0","0","2","1","1","0","0","0","24","7","17","0","0","0","0","0","0","0","0","0","-2"
"119173","Mount Saint Mary's University","2018","Tenured, associate professors","17","4","13","0","0","0","2","1","1","2","0","2","3","1","2","0","0","0","10","2","8","0","0","0","0","0","0","0","0","0","-2"
"119173","Mount Saint Mary's University","2018","Tenured, assistant professors","10","2","8","0","0","0","0","0","0","3","0","3","0","0","0","0","0","0","7","2","5","0","0","0","0","0","0","0","0","0","-2"
"119173","Mount Saint Mary's University","2018","On-Tenure track total","32","11","21","0","0","0","4","1","3","4","1","3","4","1","3","0","0","0","16","7","9","1","0","1","3","1","2","0","0","0","-2"
"119173","Mount Saint Mary's University","2018","On-tenure track, professors","1","1","0","0","0","0","0","0","0","0","0","0","0","0","0","0","0","0","1","1","0","0","0","0","0","0","0","0","0","0","-2"
"119173","Mount Saint Mary's University","2018","On-tenure track, associate professors","11","4","7","0","0","0","2","0","2","2","1","1","0","0","0","0","0","0","7","3","4","0","0","0","0","0","0","0","0","0","-2"
"119173","Mount Saint Mary's University","2018","On-tenure track, assistant professors","20","6","14","0","0","0","2","1","1","2","0","2","4","1","3","0","0","0","8","3","5","1","0","1","3","1","2","0","0","0","-2"
"119173","Mount Saint Mary's University","2018","Not on tenure track/No tenure system system total","47","14","33","0","0","0","5","2","3","3","1","2","9","4","5","0","0","0","26","7","19","2","0","2","1","0","1","1","0","1","-2"
"119173","Mount Saint Mary's University","2018","Not on tenure/no tenure system, professors","1","0","1","0","0","0","0","0","0","0","0","0","0","0","0","0","0","0","1","0","1","0","0","0","0","0","0","0","0","0","-2"
"119173","Mount Saint Mary's University","2018","Not on tenure/no tenure system, associate professors","3","1","2","0","0","0","0","0","0","0","0","0","1","1","0","0","0","0","2","0","2","0","0","0","0","0","0","0","0","0","-2"
"119173","Mount Saint Mary's University","2018","Not on tenure/no tenure system, assistant professors","26","7","19","0","0","0","5","2","3","2","1","1","2","1","1","0","0","0","14","3","11","2","0","2","0","0","0","1","0","1","-2"
"119173","Mount Saint Mary's University","2018","Not on tenure/no tenure system, instructors","17","6","11","0","0","0","0","0","0","1","0","1","6","2","4","0","0","0","9","4","5","0","0","0","1","0","1","0","0","0","-2"
"119605","National University","2018","Not on tenure track/No tenure system system total","265","119","146","1","1","0","29","17","12","16","4","12","20","7","13","1","0","1","173","85","88","5","1","4","20","4","16","0","0","0","-2"
"119605","National University","2018","Not on tenure/no tenure system, professors","117","67","50","1","1","0","17","11","6","4","2","2","8","3","5","0","0","0","76","47","29","1","0","1","10","3","7","0","0","0","-2"
"119605","National University","2018","Not on tenure/no tenure system, associate professors","78","31","47","0","0","0","5","3","2","5","2","3","4","2","2","1","0","1","56","23","33","3","1","2","4","0","4","0","0","0","-2"
"119605","National University","2018","Not on tenure/no tenure system, assistant professors","70","21","49","0","0","0","7","3","4","7","0","7","8","2","6","0","0","0","41","15","26","1","0","1","6","1","5","0","0","0","-2"
"120184","Notre Dame de Namur University","2018","Tenured total","26","14","12","0","0","0","5","2","3","1","1","0","1","1","0","0","0","0","19","10","9","0","0","0","0","0","0","0","0","0","-2"
"120184","Notre Dame de Namur University","2018","Tenured, professors","23","14","9","0","0","0","5","2","3","1","1","0","1","1","0","0","0","0","16","10","6","0","0","0","0","0","0","0","0","0","-2"
"120184","Notre Dame de Namur University","2018","Tenured, associate professors","3","0","3","0","0","0","0","0","0","0","0","0","0","0","0","0","0","0","3","0","3","0","0","0","0","0","0","0","0","0","-2"
"120184","Notre Dame de Namur University","2018","On-Tenure track total","3","0","3","0","0","0","2","0","2","0","0","0","0","0","0","0","0","0","1","0","1","0","0","0","0","0","0","0","0","0","-2"
"120184","Notre Dame de Namur University","2018","On-tenure track, associate professors","1","0","1","0","0","0","0","0","0","0","0","0","0","0","0","0","0","0","1","0","1","0","0","0","0","0","0","0","0","0","-2"
"120184","Notre Dame de Namur University","2018","On-tenure track, assistant professors","2","0","2","0","0","0","2","0","2","0","0","0","0","0","0","0","0","0","0","0","0","0","0","0","0","0","0","0","0","0","-2"
"120184","Notre Dame de Namur University","2018","Not on tenure track/No tenure system system total","11","3","8","0","0","0","2","1","1","1","0","1","0","0","0","0","0","0","8","2","6","0","0","0","0","0","0","0","0","0","-2"
"120184","Notre Dame de Namur University","2018","Not on tenure/no tenure system, associate professors","3","2","1","0","0","0","2","1","1","0","0","0","0","0","0","0","0","0","1","1","0","0","0","0","0","0","0","0","0","0","-2"
"120184","Notre Dame de Namur University","2018","Not on tenure/no tenure system, assistant professors","7","1","6","0","0","0","0","0","0","1","0","1","0","0","0","0","0","0","6","1","5","0","0","0","0","0","0","0","0","0","-2"
"120184","Notre Dame de Namur University","2018","Not on tenure/no tenure system, instructors","1","0","1","0","0","0","0","0","0","0","0","0","0","0","0","0","0","0","1","0","1","0","0","0","0","0","0","0","0","0","-2"
"120537","Hope International University","2018","Not on tenure track/No tenure system system total","31","12","19","0","0","0","2","1","1","3","1","2","1","1","0","0","0","0","25","9","16","0","0","0","0","0","0","0","0","0","-2"
"120537","Hope International University","2018","Not on tenure/no tenure system, professors","4","2","2","0","0","0","1","1","0","0","0","0","0","0","0","0","0","0","3","1","2","0","0","0","0","0","0","0","0","0","-2"
"120537","Hope International University","2018","Not on tenure/no tenure system, associate professors","19","7","12","0","0","0","1","0","1","2","1","1","1","1","0","0","0","0","15","5","10","0","0","0","0","0","0","0","0","0","-2"
"120537","Hope International University","2018","Not on tenure/no tenure system, assistant professors","8","3","5","0","0","0","0","0","0","1","0","1","0","0","0","0","0","0","7","3","4","0","0","0","0","0","0","0","0","0","-2"
"120768","Pacific Oaks College","2018","Not on tenure track/No tenure system system total","14","4","10","0","0","0","0","0","0","6","2","4","2","1","1","0","0","0","6","1","5","0","0","0","0","0","0","0","0","0","-2"
"120768","Pacific Oaks College","2018","Not on tenure/no tenure system, no academic rank","14","4","10","0","0","0","0","0","0","6","2","4","2","1","1","0","0","0","6","1","5","0","0","0","0","0","0","0","0","0","-2"
"120865","Pacific Union College","2018","Tenured total","34","18","16","0","0","0","2","1","1","0","0","0","1","0","1","0","0","0","25","13","12","2","1","1","4","3","1","0","0","0","-2"
"120865","Pacific Union College","2018","Tenured, professors","26","14","12","0","0","0","2","1","1","0","0","0","1","0","1","0","0","0","17","9","8","2","1","1","4","3","1","0","0","0","-2"
"120865","Pacific Union College","2018","Tenured, associate professors","8","4","4","0","0","0","0","0","0","0","0","0","0","0","0","0","0","0","8","4","4","0","0","0","0","0","0","0","0","0","-2"
"120865","Pacific Union College","2018","On-Tenure track total","30","18","12","0","0","0","8","5","3","1","1","0","0","0","0","0","0","0","15","10","5","3","1","2","3","1","2","0","0","0","-2"
"120865","Pacific Union College","2018","On-tenure track, professors","6","3","3","0","0","0","2","2","0","0","0","0","0","0","0","0","0","0","2","1","1","2","0","2","0","0","0","0","0","0","-2"
"120865","Pacific Union College","2018","On-tenure track, associate professors","8","7","1","0","0","0","2","2","0","0","0","0","0","0","0","0","0","0","6","5","1","0","0","0","0","0","0","0","0","0","-2"
"120865","Pacific Union College","2018","On-tenure track, assistant professors","14","6","8","0","0","0","4","1","3","1","1","0","0","0","0","0","0","0","6","3","3","0","0","0","3","1","2","0","0","0","-2"
"120865","Pacific Union College","2018","On-tenure track, instructors","2","2","0","0","0","0","0","0","0","0","0","0","0","0","0","0","0","0","1","1","0","1","1","0","0","0","0","0","0","0","-2"
"120865","Pacific Union College","2018","Not on tenure track/No tenure system system total","18","7","11","0","0","0","3","2","1","2","1","1","2","0","2","0","0","0","10","4","6","0","0","0","1","0","1","0","0","0","-2"
"120865","Pacific Union College","2018","Not on tenure/no tenure system, professors","1","1","0","0","0","0","1","1","0","0","0","0","0","0","0","0","0","0","0","0","0","0","0","0","0","0","0","0","0","0","-2"
"120865","Pacific Union College","2018","Not on tenure/no tenure system, associate professors","3","1","2","0","0","0","0","0","0","0","0","0","0","0","0","0","0","0","2","1","1","0","0","0","1","0","1","0","0","0","-2"
"120865","Pacific Union College","2018","Not on tenure/no tenure system, assistant professors","11","3","8","0","0","0","1","0","1","2","1","1","2","0","2","0","0","0","6","2","4","0","0","0","0","0","0","0","0","0","-2"
"120865","Pacific Union College","2018","Not on tenure/no tenure system, instructors","3","2","1","0","0","0","1","1","0","0","0","0","0","0","0","0","0","0","2","1","1","0","0","0","0","0","0","0","0","0","-2"
"121619","Santa Ana College","2018","Tenured total","100","44","56","2","1","1","9","3","6","1","0","1","25","10","15","0","0","0","61","29","32","0","0","0","1","0","1","1","1","0","-2"
"121619","Santa Ana College","2018","Tenured, instructors","100","44","56","2","1","1","9","3","6","1","0","1","25","10","15","0","0","0","61","29","32","0","0","0","1","0","1","1","1","0","-2"
"121619","Santa Ana College","2018","On-Tenure track total","142","66","76","0","0","0","26","13","13","4","2","2","34","14","20","0","0","0","64","28","36","0","0","0","10","8","2","4","1","3","-2"
"121619","Santa Ana College","2018","On-tenure track, instructors","142","66","76","0","0","0","26","13","13","4","2","2","34","14","20","0","0","0","64","28","36","0","0","0","10","8","2","4","1","3","-2"
"121619","Santa Ana College","2018","Not on tenure track/No tenure system system total","1","0","1","0","0","0","0","0","0","0","0","0","0","0","0","0","0","0","1","0","1","0","0","0","0","0","0","0","0","0","-2"
"121619","Santa Ana College","2018","Not on tenure/no tenure system, instructors","1","0","1","0","0","0","0","0","0","0","0","0","0","0","0","0","0","0","1","0","1","0","0","0","0","0","0","0","0","0","-2"
"121691","University of Redlands","2018","Tenured total","149","74","75","1","1","0","20","11","9","4","2","2","5","3","2","0","0","0","117","56","61","0","0","0","2","1","1","0","0","0","-2"
"121691","University of Redlands","2018","Tenured, professors","117","58","59","0","0","0","13","8","5","3","2","1","3","2","1","0","0","0","96","45","51","0","0","0","2","1","1","0","0","0","-2"
"121691","University of Redlands","2018","Tenured, associate professors","32","16","16","1","1","0","7","3","4","1","0","1","2","1","1","0","0","0","21","11","10","0","0","0","0","0","0","0","0","0","-2"
"121691","University of Redlands","2018","On-Tenure track total","23","13","10","0","0","0","3","2","1","1","0","1","3","1","2","0","0","0","12","9","3","0","0","0","4","1","3","0","0","0","-2"
"121691","University of Redlands","2018","On-tenure track, associate professors","6","4","2","0","0","0","2","1","1","0","0","0","1","0","1","0","0","0","3","3","0","0","0","0","0","0","0","0","0","0","-2"
"121691","University of Redlands","2018","On-tenure track, assistant professors","17","9","8","0","0","0","1","1","0","1","0","1","2","1","1","0","0","0","9","6","3","0","0","0","4","1","3","0","0","0","-2"
"121691","University of Redlands","2018","Not on tenure track/No tenure system system total","43","18","25","1","0","1","3","2","1","4","2","2","3","1","2","0","0","0","26","9","17","0","0","0","6","4","2","0","0","0","-2"
"121691","University of Redlands","2018","Not on tenure/no tenure system, professors","2","2","0","0","0","0","1","1","0","0","0","0","0","0","0","0","0","0","1","1","0","0","0","0","0","0","0","0","0","0","-2"
"121691","University of Redlands","2018","Not on tenure/no tenure system, lecturers","9","4","5","0","0","0","0","0","0","1","1","0","1","1","0","0","0","0","7","2","5","0","0","0","0","0","0","0","0","0","-2"
"121691","University of Redlands","2018","Not on tenure/no tenure system, no academic rank","32","12","20","1","0","1","2","1","1","3","1","2","2","0","2","0","0","0","18","6","12","0","0","0","6","4","2","0","0","0","-2"
"121886","Rio Hondo College","2018","Tenured total","141","72","69","3","3","0","13","6","7","4","2","2","45","20","25","0","0","0","71","38","33","3","3","0","1","0","1","1","0","1","-2"
"121886","Rio Hondo College","2018","Tenured, instructors","141","72","69","3","3","0","13","6","7","4","2","2","45","20","25","0","0","0","71","38","33","3","3","0","1","0","1","1","0","1","-2"
"121886","Rio Hondo College","2018","On-Tenure track total","62","24","38","0","0","0","9","3","6","1","0","1","25","9","16","1","0","1","21","12","9","1","0","1","3","0","3","1","0","1","-2"
"121886","Rio Hondo College","2018","On-tenure track, instructors","62","24","38","0","0","0","9","3","6","1","0","1","25","9","16","1","0","1","21","12","9","1","0","1","3","0","3","1","0","1","-2"
"122375","San Diego Mesa College","2018","Tenured total","23","15","8","0","0","0","2","0","2","3","2","1","2","2","0","0","0","0","15","11","4","0","0","0","1","0","1","0","0","0","-2"
"122375","San Diego Mesa College","2018","Tenured, instructors","23","15","8","0","0","0","2","0","2","3","2","1","2","2","0","0","0","0","15","11","4","0","0","0","1","0","1","0","0","0","-2"
"122375","San Diego Mesa College","2018","On-Tenure track total","234","107","127","0","0","0","16","3","13","16","6","10","30","16","14","1","1","0","125","57","68","2","2","0","43","22","21","1","0","1","-2"
"122375","San Diego Mesa College","2018","On-tenure track, instructors","234","107","127","0","0","0","16","3","13","16","6","10","30","16","14","1","1","0","125","57","68","2","2","0","43","22","21","1","0","1","-2"
"122375","San Diego Mesa College","2018","Not on tenure track/No tenure system system total","24","11","13","0","0","0","0","0","0","2","2","0","1","0","1","0","0","0","17","6","11","0","0","0","4","3","1","0","0","0","-2"
"122375","San Diego Mesa College","2018","Not on tenure/no tenure system, instructors","24","11","13","0","0","0","0","0","0","2","2","0","1","0","1","0","0","0","17","6","11","0","0","0","4","3","1","0","0","0","-2"
"122977","Santa Monica College","2018","Tenured total","211","96","115","0","0","0","27","11","16","24","11","13","26","10","16","1","0","1","113","58","55","1","0","1","2","1","1","17","5","12","-2"
"122977","Santa Monica College","2018","Tenured, instructors","211","96","115","0","0","0","27","11","16","24","11","13","26","10","16","1","0","1","113","58","55","1","0","1","2","1","1","17","5","12","-2"
"122977","Santa Monica College","2018","On-Tenure track total","105","43","62","0","0","0","6","1","5","12","3","9","13","6","7","0","0","0","49","22","27","2","0","2","0","0","0","23","11","12","-2"
"122977","Santa Monica College","2018","On-tenure track, instructors","105","43","62","0","0","0","6","1","5","12","3","9","13","6","7","0","0","0","49","22","27","2","0","2","0","0","0","23","11","12","-2"
"122977","Santa Monica College","2018","Not on tenure track/No tenure system system total","17","5","12","0","0","0","3","2","1","2","0","2","5","1","4","0","0","0","6","1","5","0","0","0","1","1","0","0","0","0","-2"
"122977","Santa Monica College","2018","Not on tenure/no tenure system, instructors","17","5","12","0","0","0","3","2","1","2","0","2","5","1","4","0","0","0","6","1","5","0","0","0","1","1","0","0","0","0","-2"
"123509","Skyline College","2018","Tenured total","100","48","52","0","0","0","20","9","11","9","7","2","15","7","8","0","0","0","47","21","26","0","0","0","9","4","5","0","0","0","-2"
"123509","Skyline College","2018","Tenured, instructors","100","48","52","0","0","0","20","9","11","9","7","2","15","7","8","0","0","0","47","21","26","0","0","0","9","4","5","0","0","0","-2"
"123509","Skyline College","2018","On-Tenure track total","35","15","20","1","1","0","8","3","5","8","3","5","6","4","2","0","0","0","9","3","6","1","0","1","1","1","0","1","0","1","-2"
"123509","Skyline College","2018","On-tenure track, instructors","35","15","20","1","1","0","8","3","5","8","3","5","6","4","2","0","0","0","9","3","6","1","0","1","1","1","0","1","0","1","-2"
"123509","Skyline College","2018","Not on tenure track/No tenure system system total","7","6","1","0","0","0","1","1","0","0","0","0","0","0","0","0","0","0","3","3","0","1","1","0","2","1","1","0","0","0","-2"
"123509","Skyline College","2018","Not on tenure/no tenure system, instructors","7","6","1","0","0","0","1","1","0","0","0","0","0","0","0","0","0","0","3","3","0","1","1","0","2","1","1","0","0","0","-2"
"123554","Saint Mary's College of California","2018","Tenured total","132","66","66","1","0","1","17","7","10","3","1","2","9","3","6","0","0","0","86","48","38","0","0","0","10","5","5","6","2","4","-2"
"123554","Saint Mary's College of California","2018","Tenured, professors","77","44","33","1","0","1","11","5","6","1","0","1","4","2","2","0","0","0","57","35","22","0","0","0","3","2","1","0","0","0","-2"
"123554","Saint Mary's College of California","2018","Tenured, associate professors","55","22","33","0","0","0","6","2","4","2","1","1","5","1","4","0","0","0","29","13","16","0","0","0","7","3","4","6","2","4","-2"
"123554","Saint Mary's College of California","2018","On-Tenure track total","61","18","43","0","0","0","5","0","5","6","1","5","11","3","8","0","0","0","18","9","9","0","0","0","13","4","9","8","1","7","-2"
"123554","Saint Mary's College of California","2018","On-tenure track, associate professors","12","4","8","0","0","0","2","0","2","0","0","0","2","0","2","0","0","0","4","2","2","0","0","0","3","1","2","1","1","0","-2"
"123554","Saint Mary's College of California","2018","On-tenure track, assistant professors","49","14","35","0","0","0","3","0","3","6","1","5","9","3","6","0","0","0","14","7","7","0","0","0","10","3","7","7","0","7","-2"
"123554","Saint Mary's College of California","2018","Not on tenure track/No tenure system system total","27","11","16","0","0","0","3","1","2","0","0","0","2","0","2","0","0","0","15","7","8","0","0","0","5","2","3","2","1","1","-2"
"123554","Saint Mary's College of California","2018","Not on tenure/no tenure system, associate professors","13","5","8","0","0","0","2","0","2","0","0","0","0","0","0","0","0","0","8","4","4","0","0","0","3","1","2","0","0","0","-2"
"123554","Saint Mary's College of California","2018","Not on tenure/no tenure system, assistant professors","14","6","8","0","0","0","1","1","0","0","0","0","2","0","2","0","0","0","7","3","4","0","0","0","2","1","1","2","1","1","-2"
"123563","Solano Community College","2018","Tenured total","88","39","49","0","0","0","5","2","3","8","3","5","9","3","6","0","0","0","66","31","35","0","0","0","0","0","0","0","0","0","-2"
"123563","Solano Community College","2018","Tenured, instructors","88","39","49","0","0","0","5","2","3","8","3","5","9","3","6","0","0","0","66","31","35","0","0","0","0","0","0","0","0","0","-2"
"123563","Solano Community College","2018","On-Tenure track total","47","18","29","0","0","0","3","0","3","7","3","4","5","4","1","0","0","0","32","11","21","0","0","0","0","0","0","0","0","0","-2"
"123563","Solano Community College","2018","On-tenure track, instructors","47","18","29","0","0","0","3","0","3","7","3","4","5","4","1","0","0","0","32","11","21","0","0","0","0","0","0","0","0","0","-2"
"123563","Solano Community College","2018","Not on tenure track/No tenure system system total","8","2","6","0","0","0","1","0","1","0","0","0","0","0","0","0","0","0","6","2","4","1","0","1","0","0","0","0","0","0","-2"
"123563","Solano Community College","2018","Not on tenure/no tenure system, instructors","8","2","6","0","0","0","1","0","1","0","0","0","0","0","0","0","0","0","6","2","4","1","0","1","0","0","0","0","0","0","-2"
"123572","Sonoma State University","2018","Tenured total","165","89","76","0","0","0","16","12","4","3","0","3","11","4","7","0","0","0","129","68","61","2","2","0","4","3","1","0","0","0","-2"
"123572","Sonoma State University","2018","Tenured, professors","133","72","61","0","0","0","13","9","4","2","0","2","8","3","5","0","0","0","106","56","50","2","2","0","2","2","0","0","0","0","-2"
"123572","Sonoma State University","2018","Tenured, associate professors","32","17","15","0","0","0","3","3","0","1","0","1","3","1","2","0","0","0","23","12","11","0","0","0","2","1","1","0","0","0","-2"
"123572","Sonoma State University","2018","On-Tenure track total","74","29","45","1","0","1","7","4","3","0","0","0","8","5","3","0","0","0","40","14","26","3","0","3","6","2","4","9","4","5","-2"
"123572","Sonoma State University","2018","On-tenure track, professors","1","1","0","0","0","0","0","0","0","0","0","0","0","0","0","0","0","0","1","1","0","0","0","0","0","0","0","0","0","0","-2"
"123572","Sonoma State University","2018","On-tenure track, associate professors","3","2","1","0","0","0","0","0","0","0","0","0","0","0","0","0","0","0","2","1","1","0","0","0","0","0","0","1","1","0","-2"
"123572","Sonoma State University","2018","On-tenure track, assistant professors","70","26","44","1","0","1","7","4","3","0","0","0","8","5","3","0","0","0","37","12","25","3","0","3","6","2","4","8","3","5","-2"
"123572","Sonoma State University","2018","Not on tenure track/No tenure system system total","34","17","17","0","0","0","0","0","0","0","0","0","2","1","1","0","0","0","25","12","13","0","0","0","6","3","3","1","1","0","-2"
"123572","Sonoma State University","2018","Not on tenure/no tenure system, lecturers","34","17","17","0","0","0","0","0","0","0","0","0","2","1","1","0","0","0","25","12","13","0","0","0","6","3","3","1","1","0","-2"
"123651","Vanguard University of Southern California","2018","Tenured total","44","19","25","0","0","0","1","0","1","1","1","0","0","0","0","0","0","0","41","18","23","1","0","1","0","0","0","0","0","0","-2"
"123651","Vanguard University of Southern California","2018","Tenured, professors","29","17","12","0","0","0","0","0","0","0","0","0","0","0","0","0","0","0","28","17","11","1","0","1","0","0","0","0","0","0","-2"
"123651","Vanguard University of Southern California","2018","Tenured, associate professors","14","2","12","0","0","0","1","0","1","1","1","0","0","0","0","0","0","0","12","1","11","0","0","0","0","0","0","0","0","0","-2"
"123651","Vanguard University of Southern California","2018","Tenured, assistant professors","1","0","1","0","0","0","0","0","0","0","0","0","0","0","0","0","0","0","1","0","1","0","0","0","0","0","0","0","0","0","-2"
"123651","Vanguard University of Southern California","2018","On-Tenure track total","24","11","13","0","0","0","5","3","2","3","2","1","2","1","1","0","0","0","13","5","8","1","0","1","0","0","0","0","0","0","-2"
"123651","Vanguard University of Southern California","2018","On-tenure track, professors","1","1","0","0","0","0","0","0","0","0","0","0","0","0","0","0","0","0","1","1","0","0","0","0","0","0","0","0","0","0","-2"
"123651","Vanguard University of Southern California","2018","On-tenure track, associate professors","5","2","3","0","0","0","2","1","1","1","1","0","0","0","0","0","0","0","2","0","2","0","0","0","0","0","0","0","0","0","-2"
"123651","Vanguard University of Southern California","2018","On-tenure track, assistant professors","18","8","10","0","0","0","3","2","1","2","1","1","2","1","1","0","0","0","10","4","6","1","0","1","0","0","0","0","0","0","-2"
"123651","Vanguard University of Southern California","2018","Not on tenure track/No tenure system system total","9","2","7","0","0","0","0","0","0","0","0","0","0","0","0","0","0","0","8","2","6","0","0","0","0","0","0","1","0","1","-2"
"123651","Vanguard University of Southern California","2018","Not on tenure/no tenure system, associate professors","1","1","0","0","0","0","0","0","0","0","0","0","0","0","0","0","0","0","1","1","0","0","0","0","0","0","0","0","0","0","-2"
"123651","Vanguard University of Southern California","2018","Not on tenure/no tenure system, assistant professors","7","1","6","0","0","0","0","0","0","0","0","0","0","0","0","0","0","0","6","1","5","0","0","0","0","0","0","1","0","1","-2"
"123651","Vanguard University of Southern California","2018","Not on tenure/no tenure system, no academic rank","1","0","1","0","0","0","0","0","0","0","0","0","0","0","0","0","0","0","1","0","1","0","0","0","0","0","0","0","0","0","-2"
"125471","West Los Angeles College","2018","Tenured total","80","37","43","0","0","0","10","6","4","13","8","5","11","4","7","1","0","1","33","15","18","0","0","0","11","4","7","1","0","1","-2"
"125471","West Los Angeles College","2018","Tenured, instructors","80","37","43","0","0","0","10","6","4","13","8","5","11","4","7","1","0","1","33","15","18","0","0","0","11","4","7","1","0","1","-2"
"125471","West Los Angeles College","2018","On-Tenure track total","36","14","22","0","0","0","3","2","1","2","1","1","6","2","4","0","0","0","9","4","5","0","0","0","16","5","11","0","0","0","-2"
"125471","West Los Angeles College","2018","On-tenure track, instructors","36","14","22","0","0","0","3","2","1","2","1","1","6","2","4","0","0","0","9","4","5","0","0","0","16","5","11","0","0","0","-2"
"125471","West Los Angeles College","2018","Not on tenure track/No tenure system system total","4","1","3","0","0","0","0","0","0","0","0","0","0","0","0","0","0","0","3","0","3","0","0","0","1","1","0","0","0","0","-2"
"125471","West Los Angeles College","2018","Not on tenure/no tenure system, instructors","4","1","3","0","0","0","0","0","0","0","0","0","0","0","0","0","0","0","3","0","3","0","0","0","1","1","0","0","0","0","-2"
"125763","Whittier College","2018","Tenured total","76","40","36","0","0","0","3","1","2","2","0","2","11","8","3","0","0","0","53","26","27","1","1","0","0","0","0","6","4","2","-2"
"125763","Whittier College","2018","Tenured, professors","38","23","15","0","0","0","1","1","0","1","0","1","3","2","1","0","0","0","30","18","12","0","0","0","0","0","0","3","2","1","-2"
"125763","Whittier College","2018","Tenured, associate professors","38","17","21","0","0","0","2","0","2","1","0","1","8","6","2","0","0","0","23","8","15","1","1","0","0","0","0","3","2","1","-2"
"125763","Whittier College","2018","On-Tenure track total","18","9","9","1","0","1","0","0","0","2","0","2","2","0","2","0","0","0","12","8","4","1","1","0","0","0","0","0","0","0","-2"
"125763","Whittier College","2018","On-tenure track, associate professors","4","3","1","0","0","0","0","0","0","0","0","0","0","0","0","0","0","0","4","3","1","0","0","0","0","0","0","0","0","0","-2"
"125763","Whittier College","2018","On-tenure track, assistant professors","14","6","8","1","0","1","0","0","0","2","0","2","2","0","2","0","0","0","8","5","3","1","1","0","0","0","0","0","0","0","-2"
"125763","Whittier College","2018","Not on tenure track/No tenure system system total","36","18","18","0","0","0","4","1","3","0","0","0","8","4","4","0","0","0","22","13","9","1","0","1","1","0","1","0","0","0","-2"
"125763","Whittier College","2018","Not on tenure/no tenure system, professors","2","1","1","0","0","0","0","0","0","0","0","0","0","0","0","0","0","0","2","1","1","0","0","0","0","0","0","0","0","0","-2"
"125763","Whittier College","2018","Not on tenure/no tenure system, associate professors","2","1","1","0","0","0","0","0","0","0","0","0","0","0","0","0","0","0","2","1","1","0","0","0","0","0","0","0","0","0","-2"
"125763","Whittier College","2018","Not on tenure/no tenure system, assistant professors","23","13","10","0","0","0","3","0","3","0","0","0","5","4","1","0","0","0","14","9","5","1","0","1","0","0","0","0","0","0","-2"
"125763","Whittier College","2018","Not on tenure/no tenure system, instructors","4","1","3","0","0","0","0","0","0","0","0","0","0","0","0","0","0","0","3","1","2","0","0","0","1","0","1","0","0","0","-2"
"125763","Whittier College","2018","Not on tenure/no tenure system, lecturers","5","2","3","0","0","0","1","1","0","0","0","0","3","0","3","0","0","0","1","1","0","0","0","0","0","0","0","0","0","0","-2"
"125897","Woodbury University","2018","Not on tenure track/No tenure system system total","63","36","27","0","0","0","8","4","4","0","0","0","3","2","1","0","0","0","47","27","20","0","0","0","5","3","2","0","0","0","-2"
"125897","Woodbury University","2018","Not on tenure/no tenure system, professors","21","12","9","0","0","0","4","3","1","0","0","0","0","0","0","0","0","0","17","9","8","0","0","0","0","0","0","0","0","0","-2"
"125897","Woodbury University","2018","Not on tenure/no tenure system, associate professors","26","16","10","0","0","0","3","0","3","0","0","0","2","2","0","0","0","0","18","11","7","0","0","0","3","3","0","0","0","0","-2"
"125897","Woodbury University","2018","Not on tenure/no tenure system, assistant professors","16","8","8","0","0","0","1","1","0","0","0","0","1","0","1","0","0","0","12","7","5","0","0","0","2","0","2","0","0","0","-2"
"126182","Adams State University","2018","Tenured total","44","23","21","0","0","0","0","0","0","0","0","0","10","4","6","1","0","1","31","17","14","0","0","0","2","2","0","0","0","0","-2"
"126182","Adams State University","2018","Tenured, professors","25","14","11","0","0","0","0","0","0","0","0","0","4","2","2","0","0","0","20","11","9","0","0","0","1","1","0","0","0","0","-2"
"126182","Adams State University","2018","Tenured, associate professors","15","6","9","0","0","0","0","0","0","0","0","0","4","1","3","1","0","1","9","4","5","0","0","0","1","1","0","0","0","0","-2"
"126182","Adams State University","2018","Tenured, assistant professors","4","3","1","0","0","0","0","0","0","0","0","0","2","1","1","0","0","0","2","2","0","0","0","0","0","0","0","0","0","0","-2"
"126182","Adams State University","2018","On-Tenure track total","11","6","5","0","0","0","0","0","0","0","0","0","1","1","0","0","0","0","9","4","5","0","0","0","1","1","0","0","0","0","-2"
"126182","Adams State University","2018","On-tenure track, associate professors","1","1","0","0","0","0","0","0","0","0","0","0","0","0","0","0","0","0","0","0","0","0","0","0","1","1","0","0","0","0","-2"
"126182","Adams State University","2018","On-tenure track, assistant professors","9","4","5","0","0","0","0","0","0","0","0","0","1","1","0","0","0","0","8","3","5","0","0","0","0","0","0","0","0","0","-2"
"126182","Adams State University","2018","On-tenure track, no academic rank","1","1","0","0","0","0","0","0","0","0","0","0","0","0","0","0","0","0","1","1","0","0","0","0","0","0","0","0","0","0","-2"
"126182","Adams State University","2018","Not on tenure track/No tenure system system total","42","19","23","0","0","0","1","1","0","0","0","0","7","2","5","1","1","0","32","14","18","0","0","0","1","1","0","0","0","0","-2"
"126182","Adams State University","2018","Not on tenure/no tenure system, no academic rank","42","19","23","0","0","0","1","1","0","0","0","0","7","2","5","1","1","0","32","14","18","0","0","0","1","1","0","0","0","0","-2"
"126562","University of Colorado Denver/Anschutz Medical Campus","2018","Tenured total","598","403","195","4","2","2","56","38","18","5","4","1","34","24","10","0","0","0","477","321","156","1","0","1","19","13","6","2","1","1","-2"
"126562","University of Colorado Denver/Anschutz Medical Campus","2018","Tenured, professors","386","266","120","2","1","1","32","24","8","3","3","0","12","8","4","0","0","0","325","225","100","1","0","1","9","4","5","2","1","1","-2"
"126562","University of Colorado Denver/Anschutz Medical Campus","2018","Tenured, associate professors","212","137","75","2","1","1","24","14","10","2","1","1","22","16","6","0","0","0","152","96","56","0","0","0","10","9","1","0","0","0","-2"
"126562","University of Colorado Denver/Anschutz Medical Campus","2018","On-Tenure track total","1863","911","952","5","3","2","176","86","90","23","8","15","87","42","45","4","1","3","1226","602","624","12","6","6","309","150","159","21","13","8","-2"
"126562","University of Colorado Denver/Anschutz Medical Campus","2018","On-tenure track, professors","243","160","83","2","2","0","18","15","3","0","0","0","10","8","2","0","0","0","186","118","68","3","0","3","24","17","7","0","0","0","-2"
"126562","University of Colorado Denver/Anschutz Medical Campus","2018","On-tenure track, associate professors","590","303","287","3","1","2","53","28","25","6","3","3","30","13","17","2","1","1","424","217","207","3","2","1","69","38","31","0","0","0","-2"
"126562","University of Colorado Denver/Anschutz Medical Campus","2018","On-tenure track, assistant professors","1030","448","582","0","0","0","105","43","62","17","5","12","47","21","26","2","0","2","616","267","349","6","4","2","216","95","121","21","13","8","-2"
"126562","University of Colorado Denver/Anschutz Medical Campus","2018","Not on tenure track/No tenure system system total","1760","520","1240","5","1","4","77","29","48","17","6","11","90","34","56","0","0","0","1180","322","858","9","2","7","370","118","252","12","8","4","-2"
"126562","University of Colorado Denver/Anschutz Medical Campus","2018","Not on tenure/no tenure system, professors","15","6","9","0","0","0","0","0","0","0","0","0","0","0","0","0","0","0","15","6","9","0","0","0","0","0","0","0","0","0","-2"
"126562","University of Colorado Denver/Anschutz Medical Campus","2018","Not on tenure/no tenure system, associate professors","73","33","40","0","0","0","8","2","6","0","0","0","6","4","2","0","0","0","54","22","32","1","1","0","4","4","0","0","0","0","-2"
"126562","University of Colorado Denver/Anschutz Medical Campus","2018","Not on tenure/no tenure system, assistant professors","118","48","70","2","0","2","7","4","3","2","1","1","7","5","2","0","0","0","86","30","56","0","0","0","9","4","5","5","4","1","-2"
"126562","University of Colorado Denver/Anschutz Medical Campus","2018","Not on tenure/no tenure system, instructors","1554","433","1121","3","1","2","62","23","39","15","5","10","77","25","52","0","0","0","1025","264","761","8","1","7","357","110","247","7","4","3","-2"
"126711","Colorado Mountain College","2018","Not on tenure track/No tenure system system total","113","57","56","0","0","0","2","1","1","0","0","0","6","2","4","0","0","0","94","47","47","1","1","0","10","6","4","0","0","0","-2"
"126711","Colorado Mountain College","2018","Not on tenure/no tenure system, professors","45","20","25","0","0","0","1","1","0","0","0","0","2","1","1","0","0","0","41","18","23","0","0","0","1","0","1","0","0","0","-2"
"126711","Colorado Mountain College","2018","Not on tenure/no tenure system, associate professors","48","26","22","0","0","0","1","0","1","0","0","0","4","1","3","0","0","0","35","18","17","1","1","0","7","6","1","0","0","0","-2"
"126711","Colorado Mountain College","2018","Not on tenure/no tenure system, assistant professors","20","11","9","0","0","0","0","0","0","0","0","0","0","0","0","0","0","0","18","11","7","0","0","0","2","0","2","0","0","0","-2"
"126942","Community College of Denver","2018","Not on tenure track/No tenure system system total","109","51","58","0","0","0","8","3","5","6","4","2","7","3","4","0","0","0","87","41","46","0","0","0","1","0","1","0","0","0","-2"
"126942","Community College of Denver","2018","Not on tenure/no tenure system, professors","46","22","24","0","0","0","4","2","2","2","1","1","1","0","1","0","0","0","39","19","20","0","0","0","0","0","0","0","0","0","-2"
"126942","Community College of Denver","2018","Not on tenure/no tenure system, associate professors","30","14","16","0","0","0","1","0","1","2","2","0","2","1","1","0","0","0","24","11","13","0","0","0","1","0","1","0","0","0","-2"
"126942","Community College of Denver","2018","Not on tenure/no tenure system, assistant professors","6","5","1","0","0","0","0","0","0","0","0","0","0","0","0","0","0","0","6","5","1","0","0","0","0","0","0","0","0","0","-2"
"126942","Community College of Denver","2018","Not on tenure/no tenure system, instructors","27","10","17","0","0","0","3","1","2","2","1","1","4","2","2","0","0","0","18","6","12","0","0","0","0","0","0","0","0","0","-2"
"127617","Morgan Community College","2018","Not on tenure track/No tenure system system total","37","19","18","0","0","0","0","0","0","0","0","0","0","0","0","0","0","0","36","19","17","1","0","1","0","0","0","0","0","0","-2"
"127617","Morgan Community College","2018","Not on tenure/no tenure system, no academic rank","37","19","18","0","0","0","0","0","0","0","0","0","0","0","0","0","0","0","36","19","17","1","0","1","0","0","0","0","0","0","-2"
"127884","Pueblo Community College","2018","Not on tenure track/No tenure system system total","89","40","49","0","0","0","1","0","1","0","0","0","13","6","7","0","0","0","74","33","41","0","0","0","1","1","0","0","0","0","-2"
"127884","Pueblo Community College","2018","Not on tenure/no tenure system, no academic rank","89","40","49","0","0","0","1","0","1","0","0","0","13","6","7","0","0","0","74","33","41","0","0","0","1","1","0","0","0","0","-2"
"128106","Colorado State University Pueblo","2018","Tenured total","92","59","33","0","0","0","4","3","1","4","3","1","12","5","7","0","0","0","65","44","21","1","0","1","6","4","2","0","0","0","-2"
"128106","Colorado State University Pueblo","2018","Tenured, professors","41","29","12","0","0","0","2","1","1","3","3","0","4","2","2","0","0","0","30","21","9","0","0","0","2","2","0","0","0","0","-2"
"128106","Colorado State University Pueblo","2018","Tenured, associate professors","45","26","19","0","0","0","2","2","0","0","0","0","7","2","5","0","0","0","31","20","11","1","0","1","4","2","2","0","0","0","-2"
"128106","Colorado State University Pueblo","2018","Tenured, assistant professors","6","4","2","0","0","0","0","0","0","1","0","1","1","1","0","0","0","0","4","3","1","0","0","0","0","0","0","0","0","0","-2"
"128106","Colorado State University Pueblo","2018","On-Tenure track total","36","15","21","0","0","0","2","1","1","0","0","0","2","0","2","0","0","0","26","9","17","0","0","0","0","0","0","6","5","1","-2"
"128106","Colorado State University Pueblo","2018","On-tenure track, assistant professors","36","15","21","0","0","0","2","1","1","0","0","0","2","0","2","0","0","0","26","9","17","0","0","0","0","0","0","6","5","1","-2"
"128106","Colorado State University Pueblo","2018","Not on tenure track/No tenure system system total","46","22","24","0","0","0","3","2","1","1","0","1","4","2","2","0","0","0","36","17","19","0","0","0","2","1","1","0","0","0","-2"
"128106","Colorado State University Pueblo","2018","Not on tenure/no tenure system, assistant professors","10","4","6","0","0","0","1","1","0","1","0","1","0","0","0","0","0","0","7","2","5","0","0","0","1","1","0","0","0","0","-2"
"128106","Colorado State University Pueblo","2018","Not on tenure/no tenure system, instructors","1","0","1","0","0","0","0","0","0","0","0","0","0","0","0","0","0","0","1","0","1","0","0","0","0","0","0","0","0","0","-2"
"128106","Colorado State University Pueblo","2018","Not on tenure/no tenure system, lecturers","30","13","17","0","0","0","1","0","1","0","0","0","4","2","2","0","0","0","24","11","13","0","0","0","1","0","1","0","0","0","-2"
"128106","Colorado State University Pueblo","2018","Not on tenure/no tenure system, no academic rank","5","5","0","0","0","0","1","1","0","0","0","0","0","0","0","0","0","0","4","4","0","0","0","0","0","0","0","0","0","0","-2"
"128744","University of Bridgeport","2018","Tenured total","71","46","25","0","0","0","14","11","3","4","3","1","0","0","0","0","0","0","53","32","21","0","0","0","0","0","0","0","0","0","-2"
"128744","University of Bridgeport","2018","Tenured, professors","21","15","6","0","0","0","7","5","2","0","0","0","0","0","0","0","0","0","14","10","4","0","0","0","0","0","0","0","0","0","-2"
"128744","University of Bridgeport","2018","Tenured, associate professors","41","28","13","0","0","0","7","6","1","2","2","0","0","0","0","0","0","0","32","20","12","0","0","0","0","0","0","0","0","0","-2"
"128744","University of Bridgeport","2018","Tenured, assistant professors","7","2","5","0","0","0","0","0","0","2","1","1","0","0","0","0","0","0","5","1","4","0","0","0","0","0","0","0","0","0","-2"
"128744","University of Bridgeport","2018","Tenured, no academic rank","2","1","1","0","0","0","0","0","0","0","0","0","0","0","0","0","0","0","2","1","1","0","0","0","0","0","0","0","0","0","-2"
"128744","University of Bridgeport","2018","On-Tenure track total","34","12","22","0","0","0","3","1","2","1","0","1","1","0","1","0","0","0","29","11","18","0","0","0","0","0","0","0","0","0","-2"
"128744","University of Bridgeport","2018","On-tenure track, associate professors","8","3","5","0","0","0","0","0","0","0","0","0","0","0","0","0","0","0","8","3","5","0","0","0","0","0","0","0","0","0","-2"
"128744","University of Bridgeport","2018","On-tenure track, assistant professors","24","9","15","0","0","0","3","1","2","1","0","1","1","0","1","0","0","0","19","8","11","0","0","0","0","0","0","0","0","0","-2"
"128744","University of Bridgeport","2018","On-tenure track, lecturers","1","0","1","0","0","0","0","0","0","0","0","0","0","0","0","0","0","0","1","0","1","0","0","0","0","0","0","0","0","0","-2"
"128744","University of Bridgeport","2018","On-tenure track, no academic rank","1","0","1","0","0","0","0","0","0","0","0","0","0","0","0","0","0","0","1","0","1","0","0","0","0","0","0","0","0","0","-2"
"128744","University of Bridgeport","2018","Not on tenure track/No tenure system system total","41","21","20","0","0","0","3","1","2","0","0","0","2","2","0","0","0","0","36","18","18","0","0","0","0","0","0","0","0","0","-2"
"128744","University of Bridgeport","2018","Not on tenure/no tenure system, associate professors","3","2","1","0","0","0","0","0","0","0","0","0","0","0","0","0","0","0","3","2","1","0","0","0","0","0","0","0","0","0","-2"
"128744","University of Bridgeport","2018","Not on tenure/no tenure system, assistant professors","9","4","5","0","0","0","1","1","0","0","0","0","0","0","0","0","0","0","8","3","5","0","0","0","0","0","0","0","0","0","-2"
"128744","University of Bridgeport","2018","Not on tenure/no tenure system, instructors","2","0","2","0","0","0","0","0","0","0","0","0","0","0","0","0","0","0","2","0","2","0","0","0","0","0","0","0","0","0","-2"
"128744","University of Bridgeport","2018","Not on tenure/no tenure system, lecturers","14","9","5","0","0","0","1","0","1","0","0","0","0","0","0","0","0","0","13","9","4","0","0","0","0","0","0","0","0","0","-2"
"128744","University of Bridgeport","2018","Not on tenure/no tenure system, no academic rank","13","6","7","0","0","0","1","0","1","0","0","0","2","2","0","0","0","0","10","4","6","0","0","0","0","0","0","0","0","0","-2"
"131876","Trinity Washington University","2018","Tenured total","25","6","19","0","0","0","4","2","2","7","2","5","1","1","0","0","0","0","13","1","12","0","0","0","0","0","0","0","0","0","-2"
"131876","Trinity Washington University","2018","Tenured, professors","4","0","4","0","0","0","0","0","0","0","0","0","0","0","0","0","0","0","4","0","4","0","0","0","0","0","0","0","0","0","-2"
"131876","Trinity Washington University","2018","Tenured, associate professors","21","6","15","0","0","0","4","2","2","7","2","5","1","1","0","0","0","0","9","1","8","0","0","0","0","0","0","0","0","0","-2"
"131876","Trinity Washington University","2018","On-Tenure track total","12","1","11","0","0","0","1","0","1","7","0","7","0","0","0","0","0","0","4","1","3","0","0","0","0","0","0","0","0","0","-2"
"131876","Trinity Washington University","2018","On-tenure track, assistant professors","12","1","11","0","0","0","1","0","1","7","0","7","0","0","0","0","0","0","4","1","3","0","0","0","0","0","0","0","0","0","-2"
"131876","Trinity Washington University","2018","Not on tenure track/No tenure system system total","20","6","14","1","0","1","0","0","0","10","3","7","0","0","0","0","0","0","8","3","5","1","0","1","0","0","0","0","0","0","-2"
"131876","Trinity Washington University","2018","Not on tenure/no tenure system, assistant professors","20","6","14","1","0","1","0","0","0","10","3","7","0","0","0","0","0","0","8","3","5","1","0","1","0","0","0","0","0","0","-2"
"132471","Barry University","2018","Tenured total","19","10","9","2","0","2","1","0","1","1","1","0","1","1","0","0","0","0","14","8","6","0","0","0","0","0","0","0","0","0","-2"
"132471","Barry University","2018","Tenured, professors","9","5","4","0","0","0","0","0","0","1","1","0","0","0","0","0","0","0","8","4","4","0","0","0","0","0","0","0","0","0","-2"
"132471","Barry University","2018","Tenured, associate professors","10","5","5","2","0","2","1","0","1","0","0","0","1","1","0","0","0","0","6","4","2","0","0","0","0","0","0","0","0","0","-2"
"132471","Barry University","2018","On-Tenure track total","8","3","5","0","0","0","2","1","1","1","0","1","0","0","0","0","0","0","3","1","2","0","0","0","2","1","1","0","0","0","-2"
"132471","Barry University","2018","On-tenure track, associate professors","4","1","3","0","0","0","1","0","1","0","0","0","0","0","0","0","0","0","2","1","1","0","0","0","1","0","1","0","0","0","-2"
"132471","Barry University","2018","On-tenure track, assistant professors","4","2","2","0","0","0","1","1","0","1","0","1","0","0","0","0","0","0","1","0","1","0","0","0","1","1","0","0","0","0","-2"
"132471","Barry University","2018","Not on tenure track/No tenure system system total","283","121","162","1","0","1","18","10","8","22","4","18","44","23","21","0","0","0","169","74","95","4","1","3","21","7","14","4","2","2","-2"
"132471","Barry University","2018","Not on tenure/no tenure system, professors","67","41","26","0","0","0","6","6","0","1","0","1","9","4","5","0","0","0","49","29","20","1","1","0","1","1","0","0","0","0","-2"
"132471","Barry University","2018","Not on tenure/no tenure system, associate professors","94","38","56","1","0","1","6","3","3","5","0","5","13","6","7","0","0","0","59","26","33","1","0","1","9","3","6","0","0","0","-2"
"132471","Barry University","2018","Not on tenure/no tenure system, assistant professors","93","28","65","0","0","0","5","1","4","14","3","11","12","6","6","0","0","0","51","15","36","2","0","2","7","3","4","2","0","2","-2"
"132471","Barry University","2018","Not on tenure/no tenure system, instructors","29","14","15","0","0","0","1","0","1","2","1","1","10","7","3","0","0","0","10","4","6","0","0","0","4","0","4","2","2","0","-2"
"132709","Broward College","2018","Tenured total","283","133","150","4","0","4","17","13","4","44","13","31","63","33","30","0","0","0","147","69","78","0","0","0","8","5","3","0","0","0","-2"
"132709","Broward College","2018","Tenured, professors","50","29","21","1","0","1","5","3","2","3","1","2","9","6","3","0","0","0","31","18","13","0","0","0","1","1","0","0","0","0","-2"
"132709","Broward College","2018","Tenured, associate professors","32","13","19","1","0","1","2","1","1","5","1","4","8","3","5","0","0","0","14","7","7","0","0","0","2","1","1","0","0","0","-2"
"132709","Broward College","2018","Tenured, assistant professors","185","84","101","2","0","2","10","9","1","34","11","23","41","21","20","0","0","0","93","40","53","0","0","0","5","3","2","0","0","0","-2"
"132709","Broward College","2018","Tenured, instructors","16","7","9","0","0","0","0","0","0","2","0","2","5","3","2","0","0","0","9","4","5","0","0","0","0","0","0","0","0","0","-2"
"132709","Broward College","2018","On-Tenure track total","92","39","53","1","0","1","3","1","2","13","4","9","12","6","6","0","0","0","46","23","23","0","0","0","17","5","12","0","0","0","-2"
"132709","Broward College","2018","On-tenure track, assistant professors","85","33","52","1","0","1","3","1","2","13","4","9","10","4","6","0","0","0","41","19","22","0","0","0","17","5","12","0","0","0","-2"
"132709","Broward College","2018","On-tenure track, instructors","7","6","1","0","0","0","0","0","0","0","0","0","2","2","0","0","0","0","5","4","1","0","0","0","0","0","0","0","0","0","-2"
"132903","University of Central Florida","2018","Tenured total","682","463","219","4","4","0","130","104","26","30","16","14","39","23","16","0","0","0","469","310","159","2","1","1","0","0","0","8","5","3","-2"
"132903","University of Central Florida","2018","Tenured, professors","322","240","82","1","1","0","69","60","9","8","4","4","16","11","5","0","0","0","224","162","62","1","0","1","0","0","0","3","2","1","-2"
"132903","University of Central Florida","2018","Tenured, associate professors","357","220","137","3","3","0","61","44","17","22","12","10","23","12","11","0","0","0","242","145","97","1","1","0","0","0","0","5","3","2","-2"
"132903","University of Central Florida","2018","Tenured, assistant professors","3","3","0","0","0","0","0","0","0","0","0","0","0","0","0","0","0","0","3","3","0","0","0","0","0","0","0","0","0","0","-2"
"132903","University of Central Florida","2018","On-Tenure track total","319","189","130","0","0","0","49","33","16","12","2","10","29","21","8","0","0","0","174","95","79","4","2","2","0","0","0","51","36","15","-2"
"132903","University of Central Florida","2018","On-tenure track, associate professors","15","12","3","0","0","0","1","1","0","0","0","0","1","1","0","0","0","0","12","10","2","0","0","0","0","0","0","1","0","1","-2"
"132903","University of Central Florida","2018","On-tenure track, assistant professors","304","177","127","0","0","0","48","32","16","12","2","10","28","20","8","0","0","0","162","85","77","4","2","2","0","0","0","50","36","14","-2"
"132903","University of Central Florida","2018","Not on tenure track/No tenure system system total","560","257","303","0","0","0","34","15","19","21","8","13","47","18","29","0","0","0","434","202","232","9","3","6","0","0","0","15","11","4","-2"
"132903","University of Central Florida","2018","Not on tenure/no tenure system, professors","12","9","3","0","0","0","3","3","0","0","0","0","1","0","1","0","0","0","8","6","2","0","0","0","0","0","0","0","0","0","-2"
"132903","University of Central Florida","2018","Not on tenure/no tenure system, associate professors","22","10","12","0","0","0","3","1","2","0","0","0","5","1","4","0","0","0","11","6","5","1","0","1","0","0","0","2","2","0","-2"
"132903","University of Central Florida","2018","Not on tenure/no tenure system, assistant professors","55","26","29","0","0","0","8","2","6","1","1","0","1","1","0","0","0","0","38","17","21","0","0","0","0","0","0","7","5","2","-2"
"132903","University of Central Florida","2018","Not on tenure/no tenure system, instructors","215","89","126","0","0","0","4","2","2","7","3","4","20","7","13","0","0","0","179","75","104","4","1","3","0","0","0","1","1","0","-2"
"132903","University of Central Florida","2018","Not on tenure/no tenure system, lecturers","256","123","133","0","0","0","16","7","9","13","4","9","20","9","11","0","0","0","198","98","100","4","2","2","0","0","0","5","3","2","-2"
"133508","Florida SouthWestern State College","2018","Tenured total","109","50","59","2","1","1","3","2","1","7","3","4","3","2","1","0","0","0","90","39","51","0","0","0","1","1","0","3","2","1","-2"
"133508","Florida SouthWestern State College","2018","Tenured, no academic rank","109","50","59","2","1","1","3","2","1","7","3","4","3","2","1","0","0","0","90","39","51","0","0","0","1","1","0","3","2","1","-2"
"133508","Florida SouthWestern State College","2018","On-Tenure track total","70","29","41","0","0","0","4","3","1","2","0","2","2","1","1","0","0","0","61","24","37","0","0","0","0","0","0","1","1","0","-2"
"133508","Florida SouthWestern State College","2018","On-tenure track, no academic rank","70","29","41","0","0","0","4","3","1","2","0","2","2","1","1","0","0","0","61","24","37","0","0","0","0","0","0","1","1","0","-2"
"133508","Florida SouthWestern State College","2018","Not on tenure track/No tenure system system total","12","6","6","0","0","0","0","0","0","0","0","0","0","0","0","0","0","0","12","6","6","0","0","0","0","0","0","0","0","0","-2"
"133508","Florida SouthWestern State College","2018","Not on tenure/no tenure system, no academic rank","12","6","6","0","0","0","0","0","0","0","0","0","0","0","0","0","0","0","12","6","6","0","0","0","0","0","0","0","0","0","-2"
"133669","Florida Atlantic University","2018","Tenured total","421","268","153","0","0","0","71","57","14","25","8","17","31","16","15","0","0","0","289","184","105","1","0","1","0","0","0","4","3","1","-2"
"133669","Florida Atlantic University","2018","Tenured, professors","228","164","64","0","0","0","40","37","3","9","4","5","15","8","7","0","0","0","163","114","49","0","0","0","0","0","0","1","1","0","-2"
"133669","Florida Atlantic University","2018","Tenured, associate professors","193","104","89","0","0","0","31","20","11","16","4","12","16","8","8","0","0","0","126","70","56","1","0","1","0","0","0","3","2","1","-2"
"133669","Florida Atlantic University","2018","On-Tenure track total","183","96","87","0","0","0","16","15","1","8","4","4","13","8","5","0","0","0","122","51","71","1","0","1","0","0","0","23","18","5","-2"
"133669","Florida Atlantic University","2018","On-tenure track, professors","2","2","0","0","0","0","0","0","0","0","0","0","0","0","0","0","0","0","2","2","0","0","0","0","0","0","0","0","0","0","-2"
"133669","Florida Atlantic University","2018","On-tenure track, associate professors","16","8","8","0","0","0","2","2","0","1","1","0","0","0","0","0","0","0","12","4","8","0","0","0","0","0","0","1","1","0","-2"
"133669","Florida Atlantic University","2018","On-tenure track, assistant professors","165","86","79","0","0","0","14","13","1","7","3","4","13","8","5","0","0","0","108","45","63","1","0","1","0","0","0","22","17","5","-2"
"133669","Florida Atlantic University","2018","Not on tenure track/No tenure system system total","270","109","161","1","1","0","17","4","13","29","10","19","30","8","22","0","0","0","188","85","103","0","0","0","0","0","0","5","1","4","-2"
"133669","Florida Atlantic University","2018","Not on tenure/no tenure system, professors","4","4","0","0","0","0","1","1","0","0","0","0","0","0","0","0","0","0","3","3","0","0","0","0","0","0","0","0","0","0","-2"
"133669","Florida Atlantic University","2018","Not on tenure/no tenure system, associate professors","14","9","5","0","0","0","2","1","1","0","0","0","4","2","2","0","0","0","8","6","2","0","0","0","0","0","0","0","0","0","-2"
"133669","Florida Atlantic University","2018","Not on tenure/no tenure system, assistant professors","35","13","22","0","0","0","3","0","3","6","1","5","2","1","1","0","0","0","23","11","12","0","0","0","0","0","0","1","0","1","-2"
"133669","Florida Atlantic University","2018","Not on tenure/no tenure system, instructors","213","83","130","1","1","0","11","2","9","23","9","14","24","5","19","0","0","0","150","65","85","0","0","0","0","0","0","4","1","3","-2"
"133669","Florida Atlantic University","2018","Not on tenure/no tenure system, lecturers","2","0","2","0","0","0","0","0","0","0","0","0","0","0","0","0","0","0","2","0","2","0","0","0","0","0","0","0","0","0","-2"
"133669","Florida Atlantic University","2018","Not on tenure/no tenure system, no academic rank","2","0","2","0","0","0","0","0","0","0","0","0","0","0","0","0","0","0","2","0","2","0","0","0","0","0","0","0","0","0","-2"
"133872","AdventHealth University","2018","Not on tenure track/No tenure system system total","91","27","64","0","0","0","4","0","4","18","6","12","9","3","6","0","0","0","58","18","40","2","0","2","0","0","0","0","0","0","-2"
"133872","AdventHealth University","2018","Not on tenure/no tenure system, professors","13","6","7","0","0","0","0","0","0","4","0","4","2","2","0","0","0","0","7","4","3","0","0","0","0","0","0","0","0","0","-2"
"133872","AdventHealth University","2018","Not on tenure/no tenure system, associate professors","26","5","21","0","0","0","2","0","2","4","2","2","3","0","3","0","0","0","16","3","13","1","0","1","0","0","0","0","0","0","-2"
"133872","AdventHealth University","2018","Not on tenure/no tenure system, assistant professors","39","13","26","0","0","0","2","0","2","9","4","5","3","1","2","0","0","0","24","8","16","1","0","1","0","0","0","0","0","0","-2"
"133872","AdventHealth University","2018","Not on tenure/no tenure system, instructors","13","3","10","0","0","0","0","0","0","1","0","1","1","0","1","0","0","0","11","3","8","0","0","0","0","0","0","0","0","0","-2"
"133960","The College of the Florida Keys","2018","Tenured total","8","3","5","0","0","0","0","0","0","0","0","0","1","0","1","0","0","0","6","3","3","0","0","0","1","0","1","0","0","0","-2"
"133960","The College of the Florida Keys","2018","Tenured, professors","3","2","1","0","0","0","0","0","0","0","0","0","0","0","0","0","0","0","2","2","0","0","0","0","1","0","1","0","0","0","-2"
"133960","The College of the Florida Keys","2018","Tenured, associate professors","2","0","2","0","0","0","0","0","0","0","0","0","1","0","1","0","0","0","1","0","1","0","0","0","0","0","0","0","0","0","-2"
"133960","The College of the Florida Keys","2018","Tenured, assistant professors","3","1","2","0","0","0","0","0","0","0","0","0","0","0","0","0","0","0","3","1","2","0","0","0","0","0","0","0","0","0","-2"
"133960","The College of the Florida Keys","2018","On-Tenure track total","18","8","10","0","0","0","0","0","0","0","0","0","1","1","0","0","0","0","14","4","10","0","0","0","2","2","0","1","1","0","-2"
"133960","The College of the Florida Keys","2018","On-tenure track, professors","3","1","2","0","0","0","0","0","0","0","0","0","0","0","0","0","0","0","2","0","2","0","0","0","1","1","0","0","0","0","-2"
"133960","The College of the Florida Keys","2018","On-tenure track, associate professors","4","2","2","0","0","0","0","0","0","0","0","0","1","1","0","0","0","0","3","1","2","0","0","0","0","0","0","0","0","0","-2"
"133960","The College of the Florida Keys","2018","On-tenure track, assistant professors","6","3","3","0","0","0","0","0","0","0","0","0","0","0","0","0","0","0","4","1","3","0","0","0","1","1","0","1","1","0","-2"
"133960","The College of the Florida Keys","2018","On-tenure track, instructors","5","2","3","0","0","0","0","0","0","0","0","0","0","0","0","0","0","0","5","2","3","0","0","0","0","0","0","0","0","0","-2"
"133960","The College of the Florida Keys","2018","Not on tenure track/No tenure system system total","3","2","1","0","0","0","0","0","0","1","1","0","0","0","0","0","0","0","2","1","1","0","0","0","0","0","0","0","0","0","-2"
"133960","The College of the Florida Keys","2018","Not on tenure/no tenure system, associate professors","1","0","1","0","0","0","0","0","0","0","0","0","0","0","0","0","0","0","1","0","1","0","0","0","0","0","0","0","0","0","-2"
"133960","The College of the Florida Keys","2018","Not on tenure/no tenure system, assistant professors","1","1","0","0","0","0","0","0","0","1","1","0","0","0","0","0","0","0","0","0","0","0","0","0","0","0","0","0","0","0","-2"
"133960","The College of the Florida Keys","2018","Not on tenure/no tenure system, instructors","1","1","0","0","0","0","0","0","0","0","0","0","0","0","0","0","0","0","1","1","0","0","0","0","0","0","0","0","0","0","-2"
"134608","Indian River State College","2018","Tenured total","137","68","69","2","0","2","5","3","2","18","8","10","7","2","5","1","0","1","104","55","49","0","0","0","0","0","0","0","0","0","-2"
"134608","Indian River State College","2018","Tenured, professors","43","19","24","1","0","1","4","2","2","5","2","3","1","1","0","1","0","1","31","14","17","0","0","0","0","0","0","0","0","0","-2"
"134608","Indian River State College","2018","Tenured, associate professors","47","27","20","0","0","0","1","1","0","7","4","3","4","1","3","0","0","0","35","21","14","0","0","0","0","0","0","0","0","0","-2"
"134608","Indian River State College","2018","Tenured, assistant professors","35","17","18","1","0","1","0","0","0","3","1","2","2","0","2","0","0","0","29","16","13","0","0","0","0","0","0","0","0","0","-2"
"134608","Indian River State College","2018","Tenured, no academic rank","12","5","7","0","0","0","0","0","0","3","1","2","0","0","0","0","0","0","9","4","5","0","0","0","0","0","0","0","0","0","-2"
"134608","Indian River State College","2018","On-Tenure track total","68","31","37","1","1","0","3","1","2","8","3","5","5","1","4","1","0","1","50","25","25","0","0","0","0","0","0","0","0","0","-2"
"134608","Indian River State College","2018","On-tenure track, associate professors","3","2","1","1","1","0","0","0","0","1","1","0","0","0","0","0","0","0","1","0","1","0","0","0","0","0","0","0","0","0","-2"
"134608","Indian River State College","2018","On-tenure track, assistant professors","32","14","18","0","0","0","2","1","1","5","1","4","2","1","1","0","0","0","23","11","12","0","0","0","0","0","0","0","0","0","-2"
"134608","Indian River State College","2018","On-tenure track, no academic rank","33","15","18","0","0","0","1","0","1","2","1","1","3","0","3","1","0","1","26","14","12","0","0","0","0","0","0","0","0","0","-2"
"134608","Indian River State College","2018","Not on tenure track/No tenure system system total","46","17","29","0","0","0","1","1","0","5","2","3","3","2","1","0","0","0","37","12","25","0","0","0","0","0","0","0","0","0","-2"
"134608","Indian River State College","2018","Not on tenure/no tenure system, associate professors","2","1","1","0","0","0","0","0","0","0","0","0","0","0","0","0","0","0","2","1","1","0","0","0","0","0","0","0","0","0","-2"
"134608","Indian River State College","2018","Not on tenure/no tenure system, assistant professors","9","2","7","0","0","0","0","0","0","1","0","1","0","0","0","0","0","0","8","2","6","0","0","0","0","0","0","0","0","0","-2"
"134608","Indian River State College","2018","Not on tenure/no tenure system, no academic rank","35","14","21","0","0","0","1","1","0","4","2","2","3","2","1","0","0","0","27","9","18","0","0","0","0","0","0","0","0","0","-2"
"135081","Keiser University-Ft Lauderdale","2018","Not on tenure track/No tenure system system total","1190","462","728","3","2","1","56","26","30","160","56","104","180","81","99","2","1","1","766","286","480","23","10","13","0","0","0","0","0","0","-2"
"135081","Keiser University-Ft Lauderdale","2018","Not on tenure/no tenure system, instructors","1190","462","728","3","2","1","56","26","30","160","56","104","180","81","99","2","1","1","766","286","480","23","10","13","0","0","0","0","0","0","-2"
"135717","Miami Dade College","2018","Tenured total","538","266","272","1","0","1","23","11","12","82","28","54","246","128","118","0","0","0","178","96","82","6","1","5","2","2","0","0","0","0","-2"
"135717","Miami Dade College","2018","Tenured, professors","168","82","86","0","0","0","8","4","4","20","10","10","79","36","43","0","0","0","57","30","27","3","1","2","1","1","0","0","0","0","-2"
"135717","Miami Dade College","2018","Tenured, associate professors","254","123","131","0","0","0","11","5","6","39","15","24","115","53","62","0","0","0","86","49","37","2","0","2","1","1","0","0","0","0","-2"
"135717","Miami Dade College","2018","Tenured, assistant professors","106","53","53","1","0","1","4","2","2","23","3","20","44","33","11","0","0","0","33","15","18","1","0","1","0","0","0","0","0","0","-2"
"135717","Miami Dade College","2018","Tenured, instructors","10","8","2","0","0","0","0","0","0","0","0","0","8","6","2","0","0","0","2","2","0","0","0","0","0","0","0","0","0","0","-2"
"135717","Miami Dade College","2018","On-Tenure track total","201","90","111","1","0","1","8","3","5","37","13","24","88","45","43","0","0","0","62","29","33","4","0","4","1","0","1","0","0","0","-2"
"135717","Miami Dade College","2018","On-tenure track, professors","18","10","8","0","0","0","1","0","1","0","0","0","6","3","3","0","0","0","11","7","4","0","0","0","0","0","0","0","0","0","-2"
"135717","Miami Dade College","2018","On-tenure track, associate professors","15","3","12","0","0","0","0","0","0","1","1","0","7","1","6","0","0","0","7","1","6","0","0","0","0","0","0","0","0","0","-2"
"135717","Miami Dade College","2018","On-tenure track, assistant professors","62","27","35","1","0","1","1","0","1","12","4","8","31","17","14","0","0","0","14","6","8","2","0","2","1","0","1","0","0","0","-2"
"135717","Miami Dade College","2018","On-tenure track, instructors","106","50","56","0","0","0","6","3","3","24","8","16","44","24","20","0","0","0","30","15","15","2","0","2","0","0","0","0","0","0","-2"
"136215","Nova Southeastern University","2018","Tenured total","29","17","12","0","0","0","1","1","0","4","2","2","2","1","1","0","0","0","22","13","9","0","0","0","0","0","0","0","0","0","-2"
"136215","Nova Southeastern University","2018","Tenured, professors","28","16","12","0","0","0","1","1","0","3","1","2","2","1","1","0","0","0","22","13","9","0","0","0","0","0","0","0","0","0","-2"
"136215","Nova Southeastern University","2018","Tenured, associate professors","1","1","0","0","0","0","0","0","0","1","1","0","0","0","0","0","0","0","0","0","0","0","0","0","0","0","0","0","0","0","-2"
"136215","Nova Southeastern University","2018","Not on tenure track/No tenure system system total","794","359","435","1","0","1","67","36","31","59","17","42","132","48","84","3","2","1","503","241","262","5","2","3","3","2","1","21","11","10","-2"
"136215","Nova Southeastern University","2018","Not on tenure/no tenure system, professors","154","96","58","0","0","0","18","15","3","6","4","2","16","8","8","2","1","1","110","67","43","0","0","0","1","0","1","1","1","0","-2"
"136215","Nova Southeastern University","2018","Not on tenure/no tenure system, associate professors","272","124","148","0","0","0","19","10","9","19","5","14","40","14","26","1","1","0","186","90","96","2","0","2","0","0","0","5","4","1","-2"
"136215","Nova Southeastern University","2018","Not on tenure/no tenure system, assistant professors","325","124","201","1","0","1","26","9","17","29","7","22","68","22","46","0","0","0","185","80","105","1","0","1","2","2","0","13","4","9","-2"
"136215","Nova Southeastern University","2018","Not on tenure/no tenure system, instructors","31","10","21","0","0","0","3","1","2","3","0","3","7","4","3","0","0","0","16","3","13","1","1","0","0","0","0","1","1","0","-2"
"136215","Nova Southeastern University","2018","Not on tenure/no tenure system, lecturers","2","0","2","0","0","0","0","0","0","0","0","0","1","0","1","0","0","0","1","0","1","0","0","0","0","0","0","0","0","0","-2"
"136215","Nova Southeastern University","2018","Not on tenure/no tenure system, no academic rank","10","5","5","0","0","0","1","1","0","2","1","1","0","0","0","0","0","0","5","1","4","1","1","0","0","0","0","1","1","0","-2"
"136358","Palm Beach State College","2018","Tenured total","163","71","92","0","0","0","7","6","1","21","10","11","16","4","12","0","0","0","112","47","65","1","1","0","6","3","3","0","0","0","-2"
"136358","Palm Beach State College","2018","Tenured, professors","44","21","23","0","0","0","4","3","1","5","3","2","4","1","3","0","0","0","31","14","17","0","0","0","0","0","0","0","0","0","-2"
"136358","Palm Beach State College","2018","Tenured, associate professors","16","5","11","0","0","0","0","0","0","3","1","2","2","0","2","0","0","0","11","4","7","0","0","0","0","0","0","0","0","0","-2"
"136358","Palm Beach State College","2018","Tenured, assistant professors","30","14","16","0","0","0","1","1","0","2","1","1","3","1","2","0","0","0","22","10","12","0","0","0","2","1","1","0","0","0","-2"
"136358","Palm Beach State College","2018","Tenured, instructors","73","31","42","0","0","0","2","2","0","11","5","6","7","2","5","0","0","0","48","19","29","1","1","0","4","2","2","0","0","0","-2"
"136358","Palm Beach State College","2018","On-Tenure track total","143","55","88","2","0","2","10","4","6","21","7","14","17","6","11","0","0","0","87","35","52","1","0","1","4","3","1","1","0","1","-2"
"136358","Palm Beach State College","2018","On-tenure track, professors","11","2","9","0","0","0","1","0","1","2","1","1","0","0","0","0","0","0","8","1","7","0","0","0","0","0","0","0","0","0","-2"
"136358","Palm Beach State College","2018","On-tenure track, associate professors","26","12","14","1","0","1","4","2","2","6","1","5","5","2","3","0","0","0","10","7","3","0","0","0","0","0","0","0","0","0","-2"
"136358","Palm Beach State College","2018","On-tenure track, assistant professors","49","18","31","1","0","1","4","1","3","6","2","4","5","1","4","0","0","0","31","13","18","1","0","1","1","1","0","0","0","0","-2"
"136358","Palm Beach State College","2018","On-tenure track, instructors","57","23","34","0","0","0","1","1","0","7","3","4","7","3","4","0","0","0","38","14","24","0","0","0","3","2","1","1","0","1","-2"
"136358","Palm Beach State College","2018","Not on tenure track/No tenure system system total","45","22","23","0","0","0","0","0","0","10","3","7","6","3","3","0","0","0","28","15","13","1","1","0","0","0","0","0","0","0","-2"
"136358","Palm Beach State College","2018","Not on tenure/no tenure system, professors","1","1","0","0","0","0","0","0","0","0","0","0","1","1","0","0","0","0","0","0","0","0","0","0","0","0","0","0","0","0","-2"
"136358","Palm Beach State College","2018","Not on tenure/no tenure system, assistant professors","6","1","5","0","0","0","0","0","0","3","0","3","0","0","0","0","0","0","3","1","2","0","0","0","0","0","0","0","0","0","-2"
"136358","Palm Beach State College","2018","Not on tenure/no tenure system, instructors","38","20","18","0","0","0","0","0","0","7","3","4","5","2","3","0","0","0","25","14","11","1","1","0","0","0","0","0","0","0","-2"
"136516","Polk State College","2018","Tenured total","112","51","61","0","0","0","1","1","0","9","5","4","5","2","3","0","0","0","97","43","54","0","0","0","0","0","0","0","0","0","-2"
"136516","Polk State College","2018","Tenured, no academic rank","112","51","61","0","0","0","1","1","0","9","5","4","5","2","3","0","0","0","97","43","54","0","0","0","0","0","0","0","0","0","-2"
"136516","Polk State College","2018","On-Tenure track total","46","23","23","0","0","0","1","1","0","4","2","2","2","1","1","0","0","0","38","18","20","0","0","0","1","1","0","0","0","0","-2"
"136516","Polk State College","2018","On-tenure track, no academic rank","46","23","23","0","0","0","1","1","0","4","2","2","2","1","1","0","0","0","38","18","20","0","0","0","1","1","0","0","0","0","-2"
"137209","Seminole State College of Florida","2018","Tenured total","141","55","86","0","0","0","5","4","1","6","2","4","13","4","9","1","1","0","115","43","72","1","1","0","0","0","0","0","0","0","-2"
"137209","Seminole State College of Florida","2018","Tenured, no academic rank","141","55","86","0","0","0","5","4","1","6","2","4","13","4","9","1","1","0","115","43","72","1","1","0","0","0","0","0","0","0","-2"
"137209","Seminole State College of Florida","2018","On-Tenure track total","68","25","43","0","0","0","4","1","3","9","1","8","6","4","2","0","0","0","49","19","30","0","0","0","0","0","0","0","0","0","-2"
"137209","Seminole State College of Florida","2018","On-tenure track, no academic rank","68","25","43","0","0","0","4","1","3","9","1","8","6","4","2","0","0","0","49","19","30","0","0","0","0","0","0","0","0","0","-2"
"137315","South Florida State College","2018","Tenured total","46","19","27","0","0","0","1","0","1","2","0","2","0","0","0","0","0","0","43","19","24","0","0","0","0","0","0","0","0","0","-2"
"137315","South Florida State College","2018","Tenured, instructors","46","19","27","0","0","0","1","0","1","2","0","2","0","0","0","0","0","0","43","19","24","0","0","0","0","0","0","0","0","0","-2"
"137315","South Florida State College","2018","On-Tenure track total","18","3","15","0","0","0","0","0","0","0","0","0","3","0","3","0","0","0","15","3","12","0","0","0","0","0","0","0","0","0","-2"
"137315","South Florida State College","2018","On-tenure track, instructors","18","3","15","0","0","0","0","0","0","0","0","0","3","0","3","0","0","0","15","3","12","0","0","0","0","0","0","0","0","0","-2"
"137315","South Florida State College","2018","Not on tenure track/No tenure system system total","1","1","0","0","0","0","1","1","0","0","0","0","0","0","0","0","0","0","0","0","0","0","0","0","0","0","0","0","0","0","-2"
"137315","South Florida State College","2018","Not on tenure/no tenure system, instructors","1","1","0","0","0","0","1","1","0","0","0","0","0","0","0","0","0","0","0","0","0","0","0","0","0","0","0","0","0","0","-2"
"137476","St. Thomas University","2018","Tenured total","19","14","5","0","0","0","0","0","0","1","1","0","1","1","0","0","0","0","17","12","5","0","0","0","0","0","0","0","0","0","-2"
"137476","St. Thomas University","2018","Tenured, professors","19","14","5","0","0","0","0","0","0","1","1","0","1","1","0","0","0","0","17","12","5","0","0","0","0","0","0","0","0","0","-2"
"137476","St. Thomas University","2018","On-Tenure track total","2","1","1","0","0","0","1","1","0","0","0","0","0","0","0","0","0","0","1","0","1","0","0","0","0","0","0","0","0","0","-2"
"137476","St. Thomas University","2018","On-tenure track, professors","2","1","1","0","0","0","1","1","0","0","0","0","0","0","0","0","0","0","1","0","1","0","0","0","0","0","0","0","0","0","-2"
"137476","St. Thomas University","2018","Not on tenure track/No tenure system system total","68","34","34","0","0","0","4","3","1","11","6","5","11","4","7","0","0","0","42","21","21","0","0","0","0","0","0","0","0","0","-2"
"137476","St. Thomas University","2018","Not on tenure/no tenure system, professors","20","13","7","0","0","0","1","1","0","0","0","0","4","1","3","0","0","0","15","11","4","0","0","0","0","0","0","0","0","0","-2"
"137476","St. Thomas University","2018","Not on tenure/no tenure system, associate professors","23","11","12","0","0","0","2","1","1","5","2","3","2","1","1","0","0","0","14","7","7","0","0","0","0","0","0","0","0","0","-2"
"137476","St. Thomas University","2018","Not on tenure/no tenure system, assistant professors","20","8","12","0","0","0","1","1","0","4","3","1","4","1","3","0","0","0","11","3","8","0","0","0","0","0","0","0","0","0","-2"
"137476","St. Thomas University","2018","Not on tenure/no tenure system, instructors","4","1","3","0","0","0","0","0","0","2","1","1","0","0","0","0","0","0","2","0","2","0","0","0","0","0","0","0","0","0","-2"
"137476","St. Thomas University","2018","Not on tenure/no tenure system, lecturers","1","1","0","0","0","0","0","0","0","0","0","0","1","1","0","0","0","0","0","0","0","0","0","0","0","0","0","0","0","0","-2"
"138187","Valencia College","2018","Tenured total","304","132","172","3","1","2","16","6","10","27","13","14","27","9","18","0","0","0","227","101","126","0","0","0","4","2","2","0","0","0","-2"
"138187","Valencia College","2018","Tenured, no academic rank","304","132","172","3","1","2","16","6","10","27","13","14","27","9","18","0","0","0","227","101","126","0","0","0","4","2","2","0","0","0","-2"
"138187","Valencia College","2018","On-Tenure track total","161","61","100","1","1","0","12","4","8","21","9","12","15","9","6","0","0","0","103","35","68","0","0","0","9","3","6","0","0","0","-2"
"138187","Valencia College","2018","On-tenure track, no academic rank","161","61","100","1","1","0","12","4","8","21","9","12","15","9","6","0","0","0","103","35","68","0","0","0","9","3","6","0","0","0","-2"
"138187","Valencia College","2018","Not on tenure track/No tenure system system total","148","68","80","1","1","0","8","2","6","22","8","14","19","10","9","0","0","0","92","45","47","0","0","0","6","2","4","0","0","0","-2"
"138187","Valencia College","2018","Not on tenure/no tenure system, no academic rank","148","68","80","1","1","0","8","2","6","22","8","14","19","10","9","0","0","0","92","45","47","0","0","0","6","2","4","0","0","0","-2"
"139463","Dalton State College","2018","Tenured total","83","42","41","0","0","0","3","2","1","3","2","1","0","0","0","0","0","0","74","36","38","0","0","0","2","2","0","1","0","1","-2"
"139463","Dalton State College","2018","Tenured, professors","25","17","8","0","0","0","1","1","0","1","1","0","0","0","0","0","0","0","22","14","8","0","0","0","1","1","0","0","0","0","-2"
"139463","Dalton State College","2018","Tenured, associate professors","55","25","30","0","0","0","2","1","1","2","1","1","0","0","0","0","0","0","49","22","27","0","0","0","1","1","0","1","0","1","-2"
"139463","Dalton State College","2018","Tenured, assistant professors","3","0","3","0","0","0","0","0","0","0","0","0","0","0","0","0","0","0","3","0","3","0","0","0","0","0","0","0","0","0","-2"
"139463","Dalton State College","2018","On-Tenure track total","56","24","32","0","0","0","3","2","1","3","1","2","1","1","0","0","0","0","48","19","29","0","0","0","0","0","0","1","1","0","-2"
"139463","Dalton State College","2018","On-tenure track, professors","1","0","1","0","0","0","0","0","0","0","0","0","0","0","0","0","0","0","1","0","1","0","0","0","0","0","0","0","0","0","-2"
"139463","Dalton State College","2018","On-tenure track, associate professors","10","2","8","0","0","0","0","0","0","0","0","0","0","0","0","0","0","0","10","2","8","0","0","0","0","0","0","0","0","0","-2"
"139463","Dalton State College","2018","On-tenure track, assistant professors","44","21","23","0","0","0","2","1","1","3","1","2","1","1","0","0","0","0","37","17","20","0","0","0","0","0","0","1","1","0","-2"
"139463","Dalton State College","2018","On-tenure track, lecturers","1","1","0","0","0","0","1","1","0","0","0","0","0","0","0","0","0","0","0","0","0","0","0","0","0","0","0","0","0","0","-2"
"139463","Dalton State College","2018","Not on tenure track/No tenure system system total","28","11","17","0","0","0","1","1","0","0","0","0","1","0","1","0","0","0","26","10","16","0","0","0","0","0","0","0","0","0","-2"
"139463","Dalton State College","2018","Not on tenure/no tenure system, instructors","6","2","4","0","0","0","0","0","0","0","0","0","1","0","1","0","0","0","5","2","3","0","0","0","0","0","0","0","0","0","-2"
"139463","Dalton State College","2018","Not on tenure/no tenure system, lecturers","19","8","11","0","0","0","1","1","0","0","0","0","0","0","0","0","0","0","18","7","11","0","0","0","0","0","0","0","0","0","-2"
"139463","Dalton State College","2018","Not on tenure/no tenure system, no academic rank","3","1","2","0","0","0","0","0","0","0","0","0","0","0","0","0","0","0","3","1","2","0","0","0","0","0","0","0","0","0","-2"
"142887","American Academy of Art","2018","Not on tenure track/No tenure system system total","21","13","8","0","0","0","1","1","0","1","0","1","0","0","0","0","0","0","19","12","7","0","0","0","0","0","0","0","0","0","-2"
"142887","American Academy of Art","2018","Not on tenure/no tenure system, instructors","21","13","8","0","0","0","1","1","0","1","0","1","0","0","0","0","0","0","19","12","7","0","0","0","0","0","0","0","0","0","-2"
"143118","Aurora University","2018","Tenured total","52","22","30","0","0","0","1","0","1","0","0","0","1","0","1","0","0","0","50","22","28","0","0","0","0","0","0","0","0","0","-2"
"143118","Aurora University","2018","Tenured, professors","20","11","9","0","0","0","1","0","1","0","0","0","0","0","0","0","0","0","19","11","8","0","0","0","0","0","0","0","0","0","-2"
"143118","Aurora University","2018","Tenured, associate professors","32","11","21","0","0","0","0","0","0","0","0","0","1","0","1","0","0","0","31","11","20","0","0","0","0","0","0","0","0","0","-2"
"143118","Aurora University","2018","On-Tenure track total","36","23","13","0","0","0","2","2","0","1","1","0","1","0","1","0","0","0","30","19","11","0","0","0","2","1","1","0","0","0","-2"
"143118","Aurora University","2018","On-tenure track, professors","1","0","1","0","0","0","0","0","0","0","0","0","0","0","0","0","0","0","1","0","1","0","0","0","0","0","0","0","0","0","-2"
"143118","Aurora University","2018","On-tenure track, assistant professors","35","23","12","0","0","0","2","2","0","1","1","0","1","0","1","0","0","0","29","19","10","0","0","0","2","1","1","0","0","0","-2"
"143118","Aurora University","2018","Not on tenure track/No tenure system system total","51","20","31","0","0","0","0","0","0","2","2","0","2","1","1","0","0","0","47","17","30","0","0","0","0","0","0","0","0","0","-2"
"143118","Aurora University","2018","Not on tenure/no tenure system, professors","4","2","2","0","0","0","0","0","0","0","0","0","0","0","0","0","0","0","4","2","2","0","0","0","0","0","0","0","0","0","-2"
"143118","Aurora University","2018","Not on tenure/no tenure system, associate professors","8","7","1","0","0","0","0","0","0","0","0","0","1","1","0","0","0","0","7","6","1","0","0","0","0","0","0","0","0","0","-2"
"143118","Aurora University","2018","Not on tenure/no tenure system, assistant professors","39","11","28","0","0","0","0","0","0","2","2","0","1","0","1","0","0","0","36","9","27","0","0","0","0","0","0","0","0","0","-2"
"143978","The Chicago School of Professional Psychology at Chicago","2018","Not on tenure track/No tenure system system total","92","34","58","1","0","1","4","1","3","11","2","9","6","2","4","0","0","0","62","26","36","3","0","3","5","3","2","0","0","0","-2"
"143978","The Chicago School of Professional Psychology at Chicago","2018","Not on tenure/no tenure system, professors","15","9","6","1","0","1","0","0","0","0","0","0","0","0","0","0","0","0","12","7","5","0","0","0","2","2","0","0","0","0","-2"
"143978","The Chicago School of Professional Psychology at Chicago","2018","Not on tenure/no tenure system, associate professors","48","15","33","0","0","0","3","1","2","6","0","6","5","1","4","0","0","0","30","12","18","1","0","1","3","1","2","0","0","0","-2"
"143978","The Chicago School of Professional Psychology at Chicago","2018","Not on tenure/no tenure system, assistant professors","28","10","18","0","0","0","1","0","1","5","2","3","1","1","0","0","0","0","19","7","12","2","0","2","0","0","0","0","0","0","-2"
"143978","The Chicago School of Professional Psychology at Chicago","2018","Not on tenure/no tenure system, instructors","1","0","1","0","0","0","0","0","0","0","0","0","0","0","0","0","0","0","1","0","1","0","0","0","0","0","0","0","0","0","-2"
"144351","Concordia University-Chicago","2018","Tenured total","54","25","29","0","0","0","2","1","1","2","0","2","0","0","0","0","0","0","50","24","26","0","0","0","0","0","0","0","0","0","-2"
"144351","Concordia University-Chicago","2018","Tenured, professors","44","18","26","0","0","0","1","0","1","2","0","2","0","0","0","0","0","0","41","18","23","0","0","0","0","0","0","0","0","0","-2"
"144351","Concordia University-Chicago","2018","Tenured, associate professors","10","7","3","0","0","0","1","1","0","0","0","0","0","0","0","0","0","0","9","6","3","0","0","0","0","0","0","0","0","0","-2"
"144351","Concordia University-Chicago","2018","On-Tenure track total","92","39","53","0","0","0","3","2","1","3","1","2","4","3","1","0","0","0","79","30","49","1","1","0","0","0","0","2","2","0","-2"
"144351","Concordia University-Chicago","2018","On-tenure track, professors","8","3","5","0","0","0","0","0","0","0","0","0","0","0","0","0","0","0","8","3","5","0","0","0","0","0","0","0","0","0","-2"
"144351","Concordia University-Chicago","2018","On-tenure track, associate professors","40","18","22","0","0","0","2","1","1","2","1","1","2","1","1","0","0","0","32","13","19","0","0","0","0","0","0","2","2","0","-2"
"144351","Concordia University-Chicago","2018","On-tenure track, assistant professors","44","18","26","0","0","0","1","1","0","1","0","1","2","2","0","0","0","0","39","14","25","1","1","0","0","0","0","0","0","0","-2"
"144351","Concordia University-Chicago","2018","Not on tenure track/No tenure system system total","194","83","111","2","0","2","5","1","4","22","10","12","7","3","4","0","0","0","149","66","83","0","0","0","8","3","5","1","0","1","-2"
"144351","Concordia University-Chicago","2018","Not on tenure/no tenure system, professors","1","1","0","0","0","0","0","0","0","0","0","0","0","0","0","0","0","0","1","1","0","0","0","0","0","0","0","0","0","0","-2"
"144351","Concordia University-Chicago","2018","Not on tenure/no tenure system, associate professors","5","2","3","0","0","0","0","0","0","1","1","0","0","0","0","0","0","0","3","1","2","0","0","0","0","0","0","1","0","1","-2"
"144351","Concordia University-Chicago","2018","Not on tenure/no tenure system, assistant professors","16","6","10","0","0","0","0","0","0","1","1","0","2","2","0","0","0","0","13","3","10","0","0","0","0","0","0","0","0","0","-2"
"144351","Concordia University-Chicago","2018","Not on tenure/no tenure system, instructors","172","74","98","2","0","2","5","1","4","20","8","12","5","1","4","0","0","0","132","61","71","0","0","0","8","3","5","0","0","0","-2"
"145600","University of Illinois Chicago","2018","Tenured total","880","538","342","1","0","1","173","119","54","38","21","17","60","29","31","1","0","1","572","347","225","6","3","3","26","17","9","3","2","1","-2"
"145600","University of Illinois Chicago","2018","Tenured, professors","460","309","151","1","0","1","74","57","17","11","6","5","23","14","9","0","0","0","334","221","113","3","2","1","14","9","5","0","0","0","-2"
"145600","University of Illinois Chicago","2018","Tenured, associate professors","418","227","191","0","0","0","98","61","37","27","15","12","37","15","22","1","0","1","237","125","112","3","1","2","12","8","4","3","2","1","-2"
"145600","University of Illinois Chicago","2018","Tenured, assistant professors","1","1","0","0","0","0","0","0","0","0","0","0","0","0","0","0","0","0","1","1","0","0","0","0","0","0","0","0","0","0","-2"
"145600","University of Illinois Chicago","2018","Tenured, no academic rank","1","1","0","0","0","0","1","1","0","0","0","0","0","0","0","0","0","0","0","0","0","0","0","0","0","0","0","0","0","0","-2"
"145600","University of Illinois Chicago","2018","On-Tenure track total","384","212","172","0","0","0","91","58","33","31","13","18","35","16","19","0","0","0","176","97","79","9","3","6","8","3","5","34","22","12","-2"
"145600","University of Illinois Chicago","2018","On-tenure track, professors","15","11","4","0","0","0","4","3","1","0","0","0","0","0","0","0","0","0","10","7","3","1","1","0","0","0","0","0","0","0","-2"
"145600","University of Illinois Chicago","2018","On-tenure track, associate professors","46","22","24","0","0","0","10","6","4","4","2","2","5","2","3","0","0","0","25","12","13","1","0","1","1","0","1","0","0","0","-2"
"145600","University of Illinois Chicago","2018","On-tenure track, assistant professors","323","179","144","0","0","0","77","49","28","27","11","16","30","14","16","0","0","0","141","78","63","7","2","5","7","3","4","34","22","12","-2"
"145600","University of Illinois Chicago","2018","Not on tenure track/No tenure system system total","883","361","522","0","0","0","147","52","95","51","21","30","51","24","27","1","0","1","569","239","330","11","1","10","13","7","6","40","17","23","-2"
"145600","University of Illinois Chicago","2018","Not on tenure/no tenure system, professors","43","22","21","0","0","0","5","3","2","3","3","0","0","0","0","0","0","0","33","16","17","1","0","1","1","0","1","0","0","0","-2"
"145600","University of Illinois Chicago","2018","Not on tenure/no tenure system, associate professors","107","43","64","0","0","0","17","5","12","3","1","2","5","3","2","0","0","0","79","34","45","0","0","0","3","0","3","0","0","0","-2"
"145600","University of Illinois Chicago","2018","Not on tenure/no tenure system, assistant professors","400","162","238","0","0","0","68","22","46","31","12","19","20","8","12","0","0","0","244","105","139","5","0","5","5","4","1","27","11","16","-2"
"145600","University of Illinois Chicago","2018","Not on tenure/no tenure system, instructors","136","43","93","0","0","0","43","18","25","5","1","4","6","2","4","0","0","0","71","17","54","1","0","1","2","1","1","8","4","4","-2"
"145600","University of Illinois Chicago","2018","Not on tenure/no tenure system, lecturers","187","88","99","0","0","0","14","4","10","8","3","5","19","10","9","1","0","1","135","66","69","3","1","2","2","2","0","5","2","3","-2"
"145600","University of Illinois Chicago","2018","Not on tenure/no tenure system, no academic rank","10","3","7","0","0","0","0","0","0","1","1","0","1","1","0","0","0","0","7","1","6","1","0","1","0","0","0","0","0","0","-2"
"147536","National Louis University","2018","Tenured total","51","20","31","0","0","0","4","0","4","4","4","0","2","1","1","0","0","0","40","14","26","1","1","0","0","0","0","0","0","0","-2"
"147536","National Louis University","2018","Tenured, professors","13","4","9","0","0","0","0","0","0","0","0","0","0","0","0","0","0","0","13","4","9","0","0","0","0","0","0","0","0","0","-2"
"147536","National Louis University","2018","Tenured, associate professors","33","12","21","0","0","0","4","0","4","3","3","0","2","1","1","0","0","0","24","8","16","0","0","0","0","0","0","0","0","0","-2"
"147536","National Louis University","2018","Tenured, assistant professors","5","4","1","0","0","0","0","0","0","1","1","0","0","0","0","0","0","0","3","2","1","1","1","0","0","0","0","0","0","0","-2"
"147536","National Louis University","2018","On-Tenure track total","8","1","7","0","0","0","2","0","2","1","0","1","0","0","0","0","0","0","3","1","2","0","0","0","0","0","0","2","0","2","-2"
"147536","National Louis University","2018","On-tenure track, associate professors","2","0","2","0","0","0","1","0","1","1","0","1","0","0","0","0","0","0","0","0","0","0","0","0","0","0","0","0","0","0","-2"
"147536","National Louis University","2018","On-tenure track, assistant professors","6","1","5","0","0","0","1","0","1","0","0","0","0","0","0","0","0","0","3","1","2","0","0","0","0","0","0","2","0","2","-2"
"147536","National Louis University","2018","Not on tenure track/No tenure system system total","101","37","64","0","0","0","2","2","0","12","1","11","2","0","2","0","0","0","83","33","50","2","1","1","0","0","0","0","0","0","-2"
"147536","National Louis University","2018","Not on tenure/no tenure system, professors","1","0","1","0","0","0","0","0","0","0","0","0","0","0","0","0","0","0","1","0","1","0","0","0","0","0","0","0","0","0","-2"
"147536","National Louis University","2018","Not on tenure/no tenure system, associate professors","11","2","9","0","0","0","1","1","0","0","0","0","0","0","0","0","0","0","9","1","8","1","0","1","0","0","0","0","0","0","-2"
"147536","National Louis University","2018","Not on tenure/no tenure system, assistant professors","80","28","52","0","0","0","1","1","0","12","1","11","2","0","2","0","0","0","64","25","39","1","1","0","0","0","0","0","0","0","-2"
"147536","National Louis University","2018","Not on tenure/no tenure system, lecturers","9","7","2","0","0","0","0","0","0","0","0","0","0","0","0","0","0","0","9","7","2","0","0","0","0","0","0","0","0","0","-2"
"147679","North Park University","2018","Tenured total","76","40","36","0","0","0","2","0","2","4","1","3","3","2","1","0","0","0","21","10","11","0","0","0","46","27","19","0","0","0","-2"
"147679","North Park University","2018","Tenured, professors","57","30","27","0","0","0","1","0","1","2","1","1","1","0","1","0","0","0","17","7","10","0","0","0","36","22","14","0","0","0","-2"
"147679","North Park University","2018","Tenured, associate professors","18","10","8","0","0","0","1","0","1","2","0","2","2","2","0","0","0","0","4","3","1","0","0","0","9","5","4","0","0","0","-2"
"147679","North Park University","2018","Tenured, assistant professors","1","0","1","0","0","0","0","0","0","0","0","0","0","0","0","0","0","0","0","0","0","0","0","0","1","0","1","0","0","0","-2"
"147679","North Park University","2018","On-Tenure track total","19","8","11","0","0","0","0","0","0","7","2","5","0","0","0","0","0","0","9","4","5","0","0","0","3","2","1","0","0","0","-2"
"147679","North Park University","2018","On-tenure track, professors","2","2","0","0","0","0","0","0","0","1","1","0","0","0","0","0","0","0","1","1","0","0","0","0","0","0","0","0","0","0","-2"
"147679","North Park University","2018","On-tenure track, associate professors","6","3","3","0","0","0","0","0","0","1","1","0","0","0","0","0","0","0","3","0","3","0","0","0","2","2","0","0","0","0","-2"
"147679","North Park University","2018","On-tenure track, assistant professors","11","3","8","0","0","0","0","0","0","5","0","5","0","0","0","0","0","0","5","3","2","0","0","0","1","0","1","0","0","0","-2"
"147679","North Park University","2018","Not on tenure track/No tenure system system total","28","11","17","0","0","0","0","0","0","0","0","0","1","0","1","0","0","0","18","6","12","0","0","0","7","3","4","2","2","0","-2"
"147679","North Park University","2018","Not on tenure/no tenure system, professors","3","2","1","0","0","0","0","0","0","0","0","0","0","0","0","0","0","0","0","0","0","0","0","0","3","2","1","0","0","0","-2"
"147679","North Park University","2018","Not on tenure/no tenure system, associate professors","7","3","4","0","0","0","0","0","0","0","0","0","0","0","0","0","0","0","7","3","4","0","0","0","0","0","0","0","0","0","-2"
"147679","North Park University","2018","Not on tenure/no tenure system, assistant professors","15","4","11","0","0","0","0","0","0","0","0","0","0","0","0","0","0","0","10","2","8","0","0","0","4","1","3","1","1","0","-2"
"147679","North Park University","2018","Not on tenure/no tenure system, no academic rank","3","2","1","0","0","0","0","0","0","0","0","0","1","0","1","0","0","0","1","1","0","0","0","0","0","0","0","1","1","0","-2"
"147776","Northeastern Illinois University","2018","Tenured total","155","71","84","0","0","0","23","10","13","15","7","8","16","6","10","0","0","0","89","41","48","0","0","0","10","7","3","2","0","2","-2"
"147776","Northeastern Illinois University","2018","Tenured, professors","63","33","30","0","0","0","11","5","6","8","4","4","5","3","2","0","0","0","38","20","18","0","0","0","1","1","0","0","0","0","-2"
"147776","Northeastern Illinois University","2018","Tenured, associate professors","91","38","53","0","0","0","12","5","7","7","3","4","11","3","8","0","0","0","50","21","29","0","0","0","9","6","3","2","0","2","-2"
"147776","Northeastern Illinois University","2018","Tenured, assistant professors","1","0","1","0","0","0","0","0","0","0","0","0","0","0","0","0","0","0","1","0","1","0","0","0","0","0","0","0","0","0","-2"
"147776","Northeastern Illinois University","2018","On-Tenure track total","61","28","33","1","1","0","8","4","4","4","2","2","8","4","4","0","0","0","30","11","19","0","0","0","7","5","2","3","1","2","-2"
"147776","Northeastern Illinois University","2018","On-tenure track, professors","1","0","1","0","0","0","0","0","0","0","0","0","0","0","0","0","0","0","1","0","1","0","0","0","0","0","0","0","0","0","-2"
"147776","Northeastern Illinois University","2018","On-tenure track, assistant professors","60","28","32","1","1","0","8","4","4","4","2","2","8","4","4","0","0","0","29","11","18","0","0","0","7","5","2","3","1","2","-2"
"147776","Northeastern Illinois University","2018","Not on tenure track/No tenure system system total","83","36","47","0","0","0","5","3","2","2","2","0","5","2","3","0","0","0","63","25","38","0","0","0","8","4","4","0","0","0","-2"
"147776","Northeastern Illinois University","2018","Not on tenure/no tenure system, instructors","82","36","46","0","0","0","5","3","2","2","2","0","5","2","3","0","0","0","62","25","37","0","0","0","8","4","4","0","0","0","-2"
"147776","Northeastern Illinois University","2018","Not on tenure/no tenure system, no academic rank","1","0","1","0","0","0","0","0","0","0","0","0","0","0","0","0","0","0","1","0","1","0","0","0","0","0","0","0","0","0","-2"
"148335","Robert Morris University Illinois","2018","Not on tenure track/No tenure system system total","49","30","19","0","0","0","9","6","3","4","3","1","3","2","1","0","0","0","33","19","14","0","0","0","0","0","0","0","0","0","-2"
"148335","Robert Morris University Illinois","2018","Not on tenure/no tenure system, professors","49","30","19","0","0","0","9","6","3","4","3","1","3","2","1","0","0","0","33","19","14","0","0","0","0","0","0","0","0","0","-2"
"148487","Roosevelt University","2018","Tenured total","121","66","55","1","1","0","2","1","1","7","3","4","4","3","1","0","0","0","84","41","43","4","2","2","6","6","0","13","9","4","-2"
"148487","Roosevelt University","2018","Tenured, professors","39","25","14","0","0","0","1","1","0","3","2","1","3","2","1","0","0","0","27","15","12","1","1","0","2","2","0","2","2","0","-2"
"148487","Roosevelt University","2018","Tenured, associate professors","79","39","40","1","1","0","1","0","1","4","1","3","1","1","0","0","0","0","55","25","30","3","1","2","4","4","0","10","6","4","-2"
"148487","Roosevelt University","2018","Tenured, assistant professors","2","1","1","0","0","0","0","0","0","0","0","0","0","0","0","0","0","0","2","1","1","0","0","0","0","0","0","0","0","0","-2"
"148487","Roosevelt University","2018","Tenured, no academic rank","1","1","0","0","0","0","0","0","0","0","0","0","0","0","0","0","0","0","0","0","0","0","0","0","0","0","0","1","1","0","-2"
"148487","Roosevelt University","2018","On-Tenure track total","27","19","8","0","0","0","0","0","0","0","0","0","0","0","0","0","0","0","14","9","5","0","0","0","0","0","0","13","10","3","-2"
"148487","Roosevelt University","2018","On-tenure track, associate professors","2","2","0","0","0","0","0","0","0","0","0","0","0","0","0","0","0","0","1","1","0","0","0","0","0","0","0","1","1","0","-2"
"148487","Roosevelt University","2018","On-tenure track, assistant professors","21","14","7","0","0","0","0","0","0","0","0","0","0","0","0","0","0","0","13","8","5","0","0","0","0","0","0","8","6","2","-2"
"148487","Roosevelt University","2018","On-tenure track, no academic rank","4","3","1","0","0","0","0","0","0","0","0","0","0","0","0","0","0","0","0","0","0","0","0","0","0","0","0","4","3","1","-2"
"148487","Roosevelt University","2018","Not on tenure track/No tenure system system total","50","27","23","0","0","0","1","0","1","1","1","0","2","1","1","0","0","0","32","17","15","1","0","1","7","3","4","6","5","1","-2"
"148487","Roosevelt University","2018","Not on tenure/no tenure system, professors","1","1","0","0","0","0","0","0","0","0","0","0","0","0","0","0","0","0","1","1","0","0","0","0","0","0","0","0","0","0","-2"
"148487","Roosevelt University","2018","Not on tenure/no tenure system, associate professors","3","2","1","0","0","0","0","0","0","0","0","0","0","0","0","0","0","0","2","1","1","0","0","0","1","1","0","0","0","0","-2"
"148487","Roosevelt University","2018","Not on tenure/no tenure system, assistant professors","18","8","10","0","0","0","0","0","0","0","0","0","2","1","1","0","0","0","11","5","6","0","0","0","3","0","3","2","2","0","-2"
"148487","Roosevelt University","2018","Not on tenure/no tenure system, lecturers","17","10","7","0","0","0","1","0","1","1","1","0","0","0","0","0","0","0","13","8","5","1","0","1","0","0","0","1","1","0","-2"
"148487","Roosevelt University","2018","Not on tenure/no tenure system, no academic rank","11","6","5","0","0","0","0","0","0","0","0","0","0","0","0","0","0","0","5","2","3","0","0","0","3","2","1","3","2","1","-2"
"148496","Dominican University","2018","Tenured total","94","38","56","0","0","0","8","4","4","6","3","3","6","1","5","0","0","0","72","28","44","1","1","0","1","1","0","0","0","0","-2"
"148496","Dominican University","2018","Tenured, professors","48","22","26","0","0","0","4","2","2","2","1","1","2","1","1","0","0","0","40","18","22","0","0","0","0","0","0","0","0","0","-2"
"148496","Dominican University","2018","Tenured, associate professors","39","14","25","0","0","0","4","2","2","3","2","1","4","0","4","0","0","0","26","8","18","1","1","0","1","1","0","0","0","0","-2"
"148496","Dominican University","2018","Tenured, assistant professors","7","2","5","0","0","0","0","0","0","1","0","1","0","0","0","0","0","0","6","2","4","0","0","0","0","0","0","0","0","0","-2"
"148496","Dominican University","2018","On-Tenure track total","29","15","14","0","0","0","7","2","5","1","1","0","4","3","1","0","0","0","16","9","7","0","0","0","1","0","1","0","0","0","-2"
"148496","Dominican University","2018","On-tenure track, associate professors","8","4","4","0","0","0","2","0","2","0","0","0","1","1","0","0","0","0","5","3","2","0","0","0","0","0","0","0","0","0","-2"
"148496","Dominican University","2018","On-tenure track, assistant professors","20","10","10","0","0","0","5","2","3","1","1","0","2","1","1","0","0","0","11","6","5","0","0","0","1","0","1","0","0","0","-2"
"148496","Dominican University","2018","On-tenure track, instructors","1","1","0","0","0","0","0","0","0","0","0","0","1","1","0","0","0","0","0","0","0","0","0","0","0","0","0","0","0","0","-2"
"148496","Dominican University","2018","Not on tenure track/No tenure system system total","35","10","25","0","0","0","1","1","0","3","1","2","5","1","4","0","0","0","25","7","18","1","0","1","0","0","0","0","0","0","-2"
"148496","Dominican University","2018","Not on tenure/no tenure system, assistant professors","3","0","3","0","0","0","0","0","0","1","0","1","0","0","0","0","0","0","1","0","1","1","0","1","0","0","0","0","0","0","-2"
"148496","Dominican University","2018","Not on tenure/no tenure system, lecturers","32","10","22","0","0","0","1","1","0","2","1","1","5","1","4","0","0","0","24","7","17","0","0","0","0","0","0","0","0","0","-2"
"148511","Rush University","2018","Tenured total","275","154","121","2","2","0","45","28","17","9","2","7","14","8","6","0","0","0","203","112","91","2","2","0","0","0","0","0","0","0","-2"
"148511","Rush University","2018","Tenured, professors","124","76","48","0","0","0","13","10","3","3","1","2","3","3","0","0","0","0","103","60","43","2","2","0","0","0","0","0","0","0","-2"
"148511","Rush University","2018","Tenured, associate professors","151","78","73","2","2","0","32","18","14","6","1","5","11","5","6","0","0","0","100","52","48","0","0","0","0","0","0","0","0","0","-2"
"148511","Rush University","2018","On-Tenure track total","716","298","418","1","1","0","177","71","106","36","10","26","41","15","26","0","0","0","447","194","253","14","7","7","0","0","0","0","0","0","-2"
"148511","Rush University","2018","On-tenure track, assistant professors","575","240","335","1","1","0","160","63","97","29","8","21","31","11","20","0","0","0","345","154","191","9","3","6","0","0","0","0","0","0","-2"
"148511","Rush University","2018","On-tenure track, instructors","141","58","83","0","0","0","17","8","9","7","2","5","10","4","6","0","0","0","102","40","62","5","4","1","0","0","0","0","0","0","-2"
"148511","Rush University","2018","Not on tenure track/No tenure system system total","73","32","41","0","0","0","6","3","3","6","2","4","3","1","2","0","0","0","54","24","30","3","1","2","1","1","0","0","0","0","-2"
"148511","Rush University","2018","Not on tenure/no tenure system, lecturers","5","4","1","0","0","0","0","0","0","0","0","0","0","0","0","0","0","0","5","4","1","0","0","0","0","0","0","0","0","0","-2"
"148511","Rush University","2018","Not on tenure/no tenure system, no academic rank","68","28","40","0","0","0","6","3","3","6","2","4","3","1","2","0","0","0","49","20","29","3","1","2","1","1","0","0","0","0","-2"
"148627","Saint Xavier University","2018","Tenured total","67","31","36","1","0","1","6","3","3","1","0","1","1","0","1","0","0","0","57","28","29","0","0","0","1","0","1","0","0","0","-2"
"148627","Saint Xavier University","2018","Tenured, professors","22","11","11","0","0","0","1","1","0","0","0","0","0","0","0","0","0","0","21","10","11","0","0","0","0","0","0","0","0","0","-2"
"148627","Saint Xavier University","2018","Tenured, associate professors","45","20","25","1","0","1","5","2","3","1","0","1","1","0","1","0","0","0","36","18","18","0","0","0","1","0","1","0","0","0","-2"
"148627","Saint Xavier University","2018","On-Tenure track total","28","9","19","0","0","0","1","1","0","1","0","1","0","0","0","0","0","0","20","6","14","0","0","0","6","2","4","0","0","0","-2"
"148627","Saint Xavier University","2018","On-tenure track, professors","1","0","1","0","0","0","0","0","0","0","0","0","0","0","0","0","0","0","1","0","1","0","0","0","0","0","0","0","0","0","-2"
"148627","Saint Xavier University","2018","On-tenure track, associate professors","1","0","1","0","0","0","0","0","0","0","0","0","0","0","0","0","0","0","1","0","1","0","0","0","0","0","0","0","0","0","-2"
"148627","Saint Xavier University","2018","On-tenure track, assistant professors","26","9","17","0","0","0","1","1","0","1","0","1","0","0","0","0","0","0","18","6","12","0","0","0","6","2","4","0","0","0","-2"
"148627","Saint Xavier University","2018","Not on tenure track/No tenure system system total","45","15","30","0","0","0","1","0","1","5","2","3","4","1","3","0","0","0","27","8","19","1","0","1","7","4","3","0","0","0","-2"
"148627","Saint Xavier University","2018","Not on tenure/no tenure system, assistant professors","2","0","2","0","0","0","0","0","0","1","0","1","0","0","0","0","0","0","1","0","1","0","0","0","0","0","0","0","0","0","-2"
"148627","Saint Xavier University","2018","Not on tenure/no tenure system, instructors","1","0","1","0","0","0","0","0","0","0","0","0","0","0","0","0","0","0","1","0","1","0","0","0","0","0","0","0","0","0","-2"
"148627","Saint Xavier University","2018","Not on tenure/no tenure system, lecturers","34","14","20","0","0","0","1","0","1","4","2","2","4","1","3","0","0","0","17","7","10","1","0","1","7","4","3","0","0","0","-2"
"148627","Saint Xavier University","2018","Not on tenure/no tenure system, no academic rank","8","1","7","0","0","0","0","0","0","0","0","0","0","0","0","0","0","0","8","1","7","0","0","0","0","0","0","0","0","0","-2"
"148876","Saint Augustine College","2018","Not on tenure track/No tenure system system total","25","11","14","0","0","0","2","1","1","1","0","1","13","9","4","0","0","0","9","1","8","0","0","0","0","0","0","0","0","0","-2"
"148876","Saint Augustine College","2018","Not on tenure/no tenure system, associate professors","4","2","2","0","0","0","0","0","0","0","0","0","2","2","0","0","0","0","2","0","2","0","0","0","0","0","0","0","0","0","-2"
"148876","Saint Augustine College","2018","Not on tenure/no tenure system, assistant professors","18","6","12","0","0","0","1","0","1","1","0","1","10","6","4","0","0","0","6","0","6","0","0","0","0","0","0","0","0","0","-2"
"148876","Saint Augustine College","2018","Not on tenure/no tenure system, instructors","2","2","0","0","0","0","1","1","0","0","0","0","1","1","0","0","0","0","0","0","0","0","0","0","0","0","0","0","0","0","-2"
"148876","Saint Augustine College","2018","Not on tenure/no tenure system, no academic rank","1","1","0","0","0","0","0","0","0","0","0","0","0","0","0","0","0","0","1","1","0","0","0","0","0","0","0","0","0","0","-2"
"149639","VanderCook College of Music","2018","Not on tenure track/No tenure system system total","9","3","6","0","0","0","2","0","2","1","1","0","0","0","0","0","0","0","6","2","4","0","0","0","0","0","0","0","0","0","-2"
"149639","VanderCook College of Music","2018","Not on tenure/no tenure system, professors","1","0","1","0","0","0","0","0","0","0","0","0","0","0","0","0","0","0","1","0","1","0","0","0","0","0","0","0","0","0","-2"
"149639","VanderCook College of Music","2018","Not on tenure/no tenure system, associate professors","7","2","5","0","0","0","2","0","2","1","1","0","0","0","0","0","0","0","4","1","3","0","0","0","0","0","0","0","0","0","-2"
"149639","VanderCook College of Music","2018","Not on tenure/no tenure system, assistant professors","1","1","0","0","0","0","0","0","0","0","0","0","0","0","0","0","0","0","1","1","0","0","0","0","0","0","0","0","0","0","-2"
"150172","Calumet College of Saint Joseph","2018","Tenured total","12","8","4","0","0","0","0","0","0","0","0","0","0","0","0","0","0","0","12","8","4","0","0","0","0","0","0","0","0","0","-2"
"150172","Calumet College of Saint Joseph","2018","Tenured, professors","4","4","0","0","0","0","0","0","0","0","0","0","0","0","0","0","0","0","4","4","0","0","0","0","0","0","0","0","0","0","-2"
"150172","Calumet College of Saint Joseph","2018","Tenured, associate professors","7","3","4","0","0","0","0","0","0","0","0","0","0","0","0","0","0","0","7","3","4","0","0","0","0","0","0","0","0","0","-2"
"150172","Calumet College of Saint Joseph","2018","Tenured, assistant professors","1","1","0","0","0","0","0","0","0","0","0","0","0","0","0","0","0","0","1","1","0","0","0","0","0","0","0","0","0","0","-2"
"150172","Calumet College of Saint Joseph","2018","On-Tenure track total","9","5","4","0","0","0","1","1","0","1","0","1","3","1","2","0","0","0","4","3","1","0","0","0","0","0","0","0","0","0","-2"
"150172","Calumet College of Saint Joseph","2018","On-tenure track, assistant professors","9","5","4","0","0","0","1","1","0","1","0","1","3","1","2","0","0","0","4","3","1","0","0","0","0","0","0","0","0","0","-2"
"150172","Calumet College of Saint Joseph","2018","Not on tenure track/No tenure system system total","7","3","4","0","0","0","0","0","0","1","0","1","0","0","0","0","0","0","6","3","3","0","0","0","0","0","0","0","0","0","-2"
"150172","Calumet College of Saint Joseph","2018","Not on tenure/no tenure system, instructors","7","3","4","0","0","0","0","0","0","1","0","1","0","0","0","0","0","0","6","3","3","0","0","0","0","0","0","0","0","0","-2"
"151360","Indiana University-Northwest","2018","Tenured total","64","41","23","0","0","0","9","5","4","4","4","0","6","4","2","0","0","0","44","27","17","1","1","0","0","0","0","0","0","0","-2"
"151360","Indiana University-Northwest","2018","Tenured, professors","32","20","12","0","0","0","5","3","2","2","2","0","2","0","2","0","0","0","22","14","8","1","1","0","0","0","0","0","0","0","-2"
"151360","Indiana University-Northwest","2018","Tenured, associate professors","32","21","11","0","0","0","4","2","2","2","2","0","4","4","0","0","0","0","22","13","9","0","0","0","0","0","0","0","0","0","-2"
"151360","Indiana University-Northwest","2018","On-Tenure track total","39","15","24","0","0","0","7","4","3","7","0","7","0","0","0","0","0","0","24","10","14","1","1","0","0","0","0","0","0","0","-2"
"151360","Indiana University-Northwest","2018","On-tenure track, associate professors","13","5","8","0","0","0","2","1","1","3","0","3","0","0","0","0","0","0","8","4","4","0","0","0","0","0","0","0","0","0","-2"
"151360","Indiana University-Northwest","2018","On-tenure track, assistant professors","26","10","16","0","0","0","5","3","2","4","0","4","0","0","0","0","0","0","16","6","10","1","1","0","0","0","0","0","0","0","-2"
"151360","Indiana University-Northwest","2018","Not on tenure track/No tenure system system total","52","18","34","0","0","0","0","0","0","5","0","5","3","2","1","0","0","0","43","16","27","1","0","1","0","0","0","0","0","0","-2"
"151360","Indiana University-Northwest","2018","Not on tenure/no tenure system, professors","1","1","0","0","0","0","0","0","0","0","0","0","0","0","0","0","0","0","1","1","0","0","0","0","0","0","0","0","0","0","-2"
"151360","Indiana University-Northwest","2018","Not on tenure/no tenure system, associate professors","4","0","4","0","0","0","0","0","0","0","0","0","0","0","0","0","0","0","4","0","4","0","0","0","0","0","0","0","0","0","-2"
"151360","Indiana University-Northwest","2018","Not on tenure/no tenure system, assistant professors","30","8","22","0","0","0","0","0","0","5","0","5","1","1","0","0","0","0","24","7","17","0","0","0","0","0","0","0","0","0","-2"
"151360","Indiana University-Northwest","2018","Not on tenure/no tenure system, lecturers","17","9","8","0","0","0","0","0","0","0","0","0","2","1","1","0","0","0","14","8","6","1","0","1","0","0","0","0","0","0","-2"
"155007","Donnelly College","2018","Not on tenure track/No tenure system system total","18","4","14","0","0","0","0","0","0","2","1","1","3","1","2","0","0","0","12","2","10","0","0","0","1","0","1","0","0","0","-2"
"155007","Donnelly College","2018","Not on tenure/no tenure system, professors","2","1","1","0","0","0","0","0","0","0","0","0","1","1","0","0","0","0","1","0","1","0","0","0","0","0","0","0","0","0","-2"
"155007","Donnelly College","2018","Not on tenure/no tenure system, associate professors","1","0","1","0","0","0","0","0","0","0","0","0","0","0","0","0","0","0","1","0","1","0","0","0","0","0","0","0","0","0","-2"
"155007","Donnelly College","2018","Not on tenure/no tenure system, assistant professors","13","2","11","0","0","0","0","0","0","1","0","1","2","0","2","0","0","0","9","2","7","0","0","0","1","0","1","0","0","0","-2"
"155007","Donnelly College","2018","Not on tenure/no tenure system, instructors","2","1","1","0","0","0","0","0","0","1","1","0","0","0","0","0","0","0","1","0","1","0","0","0","0","0","0","0","0","0","-2"
"160409","Saint Joseph Seminary College","2018","Not on tenure track/No tenure system system total","29","22","7","0","0","0","1","1","0","0","0","0","1","1","0","0","0","0","26","19","7","1","1","0","0","0","0","0","0","0","-2"
"160409","Saint Joseph Seminary College","2018","Not on tenure/no tenure system, professors","26","20","6","0","0","0","1","1","0","0","0","0","1","1","0","0","0","0","23","17","6","1","1","0","0","0","0","0","0","0","-2"
"160409","Saint Joseph Seminary College","2018","Not on tenure/no tenure system, no academic rank","3","2","1","0","0","0","0","0","0","0","0","0","0","0","0","0","0","0","3","2","1","0","0","0","0","0","0","0","0","0","-2"
"165167","Cambridge College","2018","Not on tenure track/No tenure system system total","17","7","10","0","0","0","2","0","2","2","1","1","0","0","0","0","0","0","13","6","7","0","0","0","0","0","0","0","0","0","-2"
"165167","Cambridge College","2018","Not on tenure/no tenure system, professors","12","5","7","0","0","0","2","0","2","2","1","1","0","0","0","0","0","0","8","4","4","0","0","0","0","0","0","0","0","0","-2"
"165167","Cambridge College","2018","Not on tenure/no tenure system, associate professors","2","1","1","0","0","0","0","0","0","0","0","0","0","0","0","0","0","0","2","1","1","0","0","0","0","0","0","0","0","0","-2"
"165167","Cambridge College","2018","Not on tenure/no tenure system, assistant professors","2","1","1","0","0","0","0","0","0","0","0","0","0","0","0","0","0","0","2","1","1","0","0","0","0","0","0","0","0","0","-2"
"165167","Cambridge College","2018","Not on tenure/no tenure system, lecturers","1","0","1","0","0","0","0","0","0","0","0","0","0","0","0","0","0","0","1","0","1","0","0","0","0","0","0","0","0","0","-2"
"165884","Benjamin Franklin Institute of Technology","2018","Not on tenure track/No tenure system system total","41","30","11","0","0","0","2","2","0","1","1","0","1","1","0","0","0","0","35","25","10","0","0","0","1","0","1","1","1","0","-2"
"165884","Benjamin Franklin Institute of Technology","2018","Not on tenure/no tenure system, professors","8","4","4","0","0","0","0","0","0","0","0","0","0","0","0","0","0","0","7","4","3","0","0","0","1","0","1","0","0","0","-2"
"165884","Benjamin Franklin Institute of Technology","2018","Not on tenure/no tenure system, associate professors","11","10","1","0","0","0","2","2","0","1","1","0","0","0","0","0","0","0","8","7","1","0","0","0","0","0","0","0","0","0","-2"
"165884","Benjamin Franklin Institute of Technology","2018","Not on tenure/no tenure system, assistant professors","13","8","5","0","0","0","0","0","0","0","0","0","1","1","0","0","0","0","12","7","5","0","0","0","0","0","0","0","0","0","-2"
"165884","Benjamin Franklin Institute of Technology","2018","Not on tenure/no tenure system, instructors","9","8","1","0","0","0","0","0","0","0","0","0","0","0","0","0","0","0","8","7","1","0","0","0","0","0","0","1","1","0","-2"
"182005","College of Southern Nevada","2018","Tenured total","368","190","178","4","2","2","30","15","15","18","7","11","22","9","13","0","0","0","289","153","136","3","2","1","0","0","0","2","2","0","-2"
"182005","College of Southern Nevada","2018","Tenured, professors","367","190","177","4","2","2","30","15","15","18","7","11","22","9","13","0","0","0","288","153","135","3","2","1","0","0","0","2","2","0","-2"
"182005","College of Southern Nevada","2018","Tenured, no academic rank","1","0","1","0","0","0","0","0","0","0","0","0","0","0","0","0","0","0","1","0","1","0","0","0","0","0","0","0","0","0","-2"
"182005","College of Southern Nevada","2018","On-Tenure track total","79","44","35","0","0","0","9","5","4","5","1","4","4","3","1","0","0","0","56","32","24","2","1","1","3","2","1","0","0","0","-2"
"182005","College of Southern Nevada","2018","On-tenure track, instructors","79","44","35","0","0","0","9","5","4","5","1","4","4","3","1","0","0","0","56","32","24","2","1","1","3","2","1","0","0","0","-2"
"182005","College of Southern Nevada","2018","Not on tenure track/No tenure system system total","68","39","29","0","0","0","3","2","1","3","0","3","9","8","1","0","0","0","50","27","23","1","1","0","2","1","1","0","0","0","-2"
"182005","College of Southern Nevada","2018","Not on tenure/no tenure system, instructors","38","23","15","0","0","0","1","1","0","1","0","1","5","5","0","0","0","0","31","17","14","0","0","0","0","0","0","0","0","0","-2"
"182005","College of Southern Nevada","2018","Not on tenure/no tenure system, lecturers","1","0","1","0","0","0","0","0","0","0","0","0","0","0","0","0","0","0","1","0","1","0","0","0","0","0","0","0","0","0","-2"
"182005","College of Southern Nevada","2018","Not on tenure/no tenure system, no academic rank","29","16","13","0","0","0","2","1","1","2","0","2","4","3","1","0","0","0","18","10","8","1","1","0","2","1","1","0","0","0","-2"
"182500","Truckee Meadows Community College","2018","Tenured total","100","51","49","0","0","0","5","1","4","1","0","1","6","3","3","1","1","0","86","46","40","1","0","1","0","0","0","0","0","0","-2"
"182500","Truckee Meadows Community College","2018","Tenured, professors","100","51","49","0","0","0","5","1","4","1","0","1","6","3","3","1","1","0","86","46","40","1","0","1","0","0","0","0","0","0","-2"
"182500","Truckee Meadows Community College","2018","On-Tenure track total","42","19","23","0","0","0","4","4","0","1","0","1","1","1","0","1","1","0","34","13","21","0","0","0","1","0","1","0","0","0","-2"
"182500","Truckee Meadows Community College","2018","On-tenure track, instructors","42","19","23","0","0","0","4","4","0","1","0","1","1","1","0","1","1","0","34","13","21","0","0","0","1","0","1","0","0","0","-2"
"182500","Truckee Meadows Community College","2018","Not on tenure track/No tenure system system total","16","6","10","0","0","0","0","0","0","0","0","0","2","1","1","0","0","0","14","5","9","0","0","0","0","0","0","0","0","0","-2"
"182500","Truckee Meadows Community College","2018","Not on tenure/no tenure system, instructors","14","6","8","0","0","0","0","0","0","0","0","0","1","1","0","0","0","0","13","5","8","0","0","0","0","0","0","0","0","0","-2"
"182500","Truckee Meadows Community College","2018","Not on tenure/no tenure system, no academic rank","2","0","2","0","0","0","0","0","0","0","0","0","1","0","1","0","0","0","1","0","1","0","0","0","0","0","0","0","0","0","-2"
"183822","Bloomfield College","2018","Tenured total","46","18","28","0","0","0","2","1","1","6","1","5","4","1","3","0","0","0","34","15","19","0","0","0","0","0","0","0","0","0","-2"
"183822","Bloomfield College","2018","Tenured, professors","30","11","19","0","0","0","0","0","0","4","0","4","2","0","2","0","0","0","24","11","13","0","0","0","0","0","0","0","0","0","-2"
"183822","Bloomfield College","2018","Tenured, associate professors","16","7","9","0","0","0","2","1","1","2","1","1","2","1","1","0","0","0","10","4","6","0","0","0","0","0","0","0","0","0","-2"
"183822","Bloomfield College","2018","On-Tenure track total","19","6","13","0","0","0","1","0","1","3","1","2","1","1","0","0","0","0","14","4","10","0","0","0","0","0","0","0","0","0","-2"
"183822","Bloomfield College","2018","On-tenure track, associate professors","4","2","2","0","0","0","0","0","0","1","1","0","1","1","0","0","0","0","2","0","2","0","0","0","0","0","0","0","0","0","-2"
"183822","Bloomfield College","2018","On-tenure track, assistant professors","15","4","11","0","0","0","1","0","1","2","0","2","0","0","0","0","0","0","12","4","8","0","0","0","0","0","0","0","0","0","-2"
"183822","Bloomfield College","2018","Not on tenure track/No tenure system system total","1","1","0","0","0","0","0","0","0","0","0","0","0","0","0","0","0","0","1","1","0","0","0","0","0","0","0","0","0","0","-2"
"183822","Bloomfield College","2018","Not on tenure/no tenure system, associate professors","1","1","0","0","0","0","0","0","0","0","0","0","0","0","0","0","0","0","1","1","0","0","0","0","0","0","0","0","0","0","-2"
"183910","Caldwell University","2018","Tenured total","39","19","20","0","0","0","1","0","1","0","0","0","1","1","0","0","0","0","36","18","18","0","0","0","1","0","1","0","0","0","-2"
"183910","Caldwell University","2018","Tenured, professors","32","16","16","0","0","0","1","0","1","0","0","0","1","1","0","0","0","0","29","15","14","0","0","0","1","0","1","0","0","0","-2"
"183910","Caldwell University","2018","Tenured, associate professors","5","3","2","0","0","0","0","0","0","0","0","0","0","0","0","0","0","0","5","3","2","0","0","0","0","0","0","0","0","0","-2"
"183910","Caldwell University","2018","Tenured, assistant professors","2","0","2","0","0","0","0","0","0","0","0","0","0","0","0","0","0","0","2","0","2","0","0","0","0","0","0","0","0","0","-2"
"183910","Caldwell University","2018","On-Tenure track total","34","7","27","0","0","0","2","1","1","3","0","3","3","0","3","0","0","0","25","6","19","1","0","1","0","0","0","0","0","0","-2"
"183910","Caldwell University","2018","On-tenure track, associate professors","3","0","3","0","0","0","0","0","0","0","0","0","0","0","0","0","0","0","3","0","3","0","0","0","0","0","0","0","0","0","-2"
"183910","Caldwell University","2018","On-tenure track, assistant professors","29","7","22","0","0","0","2","1","1","3","0","3","2","0","2","0","0","0","21","6","15","1","0","1","0","0","0","0","0","0","-2"
"183910","Caldwell University","2018","On-tenure track, instructors","2","0","2","0","0","0","0","0","0","0","0","0","1","0","1","0","0","0","1","0","1","0","0","0","0","0","0","0","0","0","-2"
"183910","Caldwell University","2018","Not on tenure track/No tenure system system total","4","0","4","0","0","0","0","0","0","0","0","0","0","0","0","0","0","0","4","0","4","0","0","0","0","0","0","0","0","0","-2"
"183910","Caldwell University","2018","Not on tenure/no tenure system, assistant professors","3","0","3","0","0","0","0","0","0","0","0","0","0","0","0","0","0","0","3","0","3","0","0","0","0","0","0","0","0","0","-2"
"183910","Caldwell University","2018","Not on tenure/no tenure system, instructors","1","0","1","0","0","0","0","0","0","0","0","0","0","0","0","0","0","0","1","0","1","0","0","0","0","0","0","0","0","0","-2"
"184603","Fairleigh Dickinson University-Metropolitan Campus","2018","Tenured total","81","50","31","0","0","0","15","9","6","4","4","0","0","0","0","0","0","0","61","36","25","1","1","0","0","0","0","0","0","0","-2"
"184603","Fairleigh Dickinson University-Metropolitan Campus","2018","Tenured, professors","47","31","16","0","0","0","7","4","3","2","2","0","0","0","0","0","0","0","37","24","13","1","1","0","0","0","0","0","0","0","-2"
"184603","Fairleigh Dickinson University-Metropolitan Campus","2018","Tenured, associate professors","31","16","15","0","0","0","8","5","3","2","2","0","0","0","0","0","0","0","21","9","12","0","0","0","0","0","0","0","0","0","-2"
"184603","Fairleigh Dickinson University-Metropolitan Campus","2018","Tenured, assistant professors","3","3","0","0","0","0","0","0","0","0","0","0","0","0","0","0","0","0","3","3","0","0","0","0","0","0","0","0","0","0","-2"
"184603","Fairleigh Dickinson University-Metropolitan Campus","2018","On-Tenure track total","44","25","19","0","0","0","10","7","3","2","1","1","0","0","0","0","0","0","25","14","11","6","2","4","1","1","0","0","0","0","-2"
"184603","Fairleigh Dickinson University-Metropolitan Campus","2018","On-tenure track, associate professors","3","2","1","0","0","0","2","1","1","0","0","0","0","0","0","0","0","0","1","1","0","0","0","0","0","0","0","0","0","0","-2"
"184603","Fairleigh Dickinson University-Metropolitan Campus","2018","On-tenure track, assistant professors","41","23","18","0","0","0","8","6","2","2","1","1","0","0","0","0","0","0","24","13","11","6","2","4","1","1","0","0","0","0","-2"
"184603","Fairleigh Dickinson University-Metropolitan Campus","2018","Not on tenure track/No tenure system system total","46","20","26","0","0","0","4","1","3","3","0","3","0","0","0","0","0","0","33","18","15","6","1","5","0","0","0","0","0","0","-2"
"184603","Fairleigh Dickinson University-Metropolitan Campus","2018","Not on tenure/no tenure system, associate professors","1","0","1","0","0","0","0","0","0","0","0","0","0","0","0","0","0","0","0","0","0","1","0","1","0","0","0","0","0","0","-2"
"184603","Fairleigh Dickinson University-Metropolitan Campus","2018","Not on tenure/no tenure system, assistant professors","4","0","4","0","0","0","2","0","2","1","0","1","0","0","0","0","0","0","1","0","1","0","0","0","0","0","0","0","0","0","-2"
"184603","Fairleigh Dickinson University-Metropolitan Campus","2018","Not on tenure/no tenure system, instructors","4","0","4","0","0","0","0","0","0","1","0","1","0","0","0","0","0","0","3","0","3","0","0","0","0","0","0","0","0","0","-2"
"184603","Fairleigh Dickinson University-Metropolitan Campus","2018","Not on tenure/no tenure system, lecturers","37","20","17","0","0","0","2","1","1","1","0","1","0","0","0","0","0","0","29","18","11","5","1","4","0","0","0","0","0","0","-2"
"184612","Felician University","2018","Not on tenure track/No tenure system system total","80","32","48","0","0","0","5","4","1","6","0","6","5","1","4","0","0","0","64","27","37","0","0","0","0","0","0","0","0","0","-2"
"184612","Felician University","2018","Not on tenure/no tenure system, professors","12","5","7","0","0","0","0","0","0","1","0","1","0","0","0","0","0","0","11","5","6","0","0","0","0","0","0","0","0","0","-2"
"184612","Felician University","2018","Not on tenure/no tenure system, associate professors","28","17","11","0","0","0","3","2","1","0","0","0","3","1","2","0","0","0","22","14","8","0","0","0","0","0","0","0","0","0","-2"
"184612","Felician University","2018","Not on tenure/no tenure system, assistant professors","28","8","20","0","0","0","1","1","0","4","0","4","2","0","2","0","0","0","21","7","14","0","0","0","0","0","0","0","0","0","-2"
"184612","Felician University","2018","Not on tenure/no tenure system, instructors","12","2","10","0","0","0","1","1","0","1","0","1","0","0","0","0","0","0","10","1","9","0","0","0","0","0","0","0","0","0","-2"
"185129","New Jersey City University","2018","Tenured total","159","74","85","0","0","0","20","8","12","23","8","15","16","5","11","0","0","0","100","53","47","0","0","0","0","0","0","0","0","0","-2"
"185129","New Jersey City University","2018","Tenured, professors","81","38","43","0","0","0","14","6","8","12","4","8","8","3","5","0","0","0","47","25","22","0","0","0","0","0","0","0","0","0","-2"
"185129","New Jersey City University","2018","Tenured, associate professors","59","30","29","0","0","0","4","2","2","9","3","6","5","2","3","0","0","0","41","23","18","0","0","0","0","0","0","0","0","0","-2"
"185129","New Jersey City University","2018","Tenured, assistant professors","19","6","13","0","0","0","2","0","2","2","1","1","3","0","3","0","0","0","12","5","7","0","0","0","0","0","0","0","0","0","-2"
"185129","New Jersey City University","2018","On-Tenure track total","90","51","39","0","0","0","22","14","8","5","2","3","8","6","2","0","0","0","43","23","20","0","0","0","12","6","6","0","0","0","-2"
"185129","New Jersey City University","2018","On-tenure track, professors","4","4","0","0","0","0","0","0","0","0","0","0","1","1","0","0","0","0","2","2","0","0","0","0","1","1","0","0","0","0","-2"
"185129","New Jersey City University","2018","On-tenure track, associate professors","24","11","13","0","0","0","8","4","4","1","0","1","1","0","1","0","0","0","12","5","7","0","0","0","2","2","0","0","0","0","-2"
"185129","New Jersey City University","2018","On-tenure track, assistant professors","62","36","26","0","0","0","14","10","4","4","2","2","6","5","1","0","0","0","29","16","13","0","0","0","9","3","6","0","0","0","-2"
"185129","New Jersey City University","2018","Not on tenure track/No tenure system system total","5","4","1","0","0","0","1","0","1","0","0","0","0","0","0","0","0","0","3","3","0","0","0","0","1","1","0","0","0","0","-2"
"185129","New Jersey City University","2018","Not on tenure/no tenure system, associate professors","1","1","0","0","0","0","0","0","0","0","0","0","0","0","0","0","0","0","1","1","0","0","0","0","0","0","0","0","0","0","-2"
"185129","New Jersey City University","2018","Not on tenure/no tenure system, assistant professors","4","3","1","0","0","0","1","0","1","0","0","0","0","0","0","0","0","0","2","2","0","0","0","0","1","1","0","0","0","0","-2"
"185590","Montclair State University","2018","Tenured total","423","222","201","0","0","0","67","34","33","31","14","17","30","17","13","0","0","0","279","146","133","6","5","1","7","5","2","3","1","2","-2"
"185590","Montclair State University","2018","Tenured, professors","188","102","86","0","0","0","27","17","10","12","5","7","15","10","5","0","0","0","132","68","64","1","1","0","1","1","0","0","0","0","-2"
"185590","Montclair State University","2018","Tenured, associate professors","217","113","104","0","0","0","39","17","22","16","9","7","14","6","8","0","0","0","137","73","64","5","4","1","5","4","1","1","0","1","-2"
"185590","Montclair State University","2018","Tenured, assistant professors","18","7","11","0","0","0","1","0","1","3","0","3","1","1","0","0","0","0","10","5","5","0","0","0","1","0","1","2","1","1","-2"
"185590","Montclair State University","2018","On-Tenure track total","129","62","67","0","0","0","8","5","3","4","3","1","7","3","4","0","0","0","47","22","25","1","0","1","45","19","26","17","10","7","-2"
"185590","Montclair State University","2018","On-tenure track, professors","2","1","1","0","0","0","0","0","0","0","0","0","0","0","0","0","0","0","0","0","0","0","0","0","2","1","1","0","0","0","-2"
"185590","Montclair State University","2018","On-tenure track, associate professors","14","7","7","0","0","0","1","0","1","1","1","0","1","1","0","0","0","0","5","3","2","0","0","0","5","1","4","1","1","0","-2"
"185590","Montclair State University","2018","On-tenure track, assistant professors","113","54","59","0","0","0","7","5","2","3","2","1","6","2","4","0","0","0","42","19","23","1","0","1","38","17","21","16","9","7","-2"
"185590","Montclair State University","2018","Not on tenure track/No tenure system system total","93","37","56","0","0","0","4","3","1","4","1","3","5","1","4","0","0","0","55","22","33","1","0","1","22","8","14","2","2","0","-2"
"185590","Montclair State University","2018","Not on tenure/no tenure system, associate professors","1","0","1","0","0","0","0","0","0","0","0","0","0","0","0","0","0","0","0","0","0","0","0","0","1","0","1","0","0","0","-2"
"185590","Montclair State University","2018","Not on tenure/no tenure system, assistant professors","5","4","1","0","0","0","0","0","0","0","0","0","0","0","0","0","0","0","2","2","0","0","0","0","2","1","1","1","1","0","-2"
"185590","Montclair State University","2018","Not on tenure/no tenure system, instructors","3","2","1","0","0","0","0","0","0","0","0","0","0","0","0","0","0","0","1","1","0","0","0","0","1","0","1","1","1","0","-2"
"185590","Montclair State University","2018","Not on tenure/no tenure system, no academic rank","84","31","53","0","0","0","4","3","1","4","1","3","5","1","4","0","0","0","52","19","33","1","0","1","18","7","11","0","0","0","-2"
"186399","Rutgers University-Newark","2018","Tenured total","288","189","99","1","0","1","38","28","10","18","10","8","11","9","2","0","0","0","167","112","55","1","1","0","26","14","12","26","15","11","-2"
"186399","Rutgers University-Newark","2018","Tenured, professors","175","123","52","0","0","0","26","21","5","8","5","3","5","5","0","0","0","0","119","86","33","0","0","0","9","2","7","8","4","4","-2"
"186399","Rutgers University-Newark","2018","Tenured, associate professors","113","66","47","1","0","1","12","7","5","10","5","5","6","4","2","0","0","0","48","26","22","1","1","0","17","12","5","18","11","7","-2"
"186399","Rutgers University-Newark","2018","On-Tenure track total","113","63","50","0","0","0","7","6","1","6","3","3","6","3","3","0","0","0","20","13","7","3","1","2","49","22","27","22","15","7","-2"
"186399","Rutgers University-Newark","2018","On-tenure track, professors","6","3","3","0","0","0","0","0","0","1","1","0","0","0","0","0","0","0","1","1","0","0","0","0","4","1","3","0","0","0","-2"
"186399","Rutgers University-Newark","2018","On-tenure track, associate professors","14","9","5","0","0","0","2","2","0","1","0","1","0","0","0","0","0","0","2","1","1","2","0","2","5","5","0","2","1","1","-2"
"186399","Rutgers University-Newark","2018","On-tenure track, assistant professors","93","51","42","0","0","0","5","4","1","4","2","2","6","3","3","0","0","0","17","11","6","1","1","0","40","16","24","20","14","6","-2"
"186399","Rutgers University-Newark","2018","Not on tenure track/No tenure system system total","159","94","65","0","0","0","10","4","6","16","11","5","3","2","1","0","0","0","67","42","25","0","0","0","50","27","23","13","8","5","-2"
"186399","Rutgers University-Newark","2018","Not on tenure/no tenure system, professors","15","8","7","0","0","0","0","0","0","2","1","1","1","1","0","0","0","0","10","4","6","0","0","0","2","2","0","0","0","0","-2"
"186399","Rutgers University-Newark","2018","Not on tenure/no tenure system, associate professors","21","13","8","0","0","0","0","0","0","1","1","0","0","0","0","0","0","0","13","8","5","0","0","0","7","4","3","0","0","0","-2"
"186399","Rutgers University-Newark","2018","Not on tenure/no tenure system, assistant professors","88","57","31","0","0","0","8","4","4","7","5","2","1","1","0","0","0","0","34","24","10","0","0","0","28","15","13","10","8","2","-2"
"186399","Rutgers University-Newark","2018","Not on tenure/no tenure system, instructors","33","15","18","0","0","0","2","0","2","6","4","2","1","0","1","0","0","0","9","5","4","0","0","0","12","6","6","3","0","3","-2"
"186399","Rutgers University-Newark","2018","Not on tenure/no tenure system, lecturers","2","1","1","0","0","0","0","0","0","0","0","0","0","0","0","0","0","0","1","1","0","0","0","0","1","0","1","0","0","0","-2"
"186432","Saint Peter's University","2018","Tenured total","62","34","28","0","0","0","2","1","1","4","2","2","3","1","2","0","0","0","53","30","23","0","0","0","0","0","0","0","0","0","-2"
"186432","Saint Peter's University","2018","Tenured, professors","29","17","12","0","0","0","0","0","0","0","0","0","2","0","2","0","0","0","27","17","10","0","0","0","0","0","0","0","0","0","-2"
"186432","Saint Peter's University","2018","Tenured, associate professors","27","13","14","0","0","0","1","1","0","1","0","1","1","1","0","0","0","0","24","11","13","0","0","0","0","0","0","0","0","0","-2"
"186432","Saint Peter's University","2018","Tenured, assistant professors","5","4","1","0","0","0","0","0","0","3","2","1","0","0","0","0","0","0","2","2","0","0","0","0","0","0","0","0","0","0","-2"
"186432","Saint Peter's University","2018","Tenured, lecturers","1","0","1","0","0","0","1","0","1","0","0","0","0","0","0","0","0","0","0","0","0","0","0","0","0","0","0","0","0","0","-2"
"186432","Saint Peter's University","2018","On-Tenure track total","37","18","19","0","0","0","3","2","1","3","0","3","5","3","2","0","0","0","26","13","13","0","0","0","0","0","0","0","0","0","-2"
"186432","Saint Peter's University","2018","On-tenure track, professors","1","1","0","0","0","0","0","0","0","0","0","0","1","1","0","0","0","0","0","0","0","0","0","0","0","0","0","0","0","0","-2"
"186432","Saint Peter's University","2018","On-tenure track, associate professors","4","2","2","0","0","0","0","0","0","0","0","0","1","0","1","0","0","0","3","2","1","0","0","0","0","0","0","0","0","0","-2"
"186432","Saint Peter's University","2018","On-tenure track, assistant professors","31","15","16","0","0","0","3","2","1","2","0","2","3","2","1","0","0","0","23","11","12","0","0","0","0","0","0","0","0","0","-2"
"186432","Saint Peter's University","2018","On-tenure track, instructors","1","0","1","0","0","0","0","0","0","1","0","1","0","0","0","0","0","0","0","0","0","0","0","0","0","0","0","0","0","0","-2"
"186432","Saint Peter's University","2018","Not on tenure track/No tenure system system total","13","6","7","0","0","0","1","1","0","1","0","1","0","0","0","0","0","0","11","5","6","0","0","0","0","0","0","0","0","0","-2"
"186432","Saint Peter's University","2018","Not on tenure/no tenure system, instructors","4","3","1","0","0","0","1","1","0","0","0","0","0","0","0","0","0","0","3","2","1","0","0","0","0","0","0","0","0","0","-2"
"186432","Saint Peter's University","2018","Not on tenure/no tenure system, lecturers","6","3","3","0","0","0","0","0","0","1","0","1","0","0","0","0","0","0","5","3","2","0","0","0","0","0","0","0","0","0","-2"
"186432","Saint Peter's University","2018","Not on tenure/no tenure system, no academic rank","3","0","3","0","0","0","0","0","0","0","0","0","0","0","0","0","0","0","3","0","3","0","0","0","0","0","0","0","0","0","-2"
"187444","William Paterson University of New Jersey","2018","Tenured total","309","157","152","0","0","0","61","35","26","28","20","8","25","11","14","0","0","0","188","89","99","4","1","3","2","1","1","1","0","1","-2"
"187444","William Paterson University of New Jersey","2018","Tenured, professors","192","115","77","0","0","0","46","31","15","17","14","3","13","8","5","0","0","0","111","60","51","3","1","2","2","1","1","0","0","0","-2"
"187444","William Paterson University of New Jersey","2018","Tenured, associate professors","108","40","68","0","0","0","15","4","11","9","5","4","10","3","7","0","0","0","72","28","44","1","0","1","0","0","0","1","0","1","-2"
"187444","William Paterson University of New Jersey","2018","Tenured, assistant professors","9","2","7","0","0","0","0","0","0","2","1","1","2","0","2","0","0","0","5","1","4","0","0","0","0","0","0","0","0","0","-2"
"187444","William Paterson University of New Jersey","2018","On-Tenure track total","79","38","41","0","0","0","17","7","10","9","4","5","4","2","2","0","0","0","43","23","20","0","0","0","1","0","1","5","2","3","-2"
"187444","William Paterson University of New Jersey","2018","On-tenure track, professors","1","1","0","0","0","0","0","0","0","0","0","0","0","0","0","0","0","0","1","1","0","0","0","0","0","0","0","0","0","0","-2"
"187444","William Paterson University of New Jersey","2018","On-tenure track, associate professors","5","3","2","0","0","0","1","1","0","0","0","0","0","0","0","0","0","0","4","2","2","0","0","0","0","0","0","0","0","0","-2"
"187444","William Paterson University of New Jersey","2018","On-tenure track, assistant professors","72","34","38","0","0","0","16","6","10","9","4","5","3","2","1","0","0","0","38","20","18","0","0","0","1","0","1","5","2","3","-2"
"187444","William Paterson University of New Jersey","2018","On-tenure track, instructors","1","0","1","0","0","0","0","0","0","0","0","0","1","0","1","0","0","0","0","0","0","0","0","0","0","0","0","0","0","0","-2"
"187444","William Paterson University of New Jersey","2018","Not on tenure track/No tenure system system total","15","6","9","0","0","0","1","1","0","0","0","0","0","0","0","0","0","0","13","5","8","0","0","0","1","0","1","0","0","0","-2"
"187444","William Paterson University of New Jersey","2018","Not on tenure/no tenure system, assistant professors","8","3","5","0","0","0","1","1","0","0","0","0","0","0","0","0","0","0","7","2","5","0","0","0","0","0","0","0","0","0","-2"
"187444","William Paterson University of New Jersey","2018","Not on tenure/no tenure system, instructors","7","3","4","0","0","0","0","0","0","0","0","0","0","0","0","0","0","0","6","3","3","0","0","0","1","0","1","0","0","0","-2"
"187648","Eastern New Mexico University-Main Campus","2018","Tenured total","56","33","23","0","0","0","2","2","0","0","0","0","3","1","2","0","0","0","45","27","18","0","0","0","0","0","0","6","3","3","-2"
"187648","Eastern New Mexico University-Main Campus","2018","Tenured, professors","36","23","13","0","0","0","2","2","0","0","0","0","3","1","2","0","0","0","27","17","10","0","0","0","0","0","0","4","3","1","-2"
"187648","Eastern New Mexico University-Main Campus","2018","Tenured, associate professors","17","8","9","0","0","0","0","0","0","0","0","0","0","0","0","0","0","0","15","8","7","0","0","0","0","0","0","2","0","2","-2"
"187648","Eastern New Mexico University-Main Campus","2018","Tenured, instructors","3","2","1","0","0","0","0","0","0","0","0","0","0","0","0","0","0","0","3","2","1","0","0","0","0","0","0","0","0","0","-2"
"187648","Eastern New Mexico University-Main Campus","2018","On-Tenure track total","65","44","21","0","0","0","1","1","0","2","1","1","3","2","1","0","0","0","42","25","17","0","0","0","3","3","0","14","12","2","-2"
"187648","Eastern New Mexico University-Main Campus","2018","On-tenure track, associate professors","3","1","2","0","0","0","0","0","0","2","1","1","0","0","0","0","0","0","1","0","1","0","0","0","0","0","0","0","0","0","-2"
"187648","Eastern New Mexico University-Main Campus","2018","On-tenure track, assistant professors","62","43","19","0","0","0","1","1","0","0","0","0","3","2","1","0","0","0","41","25","16","0","0","0","3","3","0","14","12","2","-2"
"187648","Eastern New Mexico University-Main Campus","2018","Not on tenure track/No tenure system system total","43","11","32","0","0","0","0","0","0","0","0","0","5","1","4","0","0","0","34","9","25","1","0","1","3","1","2","0","0","0","-2"
"187648","Eastern New Mexico University-Main Campus","2018","Not on tenure/no tenure system, assistant professors","1","0","1","0","0","0","0","0","0","0","0","0","0","0","0","0","0","0","1","0","1","0","0","0","0","0","0","0","0","0","-2"
"187648","Eastern New Mexico University-Main Campus","2018","Not on tenure/no tenure system, instructors","42","11","31","0","0","0","0","0","0","0","0","0","5","1","4","0","0","0","33","9","24","1","0","1","3","1","2","0","0","0","-2"
"187897","New Mexico Highlands University","2018","Tenured total","54","32","22","1","1","0","3","2","1","2","1","1","11","7","4","0","0","0","33","20","13","1","0","1","1","0","1","2","1","1","-2"
"187897","New Mexico Highlands University","2018","Tenured, professors","24","13","11","1","1","0","0","0","0","0","0","0","4","3","1","0","0","0","17","9","8","0","0","0","1","0","1","1","0","1","-2"
"187897","New Mexico Highlands University","2018","Tenured, associate professors","26","16","10","0","0","0","2","1","1","2","1","1","6","3","3","0","0","0","14","10","4","1","0","1","0","0","0","1","1","0","-2"
"187897","New Mexico Highlands University","2018","Tenured, assistant professors","4","3","1","0","0","0","1","1","0","0","0","0","1","1","0","0","0","0","2","1","1","0","0","0","0","0","0","0","0","0","-2"
"187897","New Mexico Highlands University","2018","On-Tenure track total","35","16","19","0","0","0","1","1","0","0","0","0","11","7","4","0","0","0","18","6","12","0","0","0","1","0","1","4","2","2","-2"
"187897","New Mexico Highlands University","2018","On-tenure track, associate professors","7","3","4","0","0","0","1","1","0","0","0","0","1","1","0","0","0","0","4","0","4","0","0","0","0","0","0","1","1","0","-2"
"187897","New Mexico Highlands University","2018","On-tenure track, assistant professors","28","13","15","0","0","0","0","0","0","0","0","0","10","6","4","0","0","0","14","6","8","0","0","0","1","0","1","3","1","2","-2"
"187897","New Mexico Highlands University","2018","Not on tenure track/No tenure system system total","44","23","21","0","0","0","1","0","1","0","0","0","17","8","9","0","0","0","22","12","10","1","1","0","1","1","0","2","1","1","-2"
"187897","New Mexico Highlands University","2018","Not on tenure/no tenure system, associate professors","2","1","1","0","0","0","0","0","0","0","0","0","1","1","0","0","0","0","0","0","0","0","0","0","0","0","0","1","0","1","-2"
"187897","New Mexico Highlands University","2018","Not on tenure/no tenure system, assistant professors","18","11","7","0","0","0","0","0","0","0","0","0","4","2","2","0","0","0","12","7","5","1","1","0","0","0","0","1","1","0","-2"
"187897","New Mexico Highlands University","2018","Not on tenure/no tenure system, instructors","24","11","13","0","0","0","1","0","1","0","0","0","12","5","7","0","0","0","10","5","5","0","0","0","1","1","0","0","0","0","-2"
"187985","University of New Mexico-Main Campus","2018","Tenured total","595","343","252","20","7","13","69","48","21","9","5","4","73","30","43","0","0","0","385","231","154","2","0","2","32","17","15","5","5","0","-2"
"187985","University of New Mexico-Main Campus","2018","Tenured, professors","301","193","108","9","3","6","36","26","10","3","1","2","31","13","18","0","0","0","213","145","68","0","0","0","8","4","4","1","1","0","-2"
"187985","University of New Mexico-Main Campus","2018","Tenured, associate professors","292","149","143","11","4","7","33","22","11","6","4","2","41","16","25","0","0","0","171","86","85","2","0","2","24","13","11","4","4","0","-2"
"187985","University of New Mexico-Main Campus","2018","Tenured, assistant professors","2","1","1","0","0","0","0","0","0","0","0","0","1","1","0","0","0","0","1","0","1","0","0","0","0","0","0","0","0","0","-2"
"187985","University of New Mexico-Main Campus","2018","On-Tenure track total","272","128","144","6","2","4","27","18","9","3","0","3","37","14","23","0","0","0","128","55","73","6","4","2","35","19","16","30","16","14","-2"
"187985","University of New Mexico-Main Campus","2018","On-tenure track, professors","5","3","2","0","0","0","1","1","0","0","0","0","0","0","0","0","0","0","4","2","2","0","0","0","0","0","0","0","0","0","-2"
"187985","University of New Mexico-Main Campus","2018","On-tenure track, associate professors","26","11","15","0","0","0","5","3","2","0","0","0","5","3","2","0","0","0","13","4","9","0","0","0","3","1","2","0","0","0","-2"
"187985","University of New Mexico-Main Campus","2018","On-tenure track, assistant professors","241","114","127","6","2","4","21","14","7","3","0","3","32","11","21","0","0","0","111","49","62","6","4","2","32","18","14","30","16","14","-2"
"187985","University of New Mexico-Main Campus","2018","Not on tenure track/No tenure system system total","872","382","490","9","2","7","68","38","30","13","2","11","133","42","91","0","0","0","564","256","308","15","6","9","26","11","15","44","25","19","-2"
"187985","University of New Mexico-Main Campus","2018","Not on tenure/no tenure system, professors","107","65","42","1","1","0","6","3","3","0","0","0","5","3","2","0","0","0","89","54","35","1","1","0","4","2","2","1","1","0","-2"
"187985","University of New Mexico-Main Campus","2018","Not on tenure/no tenure system, associate professors","179","85","94","1","0","1","25","17","8","5","1","4","29","13","16","0","0","0","110","49","61","2","1","1","5","2","3","2","2","0","-2"
"187985","University of New Mexico-Main Campus","2018","Not on tenure/no tenure system, assistant professors","316","130","186","2","0","2","32","15","17","4","0","4","46","13","33","0","0","0","182","80","102","9","3","6","5","1","4","36","18","18","-2"
"187985","University of New Mexico-Main Campus","2018","Not on tenure/no tenure system, instructors","63","26","37","2","0","2","2","2","0","0","0","0","11","1","10","0","0","0","45","20","25","1","1","0","2","2","0","0","0","0","-2"
"187985","University of New Mexico-Main Campus","2018","Not on tenure/no tenure system, lecturers","206","75","131","3","1","2","3","1","2","4","1","3","42","12","30","0","0","0","137","52","85","2","0","2","10","4","6","5","4","1","-2"
"187985","University of New Mexico-Main Campus","2018","Not on tenure/no tenure system, no academic rank","1","1","0","0","0","0","0","0","0","0","0","0","0","0","0","0","0","0","1","1","0","0","0","0","0","0","0","0","0","0","-2"
"188030","New Mexico State University-Main Campus","2018","Tenured total","368","235","133","2","2","0","43","34","9","5","4","1","60","29","31","0","0","0","249","158","91","2","2","0","0","0","0","7","6","1","-2"
"188030","New Mexico State University-Main Campus","2018","Tenured, professors","189","134","55","2","2","0","21","17","4","3","3","0","16","9","7","0","0","0","143","99","44","1","1","0","0","0","0","3","3","0","-2"
"188030","New Mexico State University-Main Campus","2018","Tenured, associate professors","171","99","72","0","0","0","22","17","5","2","1","1","41","20","21","0","0","0","101","57","44","1","1","0","0","0","0","4","3","1","-2"
"188030","New Mexico State University-Main Campus","2018","Tenured, assistant professors","8","2","6","0","0","0","0","0","0","0","0","0","3","0","3","0","0","0","5","2","3","0","0","0","0","0","0","0","0","0","-2"
"188030","New Mexico State University-Main Campus","2018","On-Tenure track total","135","72","63","0","0","0","13","7","6","5","2","3","21","11","10","0","0","0","75","36","39","0","0","0","0","0","0","21","16","5","-2"
"188030","New Mexico State University-Main Campus","2018","On-tenure track, associate professors","3","1","2","0","0","0","0","0","0","0","0","0","0","0","0","0","0","0","3","1","2","0","0","0","0","0","0","0","0","0","-2"
"188030","New Mexico State University-Main Campus","2018","On-tenure track, assistant professors","132","71","61","0","0","0","13","7","6","5","2","3","21","11","10","0","0","0","72","35","37","0","0","0","0","0","0","21","16","5","-2"
"188030","New Mexico State University-Main Campus","2018","Not on tenure track/No tenure system system total","122","42","80","1","1","0","3","2","1","2","1","1","30","5","25","0","0","0","78","26","52","4","3","1","0","0","0","4","4","0","-2"
"188030","New Mexico State University-Main Campus","2018","Not on tenure/no tenure system, professors","18","9","9","1","1","0","0","0","0","0","0","0","1","1","0","0","0","0","16","7","9","0","0","0","0","0","0","0","0","0","-2"
"188030","New Mexico State University-Main Campus","2018","Not on tenure/no tenure system, associate professors","22","3","19","0","0","0","0","0","0","0","0","0","5","0","5","0","0","0","15","1","14","2","2","0","0","0","0","0","0","0","-2"
"188030","New Mexico State University-Main Campus","2018","Not on tenure/no tenure system, assistant professors","55","17","38","0","0","0","1","0","1","0","0","0","18","2","16","0","0","0","34","14","20","1","0","1","0","0","0","1","1","0","-2"
"188030","New Mexico State University-Main Campus","2018","Not on tenure/no tenure system, instructors","3","2","1","0","0","0","1","1","0","0","0","0","1","0","1","0","0","0","1","1","0","0","0","0","0","0","0","0","0","0","-2"
"188030","New Mexico State University-Main Campus","2018","Not on tenure/no tenure system, no academic rank","24","11","13","0","0","0","1","1","0","2","1","1","5","2","3","0","0","0","12","3","9","1","1","0","0","0","0","3","3","0","-2"
"188058","Northern New Mexico College","2018","Tenured total","15","5","10","0","0","0","2","2","0","0","0","0","8","2","6","0","0","0","4","1","3","0","0","0","1","0","1","0","0","0","-2"
"188058","Northern New Mexico College","2018","Tenured, associate professors","15","5","10","0","0","0","2","2","0","0","0","0","8","2","6","0","0","0","4","1","3","0","0","0","1","0","1","0","0","0","-2"
"188058","Northern New Mexico College","2018","On-Tenure track total","24","9","15","0","0","0","4","1","3","0","0","0","4","1","3","0","0","0","13","6","7","2","1","1","1","0","1","0","0","0","-2"
"188058","Northern New Mexico College","2018","On-tenure track, assistant professors","24","9","15","0","0","0","4","1","3","0","0","0","4","1","3","0","0","0","13","6","7","2","1","1","1","0","1","0","0","0","-2"
"188058","Northern New Mexico College","2018","Not on tenure track/No tenure system system total","3","0","3","0","0","0","0","0","0","0","0","0","2","0","2","0","0","0","1","0","1","0","0","0","0","0","0","0","0","0","-2"
"188058","Northern New Mexico College","2018","Not on tenure/no tenure system, instructors","3","0","3","0","0","0","0","0","0","0","0","0","2","0","2","0","0","0","1","0","1","0","0","0","0","0","0","0","0","0","-2"
"188182","University of the Southwest","2018","Not on tenure track/No tenure system system total","23","10","13","0","0","0","1","1","0","1","0","1","1","1","0","0","0","0","9","1","8","0","0","0","11","7","4","0","0","0","-2"
"188182","University of the Southwest","2018","Not on tenure/no tenure system, professors","2","1","1","0","0","0","0","0","0","0","0","0","0","0","0","0","0","0","1","0","1","0","0","0","1","1","0","0","0","0","-2"
"188182","University of the Southwest","2018","Not on tenure/no tenure system, associate professors","4","2","2","0","0","0","0","0","0","0","0","0","0","0","0","0","0","0","1","0","1","0","0","0","3","2","1","0","0","0","-2"
"188182","University of the Southwest","2018","Not on tenure/no tenure system, assistant professors","12","4","8","0","0","0","1","1","0","1","0","1","1","1","0","0","0","0","5","1","4","0","0","0","4","1","3","0","0","0","-2"
"188182","University of the Southwest","2018","Not on tenure/no tenure system, instructors","3","2","1","0","0","0","0","0","0","0","0","0","0","0","0","0","0","0","1","0","1","0","0","0","2","2","0","0","0","0","-2"
"188182","University of the Southwest","2018","Not on tenure/no tenure system, lecturers","2","1","1","0","0","0","0","0","0","0","0","0","0","0","0","0","0","0","1","0","1","0","0","0","1","1","0","0","0","0","-2"
"188304","Western New Mexico University","2018","Tenured total","35","19","16","0","0","0","1","1","0","0","0","0","8","5","3","0","0","0","19","9","10","0","0","0","7","4","3","0","0","0","-2"
"188304","Western New Mexico University","2018","Tenured, professors","19","12","7","0","0","0","0","0","0","0","0","0","3","2","1","0","0","0","10","6","4","0","0","0","6","4","2","0","0","0","-2"
"188304","Western New Mexico University","2018","Tenured, associate professors","16","7","9","0","0","0","1","1","0","0","0","0","5","3","2","0","0","0","9","3","6","0","0","0","1","0","1","0","0","0","-2"
"188304","Western New Mexico University","2018","On-Tenure track total","49","22","27","0","0","0","4","2","2","2","1","1","8","2","6","0","0","0","29","15","14","0","0","0","6","2","4","0","0","0","-2"
"188304","Western New Mexico University","2018","On-tenure track, associate professors","10","4","6","0","0","0","2","1","1","0","0","0","0","0","0","0","0","0","8","3","5","0","0","0","0","0","0","0","0","0","-2"
"188304","Western New Mexico University","2018","On-tenure track, assistant professors","38","17","21","0","0","0","2","1","1","2","1","1","8","2","6","0","0","0","20","11","9","0","0","0","6","2","4","0","0","0","-2"
"188304","Western New Mexico University","2018","On-tenure track, instructors","1","1","0","0","0","0","0","0","0","0","0","0","0","0","0","0","0","0","1","1","0","0","0","0","0","0","0","0","0","0","-2"
"188304","Western New Mexico University","2018","Not on tenure track/No tenure system system total","8","4","4","0","0","0","0","0","0","0","0","0","2","2","0","0","0","0","5","2","3","0","0","0","1","0","1","0","0","0","-2"
"188304","Western New Mexico University","2018","Not on tenure/no tenure system, assistant professors","4","0","4","0","0","0","0","0","0","0","0","0","0","0","0","0","0","0","3","0","3","0","0","0","1","0","1","0","0","0","-2"
"188304","Western New Mexico University","2018","Not on tenure/no tenure system, lecturers","4","4","0","0","0","0","0","0","0","0","0","0","2","2","0","0","0","0","2","2","0","0","0","0","0","0","0","0","0","0","-2"
"188340","Vaughn College of Aeronautics and Technology","2018","Tenured total","17","13","4","0","0","0","2","1","1","1","0","1","0","0","0","4","4","0","10","8","2","0","0","0","0","0","0","0","0","0","-2"
"188340","Vaughn College of Aeronautics and Technology","2018","Tenured, professors","11","9","2","0","0","0","0","0","0","1","0","1","0","0","0","2","2","0","8","7","1","0","0","0","0","0","0","0","0","0","-2"
"188340","Vaughn College of Aeronautics and Technology","2018","Tenured, associate professors","6","4","2","0","0","0","2","1","1","0","0","0","0","0","0","2","2","0","2","1","1","0","0","0","0","0","0","0","0","0","-2"
"188340","Vaughn College of Aeronautics and Technology","2018","On-Tenure track total","10","5","5","0","0","0","1","0","1","0","0","0","1","1","0","1","0","1","6","3","3","1","1","0","0","0","0","0","0","0","-2"
"188340","Vaughn College of Aeronautics and Technology","2018","On-tenure track, associate professors","1","1","0","0","0","0","0","0","0","0","0","0","0","0","0","0","0","0","0","0","0","1","1","0","0","0","0","0","0","0","-2"
"188340","Vaughn College of Aeronautics and Technology","2018","On-tenure track, assistant professors","9","4","5","0","0","0","1","0","1","0","0","0","1","1","0","1","0","1","6","3","3","0","0","0","0","0","0","0","0","0","-2"
"188340","Vaughn College of Aeronautics and Technology","2018","Not on tenure track/No tenure system system total","13","11","2","0","0","0","0","0","0","2","2","0","1","0","1","2","2","0","7","6","1","1","1","0","0","0","0","0","0","0","-2"
"188340","Vaughn College of Aeronautics and Technology","2018","Not on tenure/no tenure system, associate professors","2","2","0","0","0","0","0","0","0","1","1","0","0","0","0","0","0","0","1","1","0","0","0","0","0","0","0","0","0","0","-2"
"188340","Vaughn College of Aeronautics and Technology","2018","Not on tenure/no tenure system, assistant professors","7","5","2","0","0","0","0","0","0","0","0","0","1","0","1","1","1","0","5","4","1","0","0","0","0","0","0","0","0","0","-2"
"188340","Vaughn College of Aeronautics and Technology","2018","Not on tenure/no tenure system, instructors","4","4","0","0","0","0","0","0","0","1","1","0","0","0","0","1","1","0","1","1","0","1","1","0","0","0","0","0","0","0","-2"
"189413","Boricua College","2018","Not on tenure track/No tenure system system total","34","15","19","0","0","0","0","0","0","2","1","1","28","14","14","0","0","0","4","0","4","0","0","0","0","0","0","0","0","0","-2"
"189413","Boricua College","2018","Not on tenure/no tenure system, professors","2","1","1","0","0","0","0","0","0","1","1","0","1","0","1","0","0","0","0","0","0","0","0","0","0","0","0","0","0","0","-2"
"189413","Boricua College","2018","Not on tenure/no tenure system, associate professors","7","3","4","0","0","0","0","0","0","0","0","0","5","3","2","0","0","0","2","0","2","0","0","0","0","0","0","0","0","0","-2"
"189413","Boricua College","2018","Not on tenure/no tenure system, assistant professors","15","8","7","0","0","0","0","0","0","0","0","0","15","8","7","0","0","0","0","0","0","0","0","0","0","0","0","0","0","0","-2"
"189413","Boricua College","2018","Not on tenure/no tenure system, instructors","10","3","7","0","0","0","0","0","0","1","0","1","7","3","4","0","0","0","2","0","2","0","0","0","0","0","0","0","0","0","-2"
"190114","Metropolitan College of New York","2018","Not on tenure track/No tenure system system total","20","11","9","1","0","1","1","0","1","3","1","2","0","0","0","0","0","0","14","10","4","0","0","0","1","0","1","0","0","0","-2"
"190114","Metropolitan College of New York","2018","Not on tenure/no tenure system, professors","11","7","4","0","0","0","1","0","1","0","0","0","0","0","0","0","0","0","9","7","2","0","0","0","1","0","1","0","0","0","-2"
"190114","Metropolitan College of New York","2018","Not on tenure/no tenure system, associate professors","7","4","3","1","0","1","0","0","0","2","1","1","0","0","0","0","0","0","4","3","1","0","0","0","0","0","0","0","0","0","-2"
"190114","Metropolitan College of New York","2018","Not on tenure/no tenure system, assistant professors","2","0","2","0","0","0","0","0","0","1","0","1","0","0","0","0","0","0","1","0","1","0","0","0","0","0","0","0","0","0","-2"
"190558","College of Staten Island CUNY","2018","Tenured total","259","146","113","0","0","0","38","22","16","7","4","3","17","11","6","0","0","0","196","108","88","1","1","0","0","0","0","0","0","0","-2"
"190558","College of Staten Island CUNY","2018","Tenured, professors","124","78","46","0","0","0","20","13","7","3","2","1","10","7","3","0","0","0","91","56","35","0","0","0","0","0","0","0","0","0","-2"
"190558","College of Staten Island CUNY","2018","Tenured, associate professors","104","54","50","0","0","0","18","9","9","3","1","2","6","4","2","0","0","0","76","39","37","1","1","0","0","0","0","0","0","0","-2"
"190558","College of Staten Island CUNY","2018","Tenured, assistant professors","14","7","7","0","0","0","0","0","0","1","1","0","0","0","0","0","0","0","13","6","7","0","0","0","0","0","0","0","0","0","-2"
"190558","College of Staten Island CUNY","2018","Tenured, lecturers","17","7","10","0","0","0","0","0","0","0","0","0","1","0","1","0","0","0","16","7","9","0","0","0","0","0","0","0","0","0","-2"
"190558","College of Staten Island CUNY","2018","On-Tenure track total","87","42","45","0","0","0","18","6","12","3","0","3","6","4","2","0","0","0","43","23","20","2","0","2","0","0","0","15","9","6","-2"
"190558","College of Staten Island CUNY","2018","On-tenure track, professors","2","2","0","0","0","0","1","1","0","0","0","0","0","0","0","0","0","0","1","1","0","0","0","0","0","0","0","0","0","0","-2"
"190558","College of Staten Island CUNY","2018","On-tenure track, associate professors","3","1","2","0","0","0","0","0","0","1","0","1","0","0","0","0","0","0","1","0","1","0","0","0","0","0","0","1","1","0","-2"
"190558","College of Staten Island CUNY","2018","On-tenure track, assistant professors","72","35","37","0","0","0","15","5","10","2","0","2","5","4","1","0","0","0","36","18","18","1","0","1","0","0","0","13","8","5","-2"
"190558","College of Staten Island CUNY","2018","On-tenure track, lecturers","10","4","6","0","0","0","2","0","2","0","0","0","1","0","1","0","0","0","5","4","1","1","0","1","0","0","0","1","0","1","-2"
"190558","College of Staten Island CUNY","2018","Not on tenure track/No tenure system system total","23","11","12","0","0","0","7","7","0","1","0","1","3","1","2","0","0","0","12","3","9","0","0","0","0","0","0","0","0","0","-2"
"190558","College of Staten Island CUNY","2018","Not on tenure/no tenure system, professors","3","0","3","0","0","0","0","0","0","0","0","0","1","0","1","0","0","0","2","0","2","0","0","0","0","0","0","0","0","0","-2"
"190558","College of Staten Island CUNY","2018","Not on tenure/no tenure system, assistant professors","1","0","1","0","0","0","0","0","0","1","0","1","0","0","0","0","0","0","0","0","0","0","0","0","0","0","0","0","0","0","-2"
"190558","College of Staten Island CUNY","2018","Not on tenure/no tenure system, lecturers","19","11","8","0","0","0","7","7","0","0","0","0","2","1","1","0","0","0","10","3","7","0","0","0","0","0","0","0","0","0","-2"
"190594","CUNY Hunter College","2018","Tenured total","473","241","232","0","0","0","50","25","25","45","24","21","54","19","35","0","0","0","315","169","146","5","3","2","0","0","0","4","1","3","-2"
"190594","CUNY Hunter College","2018","Tenured, professors","237","128","109","0","0","0","21","13","8","18","11","7","22","9","13","0","0","0","174","93","81","2","2","0","0","0","0","0","0","0","-2"
"190594","CUNY Hunter College","2018","Tenured, associate professors","192","96","96","0","0","0","26","11","15","21","12","9","26","9","17","0","0","0","115","63","52","2","0","2","0","0","0","2","1","1","-2"
"190594","CUNY Hunter College","2018","Tenured, assistant professors","12","5","7","0","0","0","1","0","1","2","1","1","0","0","0","0","0","0","9","4","5","0","0","0","0","0","0","0","0","0","-2"
"190594","CUNY Hunter College","2018","Tenured, lecturers","32","12","20","0","0","0","2","1","1","4","0","4","6","1","5","0","0","0","17","9","8","1","1","0","0","0","0","2","0","2","-2"
"190594","CUNY Hunter College","2018","On-Tenure track total","118","41","77","2","0","2","16","3","13","7","2","5","9","1","8","0","0","0","68","27","41","4","2","2","0","0","0","12","6","6","-2"
"190594","CUNY Hunter College","2018","On-tenure track, professors","3","0","3","0","0","0","1","0","1","0","0","0","0","0","0","0","0","0","2","0","2","0","0","0","0","0","0","0","0","0","-2"
"190594","CUNY Hunter College","2018","On-tenure track, associate professors","12","6","6","0","0","0","4","0","4","2","2","0","0","0","0","0","0","0","6","4","2","0","0","0","0","0","0","0","0","0","-2"
"190594","CUNY Hunter College","2018","On-tenure track, assistant professors","74","24","50","2","0","2","9","2","7","4","0","4","5","1","4","0","0","0","42","13","29","2","2","0","0","0","0","10","6","4","-2"
"190594","CUNY Hunter College","2018","On-tenure track, lecturers","29","11","18","0","0","0","2","1","1","1","0","1","4","0","4","0","0","0","18","10","8","2","0","2","0","0","0","2","0","2","-2"
"190594","CUNY Hunter College","2018","Not on tenure track/No tenure system system total","59","21","38","0","0","0","3","0","3","4","0","4","4","4","0","0","0","0","45","16","29","1","0","1","0","0","0","2","1","1","-2"
"190594","CUNY Hunter College","2018","Not on tenure/no tenure system, professors","48","16","32","0","0","0","1","0","1","3","0","3","3","3","0","0","0","0","40","13","27","1","0","1","0","0","0","0","0","0","-2"
"190594","CUNY Hunter College","2018","Not on tenure/no tenure system, assistant professors","4","3","1","0","0","0","1","0","1","0","0","0","1","1","0","0","0","0","1","1","0","0","0","0","0","0","0","1","1","0","-2"
"190594","CUNY Hunter College","2018","Not on tenure/no tenure system, instructors","2","0","2","0","0","0","0","0","0","0","0","0","0","0","0","0","0","0","1","0","1","0","0","0","0","0","0","1","0","1","-2"
"190594","CUNY Hunter College","2018","Not on tenure/no tenure system, lecturers","5","2","3","0","0","0","1","0","1","1","0","1","0","0","0","0","0","0","3","2","1","0","0","0","0","0","0","0","0","0","-2"
"190600","CUNY John Jay College of Criminal Justice","2018","Tenured total","299","164","135","0","0","0","25","9","16","37","19","18","33","14","19","3","0","3","188","117","71","1","1","0","0","0","0","12","4","8","-2"
"190600","CUNY John Jay College of Criminal Justice","2018","Tenured, professors","99","62","37","0","0","0","8","3","5","8","2","6","6","3","3","0","0","0","74","53","21","1","1","0","0","0","0","2","0","2","-2"
"190600","CUNY John Jay College of Criminal Justice","2018","Tenured, associate professors","147","78","69","0","0","0","13","5","8","19","12","7","18","7","11","1","0","1","87","51","36","0","0","0","0","0","0","9","3","6","-2"
"190600","CUNY John Jay College of Criminal Justice","2018","Tenured, assistant professors","20","7","13","0","0","0","3","1","2","4","1","3","4","2","2","0","0","0","9","3","6","0","0","0","0","0","0","0","0","0","-2"
"190600","CUNY John Jay College of Criminal Justice","2018","Tenured, lecturers","33","17","16","0","0","0","1","0","1","6","4","2","5","2","3","2","0","2","18","10","8","0","0","0","0","0","0","1","1","0","-2"
"190600","CUNY John Jay College of Criminal Justice","2018","On-Tenure track total","76","32","44","0","0","0","5","3","2","5","2","3","7","4","3","0","0","0","45","18","27","2","1","1","0","0","0","12","4","8","-2"
"190600","CUNY John Jay College of Criminal Justice","2018","On-tenure track, associate professors","11","6","5","0","0","0","1","0","1","0","0","0","1","1","0","0","0","0","8","4","4","0","0","0","0","0","0","1","1","0","-2"
"190600","CUNY John Jay College of Criminal Justice","2018","On-tenure track, assistant professors","62","23","39","0","0","0","4","3","1","4","1","3","5","2","3","0","0","0","36","13","23","2","1","1","0","0","0","11","3","8","-2"
"190600","CUNY John Jay College of Criminal Justice","2018","On-tenure track, lecturers","3","3","0","0","0","0","0","0","0","1","1","0","1","1","0","0","0","0","1","1","0","0","0","0","0","0","0","0","0","0","-2"
"190600","CUNY John Jay College of Criminal Justice","2018","Not on tenure track/No tenure system system total","27","15","12","0","0","0","2","1","1","2","1","1","2","0","2","0","0","0","19","13","6","1","0","1","0","0","0","1","0","1","-2"
"190600","CUNY John Jay College of Criminal Justice","2018","Not on tenure/no tenure system, professors","5","4","1","0","0","0","0","0","0","0","0","0","0","0","0","0","0","0","5","4","1","0","0","0","0","0","0","0","0","0","-2"
"190600","CUNY John Jay College of Criminal Justice","2018","Not on tenure/no tenure system, assistant professors","8","1","7","0","0","0","1","0","1","1","0","1","2","0","2","0","0","0","3","1","2","0","0","0","0","0","0","1","0","1","-2"
"190600","CUNY John Jay College of Criminal Justice","2018","Not on tenure/no tenure system, lecturers","14","10","4","0","0","0","1","1","0","1","1","0","0","0","0","0","0","0","11","8","3","1","0","1","0","0","0","0","0","0","-2"
"190637","CUNY Lehman College","2018","Tenured total","233","114","119","2","0","2","14","10","4","23","8","15","33","19","14","0","0","0","157","75","82","0","0","0","0","0","0","4","2","2","-2"
"190637","CUNY Lehman College","2018","Tenured, professors","81","51","30","1","0","1","4","3","1","2","1","1","7","5","2","0","0","0","66","41","25","0","0","0","0","0","0","1","1","0","-2"
"190637","CUNY Lehman College","2018","Tenured, associate professors","109","45","64","1","0","1","7","4","3","12","6","6","18","8","10","0","0","0","69","26","43","0","0","0","0","0","0","2","1","1","-2"
"190637","CUNY Lehman College","2018","Tenured, assistant professors","10","5","5","0","0","0","2","2","0","3","0","3","1","1","0","0","0","0","4","2","2","0","0","0","0","0","0","0","0","0","-2"
"190637","CUNY Lehman College","2018","Tenured, lecturers","33","13","20","0","0","0","1","1","0","6","1","5","7","5","2","0","0","0","18","6","12","0","0","0","0","0","0","1","0","1","-2"
"190637","CUNY Lehman College","2018","On-Tenure track total","107","43","64","0","0","0","13","4","9","15","3","12","14","5","9","0","0","0","52","23","29","1","1","0","0","0","0","12","7","5","-2"
"190637","CUNY Lehman College","2018","On-tenure track, associate professors","7","3","4","0","0","0","2","2","0","0","0","0","1","0","1","0","0","0","4","1","3","0","0","0","0","0","0","0","0","0","-2"
"190637","CUNY Lehman College","2018","On-tenure track, assistant professors","82","35","47","0","0","0","9","2","7","11","3","8","13","5","8","0","0","0","40","20","20","0","0","0","0","0","0","9","5","4","-2"
"190637","CUNY Lehman College","2018","On-tenure track, lecturers","18","5","13","0","0","0","2","0","2","4","0","4","0","0","0","0","0","0","8","2","6","1","1","0","0","0","0","3","2","1","-2"
"190637","CUNY Lehman College","2018","Not on tenure track/No tenure system system total","28","10","18","0","0","0","2","1","1","5","1","4","7","1","6","0","0","0","14","7","7","0","0","0","0","0","0","0","0","0","-2"
"190637","CUNY Lehman College","2018","Not on tenure/no tenure system, professors","3","1","2","0","0","0","0","0","0","1","1","0","0","0","0","0","0","0","2","0","2","0","0","0","0","0","0","0","0","0","-2"
"190637","CUNY Lehman College","2018","Not on tenure/no tenure system, assistant professors","7","4","3","0","0","0","0","0","0","1","0","1","1","0","1","0","0","0","5","4","1","0","0","0","0","0","0","0","0","0","-2"
"190637","CUNY Lehman College","2018","Not on tenure/no tenure system, instructors","2","2","0","0","0","0","1","1","0","0","0","0","0","0","0","0","0","0","1","1","0","0","0","0","0","0","0","0","0","0","-2"
"190637","CUNY Lehman College","2018","Not on tenure/no tenure system, lecturers","16","3","13","0","0","0","1","0","1","3","0","3","6","1","5","0","0","0","6","2","4","0","0","0","0","0","0","0","0","0","-2"
"190655","CUNY New York City College of Technology","2018","Tenured total","276","153","123","2","1","1","41","21","20","35","20","15","21","12","9","0","0","0","162","88","74","0","0","0","0","0","0","15","11","4","-2"
"190655","CUNY New York City College of Technology","2018","Tenured, professors","81","42","39","0","0","0","10","2","8","12","8","4","5","3","2","0","0","0","50","25","25","0","0","0","0","0","0","4","4","0","-2"
"190655","CUNY New York City College of Technology","2018","Tenured, associate professors","114","63","51","1","0","1","18","10","8","12","6","6","7","5","2","0","0","0","69","39","30","0","0","0","0","0","0","7","3","4","-2"
"190655","CUNY New York City College of Technology","2018","Tenured, assistant professors","62","38","24","1","1","0","13","9","4","4","2","2","8","4","4","0","0","0","32","18","14","0","0","0","0","0","0","4","4","0","-2"
"190655","CUNY New York City College of Technology","2018","Tenured, lecturers","19","10","9","0","0","0","0","0","0","7","4","3","1","0","1","0","0","0","11","6","5","0","0","0","0","0","0","0","0","0","-2"
"190655","CUNY New York City College of Technology","2018","On-Tenure track total","112","48","64","0","0","0","23","14","9","14","3","11","9","5","4","0","0","0","62","24","38","0","0","0","0","0","0","4","2","2","-2"
"190655","CUNY New York City College of Technology","2018","On-tenure track, associate professors","15","7","8","0","0","0","4","3","1","1","0","1","0","0","0","0","0","0","8","3","5","0","0","0","0","0","0","2","1","1","-2"
"190655","CUNY New York City College of Technology","2018","On-tenure track, assistant professors","95","39","56","0","0","0","18","10","8","12","2","10","9","5","4","0","0","0","54","21","33","0","0","0","0","0","0","2","1","1","-2"
"190655","CUNY New York City College of Technology","2018","On-tenure track, lecturers","2","2","0","0","0","0","1","1","0","1","1","0","0","0","0","0","0","0","0","0","0","0","0","0","0","0","0","0","0","0","-2"
"190655","CUNY New York City College of Technology","2018","Not on tenure track/No tenure system system total","13","6","7","0","0","0","0","0","0","4","2","2","1","0","1","0","0","0","6","3","3","0","0","0","0","0","0","2","1","1","-2"
"190655","CUNY New York City College of Technology","2018","Not on tenure/no tenure system, assistant professors","6","4","2","0","0","0","0","0","0","2","1","1","0","0","0","0","0","0","2","2","0","0","0","0","0","0","0","2","1","1","-2"
"190655","CUNY New York City College of Technology","2018","Not on tenure/no tenure system, instructors","3","1","2","0","0","0","0","0","0","1","1","0","1","0","1","0","0","0","1","0","1","0","0","0","0","0","0","0","0","0","-2"
"190655","CUNY New York City College of Technology","2018","Not on tenure/no tenure system, lecturers","4","1","3","0","0","0","0","0","0","1","0","1","0","0","0","0","0","0","3","1","2","0","0","0","0","0","0","0","0","0","-2"
"190664","CUNY Queens College","2018","Tenured total","426","231","195","0","0","0","47","20","27","18","12","6","29","11","18","0","0","0","307","179","128","5","3","2","0","0","0","20","6","14","-2"
"190664","CUNY Queens College","2018","Tenured, professors","189","127","62","0","0","0","22","13","9","9","7","2","13","6","7","0","0","0","140","98","42","2","1","1","0","0","0","3","2","1","-2"
"190664","CUNY Queens College","2018","Tenured, associate professors","164","72","92","0","0","0","22","6","16","7","3","4","14","4","10","0","0","0","104","53","51","2","2","0","0","0","0","15","4","11","-2"
"190664","CUNY Queens College","2018","Tenured, assistant professors","12","6","6","0","0","0","1","1","0","1","1","0","0","0","0","0","0","0","8","4","4","1","0","1","0","0","0","1","0","1","-2"
"190664","CUNY Queens College","2018","Tenured, lecturers","61","26","35","0","0","0","2","0","2","1","1","0","2","1","1","0","0","0","55","24","31","0","0","0","0","0","0","1","0","1","-2"
"190664","CUNY Queens College","2018","On-Tenure track total","121","61","60","0","0","0","11","7","4","14","5","9","14","8","6","0","0","0","57","27","30","4","2","2","0","0","0","21","12","9","-2"
"190664","CUNY Queens College","2018","On-tenure track, professors","2","1","1","0","0","0","0","0","0","1","1","0","0","0","0","0","0","0","1","0","1","0","0","0","0","0","0","0","0","0","-2"
"190664","CUNY Queens College","2018","On-tenure track, associate professors","6","3","3","0","0","0","1","1","0","1","0","1","1","1","0","0","0","0","3","1","2","0","0","0","0","0","0","0","0","0","-2"
"190664","CUNY Queens College","2018","On-tenure track, assistant professors","85","45","40","0","0","0","6","5","1","8","2","6","12","6","6","0","0","0","35","18","17","4","2","2","0","0","0","20","12","8","-2"
"190664","CUNY Queens College","2018","On-tenure track, lecturers","28","12","16","0","0","0","4","1","3","4","2","2","1","1","0","0","0","0","18","8","10","0","0","0","0","0","0","1","0","1","-2"
"190664","CUNY Queens College","2018","Not on tenure track/No tenure system system total","40","25","15","0","0","0","6","3","3","8","3","5","2","1","1","0","0","0","22","17","5","0","0","0","0","0","0","2","1","1","-2"
"190664","CUNY Queens College","2018","Not on tenure/no tenure system, professors","9","6","3","0","0","0","0","0","0","3","0","3","1","1","0","0","0","0","5","5","0","0","0","0","0","0","0","0","0","0","-2"
"190664","CUNY Queens College","2018","Not on tenure/no tenure system, associate professors","2","2","0","0","0","0","0","0","0","0","0","0","0","0","0","0","0","0","2","2","0","0","0","0","0","0","0","0","0","0","-2"
"190664","CUNY Queens College","2018","Not on tenure/no tenure system, assistant professors","3","1","2","0","0","0","1","1","0","2","0","2","0","0","0","0","0","0","0","0","0","0","0","0","0","0","0","0","0","0","-2"
"190664","CUNY Queens College","2018","Not on tenure/no tenure system, lecturers","26","16","10","0","0","0","5","2","3","3","3","0","1","0","1","0","0","0","15","10","5","0","0","0","0","0","0","2","1","1","-2"
"190691","CUNY York College","2018","Tenured total","132","73","59","0","0","0","19","12","7","26","13","13","10","5","5","0","0","0","74","42","32","0","0","0","0","0","0","3","1","2","-2"
"190691","CUNY York College","2018","Tenured, professors","43","25","18","0","0","0","6","6","0","5","4","1","3","1","2","0","0","0","28","13","15","0","0","0","0","0","0","1","1","0","-2"
"190691","CUNY York College","2018","Tenured, associate professors","64","33","31","0","0","0","11","6","5","14","4","10","7","4","3","0","0","0","30","19","11","0","0","0","0","0","0","2","0","2","-2"
"190691","CUNY York College","2018","Tenured, assistant professors","10","7","3","0","0","0","1","0","1","3","2","1","0","0","0","0","0","0","6","5","1","0","0","0","0","0","0","0","0","0","-2"
"190691","CUNY York College","2018","Tenured, lecturers","15","8","7","0","0","0","1","0","1","4","3","1","0","0","0","0","0","0","10","5","5","0","0","0","0","0","0","0","0","0","-2"
"190691","CUNY York College","2018","On-Tenure track total","46","21","25","0","0","0","6","4","2","12","3","9","7","3","4","0","0","0","20","10","10","0","0","0","0","0","0","1","1","0","-2"
"190691","CUNY York College","2018","On-tenure track, associate professors","7","3","4","0","0","0","2","1","1","1","0","1","2","1","1","0","0","0","2","1","1","0","0","0","0","0","0","0","0","0","-2"
"190691","CUNY York College","2018","On-tenure track, assistant professors","35","16","19","0","0","0","4","3","1","9","2","7","4","2","2","0","0","0","17","8","9","0","0","0","0","0","0","1","1","0","-2"
"190691","CUNY York College","2018","On-tenure track, lecturers","4","2","2","0","0","0","0","0","0","2","1","1","1","0","1","0","0","0","1","1","0","0","0","0","0","0","0","0","0","0","-2"
"190691","CUNY York College","2018","Not on tenure track/No tenure system system total","8","1","7","0","0","0","2","0","2","4","1","3","0","0","0","0","0","0","1","0","1","0","0","0","0","0","0","1","0","1","-2"
"190691","CUNY York College","2018","Not on tenure/no tenure system, professors","5","1","4","0","0","0","0","0","0","3","1","2","0","0","0","0","0","0","1","0","1","0","0","0","0","0","0","1","0","1","-2"
"190691","CUNY York College","2018","Not on tenure/no tenure system, assistant professors","3","0","3","0","0","0","2","0","2","1","0","1","0","0","0","0","0","0","0","0","0","0","0","0","0","0","0","0","0","0","-2"
"190761","Dominican College of Blauvelt","2018","Tenured total","32","12","20","0","0","0","1","1","0","0","0","0","1","1","0","0","0","0","30","10","20","0","0","0","0","0","0","0","0","0","-2"
"190761","Dominican College of Blauvelt","2018","Tenured, professors","4","0","4","0","0","0","0","0","0","0","0","0","0","0","0","0","0","0","4","0","4","0","0","0","0","0","0","0","0","0","-2"
"190761","Dominican College of Blauvelt","2018","Tenured, associate professors","14","6","8","0","0","0","1","1","0","0","0","0","1","1","0","0","0","0","12","4","8","0","0","0","0","0","0","0","0","0","-2"
"190761","Dominican College of Blauvelt","2018","Tenured, assistant professors","14","6","8","0","0","0","0","0","0","0","0","0","0","0","0","0","0","0","14","6","8","0","0","0","0","0","0","0","0","0","-2"
"190761","Dominican College of Blauvelt","2018","On-Tenure track total","25","9","16","0","0","0","4","3","1","1","0","1","3","1","2","0","0","0","16","5","11","0","0","0","1","0","1","0","0","0","-2"
"190761","Dominican College of Blauvelt","2018","On-tenure track, associate professors","2","2","0","0","0","0","1","1","0","0","0","0","0","0","0","0","0","0","1","1","0","0","0","0","0","0","0","0","0","0","-2"
"190761","Dominican College of Blauvelt","2018","On-tenure track, assistant professors","20","6","14","0","0","0","3","2","1","1","0","1","3","1","2","0","0","0","12","3","9","0","0","0","1","0","1","0","0","0","-2"
"190761","Dominican College of Blauvelt","2018","On-tenure track, instructors","3","1","2","0","0","0","0","0","0","0","0","0","0","0","0","0","0","0","3","1","2","0","0","0","0","0","0","0","0","0","-2"
"190761","Dominican College of Blauvelt","2018","Not on tenure track/No tenure system system total","18","6","12","0","0","0","0","0","0","0","0","0","0","0","0","0","0","0","18","6","12","0","0","0","0","0","0","0","0","0","-2"
"190761","Dominican College of Blauvelt","2018","Not on tenure/no tenure system, assistant professors","12","5","7","0","0","0","0","0","0","0","0","0","0","0","0","0","0","0","12","5","7","0","0","0","0","0","0","0","0","0","-2"
"190761","Dominican College of Blauvelt","2018","Not on tenure/no tenure system, instructors","6","1","5","0","0","0","0","0","0","0","0","0","0","0","0","0","0","0","6","1","5","0","0","0","0","0","0","0","0","0","-2"
"192749","Manhattanville College","2018","Tenured total","63","35","28","0","0","0","5","1","4","4","3","1","1","0","1","0","0","0","50","29","21","0","0","0","3","2","1","0","0","0","-2"
"192749","Manhattanville College","2018","Tenured, professors","42","25","17","0","0","0","4","1","3","3","3","0","1","0","1","0","0","0","34","21","13","0","0","0","0","0","0","0","0","0","-2"
"192749","Manhattanville College","2018","Tenured, associate professors","18","10","8","0","0","0","0","0","0","0","0","0","0","0","0","0","0","0","15","8","7","0","0","0","3","2","1","0","0","0","-2"
"192749","Manhattanville College","2018","Tenured, assistant professors","3","0","3","0","0","0","1","0","1","1","0","1","0","0","0","0","0","0","1","0","1","0","0","0","0","0","0","0","0","0","-2"
"192749","Manhattanville College","2018","On-Tenure track total","29","12","17","1","1","0","1","0","1","0","0","0","1","1","0","0","0","0","24","9","15","0","0","0","2","1","1","0","0","0","-2"
"192749","Manhattanville College","2018","On-tenure track, professors","4","2","2","1","1","0","0","0","0","0","0","0","0","0","0","0","0","0","3","1","2","0","0","0","0","0","0","0","0","0","-2"
"192749","Manhattanville College","2018","On-tenure track, associate professors","12","5","7","0","0","0","1","0","1","0","0","0","0","0","0","0","0","0","10","5","5","0","0","0","1","0","1","0","0","0","-2"
"192749","Manhattanville College","2018","On-tenure track, assistant professors","13","5","8","0","0","0","0","0","0","0","0","0","1","1","0","0","0","0","11","3","8","0","0","0","1","1","0","0","0","0","-2"
"192749","Manhattanville College","2018","Not on tenure track/No tenure system system total","22","8","14","0","0","0","0","0","0","1","0","1","2","1","1","0","0","0","17","7","10","1","0","1","1","0","1","0","0","0","-2"
"192749","Manhattanville College","2018","Not on tenure/no tenure system, professors","2","1","1","0","0","0","0","0","0","0","0","0","0","0","0","0","0","0","1","1","0","1","0","1","0","0","0","0","0","0","-2"
"192749","Manhattanville College","2018","Not on tenure/no tenure system, assistant professors","4","0","4","0","0","0","0","0","0","0","0","0","0","0","0","0","0","0","3","0","3","0","0","0","1","0","1","0","0","0","-2"
"192749","Manhattanville College","2018","Not on tenure/no tenure system, instructors","1","1","0","0","0","0","0","0","0","0","0","0","0","0","0","0","0","0","1","1","0","0","0","0","0","0","0","0","0","0","-2"
"192749","Manhattanville College","2018","Not on tenure/no tenure system, lecturers","15","6","9","0","0","0","0","0","0","1","0","1","2","1","1","0","0","0","12","5","7","0","0","0","0","0","0","0","0","0","-2"
"193016","Mercy College","2018","Tenured total","59","25","34","0","0","0","12","4","8","4","1","3","3","2","1","0","0","0","39","17","22","1","1","0","0","0","0","0","0","0","-2"
"193016","Mercy College","2018","Tenured, professors","21","13","8","0","0","0","3","2","1","1","1","0","1","1","0","0","0","0","15","8","7","1","1","0","0","0","0","0","0","0","-2"
"193016","Mercy College","2018","Tenured, associate professors","29","9","20","0","0","0","5","1","4","3","0","3","1","0","1","0","0","0","20","8","12","0","0","0","0","0","0","0","0","0","-2"
"193016","Mercy College","2018","Tenured, assistant professors","9","3","6","0","0","0","4","1","3","0","0","0","1","1","0","0","0","0","4","1","3","0","0","0","0","0","0","0","0","0","-2"
"193016","Mercy College","2018","On-Tenure track total","31","13","18","0","0","0","7","5","2","3","0","3","1","0","1","0","0","0","19","8","11","0","0","0","1","0","1","0","0","0","-2"
"193016","Mercy College","2018","On-tenure track, professors","1","0","1","0","0","0","0","0","0","0","0","0","0","0","0","0","0","0","1","0","1","0","0","0","0","0","0","0","0","0","-2"
"193016","Mercy College","2018","On-tenure track, associate professors","6","3","3","0","0","0","0","0","0","0","0","0","1","0","1","0","0","0","5","3","2","0","0","0","0","0","0","0","0","0","-2"
"193016","Mercy College","2018","On-tenure track, assistant professors","24","10","14","0","0","0","7","5","2","3","0","3","0","0","0","0","0","0","13","5","8","0","0","0","1","0","1","0","0","0","-2"
"193016","Mercy College","2018","Not on tenure track/No tenure system system total","115","44","71","0","0","0","6","3","3","12","4","8","8","2","6","0","0","0","88","34","54","0","0","0","1","1","0","0","0","0","-2"
"193016","Mercy College","2018","Not on tenure/no tenure system, professors","3","1","2","0","0","0","0","0","0","0","0","0","0","0","0","0","0","0","3","1","2","0","0","0","0","0","0","0","0","0","-2"
"193016","Mercy College","2018","Not on tenure/no tenure system, associate professors","29","13","16","0","0","0","3","2","1","0","0","0","1","0","1","0","0","0","25","11","14","0","0","0","0","0","0","0","0","0","-2"
"193016","Mercy College","2018","Not on tenure/no tenure system, assistant professors","71","23","48","0","0","0","2","0","2","11","3","8","7","2","5","0","0","0","50","17","33","0","0","0","1","1","0","0","0","0","-2"
"193016","Mercy College","2018","Not on tenure/no tenure system, instructors","12","7","5","0","0","0","1","1","0","1","1","0","0","0","0","0","0","0","10","5","5","0","0","0","0","0","0","0","0","0","-2"
"193399","College of Mount Saint Vincent","2018","Tenured total","29","19","10","0","0","0","1","0","1","0","0","0","0","0","0","0","0","0","27","18","9","1","1","0","0","0","0","0","0","0","-2"
"193399","College of Mount Saint Vincent","2018","Tenured, professors","8","6","2","0","0","0","0","0","0","0","0","0","0","0","0","0","0","0","7","5","2","1","1","0","0","0","0","0","0","0","-2"
"193399","College of Mount Saint Vincent","2018","Tenured, associate professors","20","12","8","0","0","0","1","0","1","0","0","0","0","0","0","0","0","0","19","12","7","0","0","0","0","0","0","0","0","0","-2"
"193399","College of Mount Saint Vincent","2018","Tenured, assistant professors","1","1","0","0","0","0","0","0","0","0","0","0","0","0","0","0","0","0","1","1","0","0","0","0","0","0","0","0","0","0","-2"
"193399","College of Mount Saint Vincent","2018","On-Tenure track total","40","15","25","0","0","0","4","1","3","1","0","1","5","1","4","0","0","0","26","11","15","4","2","2","0","0","0","0","0","0","-2"
"193399","College of Mount Saint Vincent","2018","On-tenure track, professors","1","0","1","0","0","0","0","0","0","0","0","0","0","0","0","0","0","0","1","0","1","0","0","0","0","0","0","0","0","0","-2"
"193399","College of Mount Saint Vincent","2018","On-tenure track, associate professors","17","6","11","0","0","0","2","1","1","0","0","0","3","1","2","0","0","0","10","3","7","2","1","1","0","0","0","0","0","0","-2"
"193399","College of Mount Saint Vincent","2018","On-tenure track, assistant professors","21","9","12","0","0","0","2","0","2","1","0","1","2","0","2","0","0","0","14","8","6","2","1","1","0","0","0","0","0","0","-2"
"193399","College of Mount Saint Vincent","2018","On-tenure track, instructors","1","0","1","0","0","0","0","0","0","0","0","0","0","0","0","0","0","0","1","0","1","0","0","0","0","0","0","0","0","0","-2"
"193399","College of Mount Saint Vincent","2018","Not on tenure track/No tenure system system total","9","2","7","0","0","0","0","0","0","1","0","1","0","0","0","0","0","0","8","2","6","0","0","0","0","0","0","0","0","0","-2"
"193399","College of Mount Saint Vincent","2018","Not on tenure/no tenure system, assistant professors","4","1","3","0","0","0","0","0","0","0","0","0","0","0","0","0","0","0","4","1","3","0","0","0","0","0","0","0","0","0","-2"
"193399","College of Mount Saint Vincent","2018","Not on tenure/no tenure system, instructors","5","1","4","0","0","0","0","0","0","1","0","1","0","0","0","0","0","0","4","1","3","0","0","0","0","0","0","0","0","0","-2"
"194161","Nyack College","2018","Tenured total","29","15","14","0","0","0","4","2","2","4","2","2","1","0","1","0","0","0","20","11","9","0","0","0","0","0","0","0","0","0","-2"
"194161","Nyack College","2018","Tenured, professors","24","13","11","0","0","0","4","2","2","3","1","2","1","0","1","0","0","0","16","10","6","0","0","0","0","0","0","0","0","0","-2"
"194161","Nyack College","2018","Tenured, associate professors","5","2","3","0","0","0","0","0","0","1","1","0","0","0","0","0","0","0","4","1","3","0","0","0","0","0","0","0","0","0","-2"
"194161","Nyack College","2018","On-Tenure track total","37","19","18","0","0","0","6","2","4","5","2","3","7","3","4","0","0","0","18","11","7","0","0","0","0","0","0","1","1","0","-2"
"194161","Nyack College","2018","On-tenure track, professors","8","4","4","0","0","0","0","0","0","1","0","1","0","0","0","0","0","0","7","4","3","0","0","0","0","0","0","0","0","0","-2"
"194161","Nyack College","2018","On-tenure track, associate professors","12","6","6","0","0","0","3","1","2","2","1","1","1","0","1","0","0","0","6","4","2","0","0","0","0","0","0","0","0","0","-2"
"194161","Nyack College","2018","On-tenure track, assistant professors","17","9","8","0","0","0","3","1","2","2","1","1","6","3","3","0","0","0","5","3","2","0","0","0","0","0","0","1","1","0","-2"
"194161","Nyack College","2018","Not on tenure track/No tenure system system total","6","1","5","0","0","0","1","0","1","4","0","4","0","0","0","0","0","0","1","1","0","0","0","0","0","0","0","0","0","0","-2"
"194161","Nyack College","2018","Not on tenure/no tenure system, lecturers","6","1","5","0","0","0","1","0","1","4","0","4","0","0","0","0","0","0","1","1","0","0","0","0","0","0","0","0","0","0","-2"
"195173","St Francis College","2018","Tenured total","46","22","24","0","0","0","2","1","1","3","0","3","3","1","2","0","0","0","38","20","18","0","0","0","0","0","0","0","0","0","-2"
"195173","St Francis College","2018","Tenured, professors","25","15","10","0","0","0","1","1","0","1","0","1","1","0","1","0","0","0","22","14","8","0","0","0","0","0","0","0","0","0","-2"
"195173","St Francis College","2018","Tenured, associate professors","21","7","14","0","0","0","1","0","1","2","0","2","2","1","1","0","0","0","16","6","10","0","0","0","0","0","0","0","0","0","-2"
"195173","St Francis College","2018","On-Tenure track total","32","9","23","0","0","0","2","1","1","2","0","2","1","0","1","0","0","0","24","8","16","2","0","2","0","0","0","1","0","1","-2"
"195173","St Francis College","2018","On-tenure track, associate professors","4","2","2","0","0","0","1","1","0","0","0","0","0","0","0","0","0","0","3","1","2","0","0","0","0","0","0","0","0","0","-2"
"195173","St Francis College","2018","On-tenure track, assistant professors","27","7","20","0","0","0","1","0","1","2","0","2","1","0","1","0","0","0","20","7","13","2","0","2","0","0","0","1","0","1","-2"
"195173","St Francis College","2018","On-tenure track, lecturers","1","0","1","0","0","0","0","0","0","0","0","0","0","0","0","0","0","0","1","0","1","0","0","0","0","0","0","0","0","0","-2"
"195173","St Francis College","2018","Not on tenure track/No tenure system system total","14","10","4","0","0","0","1","1","0","1","0","1","0","0","0","0","0","0","11","8","3","0","0","0","0","0","0","1","1","0","-2"
"195173","St Francis College","2018","Not on tenure/no tenure system, lecturers","14","10","4","0","0","0","1","1","0","1","0","1","0","0","0","0","0","0","11","8","3","0","0","0","0","0","0","1","1","0","-2"
"196219","SUNY at Purchase College","2018","Tenured total","91","45","46","0","0","0","5","2","3","3","2","1","2","2","0","0","0","0","77","38","39","3","1","2","0","0","0","1","0","1","-2"
"196219","SUNY at Purchase College","2018","Tenured, professors","30","15","15","0","0","0","3","2","1","1","1","0","0","0","0","0","0","0","26","12","14","0","0","0","0","0","0","0","0","0","-2"
"196219","SUNY at Purchase College","2018","Tenured, associate professors","61","30","31","0","0","0","2","0","2","2","1","1","2","2","0","0","0","0","51","26","25","3","1","2","0","0","0","1","0","1","-2"
"196219","SUNY at Purchase College","2018","On-Tenure track total","56","26","30","0","0","0","6","2","4","3","0","3","3","2","1","0","0","0","41","19","22","0","0","0","0","0","0","3","3","0","-2"
"196219","SUNY at Purchase College","2018","On-tenure track, associate professors","8","4","4","0","0","0","1","0","1","0","0","0","0","0","0","0","0","0","7","4","3","0","0","0","0","0","0","0","0","0","-2"
"196219","SUNY at Purchase College","2018","On-tenure track, assistant professors","48","22","26","0","0","0","5","2","3","3","0","3","3","2","1","0","0","0","34","15","19","0","0","0","0","0","0","3","3","0","-2"
"196219","SUNY at Purchase College","2018","Not on tenure track/No tenure system system total","30","9","21","0","0","0","2","0","2","1","0","1","4","1","3","0","0","0","22","7","15","0","0","0","0","0","0","1","1","0","-2"
"196219","SUNY at Purchase College","2018","Not on tenure/no tenure system, associate professors","4","1","3","0","0","0","0","0","0","0","0","0","0","0","0","0","0","0","4","1","3","0","0","0","0","0","0","0","0","0","-2"
"196219","SUNY at Purchase College","2018","Not on tenure/no tenure system, assistant professors","24","8","16","0","0","0","1","0","1","1","0","1","4","1","3","0","0","0","17","6","11","0","0","0","0","0","0","1","1","0","-2"
"196219","SUNY at Purchase College","2018","Not on tenure/no tenure system, lecturers","2","0","2","0","0","0","1","0","1","0","0","0","0","0","0","0","0","0","1","0","1","0","0","0","0","0","0","0","0","0","-2"
"196237","SUNY College at Old Westbury","2018","Tenured total","83","39","44","0","0","0","15","5","10","11","6","5","8","7","1","0","0","0","48","21","27","1","0","1","0","0","0","0","0","0","-2"
"196237","SUNY College at Old Westbury","2018","Tenured, professors","22","10","12","0","0","0","5","2","3","1","1","0","4","4","0","0","0","0","12","3","9","0","0","0","0","0","0","0","0","0","-2"
"196237","SUNY College at Old Westbury","2018","Tenured, associate professors","60","28","32","0","0","0","10","3","7","10","5","5","4","3","1","0","0","0","35","17","18","1","0","1","0","0","0","0","0","0","-2"
"196237","SUNY College at Old Westbury","2018","Tenured, instructors","1","1","0","0","0","0","0","0","0","0","0","0","0","0","0","0","0","0","1","1","0","0","0","0","0","0","0","0","0","0","-2"
"196237","SUNY College at Old Westbury","2018","On-Tenure track total","57","27","30","1","1","0","8","4","4","7","4","3","6","1","5","0","0","0","33","15","18","0","0","0","0","0","0","2","2","0","-2"
"196237","SUNY College at Old Westbury","2018","On-tenure track, associate professors","2","1","1","0","0","0","0","0","0","0","0","0","0","0","0","0","0","0","2","1","1","0","0","0","0","0","0","0","0","0","-2"
"196237","SUNY College at Old Westbury","2018","On-tenure track, assistant professors","55","26","29","1","1","0","8","4","4","7","4","3","6","1","5","0","0","0","31","14","17","0","0","0","0","0","0","2","2","0","-2"
"196237","SUNY College at Old Westbury","2018","Not on tenure track/No tenure system system total","32","14","18","0","0","0","7","2","5","7","2","5","0","0","0","0","0","0","18","10","8","0","0","0","0","0","0","0","0","0","-2"
"196237","SUNY College at Old Westbury","2018","Not on tenure/no tenure system, associate professors","2","1","1","0","0","0","0","0","0","2","1","1","0","0","0","0","0","0","0","0","0","0","0","0","0","0","0","0","0","0","-2"
"196237","SUNY College at Old Westbury","2018","Not on tenure/no tenure system, assistant professors","13","5","8","0","0","0","2","1","1","3","0","3","0","0","0","0","0","0","8","4","4","0","0","0","0","0","0","0","0","0","-2"
"196237","SUNY College at Old Westbury","2018","Not on tenure/no tenure system, instructors","1","1","0","0","0","0","0","0","0","0","0","0","0","0","0","0","0","0","1","1","0","0","0","0","0","0","0","0","0","0","-2"
"196237","SUNY College at Old Westbury","2018","Not on tenure/no tenure system, lecturers","16","7","9","0","0","0","5","1","4","2","1","1","0","0","0","0","0","0","9","5","4","0","0","0","0","0","0","0","0","0","-2"
"206279","Union Institute & University","2018","Not on tenure track/No tenure system system total","33","14","19","0","0","0","1","0","1","9","3","6","0","0","0","0","0","0","21","11","10","0","0","0","2","0","2","0","0","0","-2"
"206279","Union Institute & University","2018","Not on tenure/no tenure system, no academic rank","33","14","19","0","0","0","1","0","1","9","3","6","0","0","0","0","0","0","21","11","10","0","0","0","2","0","2","0","0","0","-2"
"207351","Oklahoma Panhandle State University","2018","Tenured total","9","5","4","0","0","0","0","0","0","0","0","0","0","0","0","0","0","0","8","5","3","1","0","1","0","0","0","0","0","0","-2"
"207351","Oklahoma Panhandle State University","2018","Tenured, professors","8","5","3","0","0","0","0","0","0","0","0","0","0","0","0","0","0","0","8","5","3","0","0","0","0","0","0","0","0","0","-2"
"207351","Oklahoma Panhandle State University","2018","Tenured, associate professors","1","0","1","0","0","0","0","0","0","0","0","0","0","0","0","0","0","0","0","0","0","1","0","1","0","0","0","0","0","0","-2"
"207351","Oklahoma Panhandle State University","2018","On-Tenure track total","20","11","9","1","1","0","1","0","1","0","0","0","0","0","0","0","0","0","17","9","8","1","1","0","0","0","0","0","0","0","-2"
"207351","Oklahoma Panhandle State University","2018","On-tenure track, professors","1","1","0","0","0","0","0","0","0","0","0","0","0","0","0","0","0","0","1","1","0","0","0","0","0","0","0","0","0","0","-2"
"207351","Oklahoma Panhandle State University","2018","On-tenure track, associate professors","5","4","1","1","1","0","1","0","1","0","0","0","0","0","0","0","0","0","3","3","0","0","0","0","0","0","0","0","0","0","-2"
"207351","Oklahoma Panhandle State University","2018","On-tenure track, assistant professors","13","6","7","0","0","0","0","0","0","0","0","0","0","0","0","0","0","0","12","5","7","1","1","0","0","0","0","0","0","0","-2"
"207351","Oklahoma Panhandle State University","2018","On-tenure track, no academic rank","1","0","1","0","0","0","0","0","0","0","0","0","0","0","0","0","0","0","1","0","1","0","0","0","0","0","0","0","0","0","-2"
"207351","Oklahoma Panhandle State University","2018","Not on tenure track/No tenure system system total","15","8","7","0","0","0","0","0","0","1","0","1","1","1","0","0","0","0","13","7","6","0","0","0","0","0","0","0","0","0","-2"
"207351","Oklahoma Panhandle State University","2018","Not on tenure/no tenure system, instructors","15","8","7","0","0","0","0","0","0","1","0","1","1","1","0","0","0","0","13","7","6","0","0","0","0","0","0","0","0","0","-2"
"209241","Mount Angel Seminary","2018","Not on tenure track/No tenure system system total","13","9","4","0","0","0","1","0","1","0","0","0","0","0","0","0","0","0","12","9","3","0","0","0","0","0","0","0","0","0","-2"
"209241","Mount Angel Seminary","2018","Not on tenure/no tenure system, professors","5","5","0","0","0","0","0","0","0","0","0","0","0","0","0","0","0","0","5","5","0","0","0","0","0","0","0","0","0","0","-2"
"209241","Mount Angel Seminary","2018","Not on tenure/no tenure system, associate professors","7","4","3","0","0","0","1","0","1","0","0","0","0","0","0","0","0","0","6","4","2","0","0","0","0","0","0","0","0","0","-2"
"209241","Mount Angel Seminary","2018","Not on tenure/no tenure system, assistant professors","1","0","1","0","0","0","0","0","0","0","0","0","0","0","0","0","0","0","1","0","1","0","0","0","0","0","0","0","0","0","-2"
"210304","Warner Pacific University","2018","Not on tenure track/No tenure system system total","29","14","15","0","0","0","1","1","0","2","1","1","5","2","3","0","0","0","19","9","10","0","0","0","2","1","1","0","0","0","-2"
"210304","Warner Pacific University","2018","Not on tenure/no tenure system, professors","5","3","2","0","0","0","0","0","0","0","0","0","1","1","0","0","0","0","4","2","2","0","0","0","0","0","0","0","0","0","-2"
"210304","Warner Pacific University","2018","Not on tenure/no tenure system, associate professors","11","5","6","0","0","0","1","1","0","0","0","0","1","0","1","0","0","0","8","3","5","0","0","0","1","1","0","0","0","0","-2"
"210304","Warner Pacific University","2018","Not on tenure/no tenure system, assistant professors","10","4","6","0","0","0","0","0","0","1","1","0","3","1","2","0","0","0","5","2","3","0","0","0","1","0","1","0","0","0","-2"
"210304","Warner Pacific University","2018","Not on tenure/no tenure system, instructors","3","2","1","0","0","0","0","0","0","1","0","1","0","0","0","0","0","0","2","2","0","0","0","0","0","0","0","0","0","0","-2"
"222831","Angelo State University","2018","Tenured total","137","86","51","2","1","1","9","6","3","5","1","4","9","3","6","0","0","0","111","74","37","0","0","0","1","1","0","0","0","0","-2"
"222831","Angelo State University","2018","Tenured, professors","80","54","26","1","0","1","3","2","1","2","1","1","4","2","2","0","0","0","70","49","21","0","0","0","0","0","0","0","0","0","-2"
"222831","Angelo State University","2018","Tenured, associate professors","55","31","24","1","1","0","6","4","2","3","0","3","4","1","3","0","0","0","40","24","16","0","0","0","1","1","0","0","0","0","-2"
"222831","Angelo State University","2018","Tenured, assistant professors","2","1","1","0","0","0","0","0","0","0","0","0","1","0","1","0","0","0","1","1","0","0","0","0","0","0","0","0","0","0","-2"
"222831","Angelo State University","2018","On-Tenure track total","66","39","27","0","0","0","7","7","0","2","2","0","3","2","1","0","0","0","52","26","26","0","0","0","2","2","0","0","0","0","-2"
"222831","Angelo State University","2018","On-tenure track, assistant professors","66","39","27","0","0","0","7","7","0","2","2","0","3","2","1","0","0","0","52","26","26","0","0","0","2","2","0","0","0","0","-2"
"222831","Angelo State University","2018","Not on tenure track/No tenure system system total","103","36","67","2","0","2","0","0","0","0","0","0","13","7","6","0","0","0","88","29","59","0","0","0","0","0","0","0","0","0","-2"
"222831","Angelo State University","2018","Not on tenure/no tenure system, assistant professors","3","1","2","0","0","0","0","0","0","0","0","0","0","0","0","0","0","0","3","1","2","0","0","0","0","0","0","0","0","0","-2"
"222831","Angelo State University","2018","Not on tenure/no tenure system, instructors","75","30","45","0","0","0","0","0","0","0","0","0","8","6","2","0","0","0","67","24","43","0","0","0","0","0","0","0","0","0","-2"
"222831","Angelo State University","2018","Not on tenure/no tenure system, no academic rank","25","5","20","2","0","2","0","0","0","0","0","0","5","1","4","0","0","0","18","4","14","0","0","0","0","0","0","0","0","0","-2"
"222992","Austin Community College District","2018","Not on tenure track/No tenure system system total","578","249","329","2","0","2","25","9","16","44","20","24","88","44","44","2","2","0","408","171","237","9","3","6","0","0","0","0","0","0","-2"
"222992","Austin Community College District","2018","Not on tenure/no tenure system, professors","325","159","166","2","0","2","13","5","8","24","14","10","46","26","20","1","1","0","234","112","122","5","1","4","0","0","0","0","0","0","-2"
"222992","Austin Community College District","2018","Not on tenure/no tenure system, associate professors","148","47","101","0","0","0","10","3","7","9","2","7","26","10","16","0","0","0","102","31","71","1","1","0","0","0","0","0","0","0","-2"
"222992","Austin Community College District","2018","Not on tenure/no tenure system, assistant professors","47","22","25","0","0","0","2","1","1","3","2","1","8","4","4","1","1","0","30","13","17","3","1","2","0","0","0","0","0","0","-2"
"222992","Austin Community College District","2018","Not on tenure/no tenure system, instructors","4","2","2","0","0","0","0","0","0","0","0","0","1","1","0","0","0","0","3","1","2","0","0","0","0","0","0","0","0","0","-2"
"222992","Austin Community College District","2018","Not on tenure/no tenure system, no academic rank","54","19","35","0","0","0","0","0","0","8","2","6","7","3","4","0","0","0","39","14","25","0","0","0","0","0","0","0","0","0","-2"
"223506","Brazosport College","2018","Tenured total","45","25","20","1","1","0","2","0","2","2","2","0","2","0","2","0","0","0","38","22","16","0","0","0","0","0","0","0","0","0","-2"
"223506","Brazosport College","2018","Tenured, professors","17","11","6","1","1","0","1","0","1","0","0","0","0","0","0","0","0","0","15","10","5","0","0","0","0","0","0","0","0","0","-2"
"223506","Brazosport College","2018","Tenured, associate professors","15","7","8","0","0","0","1","0","1","2","2","0","0","0","0","0","0","0","12","5","7","0","0","0","0","0","0","0","0","0","-2"
"223506","Brazosport College","2018","Tenured, assistant professors","13","7","6","0","0","0","0","0","0","0","0","0","2","0","2","0","0","0","11","7","4","0","0","0","0","0","0","0","0","0","-2"
"223506","Brazosport College","2018","Not on tenure track/No tenure system system total","52","31","21","1","1","0","2","2","0","2","0","2","5","3","2","0","0","0","41","24","17","1","1","0","0","0","0","0","0","0","-2"
"223506","Brazosport College","2018","Not on tenure/no tenure system, professors","1","1","0","0","0","0","0","0","0","0","0","0","0","0","0","0","0","0","1","1","0","0","0","0","0","0","0","0","0","0","-2"
"223506","Brazosport College","2018","Not on tenure/no tenure system, associate professors","4","2","2","0","0","0","0","0","0","1","0","1","1","1","0","0","0","0","2","1","1","0","0","0","0","0","0","0","0","0","-2"
"223506","Brazosport College","2018","Not on tenure/no tenure system, assistant professors","20","12","8","0","0","0","2","2","0","1","0","1","1","0","1","0","0","0","16","10","6","0","0","0","0","0","0","0","0","0","-2"
"223506","Brazosport College","2018","Not on tenure/no tenure system, instructors","27","16","11","1","1","0","0","0","0","0","0","0","3","2","1","0","0","0","22","12","10","1","1","0","0","0","0","0","0","0","-2"
"224004","Concordia University Texas","2018","Tenured total","9","6","3","0","0","0","0","0","0","0","0","0","0","0","0","0","0","0","9","6","3","0","0","0","0","0","0","0","0","0","-2"
"224004","Concordia University Texas","2018","Tenured, professors","8","5","3","0","0","0","0","0","0","0","0","0","0","0","0","0","0","0","8","5","3","0","0","0","0","0","0","0","0","0","-2"
"224004","Concordia University Texas","2018","Tenured, associate professors","1","1","0","0","0","0","0","0","0","0","0","0","0","0","0","0","0","0","1","1","0","0","0","0","0","0","0","0","0","0","-2"
"224004","Concordia University Texas","2018","On-Tenure track total","54","23","31","2","0","2","0","0","0","3","1","2","3","0","3","0","0","0","40","19","21","2","2","0","0","0","0","4","1","3","-2"
"224004","Concordia University Texas","2018","On-tenure track, professors","3","1","2","0","0","0","0","0","0","0","0","0","0","0","0","0","0","0","3","1","2","0","0","0","0","0","0","0","0","0","-2"
"224004","Concordia University Texas","2018","On-tenure track, associate professors","23","11","12","1","0","1","0","0","0","1","0","1","1","0","1","0","0","0","20","11","9","0","0","0","0","0","0","0","0","0","-2"
"224004","Concordia University Texas","2018","On-tenure track, assistant professors","25","11","14","1","0","1","0","0","0","2","1","1","2","0","2","0","0","0","14","7","7","2","2","0","0","0","0","4","1","3","-2"
"224004","Concordia University Texas","2018","On-tenure track, instructors","3","0","3","0","0","0","0","0","0","0","0","0","0","0","0","0","0","0","3","0","3","0","0","0","0","0","0","0","0","0","-2"
"224961","Galveston College","2018","Tenured total","18","12","6","1","1","0","1","1","0","2","1","1","3","1","2","0","0","0","11","8","3","0","0","0","0","0","0","0","0","0","-2"
"224961","Galveston College","2018","Tenured, professors","3","3","0","0","0","0","0","0","0","1","1","0","0","0","0","0","0","0","2","2","0","0","0","0","0","0","0","0","0","0","-2"
"224961","Galveston College","2018","Tenured, associate professors","6","4","2","0","0","0","0","0","0","0","0","0","2","1","1","0","0","0","4","3","1","0","0","0","0","0","0","0","0","0","-2"
"224961","Galveston College","2018","Tenured, assistant professors","4","2","2","0","0","0","1","1","0","1","0","1","0","0","0","0","0","0","2","1","1","0","0","0","0","0","0","0","0","0","-2"
"224961","Galveston College","2018","Tenured, instructors","5","3","2","1","1","0","0","0","0","0","0","0","1","0","1","0","0","0","3","2","1","0","0","0","0","0","0","0","0","0","-2"
"224961","Galveston College","2018","On-Tenure track total","41","19","22","1","0","1","3","0","3","3","3","0","5","3","2","0","0","0","29","13","16","0","0","0","0","0","0","0","0","0","-2"
"224961","Galveston College","2018","On-tenure track, associate professors","2","1","1","0","0","0","1","0","1","0","0","0","0","0","0","0","0","0","1","1","0","0","0","0","0","0","0","0","0","0","-2"
"224961","Galveston College","2018","On-tenure track, assistant professors","3","1","2","0","0","0","0","0","0","0","0","0","0","0","0","0","0","0","3","1","2","0","0","0","0","0","0","0","0","0","-2"
"224961","Galveston College","2018","On-tenure track, instructors","36","17","19","1","0","1","2","0","2","3","3","0","5","3","2","0","0","0","25","11","14","0","0","0","0","0","0","0","0","0","-2"
"225201","Hallmark University","2018","Not on tenure track/No tenure system system total","36","22","14","1","0","1","2","1","1","4","3","1","9","8","1","0","0","0","16","9","7","2","1","1","1","0","1","1","0","1","-2"
"225201","Hallmark University","2018","Not on tenure/no tenure system, instructors","36","22","14","1","0","1","2","1","1","4","3","1","9","8","1","0","0","0","16","9","7","2","1","1","1","0","1","1","0","1","-2"
"225399","Houston Baptist University","2018","Not on tenure track/No tenure system system total","154","87","67","1","1","0","4","3","1","12","2","10","10","8","2","0","0","0","116","67","49","3","2","1","4","1","3","4","3","1","-2"
"225399","Houston Baptist University","2018","Not on tenure/no tenure system, professors","34","21","13","0","0","0","0","0","0","3","0","3","0","0","0","0","0","0","29","20","9","1","1","0","1","0","1","0","0","0","-2"
"225399","Houston Baptist University","2018","Not on tenure/no tenure system, associate professors","43","29","14","0","0","0","2","2","0","2","2","0","7","6","1","0","0","0","30","19","11","1","0","1","1","0","1","0","0","0","-2"
"225399","Houston Baptist University","2018","Not on tenure/no tenure system, assistant professors","75","36","39","1","1","0","1","1","0","7","0","7","3","2","1","0","0","0","56","27","29","1","1","0","2","1","1","4","3","1","-2"
"225399","Houston Baptist University","2018","Not on tenure/no tenure system, instructors","2","1","1","0","0","0","1","0","1","0","0","0","0","0","0","0","0","0","1","1","0","0","0","0","0","0","0","0","0","0","-2"
"225414","University of Houston-Clear Lake","2018","Tenured total","149","89","60","0","0","0","22","15","7","7","4","3","7","1","6","0","0","0","111","67","44","2","2","0","0","0","0","0","0","0","-2"
"225414","University of Houston-Clear Lake","2018","Tenured, professors","54","33","21","0","0","0","11","7","4","3","2","1","2","0","2","0","0","0","38","24","14","0","0","0","0","0","0","0","0","0","-2"
"225414","University of Houston-Clear Lake","2018","Tenured, associate professors","95","56","39","0","0","0","11","8","3","4","2","2","5","1","4","0","0","0","73","43","30","2","2","0","0","0","0","0","0","0","-2"
"225414","University of Houston-Clear Lake","2018","On-Tenure track total","92","45","47","0","0","0","17","9","8","5","2","3","7","2","5","1","0","1","45","22","23","2","0","2","1","0","1","14","10","4","-2"
"225414","University of Houston-Clear Lake","2018","On-tenure track, associate professors","4","1","3","0","0","0","1","0","1","0","0","0","0","0","0","0","0","0","3","1","2","0","0","0","0","0","0","0","0","0","-2"
"225414","University of Houston-Clear Lake","2018","On-tenure track, assistant professors","88","44","44","0","0","0","16","9","7","5","2","3","7","2","5","1","0","1","42","21","21","2","0","2","1","0","1","14","10","4","-2"
"225414","University of Houston-Clear Lake","2018","Not on tenure track/No tenure system system total","45","16","29","0","0","0","5","2","3","3","0","3","5","0","5","0","0","0","29","13","16","1","0","1","0","0","0","2","1","1","-2"
"225414","University of Houston-Clear Lake","2018","Not on tenure/no tenure system, lecturers","31","11","20","0","0","0","2","0","2","2","0","2","3","0","3","0","0","0","22","10","12","1","0","1","0","0","0","1","1","0","-2"
"225414","University of Houston-Clear Lake","2018","Not on tenure/no tenure system, no academic rank","14","5","9","0","0","0","3","2","1","1","0","1","2","0","2","0","0","0","7","3","4","0","0","0","0","0","0","1","0","1","-2"
"225432","University of Houston-Downtown","2018","Tenured total","164","94","70","1","0","1","31","21","10","13","5","8","12","7","5","0","0","0","104","58","46","2","2","0","0","0","0","1","1","0","-2"
"225432","University of Houston-Downtown","2018","Tenured, professors","55","35","20","0","0","0","14","11","3","5","2","3","4","4","0","0","0","0","31","17","14","1","1","0","0","0","0","0","0","0","-2"
"225432","University of Houston-Downtown","2018","Tenured, associate professors","109","59","50","1","0","1","17","10","7","8","3","5","8","3","5","0","0","0","73","41","32","1","1","0","0","0","0","1","1","0","-2"
"225432","University of Houston-Downtown","2018","On-Tenure track total","79","40","39","0","0","0","12","9","3","14","6","8","13","5","8","0","0","0","31","15","16","0","0","0","1","1","0","8","4","4","-2"
"225432","University of Houston-Downtown","2018","On-tenure track, associate professors","4","3","1","0","0","0","2","2","0","0","0","0","1","0","1","0","0","0","1","1","0","0","0","0","0","0","0","0","0","0","-2"
"225432","University of Houston-Downtown","2018","On-tenure track, assistant professors","74","36","38","0","0","0","10","7","3","14","6","8","12","5","7","0","0","0","30","14","16","0","0","0","0","0","0","8","4","4","-2"
"225432","University of Houston-Downtown","2018","On-tenure track, instructors","1","1","0","0","0","0","0","0","0","0","0","0","0","0","0","0","0","0","0","0","0","0","0","0","1","1","0","0","0","0","-2"
"225432","University of Houston-Downtown","2018","Not on tenure track/No tenure system system total","119","58","61","0","0","0","23","11","12","12","4","8","12","8","4","1","0","1","63","29","34","4","3","1","0","0","0","4","3","1","-2"
"225432","University of Houston-Downtown","2018","Not on tenure/no tenure system, lecturers","106","49","57","0","0","0","20","9","11","10","4","6","10","6","4","1","0","1","57","24","33","4","3","1","0","0","0","4","3","1","-2"
"225432","University of Houston-Downtown","2018","Not on tenure/no tenure system, no academic rank","13","9","4","0","0","0","3","2","1","2","0","2","2","2","0","0","0","0","6","5","1","0","0","0","0","0","0","0","0","0","-2"
"225502","University of Houston-Victoria","2018","Tenured total","63","38","25","0","0","0","18","13","5","1","1","0","8","3","5","1","1","0","33","19","14","0","0","0","0","0","0","2","1","1","-2"
"225502","University of Houston-Victoria","2018","Tenured, professors","28","18","10","0","0","0","7","4","3","0","0","0","3","2","1","1","1","0","17","11","6","0","0","0","0","0","0","0","0","0","-2"
"225502","University of Houston-Victoria","2018","Tenured, associate professors","35","20","15","0","0","0","11","9","2","1","1","0","5","1","4","0","0","0","16","8","8","0","0","0","0","0","0","2","1","1","-2"
"225502","University of Houston-Victoria","2018","On-Tenure track total","42","19","23","0","0","0","5","3","2","5","2","3","1","1","0","0","0","0","21","10","11","2","0","2","1","0","1","7","3","4","-2"
"225502","University of Houston-Victoria","2018","On-tenure track, associate professors","3","1","2","0","0","0","0","0","0","0","0","0","0","0","0","0","0","0","2","1","1","0","0","0","0","0","0","1","0","1","-2"
"225502","University of Houston-Victoria","2018","On-tenure track, assistant professors","39","18","21","0","0","0","5","3","2","5","2","3","1","1","0","0","0","0","19","9","10","2","0","2","1","0","1","6","3","3","-2"
"225502","University of Houston-Victoria","2018","Not on tenure track/No tenure system system total","12","4","8","0","0","0","1","0","1","0","0","0","1","0","1","0","0","0","7","4","3","0","0","0","0","0","0","3","0","3","-2"
"225502","University of Houston-Victoria","2018","Not on tenure/no tenure system, lecturers","10","4","6","0","0","0","1","0","1","0","0","0","1","0","1","0","0","0","6","4","2","0","0","0","0","0","0","2","0","2","-2"
"225502","University of Houston-Victoria","2018","Not on tenure/no tenure system, no academic rank","2","0","2","0","0","0","0","0","0","0","0","0","0","0","0","0","0","0","1","0","1","0","0","0","0","0","0","1","0","1","-2"
"225548","Howard Payne University","2018","Tenured total","2","1","1","0","0","0","0","0","0","0","0","0","0","0","0","0","0","0","2","1","1","0","0","0","0","0","0","0","0","0","-2"
"225548","Howard Payne University","2018","Tenured, professors","2","1","1","0","0","0","0","0","0","0","0","0","0","0","0","0","0","0","2","1","1","0","0","0","0","0","0","0","0","0","-2"
"225548","Howard Payne University","2018","Not on tenure track/No tenure system system total","77","49","28","0","0","0","1","1","0","2","1","1","3","3","0","0","0","0","71","44","27","0","0","0","0","0","0","0","0","0","-2"
"225548","Howard Payne University","2018","Not on tenure/no tenure system, professors","22","15","7","0","0","0","0","0","0","0","0","0","1","1","0","0","0","0","21","14","7","0","0","0","0","0","0","0","0","0","-2"
"225548","Howard Payne University","2018","Not on tenure/no tenure system, associate professors","24","18","6","0","0","0","0","0","0","2","1","1","2","2","0","0","0","0","20","15","5","0","0","0","0","0","0","0","0","0","-2"
"225548","Howard Payne University","2018","Not on tenure/no tenure system, assistant professors","16","8","8","0","0","0","1","1","0","0","0","0","0","0","0","0","0","0","15","7","8","0","0","0","0","0","0","0","0","0","-2"
"225548","Howard Payne University","2018","Not on tenure/no tenure system, instructors","15","8","7","0","0","0","0","0","0","0","0","0","0","0","0","0","0","0","15","8","7","0","0","0","0","0","0","0","0","0","-2"
"225575","Huston-Tillotson University","2018","Tenured total","10","4","6","0","0","0","0","0","0","5","1","4","0","0","0","0","0","0","5","3","2","0","0","0","0","0","0","0","0","0","-2"
"225575","Huston-Tillotson University","2018","Tenured, professors","9","3","6","0","0","0","0","0","0","5","1","4","0","0","0","0","0","0","4","2","2","0","0","0","0","0","0","0","0","0","-2"
"225575","Huston-Tillotson University","2018","Tenured, assistant professors","1","1","0","0","0","0","0","0","0","0","0","0","0","0","0","0","0","0","1","1","0","0","0","0","0","0","0","0","0","0","-2"
"225575","Huston-Tillotson University","2018","On-Tenure track total","21","12","9","0","0","0","1","1","0","7","2","5","4","4","0","0","0","0","5","3","2","0","0","0","0","0","0","4","2","2","-2"
"225575","Huston-Tillotson University","2018","On-tenure track, professors","1","1","0","0","0","0","0","0","0","0","0","0","0","0","0","0","0","0","1","1","0","0","0","0","0","0","0","0","0","0","-2"
"225575","Huston-Tillotson University","2018","On-tenure track, associate professors","3","1","2","0","0","0","0","0","0","2","1","1","0","0","0","0","0","0","1","0","1","0","0","0","0","0","0","0","0","0","-2"
"225575","Huston-Tillotson University","2018","On-tenure track, assistant professors","17","10","7","0","0","0","1","1","0","5","1","4","4","4","0","0","0","0","3","2","1","0","0","0","0","0","0","4","2","2","-2"
"225575","Huston-Tillotson University","2018","Not on tenure track/No tenure system system total","10","4","6","0","0","0","1","0","1","4","1","3","2","2","0","0","0","0","3","1","2","0","0","0","0","0","0","0","0","0","-2"
"225575","Huston-Tillotson University","2018","Not on tenure/no tenure system, associate professors","2","1","1","0","0","0","0","0","0","0","0","0","1","1","0","0","0","0","1","0","1","0","0","0","0","0","0","0","0","0","-2"
"225575","Huston-Tillotson University","2018","Not on tenure/no tenure system, assistant professors","3","0","3","0","0","0","1","0","1","1","0","1","0","0","0","0","0","0","1","0","1","0","0","0","0","0","0","0","0","0","-2"
"225575","Huston-Tillotson University","2018","Not on tenure/no tenure system, instructors","4","3","1","0","0","0","0","0","0","2","1","1","1","1","0","0","0","0","1","1","0","0","0","0","0","0","0","0","0","0","-2"
"225575","Huston-Tillotson University","2018","Not on tenure/no tenure system, lecturers","1","0","1","0","0","0","0","0","0","1","0","1","0","0","0","0","0","0","0","0","0","0","0","0","0","0","0","0","0","0","-2"
"226134","Laredo College","2018","Tenured total","133","76","57","1","0","1","4","3","1","1","0","1","104","59","45","0","0","0","22","13","9","0","0","0","1","1","0","0","0","0","-2"
"226134","Laredo College","2018","Tenured, instructors","133","76","57","1","0","1","4","3","1","1","0","1","104","59","45","0","0","0","22","13","9","0","0","0","1","1","0","0","0","0","-2"
"226134","Laredo College","2018","On-Tenure track total","42","20","22","0","0","0","4","2","2","1","1","0","36","16","20","0","0","0","1","1","0","0","0","0","0","0","0","0","0","0","-2"
"226134","Laredo College","2018","On-tenure track, instructors","42","20","22","0","0","0","4","2","2","1","1","0","36","16","20","0","0","0","1","1","0","0","0","0","0","0","0","0","0","0","-2"
"226134","Laredo College","2018","Not on tenure track/No tenure system system total","13","7","6","0","0","0","0","0","0","0","0","0","13","7","6","0","0","0","0","0","0","0","0","0","0","0","0","0","0","0","-2"
"226134","Laredo College","2018","Not on tenure/no tenure system, instructors","13","7","6","0","0","0","0","0","0","0","0","0","13","7","6","0","0","0","0","0","0","0","0","0","0","0","0","0","0","0","-2"
"226152","Texas A & M International University","2018","Tenured total","63","43","20","0","0","0","15","10","5","1","1","0","21","15","6","0","0","0","26","17","9","0","0","0","0","0","0","0","0","0","-2"
"226152","Texas A & M International University","2018","Tenured, professors","24","20","4","0","0","0","7","6","1","1","1","0","9","9","0","0","0","0","7","4","3","0","0","0","0","0","0","0","0","0","-2"
"226152","Texas A & M International University","2018","Tenured, associate professors","38","22","16","0","0","0","8","4","4","0","0","0","12","6","6","0","0","0","18","12","6","0","0","0","0","0","0","0","0","0","-2"
"226152","Texas A & M International University","2018","Tenured, assistant professors","1","1","0","0","0","0","0","0","0","0","0","0","0","0","0","0","0","0","1","1","0","0","0","0","0","0","0","0","0","0","-2"
"226152","Texas A & M International University","2018","On-Tenure track total","54","30","24","0","0","0","11","5","6","1","1","0","10","5","5","0","0","0","20","12","8","0","0","0","0","0","0","12","7","5","-2"
"226152","Texas A & M International University","2018","On-tenure track, associate professors","5","3","2","0","0","0","2","0","2","1","1","0","0","0","0","0","0","0","1","1","0","0","0","0","0","0","0","1","1","0","-2"
"226152","Texas A & M International University","2018","On-tenure track, assistant professors","49","27","22","0","0","0","9","5","4","0","0","0","10","5","5","0","0","0","19","11","8","0","0","0","0","0","0","11","6","5","-2"
"226152","Texas A & M International University","2018","Not on tenure track/No tenure system system total","96","36","60","0","0","0","3","0","3","4","3","1","51","19","32","0","0","0","31","11","20","0","0","0","1","1","0","6","2","4","-2"
"226152","Texas A & M International University","2018","Not on tenure/no tenure system, professors","2","1","1","0","0","0","0","0","0","0","0","0","0","0","0","0","0","0","1","0","1","0","0","0","0","0","0","1","1","0","-2"
"226152","Texas A & M International University","2018","Not on tenure/no tenure system, associate professors","7","4","3","0","0","0","1","0","1","1","1","0","1","1","0","0","0","0","4","2","2","0","0","0","0","0","0","0","0","0","-2"
"226152","Texas A & M International University","2018","Not on tenure/no tenure system, assistant professors","57","17","40","0","0","0","2","0","2","2","2","0","30","8","22","0","0","0","18","6","12","0","0","0","1","1","0","4","0","4","-2"
"226152","Texas A & M International University","2018","Not on tenure/no tenure system, instructors","23","11","12","0","0","0","0","0","0","0","0","0","16","8","8","0","0","0","6","2","4","0","0","0","0","0","0","1","1","0","-2"
"226152","Texas A & M International University","2018","Not on tenure/no tenure system, lecturers","7","3","4","0","0","0","0","0","0","1","0","1","4","2","2","0","0","0","2","1","1","0","0","0","0","0","0","0","0","0","-2"
"226587","McMurry University","2018","Tenured total","44","30","14","1","1","0","1","0","1","0","0","0","4","1","3","0","0","0","38","28","10","0","0","0","0","0","0","0","0","0","-2"
"226587","McMurry University","2018","Tenured, professors","28","20","8","1","1","0","1","0","1","0","0","0","0","0","0","0","0","0","26","19","7","0","0","0","0","0","0","0","0","0","-2"
"226587","McMurry University","2018","Tenured, associate professors","16","10","6","0","0","0","0","0","0","0","0","0","4","1","3","0","0","0","12","9","3","0","0","0","0","0","0","0","0","0","-2"
"226587","McMurry University","2018","On-Tenure track total","10","6","4","0","0","0","0","0","0","0","0","0","0","0","0","0","0","0","9","6","3","0","0","0","0","0","0","1","0","1","-2"
"226587","McMurry University","2018","On-tenure track, assistant professors","10","6","4","0","0","0","0","0","0","0","0","0","0","0","0","0","0","0","9","6","3","0","0","0","0","0","0","1","0","1","-2"
"226587","McMurry University","2018","Not on tenure track/No tenure system system total","25","10","15","0","0","0","0","0","0","0","0","0","1","1","0","0","0","0","22","9","13","0","0","0","0","0","0","2","0","2","-2"
"226587","McMurry University","2018","Not on tenure/no tenure system, associate professors","1","1","0","0","0","0","0","0","0","0","0","0","0","0","0","0","0","0","1","1","0","0","0","0","0","0","0","0","0","0","-2"
"226587","McMurry University","2018","Not on tenure/no tenure system, assistant professors","7","4","3","0","0","0","0","0","0","0","0","0","1","1","0","0","0","0","5","3","2","0","0","0","0","0","0","1","0","1","-2"
"226587","McMurry University","2018","Not on tenure/no tenure system, instructors","17","5","12","0","0","0","0","0","0","0","0","0","0","0","0","0","0","0","16","5","11","0","0","0","0","0","0","1","0","1","-2"
"226806","Midland College","2018","Not on tenure track/No tenure system system total","139","63","76","0","0","0","1","1","0","3","0","3","13","7","6","0","0","0","120","54","66","0","0","0","2","1","1","0","0","0","-2"
"226806","Midland College","2018","Not on tenure/no tenure system, professors","43","18","25","0","0","0","1","1","0","0","0","0","6","2","4","0","0","0","35","15","20","0","0","0","1","0","1","0","0","0","-2"
"226806","Midland College","2018","Not on tenure/no tenure system, associate professors","52","25","27","0","0","0","0","0","0","1","0","1","6","4","2","0","0","0","45","21","24","0","0","0","0","0","0","0","0","0","-2"
"226806","Midland College","2018","Not on tenure/no tenure system, assistant professors","16","9","7","0","0","0","0","0","0","0","0","0","1","1","0","0","0","0","14","7","7","0","0","0","1","1","0","0","0","0","-2"
"226806","Midland College","2018","Not on tenure/no tenure system, instructors","28","11","17","0","0","0","0","0","0","2","0","2","0","0","0","0","0","0","26","11","15","0","0","0","0","0","0","0","0","0","-2"
"227216","University of North Texas","2018","Tenured total","602","396","206","1","1","0","105","73","32","22","11","11","39","22","17","0","0","0","398","263","135","6","5","1","18","15","3","13","6","7","-2"
"227216","University of North Texas","2018","Tenured, professors","333","238","95","1","1","0","43","35","8","10","6","4","17","11","6","0","0","0","244","170","74","3","2","1","10","9","1","5","4","1","-2"
"227216","University of North Texas","2018","Tenured, associate professors","268","157","111","0","0","0","62","38","24","12","5","7","22","11","11","0","0","0","153","92","61","3","3","0","8","6","2","8","2","6","-2"
"227216","University of North Texas","2018","Tenured, assistant professors","1","1","0","0","0","0","0","0","0","0","0","0","0","0","0","0","0","0","1","1","0","0","0","0","0","0","0","0","0","0","-2"
"227216","University of North Texas","2018","On-Tenure track total","166","83","83","0","0","0","32","15","17","11","3","8","13","8","5","0","0","0","95","52","43","3","1","2","9","2","7","3","2","1","-2"
"227216","University of North Texas","2018","On-tenure track, associate professors","7","3","4","0","0","0","0","0","0","0","0","0","0","0","0","0","0","0","7","3","4","0","0","0","0","0","0","0","0","0","-2"
"227216","University of North Texas","2018","On-tenure track, assistant professors","159","80","79","0","0","0","32","15","17","11","3","8","13","8","5","0","0","0","88","49","39","3","1","2","9","2","7","3","2","1","-2"
"227216","University of North Texas","2018","Not on tenure track/No tenure system system total","387","158","229","0","0","0","31","10","21","23","8","15","29","10","19","1","0","1","277","122","155","11","3","8","7","0","7","8","5","3","-2"
"227216","University of North Texas","2018","Not on tenure/no tenure system, professors","1","1","0","0","0","0","0","0","0","0","0","0","0","0","0","0","0","0","1","1","0","0","0","0","0","0","0","0","0","0","-2"
"227216","University of North Texas","2018","Not on tenure/no tenure system, assistant professors","1","0","1","0","0","0","0","0","0","0","0","0","0","0","0","0","0","0","1","0","1","0","0","0","0","0","0","0","0","0","-2"
"227216","University of North Texas","2018","Not on tenure/no tenure system, instructors","74","33","41","0","0","0","5","1","4","3","2","1","9","4","5","0","0","0","50","22","28","2","1","1","1","0","1","4","3","1","-2"
"227216","University of North Texas","2018","Not on tenure/no tenure system, lecturers","292","118","174","0","0","0","25","9","16","20","6","14","20","6","14","1","0","1","209","93","116","9","2","7","4","0","4","4","2","2","-2"
"227216","University of North Texas","2018","Not on tenure/no tenure system, no academic rank","19","6","13","0","0","0","1","0","1","0","0","0","0","0","0","0","0","0","16","6","10","0","0","0","2","0","2","0","0","0","-2"
"227331","Our Lady of the Lake University","2018","Tenured total","38","13","25","0","0","0","1","1","0","2","1","1","11","3","8","0","0","0","24","8","16","0","0","0","0","0","0","0","0","0","-2"
"227331","Our Lady of the Lake University","2018","Tenured, professors","23","8","15","0","0","0","1","1","0","1","0","1","5","1","4","0","0","0","16","6","10","0","0","0","0","0","0","0","0","0","-2"
"227331","Our Lady of the Lake University","2018","Tenured, associate professors","15","5","10","0","0","0","0","0","0","1","1","0","6","2","4","0","0","0","8","2","6","0","0","0","0","0","0","0","0","0","-2"
"227331","Our Lady of the Lake University","2018","On-Tenure track total","29","8","21","0","0","0","2","0","2","3","1","2","9","4","5","0","0","0","13","1","12","0","0","0","0","0","0","2","2","0","-2"
"227331","Our Lady of the Lake University","2018","On-tenure track, associate professors","1","0","1","0","0","0","0","0","0","0","0","0","0","0","0","0","0","0","1","0","1","0","0","0","0","0","0","0","0","0","-2"
"227331","Our Lady of the Lake University","2018","On-tenure track, assistant professors","27","8","19","0","0","0","2","0","2","3","1","2","9","4","5","0","0","0","11","1","10","0","0","0","0","0","0","2","2","0","-2"
"227331","Our Lady of the Lake University","2018","On-tenure track, instructors","1","0","1","0","0","0","0","0","0","0","0","0","0","0","0","0","0","0","1","0","1","0","0","0","0","0","0","0","0","0","-2"
"227331","Our Lady of the Lake University","2018","Not on tenure track/No tenure system system total","35","13","22","0","0","0","0","0","0","1","1","0","12","2","10","0","0","0","21","9","12","0","0","0","0","0","0","1","1","0","-2"
"227331","Our Lady of the Lake University","2018","Not on tenure/no tenure system, professors","2","0","2","0","0","0","0","0","0","0","0","0","1","0","1","0","0","0","1","0","1","0","0","0","0","0","0","0","0","0","-2"
"227331","Our Lady of the Lake University","2018","Not on tenure/no tenure system, associate professors","10","4","6","0","0","0","0","0","0","0","0","0","5","1","4","0","0","0","5","3","2","0","0","0","0","0","0","0","0","0","-2"
"227331","Our Lady of the Lake University","2018","Not on tenure/no tenure system, assistant professors","21","7","14","0","0","0","0","0","0","1","1","0","6","1","5","0","0","0","13","4","9","0","0","0","0","0","0","1","1","0","-2"
"227331","Our Lady of the Lake University","2018","Not on tenure/no tenure system, instructors","2","2","0","0","0","0","0","0","0","0","0","0","0","0","0","0","0","0","2","2","0","0","0","0","0","0","0","0","0","0","-2"
"227368","The University of Texas Rio Grande Valley","2018","Tenured total","439","302","137","1","0","1","83","60","23","14","12","2","104","51","53","0","0","0","209","157","52","1","1","0","23","17","6","4","4","0","-2"
"227368","The University of Texas Rio Grande Valley","2018","Tenured, professors","227","169","58","1","0","1","45","36","9","4","4","0","48","28","20","0","0","0","112","87","25","0","0","0","16","13","3","1","1","0","-2"
"227368","The University of Texas Rio Grande Valley","2018","Tenured, associate professors","212","133","79","0","0","0","38","24","14","10","8","2","56","23","33","0","0","0","97","70","27","1","1","0","7","4","3","3","3","0","-2"
"227368","The University of Texas Rio Grande Valley","2018","On-Tenure track total","247","144","103","1","1","0","39","28","11","8","5","3","69","37","32","0","0","0","85","45","40","0","0","0","5","4","1","40","24","16","-2"
"227368","The University of Texas Rio Grande Valley","2018","On-tenure track, professors","3","2","1","0","0","0","1","1","0","0","0","0","2","1","1","0","0","0","0","0","0","0","0","0","0","0","0","0","0","0","-2"
"227368","The University of Texas Rio Grande Valley","2018","On-tenure track, associate professors","22","13","9","0","0","0","5","4","1","0","0","0","6","3","3","0","0","0","9","4","5","0","0","0","2","2","0","0","0","0","-2"
"227368","The University of Texas Rio Grande Valley","2018","On-tenure track, assistant professors","222","129","93","1","1","0","33","23","10","8","5","3","61","33","28","0","0","0","76","41","35","0","0","0","3","2","1","40","24","16","-2"
"227368","The University of Texas Rio Grande Valley","2018","Not on tenure track/No tenure system system total","542","262","280","1","0","1","56","26","30","10","4","6","269","124","145","0","0","0","152","75","77","2","0","2","20","11","9","32","22","10","-2"
"227368","The University of Texas Rio Grande Valley","2018","Not on tenure/no tenure system, professors","11","6","5","0","0","0","0","0","0","0","0","0","2","1","1","0","0","0","6","3","3","0","0","0","3","2","1","0","0","0","-2"
"227368","The University of Texas Rio Grande Valley","2018","Not on tenure/no tenure system, associate professors","17","10","7","0","0","0","3","1","2","0","0","0","3","2","1","0","0","0","5","3","2","0","0","0","5","3","2","1","1","0","-2"
"227368","The University of Texas Rio Grande Valley","2018","Not on tenure/no tenure system, assistant professors","50","29","21","0","0","0","5","5","0","2","1","1","19","10","9","0","0","0","11","5","6","1","0","1","6","4","2","6","4","2","-2"
"227368","The University of Texas Rio Grande Valley","2018","Not on tenure/no tenure system, instructors","2","0","2","0","0","0","1","0","1","0","0","0","1","0","1","0","0","0","0","0","0","0","0","0","0","0","0","0","0","0","-2"
"227368","The University of Texas Rio Grande Valley","2018","Not on tenure/no tenure system, lecturers","459","216","243","1","0","1","45","19","26","8","3","5","244","111","133","0","0","0","129","64","65","1","0","1","6","2","4","25","17","8","-2"
"227368","The University of Texas Rio Grande Valley","2018","Not on tenure/no tenure system, no academic rank","3","1","2","0","0","0","2","1","1","0","0","0","0","0","0","0","0","0","1","0","1","0","0","0","0","0","0","0","0","0","-2"
"227845","Saint Edward's University","2018","Tenured total","85","37","48","0","0","0","2","1","1","2","0","2","10","2","8","0","0","0","69","33","36","2","1","1","0","0","0","0","0","0","-2"
"227845","Saint Edward's University","2018","Tenured, professors","39","17","22","0","0","0","1","1","0","1","0","1","4","0","4","0","0","0","32","15","17","1","1","0","0","0","0","0","0","0","-2"
"227845","Saint Edward's University","2018","Tenured, associate professors","46","20","26","0","0","0","1","0","1","1","0","1","6","2","4","0","0","0","37","18","19","1","0","1","0","0","0","0","0","0","-2"
"227845","Saint Edward's University","2018","On-Tenure track total","69","34","35","0","0","0","5","4","1","3","1","2","6","2","4","0","0","0","54","27","27","0","0","0","0","0","0","1","0","1","-2"
"227845","Saint Edward's University","2018","On-tenure track, professors","1","0","1","0","0","0","0","0","0","0","0","0","0","0","0","0","0","0","1","0","1","0","0","0","0","0","0","0","0","0","-2"
"227845","Saint Edward's University","2018","On-tenure track, associate professors","21","9","12","0","0","0","2","1","1","0","0","0","1","0","1","0","0","0","18","8","10","0","0","0","0","0","0","0","0","0","-2"
"227845","Saint Edward's University","2018","On-tenure track, assistant professors","47","25","22","0","0","0","3","3","0","3","1","2","5","2","3","0","0","0","35","19","16","0","0","0","0","0","0","1","0","1","-2"
"227845","Saint Edward's University","2018","Not on tenure track/No tenure system system total","29","15","14","0","0","0","1","0","1","1","1","0","2","2","0","0","0","0","24","11","13","0","0","0","0","0","0","1","1","0","-2"
"227845","Saint Edward's University","2018","Not on tenure/no tenure system, assistant professors","20","11","9","0","0","0","0","0","0","1","1","0","1","1","0","0","0","0","17","8","9","0","0","0","0","0","0","1","1","0","-2"
"227845","Saint Edward's University","2018","Not on tenure/no tenure system, instructors","9","4","5","0","0","0","1","0","1","0","0","0","1","1","0","0","0","0","7","3","4","0","0","0","0","0","0","0","0","0","-2"
"227863","University of St Thomas","2018","Tenured total","81","50","31","0","0","0","6","4","2","2","2","0","11","5","6","0","0","0","55","36","19","3","3","0","1","0","1","3","0","3","-2"
"227863","University of St Thomas","2018","Tenured, professors","32","20","12","0","0","0","3","1","2","0","0","0","2","1","1","0","0","0","27","18","9","0","0","0","0","0","0","0","0","0","-2"
"227863","University of St Thomas","2018","Tenured, associate professors","45","28","17","0","0","0","3","3","0","2","2","0","7","3","4","0","0","0","26","17","9","3","3","0","1","0","1","3","0","3","-2"
"227863","University of St Thomas","2018","Tenured, assistant professors","4","2","2","0","0","0","0","0","0","0","0","0","2","1","1","0","0","0","2","1","1","0","0","0","0","0","0","0","0","0","-2"
"227863","University of St Thomas","2018","On-Tenure track total","22","11","11","0","0","0","4","1","3","2","1","1","2","2","0","0","0","0","7","4","3","0","0","0","2","1","1","5","2","3","-2"
"227863","University of St Thomas","2018","On-tenure track, associate professors","2","2","0","0","0","0","0","0","0","0","0","0","0","0","0","0","0","0","2","2","0","0","0","0","0","0","0","0","0","0","-2"
"227863","University of St Thomas","2018","On-tenure track, assistant professors","20","9","11","0","0","0","4","1","3","2","1","1","2","2","0","0","0","0","5","2","3","0","0","0","2","1","1","5","2","3","-2"
"227863","University of St Thomas","2018","Not on tenure track/No tenure system system total","53","23","30","0","0","0","2","0","2","8","2","6","4","2","2","0","0","0","36","17","19","0","0","0","1","1","0","2","1","1","-2"
"227863","University of St Thomas","2018","Not on tenure/no tenure system, professors","7","2","5","0","0","0","0","0","0","2","0","2","1","1","0","0","0","0","4","1","3","0","0","0","0","0","0","0","0","0","-2"
"227863","University of St Thomas","2018","Not on tenure/no tenure system, associate professors","1","0","1","0","0","0","0","0","0","0","0","0","0","0","0","0","0","0","1","0","1","0","0","0","0","0","0","0","0","0","-2"
"227863","University of St Thomas","2018","Not on tenure/no tenure system, assistant professors","17","9","8","0","0","0","1","0","1","1","0","1","1","0","1","0","0","0","13","8","5","0","0","0","1","1","0","0","0","0","-2"
"227863","University of St Thomas","2018","Not on tenure/no tenure system, instructors","25","11","14","0","0","0","1","0","1","5","2","3","2","1","1","0","0","0","15","7","8","0","0","0","0","0","0","2","1","1","-2"
"227863","University of St Thomas","2018","Not on tenure/no tenure system, no academic rank","3","1","2","0","0","0","0","0","0","0","0","0","0","0","0","0","0","0","3","1","2","0","0","0","0","0","0","0","0","0","-2"
"228042","Schreiner University","2018","Tenured total","23","13","10","0","0","0","0","0","0","0","0","0","0","0","0","0","0","0","23","13","10","0","0","0","0","0","0","0","0","0","-2"
"228042","Schreiner University","2018","Tenured, professors","15","9","6","0","0","0","0","0","0","0","0","0","0","0","0","0","0","0","15","9","6","0","0","0","0","0","0","0","0","0","-2"
"228042","Schreiner University","2018","Tenured, associate professors","8","4","4","0","0","0","0","0","0","0","0","0","0","0","0","0","0","0","8","4","4","0","0","0","0","0","0","0","0","0","-2"
"228042","Schreiner University","2018","On-Tenure track total","29","19","10","0","0","0","0","0","0","0","0","0","4","4","0","0","0","0","25","15","10","0","0","0","0","0","0","0","0","0","-2"
"228042","Schreiner University","2018","On-tenure track, professors","2","1","1","0","0","0","0","0","0","0","0","0","0","0","0","0","0","0","2","1","1","0","0","0","0","0","0","0","0","0","-2"
"228042","Schreiner University","2018","On-tenure track, associate professors","1","0","1","0","0","0","0","0","0","0","0","0","0","0","0","0","0","0","1","0","1","0","0","0","0","0","0","0","0","0","-2"
"228042","Schreiner University","2018","On-tenure track, assistant professors","26","18","8","0","0","0","0","0","0","0","0","0","4","4","0","0","0","0","22","14","8","0","0","0","0","0","0","0","0","0","-2"
"228042","Schreiner University","2018","Not on tenure track/No tenure system system total","28","8","20","0","0","0","1","0","1","0","0","0","5","3","2","0","0","0","22","5","17","0","0","0","0","0","0","0","0","0","-2"
"228042","Schreiner University","2018","Not on tenure/no tenure system, professors","1","1","0","0","0","0","0","0","0","0","0","0","0","0","0","0","0","0","1","1","0","0","0","0","0","0","0","0","0","0","-2"
"228042","Schreiner University","2018","Not on tenure/no tenure system, assistant professors","10","4","6","0","0","0","0","0","0","0","0","0","2","2","0","0","0","0","8","2","6","0","0","0","0","0","0","0","0","0","-2"
"228042","Schreiner University","2018","Not on tenure/no tenure system, instructors","15","3","12","0","0","0","1","0","1","0","0","0","3","1","2","0","0","0","11","2","9","0","0","0","0","0","0","0","0","0","-2"
"228042","Schreiner University","2018","Not on tenure/no tenure system, no academic rank","2","0","2","0","0","0","0","0","0","0","0","0","0","0","0","0","0","0","2","0","2","0","0","0","0","0","0","0","0","0","-2"
"228149","St. Mary's University","2018","Tenured total","141","94","47","1","1","0","8","8","0","4","3","1","18","12","6","1","1","0","101","61","40","0","0","0","0","0","0","8","8","0","-2"
"228149","St. Mary's University","2018","Tenured, professors","82","56","26","0","0","0","7","7","0","3","3","0","6","3","3","1","1","0","63","40","23","0","0","0","0","0","0","2","2","0","-2"
"228149","St. Mary's University","2018","Tenured, associate professors","57","36","21","1","1","0","1","1","0","1","0","1","12","9","3","0","0","0","36","19","17","0","0","0","0","0","0","6","6","0","-2"
"228149","St. Mary's University","2018","Tenured, assistant professors","2","2","0","0","0","0","0","0","0","0","0","0","0","0","0","0","0","0","2","2","0","0","0","0","0","0","0","0","0","0","-2"
"228149","St. Mary's University","2018","On-Tenure track total","30","15","15","1","1","0","4","2","2","0","0","0","2","2","0","0","0","0","14","4","10","0","0","0","1","1","0","8","5","3","-2"
"228149","St. Mary's University","2018","On-tenure track, associate professors","1","1","0","0","0","0","0","0","0","0","0","0","0","0","0","0","0","0","0","0","0","0","0","0","1","1","0","0","0","0","-2"
"228149","St. Mary's University","2018","On-tenure track, assistant professors","29","14","15","1","1","0","4","2","2","0","0","0","2","2","0","0","0","0","14","4","10","0","0","0","0","0","0","8","5","3","-2"
"228149","St. Mary's University","2018","Not on tenure track/No tenure system system total","52","26","26","0","0","0","0","0","0","1","1","0","12","7","5","0","0","0","37","17","20","0","0","0","1","0","1","1","1","0","-2"
"228149","St. Mary's University","2018","Not on tenure/no tenure system, professors","9","3","6","0","0","0","0","0","0","0","0","0","3","2","1","0","0","0","6","1","5","0","0","0","0","0","0","0","0","0","-2"
"228149","St. Mary's University","2018","Not on tenure/no tenure system, associate professors","2","1","1","0","0","0","0","0","0","0","0","0","0","0","0","0","0","0","2","1","1","0","0","0","0","0","0","0","0","0","-2"
"228149","St. Mary's University","2018","Not on tenure/no tenure system, assistant professors","10","7","3","0","0","0","0","0","0","0","0","0","2","2","0","0","0","0","7","5","2","0","0","0","1","0","1","0","0","0","-2"
"228149","St. Mary's University","2018","Not on tenure/no tenure system, instructors","27","15","12","0","0","0","0","0","0","1","1","0","5","3","2","0","0","0","20","10","10","0","0","0","0","0","0","1","1","0","-2"
"228149","St. Mary's University","2018","Not on tenure/no tenure system, lecturers","4","0","4","0","0","0","0","0","0","0","0","0","2","0","2","0","0","0","2","0","2","0","0","0","0","0","0","0","0","0","-2"
"228468","Southwestern Adventist University","2018","Not on tenure track/No tenure system system total","85","53","32","1","0","1","5","2","3","9","6","3","10","5","5","1","1","0","57","37","20","0","0","0","0","0","0","2","2","0","-2"
"228468","Southwestern Adventist University","2018","Not on tenure/no tenure system, professors","13","11","2","0","0","0","0","0","0","2","2","0","1","1","0","0","0","0","10","8","2","0","0","0","0","0","0","0","0","0","-2"
"228468","Southwestern Adventist University","2018","Not on tenure/no tenure system, associate professors","15","9","6","0","0","0","1","0","1","1","1","0","2","2","0","1","1","0","9","4","5","0","0","0","0","0","0","1","1","0","-2"
"228468","Southwestern Adventist University","2018","Not on tenure/no tenure system, assistant professors","20","9","11","0","0","0","0","0","0","1","0","1","4","1","3","0","0","0","14","7","7","0","0","0","0","0","0","1","1","0","-2"
"228468","Southwestern Adventist University","2018","Not on tenure/no tenure system, instructors","37","24","13","1","0","1","4","2","2","5","3","2","3","1","2","0","0","0","24","18","6","0","0","0","0","0","0","0","0","0","-2"
"228501","Sul Ross State University","2018","Tenured total","41","25","16","1","1","0","1","1","0","0","0","0","9","6","3","0","0","0","28","16","12","0","0","0","0","0","0","2","1","1","-2"
"228501","Sul Ross State University","2018","Tenured, professors","29","19","10","1","1","0","1","1","0","0","0","0","6","3","3","0","0","0","20","14","6","0","0","0","0","0","0","1","0","1","-2"
"228501","Sul Ross State University","2018","Tenured, associate professors","12","6","6","0","0","0","0","0","0","0","0","0","3","3","0","0","0","0","8","2","6","0","0","0","0","0","0","1","1","0","-2"
"228501","Sul Ross State University","2018","On-Tenure track total","39","23","16","0","0","0","1","1","0","0","0","0","11","4","7","0","0","0","22","13","9","0","0","0","0","0","0","5","5","0","-2"
"228501","Sul Ross State University","2018","On-tenure track, associate professors","4","3","1","0","0","0","0","0","0","0","0","0","1","1","0","0","0","0","3","2","1","0","0","0","0","0","0","0","0","0","-2"
"228501","Sul Ross State University","2018","On-tenure track, assistant professors","30","18","12","0","0","0","1","1","0","0","0","0","9","3","6","0","0","0","16","10","6","0","0","0","0","0","0","4","4","0","-2"
"228501","Sul Ross State University","2018","On-tenure track, instructors","4","1","3","0","0","0","0","0","0","0","0","0","1","0","1","0","0","0","3","1","2","0","0","0","0","0","0","0","0","0","-2"
"228501","Sul Ross State University","2018","On-tenure track, no academic rank","1","1","0","0","0","0","0","0","0","0","0","0","0","0","0","0","0","0","0","0","0","0","0","0","0","0","0","1","1","0","-2"
"228501","Sul Ross State University","2018","Not on tenure track/No tenure system system total","23","9","14","0","0","0","0","0","0","2","1","1","7","2","5","0","0","0","13","5","8","1","1","0","0","0","0","0","0","0","-2"
"228501","Sul Ross State University","2018","Not on tenure/no tenure system, assistant professors","3","0","3","0","0","0","0","0","0","1","0","1","1","0","1","0","0","0","1","0","1","0","0","0","0","0","0","0","0","0","-2"
"228501","Sul Ross State University","2018","Not on tenure/no tenure system, instructors","1","1","0","0","0","0","0","0","0","0","0","0","0","0","0","0","0","0","0","0","0","1","1","0","0","0","0","0","0","0","-2"
"228501","Sul Ross State University","2018","Not on tenure/no tenure system, lecturers","15","6","9","0","0","0","0","0","0","0","0","0","5","2","3","0","0","0","10","4","6","0","0","0","0","0","0","0","0","0","-2"
"228501","Sul Ross State University","2018","Not on tenure/no tenure system, no academic rank","4","2","2","0","0","0","0","0","0","1","1","0","1","0","1","0","0","0","2","1","1","0","0","0","0","0","0","0","0","0","-2"
"228644","The University of Texas Health Science Center at San Antonio","2018","Tenured total","225","159","66","0","0","0","40","28","12","4","4","0","27","15","12","0","0","0","151","110","41","0","0","0","3","2","1","0","0","0","-2"
"228644","The University of Texas Health Science Center at San Antonio","2018","Tenured, professors","160","121","39","0","0","0","26","22","4","3","3","0","19","14","5","0","0","0","111","81","30","0","0","0","1","1","0","0","0","0","-2"
"228644","The University of Texas Health Science Center at San Antonio","2018","Tenured, associate professors","64","38","26","0","0","0","14","6","8","1","1","0","8","1","7","0","0","0","39","29","10","0","0","0","2","1","1","0","0","0","-2"
"228644","The University of Texas Health Science Center at San Antonio","2018","Tenured, assistant professors","1","0","1","0","0","0","0","0","0","0","0","0","0","0","0","0","0","0","1","0","1","0","0","0","0","0","0","0","0","0","-2"
"228644","The University of Texas Health Science Center at San Antonio","2018","On-Tenure track total","66","35","31","0","0","0","25","15","10","4","2","2","7","3","4","0","0","0","28","13","15","0","0","0","2","2","0","0","0","0","-2"
"228644","The University of Texas Health Science Center at San Antonio","2018","On-tenure track, professors","1","1","0","0","0","0","0","0","0","0","0","0","0","0","0","0","0","0","1","1","0","0","0","0","0","0","0","0","0","0","-2"
"228644","The University of Texas Health Science Center at San Antonio","2018","On-tenure track, associate professors","13","7","6","0","0","0","2","2","0","0","0","0","0","0","0","0","0","0","11","5","6","0","0","0","0","0","0","0","0","0","-2"
"228644","The University of Texas Health Science Center at San Antonio","2018","On-tenure track, assistant professors","52","27","25","0","0","0","23","13","10","4","2","2","7","3","4","0","0","0","16","7","9","0","0","0","2","2","0","0","0","0","-2"
"228644","The University of Texas Health Science Center at San Antonio","2018","Not on tenure track/No tenure system system total","514","256","258","0","0","0","83","39","44","14","3","11","111","48","63","1","0","1","285","156","129","2","1","1","18","9","9","0","0","0","-2"
"228644","The University of Texas Health Science Center at San Antonio","2018","Not on tenure/no tenure system, professors","60","41","19","0","0","0","6","5","1","2","1","1","5","2","3","0","0","0","47","33","14","0","0","0","0","0","0","0","0","0","-2"
"228644","The University of Texas Health Science Center at San Antonio","2018","Not on tenure/no tenure system, associate professors","120","71","49","0","0","0","22","14","8","3","0","3","21","10","11","1","0","1","73","47","26","0","0","0","0","0","0","0","0","0","-2"
"228644","The University of Texas Health Science Center at San Antonio","2018","Not on tenure/no tenure system, assistant professors","279","122","157","0","0","0","51","19","32","7","1","6","71","31","40","0","0","0","131","61","70","2","1","1","17","9","8","0","0","0","-2"
"228644","The University of Texas Health Science Center at San Antonio","2018","Not on tenure/no tenure system, instructors","15","6","9","0","0","0","1","0","1","0","0","0","6","3","3","0","0","0","8","3","5","0","0","0","0","0","0","0","0","0","-2"
"228644","The University of Texas Health Science Center at San Antonio","2018","Not on tenure/no tenure system, lecturers","6","1","5","0","0","0","1","0","1","0","0","0","0","0","0","0","0","0","5","1","4","0","0","0","0","0","0","0","0","0","-2"
"228644","The University of Texas Health Science Center at San Antonio","2018","Not on tenure/no tenure system, no academic rank","34","15","19","0","0","0","2","1","1","2","1","1","8","2","6","0","0","0","21","11","10","0","0","0","1","0","1","0","0","0","-2"
"228705","Texas A & M University-Kingsville","2018","Tenured total","171","122","49","3","2","1","26","21","5","6","6","0","25","17","8","0","0","0","107","74","33","0","0","0","1","1","0","3","1","2","-2"
"228705","Texas A & M University-Kingsville","2018","Tenured, professors","96","73","23","1","1","0","18","15","3","4","4","0","14","10","4","0","0","0","58","43","15","0","0","0","0","0","0","1","0","1","-2"
"228705","Texas A & M University-Kingsville","2018","Tenured, associate professors","74","49","25","2","1","1","8","6","2","2","2","0","11","7","4","0","0","0","48","31","17","0","0","0","1","1","0","2","1","1","-2"
"228705","Texas A & M University-Kingsville","2018","Tenured, assistant professors","1","0","1","0","0","0","0","0","0","0","0","0","0","0","0","0","0","0","1","0","1","0","0","0","0","0","0","0","0","0","-2"
"228705","Texas A & M University-Kingsville","2018","On-Tenure track total","96","59","37","1","1","0","17","12","5","2","1","1","13","4","9","0","0","0","43","26","17","1","1","0","1","1","0","18","13","5","-2"
"228705","Texas A & M University-Kingsville","2018","On-tenure track, professors","1","1","0","0","0","0","0","0","0","0","0","0","0","0","0","0","0","0","1","1","0","0","0","0","0","0","0","0","0","0","-2"
"228705","Texas A & M University-Kingsville","2018","On-tenure track, associate professors","7","6","1","0","0","0","0","0","0","1","0","1","2","2","0","0","0","0","4","4","0","0","0","0","0","0","0","0","0","0","-2"
"228705","Texas A & M University-Kingsville","2018","On-tenure track, assistant professors","88","52","36","1","1","0","17","12","5","1","1","0","11","2","9","0","0","0","38","21","17","1","1","0","1","1","0","18","13","5","-2"
"228705","Texas A & M University-Kingsville","2018","Not on tenure track/No tenure system system total","63","35","28","1","1","0","8","6","2","1","1","0","14","8","6","0","0","0","28","11","17","1","1","0","0","0","0","10","7","3","-2"
"228705","Texas A & M University-Kingsville","2018","Not on tenure/no tenure system, professors","3","3","0","0","0","0","1","1","0","0","0","0","2","2","0","0","0","0","0","0","0","0","0","0","0","0","0","0","0","0","-2"
"228705","Texas A & M University-Kingsville","2018","Not on tenure/no tenure system, associate professors","1","1","0","0","0","0","0","0","0","0","0","0","0","0","0","0","0","0","1","1","0","0","0","0","0","0","0","0","0","0","-2"
"228705","Texas A & M University-Kingsville","2018","Not on tenure/no tenure system, assistant professors","11","8","3","0","0","0","4","3","1","0","0","0","2","1","1","0","0","0","2","2","0","0","0","0","0","0","0","3","2","1","-2"
"228705","Texas A & M University-Kingsville","2018","Not on tenure/no tenure system, instructors","2","0","2","0","0","0","0","0","0","0","0","0","0","0","0","0","0","0","1","0","1","0","0","0","0","0","0","1","0","1","-2"
"228705","Texas A & M University-Kingsville","2018","Not on tenure/no tenure system, lecturers","33","16","17","1","1","0","3","2","1","0","0","0","5","2","3","0","0","0","17","5","12","1","1","0","0","0","0","6","5","1","-2"
"228705","Texas A & M University-Kingsville","2018","Not on tenure/no tenure system, no academic rank","13","7","6","0","0","0","0","0","0","1","1","0","5","3","2","0","0","0","7","3","4","0","0","0","0","0","0","0","0","0","-2"
"228981","Texas Lutheran University","2018","Tenured total","47","24","23","0","0","0","1","0","1","0","0","0","3","1","2","0","0","0","43","23","20","0","0","0","0","0","0","0","0","0","-2"
"228981","Texas Lutheran University","2018","Tenured, professors","25","13","12","0","0","0","0","0","0","0","0","0","1","0","1","0","0","0","24","13","11","0","0","0","0","0","0","0","0","0","-2"
"228981","Texas Lutheran University","2018","Tenured, associate professors","21","10","11","0","0","0","1","0","1","0","0","0","2","1","1","0","0","0","18","9","9","0","0","0","0","0","0","0","0","0","-2"
"228981","Texas Lutheran University","2018","Tenured, assistant professors","1","1","0","0","0","0","0","0","0","0","0","0","0","0","0","0","0","0","1","1","0","0","0","0","0","0","0","0","0","0","-2"
"228981","Texas Lutheran University","2018","On-Tenure track total","29","9","20","0","0","0","1","0","1","1","0","1","2","0","2","0","0","0","24","9","15","0","0","0","1","0","1","0","0","0","-2"
"228981","Texas Lutheran University","2018","On-tenure track, associate professors","3","0","3","0","0","0","0","0","0","0","0","0","0","0","0","0","0","0","3","0","3","0","0","0","0","0","0","0","0","0","-2"
"228981","Texas Lutheran University","2018","On-tenure track, assistant professors","22","9","13","0","0","0","1","0","1","1","0","1","1","0","1","0","0","0","18","9","9","0","0","0","1","0","1","0","0","0","-2"
"228981","Texas Lutheran University","2018","On-tenure track, instructors","4","0","4","0","0","0","0","0","0","0","0","0","1","0","1","0","0","0","3","0","3","0","0","0","0","0","0","0","0","0","-2"
"228981","Texas Lutheran University","2018","Not on tenure track/No tenure system system total","10","3","7","0","0","0","0","0","0","0","0","0","2","1","1","0","0","0","7","1","6","0","0","0","0","0","0","1","1","0","-2"
"228981","Texas Lutheran University","2018","Not on tenure/no tenure system, assistant professors","4","2","2","0","0","0","0","0","0","0","0","0","1","1","0","0","0","0","2","0","2","0","0","0","0","0","0","1","1","0","-2"
"228981","Texas Lutheran University","2018","Not on tenure/no tenure system, lecturers","6","1","5","0","0","0","0","0","0","0","0","0","1","0","1","0","0","0","5","1","4","0","0","0","0","0","0","0","0","0","-2"
"229018","The University of Texas Permian Basin","2018","Tenured total","57","38","19","0","0","0","9","6","3","1","0","1","5","2","3","0","0","0","40","28","12","0","0","0","0","0","0","2","2","0","-2"
"229018","The University of Texas Permian Basin","2018","Tenured, professors","17","12","5","0","0","0","4","2","2","1","0","1","0","0","0","0","0","0","12","10","2","0","0","0","0","0","0","0","0","0","-2"
"229018","The University of Texas Permian Basin","2018","Tenured, associate professors","36","24","12","0","0","0","5","4","1","0","0","0","3","1","2","0","0","0","26","17","9","0","0","0","0","0","0","2","2","0","-2"
"229018","The University of Texas Permian Basin","2018","Tenured, assistant professors","4","2","2","0","0","0","0","0","0","0","0","0","2","1","1","0","0","0","2","1","1","0","0","0","0","0","0","0","0","0","-2"
"229018","The University of Texas Permian Basin","2018","On-Tenure track total","41","22","19","0","0","0","8","6","2","2","0","2","7","3","4","0","0","0","23","12","11","0","0","0","0","0","0","1","1","0","-2"
"229018","The University of Texas Permian Basin","2018","On-tenure track, professors","4","4","0","0","0","0","1","1","0","0","0","0","1","1","0","0","0","0","2","2","0","0","0","0","0","0","0","0","0","0","-2"
"229018","The University of Texas Permian Basin","2018","On-tenure track, associate professors","5","2","3","0","0","0","1","1","0","1","0","1","0","0","0","0","0","0","3","1","2","0","0","0","0","0","0","0","0","0","-2"
"229018","The University of Texas Permian Basin","2018","On-tenure track, assistant professors","31","16","15","0","0","0","6","4","2","1","0","1","6","2","4","0","0","0","17","9","8","0","0","0","0","0","0","1","1","0","-2"
"229018","The University of Texas Permian Basin","2018","On-tenure track, lecturers","1","0","1","0","0","0","0","0","0","0","0","0","0","0","0","0","0","0","1","0","1","0","0","0","0","0","0","0","0","0","-2"
"229018","The University of Texas Permian Basin","2018","Not on tenure track/No tenure system system total","41","17","24","0","0","0","4","2","2","1","0","1","3","2","1","0","0","0","31","11","20","0","0","0","0","0","0","2","2","0","-2"
"229018","The University of Texas Permian Basin","2018","Not on tenure/no tenure system, professors","1","1","0","0","0","0","1","1","0","0","0","0","0","0","0","0","0","0","0","0","0","0","0","0","0","0","0","0","0","0","-2"
"229018","The University of Texas Permian Basin","2018","Not on tenure/no tenure system, associate professors","1","1","0","0","0","0","0","0","0","0","0","0","0","0","0","0","0","0","1","1","0","0","0","0","0","0","0","0","0","0","-2"
"229018","The University of Texas Permian Basin","2018","Not on tenure/no tenure system, instructors","2","0","2","0","0","0","0","0","0","0","0","0","0","0","0","0","0","0","2","0","2","0","0","0","0","0","0","0","0","0","-2"
"229018","The University of Texas Permian Basin","2018","Not on tenure/no tenure system, lecturers","37","15","22","0","0","0","3","1","2","1","0","1","3","2","1","0","0","0","28","10","18","0","0","0","0","0","0","2","2","0","-2"
"229027","The University of Texas at San Antonio","2018","Tenured total","425","298","127","4","3","1","91","74","17","16","10","6","75","43","32","0","0","0","232","164","68","1","1","0","6","3","3","0","0","0","-2"
"229027","The University of Texas at San Antonio","2018","Tenured, professors","249","190","59","2","2","0","61","52","9","8","5","3","40","24","16","0","0","0","133","104","29","0","0","0","5","3","2","0","0","0","-2"
"229027","The University of Texas at San Antonio","2018","Tenured, associate professors","176","108","68","2","1","1","30","22","8","8","5","3","35","19","16","0","0","0","99","60","39","1","1","0","1","0","1","0","0","0","-2"
"229027","The University of Texas at San Antonio","2018","On-Tenure track total","196","119","77","0","0","0","29","17","12","3","3","0","24","12","12","0","0","0","83","50","33","2","0","2","21","11","10","34","26","8","-2"
"229027","The University of Texas at San Antonio","2018","On-tenure track, associate professors","28","20","8","0","0","0","4","1","3","0","0","0","5","3","2","0","0","0","16","13","3","0","0","0","2","2","0","1","1","0","-2"
"229027","The University of Texas at San Antonio","2018","On-tenure track, assistant professors","168","99","69","0","0","0","25","16","9","3","3","0","19","9","10","0","0","0","67","37","30","2","0","2","19","9","10","33","25","8","-2"
"229027","The University of Texas at San Antonio","2018","Not on tenure track/No tenure system system total","320","159","161","1","0","1","24","13","11","11","5","6","65","37","28","0","0","0","191","92","99","3","0","3","14","4","10","11","8","3","-2"
"229027","The University of Texas at San Antonio","2018","Not on tenure/no tenure system, professors","6","3","3","0","0","0","0","0","0","0","0","0","0","0","0","0","0","0","5","3","2","0","0","0","0","0","0","1","0","1","-2"
"229027","The University of Texas at San Antonio","2018","Not on tenure/no tenure system, associate professors","17","13","4","0","0","0","2","1","1","1","1","0","4","2","2","0","0","0","10","9","1","0","0","0","0","0","0","0","0","0","-2"
"229027","The University of Texas at San Antonio","2018","Not on tenure/no tenure system, assistant professors","40","24","16","0","0","0","5","4","1","1","0","1","10","3","7","0","0","0","15","11","4","0","0","0","3","0","3","6","6","0","-2"
"229027","The University of Texas at San Antonio","2018","Not on tenure/no tenure system, instructors","1","0","1","1","0","1","0","0","0","0","0","0","0","0","0","0","0","0","0","0","0","0","0","0","0","0","0","0","0","0","-2"
"229027","The University of Texas at San Antonio","2018","Not on tenure/no tenure system, lecturers","251","118","133","0","0","0","15","8","7","9","4","5","50","31","19","0","0","0","159","69","90","3","0","3","11","4","7","4","2","2","-2"
"229027","The University of Texas at San Antonio","2018","Not on tenure/no tenure system, no academic rank","5","1","4","0","0","0","2","0","2","0","0","0","1","1","0","0","0","0","2","0","2","0","0","0","0","0","0","0","0","0","-2"
"229160","Texas Wesleyan University","2018","Tenured total","77","38","39","0","0","0","5","3","2","1","1","0","6","3","3","0","0","0","63","29","34","2","2","0","0","0","0","0","0","0","-2"
"229160","Texas Wesleyan University","2018","Tenured, professors","34","21","13","0","0","0","2","2","0","1","1","0","4","3","1","0","0","0","26","14","12","1","1","0","0","0","0","0","0","0","-2"
"229160","Texas Wesleyan University","2018","Tenured, associate professors","41","17","24","0","0","0","3","1","2","0","0","0","1","0","1","0","0","0","36","15","21","1","1","0","0","0","0","0","0","0","-2"
"229160","Texas Wesleyan University","2018","Tenured, assistant professors","2","0","2","0","0","0","0","0","0","0","0","0","1","0","1","0","0","0","1","0","1","0","0","0","0","0","0","0","0","0","-2"
"229160","Texas Wesleyan University","2018","On-Tenure track total","30","14","16","0","0","0","3","1","2","1","0","1","3","3","0","0","0","0","21","10","11","2","0","2","0","0","0","0","0","0","-2"
"229160","Texas Wesleyan University","2018","On-tenure track, associate professors","2","0","2","0","0","0","0","0","0","0","0","0","0","0","0","0","0","0","2","0","2","0","0","0","0","0","0","0","0","0","-2"
"229160","Texas Wesleyan University","2018","On-tenure track, assistant professors","27","13","14","0","0","0","3","1","2","1","0","1","3","3","0","0","0","0","18","9","9","2","0","2","0","0","0","0","0","0","-2"
"229160","Texas Wesleyan University","2018","On-tenure track, instructors","1","1","0","0","0","0","0","0","0","0","0","0","0","0","0","0","0","0","1","1","0","0","0","0","0","0","0","0","0","0","-2"
"229160","Texas Wesleyan University","2018","Not on tenure track/No tenure system system total","26","14","12","0","0","0","3","2","1","0","0","0","2","1","1","0","0","0","20","11","9","1","0","1","0","0","0","0","0","0","-2"
"229160","Texas Wesleyan University","2018","Not on tenure/no tenure system, professors","1","1","0","0","0","0","0","0","0","0","0","0","0","0","0","0","0","0","1","1","0","0","0","0","0","0","0","0","0","0","-2"
"229160","Texas Wesleyan University","2018","Not on tenure/no tenure system, associate professors","1","0","1","0","0","0","0","0","0","0","0","0","0","0","0","0","0","0","1","0","1","0","0","0","0","0","0","0","0","0","-2"
"229160","Texas Wesleyan University","2018","Not on tenure/no tenure system, assistant professors","16","8","8","0","0","0","3","2","1","0","0","0","1","0","1","0","0","0","11","6","5","1","0","1","0","0","0","0","0","0","-2"
"229160","Texas Wesleyan University","2018","Not on tenure/no tenure system, instructors","8","5","3","0","0","0","0","0","0","0","0","0","1","1","0","0","0","0","7","4","3","0","0","0","0","0","0","0","0","0","-2"
"229179","Texas Woman's University","2018","Tenured total","216","62","154","3","0","3","25","10","15","11","1","10","6","2","4","2","1","1","165","45","120","3","2","1","1","1","0","0","0","0","-2"
"229179","Texas Woman's University","2018","Tenured, professors","116","36","80","2","0","2","14","7","7","3","0","3","4","2","2","0","0","0","92","26","66","0","0","0","1","1","0","0","0","0","-2"
"229179","Texas Woman's University","2018","Tenured, associate professors","97","26","71","1","0","1","11","3","8","7","1","6","2","0","2","2","1","1","71","19","52","3","2","1","0","0","0","0","0","0","-2"
"229179","Texas Woman's University","2018","Tenured, assistant professors","3","0","3","0","0","0","0","0","0","1","0","1","0","0","0","0","0","0","2","0","2","0","0","0","0","0","0","0","0","0","-2"
"229179","Texas Woman's University","2018","On-Tenure track total","125","41","84","1","0","1","13","3","10","10","4","6","12","2","10","0","0","0","83","31","52","5","1","4","1","0","1","0","0","0","-2"
"229179","Texas Woman's University","2018","On-tenure track, professors","2","0","2","0","0","0","0","0","0","0","0","0","0","0","0","0","0","0","2","0","2","0","0","0","0","0","0","0","0","0","-2"
"229179","Texas Woman's University","2018","On-tenure track, associate professors","13","0","13","0","0","0","2","0","2","0","0","0","1","0","1","0","0","0","9","0","9","0","0","0","1","0","1","0","0","0","-2"
"229179","Texas Woman's University","2018","On-tenure track, assistant professors","110","41","69","1","0","1","11","3","8","10","4","6","11","2","9","0","0","0","72","31","41","5","1","4","0","0","0","0","0","0","-2"
"229179","Texas Woman's University","2018","Not on tenure track/No tenure system system total","128","17","111","1","0","1","10","1","9","8","0","8","7","2","5","0","0","0","100","13","87","1","1","0","1","0","1","0","0","0","-2"
"229179","Texas Woman's University","2018","Not on tenure/no tenure system, professors","9","1","8","0","0","0","0","0","0","1","0","1","0","0","0","0","0","0","8","1","7","0","0","0","0","0","0","0","0","0","-2"
"229179","Texas Woman's University","2018","Not on tenure/no tenure system, associate professors","45","6","39","1","0","1","4","1","3","2","0","2","2","1","1","0","0","0","36","4","32","0","0","0","0","0","0","0","0","0","-2"
"229179","Texas Woman's University","2018","Not on tenure/no tenure system, assistant professors","54","7","47","0","0","0","3","0","3","4","0","4","5","1","4","0","0","0","40","5","35","1","1","0","1","0","1","0","0","0","-2"
"229179","Texas Woman's University","2018","Not on tenure/no tenure system, instructors","3","0","3","0","0","0","0","0","0","0","0","0","0","0","0","0","0","0","3","0","3","0","0","0","0","0","0","0","0","0","-2"
"229179","Texas Woman's University","2018","Not on tenure/no tenure system, lecturers","17","3","14","0","0","0","3","0","3","1","0","1","0","0","0","0","0","0","13","3","10","0","0","0","0","0","0","0","0","0","-2"
"229300","The University of Texas Health Science Center at Houston","2018","Tenured total","277","186","91","0","0","0","72","53","19","7","7","0","15","10","5","0","0","0","177","112","65","1","1","0","5","3","2","0","0","0","-2"
"229300","The University of Texas Health Science Center at Houston","2018","Tenured, professors","199","141","58","0","0","0","44","35","9","4","4","0","11","9","2","0","0","0","134","89","45","1","1","0","5","3","2","0","0","0","-2"
"229300","The University of Texas Health Science Center at Houston","2018","Tenured, associate professors","78","45","33","0","0","0","28","18","10","3","3","0","4","1","3","0","0","0","43","23","20","0","0","0","0","0","0","0","0","0","-2"
"229300","The University of Texas Health Science Center at Houston","2018","On-Tenure track total","150","87","63","1","1","0","56","33","23","5","1","4","15","8","7","0","0","0","61","36","25","0","0","0","4","2","2","8","6","2","-2"
"229300","The University of Texas Health Science Center at Houston","2018","On-tenure track, professors","13","10","3","0","0","0","2","2","0","0","0","0","1","1","0","0","0","0","9","6","3","0","0","0","1","1","0","0","0","0","-2"
"229300","The University of Texas Health Science Center at Houston","2018","On-tenure track, associate professors","34","19","15","1","1","0","17","10","7","1","0","1","6","3","3","0","0","0","9","5","4","0","0","0","0","0","0","0","0","0","-2"
"229300","The University of Texas Health Science Center at Houston","2018","On-tenure track, assistant professors","103","58","45","0","0","0","37","21","16","4","1","3","8","4","4","0","0","0","43","25","18","0","0","0","3","1","2","8","6","2","-2"
"229300","The University of Texas Health Science Center at Houston","2018","Not on tenure track/No tenure system system total","1360","688","672","3","3","0","388","204","184","101","28","73","126","59","67","0","0","0","597","310","287","15","7","8","50","26","24","80","51","29","-2"
"229300","The University of Texas Health Science Center at Houston","2018","Not on tenure/no tenure system, professors","129","83","46","1","1","0","26","15","11","3","0","3","10","7","3","0","0","0","82","54","28","0","0","0","7","6","1","0","0","0","-2"
"229300","The University of Texas Health Science Center at Houston","2018","Not on tenure/no tenure system, associate professors","263","142","121","1","1","0","74","45","29","18","4","14","30","14","16","0","0","0","128","72","56","2","2","0","9","4","5","1","0","1","-2"
"229300","The University of Texas Health Science Center at Houston","2018","Not on tenure/no tenure system, assistant professors","877","433","444","1","1","0","265","134","131","73","23","50","82","37","45","0","0","0","349","176","173","12","5","7","31","15","16","64","42","22","-2"
"229300","The University of Texas Health Science Center at Houston","2018","Not on tenure/no tenure system, instructors","76","25","51","0","0","0","22","10","12","6","1","5","3","1","2","0","0","0","29","5","24","1","0","1","3","1","2","12","7","5","-2"
"229300","The University of Texas Health Science Center at Houston","2018","Not on tenure/no tenure system, no academic rank","15","5","10","0","0","0","1","0","1","1","0","1","1","0","1","0","0","0","9","3","6","0","0","0","0","0","0","3","2","1","-2"
"229337","Texas Tech University Health Sciences Center","2018","Tenured total","138","92","46","0","0","0","27","17","10","1","1","0","9","8","1","0","0","0","101","66","35","0","0","0","0","0","0","0","0","0","-2"
"229337","Texas Tech University Health Sciences Center","2018","Tenured, professors","99","70","29","0","0","0","22","15","7","0","0","0","4","4","0","0","0","0","73","51","22","0","0","0","0","0","0","0","0","0","-2"
"229337","Texas Tech University Health Sciences Center","2018","Tenured, associate professors","39","22","17","0","0","0","5","2","3","1","1","0","5","4","1","0","0","0","28","15","13","0","0","0","0","0","0","0","0","0","-2"
"229337","Texas Tech University Health Sciences Center","2018","On-Tenure track total","58","36","22","0","0","0","17","11","6","3","2","1","2","0","2","0","0","0","36","23","13","0","0","0","0","0","0","0","0","0","-2"
"229337","Texas Tech University Health Sciences Center","2018","On-tenure track, professors","5","5","0","0","0","0","4","4","0","0","0","0","0","0","0","0","0","0","1","1","0","0","0","0","0","0","0","0","0","0","-2"
"229337","Texas Tech University Health Sciences Center","2018","On-tenure track, associate professors","16","9","7","0","0","0","5","3","2","0","0","0","0","0","0","0","0","0","11","6","5","0","0","0","0","0","0","0","0","0","-2"
"229337","Texas Tech University Health Sciences Center","2018","On-tenure track, assistant professors","37","22","15","0","0","0","8","4","4","3","2","1","2","0","2","0","0","0","24","16","8","0","0","0","0","0","0","0","0","0","-2"
"229337","Texas Tech University Health Sciences Center","2018","Not on tenure track/No tenure system system total","536","222","314","2","2","0","94","53","41","34","13","21","36","10","26","0","0","0","370","144","226","0","0","0","0","0","0","0","0","0","-2"
"229337","Texas Tech University Health Sciences Center","2018","Not on tenure/no tenure system, professors","57","33","24","0","0","0","4","3","1","0","0","0","1","1","0","0","0","0","52","29","23","0","0","0","0","0","0","0","0","0","-2"
"229337","Texas Tech University Health Sciences Center","2018","Not on tenure/no tenure system, associate professors","161","78","83","2","2","0","33","19","14","13","6","7","9","3","6","0","0","0","104","48","56","0","0","0","0","0","0","0","0","0","-2"
"229337","Texas Tech University Health Sciences Center","2018","Not on tenure/no tenure system, assistant professors","246","92","154","0","0","0","49","28","21","16","6","10","22","6","16","0","0","0","159","52","107","0","0","0","0","0","0","0","0","0","-2"
"229337","Texas Tech University Health Sciences Center","2018","Not on tenure/no tenure system, instructors","38","7","31","0","0","0","5","3","2","4","1","3","4","0","4","0","0","0","25","3","22","0","0","0","0","0","0","0","0","0","-2"
"229337","Texas Tech University Health Sciences Center","2018","Not on tenure/no tenure system, no academic rank","34","12","22","0","0","0","3","0","3","1","0","1","0","0","0","0","0","0","30","12","18","0","0","0","0","0","0","0","0","0","-2"
"229355","Tyler Junior College","2018","Not on tenure track/No tenure system system total","316","136","180","3","0","3","0","0","0","20","5","15","8","4","4","0","0","0","281","125","156","1","1","0","2","0","2","1","1","0","-2"
"229355","Tyler Junior College","2018","Not on tenure/no tenure system, professors","316","136","180","3","0","3","0","0","0","20","5","15","8","4","4","0","0","0","281","125","156","1","1","0","2","0","2","1","1","0","-2"
"229780","Wayland Baptist University","2018","Not on tenure track/No tenure system system total","142","90","52","2","1","1","5","3","2","11","6","5","7","5","2","0","0","0","101","66","35","4","1","3","12","8","4","0","0","0","-2"
"229780","Wayland Baptist University","2018","Not on tenure/no tenure system, professors","59","42","17","1","1","0","2","1","1","1","1","0","1","1","0","0","0","0","53","37","16","0","0","0","1","1","0","0","0","0","-2"
"229780","Wayland Baptist University","2018","Not on tenure/no tenure system, associate professors","35","26","9","0","0","0","3","2","1","5","2","3","3","2","1","0","0","0","17","15","2","1","0","1","6","5","1","0","0","0","-2"
"229780","Wayland Baptist University","2018","Not on tenure/no tenure system, assistant professors","38","14","24","1","0","1","0","0","0","5","3","2","2","1","1","0","0","0","23","7","16","2","1","1","5","2","3","0","0","0","-2"
"229780","Wayland Baptist University","2018","Not on tenure/no tenure system, instructors","6","6","0","0","0","0","0","0","0","0","0","0","0","0","0","0","0","0","6","6","0","0","0","0","0","0","0","0","0","0","-2"
"229780","Wayland Baptist University","2018","Not on tenure/no tenure system, lecturers","4","2","2","0","0","0","0","0","0","0","0","0","1","1","0","0","0","0","2","1","1","1","0","1","0","0","0","0","0","0","-2"
"229814","West Texas A & M University","2018","Tenured total","131","83","48","2","2","0","11","7","4","0","0","0","3","2","1","0","0","0","113","71","42","0","0","0","1","0","1","1","1","0","-2"
"229814","West Texas A & M University","2018","Tenured, professors","65","43","22","1","1","0","7","6","1","0","0","0","1","1","0","0","0","0","56","35","21","0","0","0","0","0","0","0","0","0","-2"
"229814","West Texas A & M University","2018","Tenured, associate professors","64","39","25","1","1","0","4","1","3","0","0","0","2","1","1","0","0","0","55","35","20","0","0","0","1","0","1","1","1","0","-2"
"229814","West Texas A & M University","2018","Tenured, assistant professors","2","1","1","0","0","0","0","0","0","0","0","0","0","0","0","0","0","0","2","1","1","0","0","0","0","0","0","0","0","0","-2"
"229814","West Texas A & M University","2018","On-Tenure track total","98","53","45","0","0","0","3","0","3","1","1","0","7","2","5","0","0","0","67","40","27","0","0","0","2","1","1","18","9","9","-2"
"229814","West Texas A & M University","2018","On-tenure track, associate professors","4","1","3","0","0","0","0","0","0","0","0","0","2","1","1","0","0","0","2","0","2","0","0","0","0","0","0","0","0","0","-2"
"229814","West Texas A & M University","2018","On-tenure track, assistant professors","94","52","42","0","0","0","3","0","3","1","1","0","5","1","4","0","0","0","65","40","25","0","0","0","2","1","1","18","9","9","-2"
"229814","West Texas A & M University","2018","Not on tenure track/No tenure system system total","104","40","64","0","0","0","2","2","0","1","1","0","7","3","4","0","0","0","88","29","59","0","0","0","1","1","0","5","4","1","-2"
"229814","West Texas A & M University","2018","Not on tenure/no tenure system, assistant professors","6","3","3","0","0","0","0","0","0","0","0","0","1","1","0","0","0","0","3","1","2","0","0","0","0","0","0","2","1","1","-2"
"229814","West Texas A & M University","2018","Not on tenure/no tenure system, instructors","93","36","57","0","0","0","2","2","0","1","1","0","6","2","4","0","0","0","80","27","53","0","0","0","1","1","0","3","3","0","-2"
"229814","West Texas A & M University","2018","Not on tenure/no tenure system, lecturers","5","1","4","0","0","0","0","0","0","0","0","0","0","0","0","0","0","0","5","1","4","0","0","0","0","0","0","0","0","0","-2"
"234979","Columbia Basin College","2018","Tenured total","80","41","39","1","1","0","8","4","4","3","2","1","5","1","4","0","0","0","63","33","30","0","0","0","0","0","0","0","0","0","-2"
"234979","Columbia Basin College","2018","Tenured, no academic rank","80","41","39","1","1","0","8","4","4","3","2","1","5","1","4","0","0","0","63","33","30","0","0","0","0","0","0","0","0","0","-2"
"234979","Columbia Basin College","2018","On-Tenure track total","40","17","23","0","0","0","1","0","1","0","0","0","3","2","1","1","0","1","33","13","20","2","2","0","0","0","0","0","0","0","-2"
"234979","Columbia Basin College","2018","On-tenure track, no academic rank","40","17","23","0","0","0","1","0","1","0","0","0","3","2","1","1","0","1","33","13","20","2","2","0","0","0","0","0","0","0","-2"
"234979","Columbia Basin College","2018","Not on tenure track/No tenure system system total","15","6","9","0","0","0","0","0","0","1","1","0","1","1","0","0","0","0","12","3","9","1","1","0","0","0","0","0","0","0","-2"
"234979","Columbia Basin College","2018","Not on tenure/no tenure system, no academic rank","15","6","9","0","0","0","0","0","0","1","1","0","1","1","0","0","0","0","12","3","9","1","1","0","0","0","0","0","0","0","-2"
"235422","Heritage University","2018","Not on tenure track/No tenure system system total","62","34","28","4","2","2","1","1","0","3","2","1","8","3","5","1","1","0","44","24","20","1","1","0","0","0","0","0","0","0","-2"
"235422","Heritage University","2018","Not on tenure/no tenure system, professors","6","4","2","0","0","0","0","0","0","0","0","0","0","0","0","0","0","0","5","3","2","1","1","0","0","0","0","0","0","0","-2"
"235422","Heritage University","2018","Not on tenure/no tenure system, associate professors","21","14","7","2","0","2","0","0","0","2","2","0","3","0","3","1","1","0","13","11","2","0","0","0","0","0","0","0","0","0","-2"
"235422","Heritage University","2018","Not on tenure/no tenure system, assistant professors","30","15","15","2","2","0","1","1","0","1","0","1","3","3","0","0","0","0","23","9","14","0","0","0","0","0","0","0","0","0","-2"
"235422","Heritage University","2018","Not on tenure/no tenure system, instructors","5","1","4","0","0","0","0","0","0","0","0","0","2","0","2","0","0","0","3","1","2","0","0","0","0","0","0","0","0","0","-2"
"236975","Wenatchee Valley College","2018","Tenured total","53","29","24","0","0","0","2","0","2","1","0","1","4","4","0","0","0","0","43","23","20","3","2","1","0","0","0","0","0","0","-2"
"236975","Wenatchee Valley College","2018","Tenured, no academic rank","53","29","24","0","0","0","2","0","2","1","0","1","4","4","0","0","0","0","43","23","20","3","2","1","0","0","0","0","0","0","-2"
"236975","Wenatchee Valley College","2018","On-Tenure track total","18","8","10","0","0","0","0","0","0","0","0","0","0","0","0","0","0","0","16","6","10","2","2","0","0","0","0","0","0","0","-2"
"236975","Wenatchee Valley College","2018","On-tenure track, no academic rank","18","8","10","0","0","0","0","0","0","0","0","0","0","0","0","0","0","0","16","6","10","2","2","0","0","0","0","0","0","0","-2"
"236975","Wenatchee Valley College","2018","Not on tenure track/No tenure system system total","7","3","4","0","0","0","1","0","1","0","0","0","0","0","0","0","0","0","5","2","3","1","1","0","0","0","0","0","0","0","-2"
"236975","Wenatchee Valley College","2018","Not on tenure/no tenure system, no academic rank","7","3","4","0","0","0","1","0","1","0","0","0","0","0","0","0","0","0","5","2","3","1","1","0","0","0","0","0","0","0","-2"
"237109","Yakima Valley College","2018","Tenured total","69","30","39","0","0","0","2","1","1","0","0","0","5","1","4","0","0","0","62","28","34","0","0","0","0","0","0","0","0","0","-2"
"237109","Yakima Valley College","2018","Tenured, instructors","69","30","39","0","0","0","2","1","1","0","0","0","5","1","4","0","0","0","62","28","34","0","0","0","0","0","0","0","0","0","-2"
"237109","Yakima Valley College","2018","On-Tenure track total","12","6","6","0","0","0","0","0","0","0","0","0","2","1","1","0","0","0","10","5","5","0","0","0","0","0","0","0","0","0","-2"
"237109","Yakima Valley College","2018","On-tenure track, instructors","12","6","6","0","0","0","0","0","0","0","0","0","2","1","1","0","0","0","10","5","5","0","0","0","0","0","0","0","0","0","-2"
"237109","Yakima Valley College","2018","Not on tenure track/No tenure system system total","55","26","29","0","0","0","1","0","1","0","0","0","6","3","3","0","0","0","48","23","25","0","0","0","0","0","0","0","0","0","-2"
"237109","Yakima Valley College","2018","Not on tenure/no tenure system, instructors","55","26","29","0","0","0","1","0","1","0","0","0","6","3","3","0","0","0","48","23","25","0","0","0","0","0","0","0","0","0","-2"
"238193","Alverno College","2018","Tenured total","45","12","33","0","0","0","1","0","1","2","0","2","0","0","0","0","0","0","41","11","30","0","0","0","1","1","0","0","0","0","-2"
"238193","Alverno College","2018","Tenured, professors","28","7","21","0","0","0","1","0","1","0","0","0","0","0","0","0","0","0","27","7","20","0","0","0","0","0","0","0","0","0","-2"
"238193","Alverno College","2018","Tenured, associate professors","14","4","10","0","0","0","0","0","0","1","0","1","0","0","0","0","0","0","12","3","9","0","0","0","1","1","0","0","0","0","-2"
"238193","Alverno College","2018","Tenured, assistant professors","3","1","2","0","0","0","0","0","0","1","0","1","0","0","0","0","0","0","2","1","1","0","0","0","0","0","0","0","0","0","-2"
"238193","Alverno College","2018","On-Tenure track total","42","7","35","0","0","0","0","0","0","2","0","2","3","1","2","0","0","0","37","6","31","0","0","0","0","0","0","0","0","0","-2"
"238193","Alverno College","2018","On-tenure track, associate professors","7","1","6","0","0","0","0","0","0","0","0","0","0","0","0","0","0","0","7","1","6","0","0","0","0","0","0","0","0","0","-2"
"238193","Alverno College","2018","On-tenure track, assistant professors","35","6","29","0","0","0","0","0","0","2","0","2","3","1","2","0","0","0","30","5","25","0","0","0","0","0","0","0","0","0","-2"
"238193","Alverno College","2018","Not on tenure track/No tenure system system total","3","0","3","0","0","0","0","0","0","0","0","0","0","0","0","0","0","0","3","0","3","0","0","0","0","0","0","0","0","0","-2"
"238193","Alverno College","2018","Not on tenure/no tenure system, assistant professors","3","0","3","0","0","0","0","0","0","0","0","0","0","0","0","0","0","0","3","0","3","0","0","0","0","0","0","0","0","0","-2"
"239390","Mount Mary University","2018","Tenured total","30","3","27","0","0","0","0","0","0","0","0","0","0","0","0","0","0","0","30","3","27","0","0","0","0","0","0","0","0","0","-2"
"239390","Mount Mary University","2018","Tenured, professors","7","1","6","0","0","0","0","0","0","0","0","0","0","0","0","0","0","0","7","1","6","0","0","0","0","0","0","0","0","0","-2"
"239390","Mount Mary University","2018","Tenured, associate professors","17","2","15","0","0","0","0","0","0","0","0","0","0","0","0","0","0","0","17","2","15","0","0","0","0","0","0","0","0","0","-2"
"239390","Mount Mary University","2018","Tenured, assistant professors","6","0","6","0","0","0","0","0","0","0","0","0","0","0","0","0","0","0","6","0","6","0","0","0","0","0","0","0","0","0","-2"
"239390","Mount Mary University","2018","On-Tenure track total","19","3","16","0","0","0","0","0","0","2","0","2","1","1","0","0","0","0","16","2","14","0","0","0","0","0","0","0","0","0","-2"
"239390","Mount Mary University","2018","On-tenure track, associate professors","5","0","5","0","0","0","0","0","0","1","0","1","0","0","0","0","0","0","4","0","4","0","0","0","0","0","0","0","0","0","-2"
"239390","Mount Mary University","2018","On-tenure track, assistant professors","14","3","11","0","0","0","0","0","0","1","0","1","1","1","0","0","0","0","12","2","10","0","0","0","0","0","0","0","0","0","-2"
"239390","Mount Mary University","2018","Not on tenure track/No tenure system system total","12","0","12","0","0","0","0","0","0","0","0","0","1","0","1","0","0","0","11","0","11","0","0","0","0","0","0","0","0","0","-2"
"239390","Mount Mary University","2018","Not on tenure/no tenure system, assistant professors","5","0","5","0","0","0","0","0","0","0","0","0","1","0","1","0","0","0","4","0","4","0","0","0","0","0","0","0","0","0","-2"
"239390","Mount Mary University","2018","Not on tenure/no tenure system, instructors","7","0","7","0","0","0","0","0","0","0","0","0","0","0","0","0","0","0","7","0","7","0","0","0","0","0","0","0","0","0","-2"
"241100","American University of Puerto Rico","2018","Tenured total","11","5","6","0","0","0","0","0","0","0","0","0","11","5","6","0","0","0","0","0","0","0","0","0","0","0","0","0","0","0","-2"
"241100","American University of Puerto Rico","2018","Tenured, associate professors","3","1","2","0","0","0","0","0","0","0","0","0","3","1","2","0","0","0","0","0","0","0","0","0","0","0","0","0","0","0","-2"
"241100","American University of Puerto Rico","2018","Tenured, assistant professors","7","4","3","0","0","0","0","0","0","0","0","0","7","4","3","0","0","0","0","0","0","0","0","0","0","0","0","0","0","0","-2"
"241100","American University of Puerto Rico","2018","Tenured, instructors","1","0","1","0","0","0","0","0","0","0","0","0","1","0","1","0","0","0","0","0","0","0","0","0","0","0","0","0","0","0","-2"
"241128","American University of Puerto Rico","2018","Tenured total","8","4","4","0","0","0","0","0","0","0","0","0","7","3","4","0","0","0","1","1","0","0","0","0","0","0","0","0","0","0","-2"
"241128","American University of Puerto Rico","2018","Tenured, associate professors","3","0","3","0","0","0","0","0","0","0","0","0","3","0","3","0","0","0","0","0","0","0","0","0","0","0","0","0","0","0","-2"
"241128","American University of Puerto Rico","2018","Tenured, assistant professors","2","1","1","0","0","0","0","0","0","0","0","0","1","0","1","0","0","0","1","1","0","0","0","0","0","0","0","0","0","0","-2"
"241128","American University of Puerto Rico","2018","Tenured, instructors","3","3","0","0","0","0","0","0","0","0","0","0","3","3","0","0","0","0","0","0","0","0","0","0","0","0","0","0","0","0","-2"
"241191","Universidad Adventista de las Antillas","2018","Tenured total","19","10","9","0","0","0","0","0","0","0","0","0","19","10","9","0","0","0","0","0","0","0","0","0","0","0","0","0","0","0","-2"
"241191","Universidad Adventista de las Antillas","2018","Tenured, professors","1","0","1","0","0","0","0","0","0","0","0","0","1","0","1","0","0","0","0","0","0","0","0","0","0","0","0","0","0","0","-2"
"241191","Universidad Adventista de las Antillas","2018","Tenured, associate professors","8","4","4","0","0","0","0","0","0","0","0","0","8","4","4","0","0","0","0","0","0","0","0","0","0","0","0","0","0","0","-2"
"241191","Universidad Adventista de las Antillas","2018","Tenured, assistant professors","9","5","4","0","0","0","0","0","0","0","0","0","9","5","4","0","0","0","0","0","0","0","0","0","0","0","0","0","0","0","-2"
"241191","Universidad Adventista de las Antillas","2018","Tenured, instructors","1","1","0","0","0","0","0","0","0","0","0","0","1","1","0","0","0","0","0","0","0","0","0","0","0","0","0","0","0","0","-2"
"241191","Universidad Adventista de las Antillas","2018","On-Tenure track total","12","6","6","0","0","0","0","0","0","0","0","0","11","6","5","0","0","0","1","0","1","0","0","0","0","0","0","0","0","0","-2"
"241191","Universidad Adventista de las Antillas","2018","On-tenure track, assistant professors","9","5","4","0","0","0","0","0","0","0","0","0","9","5","4","0","0","0","0","0","0","0","0","0","0","0","0","0","0","0","-2"
"241191","Universidad Adventista de las Antillas","2018","On-tenure track, instructors","3","1","2","0","0","0","0","0","0","0","0","0","2","1","1","0","0","0","1","0","1","0","0","0","0","0","0","0","0","0","-2"
"241191","Universidad Adventista de las Antillas","2018","Not on tenure track/No tenure system system total","7","4","3","0","0","0","0","0","0","0","0","0","7","4","3","0","0","0","0","0","0","0","0","0","0","0","0","0","0","0","-2"
"241191","Universidad Adventista de las Antillas","2018","Not on tenure/no tenure system, no academic rank","7","4","3","0","0","0","0","0","0","0","0","0","7","4","3","0","0","0","0","0","0","0","0","0","0","0","0","0","0","0","-2"
"241216","Atlantic University College","2018","Not on tenure track/No tenure system system total","61","34","27","0","0","0","0","0","0","0","0","0","61","34","27","0","0","0","0","0","0","0","0","0","0","0","0","0","0","0","-2"
"241216","Atlantic University College","2018","Not on tenure/no tenure system, professors","61","34","27","0","0","0","0","0","0","0","0","0","61","34","27","0","0","0","0","0","0","0","0","0","0","0","0","0","0","0","-2"
"241225","Universidad Central de Bayamon","2018","Not on tenure track/No tenure system system total","28","7","21","0","0","0","0","0","0","0","0","0","27","7","20","0","0","0","0","0","0","0","0","0","0","0","0","1","0","1","-2"
"241225","Universidad Central de Bayamon","2018","Not on tenure/no tenure system, professors","2","1","1","0","0","0","0","0","0","0","0","0","2","1","1","0","0","0","0","0","0","0","0","0","0","0","0","0","0","0","-2"
"241225","Universidad Central de Bayamon","2018","Not on tenure/no tenure system, associate professors","15","4","11","0","0","0","0","0","0","0","0","0","14","4","10","0","0","0","0","0","0","0","0","0","0","0","0","1","0","1","-2"
"241225","Universidad Central de Bayamon","2018","Not on tenure/no tenure system, assistant professors","6","2","4","0","0","0","0","0","0","0","0","0","6","2","4","0","0","0","0","0","0","0","0","0","0","0","0","0","0","0","-2"
"241225","Universidad Central de Bayamon","2018","Not on tenure/no tenure system, instructors","5","0","5","0","0","0","0","0","0","0","0","0","5","0","5","0","0","0","0","0","0","0","0","0","0","0","0","0","0","0","-2"
"241377","Caribbean University-Bayamon","2018","Not on tenure track/No tenure system system total","34","18","16","0","0","0","0","0","0","0","0","0","34","18","16","0","0","0","0","0","0","0","0","0","0","0","0","0","0","0","-2"
"241377","Caribbean University-Bayamon","2018","Not on tenure/no tenure system, professors","1","1","0","0","0","0","0","0","0","0","0","0","1","1","0","0","0","0","0","0","0","0","0","0","0","0","0","0","0","0","-2"
"241377","Caribbean University-Bayamon","2018","Not on tenure/no tenure system, associate professors","1","0","1","0","0","0","0","0","0","0","0","0","1","0","1","0","0","0","0","0","0","0","0","0","0","0","0","0","0","0","-2"
"241377","Caribbean University-Bayamon","2018","Not on tenure/no tenure system, assistant professors","4","1","3","0","0","0","0","0","0","0","0","0","4","1","3","0","0","0","0","0","0","0","0","0","0","0","0","0","0","0","-2"
"241377","Caribbean University-Bayamon","2018","Not on tenure/no tenure system, instructors","28","16","12","0","0","0","0","0","0","0","0","0","28","16","12","0","0","0","0","0","0","0","0","0","0","0","0","0","0","0","-2"
"241386","Caribbean University-Carolina","2018","Not on tenure track/No tenure system system total","8","4","4","0","0","0","0","0","0","0","0","0","8","4","4","0","0","0","0","0","0","0","0","0","0","0","0","0","0","0","-2"
"241386","Caribbean University-Carolina","2018","Not on tenure/no tenure system, assistant professors","2","1","1","0","0","0","0","0","0","0","0","0","2","1","1","0","0","0","0","0","0","0","0","0","0","0","0","0","0","0","-2"
"241386","Caribbean University-Carolina","2018","Not on tenure/no tenure system, instructors","6","3","3","0","0","0","0","0","0","0","0","0","6","3","3","0","0","0","0","0","0","0","0","0","0","0","0","0","0","0","-2"
"241395","Pontifical Catholic University of Puerto Rico-Arecibo","2018","Not on tenure track/No tenure system system total","23","9","14","0","0","0","0","0","0","0","0","0","23","9","14","0","0","0","0","0","0","0","0","0","0","0","0","0","0","0","-2"
"241395","Pontifical Catholic University of Puerto Rico-Arecibo","2018","Not on tenure/no tenure system, professors","2","1","1","0","0","0","0","0","0","0","0","0","2","1","1","0","0","0","0","0","0","0","0","0","0","0","0","0","0","0","-2"
"241395","Pontifical Catholic University of Puerto Rico-Arecibo","2018","Not on tenure/no tenure system, associate professors","6","2","4","0","0","0","0","0","0","0","0","0","6","2","4","0","0","0","0","0","0","0","0","0","0","0","0","0","0","0","-2"
"241395","Pontifical Catholic University of Puerto Rico-Arecibo","2018","Not on tenure/no tenure system, assistant professors","5","2","3","0","0","0","0","0","0","0","0","0","5","2","3","0","0","0","0","0","0","0","0","0","0","0","0","0","0","0","-2"
"241395","Pontifical Catholic University of Puerto Rico-Arecibo","2018","Not on tenure/no tenure system, instructors","2","1","1","0","0","0","0","0","0","0","0","0","2","1","1","0","0","0","0","0","0","0","0","0","0","0","0","0","0","0","-2"
"241395","Pontifical Catholic University of Puerto Rico-Arecibo","2018","Not on tenure/no tenure system, no academic rank","8","3","5","0","0","0","0","0","0","0","0","0","8","3","5","0","0","0","0","0","0","0","0","0","0","0","0","0","0","0","-2"
"241410","Pontifical Catholic University of Puerto Rico-Ponce","2018","Not on tenure track/No tenure system system total","228","95","133","0","0","0","0","0","0","0","0","0","218","90","128","0","0","0","10","5","5","0","0","0","0","0","0","0","0","0","-2"
"241410","Pontifical Catholic University of Puerto Rico-Ponce","2018","Not on tenure/no tenure system, professors","40","22","18","0","0","0","0","0","0","0","0","0","38","20","18","0","0","0","2","2","0","0","0","0","0","0","0","0","0","0","-2"
"241410","Pontifical Catholic University of Puerto Rico-Ponce","2018","Not on tenure/no tenure system, associate professors","67","27","40","0","0","0","0","0","0","0","0","0","64","26","38","0","0","0","3","1","2","0","0","0","0","0","0","0","0","0","-2"
"241410","Pontifical Catholic University of Puerto Rico-Ponce","2018","Not on tenure/no tenure system, assistant professors","69","34","35","0","0","0","0","0","0","0","0","0","65","32","33","0","0","0","4","2","2","0","0","0","0","0","0","0","0","0","-2"
"241410","Pontifical Catholic University of Puerto Rico-Ponce","2018","Not on tenure/no tenure system, instructors","14","4","10","0","0","0","0","0","0","0","0","0","13","4","9","0","0","0","1","0","1","0","0","0","0","0","0","0","0","0","-2"
"241410","Pontifical Catholic University of Puerto Rico-Ponce","2018","Not on tenure/no tenure system, no academic rank","38","8","30","0","0","0","0","0","0","0","0","0","38","8","30","0","0","0","0","0","0","0","0","0","0","0","0","0","0","0","-2"
"241614","Universidad Teologica del Caribe","2018","Tenured total","2","0","2","0","0","0","0","0","0","0","0","0","2","0","2","0","0","0","0","0","0","0","0","0","0","0","0","0","0","0","-2"
"241614","Universidad Teologica del Caribe","2018","Tenured, professors","1","0","1","0","0","0","0","0","0","0","0","0","1","0","1","0","0","0","0","0","0","0","0","0","0","0","0","0","0","0","-2"
"241614","Universidad Teologica del Caribe","2018","Tenured, instructors","1","0","1","0","0","0","0","0","0","0","0","0","1","0","1","0","0","0","0","0","0","0","0","0","0","0","0","0","0","0","-2"
"241614","Universidad Teologica del Caribe","2018","Not on tenure track/No tenure system system total","14","8","6","0","0","0","0","0","0","0","0","0","14","8","6","0","0","0","0","0","0","0","0","0","0","0","0","0","0","0","-2"
"241614","Universidad Teologica del Caribe","2018","Not on tenure/no tenure system, instructors","14","8","6","0","0","0","0","0","0","0","0","0","14","8","6","0","0","0","0","0","0","0","0","0","0","0","0","0","0","0","-2"
"241720","Colegio Universitario de San Juan","2018","Tenured total","23","9","14","0","0","0","0","0","0","0","0","0","23","9","14","0","0","0","0","0","0","0","0","0","0","0","0","0","0","0","-2"
"241720","Colegio Universitario de San Juan","2018","Tenured, professors","1","1","0","0","0","0","0","0","0","0","0","0","1","1","0","0","0","0","0","0","0","0","0","0","0","0","0","0","0","0","-2"
"241720","Colegio Universitario de San Juan","2018","Tenured, associate professors","2","1","1","0","0","0","0","0","0","0","0","0","2","1","1","0","0","0","0","0","0","0","0","0","0","0","0","0","0","0","-2"
"241720","Colegio Universitario de San Juan","2018","Tenured, assistant professors","5","2","3","0","0","0","0","0","0","0","0","0","5","2","3","0","0","0","0","0","0","0","0","0","0","0","0","0","0","0","-2"
"241720","Colegio Universitario de San Juan","2018","Tenured, instructors","15","5","10","0","0","0","0","0","0","0","0","0","15","5","10","0","0","0","0","0","0","0","0","0","0","0","0","0","0","0","-2"
"241739","Universidad Ana G. Mendez-Cupey Campus","2018","Tenured total","11","2","9","0","0","0","0","0","0","0","0","0","11","2","9","0","0","0","0","0","0","0","0","0","0","0","0","0","0","0","-2"
"241739","Universidad Ana G. Mendez-Cupey Campus","2018","Tenured, professors","7","1","6","0","0","0","0","0","0","0","0","0","7","1","6","0","0","0","0","0","0","0","0","0","0","0","0","0","0","0","-2"
"241739","Universidad Ana G. Mendez-Cupey Campus","2018","Tenured, associate professors","4","1","3","0","0","0","0","0","0","0","0","0","4","1","3","0","0","0","0","0","0","0","0","0","0","0","0","0","0","0","-2"
"241739","Universidad Ana G. Mendez-Cupey Campus","2018","Not on tenure track/No tenure system system total","157","49","108","0","0","0","0","0","0","0","0","0","153","46","107","0","0","0","3","2","1","0","0","0","1","1","0","0","0","0","-2"
"241739","Universidad Ana G. Mendez-Cupey Campus","2018","Not on tenure/no tenure system, professors","13","6","7","0","0","0","0","0","0","0","0","0","12","5","7","0","0","0","1","1","0","0","0","0","0","0","0","0","0","0","-2"
"241739","Universidad Ana G. Mendez-Cupey Campus","2018","Not on tenure/no tenure system, associate professors","20","8","12","0","0","0","0","0","0","0","0","0","17","6","11","0","0","0","2","1","1","0","0","0","1","1","0","0","0","0","-2"
"241739","Universidad Ana G. Mendez-Cupey Campus","2018","Not on tenure/no tenure system, assistant professors","48","16","32","0","0","0","0","0","0","0","0","0","48","16","32","0","0","0","0","0","0","0","0","0","0","0","0","0","0","0","-2"
"241739","Universidad Ana G. Mendez-Cupey Campus","2018","Not on tenure/no tenure system, instructors","76","19","57","0","0","0","0","0","0","0","0","0","76","19","57","0","0","0","0","0","0","0","0","0","0","0","0","0","0","0","-2"
"241766","Conservatory of Music of Puerto Rico","2018","Tenured total","36","26","10","0","0","0","0","0","0","0","0","0","35","26","9","0","0","0","1","0","1","0","0","0","0","0","0","0","0","0","-2"
"241766","Conservatory of Music of Puerto Rico","2018","Tenured, professors","10","5","5","0","0","0","0","0","0","0","0","0","9","5","4","0","0","0","1","0","1","0","0","0","0","0","0","0","0","0","-2"
"241766","Conservatory of Music of Puerto Rico","2018","Tenured, associate professors","16","12","4","0","0","0","0","0","0","0","0","0","16","12","4","0","0","0","0","0","0","0","0","0","0","0","0","0","0","0","-2"
"241766","Conservatory of Music of Puerto Rico","2018","Tenured, assistant professors","7","7","0","0","0","0","0","0","0","0","0","0","7","7","0","0","0","0","0","0","0","0","0","0","0","0","0","0","0","0","-2"
"241766","Conservatory of Music of Puerto Rico","2018","Tenured, instructors","3","2","1","0","0","0","0","0","0","0","0","0","3","2","1","0","0","0","0","0","0","0","0","0","0","0","0","0","0","0","-2"
"241766","Conservatory of Music of Puerto Rico","2018","On-Tenure track total","1","1","0","0","0","0","0","0","0","0","0","0","0","0","0","0","0","0","1","1","0","0","0","0","0","0","0","0","0","0","-2"
"241766","Conservatory of Music of Puerto Rico","2018","On-tenure track, assistant professors","1","1","0","0","0","0","0","0","0","0","0","0","0","0","0","0","0","0","1","1","0","0","0","0","0","0","0","0","0","0","-2"
"241766","Conservatory of Music of Puerto Rico","2018","Not on tenure track/No tenure system system total","7","4","3","0","0","0","0","0","0","0","0","0","6","4","2","0","0","0","1","0","1","0","0","0","0","0","0","0","0","0","-2"
"241766","Conservatory of Music of Puerto Rico","2018","Not on tenure/no tenure system, no academic rank","7","4","3","0","0","0","0","0","0","0","0","0","6","4","2","0","0","0","1","0","1","0","0","0","0","0","0","0","0","0","-2"
"241836","EDP University of Puerto Rico Inc-San Sebastian","2018","Not on tenure track/No tenure system system total","28","8","20","0","0","0","0","0","0","0","0","0","28","8","20","0","0","0","0","0","0","0","0","0","0","0","0","0","0","0","-2"
"241836","EDP University of Puerto Rico Inc-San Sebastian","2018","Not on tenure/no tenure system, instructors","28","8","20","0","0","0","0","0","0","0","0","0","28","8","20","0","0","0","0","0","0","0","0","0","0","0","0","0","0","0","-2"
"241951","Escuela de Artes Plasticas y Diseno de Puerto Rico","2018","Tenured total","13","8","5","0","0","0","0","0","0","0","0","0","13","8","5","0","0","0","0","0","0","0","0","0","0","0","0","0","0","0","-2"
"241951","Escuela de Artes Plasticas y Diseno de Puerto Rico","2018","Tenured, professors","3","2","1","0","0","0","0","0","0","0","0","0","3","2","1","0","0","0","0","0","0","0","0","0","0","0","0","0","0","0","-2"
"241951","Escuela de Artes Plasticas y Diseno de Puerto Rico","2018","Tenured, associate professors","1","0","1","0","0","0","0","0","0","0","0","0","1","0","1","0","0","0","0","0","0","0","0","0","0","0","0","0","0","0","-2"
"241951","Escuela de Artes Plasticas y Diseno de Puerto Rico","2018","Tenured, assistant professors","1","1","0","0","0","0","0","0","0","0","0","0","1","1","0","0","0","0","0","0","0","0","0","0","0","0","0","0","0","0","-2"
"241951","Escuela de Artes Plasticas y Diseno de Puerto Rico","2018","Tenured, instructors","8","5","3","0","0","0","0","0","0","0","0","0","8","5","3","0","0","0","0","0","0","0","0","0","0","0","0","0","0","0","-2"
"241951","Escuela de Artes Plasticas y Diseno de Puerto Rico","2018","On-Tenure track total","1","1","0","0","0","0","0","0","0","0","0","0","1","1","0","0","0","0","0","0","0","0","0","0","0","0","0","0","0","0","-2"
"241951","Escuela de Artes Plasticas y Diseno de Puerto Rico","2018","On-tenure track, instructors","1","1","0","0","0","0","0","0","0","0","0","0","1","1","0","0","0","0","0","0","0","0","0","0","0","0","0","0","0","0","-2"
"241951","Escuela de Artes Plasticas y Diseno de Puerto Rico","2018","Not on tenure track/No tenure system system total","12","5","7","0","0","0","0","0","0","0","0","0","12","5","7","0","0","0","0","0","0","0","0","0","0","0","0","0","0","0","-2"
"241951","Escuela de Artes Plasticas y Diseno de Puerto Rico","2018","Not on tenure/no tenure system, no academic rank","12","5","7","0","0","0","0","0","0","0","0","0","12","5","7","0","0","0","0","0","0","0","0","0","0","0","0","0","0","0","-2"
"242121","Humacao Community College","2018","Not on tenure track/No tenure system system total","16","9","7","0","0","0","0","0","0","0","0","0","16","9","7","0","0","0","0","0","0","0","0","0","0","0","0","0","0","0","-2"
"242121","Humacao Community College","2018","Not on tenure/no tenure system, professors","16","9","7","0","0","0","0","0","0","0","0","0","16","9","7","0","0","0","0","0","0","0","0","0","0","0","0","0","0","0","-2"
"242617","Inter American University of Puerto Rico-San German","2018","Tenured total","78","36","42","0","0","0","0","0","0","0","0","0","77","35","42","0","0","0","1","1","0","0","0","0","0","0","0","0","0","0","-2"
"242617","Inter American University of Puerto Rico-San German","2018","Tenured, professors","25","13","12","0","0","0","0","0","0","0","0","0","24","12","12","0","0","0","1","1","0","0","0","0","0","0","0","0","0","0","-2"
"242617","Inter American University of Puerto Rico-San German","2018","Tenured, associate professors","36","17","19","0","0","0","0","0","0","0","0","0","36","17","19","0","0","0","0","0","0","0","0","0","0","0","0","0","0","0","-2"
"242617","Inter American University of Puerto Rico-San German","2018","Tenured, assistant professors","17","6","11","0","0","0","0","0","0","0","0","0","17","6","11","0","0","0","0","0","0","0","0","0","0","0","0","0","0","0","-2"
"242617","Inter American University of Puerto Rico-San German","2018","On-Tenure track total","17","6","11","0","0","0","0","0","0","0","0","0","17","6","11","0","0","0","0","0","0","0","0","0","0","0","0","0","0","0","-2"
"242617","Inter American University of Puerto Rico-San German","2018","On-tenure track, associate professors","3","0","3","0","0","0","0","0","0","0","0","0","3","0","3","0","0","0","0","0","0","0","0","0","0","0","0","0","0","0","-2"
"242617","Inter American University of Puerto Rico-San German","2018","On-tenure track, assistant professors","13","5","8","0","0","0","0","0","0","0","0","0","13","5","8","0","0","0","0","0","0","0","0","0","0","0","0","0","0","0","-2"
"242617","Inter American University of Puerto Rico-San German","2018","On-tenure track, instructors","1","1","0","0","0","0","0","0","0","0","0","0","1","1","0","0","0","0","0","0","0","0","0","0","0","0","0","0","0","0","-2"
"242617","Inter American University of Puerto Rico-San German","2018","Not on tenure track/No tenure system system total","2","0","2","0","0","0","0","0","0","0","0","0","2","0","2","0","0","0","0","0","0","0","0","0","0","0","0","0","0","0","-2"
"242617","Inter American University of Puerto Rico-San German","2018","Not on tenure/no tenure system, assistant professors","1","0","1","0","0","0","0","0","0","0","0","0","1","0","1","0","0","0","0","0","0","0","0","0","0","0","0","0","0","0","-2"
"242617","Inter American University of Puerto Rico-San German","2018","Not on tenure/no tenure system, instructors","1","0","1","0","0","0","0","0","0","0","0","0","1","0","1","0","0","0","0","0","0","0","0","0","0","0","0","0","0","0","-2"
"242626","Inter American University of Puerto Rico-Aguadilla","2018","Tenured total","55","23","32","0","0","0","0","0","0","1","0","1","54","23","31","0","0","0","0","0","0","0","0","0","0","0","0","0","0","0","-2"
"242626","Inter American University of Puerto Rico-Aguadilla","2018","Tenured, professors","10","1","9","0","0","0","0","0","0","1","0","1","9","1","8","0","0","0","0","0","0","0","0","0","0","0","0","0","0","0","-2"
"242626","Inter American University of Puerto Rico-Aguadilla","2018","Tenured, associate professors","20","7","13","0","0","0","0","0","0","0","0","0","20","7","13","0","0","0","0","0","0","0","0","0","0","0","0","0","0","0","-2"
"242626","Inter American University of Puerto Rico-Aguadilla","2018","Tenured, assistant professors","25","15","10","0","0","0","0","0","0","0","0","0","25","15","10","0","0","0","0","0","0","0","0","0","0","0","0","0","0","0","-2"
"242626","Inter American University of Puerto Rico-Aguadilla","2018","On-Tenure track total","14","5","9","0","0","0","0","0","0","0","0","0","14","5","9","0","0","0","0","0","0","0","0","0","0","0","0","0","0","0","-2"
"242626","Inter American University of Puerto Rico-Aguadilla","2018","On-tenure track, assistant professors","8","5","3","0","0","0","0","0","0","0","0","0","8","5","3","0","0","0","0","0","0","0","0","0","0","0","0","0","0","0","-2"
"242626","Inter American University of Puerto Rico-Aguadilla","2018","On-tenure track, instructors","6","0","6","0","0","0","0","0","0","0","0","0","6","0","6","0","0","0","0","0","0","0","0","0","0","0","0","0","0","0","-2"
"242626","Inter American University of Puerto Rico-Aguadilla","2018","Not on tenure track/No tenure system system total","11","5","6","0","0","0","0","0","0","0","0","0","11","5","6","0","0","0","0","0","0","0","0","0","0","0","0","0","0","0","-2"
"242626","Inter American University of Puerto Rico-Aguadilla","2018","Not on tenure/no tenure system, assistant professors","4","1","3","0","0","0","0","0","0","0","0","0","4","1","3","0","0","0","0","0","0","0","0","0","0","0","0","0","0","0","-2"
"242626","Inter American University of Puerto Rico-Aguadilla","2018","Not on tenure/no tenure system, instructors","7","4","3","0","0","0","0","0","0","0","0","0","7","4","3","0","0","0","0","0","0","0","0","0","0","0","0","0","0","0","-2"
"242635","Inter American University of Puerto Rico-Arecibo","2018","Tenured total","48","23","25","0","0","0","0","0","0","0","0","0","48","23","25","0","0","0","0","0","0","0","0","0","0","0","0","0","0","0","-2"
"242635","Inter American University of Puerto Rico-Arecibo","2018","Tenured, professors","19","9","10","0","0","0","0","0","0","0","0","0","19","9","10","0","0","0","0","0","0","0","0","0","0","0","0","0","0","0","-2"
"242635","Inter American University of Puerto Rico-Arecibo","2018","Tenured, associate professors","13","7","6","0","0","0","0","0","0","0","0","0","13","7","6","0","0","0","0","0","0","0","0","0","0","0","0","0","0","0","-2"
"242635","Inter American University of Puerto Rico-Arecibo","2018","Tenured, assistant professors","16","7","9","0","0","0","0","0","0","0","0","0","16","7","9","0","0","0","0","0","0","0","0","0","0","0","0","0","0","0","-2"
"242635","Inter American University of Puerto Rico-Arecibo","2018","On-Tenure track total","17","4","13","0","0","0","0","0","0","0","0","0","17","4","13","0","0","0","0","0","0","0","0","0","0","0","0","0","0","0","-2"
"242635","Inter American University of Puerto Rico-Arecibo","2018","On-tenure track, associate professors","1","0","1","0","0","0","0","0","0","0","0","0","1","0","1","0","0","0","0","0","0","0","0","0","0","0","0","0","0","0","-2"
"242635","Inter American University of Puerto Rico-Arecibo","2018","On-tenure track, assistant professors","11","3","8","0","0","0","0","0","0","0","0","0","11","3","8","0","0","0","0","0","0","0","0","0","0","0","0","0","0","0","-2"
"242635","Inter American University of Puerto Rico-Arecibo","2018","On-tenure track, instructors","5","1","4","0","0","0","0","0","0","0","0","0","5","1","4","0","0","0","0","0","0","0","0","0","0","0","0","0","0","0","-2"
"242635","Inter American University of Puerto Rico-Arecibo","2018","Not on tenure track/No tenure system system total","10","6","4","0","0","0","0","0","0","0","0","0","10","6","4","0","0","0","0","0","0","0","0","0","0","0","0","0","0","0","-2"
"242635","Inter American University of Puerto Rico-Arecibo","2018","Not on tenure/no tenure system, assistant professors","5","4","1","0","0","0","0","0","0","0","0","0","5","4","1","0","0","0","0","0","0","0","0","0","0","0","0","0","0","0","-2"
"242635","Inter American University of Puerto Rico-Arecibo","2018","Not on tenure/no tenure system, instructors","5","2","3","0","0","0","0","0","0","0","0","0","5","2","3","0","0","0","0","0","0","0","0","0","0","0","0","0","0","0","-2"
"242644","Inter American University of Puerto Rico-Barranquitas","2018","Tenured total","13","4","9","0","0","0","0","0","0","0","0","0","13","4","9","0","0","0","0","0","0","0","0","0","0","0","0","0","0","0","-2"
"242644","Inter American University of Puerto Rico-Barranquitas","2018","Tenured, professors","1","1","0","0","0","0","0","0","0","0","0","0","1","1","0","0","0","0","0","0","0","0","0","0","0","0","0","0","0","0","-2"
"242644","Inter American University of Puerto Rico-Barranquitas","2018","Tenured, associate professors","3","1","2","0","0","0","0","0","0","0","0","0","3","1","2","0","0","0","0","0","0","0","0","0","0","0","0","0","0","0","-2"
"242644","Inter American University of Puerto Rico-Barranquitas","2018","Tenured, assistant professors","9","2","7","0","0","0","0","0","0","0","0","0","9","2","7","0","0","0","0","0","0","0","0","0","0","0","0","0","0","0","-2"
"242644","Inter American University of Puerto Rico-Barranquitas","2018","On-Tenure track total","10","4","6","0","0","0","0","0","0","0","0","0","10","4","6","0","0","0","0","0","0","0","0","0","0","0","0","0","0","0","-2"
"242644","Inter American University of Puerto Rico-Barranquitas","2018","On-tenure track, associate professors","2","1","1","0","0","0","0","0","0","0","0","0","2","1","1","0","0","0","0","0","0","0","0","0","0","0","0","0","0","0","-2"
"242644","Inter American University of Puerto Rico-Barranquitas","2018","On-tenure track, assistant professors","4","2","2","0","0","0","0","0","0","0","0","0","4","2","2","0","0","0","0","0","0","0","0","0","0","0","0","0","0","0","-2"
"242644","Inter American University of Puerto Rico-Barranquitas","2018","On-tenure track, instructors","4","1","3","0","0","0","0","0","0","0","0","0","4","1","3","0","0","0","0","0","0","0","0","0","0","0","0","0","0","0","-2"
"242644","Inter American University of Puerto Rico-Barranquitas","2018","Not on tenure track/No tenure system system total","8","3","5","0","0","0","0","0","0","0","0","0","8","3","5","0","0","0","0","0","0","0","0","0","0","0","0","0","0","0","-2"
"242644","Inter American University of Puerto Rico-Barranquitas","2018","Not on tenure/no tenure system, assistant professors","5","2","3","0","0","0","0","0","0","0","0","0","5","2","3","0","0","0","0","0","0","0","0","0","0","0","0","0","0","0","-2"
"242644","Inter American University of Puerto Rico-Barranquitas","2018","Not on tenure/no tenure system, instructors","3","1","2","0","0","0","0","0","0","0","0","0","3","1","2","0","0","0","0","0","0","0","0","0","0","0","0","0","0","0","-2"
"242653","Inter American University of Puerto Rico-Metro","2018","Tenured total","140","63","77","11","0","11","0","0","0","0","0","0","128","62","66","0","0","0","1","1","0","0","0","0","0","0","0","0","0","0","-2"
"242653","Inter American University of Puerto Rico-Metro","2018","Tenured, professors","56","24","32","0","0","0","0","0","0","0","0","0","55","23","32","0","0","0","1","1","0","0","0","0","0","0","0","0","0","0","-2"
"242653","Inter American University of Puerto Rico-Metro","2018","Tenured, associate professors","64","30","34","0","0","0","0","0","0","0","0","0","64","30","34","0","0","0","0","0","0","0","0","0","0","0","0","0","0","0","-2"
"242653","Inter American University of Puerto Rico-Metro","2018","Tenured, assistant professors","20","9","11","11","0","11","0","0","0","0","0","0","9","9","0","0","0","0","0","0","0","0","0","0","0","0","0","0","0","0","-2"
"242653","Inter American University of Puerto Rico-Metro","2018","On-Tenure track total","16","6","10","0","0","0","0","0","0","0","0","0","16","6","10","0","0","0","0","0","0","0","0","0","0","0","0","0","0","0","-2"
"242653","Inter American University of Puerto Rico-Metro","2018","On-tenure track, professors","1","1","0","0","0","0","0","0","0","0","0","0","1","1","0","0","0","0","0","0","0","0","0","0","0","0","0","0","0","0","-2"
"242653","Inter American University of Puerto Rico-Metro","2018","On-tenure track, associate professors","2","2","0","0","0","0","0","0","0","0","0","0","2","2","0","0","0","0","0","0","0","0","0","0","0","0","0","0","0","0","-2"
"242653","Inter American University of Puerto Rico-Metro","2018","On-tenure track, assistant professors","9","2","7","0","0","0","0","0","0","0","0","0","9","2","7","0","0","0","0","0","0","0","0","0","0","0","0","0","0","0","-2"
"242653","Inter American University of Puerto Rico-Metro","2018","On-tenure track, instructors","4","1","3","0","0","0","0","0","0","0","0","0","4","1","3","0","0","0","0","0","0","0","0","0","0","0","0","0","0","0","-2"
"242653","Inter American University of Puerto Rico-Metro","2018","Not on tenure track/No tenure system system total","32","15","17","0","0","0","0","0","0","0","0","0","32","15","17","0","0","0","0","0","0","0","0","0","0","0","0","0","0","0","-2"
"242653","Inter American University of Puerto Rico-Metro","2018","Not on tenure/no tenure system, professors","3","2","1","0","0","0","0","0","0","0","0","0","3","2","1","0","0","0","0","0","0","0","0","0","0","0","0","0","0","0","-2"
"242653","Inter American University of Puerto Rico-Metro","2018","Not on tenure/no tenure system, associate professors","1","1","0","0","0","0","0","0","0","0","0","0","1","1","0","0","0","0","0","0","0","0","0","0","0","0","0","0","0","0","-2"
"242653","Inter American University of Puerto Rico-Metro","2018","Not on tenure/no tenure system, assistant professors","16","7","9","0","0","0","0","0","0","0","0","0","16","7","9","0","0","0","0","0","0","0","0","0","0","0","0","0","0","0","-2"
"242653","Inter American University of Puerto Rico-Metro","2018","Not on tenure/no tenure system, instructors","12","5","7","0","0","0","0","0","0","0","0","0","12","5","7","0","0","0","0","0","0","0","0","0","0","0","0","0","0","0","-2"
"242662","Inter American University of Puerto Rico-Ponce","2018","Tenured total","57","27","30","0","0","0","0","0","0","0","0","0","57","27","30","0","0","0","0","0","0","0","0","0","0","0","0","0","0","0","-2"
"242662","Inter American University of Puerto Rico-Ponce","2018","Tenured, professors","11","5","6","0","0","0","0","0","0","0","0","0","11","5","6","0","0","0","0","0","0","0","0","0","0","0","0","0","0","0","-2"
"242662","Inter American University of Puerto Rico-Ponce","2018","Tenured, associate professors","29","16","13","0","0","0","0","0","0","0","0","0","29","16","13","0","0","0","0","0","0","0","0","0","0","0","0","0","0","0","-2"
"242662","Inter American University of Puerto Rico-Ponce","2018","Tenured, assistant professors","17","6","11","0","0","0","0","0","0","0","0","0","17","6","11","0","0","0","0","0","0","0","0","0","0","0","0","0","0","0","-2"
"242662","Inter American University of Puerto Rico-Ponce","2018","On-Tenure track total","32","13","19","0","0","0","0","0","0","0","0","0","30","12","18","0","0","0","2","1","1","0","0","0","0","0","0","0","0","0","-2"
"242662","Inter American University of Puerto Rico-Ponce","2018","On-tenure track, professors","2","1","1","0","0","0","0","0","0","0","0","0","2","1","1","0","0","0","0","0","0","0","0","0","0","0","0","0","0","0","-2"
"242662","Inter American University of Puerto Rico-Ponce","2018","On-tenure track, associate professors","7","5","2","0","0","0","0","0","0","0","0","0","6","4","2","0","0","0","1","1","0","0","0","0","0","0","0","0","0","0","-2"
"242662","Inter American University of Puerto Rico-Ponce","2018","On-tenure track, assistant professors","15","4","11","0","0","0","0","0","0","0","0","0","14","4","10","0","0","0","1","0","1","0","0","0","0","0","0","0","0","0","-2"
"242662","Inter American University of Puerto Rico-Ponce","2018","On-tenure track, instructors","8","3","5","0","0","0","0","0","0","0","0","0","8","3","5","0","0","0","0","0","0","0","0","0","0","0","0","0","0","0","-2"
"242662","Inter American University of Puerto Rico-Ponce","2018","Not on tenure track/No tenure system system total","15","2","13","0","0","0","0","0","0","0","0","0","15","2","13","0","0","0","0","0","0","0","0","0","0","0","0","0","0","0","-2"
"242662","Inter American University of Puerto Rico-Ponce","2018","Not on tenure/no tenure system, assistant professors","6","0","6","0","0","0","0","0","0","0","0","0","6","0","6","0","0","0","0","0","0","0","0","0","0","0","0","0","0","0","-2"
"242662","Inter American University of Puerto Rico-Ponce","2018","Not on tenure/no tenure system, instructors","9","2","7","0","0","0","0","0","0","0","0","0","9","2","7","0","0","0","0","0","0","0","0","0","0","0","0","0","0","0","-2"
"242680","Inter American University of Puerto Rico-Fajardo","2018","Tenured total","29","15","14","0","0","0","0","0","0","0","0","0","29","15","14","0","0","0","0","0","0","0","0","0","0","0","0","0","0","0","-2"
"242680","Inter American University of Puerto Rico-Fajardo","2018","Tenured, professors","5","4","1","0","0","0","0","0","0","0","0","0","5","4","1","0","0","0","0","0","0","0","0","0","0","0","0","0","0","0","-2"
"242680","Inter American University of Puerto Rico-Fajardo","2018","Tenured, associate professors","9","4","5","0","0","0","0","0","0","0","0","0","9","4","5","0","0","0","0","0","0","0","0","0","0","0","0","0","0","0","-2"
"242680","Inter American University of Puerto Rico-Fajardo","2018","Tenured, assistant professors","15","7","8","0","0","0","0","0","0","0","0","0","15","7","8","0","0","0","0","0","0","0","0","0","0","0","0","0","0","0","-2"
"242680","Inter American University of Puerto Rico-Fajardo","2018","On-Tenure track total","10","1","9","0","0","0","0","0","0","0","0","0","10","1","9","0","0","0","0","0","0","0","0","0","0","0","0","0","0","0","-2"
"242680","Inter American University of Puerto Rico-Fajardo","2018","On-tenure track, associate professors","1","0","1","0","0","0","0","0","0","0","0","0","1","0","1","0","0","0","0","0","0","0","0","0","0","0","0","0","0","0","-2"
"242680","Inter American University of Puerto Rico-Fajardo","2018","On-tenure track, assistant professors","8","1","7","0","0","0","0","0","0","0","0","0","8","1","7","0","0","0","0","0","0","0","0","0","0","0","0","0","0","0","-2"
"242680","Inter American University of Puerto Rico-Fajardo","2018","On-tenure track, instructors","1","0","1","0","0","0","0","0","0","0","0","0","1","0","1","0","0","0","0","0","0","0","0","0","0","0","0","0","0","0","-2"
"242680","Inter American University of Puerto Rico-Fajardo","2018","Not on tenure track/No tenure system system total","2","1","1","0","0","0","0","0","0","0","0","0","2","1","1","0","0","0","0","0","0","0","0","0","0","0","0","0","0","0","-2"
"242680","Inter American University of Puerto Rico-Fajardo","2018","Not on tenure/no tenure system, assistant professors","2","1","1","0","0","0","0","0","0","0","0","0","2","1","1","0","0","0","0","0","0","0","0","0","0","0","0","0","0","0","-2"
"242699","Inter American University of Puerto Rico-Guayama","2018","Tenured total","23","9","14","0","0","0","0","0","0","0","0","0","23","9","14","0","0","0","0","0","0","0","0","0","0","0","0","0","0","0","-2"
"242699","Inter American University of Puerto Rico-Guayama","2018","Tenured, professors","3","2","1","0","0","0","0","0","0","0","0","0","3","2","1","0","0","0","0","0","0","0","0","0","0","0","0","0","0","0","-2"
"242699","Inter American University of Puerto Rico-Guayama","2018","Tenured, associate professors","7","2","5","0","0","0","0","0","0","0","0","0","7","2","5","0","0","0","0","0","0","0","0","0","0","0","0","0","0","0","-2"
"242699","Inter American University of Puerto Rico-Guayama","2018","Tenured, assistant professors","13","5","8","0","0","0","0","0","0","0","0","0","13","5","8","0","0","0","0","0","0","0","0","0","0","0","0","0","0","0","-2"
"242699","Inter American University of Puerto Rico-Guayama","2018","On-Tenure track total","5","4","1","0","0","0","0","0","0","0","0","0","5","4","1","0","0","0","0","0","0","0","0","0","0","0","0","0","0","0","-2"
"242699","Inter American University of Puerto Rico-Guayama","2018","On-tenure track, assistant professors","5","4","1","0","0","0","0","0","0","0","0","0","5","4","1","0","0","0","0","0","0","0","0","0","0","0","0","0","0","0","-2"
"242699","Inter American University of Puerto Rico-Guayama","2018","Not on tenure track/No tenure system system total","4","0","4","0","0","0","0","0","0","0","0","0","4","0","4","0","0","0","0","0","0","0","0","0","0","0","0","0","0","0","-2"
"242699","Inter American University of Puerto Rico-Guayama","2018","Not on tenure/no tenure system, assistant professors","1","0","1","0","0","0","0","0","0","0","0","0","1","0","1","0","0","0","0","0","0","0","0","0","0","0","0","0","0","0","-2"
"242699","Inter American University of Puerto Rico-Guayama","2018","Not on tenure/no tenure system, instructors","3","0","3","0","0","0","0","0","0","0","0","0","3","0","3","0","0","0","0","0","0","0","0","0","0","0","0","0","0","0","-2"
"242705","Inter American University of Puerto Rico-Bayamon","2018","Tenured total","52","34","18","0","0","0","0","0","0","0","0","0","51","33","18","0","0","0","1","1","0","0","0","0","0","0","0","0","0","0","-2"
"242705","Inter American University of Puerto Rico-Bayamon","2018","Tenured, professors","12","11","1","0","0","0","0","0","0","0","0","0","11","10","1","0","0","0","1","1","0","0","0","0","0","0","0","0","0","0","-2"
"242705","Inter American University of Puerto Rico-Bayamon","2018","Tenured, associate professors","20","11","9","0","0","0","0","0","0","0","0","0","20","11","9","0","0","0","0","0","0","0","0","0","0","0","0","0","0","0","-2"
"242705","Inter American University of Puerto Rico-Bayamon","2018","Tenured, assistant professors","20","12","8","0","0","0","0","0","0","0","0","0","20","12","8","0","0","0","0","0","0","0","0","0","0","0","0","0","0","0","-2"
"242705","Inter American University of Puerto Rico-Bayamon","2018","On-Tenure track total","28","15","13","0","0","0","0","0","0","0","0","0","27","14","13","0","0","0","1","1","0","0","0","0","0","0","0","0","0","0","-2"
"242705","Inter American University of Puerto Rico-Bayamon","2018","On-tenure track, professors","2","2","0","0","0","0","0","0","0","0","0","0","2","2","0","0","0","0","0","0","0","0","0","0","0","0","0","0","0","0","-2"
"242705","Inter American University of Puerto Rico-Bayamon","2018","On-tenure track, associate professors","7","4","3","0","0","0","0","0","0","0","0","0","7","4","3","0","0","0","0","0","0","0","0","0","0","0","0","0","0","0","-2"
"242705","Inter American University of Puerto Rico-Bayamon","2018","On-tenure track, assistant professors","11","5","6","0","0","0","0","0","0","0","0","0","10","4","6","0","0","0","1","1","0","0","0","0","0","0","0","0","0","0","-2"
"242705","Inter American University of Puerto Rico-Bayamon","2018","On-tenure track, instructors","8","4","4","0","0","0","0","0","0","0","0","0","8","4","4","0","0","0","0","0","0","0","0","0","0","0","0","0","0","0","-2"
"242705","Inter American University of Puerto Rico-Bayamon","2018","Not on tenure track/No tenure system system total","13","8","5","0","0","0","0","0","0","0","0","0","12","8","4","1","0","1","0","0","0","0","0","0","0","0","0","0","0","0","-2"
"242705","Inter American University of Puerto Rico-Bayamon","2018","Not on tenure/no tenure system, assistant professors","5","3","2","0","0","0","0","0","0","0","0","0","5","3","2","0","0","0","0","0","0","0","0","0","0","0","0","0","0","0","-2"
"242705","Inter American University of Puerto Rico-Bayamon","2018","Not on tenure/no tenure system, instructors","8","5","3","0","0","0","0","0","0","0","0","0","7","5","2","1","0","1","0","0","0","0","0","0","0","0","0","0","0","0","-2"
"243106","University of Puerto Rico-Aguadilla","2018","Tenured total","77","42","35","0","0","0","0","0","0","0","0","0","76","41","35","0","0","0","1","1","0","0","0","0","0","0","0","0","0","0","-2"
"243106","University of Puerto Rico-Aguadilla","2018","Tenured, professors","43","24","19","0","0","0","0","0","0","0","0","0","43","24","19","0","0","0","0","0","0","0","0","0","0","0","0","0","0","0","-2"
"243106","University of Puerto Rico-Aguadilla","2018","Tenured, associate professors","25","15","10","0","0","0","0","0","0","0","0","0","25","15","10","0","0","0","0","0","0","0","0","0","0","0","0","0","0","0","-2"
"243106","University of Puerto Rico-Aguadilla","2018","Tenured, assistant professors","8","2","6","0","0","0","0","0","0","0","0","0","7","1","6","0","0","0","1","1","0","0","0","0","0","0","0","0","0","0","-2"
"243106","University of Puerto Rico-Aguadilla","2018","Tenured, instructors","1","1","0","0","0","0","0","0","0","0","0","0","1","1","0","0","0","0","0","0","0","0","0","0","0","0","0","0","0","0","-2"
"243106","University of Puerto Rico-Aguadilla","2018","On-Tenure track total","2","2","0","0","0","0","0","0","0","0","0","0","2","2","0","0","0","0","0","0","0","0","0","0","0","0","0","0","0","0","-2"
"243106","University of Puerto Rico-Aguadilla","2018","On-tenure track, assistant professors","1","1","0","0","0","0","0","0","0","0","0","0","1","1","0","0","0","0","0","0","0","0","0","0","0","0","0","0","0","0","-2"
"243106","University of Puerto Rico-Aguadilla","2018","On-tenure track, instructors","1","1","0","0","0","0","0","0","0","0","0","0","1","1","0","0","0","0","0","0","0","0","0","0","0","0","0","0","0","0","-2"
"243106","University of Puerto Rico-Aguadilla","2018","Not on tenure track/No tenure system system total","21","12","9","0","0","0","0","0","0","0","0","0","20","12","8","0","0","0","0","0","0","0","0","0","1","0","1","0","0","0","-2"
"243106","University of Puerto Rico-Aguadilla","2018","Not on tenure/no tenure system, assistant professors","8","4","4","0","0","0","0","0","0","0","0","0","8","4","4","0","0","0","0","0","0","0","0","0","0","0","0","0","0","0","-2"
"243106","University of Puerto Rico-Aguadilla","2018","Not on tenure/no tenure system, instructors","13","8","5","0","0","0","0","0","0","0","0","0","12","8","4","0","0","0","0","0","0","0","0","0","1","0","1","0","0","0","-2"
"243115","University of Puerto Rico-Arecibo","2018","Tenured total","125","63","62","0","0","0","0","0","0","0","0","0","125","63","62","0","0","0","0","0","0","0","0","0","0","0","0","0","0","0","-2"
"243115","University of Puerto Rico-Arecibo","2018","Tenured, professors","72","35","37","0","0","0","0","0","0","0","0","0","72","35","37","0","0","0","0","0","0","0","0","0","0","0","0","0","0","0","-2"
"243115","University of Puerto Rico-Arecibo","2018","Tenured, associate professors","30","13","17","0","0","0","0","0","0","0","0","0","30","13","17","0","0","0","0","0","0","0","0","0","0","0","0","0","0","0","-2"
"243115","University of Puerto Rico-Arecibo","2018","Tenured, assistant professors","20","12","8","0","0","0","0","0","0","0","0","0","20","12","8","0","0","0","0","0","0","0","0","0","0","0","0","0","0","0","-2"
"243115","University of Puerto Rico-Arecibo","2018","Tenured, instructors","3","3","0","0","0","0","0","0","0","0","0","0","3","3","0","0","0","0","0","0","0","0","0","0","0","0","0","0","0","0","-2"
"243115","University of Puerto Rico-Arecibo","2018","On-Tenure track total","10","5","5","0","0","0","0","0","0","0","0","0","9","4","5","0","0","0","0","0","0","0","0","0","1","1","0","0","0","0","-2"
"243115","University of Puerto Rico-Arecibo","2018","On-tenure track, associate professors","1","0","1","0","0","0","0","0","0","0","0","0","1","0","1","0","0","0","0","0","0","0","0","0","0","0","0","0","0","0","-2"
"243115","University of Puerto Rico-Arecibo","2018","On-tenure track, assistant professors","7","4","3","0","0","0","0","0","0","0","0","0","6","3","3","0","0","0","0","0","0","0","0","0","1","1","0","0","0","0","-2"
"243115","University of Puerto Rico-Arecibo","2018","On-tenure track, instructors","1","0","1","0","0","0","0","0","0","0","0","0","1","0","1","0","0","0","0","0","0","0","0","0","0","0","0","0","0","0","-2"
"243115","University of Puerto Rico-Arecibo","2018","On-tenure track, no academic rank","1","1","0","0","0","0","0","0","0","0","0","0","1","1","0","0","0","0","0","0","0","0","0","0","0","0","0","0","0","0","-2"
"243115","University of Puerto Rico-Arecibo","2018","Not on tenure track/No tenure system system total","9","1","8","0","0","0","0","0","0","0","0","0","8","1","7","0","0","0","0","0","0","0","0","0","1","0","1","0","0","0","-2"
"243115","University of Puerto Rico-Arecibo","2018","Not on tenure/no tenure system, assistant professors","1","0","1","0","0","0","0","0","0","0","0","0","1","0","1","0","0","0","0","0","0","0","0","0","0","0","0","0","0","0","-2"
"243115","University of Puerto Rico-Arecibo","2018","Not on tenure/no tenure system, instructors","8","1","7","0","0","0","0","0","0","0","0","0","7","1","6","0","0","0","0","0","0","0","0","0","1","0","1","0","0","0","-2"
"243133","University of Puerto Rico-Bayamon","2018","Tenured total","129","65","64","0","0","0","0","0","0","0","0","0","129","65","64","0","0","0","0","0","0","0","0","0","0","0","0","0","0","0","-2"
"243133","University of Puerto Rico-Bayamon","2018","Tenured, professors","53","31","22","0","0","0","0","0","0","0","0","0","53","31","22","0","0","0","0","0","0","0","0","0","0","0","0","0","0","0","-2"
"243133","University of Puerto Rico-Bayamon","2018","Tenured, associate professors","39","17","22","0","0","0","0","0","0","0","0","0","39","17","22","0","0","0","0","0","0","0","0","0","0","0","0","0","0","0","-2"
"243133","University of Puerto Rico-Bayamon","2018","Tenured, assistant professors","25","12","13","0","0","0","0","0","0","0","0","0","25","12","13","0","0","0","0","0","0","0","0","0","0","0","0","0","0","0","-2"
"243133","University of Puerto Rico-Bayamon","2018","Tenured, instructors","2","1","1","0","0","0","0","0","0","0","0","0","2","1","1","0","0","0","0","0","0","0","0","0","0","0","0","0","0","0","-2"
"243133","University of Puerto Rico-Bayamon","2018","Tenured, no academic rank","10","4","6","0","0","0","0","0","0","0","0","0","10","4","6","0","0","0","0","0","0","0","0","0","0","0","0","0","0","0","-2"
"243133","University of Puerto Rico-Bayamon","2018","On-Tenure track total","7","2","5","0","0","0","0","0","0","0","0","0","7","2","5","0","0","0","0","0","0","0","0","0","0","0","0","0","0","0","-2"
"243133","University of Puerto Rico-Bayamon","2018","On-tenure track, associate professors","2","0","2","0","0","0","0","0","0","0","0","0","2","0","2","0","0","0","0","0","0","0","0","0","0","0","0","0","0","0","-2"
"243133","University of Puerto Rico-Bayamon","2018","On-tenure track, assistant professors","4","2","2","0","0","0","0","0","0","0","0","0","4","2","2","0","0","0","0","0","0","0","0","0","0","0","0","0","0","0","-2"
"243133","University of Puerto Rico-Bayamon","2018","On-tenure track, no academic rank","1","0","1","0","0","0","0","0","0","0","0","0","1","0","1","0","0","0","0","0","0","0","0","0","0","0","0","0","0","0","-2"
"243133","University of Puerto Rico-Bayamon","2018","Not on tenure track/No tenure system system total","38","19","19","0","0","0","0","0","0","0","0","0","38","19","19","0","0","0","0","0","0","0","0","0","0","0","0","0","0","0","-2"
"243133","University of Puerto Rico-Bayamon","2018","Not on tenure/no tenure system, assistant professors","17","6","11","0","0","0","0","0","0","0","0","0","17","6","11","0","0","0","0","0","0","0","0","0","0","0","0","0","0","0","-2"
"243133","University of Puerto Rico-Bayamon","2018","Not on tenure/no tenure system, instructors","19","12","7","0","0","0","0","0","0","0","0","0","19","12","7","0","0","0","0","0","0","0","0","0","0","0","0","0","0","0","-2"
"243133","University of Puerto Rico-Bayamon","2018","Not on tenure/no tenure system, no academic rank","2","1","1","0","0","0","0","0","0","0","0","0","2","1","1","0","0","0","0","0","0","0","0","0","0","0","0","0","0","0","-2"
"243142","University of Puerto Rico-Carolina","2018","Tenured total","62","36","26","0","0","0","0","0","0","0","0","0","61","35","26","0","0","0","1","1","0","0","0","0","0","0","0","0","0","0","-2"
"243142","University of Puerto Rico-Carolina","2018","Tenured, professors","19","13","6","0","0","0","0","0","0","0","0","0","18","12","6","0","0","0","1","1","0","0","0","0","0","0","0","0","0","0","-2"
"243142","University of Puerto Rico-Carolina","2018","Tenured, associate professors","28","13","15","0","0","0","0","0","0","0","0","0","28","13","15","0","0","0","0","0","0","0","0","0","0","0","0","0","0","0","-2"
"243142","University of Puerto Rico-Carolina","2018","Tenured, assistant professors","13","8","5","0","0","0","0","0","0","0","0","0","13","8","5","0","0","0","0","0","0","0","0","0","0","0","0","0","0","0","-2"
"243142","University of Puerto Rico-Carolina","2018","Tenured, instructors","2","2","0","0","0","0","0","0","0","0","0","0","2","2","0","0","0","0","0","0","0","0","0","0","0","0","0","0","0","0","-2"
"243142","University of Puerto Rico-Carolina","2018","On-Tenure track total","11","6","5","0","0","0","0","0","0","0","0","0","11","6","5","0","0","0","0","0","0","0","0","0","0","0","0","0","0","0","-2"
"243142","University of Puerto Rico-Carolina","2018","On-tenure track, assistant professors","5","3","2","0","0","0","0","0","0","0","0","0","5","3","2","0","0","0","0","0","0","0","0","0","0","0","0","0","0","0","-2"
"243142","University of Puerto Rico-Carolina","2018","On-tenure track, instructors","6","3","3","0","0","0","0","0","0","0","0","0","6","3","3","0","0","0","0","0","0","0","0","0","0","0","0","0","0","0","-2"
"243142","University of Puerto Rico-Carolina","2018","Not on tenure track/No tenure system system total","17","5","12","0","0","0","0","0","0","0","0","0","17","5","12","0","0","0","0","0","0","0","0","0","0","0","0","0","0","0","-2"
"243142","University of Puerto Rico-Carolina","2018","Not on tenure/no tenure system, assistant professors","6","2","4","0","0","0","0","0","0","0","0","0","6","2","4","0","0","0","0","0","0","0","0","0","0","0","0","0","0","0","-2"
"243142","University of Puerto Rico-Carolina","2018","Not on tenure/no tenure system, instructors","11","3","8","0","0","0","0","0","0","0","0","0","11","3","8","0","0","0","0","0","0","0","0","0","0","0","0","0","0","0","-2"
"243151","University of Puerto Rico-Cayey","2018","Tenured total","69","40","29","0","0","0","0","0","0","0","0","0","69","40","29","0","0","0","0","0","0","0","0","0","0","0","0","0","0","0","-2"
"243151","University of Puerto Rico-Cayey","2018","Tenured, professors","37","22","15","0","0","0","0","0","0","0","0","0","37","22","15","0","0","0","0","0","0","0","0","0","0","0","0","0","0","0","-2"
"243151","University of Puerto Rico-Cayey","2018","Tenured, associate professors","9","5","4","0","0","0","0","0","0","0","0","0","9","5","4","0","0","0","0","0","0","0","0","0","0","0","0","0","0","0","-2"
"243151","University of Puerto Rico-Cayey","2018","Tenured, assistant professors","23","13","10","0","0","0","0","0","0","0","0","0","23","13","10","0","0","0","0","0","0","0","0","0","0","0","0","0","0","0","-2"
"243151","University of Puerto Rico-Cayey","2018","On-Tenure track total","18","10","8","0","0","0","0","0","0","0","0","0","18","10","8","0","0","0","0","0","0","0","0","0","0","0","0","0","0","0","-2"
"243151","University of Puerto Rico-Cayey","2018","On-tenure track, associate professors","11","5","6","0","0","0","0","0","0","0","0","0","11","5","6","0","0","0","0","0","0","0","0","0","0","0","0","0","0","0","-2"
"243151","University of Puerto Rico-Cayey","2018","On-tenure track, assistant professors","7","5","2","0","0","0","0","0","0","0","0","0","7","5","2","0","0","0","0","0","0","0","0","0","0","0","0","0","0","0","-2"
"243151","University of Puerto Rico-Cayey","2018","Not on tenure track/No tenure system system total","32","15","17","0","0","0","0","0","0","0","0","0","32","15","17","0","0","0","0","0","0","0","0","0","0","0","0","0","0","0","-2"
"243151","University of Puerto Rico-Cayey","2018","Not on tenure/no tenure system, associate professors","26","12","14","0","0","0","0","0","0","0","0","0","26","12","14","0","0","0","0","0","0","0","0","0","0","0","0","0","0","0","-2"
"243151","University of Puerto Rico-Cayey","2018","Not on tenure/no tenure system, instructors","6","3","3","0","0","0","0","0","0","0","0","0","6","3","3","0","0","0","0","0","0","0","0","0","0","0","0","0","0","0","-2"
"243179","University of Puerto Rico-Humacao","2018","Tenured total","119","65","54","1","1","0","0","0","0","0","0","0","112","62","50","0","0","0","6","2","4","0","0","0","0","0","0","0","0","0","-2"
"243179","University of Puerto Rico-Humacao","2018","Tenured, professors","79","43","36","1","1","0","0","0","0","0","0","0","72","40","32","0","0","0","6","2","4","0","0","0","0","0","0","0","0","0","-2"
"243179","University of Puerto Rico-Humacao","2018","Tenured, associate professors","31","14","17","0","0","0","0","0","0","0","0","0","31","14","17","0","0","0","0","0","0","0","0","0","0","0","0","0","0","0","-2"
"243179","University of Puerto Rico-Humacao","2018","Tenured, assistant professors","9","8","1","0","0","0","0","0","0","0","0","0","9","8","1","0","0","0","0","0","0","0","0","0","0","0","0","0","0","0","-2"
"243179","University of Puerto Rico-Humacao","2018","On-Tenure track total","14","4","10","0","0","0","0","0","0","0","0","0","14","4","10","0","0","0","0","0","0","0","0","0","0","0","0","0","0","0","-2"
"243179","University of Puerto Rico-Humacao","2018","On-tenure track, associate professors","4","1","3","0","0","0","0","0","0","0","0","0","4","1","3","0","0","0","0","0","0","0","0","0","0","0","0","0","0","0","-2"
"243179","University of Puerto Rico-Humacao","2018","On-tenure track, assistant professors","8","3","5","0","0","0","0","0","0","0","0","0","8","3","5","0","0","0","0","0","0","0","0","0","0","0","0","0","0","0","-2"
"243179","University of Puerto Rico-Humacao","2018","On-tenure track, instructors","2","0","2","0","0","0","0","0","0","0","0","0","2","0","2","0","0","0","0","0","0","0","0","0","0","0","0","0","0","0","-2"
"243179","University of Puerto Rico-Humacao","2018","Not on tenure track/No tenure system system total","12","3","9","0","0","0","0","0","0","0","0","0","10","2","8","0","0","0","0","0","0","0","0","0","2","1","1","0","0","0","-2"
"243179","University of Puerto Rico-Humacao","2018","Not on tenure/no tenure system, assistant professors","3","2","1","0","0","0","0","0","0","0","0","0","2","1","1","0","0","0","0","0","0","0","0","0","1","1","0","0","0","0","-2"
"243179","University of Puerto Rico-Humacao","2018","Not on tenure/no tenure system, instructors","9","1","8","0","0","0","0","0","0","0","0","0","8","1","7","0","0","0","0","0","0","0","0","0","1","0","1","0","0","0","-2"
"243188","University of Puerto Rico-Utuado","2018","Tenured total","41","24","17","0","0","0","0","0","0","0","0","0","41","24","17","0","0","0","0","0","0","0","0","0","0","0","0","0","0","0","-2"
"243188","University of Puerto Rico-Utuado","2018","Tenured, professors","18","10","8","0","0","0","0","0","0","0","0","0","18","10","8","0","0","0","0","0","0","0","0","0","0","0","0","0","0","0","-2"
"243188","University of Puerto Rico-Utuado","2018","Tenured, associate professors","9","5","4","0","0","0","0","0","0","0","0","0","9","5","4","0","0","0","0","0","0","0","0","0","0","0","0","0","0","0","-2"
"243188","University of Puerto Rico-Utuado","2018","Tenured, assistant professors","12","7","5","0","0","0","0","0","0","0","0","0","12","7","5","0","0","0","0","0","0","0","0","0","0","0","0","0","0","0","-2"
"243188","University of Puerto Rico-Utuado","2018","Tenured, instructors","2","2","0","0","0","0","0","0","0","0","0","0","2","2","0","0","0","0","0","0","0","0","0","0","0","0","0","0","0","0","-2"
"243188","University of Puerto Rico-Utuado","2018","On-Tenure track total","3","2","1","0","0","0","0","0","0","0","0","0","2","1","1","0","0","0","0","0","0","0","0","0","1","1","0","0","0","0","-2"
"243188","University of Puerto Rico-Utuado","2018","On-tenure track, assistant professors","3","2","1","0","0","0","0","0","0","0","0","0","2","1","1","0","0","0","0","0","0","0","0","0","1","1","0","0","0","0","-2"
"243188","University of Puerto Rico-Utuado","2018","Not on tenure track/No tenure system system total","7","4","3","0","0","0","0","0","0","0","0","0","7","4","3","0","0","0","0","0","0","0","0","0","0","0","0","0","0","0","-2"
"243188","University of Puerto Rico-Utuado","2018","Not on tenure/no tenure system, assistant professors","2","0","2","0","0","0","0","0","0","0","0","0","2","0","2","0","0","0","0","0","0","0","0","0","0","0","0","0","0","0","-2"
"243188","University of Puerto Rico-Utuado","2018","Not on tenure/no tenure system, instructors","5","4","1","0","0","0","0","0","0","0","0","0","5","4","1","0","0","0","0","0","0","0","0","0","0","0","0","0","0","0","-2"
"243197","University of Puerto Rico-Mayaguez","2018","Tenured total","402","261","141","0","0","0","0","0","0","0","0","0","401","260","141","0","0","0","1","1","0","0","0","0","0","0","0","0","0","0","-2"
"243197","University of Puerto Rico-Mayaguez","2018","Tenured, professors","328","222","106","0","0","0","0","0","0","0","0","0","327","221","106","0","0","0","1","1","0","0","0","0","0","0","0","0","0","0","-2"
"243197","University of Puerto Rico-Mayaguez","2018","Tenured, associate professors","66","35","31","0","0","0","0","0","0","0","0","0","66","35","31","0","0","0","0","0","0","0","0","0","0","0","0","0","0","0","-2"
"243197","University of Puerto Rico-Mayaguez","2018","Tenured, assistant professors","8","4","4","0","0","0","0","0","0","0","0","0","8","4","4","0","0","0","0","0","0","0","0","0","0","0","0","0","0","0","-2"
"243197","University of Puerto Rico-Mayaguez","2018","On-Tenure track total","47","25","22","0","0","0","0","0","0","0","0","0","45","23","22","0","0","0","0","0","0","0","0","0","2","2","0","0","0","0","-2"
"243197","University of Puerto Rico-Mayaguez","2018","On-tenure track, professors","1","0","1","0","0","0","0","0","0","0","0","0","1","0","1","0","0","0","0","0","0","0","0","0","0","0","0","0","0","0","-2"
"243197","University of Puerto Rico-Mayaguez","2018","On-tenure track, associate professors","27","15","12","0","0","0","0","0","0","0","0","0","27","15","12","0","0","0","0","0","0","0","0","0","0","0","0","0","0","0","-2"
"243197","University of Puerto Rico-Mayaguez","2018","On-tenure track, assistant professors","19","10","9","0","0","0","0","0","0","0","0","0","17","8","9","0","0","0","0","0","0","0","0","0","2","2","0","0","0","0","-2"
"243197","University of Puerto Rico-Mayaguez","2018","Not on tenure track/No tenure system system total","26","12","14","0","0","0","0","0","0","0","0","0","18","8","10","0","0","0","0","0","0","0","0","0","8","4","4","0","0","0","-2"
"243197","University of Puerto Rico-Mayaguez","2018","Not on tenure/no tenure system, professors","2","2","0","0","0","0","0","0","0","0","0","0","2","2","0","0","0","0","0","0","0","0","0","0","0","0","0","0","0","0","-2"
"243197","University of Puerto Rico-Mayaguez","2018","Not on tenure/no tenure system, associate professors","1","0","1","0","0","0","0","0","0","0","0","0","1","0","1","0","0","0","0","0","0","0","0","0","0","0","0","0","0","0","-2"
"243197","University of Puerto Rico-Mayaguez","2018","Not on tenure/no tenure system, assistant professors","23","10","13","0","0","0","0","0","0","0","0","0","15","6","9","0","0","0","0","0","0","0","0","0","8","4","4","0","0","0","-2"
"243203","University of Puerto Rico-Medical Sciences","2018","Tenured total","387","166","221","0","0","0","0","0","0","1","1","0","366","155","211","0","0","0","16","9","7","0","0","0","4","1","3","0","0","0","-2"
"243203","University of Puerto Rico-Medical Sciences","2018","Tenured, professors","253","115","138","0","0","0","0","0","0","1","1","0","237","105","132","0","0","0","12","8","4","0","0","0","3","1","2","0","0","0","-2"
"243203","University of Puerto Rico-Medical Sciences","2018","Tenured, associate professors","81","32","49","0","0","0","0","0","0","0","0","0","78","32","46","0","0","0","2","0","2","0","0","0","1","0","1","0","0","0","-2"
"243203","University of Puerto Rico-Medical Sciences","2018","Tenured, assistant professors","32","12","20","0","0","0","0","0","0","0","0","0","32","12","20","0","0","0","0","0","0","0","0","0","0","0","0","0","0","0","-2"
"243203","University of Puerto Rico-Medical Sciences","2018","Tenured, instructors","5","2","3","0","0","0","0","0","0","0","0","0","4","2","2","0","0","0","1","0","1","0","0","0","0","0","0","0","0","0","-2"
"243203","University of Puerto Rico-Medical Sciences","2018","Tenured, no academic rank","16","5","11","0","0","0","0","0","0","0","0","0","15","4","11","0","0","0","1","1","0","0","0","0","0","0","0","0","0","0","-2"
"243203","University of Puerto Rico-Medical Sciences","2018","On-Tenure track total","81","35","46","1","1","0","0","0","0","0","0","0","74","30","44","0","0","0","3","3","0","0","0","0","3","1","2","0","0","0","-2"
"243203","University of Puerto Rico-Medical Sciences","2018","On-tenure track, professors","18","10","8","0","0","0","0","0","0","0","0","0","17","10","7","0","0","0","0","0","0","0","0","0","1","0","1","0","0","0","-2"
"243203","University of Puerto Rico-Medical Sciences","2018","On-tenure track, associate professors","18","7","11","0","0","0","0","0","0","0","0","0","18","7","11","0","0","0","0","0","0","0","0","0","0","0","0","0","0","0","-2"
"243203","University of Puerto Rico-Medical Sciences","2018","On-tenure track, assistant professors","31","14","17","1","1","0","0","0","0","0","0","0","27","10","17","0","0","0","2","2","0","0","0","0","1","1","0","0","0","0","-2"
"243203","University of Puerto Rico-Medical Sciences","2018","On-tenure track, instructors","5","1","4","0","0","0","0","0","0","0","0","0","5","1","4","0","0","0","0","0","0","0","0","0","0","0","0","0","0","0","-2"
"243203","University of Puerto Rico-Medical Sciences","2018","On-tenure track, no academic rank","9","3","6","0","0","0","0","0","0","0","0","0","7","2","5","0","0","0","1","1","0","0","0","0","1","0","1","0","0","0","-2"
"243203","University of Puerto Rico-Medical Sciences","2018","Not on tenure track/No tenure system system total","217","68","149","0","0","0","1","1","0","0","0","0","198","64","134","1","0","1","9","1","8","0","0","0","8","2","6","0","0","0","-2"
"243203","University of Puerto Rico-Medical Sciences","2018","Not on tenure/no tenure system, professors","18","8","10","0","0","0","0","0","0","0","0","0","16","7","9","0","0","0","1","1","0","0","0","0","1","0","1","0","0","0","-2"
"243203","University of Puerto Rico-Medical Sciences","2018","Not on tenure/no tenure system, associate professors","40","16","24","0","0","0","0","0","0","0","0","0","38","16","22","1","0","1","0","0","0","0","0","0","1","0","1","0","0","0","-2"
"243203","University of Puerto Rico-Medical Sciences","2018","Not on tenure/no tenure system, assistant professors","78","33","45","0","0","0","0","0","0","0","0","0","75","32","43","0","0","0","0","0","0","0","0","0","3","1","2","0","0","0","-2"
"243203","University of Puerto Rico-Medical Sciences","2018","Not on tenure/no tenure system, instructors","12","3","9","0","0","0","0","0","0","0","0","0","11","2","9","0","0","0","0","0","0","0","0","0","1","1","0","0","0","0","-2"
"243203","University of Puerto Rico-Medical Sciences","2018","Not on tenure/no tenure system, no academic rank","69","8","61","0","0","0","1","1","0","0","0","0","58","7","51","0","0","0","8","0","8","0","0","0","2","0","2","0","0","0","-2"
"243212","University of Puerto Rico-Ponce","2018","Tenured total","64","29","35","0","0","0","0","0","0","0","0","0","64","29","35","0","0","0","0","0","0","0","0","0","0","0","0","0","0","0","-2"
"243212","University of Puerto Rico-Ponce","2018","Tenured, professors","26","11","15","0","0","0","0","0","0","0","0","0","26","11","15","0","0","0","0","0","0","0","0","0","0","0","0","0","0","0","-2"
"243212","University of Puerto Rico-Ponce","2018","Tenured, associate professors","18","8","10","0","0","0","0","0","0","0","0","0","18","8","10","0","0","0","0","0","0","0","0","0","0","0","0","0","0","0","-2"
"243212","University of Puerto Rico-Ponce","2018","Tenured, assistant professors","15","5","10","0","0","0","0","0","0","0","0","0","15","5","10","0","0","0","0","0","0","0","0","0","0","0","0","0","0","0","-2"
"243212","University of Puerto Rico-Ponce","2018","Tenured, instructors","5","5","0","0","0","0","0","0","0","0","0","0","5","5","0","0","0","0","0","0","0","0","0","0","0","0","0","0","0","0","-2"
"243212","University of Puerto Rico-Ponce","2018","On-Tenure track total","5","2","3","0","0","0","0","0","0","0","0","0","5","2","3","0","0","0","0","0","0","0","0","0","0","0","0","0","0","0","-2"
"243212","University of Puerto Rico-Ponce","2018","On-tenure track, assistant professors","5","2","3","0","0","0","0","0","0","0","0","0","5","2","3","0","0","0","0","0","0","0","0","0","0","0","0","0","0","0","-2"
"243212","University of Puerto Rico-Ponce","2018","Not on tenure track/No tenure system system total","8","4","4","0","0","0","0","0","0","0","0","0","8","4","4","0","0","0","0","0","0","0","0","0","0","0","0","0","0","0","-2"
"243212","University of Puerto Rico-Ponce","2018","Not on tenure/no tenure system, assistant professors","4","1","3","0","0","0","0","0","0","0","0","0","4","1","3","0","0","0","0","0","0","0","0","0","0","0","0","0","0","0","-2"
"243212","University of Puerto Rico-Ponce","2018","Not on tenure/no tenure system, instructors","4","3","1","0","0","0","0","0","0","0","0","0","4","3","1","0","0","0","0","0","0","0","0","0","0","0","0","0","0","0","-2"
"243221","University of Puerto Rico-Rio Piedras","2018","Tenured total","610","311","299","0","0","0","5","5","0","0","0","0","593","298","295","0","0","0","10","6","4","0","0","0","2","2","0","0","0","0","-2"
"243221","University of Puerto Rico-Rio Piedras","2018","Tenured, professors","433","235","198","0","0","0","4","4","0","0","0","0","422","226","196","0","0","0","7","5","2","0","0","0","0","0","0","0","0","0","-2"
"243221","University of Puerto Rico-Rio Piedras","2018","Tenured, associate professors","120","56","64","0","0","0","1","1","0","0","0","0","115","53","62","0","0","0","2","0","2","0","0","0","2","2","0","0","0","0","-2"
"243221","University of Puerto Rico-Rio Piedras","2018","Tenured, assistant professors","35","14","21","0","0","0","0","0","0","0","0","0","34","13","21","0","0","0","1","1","0","0","0","0","0","0","0","0","0","0","-2"
"243221","University of Puerto Rico-Rio Piedras","2018","Tenured, instructors","14","2","12","0","0","0","0","0","0","0","0","0","14","2","12","0","0","0","0","0","0","0","0","0","0","0","0","0","0","0","-2"
"243221","University of Puerto Rico-Rio Piedras","2018","Tenured, no academic rank","8","4","4","0","0","0","0","0","0","0","0","0","8","4","4","0","0","0","0","0","0","0","0","0","0","0","0","0","0","0","-2"
"243221","University of Puerto Rico-Rio Piedras","2018","On-Tenure track total","47","23","24","0","0","0","0","0","0","0","0","0","39","17","22","0","0","0","4","3","1","0","0","0","4","3","1","0","0","0","-2"
"243221","University of Puerto Rico-Rio Piedras","2018","On-tenure track, associate professors","10","3","7","0","0","0","0","0","0","0","0","0","9","3","6","0","0","0","1","0","1","0","0","0","0","0","0","0","0","0","-2"
"243221","University of Puerto Rico-Rio Piedras","2018","On-tenure track, assistant professors","34","18","16","0","0","0","0","0","0","0","0","0","27","12","15","0","0","0","3","3","0","0","0","0","4","3","1","0","0","0","-2"
"243221","University of Puerto Rico-Rio Piedras","2018","On-tenure track, instructors","2","2","0","0","0","0","0","0","0","0","0","0","2","2","0","0","0","0","0","0","0","0","0","0","0","0","0","0","0","0","-2"
"243221","University of Puerto Rico-Rio Piedras","2018","On-tenure track, no academic rank","1","0","1","0","0","0","0","0","0","0","0","0","1","0","1","0","0","0","0","0","0","0","0","0","0","0","0","0","0","0","-2"
"243221","University of Puerto Rico-Rio Piedras","2018","Not on tenure track/No tenure system system total","224","110","114","0","0","0","3","1","2","1","1","0","193","96","97","0","0","0","2","2","0","0","0","0","25","10","15","0","0","0","-2"
"243221","University of Puerto Rico-Rio Piedras","2018","Not on tenure/no tenure system, professors","6","2","4","0","0","0","0","0","0","0","0","0","5","2","3","0","0","0","0","0","0","0","0","0","1","0","1","0","0","0","-2"
"243221","University of Puerto Rico-Rio Piedras","2018","Not on tenure/no tenure system, assistant professors","112","59","53","0","0","0","1","0","1","1","1","0","98","51","47","0","0","0","0","0","0","0","0","0","12","7","5","0","0","0","-2"
"243221","University of Puerto Rico-Rio Piedras","2018","Not on tenure/no tenure system, instructors","94","41","53","0","0","0","0","0","0","0","0","0","83","39","44","0","0","0","1","1","0","0","0","0","10","1","9","0","0","0","-2"
"243221","University of Puerto Rico-Rio Piedras","2018","Not on tenure/no tenure system, no academic rank","12","8","4","0","0","0","2","1","1","0","0","0","7","4","3","0","0","0","1","1","0","0","0","0","2","2","0","0","0","0","-2"
"243346","Universidad Ana G. Mendez-Carolina Campus","2018","Tenured total","11","6","5","0","0","0","0","0","0","0","0","0","11","6","5","0","0","0","0","0","0","0","0","0","0","0","0","0","0","0","-2"
"243346","Universidad Ana G. Mendez-Carolina Campus","2018","Tenured, professors","5","2","3","0","0","0","0","0","0","0","0","0","5","2","3","0","0","0","0","0","0","0","0","0","0","0","0","0","0","0","-2"
"243346","Universidad Ana G. Mendez-Carolina Campus","2018","Tenured, associate professors","3","2","1","0","0","0","0","0","0","0","0","0","3","2","1","0","0","0","0","0","0","0","0","0","0","0","0","0","0","0","-2"
"243346","Universidad Ana G. Mendez-Carolina Campus","2018","Tenured, assistant professors","3","2","1","0","0","0","0","0","0","0","0","0","3","2","1","0","0","0","0","0","0","0","0","0","0","0","0","0","0","0","-2"
"243346","Universidad Ana G. Mendez-Carolina Campus","2018","Not on tenure track/No tenure system system total","132","54","78","0","0","0","0","0","0","1","1","0","127","50","77","0","0","0","3","2","1","0","0","0","1","1","0","0","0","0","-2"
"243346","Universidad Ana G. Mendez-Carolina Campus","2018","Not on tenure/no tenure system, professors","15","5","10","0","0","0","0","0","0","0","0","0","15","5","10","0","0","0","0","0","0","0","0","0","0","0","0","0","0","0","-2"
"243346","Universidad Ana G. Mendez-Carolina Campus","2018","Not on tenure/no tenure system, associate professors","19","6","13","0","0","0","0","0","0","0","0","0","17","5","12","0","0","0","1","0","1","0","0","0","1","1","0","0","0","0","-2"
"243346","Universidad Ana G. Mendez-Carolina Campus","2018","Not on tenure/no tenure system, assistant professors","38","16","22","0","0","0","0","0","0","1","1","0","37","15","22","0","0","0","0","0","0","0","0","0","0","0","0","0","0","0","-2"
"243346","Universidad Ana G. Mendez-Carolina Campus","2018","Not on tenure/no tenure system, instructors","60","27","33","0","0","0","0","0","0","0","0","0","58","25","33","0","0","0","2","2","0","0","0","0","0","0","0","0","0","0","-2"
"243443","Universidad del Sagrado Corazon","2018","Tenured total","73","24","49","0","0","0","0","0","0","0","0","0","72","23","49","0","0","0","1","1","0","0","0","0","0","0","0","0","0","0","-2"
"243443","Universidad del Sagrado Corazon","2018","Tenured, professors","47","18","29","0","0","0","0","0","0","0","0","0","46","17","29","0","0","0","1","1","0","0","0","0","0","0","0","0","0","0","-2"
"243443","Universidad del Sagrado Corazon","2018","Tenured, associate professors","10","0","10","0","0","0","0","0","0","0","0","0","10","0","10","0","0","0","0","0","0","0","0","0","0","0","0","0","0","0","-2"
"243443","Universidad del Sagrado Corazon","2018","Tenured, assistant professors","11","4","7","0","0","0","0","0","0","0","0","0","11","4","7","0","0","0","0","0","0","0","0","0","0","0","0","0","0","0","-2"
"243443","Universidad del Sagrado Corazon","2018","Tenured, instructors","5","2","3","0","0","0","0","0","0","0","0","0","5","2","3","0","0","0","0","0","0","0","0","0","0","0","0","0","0","0","-2"
"243443","Universidad del Sagrado Corazon","2018","Not on tenure track/No tenure system system total","9","2","7","0","0","0","0","0","0","0","0","0","9","2","7","0","0","0","0","0","0","0","0","0","0","0","0","0","0","0","-2"
"243443","Universidad del Sagrado Corazon","2018","Not on tenure/no tenure system, assistant professors","3","0","3","0","0","0","0","0","0","0","0","0","3","0","3","0","0","0","0","0","0","0","0","0","0","0","0","0","0","0","-2"
"243443","Universidad del Sagrado Corazon","2018","Not on tenure/no tenure system, instructors","6","2","4","0","0","0","0","0","0","0","0","0","6","2","4","0","0","0","0","0","0","0","0","0","0","0","0","0","0","0","-2"
"243568","Universidad Central Del Caribe","2018","Not on tenure track/No tenure system system total","43","19","24","0","0","0","0","0","0","0","0","0","32","13","19","0","0","0","11","6","5","0","0","0","0","0","0","0","0","0","-2"
"243568","Universidad Central Del Caribe","2018","Not on tenure/no tenure system, professors","15","9","6","0","0","0","0","0","0","0","0","0","9","6","3","0","0","0","6","3","3","0","0","0","0","0","0","0","0","0","-2"
"243568","Universidad Central Del Caribe","2018","Not on tenure/no tenure system, associate professors","15","5","10","0","0","0","0","0","0","0","0","0","12","4","8","0","0","0","3","1","2","0","0","0","0","0","0","0","0","0","-2"
"243568","Universidad Central Del Caribe","2018","Not on tenure/no tenure system, assistant professors","12","5","7","0","0","0","0","0","0","0","0","0","10","3","7","0","0","0","2","2","0","0","0","0","0","0","0","0","0","0","-2"
"243568","Universidad Central Del Caribe","2018","Not on tenure/no tenure system, instructors","1","0","1","0","0","0","0","0","0","0","0","0","1","0","1","0","0","0","0","0","0","0","0","0","0","0","0","0","0","0","-2"
"243577","Universidad Politecnica de Puerto Rico","2018","Not on tenure track/No tenure system system total","139","93","46","0","0","0","1","1","0","0","0","0","125","81","44","0","0","0","2","2","0","0","0","0","11","9","2","0","0","0","-2"
"243577","Universidad Politecnica de Puerto Rico","2018","Not on tenure/no tenure system, professors","38","30","8","0","0","0","1","1","0","0","0","0","36","28","8","0","0","0","1","1","0","0","0","0","0","0","0","0","0","0","-2"
"243577","Universidad Politecnica de Puerto Rico","2018","Not on tenure/no tenure system, associate professors","81","51","30","0","0","0","0","0","0","0","0","0","70","41","29","0","0","0","1","1","0","0","0","0","10","9","1","0","0","0","-2"
"243577","Universidad Politecnica de Puerto Rico","2018","Not on tenure/no tenure system, assistant professors","16","10","6","0","0","0","0","0","0","0","0","0","15","10","5","0","0","0","0","0","0","0","0","0","1","0","1","0","0","0","-2"
"243577","Universidad Politecnica de Puerto Rico","2018","Not on tenure/no tenure system, instructors","4","2","2","0","0","0","0","0","0","0","0","0","4","2","2","0","0","0","0","0","0","0","0","0","0","0","0","0","0","0","-2"
"243586","Pontifical Catholic University of Puerto Rico-Mayaguez","2018","Not on tenure track/No tenure system system total","41","20","21","0","0","0","0","0","0","0","0","0","40","19","21","0","0","0","1","1","0","0","0","0","0","0","0","0","0","0","-2"
"243586","Pontifical Catholic University of Puerto Rico-Mayaguez","2018","Not on tenure/no tenure system, professors","2","1","1","0","0","0","0","0","0","0","0","0","2","1","1","0","0","0","0","0","0","0","0","0","0","0","0","0","0","0","-2"
"243586","Pontifical Catholic University of Puerto Rico-Mayaguez","2018","Not on tenure/no tenure system, associate professors","9","8","1","0","0","0","0","0","0","0","0","0","9","8","1","0","0","0","0","0","0","0","0","0","0","0","0","0","0","0","-2"
"243586","Pontifical Catholic University of Puerto Rico-Mayaguez","2018","Not on tenure/no tenure system, assistant professors","22","8","14","0","0","0","0","0","0","0","0","0","22","8","14","0","0","0","0","0","0","0","0","0","0","0","0","0","0","0","-2"
"243586","Pontifical Catholic University of Puerto Rico-Mayaguez","2018","Not on tenure/no tenure system, instructors","3","2","1","0","0","0","0","0","0","0","0","0","2","1","1","0","0","0","1","1","0","0","0","0","0","0","0","0","0","0","-2"
"243586","Pontifical Catholic University of Puerto Rico-Mayaguez","2018","Not on tenure/no tenure system, no academic rank","5","1","4","0","0","0","0","0","0","0","0","0","5","1","4","0","0","0","0","0","0","0","0","0","0","0","0","0","0","0","-2"
"243601","Universidad Ana G. Mendez-Gurabo Campus","2018","Tenured total","28","14","14","0","0","0","0","0","0","0","0","0","28","14","14","0","0","0","0","0","0","0","0","0","0","0","0","0","0","0","-2"
"243601","Universidad Ana G. Mendez-Gurabo Campus","2018","Tenured, professors","17","9","8","0","0","0","0","0","0","0","0","0","17","9","8","0","0","0","0","0","0","0","0","0","0","0","0","0","0","0","-2"
"243601","Universidad Ana G. Mendez-Gurabo Campus","2018","Tenured, associate professors","10","4","6","0","0","0","0","0","0","0","0","0","10","4","6","0","0","0","0","0","0","0","0","0","0","0","0","0","0","0","-2"
"243601","Universidad Ana G. Mendez-Gurabo Campus","2018","Tenured, assistant professors","1","1","0","0","0","0","0","0","0","0","0","0","1","1","0","0","0","0","0","0","0","0","0","0","0","0","0","0","0","0","-2"
"243601","Universidad Ana G. Mendez-Gurabo Campus","2018","Not on tenure track/No tenure system system total","169","80","89","0","0","0","1","1","0","0","0","0","160","75","85","0","0","0","2","1","1","0","0","0","6","3","3","0","0","0","-2"
"243601","Universidad Ana G. Mendez-Gurabo Campus","2018","Not on tenure/no tenure system, professors","20","14","6","0","0","0","1","1","0","0","0","0","16","10","6","0","0","0","1","1","0","0","0","0","2","2","0","0","0","0","-2"
"243601","Universidad Ana G. Mendez-Gurabo Campus","2018","Not on tenure/no tenure system, associate professors","28","10","18","0","0","0","0","0","0","0","0","0","26","10","16","0","0","0","0","0","0","0","0","0","2","0","2","0","0","0","-2"
"243601","Universidad Ana G. Mendez-Gurabo Campus","2018","Not on tenure/no tenure system, assistant professors","73","35","38","0","0","0","0","0","0","0","0","0","72","34","38","0","0","0","0","0","0","0","0","0","1","1","0","0","0","0","-2"
"243601","Universidad Ana G. Mendez-Gurabo Campus","2018","Not on tenure/no tenure system, instructors","48","21","27","0","0","0","0","0","0","0","0","0","46","21","25","0","0","0","1","0","1","0","0","0","1","0","1","0","0","0","-2"
"243832","EDP University of Puerto Rico Inc-San Juan","2018","Not on tenure track/No tenure system system total","44","16","28","0","0","0","0","0","0","0","0","0","44","16","28","0","0","0","0","0","0","0","0","0","0","0","0","0","0","0","-2"
"243832","EDP University of Puerto Rico Inc-San Juan","2018","Not on tenure/no tenure system, instructors","44","16","28","0","0","0","0","0","0","0","0","0","44","16","28","0","0","0","0","0","0","0","0","0","0","0","0","0","0","0","-2"
"245953","Mid-America Christian University","2018","Not on tenure track/No tenure system system total","33","18","15","3","3","0","0","0","0","1","0","1","0","0","0","0","0","0","27","15","12","0","0","0","1","0","1","1","0","1","-2"
"245953","Mid-America Christian University","2018","Not on tenure/no tenure system, professors","8","5","3","2","2","0","0","0","0","1","0","1","0","0","0","0","0","0","5","3","2","0","0","0","0","0","0","0","0","0","-2"
"245953","Mid-America Christian University","2018","Not on tenure/no tenure system, associate professors","12","8","4","1","1","0","0","0","0","0","0","0","0","0","0","0","0","0","10","7","3","0","0","0","0","0","0","1","0","1","-2"
"245953","Mid-America Christian University","2018","Not on tenure/no tenure system, assistant professors","11","5","6","0","0","0","0","0","0","0","0","0","0","0","0","0","0","0","10","5","5","0","0","0","1","0","1","0","0","0","-2"
"245953","Mid-America Christian University","2018","Not on tenure/no tenure system, instructors","2","0","2","0","0","0","0","0","0","0","0","0","0","0","0","0","0","0","2","0","2","0","0","0","0","0","0","0","0","0","-2"
"363907","Caribbean University-Ponce","2018","Not on tenure track/No tenure system system total","22","8","14","0","0","0","0","0","0","0","0","0","22","8","14","0","0","0","0","0","0","0","0","0","0","0","0","0","0","0","-2"
"363907","Caribbean University-Ponce","2018","Not on tenure/no tenure system, assistant professors","6","3","3","0","0","0","0","0","0","0","0","0","6","3","3","0","0","0","0","0","0","0","0","0","0","0","0","0","0","0","-2"
"363907","Caribbean University-Ponce","2018","Not on tenure/no tenure system, instructors","16","5","11","0","0","0","0","0","0","0","0","0","16","5","11","0","0","0","0","0","0","0","0","0","0","0","0","0","0","0","-2"
"363916","Caribbean University-Vega Baja","2018","Not on tenure track/No tenure system system total","9","3","6","0","0","0","0","0","0","0","0","0","9","3","6","0","0","0","0","0","0","0","0","0","0","0","0","0","0","0","-2"
"363916","Caribbean University-Vega Baja","2018","Not on tenure/no tenure system, assistant professors","2","0","2","0","0","0","0","0","0","0","0","0","2","0","2","0","0","0","0","0","0","0","0","0","0","0","0","0","0","0","-2"
"363916","Caribbean University-Vega Baja","2018","Not on tenure/no tenure system, instructors","7","3","4","0","0","0","0","0","0","0","0","0","7","3","4","0","0","0","0","0","0","0","0","0","0","0","0","0","0","0","-2"
"366711","California State University-San Marcos","2018","Tenured total","191","96","95","4","2","2","29","18","11","5","4","1","28","11","17","1","1","0","110","52","58","5","1","4","6","4","2","3","3","0","-2"
"366711","California State University-San Marcos","2018","Tenured, professors","105","49","56","1","0","1","13","9","4","2","1","1","13","6","7","0","0","0","69","30","39","3","0","3","2","1","1","2","2","0","-2"
"366711","California State University-San Marcos","2018","Tenured, associate professors","82","44","38","2","1","1","15","9","6","3","3","0","14","4","10","1","1","0","41","22","19","2","1","1","3","2","1","1","1","0","-2"
"366711","California State University-San Marcos","2018","Tenured, assistant professors","1","1","0","1","1","0","0","0","0","0","0","0","0","0","0","0","0","0","0","0","0","0","0","0","0","0","0","0","0","0","-2"
"366711","California State University-San Marcos","2018","Tenured, no academic rank","3","2","1","0","0","0","1","0","1","0","0","0","1","1","0","0","0","0","0","0","0","0","0","0","1","1","0","0","0","0","-2"
"366711","California State University-San Marcos","2018","On-Tenure track total","92","43","49","0","0","0","12","6","6","6","3","3","12","7","5","0","0","0","45","19","26","4","1","3","3","2","1","10","5","5","-2"
"366711","California State University-San Marcos","2018","On-tenure track, associate professors","3","3","0","0","0","0","2","2","0","0","0","0","0","0","0","0","0","0","1","1","0","0","0","0","0","0","0","0","0","0","-2"
"366711","California State University-San Marcos","2018","On-tenure track, assistant professors","89","40","49","0","0","0","10","4","6","6","3","3","12","7","5","0","0","0","44","18","26","4","1","3","3","2","1","10","5","5","-2"
"366711","California State University-San Marcos","2018","Not on tenure track/No tenure system system total","112","33","79","1","0","1","10","5","5","1","0","1","13","4","9","0","0","0","78","21","57","6","1","5","2","2","0","1","0","1","-2"
"366711","California State University-San Marcos","2018","Not on tenure/no tenure system, lecturers","112","33","79","1","0","1","10","5","5","1","0","1","13","4","9","0","0","0","78","21","57","6","1","5","2","2","0","1","0","1","-2"
"367884","Hodges University","2018","Not on tenure track/No tenure system system total","36","17","19","0","0","0","0","0","0","2","0","2","6","4","2","0","0","0","27","13","14","1","0","1","0","0","0","0","0","0","-2"
"367884","Hodges University","2018","Not on tenure/no tenure system, professors","11","5","6","0","0","0","0","0","0","1","0","1","0","0","0","0","0","0","10","5","5","0","0","0","0","0","0","0","0","0","-2"
"367884","Hodges University","2018","Not on tenure/no tenure system, associate professors","9","5","4","0","0","0","0","0","0","0","0","0","2","2","0","0","0","0","6","3","3","1","0","1","0","0","0","0","0","0","-2"
"367884","Hodges University","2018","Not on tenure/no tenure system, assistant professors","15","7","8","0","0","0","0","0","0","1","0","1","4","2","2","0","0","0","10","5","5","0","0","0","0","0","0","0","0","0","-2"
"367884","Hodges University","2018","Not on tenure/no tenure system, instructors","1","0","1","0","0","0","0","0","0","0","0","0","0","0","0","0","0","0","1","0","1","0","0","0","0","0","0","0","0","0","-2"
"376385","Universal Technology College of Puerto Rico","2018","Not on tenure track/No tenure system system total","24","13","11","0","0","0","0","0","0","0","0","0","24","13","11","0","0","0","0","0","0","0","0","0","0","0","0","0","0","0","-2"
"376385","Universal Technology College of Puerto Rico","2018","Not on tenure/no tenure system, professors","24","13","11","0","0","0","0","0","0","0","0","0","24","13","11","0","0","0","0","0","0","0","0","0","0","0","0","0","0","0","-2"
"401223","World Mission University","2018","Not on tenure track/No tenure system system total","5","3","2","0","0","0","5","3","2","0","0","0","0","0","0","0","0","0","0","0","0","0","0","0","0","0","0","0","0","0","-2"
"401223","World Mission University","2018","Not on tenure/no tenure system, associate professors","1","1","0","0","0","0","1","1","0","0","0","0","0","0","0","0","0","0","0","0","0","0","0","0","0","0","0","0","0","0","-2"
"401223","World Mission University","2018","Not on tenure/no tenure system, assistant professors","4","2","2","0","0","0","4","2","2","0","0","0","0","0","0","0","0","0","0","0","0","0","0","0","0","0","0","0","0","0","-2"
"407009","Arizona State University-West","2018","Tenured total","126","71","55","0","0","0","14","8","6","2","1","1","14","9","5","0","0","0","93","52","41","1","0","1","1","1","0","1","0","1","-2"
"407009","Arizona State University-West","2018","Tenured, professors","55","36","19","0","0","0","6","4","2","0","0","0","5","5","0","0","0","0","44","27","17","0","0","0","0","0","0","0","0","0","-2"
"407009","Arizona State University-West","2018","Tenured, associate professors","71","35","36","0","0","0","8","4","4","2","1","1","9","4","5","0","0","0","49","25","24","1","0","1","1","1","0","1","0","1","-2"
"407009","Arizona State University-West","2018","On-Tenure track total","38","15","23","1","1","0","6","1","5","1","0","1","4","1","3","0","0","0","19","9","10","2","1","1","1","0","1","4","2","2","-2"
"407009","Arizona State University-West","2018","On-tenure track, associate professors","3","1","2","0","0","0","1","0","1","0","0","0","0","0","0","0","0","0","1","1","0","0","0","0","1","0","1","0","0","0","-2"
"407009","Arizona State University-West","2018","On-tenure track, assistant professors","35","14","21","1","1","0","5","1","4","1","0","1","4","1","3","0","0","0","18","8","10","2","1","1","0","0","0","4","2","2","-2"
"407009","Arizona State University-West","2018","Not on tenure track/No tenure system system total","134","38","96","2","0","2","6","2","4","6","3","3","16","7","9","1","0","1","99","26","73","1","0","1","3","0","3","0","0","0","-2"
"407009","Arizona State University-West","2018","Not on tenure/no tenure system, professors","1","1","0","0","0","0","0","0","0","0","0","0","1","1","0","0","0","0","0","0","0","0","0","0","0","0","0","0","0","0","-2"
"407009","Arizona State University-West","2018","Not on tenure/no tenure system, associate professors","9","6","3","0","0","0","0","0","0","1","1","0","0","0","0","0","0","0","8","5","3","0","0","0","0","0","0","0","0","0","-2"
"407009","Arizona State University-West","2018","Not on tenure/no tenure system, assistant professors","37","7","30","0","0","0","0","0","0","1","1","0","6","3","3","1","0","1","29","3","26","0","0","0","0","0","0","0","0","0","-2"
"407009","Arizona State University-West","2018","Not on tenure/no tenure system, instructors","40","10","30","0","0","0","3","2","1","0","0","0","6","2","4","0","0","0","28","6","22","1","0","1","2","0","2","0","0","0","-2"
"407009","Arizona State University-West","2018","Not on tenure/no tenure system, lecturers","47","14","33","2","0","2","3","0","3","4","1","3","3","1","2","0","0","0","34","12","22","0","0","0","1","0","1","0","0","0","-2"
"409315","South Texas College","2018","Not on tenure track/No tenure system system total","645","388","257","4","3","1","56","29","27","4","3","1","382","228","154","8","8","0","185","112","73","0","0","0","6","5","1","0","0","0","-2"
"409315","South Texas College","2018","Not on tenure/no tenure system, professors","10","6","4","0","0","0","1","1","0","1","1","0","2","1","1","0","0","0","6","3","3","0","0","0","0","0","0","0","0","0","-2"
"409315","South Texas College","2018","Not on tenure/no tenure system, associate professors","33","20","13","0","0","0","1","1","0","0","0","0","18","11","7","0","0","0","14","8","6","0","0","0","0","0","0","0","0","0","-2"
"409315","South Texas College","2018","Not on tenure/no tenure system, assistant professors","45","28","17","0","0","0","4","2","2","1","1","0","21","12","9","0","0","0","19","13","6","0","0","0","0","0","0","0","0","0","-2"
"409315","South Texas College","2018","Not on tenure/no tenure system, instructors","454","257","197","2","1","1","45","22","23","1","0","1","275","155","120","8","8","0","122","71","51","0","0","0","1","0","1","0","0","0","-2"
"409315","South Texas College","2018","Not on tenure/no tenure system, lecturers","103","77","26","2","2","0","5","3","2","1","1","0","66","49","17","0","0","0","24","17","7","0","0","0","5","5","0","0","0","0","-2"
"409698","California State University-Monterey Bay","2018","Tenured total","89","44","45","1","1","0","18","8","10","2","1","1","18","11","7","1","0","1","43","21","22","1","0","1","5","2","3","0","0","0","-2"
"409698","California State University-Monterey Bay","2018","Tenured, professors","61","32","29","1","1","0","14","7","7","1","0","1","10","7","3","1","0","1","30","16","14","1","0","1","3","1","2","0","0","0","-2"
"409698","California State University-Monterey Bay","2018","Tenured, associate professors","28","12","16","0","0","0","4","1","3","1","1","0","8","4","4","0","0","0","13","5","8","0","0","0","2","1","1","0","0","0","-2"
"409698","California State University-Monterey Bay","2018","On-Tenure track total","72","32","40","1","1","0","7","3","4","2","1","1","8","4","4","0","0","0","44","18","26","1","1","0","3","1","2","6","3","3","-2"
"409698","California State University-Monterey Bay","2018","On-tenure track, associate professors","5","4","1","0","0","0","0","0","0","0","0","0","0","0","0","0","0","0","4","3","1","0","0","0","0","0","0","1","1","0","-2"
"409698","California State University-Monterey Bay","2018","On-tenure track, assistant professors","67","28","39","1","1","0","7","3","4","2","1","1","8","4","4","0","0","0","40","15","25","1","1","0","3","1","2","5","2","3","-2"
"409698","California State University-Monterey Bay","2018","Not on tenure track/No tenure system system total","56","21","35","0","0","0","4","2","2","1","0","1","14","6","8","0","0","0","29","8","21","2","2","0","6","3","3","0","0","0","-2"
"409698","California State University-Monterey Bay","2018","Not on tenure/no tenure system, lecturers","56","21","35","0","0","0","4","2","2","1","0","1","14","6","8","0","0","0","29","8","21","2","2","0","6","3","3","0","0","0","-2"
"414823","Johnson & Wales University-North Miami","2018","Not on tenure track/No tenure system system total","47","31","16","0","0","0","3","1","2","9","6","3","5","3","2","0","0","0","28","20","8","2","1","1","0","0","0","0","0","0","-2"
"414823","Johnson & Wales University-North Miami","2018","Not on tenure/no tenure system, professors","12","6","6","0","0","0","1","0","1","2","1","1","1","0","1","0","0","0","8","5","3","0","0","0","0","0","0","0","0","0","-2"
"414823","Johnson & Wales University-North Miami","2018","Not on tenure/no tenure system, associate professors","12","8","4","0","0","0","1","1","0","3","2","1","1","0","1","0","0","0","6","5","1","1","0","1","0","0","0","0","0","0","-2"
"414823","Johnson & Wales University-North Miami","2018","Not on tenure/no tenure system, assistant professors","13","9","4","0","0","0","0","0","0","2","1","1","1","1","0","0","0","0","9","6","3","1","1","0","0","0","0","0","0","0","-2"
"414823","Johnson & Wales University-North Miami","2018","Not on tenure/no tenure system, instructors","10","8","2","0","0","0","1","0","1","2","2","0","2","2","0","0","0","0","5","4","1","0","0","0","0","0","0","0","0","0","-2"
"416801","The University of Texas MD Anderson Cancer Center","2018","Tenured total","1","1","0","0","0","0","1","1","0","0","0","0","0","0","0","0","0","0","0","0","0","0","0","0","0","0","0","0","0","0","-2"
"416801","The University of Texas MD Anderson Cancer Center","2018","Tenured, professors","1","1","0","0","0","0","1","1","0","0","0","0","0","0","0","0","0","0","0","0","0","0","0","0","0","0","0","0","0","0","-2"
"416801","The University of Texas MD Anderson Cancer Center","2018","Not on tenure track/No tenure system system total","22","10","12","0","0","0","4","4","0","3","1","2","0","0","0","0","0","0","15","5","10","0","0","0","0","0","0","0","0","0","-2"
"416801","The University of Texas MD Anderson Cancer Center","2018","Not on tenure/no tenure system, lecturers","22","10","12","0","0","0","4","4","0","3","1","2","0","0","0","0","0","0","15","5","10","0","0","0","0","0","0","0","0","0","-2"
"430670","San Juan Bautista School of Medicine","2018","Tenured total","11","6","5","0","0","0","0","0","0","0","0","0","11","6","5","0","0","0","0","0","0","0","0","0","0","0","0","0","0","0","-2"
"430670","San Juan Bautista School of Medicine","2018","Tenured, associate professors","5","5","0","0","0","0","0","0","0","0","0","0","5","5","0","0","0","0","0","0","0","0","0","0","0","0","0","0","0","0","-2"
"430670","San Juan Bautista School of Medicine","2018","Tenured, assistant professors","5","1","4","0","0","0","0","0","0","0","0","0","5","1","4","0","0","0","0","0","0","0","0","0","0","0","0","0","0","0","-2"
"430670","San Juan Bautista School of Medicine","2018","Tenured, instructors","1","0","1","0","0","0","0","0","0","0","0","0","1","0","1","0","0","0","0","0","0","0","0","0","0","0","0","0","0","0","-2"
"430670","San Juan Bautista School of Medicine","2018","On-Tenure track total","10","3","7","0","0","0","0","0","0","0","0","0","10","3","7","0","0","0","0","0","0","0","0","0","0","0","0","0","0","0","-2"
"430670","San Juan Bautista School of Medicine","2018","On-tenure track, associate professors","1","0","1","0","0","0","0","0","0","0","0","0","1","0","1","0","0","0","0","0","0","0","0","0","0","0","0","0","0","0","-2"
"430670","San Juan Bautista School of Medicine","2018","On-tenure track, assistant professors","6","3","3","0","0","0","0","0","0","0","0","0","6","3","3","0","0","0","0","0","0","0","0","0","0","0","0","0","0","0","-2"
"430670","San Juan Bautista School of Medicine","2018","On-tenure track, instructors","3","0","3","0","0","0","0","0","0","0","0","0","3","0","3","0","0","0","0","0","0","0","0","0","0","0","0","0","0","0","-2"
"430670","San Juan Bautista School of Medicine","2018","Not on tenure track/No tenure system system total","20","16","4","0","0","0","0","0","0","0","0","0","20","16","4","0","0","0","0","0","0","0","0","0","0","0","0","0","0","0","-2"
"430670","San Juan Bautista School of Medicine","2018","Not on tenure/no tenure system, professors","1","1","0","0","0","0","0","0","0","0","0","0","1","1","0","0","0","0","0","0","0","0","0","0","0","0","0","0","0","0","-2"
"430670","San Juan Bautista School of Medicine","2018","Not on tenure/no tenure system, associate professors","2","2","0","0","0","0","0","0","0","0","0","0","2","2","0","0","0","0","0","0","0","0","0","0","0","0","0","0","0","0","-2"
"430670","San Juan Bautista School of Medicine","2018","Not on tenure/no tenure system, assistant professors","15","12","3","0","0","0","0","0","0","0","0","0","15","12","3","0","0","0","0","0","0","0","0","0","0","0","0","0","0","0","-2"
"430670","San Juan Bautista School of Medicine","2018","Not on tenure/no tenure system, instructors","2","1","1","0","0","0","0","0","0","0","0","0","2","1","1","0","0","0","0","0","0","0","0","0","0","0","0","0","0","0","-2"
"434539","City College-Miami","2018","Not on tenure track/No tenure system system total","1","0","1","0","0","0","0","0","0","0","0","0","0","0","0","0","0","0","0","0","0","0","0","0","1","0","1","0","0","0","-2"
"434539","City College-Miami","2018","Not on tenure/no tenure system, instructors","1","0","1","0","0","0","0","0","0","0","0","0","0","0","0","0","0","0","0","0","0","0","0","0","1","0","1","0","0","0","-2"
"434900","Dewey University-Carolina","2018","Not on tenure track/No tenure system system total","50","22","28","0","0","0","0","0","0","0","0","0","50","22","28","0","0","0","0","0","0","0","0","0","0","0","0","0","0","0","-2"
"434900","Dewey University-Carolina","2018","Not on tenure/no tenure system, professors","50","22","28","0","0","0","0","0","0","0","0","0","50","22","28","0","0","0","0","0","0","0","0","0","0","0","0","0","0","0","-2"
"439446","Atlantic Institute of Oriental Medicine","2018","Not on tenure track/No tenure system system total","6","3","3","0","0","0","4","2","2","1","1","0","0","0","0","0","0","0","1","0","1","0","0","0","0","0","0","0","0","0","-2"
"439446","Atlantic Institute of Oriental Medicine","2018","Not on tenure/no tenure system, instructors","6","3","3","0","0","0","4","2","2","1","1","0","0","0","0","0","0","0","1","0","1","0","0","0","0","0","0","0","0","0","-2"
"440651","Atenas College","2018","Tenured total","13","1","12","0","0","0","0","0","0","0","0","0","13","1","12","0","0","0","0","0","0","0","0","0","0","0","0","0","0","0","-2"
"440651","Atenas College","2018","Tenured, professors","13","1","12","0","0","0","0","0","0","0","0","0","13","1","12","0","0","0","0","0","0","0","0","0","0","0","0","0","0","0","-2"
"440651","Atenas College","2018","Not on tenure track/No tenure system system total","8","5","3","0","0","0","0","0","0","0","0","0","8","5","3","0","0","0","0","0","0","0","0","0","0","0","0","0","0","0","-2"
"440651","Atenas College","2018","Not on tenure/no tenure system, professors","8","5","3","0","0","0","0","0","0","0","0","0","8","5","3","0","0","0","0","0","0","0","0","0","0","0","0","0","0","0","-2"
"440794","Pillar College","2018","Not on tenure track/No tenure system system total","15","9","6","0","0","0","1","1","0","5","1","4","2","2","0","0","0","0","7","5","2","0","0","0","0","0","0","0","0","0","-2"
"440794","Pillar College","2018","Not on tenure/no tenure system, professors","3","2","1","0","0","0","0","0","0","1","0","1","0","0","0","0","0","0","2","2","0","0","0","0","0","0","0","0","0","0","-2"
"440794","Pillar College","2018","Not on tenure/no tenure system, associate professors","3","2","1","0","0","0","1","1","0","1","0","1","0","0","0","0","0","0","1","1","0","0","0","0","0","0","0","0","0","0","-2"
"440794","Pillar College","2018","Not on tenure/no tenure system, assistant professors","3","1","2","0","0","0","0","0","0","2","0","2","0","0","0","0","0","0","1","1","0","0","0","0","0","0","0","0","0","0","-2"
"440794","Pillar College","2018","Not on tenure/no tenure system, no academic rank","6","4","2","0","0","0","0","0","0","1","1","0","2","2","0","0","0","0","3","1","2","0","0","0","0","0","0","0","0","0","-2"
"441900","Nevada State College","2018","Tenured total","21","12","9","0","0","0","2","1","1","2","2","0","1","0","1","0","0","0","16","9","7","0","0","0","0","0","0","0","0","0","-2"
"441900","Nevada State College","2018","Tenured, professors","5","3","2","0","0","0","0","0","0","0","0","0","0","0","0","0","0","0","5","3","2","0","0","0","0","0","0","0","0","0","-2"
"441900","Nevada State College","2018","Tenured, associate professors","16","9","7","0","0","0","2","1","1","2","2","0","1","0","1","0","0","0","11","6","5","0","0","0","0","0","0","0","0","0","-2"
"441900","Nevada State College","2018","On-Tenure track total","29","4","25","0","0","0","1","0","1","1","0","1","5","1","4","0","0","0","20","3","17","2","0","2","0","0","0","0","0","0","-2"
"441900","Nevada State College","2018","On-tenure track, assistant professors","29","4","25","0","0","0","1","0","1","1","0","1","5","1","4","0","0","0","20","3","17","2","0","2","0","0","0","0","0","0","-2"
"441900","Nevada State College","2018","Not on tenure track/No tenure system system total","31","10","21","0","0","0","3","1","2","2","0","2","3","1","2","0","0","0","21","6","15","2","2","0","0","0","0","0","0","0","-2"
"441900","Nevada State College","2018","Not on tenure/no tenure system, lecturers","31","10","21","0","0","0","3","1","2","2","0","2","3","1","2","0","0","0","21","6","15","2","2","0","0","0","0","0","0","0","-2"
"441937","California State University-Channel Islands","2018","Tenured total","63","33","30","0","0","0","5","1","4","1","1","0","11","6","5","0","0","0","42","21","21","0","0","0","3","3","0","1","1","0","-2"
"441937","California State University-Channel Islands","2018","Tenured, professors","52","28","24","0","0","0","4","1","3","1","1","0","9","5","4","0","0","0","34","17","17","0","0","0","3","3","0","1","1","0","-2"
"441937","California State University-Channel Islands","2018","Tenured, associate professors","11","5","6","0","0","0","1","0","1","0","0","0","2","1","1","0","0","0","8","4","4","0","0","0","0","0","0","0","0","0","-2"
"441937","California State University-Channel Islands","2018","On-Tenure track total","80","28","52","0","0","0","4","1","3","3","0","3","18","8","10","0","0","0","44","16","28","3","0","3","2","2","0","6","1","5","-2"
"441937","California State University-Channel Islands","2018","On-tenure track, associate professors","8","3","5","0","0","0","0","0","0","1","0","1","0","0","0","0","0","0","6","3","3","1","0","1","0","0","0","0","0","0","-2"
"441937","California State University-Channel Islands","2018","On-tenure track, assistant professors","72","25","47","0","0","0","4","1","3","2","0","2","18","8","10","0","0","0","38","13","25","2","0","2","2","2","0","6","1","5","-2"
"441937","California State University-Channel Islands","2018","Not on tenure track/No tenure system system total","92","43","49","0","0","0","10","4","6","0","0","0","14","8","6","0","0","0","64","27","37","4","4","0","0","0","0","0","0","0","-2"
"441937","California State University-Channel Islands","2018","Not on tenure/no tenure system, lecturers","92","43","49","0","0","0","10","4","6","0","0","0","14","8","6","0","0","0","64","27","37","4","4","0","0","0","0","0","0","0","-2"
"443562","Dewey University-Hato Rey","2018","Not on tenure track/No tenure system system total","269","118","151","0","0","0","0","0","0","0","0","0","269","118","151","0","0","0","0","0","0","0","0","0","0","0","0","0","0","0","-2"
"443562","Dewey University-Hato Rey","2018","Not on tenure/no tenure system, professors","269","118","151","0","0","0","0","0","0","0","0","0","269","118","151","0","0","0","0","0","0","0","0","0","0","0","0","0","0","0","-2"
"444398","Baptist University of the Americas","2018","Tenured total","2","1","1","0","0","0","0","0","0","0","0","0","2","1","1","0","0","0","0","0","0","0","0","0","0","0","0","0","0","0","-2"
"444398","Baptist University of the Americas","2018","Tenured, professors","2","1","1","0","0","0","0","0","0","0","0","0","2","1","1","0","0","0","0","0","0","0","0","0","0","0","0","0","0","0","-2"
"444398","Baptist University of the Americas","2018","Not on tenure track/No tenure system system total","6","2","4","0","0","0","0","0","0","0","0","0","4","0","4","0","0","0","2","2","0","0","0","0","0","0","0","0","0","0","-2"
"444398","Baptist University of the Americas","2018","Not on tenure/no tenure system, assistant professors","3","2","1","0","0","0","0","0","0","0","0","0","1","0","1","0","0","0","2","2","0","0","0","0","0","0","0","0","0","0","-2"
"444398","Baptist University of the Americas","2018","Not on tenure/no tenure system, instructors","3","0","3","0","0","0","0","0","0","0","0","0","3","0","3","0","0","0","0","0","0","0","0","0","0","0","0","0","0","0","-2"
"448752","CollegeAmerica-Colorado Springs","2018","Not on tenure track/No tenure system system total","2","2","0","0","0","0","0","0","0","0","0","0","0","0","0","0","0","0","2","2","0","0","0","0","0","0","0","0","0","0","-2"
"448752","CollegeAmerica-Colorado Springs","2018","Not on tenure/no tenure system, no academic rank","2","2","0","0","0","0","0","0","0","0","0","0","0","0","0","0","0","0","2","2","0","0","0","0","0","0","0","0","0","0","-2"
"448886","Arizona State University-Downtown Phoenix","2018","Tenured total","152","77","75","0","0","0","12","4","8","6","2","4","13","7","6","0","0","0","116","61","55","3","2","1","1","0","1","1","1","0","-2"
"448886","Arizona State University-Downtown Phoenix","2018","Tenured, professors","77","49","28","0","0","0","3","2","1","3","2","1","6","5","1","0","0","0","61","37","24","2","2","0","1","0","1","1","1","0","-2"
"448886","Arizona State University-Downtown Phoenix","2018","Tenured, associate professors","75","28","47","0","0","0","9","2","7","3","0","3","7","2","5","0","0","0","55","24","31","1","0","1","0","0","0","0","0","0","-2"
"448886","Arizona State University-Downtown Phoenix","2018","On-Tenure track total","70","30","40","0","0","0","12","6","6","1","1","0","7","1","6","0","0","0","31","16","15","4","1","3","8","2","6","7","3","4","-2"
"448886","Arizona State University-Downtown Phoenix","2018","On-tenure track, associate professors","9","4","5","0","0","0","1","1","0","0","0","0","0","0","0","0","0","0","4","1","3","1","1","0","3","1","2","0","0","0","-2"
"448886","Arizona State University-Downtown Phoenix","2018","On-tenure track, assistant professors","61","26","35","0","0","0","11","5","6","1","1","0","7","1","6","0","0","0","27","15","12","3","0","3","5","1","4","7","3","4","-2"
"448886","Arizona State University-Downtown Phoenix","2018","Not on tenure track/No tenure system system total","314","88","226","0","0","0","7","1","6","16","3","13","19","5","14","1","0","1","251","71","180","4","1","3","14","6","8","2","1","1","-2"
"448886","Arizona State University-Downtown Phoenix","2018","Not on tenure/no tenure system, professors","48","17","31","0","0","0","0","0","0","3","1","2","5","1","4","0","0","0","36","14","22","0","0","0","4","1","3","0","0","0","-2"
"448886","Arizona State University-Downtown Phoenix","2018","Not on tenure/no tenure system, associate professors","31","5","26","0","0","0","0","0","0","2","0","2","0","0","0","0","0","0","27","4","23","1","0","1","1","1","0","0","0","0","-2"
"448886","Arizona State University-Downtown Phoenix","2018","Not on tenure/no tenure system, assistant professors","49","7","42","0","0","0","2","0","2","2","0","2","5","1","4","1","0","1","38","5","33","0","0","0","0","0","0","1","1","0","-2"
"448886","Arizona State University-Downtown Phoenix","2018","Not on tenure/no tenure system, instructors","84","29","55","0","0","0","1","1","0","7","2","5","5","1","4","0","0","0","64","23","41","2","1","1","5","1","4","0","0","0","-2"
"448886","Arizona State University-Downtown Phoenix","2018","Not on tenure/no tenure system, lecturers","101","29","72","0","0","0","4","0","4","2","0","2","4","2","2","0","0","0","86","25","61","1","0","1","3","2","1","1","0","1","-2"
"448886","Arizona State University-Downtown Phoenix","2018","Not on tenure/no tenure system, no academic rank","1","1","0","0","0","0","0","0","0","0","0","0","0","0","0","0","0","0","0","0","0","0","0","0","1","1","0","0","0","0","-2"
"449870","University of the West","2018","Tenured total","6","4","2","0","0","0","5","4","1","1","0","1","0","0","0","0","0","0","0","0","0","0","0","0","0","0","0","0","0","0","-2"
"449870","University of the West","2018","Tenured, professors","2","2","0","0","0","0","2","2","0","0","0","0","0","0","0","0","0","0","0","0","0","0","0","0","0","0","0","0","0","0","-2"
"449870","University of the West","2018","Tenured, associate professors","4","2","2","0","0","0","3","2","1","1","0","1","0","0","0","0","0","0","0","0","0","0","0","0","0","0","0","0","0","0","-2"
"449870","University of the West","2018","On-Tenure track total","5","3","2","0","0","0","1","1","0","2","1","1","0","0","0","0","0","0","1","0","1","1","1","0","0","0","0","0","0","0","-2"
"449870","University of the West","2018","On-tenure track, assistant professors","5","3","2","0","0","0","1","1","0","2","1","1","0","0","0","0","0","0","1","0","1","1","1","0","0","0","0","0","0","0","-2"
"449870","University of the West","2018","Not on tenure track/No tenure system system total","4","2","2","0","0","0","2","1","1","0","0","0","2","1","1","0","0","0","0","0","0","0","0","0","0","0","0","0","0","0","-2"
"449870","University of the West","2018","Not on tenure/no tenure system, assistant professors","2","1","1","0","0","0","2","1","1","0","0","0","0","0","0","0","0","0","0","0","0","0","0","0","0","0","0","0","0","0","-2"
"449870","University of the West","2018","Not on tenure/no tenure system, instructors","2","1","1","0","0","0","0","0","0","0","0","0","2","1","1","0","0","0","0","0","0","0","0","0","0","0","0","0","0","0","-2"
"455770","Providence Christian College","2018","Not on tenure track/No tenure system system total","6","3","3","0","0","0","1","0","1","0","0","0","0","0","0","0","0","0","5","3","2","0","0","0","0","0","0","0","0","0","-2"
"455770","Providence Christian College","2018","Not on tenure/no tenure system, professors","1","1","0","0","0","0","0","0","0","0","0","0","0","0","0","0","0","0","1","1","0","0","0","0","0","0","0","0","0","0","-2"
"455770","Providence Christian College","2018","Not on tenure/no tenure system, assistant professors","4","2","2","0","0","0","1","0","1","0","0","0","0","0","0","0","0","0","3","2","1","0","0","0","0","0","0","0","0","0","-2"
"455770","Providence Christian College","2018","Not on tenure/no tenure system, instructors","1","0","1","0","0","0","0","0","0","0","0","0","0","0","0","0","0","0","1","0","1","0","0","0","0","0","0","0","0","0","-2"
"456490","Polytechnic University of Puerto Rico-Orlando","2018","Not on tenure track/No tenure system system total","6","5","1","0","0","0","0","0","0","0","0","0","6","5","1","0","0","0","0","0","0","0","0","0","0","0","0","0","0","0","-2"
"456490","Polytechnic University of Puerto Rico-Orlando","2018","Not on tenure/no tenure system, associate professors","6","5","1","0","0","0","0","0","0","0","0","0","6","5","1","0","0","0","0","0","0","0","0","0","0","0","0","0","0","0","-2"
"459949","Texas A&M University-San Antonio","2018","Tenured total","48","24","24","0","0","0","8","5","3","1","0","1","6","4","2","0","0","0","32","14","18","0","0","0","1","1","0","0","0","0","-2"
"459949","Texas A&M University-San Antonio","2018","Tenured, professors","16","10","6","0","0","0","2","2","0","0","0","0","3","2","1","0","0","0","10","5","5","0","0","0","1","1","0","0","0","0","-2"
"459949","Texas A&M University-San Antonio","2018","Tenured, associate professors","32","14","18","0","0","0","6","3","3","1","0","1","3","2","1","0","0","0","22","9","13","0","0","0","0","0","0","0","0","0","-2"
"459949","Texas A&M University-San Antonio","2018","On-Tenure track total","78","44","34","1","0","1","16","11","5","3","2","1","18","6","12","1","1","0","38","23","15","0","0","0","1","1","0","0","0","0","-2"
"459949","Texas A&M University-San Antonio","2018","On-tenure track, professors","1","1","0","0","0","0","1","1","0","0","0","0","0","0","0","0","0","0","0","0","0","0","0","0","0","0","0","0","0","0","-2"
"459949","Texas A&M University-San Antonio","2018","On-tenure track, associate professors","3","2","1","0","0","0","1","1","0","0","0","0","1","0","1","0","0","0","1","1","0","0","0","0","0","0","0","0","0","0","-2"
"459949","Texas A&M University-San Antonio","2018","On-tenure track, assistant professors","74","41","33","1","0","1","14","9","5","3","2","1","17","6","11","1","1","0","37","22","15","0","0","0","1","1","0","0","0","0","-2"
"459949","Texas A&M University-San Antonio","2018","Not on tenure track/No tenure system system total","68","34","34","0","0","0","2","1","1","5","3","2","14","8","6","1","1","0","43","21","22","0","0","0","3","0","3","0","0","0","-2"
"459949","Texas A&M University-San Antonio","2018","Not on tenure/no tenure system, professors","1","0","1","0","0","0","0","0","0","0","0","0","1","0","1","0","0","0","0","0","0","0","0","0","0","0","0","0","0","0","-2"
"459949","Texas A&M University-San Antonio","2018","Not on tenure/no tenure system, associate professors","4","3","1","0","0","0","0","0","0","0","0","0","1","1","0","0","0","0","3","2","1","0","0","0","0","0","0","0","0","0","-2"
"459949","Texas A&M University-San Antonio","2018","Not on tenure/no tenure system, assistant professors","17","13","4","0","0","0","0","0","0","1","1","0","4","4","0","1","1","0","11","7","4","0","0","0","0","0","0","0","0","0","-2"
"459949","Texas A&M University-San Antonio","2018","Not on tenure/no tenure system, lecturers","46","18","28","0","0","0","2","1","1","4","2","2","8","3","5","0","0","0","29","12","17","0","0","0","3","0","3","0","0","0","-2"
"462354","John Paul the Great Catholic University","2018","Not on tenure track/No tenure system system total","10","8","2","0","0","0","1","0","1","0","0","0","0","0","0","0","0","0","9","8","1","0","0","0","0","0","0","0","0","0","-2"
"462354","John Paul the Great Catholic University","2018","Not on tenure/no tenure system, professors","10","8","2","0","0","0","1","0","1","0","0","0","0","0","0","0","0","0","9","8","1","0","0","0","0","0","0","0","0","0","-2"
"464226","Ottawa University-Surprise","2018","Not on tenure track/No tenure system system total","6","2","4","0","0","0","1","0","1","0","0","0","0","0","0","0","0","0","5","2","3","0","0","0","0","0","0","0","0","0","-2"
"464226","Ottawa University-Surprise","2018","Not on tenure/no tenure system, associate professors","1","1","0","0","0","0","0","0","0","0","0","0","0","0","0","0","0","0","1","1","0","0","0","0","0","0","0","0","0","0","-2"
"464226","Ottawa University-Surprise","2018","Not on tenure/no tenure system, assistant professors","4","1","3","0","0","0","1","0","1","0","0","0","0","0","0","0","0","0","3","1","2","0","0","0","0","0","0","0","0","0","-2"
"464226","Ottawa University-Surprise","2018","Not on tenure/no tenure system, instructors","1","0","1","0","0","0","0","0","0","0","0","0","0","0","0","0","0","0","1","0","1","0","0","0","0","0","0","0","0","0","-2"
"474863","Los Angeles Pacific University","2018","Not on tenure track/No tenure system system total","13","8","5","1","1","0","2","0","2","2","1","1","1","1","0","0","0","0","7","5","2","0","0","0","0","0","0","0","0","0","-2"
"474863","Los Angeles Pacific University","2018","Not on tenure/no tenure system, lecturers","13","8","5","1","1","0","2","0","2","2","1","1","1","1","0","0","0","0","7","5","2","0","0","0","0","0","0","0","0","0","-2"
"475273","Springfield College-Regional, Online, and Continuing Education","2018","Tenured total","4","2","2","0","0","0","0","0","0","2","1","1","0","0","0","0","0","0","2","1","1","0","0","0","0","0","0","0","0","0","-2"
"475273","Springfield College-Regional, Online, and Continuing Education","2018","Tenured, professors","4","2","2","0","0","0","0","0","0","2","1","1","0","0","0","0","0","0","2","1","1","0","0","0","0","0","0","0","0","0","-2"
"475273","Springfield College-Regional, Online, and Continuing Education","2018","Not on tenure track/No tenure system system total","8","2","6","1","1","0","0","0","0","0","0","0","1","0","1","0","0","0","3","1","2","0","0","0","3","0","3","0","0","0","-2"
"475273","Springfield College-Regional, Online, and Continuing Education","2018","Not on tenure/no tenure system, professors","1","0","1","0","0","0","0","0","0","0","0","0","0","0","0","0","0","0","1","0","1","0","0","0","0","0","0","0","0","0","-2"
"475273","Springfield College-Regional, Online, and Continuing Education","2018","Not on tenure/no tenure system, associate professors","2","0","2","0","0","0","0","0","0","0","0","0","1","0","1","0","0","0","0","0","0","0","0","0","1","0","1","0","0","0","-2"
"475273","Springfield College-Regional, Online, and Continuing Education","2018","Not on tenure/no tenure system, assistant professors","5","2","3","1","1","0","0","0","0","0","0","0","0","0","0","0","0","0","2","1","1","0","0","0","2","0","2","0","0","0","-2"
"478634","California College San Diego","2018","Not on tenure track/No tenure system system total","7","5","2","0","0","0","1","0","1","1","1","0","1","1","0","0","0","0","3","2","1","1","1","0","0","0","0","0","0","0","-2"
"478634","California College San Diego","2018","Not on tenure/no tenure system, no academic rank","7","5","2","0","0","0","1","0","1","1","1","0","1","1","0","0","0","0","3","2","1","1","1","0","0","0","0","0","0","0","-2"
"483036","Texas A&M University-Central Texas","2018","Tenured total","20","12","8","0","0","0","1","0","1","0","0","0","0","0","0","0","0","0","19","12","7","0","0","0","0","0","0","0","0","0","-2"
"483036","Texas A&M University-Central Texas","2018","Tenured, professors","5","5","0","0","0","0","0","0","0","0","0","0","0","0","0","0","0","0","5","5","0","0","0","0","0","0","0","0","0","0","-2"
"483036","Texas A&M University-Central Texas","2018","Tenured, associate professors","15","7","8","0","0","0","1","0","1","0","0","0","0","0","0","0","0","0","14","7","7","0","0","0","0","0","0","0","0","0","-2"
"483036","Texas A&M University-Central Texas","2018","On-Tenure track total","47","25","22","0","0","0","5","1","4","5","2","3","4","0","4","0","0","0","24","17","7","1","0","1","2","0","2","6","5","1","-2"
"483036","Texas A&M University-Central Texas","2018","On-tenure track, associate professors","5","2","3","0","0","0","0","0","0","0","0","0","0","0","0","0","0","0","4","2","2","1","0","1","0","0","0","0","0","0","-2"
"483036","Texas A&M University-Central Texas","2018","On-tenure track, assistant professors","41","23","18","0","0","0","5","1","4","5","2","3","3","0","3","0","0","0","20","15","5","0","0","0","2","0","2","6","5","1","-2"
"483036","Texas A&M University-Central Texas","2018","On-tenure track, lecturers","1","0","1","0","0","0","0","0","0","0","0","0","1","0","1","0","0","0","0","0","0","0","0","0","0","0","0","0","0","0","-2"
"483036","Texas A&M University-Central Texas","2018","Not on tenure track/No tenure system system total","23","9","14","0","0","0","0","0","0","1","1","0","3","0","3","0","0","0","17","7","10","0","0","0","1","0","1","1","1","0","-2"
"483036","Texas A&M University-Central Texas","2018","Not on tenure/no tenure system, professors","5","0","5","0","0","0","0","0","0","0","0","0","0","0","0","0","0","0","5","0","5","0","0","0","0","0","0","0","0","0","-2"
"483036","Texas A&M University-Central Texas","2018","Not on tenure/no tenure system, associate professors","1","1","0","0","0","0","0","0","0","0","0","0","0","0","0","0","0","0","1","1","0","0","0","0","0","0","0","0","0","0","-2"
"483036","Texas A&M University-Central Texas","2018","Not on tenure/no tenure system, assistant professors","5","2","3","0","0","0","0","0","0","0","0","0","0","0","0","0","0","0","3","1","2","0","0","0","1","0","1","1","1","0","-2"
"483036","Texas A&M University-Central Texas","2018","Not on tenure/no tenure system, instructors","1","0","1","0","0","0","0","0","0","0","0","0","0","0","0","0","0","0","1","0","1","0","0","0","0","0","0","0","0","0","-2"
"483036","Texas A&M University-Central Texas","2018","Not on tenure/no tenure system, lecturers","11","6","5","0","0","0","0","0","0","1","1","0","3","0","3","0","0","0","7","5","2","0","0","0","0","0","0","0","0","0","-2"
"484905","University of North Texas at Dallas","2018","Tenured total","27","14","13","0","0","0","7","5","2","1","0","1","4","3","1","0","0","0","13","5","8","0","0","0","0","0","0","2","1","1","-2"
"484905","University of North Texas at Dallas","2018","Tenured, professors","10","4","6","0","0","0","2","2","0","1","0","1","2","1","1","0","0","0","5","1","4","0","0","0","0","0","0","0","0","0","-2"
"484905","University of North Texas at Dallas","2018","Tenured, associate professors","17","10","7","0","0","0","5","3","2","0","0","0","2","2","0","0","0","0","8","4","4","0","0","0","0","0","0","2","1","1","-2"
"484905","University of North Texas at Dallas","2018","On-Tenure track total","34","18","16","0","0","0","2","0","2","7","6","1","2","1","1","0","0","0","22","11","11","0","0","0","1","0","1","0","0","0","-2"
"484905","University of North Texas at Dallas","2018","On-tenure track, associate professors","3","2","1","0","0","0","0","0","0","1","1","0","0","0","0","0","0","0","2","1","1","0","0","0","0","0","0","0","0","0","-2"
"484905","University of North Texas at Dallas","2018","On-tenure track, assistant professors","31","16","15","0","0","0","2","0","2","6","5","1","2","1","1","0","0","0","20","10","10","0","0","0","1","0","1","0","0","0","-2"
"484905","University of North Texas at Dallas","2018","Not on tenure track/No tenure system system total","42","20","22","1","1","0","2","2","0","9","3","6","4","0","4","0","0","0","24","14","10","1","0","1","1","0","1","0","0","0","-2"
"484905","University of North Texas at Dallas","2018","Not on tenure/no tenure system, assistant professors","1","1","0","0","0","0","0","0","0","1","1","0","0","0","0","0","0","0","0","0","0","0","0","0","0","0","0","0","0","0","-2"
"484905","University of North Texas at Dallas","2018","Not on tenure/no tenure system, lecturers","41","19","22","1","1","0","2","2","0","8","2","6","4","0","4","0","0","0","24","14","10","1","0","1","1","0","1","0","0","0","-2"
"485263","California College San Diego","2018","Not on tenure track/No tenure system system total","14","7","7","0","0","0","4","3","1","0","0","0","3","2","1","0","0","0","7","2","5","0","0","0","0","0","0","0","0","0","-2"
"485263","California College San Diego","2018","Not on tenure/no tenure system, no academic rank","14","7","7","0","0","0","4","3","1","0","0","0","3","2","1","0","0","0","7","2","5","0","0","0","0","0","0","0","0","0","-2"
"487296","University of Arizona-Sierra Vista","2018","Tenured total","6","3","3","0","0","0","1","0","1","0","0","0","1","1","0","0","0","0","4","2","2","0","0","0","0","0","0","0","0","0","-2"
"487296","University of Arizona-Sierra Vista","2018","Tenured, professors","3","0","3","0","0","0","1","0","1","0","0","0","0","0","0","0","0","0","2","0","2","0","0","0","0","0","0","0","0","0","-2"
"487296","University of Arizona-Sierra Vista","2018","Tenured, associate professors","3","3","0","0","0","0","0","0","0","0","0","0","1","1","0","0","0","0","2","2","0","0","0","0","0","0","0","0","0","0","-2"
"487296","University of Arizona-Sierra Vista","2018","On-Tenure track total","2","1","1","1","0","1","0","0","0","0","0","0","1","1","0","0","0","0","0","0","0","0","0","0","0","0","0","0","0","0","-2"
"487296","University of Arizona-Sierra Vista","2018","On-tenure track, assistant professors","2","1","1","1","0","1","0","0","0","0","0","0","1","1","0","0","0","0","0","0","0","0","0","0","0","0","0","0","0","0","-2"
"487296","University of Arizona-Sierra Vista","2018","Not on tenure track/No tenure system system total","18","9","9","1","0","1","0","0","0","0","0","0","2","1","1","0","0","0","14","7","7","0","0","0","1","1","0","0","0","0","-2"
"487296","University of Arizona-Sierra Vista","2018","Not on tenure/no tenure system, professors","1","1","0","0","0","0","0","0","0","0","0","0","0","0","0","0","0","0","1","1","0","0","0","0","0","0","0","0","0","0","-2"
"487296","University of Arizona-Sierra Vista","2018","Not on tenure/no tenure system, assistant professors","15","7","8","1","0","1","0","0","0","0","0","0","2","1","1","0","0","0","11","5","6","0","0","0","1","1","0","0","0","0","-2"
"487296","University of Arizona-Sierra Vista","2018","Not on tenure/no tenure system, lecturers","2","1","1","0","0","0","0","0","0","0","0","0","0","0","0","0","0","0","2","1","1","0","0","0","0","0","0","0","0","0","-2"
"488785","University of Saint Katherine","2018","Not on tenure track/No tenure system system total","4","3","1","0","0","0","0","0","0","0","0","0","0","0","0","0","0","0","4","3","1","0","0","0","0","0","0","0","0","0","-2"
"488785","University of Saint Katherine","2018","Not on tenure/no tenure system, assistant professors","4","3","1","0","0","0","0","0","0","0","0","0","0","0","0","0","0","0","4","3","1","0","0","0","0","0","0","0","0","0","-2"
"492689","Texas Tech University Health Sciences Center-El Paso","2018","Tenured total","31","26","5","0","0","0","9","7","2","0","0","0","3","3","0","0","0","0","19","16","3","0","0","0","0","0","0","0","0","0","-2"
"492689","Texas Tech University Health Sciences Center-El Paso","2018","Tenured, professors","22","19","3","0","0","0","4","3","1","0","0","0","3","3","0","0","0","0","15","13","2","0","0","0","0","0","0","0","0","0","-2"
"492689","Texas Tech University Health Sciences Center-El Paso","2018","Tenured, associate professors","9","7","2","0","0","0","5","4","1","0","0","0","0","0","0","0","0","0","4","3","1","0","0","0","0","0","0","0","0","0","-2"
"492689","Texas Tech University Health Sciences Center-El Paso","2018","On-Tenure track total","20","11","9","0","0","0","7","4","3","0","0","0","5","3","2","0","0","0","8","4","4","0","0","0","0","0","0","0","0","0","-2"
"492689","Texas Tech University Health Sciences Center-El Paso","2018","On-tenure track, professors","5","5","0","0","0","0","2","2","0","0","0","0","0","0","0","0","0","0","3","3","0","0","0","0","0","0","0","0","0","0","-2"
"492689","Texas Tech University Health Sciences Center-El Paso","2018","On-tenure track, associate professors","7","4","3","0","0","0","3","2","1","0","0","0","2","1","1","0","0","0","2","1","1","0","0","0","0","0","0","0","0","0","-2"
"492689","Texas Tech University Health Sciences Center-El Paso","2018","On-tenure track, assistant professors","8","2","6","0","0","0","2","0","2","0","0","0","3","2","1","0","0","0","3","0","3","0","0","0","0","0","0","0","0","0","-2"
"492689","Texas Tech University Health Sciences Center-El Paso","2018","Not on tenure track/No tenure system system total","224","118","106","0","0","0","28","12","16","14","4","10","80","40","40","0","0","0","72","40","32","0","0","0","1","1","0","29","21","8","-2"
"492689","Texas Tech University Health Sciences Center-El Paso","2018","Not on tenure/no tenure system, professors","10","5","5","0","0","0","1","0","1","1","0","1","1","1","0","0","0","0","7","4","3","0","0","0","0","0","0","0","0","0","-2"
"492689","Texas Tech University Health Sciences Center-El Paso","2018","Not on tenure/no tenure system, associate professors","36","24","12","0","0","0","5","2","3","4","1","3","11","9","2","0","0","0","15","11","4","0","0","0","0","0","0","1","1","0","-2"
"492689","Texas Tech University Health Sciences Center-El Paso","2018","Not on tenure/no tenure system, assistant professors","141","78","63","0","0","0","20","10","10","8","3","5","43","21","22","0","0","0","42","24","18","0","0","0","1","1","0","27","19","8","-2"
"492689","Texas Tech University Health Sciences Center-El Paso","2018","Not on tenure/no tenure system, instructors","15","4","11","0","0","0","2","0","2","1","0","1","9","3","6","0","0","0","2","0","2","0","0","0","0","0","0","1","1","0","-2"
"492689","Texas Tech University Health Sciences Center-El Paso","2018","Not on tenure/no tenure system, no academic rank","22","7","15","0","0","0","0","0","0","0","0","0","16","6","10","0","0","0","6","1","5","0","0","0","0","0","0","0","0","0","-2"
