"unitid","institution name","year","S2017_IS.Instructional staff category","S2017_IS_RV.Grand total","S2017_IS_RV.Grand total men","S2017_IS_RV.Grand total women","S2017_IS_RV.American Indian or Alaska Native total","S2017_IS_RV.American Indian or Alaska Native men","S2017_IS_RV.American Indian or Alaska Native women","S2017_IS_RV.Asian total","S2017_IS_RV.Asian men","S2017_IS_RV.Asian women","S2017_IS_RV.Black or African American total","S2017_IS_RV.Black or African American men","S2017_IS_RV.Black or African American women","S2017_IS_RV.Hispanic or Latino total","S2017_IS_RV.Hispanic or Latino men","S2017_IS_RV.Hispanic or Latino women","S2017_IS_RV.Native Hawaiian or Other Pacific Islander total","S2017_IS_RV.Native Hawaiian or Other Pacific Islander men","S2017_IS_RV.Native Hawaiian or Other Pacific Islander women","S2017_IS_RV.White total","S2017_IS_RV.White men","S2017_IS_RV.White women","S2017_IS_RV.Two or more races total","S2017_IS_RV.Two or more races men","S2017_IS_RV.Two or more races women","S2017_IS_RV.Race/ethnicity unknown total","S2017_IS_RV.Race/ethnicity unknown men","S2017_IS_RV.Race/ethnicity unknown women","S2017_IS_RV.Nonresident alien total","S2017_IS_RV.Nonresident alien men","S2017_IS_RV.Nonresident alien women","IDX_HR"
"104188","Southwest University of Visual Arts-Tucson","2017","Not on tenure track/No tenure system system total","10","7","3","0","0","0","0","0","0","0","0","0","2","2","0","0","0","0","8","5","3","0","0","0","0","0","0","0","0","0","-2"
"104188","Southwest University of Visual Arts-Tucson","2017","Not on tenure/no tenure system, professors","10","7","3","0","0","0","0","0","0","0","0","0","2","2","0","0","0","0","8","5","3","0","0","0","0","0","0","0","0","0","-2"
"105367","Ottawa University-Phoenix","2017","Tenured total","3","1","2","0","0","0","1","0","1","1","0","1","1","1","0","0","0","0","0","0","0","0","0","0","0","0","0","0","0","0","-2"
"105367","Ottawa University-Phoenix","2017","Tenured, professors","1","0","1","0","0","0","1","0","1","0","0","0","0","0","0","0","0","0","0","0","0","0","0","0","0","0","0","0","0","0","-2"
"105367","Ottawa University-Phoenix","2017","Tenured, associate professors","2","1","1","0","0","0","0","0","0","1","0","1","1","1","0","0","0","0","0","0","0","0","0","0","0","0","0","0","0","0","-2"
"105367","Ottawa University-Phoenix","2017","Not on tenure track/No tenure system system total","2","0","2","0","0","0","0","0","0","0","0","0","0","0","0","0","0","0","2","0","2","0","0","0","0","0","0","0","0","0","-2"
"105367","Ottawa University-Phoenix","2017","Not on tenure/no tenure system, associate professors","2","0","2","0","0","0","0","0","0","0","0","0","0","0","0","0","0","0","2","0","2","0","0","0","0","0","0","0","0","0","-2"
"109350","Antelope Valley College","2017","Tenured total","128","68","60","1","1","0","8","5","3","10","4","6","11","8","3","0","0","0","93","48","45","5","2","3","0","0","0","0","0","0","-2"
"109350","Antelope Valley College","2017","Tenured, professors","60","26","34","1","1","0","2","0","2","4","0","4","5","3","2","0","0","0","44","20","24","4","2","2","0","0","0","0","0","0","-2"
"109350","Antelope Valley College","2017","Tenured, associate professors","13","8","5","0","0","0","1","0","1","1","0","1","2","2","0","0","0","0","9","6","3","0","0","0","0","0","0","0","0","0","-2"
"109350","Antelope Valley College","2017","Tenured, assistant professors","5","2","3","0","0","0","0","0","0","0","0","0","0","0","0","0","0","0","5","2","3","0","0","0","0","0","0","0","0","0","-2"
"109350","Antelope Valley College","2017","Tenured, instructors","1","0","1","0","0","0","0","0","0","0","0","0","0","0","0","0","0","0","1","0","1","0","0","0","0","0","0","0","0","0","-2"
"109350","Antelope Valley College","2017","Tenured, no academic rank","49","32","17","0","0","0","5","5","0","5","4","1","4","3","1","0","0","0","34","20","14","1","0","1","0","0","0","0","0","0","-2"
"109350","Antelope Valley College","2017","On-Tenure track total","34","21","13","0","0","0","2","2","0","2","1","1","4","1","3","1","0","1","19","13","6","4","3","1","2","1","1","0","0","0","-2"
"109350","Antelope Valley College","2017","On-tenure track, assistant professors","1","1","0","0","0","0","0","0","0","0","0","0","0","0","0","0","0","0","1","1","0","0","0","0","0","0","0","0","0","0","-2"
"109350","Antelope Valley College","2017","On-tenure track, no academic rank","33","20","13","0","0","0","2","2","0","2","1","1","4","1","3","1","0","1","18","12","6","4","3","1","2","1","1","0","0","0","-2"
"109785","Azusa Pacific University","2017","Not on tenure track/No tenure system system total","484","221","263","5","3","2","64","24","40","27","10","17","33","16","17","3","2","1","322","148","174","1","0","1","29","18","11","0","0","0","-2"
"109785","Azusa Pacific University","2017","Not on tenure/no tenure system, professors","139","87","52","1","1","0","14","10","4","11","6","5","4","2","2","0","0","0","99","61","38","0","0","0","10","7","3","0","0","0","-2"
"109785","Azusa Pacific University","2017","Not on tenure/no tenure system, associate professors","119","59","60","1","0","1","19","8","11","5","1","4","10","4","6","1","0","1","75","41","34","0","0","0","8","5","3","0","0","0","-2"
"109785","Azusa Pacific University","2017","Not on tenure/no tenure system, assistant professors","202","71","131","3","2","1","29","6","23","11","3","8","14","7","7","2","2","0","132","45","87","1","0","1","10","6","4","0","0","0","-2"
"109785","Azusa Pacific University","2017","Not on tenure/no tenure system, instructors","24","4","20","0","0","0","2","0","2","0","0","0","5","3","2","0","0","0","16","1","15","0","0","0","1","0","1","0","0","0","-2"
"109819","Bakersfield College","2017","Tenured total","176","93","83","2","1","1","8","4","4","9","5","4","17","8","9","1","1","0","127","69","58","0","0","0","12","5","7","0","0","0","-2"
"109819","Bakersfield College","2017","Tenured, instructors","176","93","83","2","1","1","8","4","4","9","5","4","17","8","9","1","1","0","127","69","58","0","0","0","12","5","7","0","0","0","-2"
"109819","Bakersfield College","2017","On-Tenure track total","130","63","67","1","1","0","7","5","2","5","3","2","33","12","21","0","0","0","84","42","42","0","0","0","0","0","0","0","0","0","-2"
"109819","Bakersfield College","2017","On-tenure track, instructors","130","63","67","1","1","0","7","5","2","5","3","2","33","12","21","0","0","0","84","42","42","0","0","0","0","0","0","0","0","0","-2"
"109819","Bakersfield College","2017","Not on tenure track/No tenure system system total","18","9","9","0","0","0","0","0","0","2","1","1","4","3","1","0","0","0","12","5","7","0","0","0","0","0","0","0","0","0","-2"
"109819","Bakersfield College","2017","Not on tenure/no tenure system, instructors","18","9","9","0","0","0","0","0","0","2","1","1","4","3","1","0","0","0","12","5","7","0","0","0","0","0","0","0","0","0","-2"
"110361","California Baptist University","2017","Tenured total","95","59","36","0","0","0","14","10","4","1","0","1","5","1","4","0","0","0","72","47","25","3","1","2","0","0","0","0","0","0","-2"
"110361","California Baptist University","2017","Tenured, professors","73","49","24","0","0","0","11","9","2","0","0","0","5","1","4","0","0","0","55","38","17","2","1","1","0","0","0","0","0","0","-2"
"110361","California Baptist University","2017","Tenured, associate professors","22","10","12","0","0","0","3","1","2","1","0","1","0","0","0","0","0","0","17","9","8","1","0","1","0","0","0","0","0","0","-2"
"110361","California Baptist University","2017","On-Tenure track total","208","102","106","2","0","2","32","16","16","17","8","9","19","8","11","1","0","1","124","67","57","5","2","3","8","1","7","0","0","0","-2"
"110361","California Baptist University","2017","On-tenure track, professors","13","9","4","0","0","0","4","4","0","0","0","0","1","1","0","0","0","0","7","4","3","1","0","1","0","0","0","0","0","0","-2"
"110361","California Baptist University","2017","On-tenure track, associate professors","73","42","31","1","0","1","13","8","5","5","3","2","6","3","3","0","0","0","46","27","19","1","1","0","1","0","1","0","0","0","-2"
"110361","California Baptist University","2017","On-tenure track, assistant professors","122","51","71","1","0","1","15","4","11","12","5","7","12","4","8","1","0","1","71","36","35","3","1","2","7","1","6","0","0","0","-2"
"110361","California Baptist University","2017","Not on tenure track/No tenure system system total","21","8","13","0","0","0","0","0","0","1","0","1","2","0","2","0","0","0","18","8","10","0","0","0","0","0","0","0","0","0","-2"
"110361","California Baptist University","2017","Not on tenure/no tenure system, instructors","10","4","6","0","0","0","0","0","0","0","0","0","1","0","1","0","0","0","9","4","5","0","0","0","0","0","0","0","0","0","-2"
"110361","California Baptist University","2017","Not on tenure/no tenure system, lecturers","11","4","7","0","0","0","0","0","0","1","0","1","1","0","1","0","0","0","9","4","5","0","0","0","0","0","0","0","0","0","-2"
"110413","California Lutheran University","2017","Tenured total","103","54","49","0","0","0","10","5","5","4","2","2","8","2","6","0","0","0","80","45","35","0","0","0","1","0","1","0","0","0","-2"
"110413","California Lutheran University","2017","Tenured, professors","51","31","20","0","0","0","5","2","3","3","2","1","1","1","0","0","0","0","41","26","15","0","0","0","1","0","1","0","0","0","-2"
"110413","California Lutheran University","2017","Tenured, associate professors","45","19","26","0","0","0","4","2","2","1","0","1","6","0","6","0","0","0","34","17","17","0","0","0","0","0","0","0","0","0","-2"
"110413","California Lutheran University","2017","Tenured, assistant professors","7","4","3","0","0","0","1","1","0","0","0","0","1","1","0","0","0","0","5","2","3","0","0","0","0","0","0","0","0","0","-2"
"110413","California Lutheran University","2017","On-Tenure track total","42","18","24","0","0","0","5","4","1","1","0","1","9","4","5","0","0","0","24","9","15","2","1","1","1","0","1","0","0","0","-2"
"110413","California Lutheran University","2017","On-tenure track, professors","3","1","2","0","0","0","0","0","0","0","0","0","0","0","0","0","0","0","3","1","2","0","0","0","0","0","0","0","0","0","-2"
"110413","California Lutheran University","2017","On-tenure track, associate professors","4","2","2","0","0","0","0","0","0","0","0","0","1","1","0","0","0","0","2","0","2","1","1","0","0","0","0","0","0","0","-2"
"110413","California Lutheran University","2017","On-tenure track, assistant professors","35","15","20","0","0","0","5","4","1","1","0","1","8","3","5","0","0","0","19","8","11","1","0","1","1","0","1","0","0","0","-2"
"110413","California Lutheran University","2017","Not on tenure track/No tenure system system total","45","23","22","1","0","1","1","1","0","2","2","0","0","0","0","0","0","0","39","19","20","1","0","1","1","1","0","0","0","0","-2"
"110413","California Lutheran University","2017","Not on tenure/no tenure system, professors","5","3","2","0","0","0","0","0","0","0","0","0","0","0","0","0","0","0","5","3","2","0","0","0","0","0","0","0","0","0","-2"
"110413","California Lutheran University","2017","Not on tenure/no tenure system, assistant professors","5","3","2","0","0","0","0","0","0","0","0","0","0","0","0","0","0","0","5","3","2","0","0","0","0","0","0","0","0","0","-2"
"110413","California Lutheran University","2017","Not on tenure/no tenure system, instructors","1","1","0","0","0","0","0","0","0","0","0","0","0","0","0","0","0","0","1","1","0","0","0","0","0","0","0","0","0","0","-2"
"110413","California Lutheran University","2017","Not on tenure/no tenure system, lecturers","32","14","18","1","0","1","1","1","0","0","0","0","0","0","0","0","0","0","28","12","16","1","0","1","1","1","0","0","0","0","-2"
"110413","California Lutheran University","2017","Not on tenure/no tenure system, no academic rank","2","2","0","0","0","0","0","0","0","2","2","0","0","0","0","0","0","0","0","0","0","0","0","0","0","0","0","0","0","0","-2"
"110486","California State University-Bakersfield","2017","Tenured total","123","74","49","0","0","0","18","13","5","6","3","3","18","13","5","1","1","0","71","38","33","2","0","2","3","3","0","4","3","1","-2"
"110486","California State University-Bakersfield","2017","Tenured, professors","81","48","33","0","0","0","14","11","3","3","2","1","9","5","4","1","1","0","49","27","22","2","0","2","1","1","0","2","1","1","-2"
"110486","California State University-Bakersfield","2017","Tenured, associate professors","41","25","16","0","0","0","3","1","2","3","1","2","9","8","1","0","0","0","22","11","11","0","0","0","2","2","0","2","2","0","-2"
"110486","California State University-Bakersfield","2017","Tenured, assistant professors","1","1","0","0","0","0","1","1","0","0","0","0","0","0","0","0","0","0","0","0","0","0","0","0","0","0","0","0","0","0","-2"
"110486","California State University-Bakersfield","2017","On-Tenure track total","75","36","39","0","0","0","12","8","4","2","0","2","10","4","6","0","0","0","37","15","22","0","0","0","1","1","0","13","8","5","-2"
"110486","California State University-Bakersfield","2017","On-tenure track, associate professors","3","0","3","0","0","0","1","0","1","0","0","0","1","0","1","0","0","0","1","0","1","0","0","0","0","0","0","0","0","0","-2"
"110486","California State University-Bakersfield","2017","On-tenure track, assistant professors","72","36","36","0","0","0","11","8","3","2","0","2","9","4","5","0","0","0","36","15","21","0","0","0","1","1","0","13","8","5","-2"
"110486","California State University-Bakersfield","2017","Not on tenure track/No tenure system system total","95","34","61","0","0","0","5","2","3","3","0","3","12","3","9","1","0","1","65","22","43","1","1","0","1","0","1","7","6","1","-2"
"110486","California State University-Bakersfield","2017","Not on tenure/no tenure system, lecturers","95","34","61","0","0","0","5","2","3","3","0","3","12","3","9","1","0","1","65","22","43","1","1","0","1","0","1","7","6","1","-2"
"110495","California State University-Stanislaus","2017","Tenured total","170","100","70","1","0","1","27","11","16","7","5","2","15","10","5","0","0","0","113","70","43","1","1","0","5","3","2","1","0","1","-2"
"110495","California State University-Stanislaus","2017","Tenured, professors","125","73","52","1","0","1","19","5","14","3","3","0","12","8","4","0","0","0","86","54","32","0","0","0","4","3","1","0","0","0","-2"
"110495","California State University-Stanislaus","2017","Tenured, associate professors","45","27","18","0","0","0","8","6","2","4","2","2","3","2","1","0","0","0","27","16","11","1","1","0","1","0","1","1","0","1","-2"
"110495","California State University-Stanislaus","2017","On-Tenure track total","83","41","42","0","0","0","10","7","3","3","1","2","12","4","8","0","0","0","44","22","22","0","0","0","6","1","5","8","6","2","-2"
"110495","California State University-Stanislaus","2017","On-tenure track, associate professors","3","1","2","0","0","0","1","1","0","0","0","0","0","0","0","0","0","0","2","0","2","0","0","0","0","0","0","0","0","0","-2"
"110495","California State University-Stanislaus","2017","On-tenure track, assistant professors","80","40","40","0","0","0","9","6","3","3","1","2","12","4","8","0","0","0","42","22","20","0","0","0","6","1","5","8","6","2","-2"
"110495","California State University-Stanislaus","2017","Not on tenure track/No tenure system system total","67","32","35","0","0","0","5","1","4","0","0","0","5","1","4","1","0","1","53","29","24","0","0","0","3","1","2","0","0","0","-2"
"110495","California State University-Stanislaus","2017","Not on tenure/no tenure system, lecturers","67","32","35","0","0","0","5","1","4","0","0","0","5","1","4","1","0","1","53","29","24","0","0","0","3","1","2","0","0","0","-2"
"110510","California State University-San Bernardino","2017","Tenured total","255","148","107","1","1","0","50","27","23","9","4","5","21","11","10","0","0","0","162","99","63","1","1","0","10","5","5","1","0","1","-2"
"110510","California State University-San Bernardino","2017","Tenured, professors","198","125","73","1","1","0","36","23","13","7","3","4","16","10","6","0","0","0","132","83","49","1","1","0","5","4","1","0","0","0","-2"
"110510","California State University-San Bernardino","2017","Tenured, associate professors","54","21","33","0","0","0","13","3","10","2","1","1","5","1","4","0","0","0","28","15","13","0","0","0","5","1","4","1","0","1","-2"
"110510","California State University-San Bernardino","2017","Tenured, assistant professors","3","2","1","0","0","0","1","1","0","0","0","0","0","0","0","0","0","0","2","1","1","0","0","0","0","0","0","0","0","0","-2"
"110510","California State University-San Bernardino","2017","On-Tenure track total","117","58","59","0","0","0","18","10","8","8","4","4","17","6","11","0","0","0","52","25","27","0","0","0","10","6","4","12","7","5","-2"
"110510","California State University-San Bernardino","2017","On-tenure track, professors","4","2","2","0","0","0","0","0","0","0","0","0","0","0","0","0","0","0","3","2","1","0","0","0","1","0","1","0","0","0","-2"
"110510","California State University-San Bernardino","2017","On-tenure track, associate professors","5","1","4","0","0","0","0","0","0","2","0","2","0","0","0","0","0","0","3","1","2","0","0","0","0","0","0","0","0","0","-2"
"110510","California State University-San Bernardino","2017","On-tenure track, assistant professors","108","55","53","0","0","0","18","10","8","6","4","2","17","6","11","0","0","0","46","22","24","0","0","0","9","6","3","12","7","5","-2"
"110510","California State University-San Bernardino","2017","Not on tenure track/No tenure system system total","98","32","66","1","0","1","9","1","8","4","2","2","9","3","6","0","0","0","66","22","44","0","0","0","8","3","5","1","1","0","-2"
"110510","California State University-San Bernardino","2017","Not on tenure/no tenure system, lecturers","98","32","66","1","0","1","9","1","8","4","2","2","9","3","6","0","0","0","66","22","44","0","0","0","8","3","5","1","1","0","-2"
"110529","California State Polytechnic University-Pomona","2017","Tenured total","328","196","132","1","0","1","93","55","38","8","6","2","30","19","11","1","1","0","175","106","69","0","0","0","16","9","7","4","0","4","-2"
"110529","California State Polytechnic University-Pomona","2017","Tenured, professors","251","159","92","1","0","1","67","45","22","6","4","2","24","15","9","1","1","0","143","89","54","0","0","0","9","5","4","0","0","0","-2"
"110529","California State Polytechnic University-Pomona","2017","Tenured, associate professors","77","37","40","0","0","0","26","10","16","2","2","0","6","4","2","0","0","0","32","17","15","0","0","0","7","4","3","4","0","4","-2"
"110529","California State Polytechnic University-Pomona","2017","On-Tenure track total","179","104","75","1","1","0","31","14","17","4","2","2","21","12","9","0","0","0","87","51","36","2","2","0","7","5","2","26","17","9","-2"
"110529","California State Polytechnic University-Pomona","2017","On-tenure track, associate professors","3","2","1","0","0","0","0","0","0","0","0","0","0","0","0","0","0","0","3","2","1","0","0","0","0","0","0","0","0","0","-2"
"110529","California State Polytechnic University-Pomona","2017","On-tenure track, assistant professors","176","102","74","1","1","0","31","14","17","4","2","2","21","12","9","0","0","0","84","49","35","2","2","0","7","5","2","26","17","9","-2"
"110529","California State Polytechnic University-Pomona","2017","Not on tenure track/No tenure system system total","100","61","39","1","1","0","15","8","7","3","2","1","14","11","3","1","1","0","59","33","26","1","0","1","2","2","0","4","3","1","-2"
"110529","California State Polytechnic University-Pomona","2017","Not on tenure/no tenure system, lecturers","100","61","39","1","1","0","15","8","7","3","2","1","14","11","3","1","1","0","59","33","26","1","0","1","2","2","0","4","3","1","-2"
"110547","California State University-Dominguez Hills","2017","Tenured total","147","74","73","1","0","1","31","17","14","11","6","5","16","9","7","0","0","0","76","36","40","5","3","2","7","3","4","0","0","0","-2"
"110547","California State University-Dominguez Hills","2017","Tenured, professors","95","53","42","0","0","0","20","14","6","8","4","4","8","5","3","0","0","0","53","26","27","2","2","0","4","2","2","0","0","0","-2"
"110547","California State University-Dominguez Hills","2017","Tenured, associate professors","52","21","31","1","0","1","11","3","8","3","2","1","8","4","4","0","0","0","23","10","13","3","1","2","3","1","2","0","0","0","-2"
"110547","California State University-Dominguez Hills","2017","On-Tenure track total","85","32","53","2","1","1","15","4","11","8","4","4","9","2","7","0","0","0","35","12","23","3","2","1","4","1","3","9","6","3","-2"
"110547","California State University-Dominguez Hills","2017","On-tenure track, professors","2","1","1","0","0","0","0","0","0","0","0","0","0","0","0","0","0","0","2","1","1","0","0","0","0","0","0","0","0","0","-2"
"110547","California State University-Dominguez Hills","2017","On-tenure track, associate professors","7","4","3","1","1","0","3","1","2","1","1","0","0","0","0","0","0","0","2","1","1","0","0","0","0","0","0","0","0","0","-2"
"110547","California State University-Dominguez Hills","2017","On-tenure track, assistant professors","76","27","49","1","0","1","12","3","9","7","3","4","9","2","7","0","0","0","31","10","21","3","2","1","4","1","3","9","6","3","-2"
"110547","California State University-Dominguez Hills","2017","Not on tenure track/No tenure system system total","122","54","68","1","0","1","11","5","6","17","5","12","22","10","12","0","0","0","60","30","30","2","0","2","6","3","3","3","1","2","-2"
"110547","California State University-Dominguez Hills","2017","Not on tenure/no tenure system, lecturers","122","54","68","1","0","1","11","5","6","17","5","12","22","10","12","0","0","0","60","30","30","2","0","2","6","3","3","3","1","2","-2"
"110556","California State University-Fresno","2017","Tenured total","342","212","130","0","0","0","60","45","15","13","7","6","33","21","12","0","0","0","219","129","90","4","3","1","7","3","4","6","4","2","-2"
"110556","California State University-Fresno","2017","Tenured, professors","222","142","80","0","0","0","29","24","5","8","4","4","19","14","5","0","0","0","156","94","62","3","3","0","5","2","3","2","1","1","-2"
"110556","California State University-Fresno","2017","Tenured, associate professors","115","66","49","0","0","0","31","21","10","5","3","2","14","7","7","0","0","0","59","32","27","1","0","1","2","1","1","3","2","1","-2"
"110556","California State University-Fresno","2017","Tenured, assistant professors","3","2","1","0","0","0","0","0","0","0","0","0","0","0","0","0","0","0","2","1","1","0","0","0","0","0","0","1","1","0","-2"
"110556","California State University-Fresno","2017","Tenured, no academic rank","2","2","0","0","0","0","0","0","0","0","0","0","0","0","0","0","0","0","2","2","0","0","0","0","0","0","0","0","0","0","-2"
"110556","California State University-Fresno","2017","On-Tenure track total","237","112","125","2","0","2","35","21","14","14","8","6","41","21","20","0","0","0","116","47","69","4","3","1","7","4","3","18","8","10","-2"
"110556","California State University-Fresno","2017","On-tenure track, associate professors","7","5","2","0","0","0","3","2","1","1","1","0","1","1","0","0","0","0","1","0","1","0","0","0","0","0","0","1","1","0","-2"
"110556","California State University-Fresno","2017","On-tenure track, assistant professors","228","106","122","2","0","2","32","19","13","13","7","6","39","20","19","0","0","0","114","46","68","4","3","1","7","4","3","17","7","10","-2"
"110556","California State University-Fresno","2017","On-tenure track, no academic rank","2","1","1","0","0","0","0","0","0","0","0","0","1","0","1","0","0","0","1","1","0","0","0","0","0","0","0","0","0","0","-2"
"110556","California State University-Fresno","2017","Not on tenure track/No tenure system system total","198","87","111","3","0","3","15","8","7","4","1","3","29","13","16","1","1","0","123","57","66","3","1","2","19","6","13","1","0","1","-2"
"110556","California State University-Fresno","2017","Not on tenure/no tenure system, lecturers","198","87","111","3","0","3","15","8","7","4","1","3","29","13","16","1","1","0","123","57","66","3","1","2","19","6","13","1","0","1","-2"
"110565","California State University-Fullerton","2017","Tenured total","525","294","231","1","1","0","116","66","50","13","6","7","39","23","16","1","1","0","347","191","156","0","0","0","1","1","0","7","5","2","-2"
"110565","California State University-Fullerton","2017","Tenured, professors","323","185","138","1","1","0","73","43","30","5","2","3","22","10","12","1","1","0","221","128","93","0","0","0","0","0","0","0","0","0","-2"
"110565","California State University-Fullerton","2017","Tenured, associate professors","202","109","93","0","0","0","43","23","20","8","4","4","17","13","4","0","0","0","126","63","63","0","0","0","1","1","0","7","5","2","-2"
"110565","California State University-Fullerton","2017","On-Tenure track total","255","117","138","2","1","1","40","14","26","13","5","8","30","9","21","0","0","0","114","60","54","0","0","0","4","2","2","52","26","26","-2"
"110565","California State University-Fullerton","2017","On-tenure track, associate professors","21","13","8","0","0","0","3","2","1","0","0","0","2","1","1","0","0","0","10","7","3","0","0","0","1","1","0","5","2","3","-2"
"110565","California State University-Fullerton","2017","On-tenure track, assistant professors","234","104","130","2","1","1","37","12","25","13","5","8","28","8","20","0","0","0","104","53","51","0","0","0","3","1","2","47","24","23","-2"
"110565","California State University-Fullerton","2017","Not on tenure track/No tenure system system total","246","102","144","0","0","0","44","20","24","8","3","5","23","9","14","0","0","0","154","61","93","2","1","1","13","7","6","2","1","1","-2"
"110565","California State University-Fullerton","2017","Not on tenure/no tenure system, lecturers","246","102","144","0","0","0","44","20","24","8","3","5","23","9","14","0","0","0","154","61","93","2","1","1","13","7","6","2","1","1","-2"
"110574","California State University-East Bay","2017","Tenured total","190","93","97","0","0","0","40","19","21","10","4","6","21","9","12","1","0","1","106","54","52","2","1","1","7","4","3","3","2","1","-2"
"110574","California State University-East Bay","2017","Tenured, professors","120","59","61","0","0","0","25","11","14","7","4","3","12","4","8","1","0","1","69","36","33","2","1","1","2","1","1","2","2","0","-2"
"110574","California State University-East Bay","2017","Tenured, associate professors","68","33","35","0","0","0","15","8","7","3","0","3","8","5","3","0","0","0","36","17","19","0","0","0","5","3","2","1","0","1","-2"
"110574","California State University-East Bay","2017","Tenured, assistant professors","2","1","1","0","0","0","0","0","0","0","0","0","1","0","1","0","0","0","1","1","0","0","0","0","0","0","0","0","0","0","-2"
"110574","California State University-East Bay","2017","On-Tenure track total","128","66","62","0","0","0","25","14","11","9","2","7","8","7","1","0","0","0","54","24","30","2","2","0","12","5","7","18","12","6","-2"
"110574","California State University-East Bay","2017","On-tenure track, associate professors","8","5","3","0","0","0","3","3","0","0","0","0","1","0","1","0","0","0","3","1","2","0","0","0","1","1","0","0","0","0","-2"
"110574","California State University-East Bay","2017","On-tenure track, assistant professors","120","61","59","0","0","0","22","11","11","9","2","7","7","7","0","0","0","0","51","23","28","2","2","0","11","4","7","18","12","6","-2"
"110574","California State University-East Bay","2017","Not on tenure track/No tenure system system total","59","26","33","1","1","0","3","1","2","5","1","4","4","2","2","2","0","2","40","20","20","0","0","0","4","1","3","0","0","0","-2"
"110574","California State University-East Bay","2017","Not on tenure/no tenure system, lecturers","59","26","33","1","1","0","3","1","2","5","1","4","4","2","2","2","0","2","40","20","20","0","0","0","4","1","3","0","0","0","-2"
"110583","California State University-Long Beach","2017","Tenured total","561","306","255","4","2","2","126","60","66","18","13","5","52","31","21","0","0","0","340","185","155","3","1","2","17","14","3","1","0","1","-2"
"110583","California State University-Long Beach","2017","Tenured, professors","382","217","165","2","2","0","81","43","38","11","9","2","32","19","13","0","0","0","247","137","110","1","1","0","8","6","2","0","0","0","-2"
"110583","California State University-Long Beach","2017","Tenured, associate professors","175","87","88","2","0","2","44","16","28","7","4","3","20","12","8","0","0","0","90","47","43","2","0","2","9","8","1","1","0","1","-2"
"110583","California State University-Long Beach","2017","Tenured, assistant professors","3","1","2","0","0","0","1","1","0","0","0","0","0","0","0","0","0","0","2","0","2","0","0","0","0","0","0","0","0","0","-2"
"110583","California State University-Long Beach","2017","Tenured, no academic rank","1","1","0","0","0","0","0","0","0","0","0","0","0","0","0","0","0","0","1","1","0","0","0","0","0","0","0","0","0","0","-2"
"110583","California State University-Long Beach","2017","On-Tenure track total","242","101","141","2","1","1","49","13","36","12","4","8","24","7","17","0","0","0","112","56","56","4","1","3","9","3","6","30","16","14","-2"
"110583","California State University-Long Beach","2017","On-tenure track, professors","3","3","0","0","0","0","0","0","0","0","0","0","1","1","0","0","0","0","2","2","0","0","0","0","0","0","0","0","0","0","-2"
"110583","California State University-Long Beach","2017","On-tenure track, associate professors","10","2","8","0","0","0","4","0","4","1","0","1","2","0","2","0","0","0","2","1","1","0","0","0","0","0","0","1","1","0","-2"
"110583","California State University-Long Beach","2017","On-tenure track, assistant professors","229","96","133","2","1","1","45","13","32","11","4","7","21","6","15","0","0","0","108","53","55","4","1","3","9","3","6","29","15","14","-2"
"110583","California State University-Long Beach","2017","Not on tenure track/No tenure system system total","272","119","153","1","0","1","30","15","15","12","3","9","31","12","19","0","0","0","177","80","97","8","3","5","11","5","6","2","1","1","-2"
"110583","California State University-Long Beach","2017","Not on tenure/no tenure system, lecturers","272","119","153","1","0","1","30","15","15","12","3","9","31","12","19","0","0","0","177","80","97","8","3","5","11","5","6","2","1","1","-2"
"110592","California State University-Los Angeles","2017","Tenured total","363","199","164","1","0","1","99","54","45","16","8","8","51","35","16","1","1","0","180","92","88","1","0","1","13","8","5","1","1","0","-2"
"110592","California State University-Los Angeles","2017","Tenured, professors","278","158","120","1","0","1","74","40","34","12","6","6","40","28","12","1","1","0","141","77","64","1","0","1","8","6","2","0","0","0","-2"
"110592","California State University-Los Angeles","2017","Tenured, associate professors","85","41","44","0","0","0","25","14","11","4","2","2","11","7","4","0","0","0","39","15","24","0","0","0","5","2","3","1","1","0","-2"
"110592","California State University-Los Angeles","2017","On-Tenure track total","156","62","94","2","0","2","29","7","22","14","6","8","22","6","16","0","0","0","45","25","20","4","0","4","5","0","5","35","18","17","-2"
"110592","California State University-Los Angeles","2017","On-tenure track, professors","3","0","3","0","0","0","1","0","1","0","0","0","1","0","1","0","0","0","0","0","0","0","0","0","1","0","1","0","0","0","-2"
"110592","California State University-Los Angeles","2017","On-tenure track, associate professors","2","1","1","0","0","0","1","1","0","0","0","0","0","0","0","0","0","0","1","0","1","0","0","0","0","0","0","0","0","0","-2"
"110592","California State University-Los Angeles","2017","On-tenure track, assistant professors","151","61","90","2","0","2","27","6","21","14","6","8","21","6","15","0","0","0","44","25","19","4","0","4","4","0","4","35","18","17","-2"
"110592","California State University-Los Angeles","2017","Not on tenure track/No tenure system system total","185","96","89","2","1","1","30","16","14","13","7","6","39","19","20","0","0","0","87","47","40","3","2","1","8","3","5","3","1","2","-2"
"110592","California State University-Los Angeles","2017","Not on tenure/no tenure system, lecturers","185","96","89","2","1","1","30","16","14","13","7","6","39","19","20","0","0","0","87","47","40","3","2","1","8","3","5","3","1","2","-2"
"110608","California State University-Northridge","2017","Tenured total","554","295","259","4","2","2","93","53","40","26","10","16","66","31","35","0","0","0","344","186","158","6","3","3","12","8","4","3","2","1","-2"
"110608","California State University-Northridge","2017","Tenured, professors","387","206","181","3","1","2","62","35","27","15","5","10","51","23","28","0","0","0","248","136","112","4","3","1","3","2","1","1","1","0","-2"
"110608","California State University-Northridge","2017","Tenured, associate professors","154","80","74","1","1","0","29","16","13","11","5","6","13","8","5","0","0","0","87","43","44","2","0","2","9","6","3","2","1","1","-2"
"110608","California State University-Northridge","2017","Tenured, assistant professors","1","1","0","0","0","0","0","0","0","0","0","0","0","0","0","0","0","0","1","1","0","0","0","0","0","0","0","0","0","0","-2"
"110608","California State University-Northridge","2017","Tenured, no academic rank","12","8","4","0","0","0","2","2","0","0","0","0","2","0","2","0","0","0","8","6","2","0","0","0","0","0","0","0","0","0","-2"
"110608","California State University-Northridge","2017","On-Tenure track total","223","98","125","1","0","1","42","15","27","13","4","9","16","11","5","0","0","0","108","47","61","2","1","1","17","9","8","24","11","13","-2"
"110608","California State University-Northridge","2017","On-tenure track, professors","2","0","2","0","0","0","0","0","0","1","0","1","0","0","0","0","0","0","1","0","1","0","0","0","0","0","0","0","0","0","-2"
"110608","California State University-Northridge","2017","On-tenure track, associate professors","21","6","15","0","0","0","5","0","5","0","0","0","1","1","0","0","0","0","13","3","10","0","0","0","0","0","0","2","2","0","-2"
"110608","California State University-Northridge","2017","On-tenure track, assistant professors","200","92","108","1","0","1","37","15","22","12","4","8","15","10","5","0","0","0","94","44","50","2","1","1","17","9","8","22","9","13","-2"
"110608","California State University-Northridge","2017","Not on tenure track/No tenure system system total","168","78","90","2","1","1","15","7","8","7","3","4","25","15","10","0","0","0","109","49","60","1","0","1","8","2","6","1","1","0","-2"
"110608","California State University-Northridge","2017","Not on tenure/no tenure system, lecturers","168","78","90","2","1","1","15","7","8","7","3","4","25","15","10","0","0","0","109","49","60","1","0","1","8","2","6","1","1","0","-2"
"110617","California State University-Sacramento","2017","Tenured total","435","245","190","5","3","2","74","45","29","22","9","13","38","22","16","0","0","0","271","150","121","2","1","1","9","7","2","14","8","6","-2"
"110617","California State University-Sacramento","2017","Tenured, professors","328","186","142","4","2","2","50","30","20","17","6","11","31","19","12","0","0","0","215","123","92","2","1","1","4","3","1","5","2","3","-2"
"110617","California State University-Sacramento","2017","Tenured, associate professors","103","56","47","1","1","0","23","14","9","5","3","2","7","3","4","0","0","0","53","25","28","0","0","0","5","4","1","9","6","3","-2"
"110617","California State University-Sacramento","2017","Tenured, assistant professors","2","1","1","0","0","0","1","1","0","0","0","0","0","0","0","0","0","0","1","0","1","0","0","0","0","0","0","0","0","0","-2"
"110617","California State University-Sacramento","2017","Tenured, no academic rank","2","2","0","0","0","0","0","0","0","0","0","0","0","0","0","0","0","0","2","2","0","0","0","0","0","0","0","0","0","0","-2"
"110617","California State University-Sacramento","2017","On-Tenure track total","211","93","118","1","1","0","18","9","9","11","4","7","10","4","6","0","0","0","109","49","60","4","2","2","58","24","34","0","0","0","-2"
"110617","California State University-Sacramento","2017","On-tenure track, professors","5","2","3","0","0","0","1","0","1","0","0","0","1","0","1","0","0","0","3","2","1","0","0","0","0","0","0","0","0","0","-2"
"110617","California State University-Sacramento","2017","On-tenure track, associate professors","5","2","3","0","0","0","1","0","1","0","0","0","0","0","0","0","0","0","2","0","2","1","1","0","1","1","0","0","0","0","-2"
"110617","California State University-Sacramento","2017","On-tenure track, assistant professors","199","89","110","1","1","0","16","9","7","11","4","7","9","4","5","0","0","0","102","47","55","3","1","2","57","23","34","0","0","0","-2"
"110617","California State University-Sacramento","2017","On-tenure track, no academic rank","2","0","2","0","0","0","0","0","0","0","0","0","0","0","0","0","0","0","2","0","2","0","0","0","0","0","0","0","0","0","-2"
"110617","California State University-Sacramento","2017","Not on tenure track/No tenure system system total","123","49","74","0","0","0","6","4","2","1","0","1","5","3","2","0","0","0","104","40","64","1","1","0","5","0","5","1","1","0","-2"
"110617","California State University-Sacramento","2017","Not on tenure/no tenure system, lecturers","123","49","74","0","0","0","6","4","2","1","0","1","5","3","2","0","0","0","104","40","64","1","1","0","5","0","5","1","1","0","-2"
"110671","University of California-Riverside","2017","Tenured total","554","386","168","5","3","2","124","87","37","13","9","4","34","23","11","0","0","0","364","257","107","2","1","1","9","4","5","3","2","1","-2"
"110671","University of California-Riverside","2017","Tenured, professors","353","268","85","2","2","0","68","55","13","10","6","4","16","11","5","0","0","0","249","191","58","2","1","1","5","1","4","1","1","0","-2"
"110671","University of California-Riverside","2017","Tenured, associate professors","196","115","81","3","1","2","54","31","23","3","3","0","17","11","6","0","0","0","113","65","48","0","0","0","4","3","1","2","1","1","-2"
"110671","University of California-Riverside","2017","Tenured, lecturers","5","3","2","0","0","0","2","1","1","0","0","0","1","1","0","0","0","0","2","1","1","0","0","0","0","0","0","0","0","0","-2"
"110671","University of California-Riverside","2017","On-Tenure track total","254","154","100","2","1","1","54","34","20","11","3","8","24","12","12","1","1","0","107","66","41","3","0","3","16","11","5","36","26","10","-2"
"110671","University of California-Riverside","2017","On-tenure track, assistant professors","241","147","94","2","1","1","53","34","19","10","2","8","24","12","12","1","1","0","97","60","37","3","0","3","15","11","4","36","26","10","-2"
"110671","University of California-Riverside","2017","On-tenure track, lecturers","13","7","6","0","0","0","1","0","1","1","1","0","0","0","0","0","0","0","10","6","4","0","0","0","1","0","1","0","0","0","-2"
"110671","University of California-Riverside","2017","Not on tenure track/No tenure system system total","206","111","95","2","1","1","31","19","12","7","3","4","15","6","9","0","0","0","126","67","59","2","2","0","10","6","4","13","7","6","-2"
"110671","University of California-Riverside","2017","Not on tenure/no tenure system, professors","11","8","3","0","0","0","3","3","0","1","0","1","0","0","0","0","0","0","7","5","2","0","0","0","0","0","0","0","0","0","-2"
"110671","University of California-Riverside","2017","Not on tenure/no tenure system, associate professors","14","10","4","0","0","0","4","2","2","1","1","0","0","0","0","0","0","0","8","7","1","0","0","0","1","0","1","0","0","0","-2"
"110671","University of California-Riverside","2017","Not on tenure/no tenure system, assistant professors","57","33","24","0","0","0","11","7","4","3","2","1","3","2","1","0","0","0","26","13","13","2","2","0","0","0","0","12","7","5","-2"
"110671","University of California-Riverside","2017","Not on tenure/no tenure system, instructors","1","1","0","0","0","0","0","0","0","0","0","0","0","0","0","0","0","0","1","1","0","0","0","0","0","0","0","0","0","0","-2"
"110671","University of California-Riverside","2017","Not on tenure/no tenure system, lecturers","121","58","63","2","1","1","12","6","6","2","0","2","11","4","7","0","0","0","84","41","43","0","0","0","9","6","3","1","0","1","-2"
"110671","University of California-Riverside","2017","Not on tenure/no tenure system, no academic rank","2","1","1","0","0","0","1","1","0","0","0","0","1","0","1","0","0","0","0","0","0","0","0","0","0","0","0","0","0","0","-2"
"110705","University of California-Santa Barbara","2017","Tenured total","693","454","239","5","0","5","70","44","26","16","10","6","48","29","19","0","0","0","515","347","168","2","0","2","14","9","5","23","15","8","-2"
"110705","University of California-Santa Barbara","2017","Tenured, professors","520","363","157","2","0","2","56","35","21","7","4","3","32","22","10","0","0","0","394","282","112","2","0","2","10","7","3","17","13","4","-2"
"110705","University of California-Santa Barbara","2017","Tenured, associate professors","144","77","67","3","0","3","14","9","5","8","5","3","13","6","7","0","0","0","97","53","44","0","0","0","4","2","2","5","2","3","-2"
"110705","University of California-Santa Barbara","2017","Tenured, lecturers","29","14","15","0","0","0","0","0","0","1","1","0","3","1","2","0","0","0","24","12","12","0","0","0","0","0","0","1","0","1","-2"
"110705","University of California-Santa Barbara","2017","On-Tenure track total","157","88","69","2","1","1","17","8","9","4","1","3","11","5","6","0","0","0","59","30","29","3","1","2","30","21","9","31","21","10","-2"
"110705","University of California-Santa Barbara","2017","On-tenure track, professors","1","1","0","0","0","0","0","0","0","0","0","0","0","0","0","0","0","0","0","0","0","0","0","0","0","0","0","1","1","0","-2"
"110705","University of California-Santa Barbara","2017","On-tenure track, assistant professors","146","81","65","2","1","1","16","8","8","4","1","3","11","5","6","0","0","0","55","28","27","3","1","2","27","19","8","28","18","10","-2"
"110705","University of California-Santa Barbara","2017","On-tenure track, lecturers","10","6","4","0","0","0","1","0","1","0","0","0","0","0","0","0","0","0","4","2","2","0","0","0","3","2","1","2","2","0","-2"
"110705","University of California-Santa Barbara","2017","Not on tenure track/No tenure system system total","160","69","91","2","1","1","13","3","10","0","0","0","8","4","4","0","0","0","102","41","61","0","0","0","14","8","6","21","12","9","-2"
"110705","University of California-Santa Barbara","2017","Not on tenure/no tenure system, associate professors","2","2","0","0","0","0","0","0","0","0","0","0","0","0","0","0","0","0","1","1","0","0","0","0","1","1","0","0","0","0","-2"
"110705","University of California-Santa Barbara","2017","Not on tenure/no tenure system, assistant professors","18","10","8","0","0","0","2","1","1","0","0","0","0","0","0","0","0","0","2","0","2","0","0","0","3","1","2","11","8","3","-2"
"110705","University of California-Santa Barbara","2017","Not on tenure/no tenure system, lecturers","140","57","83","2","1","1","11","2","9","0","0","0","8","4","4","0","0","0","99","40","59","0","0","0","10","6","4","10","4","6","-2"
"110714","University of California-Santa Cruz","2017","Tenured total","432","269","163","8","1","7","68","41","27","9","8","1","39","18","21","0","0","0","300","196","104","1","1","0","7","4","3","0","0","0","-2"
"110714","University of California-Santa Cruz","2017","Tenured, professors","292","195","97","3","1","2","43","28","15","5","5","0","19","10","9","0","0","0","216","148","68","0","0","0","6","3","3","0","0","0","-2"
"110714","University of California-Santa Cruz","2017","Tenured, associate professors","130","70","60","5","0","5","24","12","12","4","3","1","18","8","10","0","0","0","78","46","32","1","1","0","0","0","0","0","0","0","-2"
"110714","University of California-Santa Cruz","2017","Tenured, lecturers","10","4","6","0","0","0","1","1","0","0","0","0","2","0","2","0","0","0","6","2","4","0","0","0","1","1","0","0","0","0","-2"
"110714","University of California-Santa Cruz","2017","On-Tenure track total","125","73","52","1","1","0","20","11","9","6","3","3","11","8","3","0","0","0","56","33","23","1","0","1","8","3","5","22","14","8","-2"
"110714","University of California-Santa Cruz","2017","On-tenure track, professors","1","1","0","0","0","0","0","0","0","0","0","0","0","0","0","0","0","0","0","0","0","0","0","0","0","0","0","1","1","0","-2"
"110714","University of California-Santa Cruz","2017","On-tenure track, associate professors","1","0","1","0","0","0","1","0","1","0","0","0","0","0","0","0","0","0","0","0","0","0","0","0","0","0","0","0","0","0","-2"
"110714","University of California-Santa Cruz","2017","On-tenure track, assistant professors","119","70","49","1","1","0","19","11","8","5","2","3","11","8","3","0","0","0","54","32","22","1","0","1","7","3","4","21","13","8","-2"
"110714","University of California-Santa Cruz","2017","On-tenure track, lecturers","4","2","2","0","0","0","0","0","0","1","1","0","0","0","0","0","0","0","2","1","1","0","0","0","1","0","1","0","0","0","-2"
"110714","University of California-Santa Cruz","2017","Not on tenure track/No tenure system system total","96","47","49","1","0","1","5","1","4","2","1","1","8","3","5","0","0","0","69","39","30","1","0","1","5","2","3","5","1","4","-2"
"110714","University of California-Santa Cruz","2017","Not on tenure/no tenure system, professors","2","2","0","0","0","0","0","0","0","0","0","0","0","0","0","0","0","0","2","2","0","0","0","0","0","0","0","0","0","0","-2"
"110714","University of California-Santa Cruz","2017","Not on tenure/no tenure system, assistant professors","7","5","2","0","0","0","1","1","0","0","0","0","0","0","0","0","0","0","5","4","1","0","0","0","0","0","0","1","0","1","-2"
"110714","University of California-Santa Cruz","2017","Not on tenure/no tenure system, lecturers","84","38","46","1","0","1","4","0","4","2","1","1","8","3","5","0","0","0","59","31","28","1","0","1","5","2","3","4","1","3","-2"
"110714","University of California-Santa Cruz","2017","Not on tenure/no tenure system, no academic rank","3","2","1","0","0","0","0","0","0","0","0","0","0","0","0","0","0","0","3","2","1","0","0","0","0","0","0","0","0","0","-2"
"111966","Charles R Drew University of Medicine and Science","2017","Not on tenure track/No tenure system system total","46","17","29","0","0","0","10","5","5","11","4","7","6","2","4","7","6","1","12","0","12","0","0","0","0","0","0","0","0","0","-2"
"111966","Charles R Drew University of Medicine and Science","2017","Not on tenure/no tenure system, professors","4","3","1","0","0","0","0","0","0","0","0","0","0","0","0","3","3","0","1","0","1","0","0","0","0","0","0","0","0","0","-2"
"111966","Charles R Drew University of Medicine and Science","2017","Not on tenure/no tenure system, associate professors","9","4","5","0","0","0","0","0","0","2","1","1","3","2","1","1","1","0","3","0","3","0","0","0","0","0","0","0","0","0","-2"
"111966","Charles R Drew University of Medicine and Science","2017","Not on tenure/no tenure system, assistant professors","23","7","16","0","0","0","9","4","5","4","1","3","1","0","1","2","2","0","7","0","7","0","0","0","0","0","0","0","0","0","-2"
"111966","Charles R Drew University of Medicine and Science","2017","Not on tenure/no tenure system, instructors","10","3","7","0","0","0","1","1","0","5","2","3","2","0","2","1","0","1","1","0","1","0","0","0","0","0","0","0","0","0","-2"
"112075","Concordia University-Irvine","2017","Not on tenure track/No tenure system system total","109","56","53","1","1","0","5","3","2","3","0","3","8","4","4","0","0","0","92","48","44","0","0","0","0","0","0","0","0","0","-2"
"112075","Concordia University-Irvine","2017","Not on tenure/no tenure system, professors","33","24","9","0","0","0","1","1","0","1","0","1","3","3","0","0","0","0","28","20","8","0","0","0","0","0","0","0","0","0","-2"
"112075","Concordia University-Irvine","2017","Not on tenure/no tenure system, associate professors","22","11","11","0","0","0","1","1","0","0","0","0","2","0","2","0","0","0","19","10","9","0","0","0","0","0","0","0","0","0","-2"
"112075","Concordia University-Irvine","2017","Not on tenure/no tenure system, assistant professors","35","13","22","1","1","0","1","1","0","1","0","1","2","0","2","0","0","0","30","11","19","0","0","0","0","0","0","0","0","0","-2"
"112075","Concordia University-Irvine","2017","Not on tenure/no tenure system, no academic rank","19","8","11","0","0","0","2","0","2","1","0","1","1","1","0","0","0","0","15","7","8","0","0","0","0","0","0","0","0","0","-2"
"112084","San Diego Christian College","2017","Not on tenure track/No tenure system system total","13","7","6","0","0","0","0","0","0","1","0","1","0","0","0","0","0","0","12","7","5","0","0","0","0","0","0","0","0","0","-2"
"112084","San Diego Christian College","2017","Not on tenure/no tenure system, professors","2","2","0","0","0","0","0","0","0","0","0","0","0","0","0","0","0","0","2","2","0","0","0","0","0","0","0","0","0","0","-2"
"112084","San Diego Christian College","2017","Not on tenure/no tenure system, associate professors","2","1","1","0","0","0","0","0","0","0","0","0","0","0","0","0","0","0","2","1","1","0","0","0","0","0","0","0","0","0","-2"
"112084","San Diego Christian College","2017","Not on tenure/no tenure system, assistant professors","8","3","5","0","0","0","0","0","0","1","0","1","0","0","0","0","0","0","7","3","4","0","0","0","0","0","0","0","0","0","-2"
"112084","San Diego Christian College","2017","Not on tenure/no tenure system, instructors","1","1","0","0","0","0","0","0","0","0","0","0","0","0","0","0","0","0","1","1","0","0","0","0","0","0","0","0","0","0","-2"
"113236","Cypress College","2017","Tenured total","157","69","88","1","1","0","23","4","19","8","2","6","25","14","11","4","2","2","92","45","47","2","0","2","2","1","1","0","0","0","-2"
"113236","Cypress College","2017","Tenured, instructors","157","69","88","1","1","0","23","4","19","8","2","6","25","14","11","4","2","2","92","45","47","2","0","2","2","1","1","0","0","0","-2"
"113236","Cypress College","2017","On-Tenure track total","65","28","37","0","0","0","13","2","11","2","1","1","15","8","7","0","0","0","34","17","17","0","0","0","1","0","1","0","0","0","-2"
"113236","Cypress College","2017","On-tenure track, instructors","65","28","37","0","0","0","13","2","11","2","1","1","15","8","7","0","0","0","34","17","17","0","0","0","1","0","1","0","0","0","-2"
"113698","Dominican University of California","2017","Tenured total","47","21","26","0","0","0","5","2","3","4","3","1","1","0","1","0","0","0","37","16","21","0","0","0","0","0","0","0","0","0","-2"
"113698","Dominican University of California","2017","Tenured, professors","31","13","18","0","0","0","2","0","2","3","2","1","1","0","1","0","0","0","25","11","14","0","0","0","0","0","0","0","0","0","-2"
"113698","Dominican University of California","2017","Tenured, associate professors","16","8","8","0","0","0","3","2","1","1","1","0","0","0","0","0","0","0","12","5","7","0","0","0","0","0","0","0","0","0","-2"
"113698","Dominican University of California","2017","On-Tenure track total","33","14","19","0","0","0","3","1","2","2","1","1","2","2","0","0","0","0","22","7","15","1","1","0","3","2","1","0","0","0","-2"
"113698","Dominican University of California","2017","On-tenure track, associate professors","1","0","1","0","0","0","0","0","0","0","0","0","0","0","0","0","0","0","1","0","1","0","0","0","0","0","0","0","0","0","-2"
"113698","Dominican University of California","2017","On-tenure track, assistant professors","32","14","18","0","0","0","3","1","2","2","1","1","2","2","0","0","0","0","21","7","14","1","1","0","3","2","1","0","0","0","-2"
"113698","Dominican University of California","2017","Not on tenure track/No tenure system system total","25","11","14","0","0","0","2","0","2","1","1","0","2","2","0","0","0","0","18","7","11","0","0","0","2","1","1","0","0","0","-2"
"113698","Dominican University of California","2017","Not on tenure/no tenure system, assistant professors","25","11","14","0","0","0","2","0","2","1","1","0","2","2","0","0","0","0","18","7","11","0","0","0","2","1","1","0","0","0","-2"
"114433","Feather River Community College District","2017","Tenured total","17","10","7","0","0","0","0","0","0","0","0","0","0","0","0","0","0","0","16","10","6","0","0","0","0","0","0","1","0","1","-2"
"114433","Feather River Community College District","2017","Tenured, instructors","17","10","7","0","0","0","0","0","0","0","0","0","0","0","0","0","0","0","16","10","6","0","0","0","0","0","0","1","0","1","-2"
"114433","Feather River Community College District","2017","On-Tenure track total","10","7","3","0","0","0","0","0","0","0","0","0","0","0","0","0","0","0","7","5","2","0","0","0","2","1","1","1","1","0","-2"
"114433","Feather River Community College District","2017","On-tenure track, instructors","10","7","3","0","0","0","0","0","0","0","0","0","0","0","0","0","0","0","7","5","2","0","0","0","2","1","1","1","1","0","-2"
"114716","Foothill College","2017","Tenured total","139","56","83","0","0","0","23","6","17","5","3","2","22","9","13","0","0","0","88","37","51","1","1","0","0","0","0","0","0","0","-2"
"114716","Foothill College","2017","Tenured, instructors","139","56","83","0","0","0","23","6","17","5","3","2","22","9","13","0","0","0","88","37","51","1","1","0","0","0","0","0","0","0","-2"
"114716","Foothill College","2017","On-Tenure track total","52","23","29","0","0","0","7","4","3","5","1","4","7","4","3","0","0","0","27","11","16","5","3","2","1","0","1","0","0","0","-2"
"114716","Foothill College","2017","On-tenure track, instructors","52","23","29","0","0","0","7","4","3","5","1","4","7","4","3","0","0","0","27","11","16","5","3","2","1","0","1","0","0","0","-2"
"114716","Foothill College","2017","Not on tenure track/No tenure system system total","5","0","5","0","0","0","0","0","0","0","0","0","2","0","2","0","0","0","2","0","2","1","0","1","0","0","0","0","0","0","-2"
"114716","Foothill College","2017","Not on tenure/no tenure system, instructors","5","0","5","0","0","0","0","0","0","0","0","0","2","0","2","0","0","0","2","0","2","1","0","1","0","0","0","0","0","0","-2"
"114813","Fresno Pacific University","2017","Tenured total","49","32","17","0","0","0","3","2","1","0","0","0","1","0","1","0","0","0","41","28","13","2","1","1","2","1","1","0","0","0","-2"
"114813","Fresno Pacific University","2017","Tenured, professors","16","13","3","0","0","0","1","1","0","0","0","0","1","0","1","0","0","0","14","12","2","0","0","0","0","0","0","0","0","0","-2"
"114813","Fresno Pacific University","2017","Tenured, associate professors","32","19","13","0","0","0","2","1","1","0","0","0","0","0","0","0","0","0","26","16","10","2","1","1","2","1","1","0","0","0","-2"
"114813","Fresno Pacific University","2017","Tenured, assistant professors","1","0","1","0","0","0","0","0","0","0","0","0","0","0","0","0","0","0","1","0","1","0","0","0","0","0","0","0","0","0","-2"
"114813","Fresno Pacific University","2017","On-Tenure track total","37","16","21","0","0","0","4","2","2","2","2","0","2","0","2","0","0","0","24","9","15","0","0","0","5","3","2","0","0","0","-2"
"114813","Fresno Pacific University","2017","On-tenure track, associate professors","5","3","2","0","0","0","1","1","0","1","1","0","1","0","1","0","0","0","0","0","0","0","0","0","2","1","1","0","0","0","-2"
"114813","Fresno Pacific University","2017","On-tenure track, assistant professors","30","12","18","0","0","0","3","1","2","1","1","0","1","0","1","0","0","0","22","8","14","0","0","0","3","2","1","0","0","0","-2"
"114813","Fresno Pacific University","2017","On-tenure track, instructors","2","1","1","0","0","0","0","0","0","0","0","0","0","0","0","0","0","0","2","1","1","0","0","0","0","0","0","0","0","0","-2"
"114813","Fresno Pacific University","2017","Not on tenure track/No tenure system system total","26","9","17","0","0","0","0","0","0","0","0","0","3","0","3","0","0","0","20","8","12","0","0","0","3","1","2","0","0","0","-2"
"114813","Fresno Pacific University","2017","Not on tenure/no tenure system, professors","2","2","0","0","0","0","0","0","0","0","0","0","0","0","0","0","0","0","2","2","0","0","0","0","0","0","0","0","0","0","-2"
"114813","Fresno Pacific University","2017","Not on tenure/no tenure system, associate professors","3","2","1","0","0","0","0","0","0","0","0","0","0","0","0","0","0","0","3","2","1","0","0","0","0","0","0","0","0","0","-2"
"114813","Fresno Pacific University","2017","Not on tenure/no tenure system, assistant professors","15","5","10","0","0","0","0","0","0","0","0","0","1","0","1","0","0","0","12","4","8","0","0","0","2","1","1","0","0","0","-2"
"114813","Fresno Pacific University","2017","Not on tenure/no tenure system, instructors","6","0","6","0","0","0","0","0","0","0","0","0","2","0","2","0","0","0","3","0","3","0","0","0","1","0","1","0","0","0","-2"
"115728","Holy Names University","2017","Tenured total","12","7","5","0","0","0","3","2","1","0","0","0","1","0","1","0","0","0","7","5","2","0","0","0","0","0","0","1","0","1","-2"
"115728","Holy Names University","2017","Tenured, professors","5","3","2","0","0","0","0","0","0","0","0","0","1","0","1","0","0","0","4","3","1","0","0","0","0","0","0","0","0","0","-2"
"115728","Holy Names University","2017","Tenured, associate professors","7","4","3","0","0","0","3","2","1","0","0","0","0","0","0","0","0","0","3","2","1","0","0","0","0","0","0","1","0","1","-2"
"115728","Holy Names University","2017","On-Tenure track total","14","4","10","0","0","0","3","1","2","2","2","0","0","0","0","0","0","0","8","1","7","1","0","1","0","0","0","0","0","0","-2"
"115728","Holy Names University","2017","On-tenure track, associate professors","3","1","2","0","0","0","0","0","0","0","0","0","0","0","0","0","0","0","3","1","2","0","0","0","0","0","0","0","0","0","-2"
"115728","Holy Names University","2017","On-tenure track, assistant professors","11","3","8","0","0","0","3","1","2","2","2","0","0","0","0","0","0","0","5","0","5","1","0","1","0","0","0","0","0","0","-2"
"115728","Holy Names University","2017","Not on tenure track/No tenure system system total","15","3","12","0","0","0","1","1","0","3","0","3","0","0","0","0","0","0","10","2","8","0","0","0","0","0","0","1","0","1","-2"
"115728","Holy Names University","2017","Not on tenure/no tenure system, professors","1","1","0","0","0","0","0","0","0","0","0","0","0","0","0","0","0","0","1","1","0","0","0","0","0","0","0","0","0","0","-2"
"115728","Holy Names University","2017","Not on tenure/no tenure system, associate professors","2","0","2","0","0","0","0","0","0","0","0","0","0","0","0","0","0","0","2","0","2","0","0","0","0","0","0","0","0","0","-2"
"115728","Holy Names University","2017","Not on tenure/no tenure system, assistant professors","7","0","7","0","0","0","0","0","0","3","0","3","0","0","0","0","0","0","3","0","3","0","0","0","0","0","0","1","0","1","-2"
"115728","Holy Names University","2017","Not on tenure/no tenure system, instructors","5","2","3","0","0","0","1","1","0","0","0","0","0","0","0","0","0","0","4","1","3","0","0","0","0","0","0","0","0","0","-2"
"115773","Humphreys University-Stockton and Modesto Campuses","2017","Not on tenure track/No tenure system system total","21","5","16","0","0","0","0","0","0","0","0","0","4","1","3","0","0","0","17","4","13","0","0","0","0","0","0","0","0","0","-2"
"115773","Humphreys University-Stockton and Modesto Campuses","2017","Not on tenure/no tenure system, professors","2","2","0","0","0","0","0","0","0","0","0","0","0","0","0","0","0","0","2","2","0","0","0","0","0","0","0","0","0","0","-2"
"115773","Humphreys University-Stockton and Modesto Campuses","2017","Not on tenure/no tenure system, associate professors","3","2","1","0","0","0","0","0","0","0","0","0","1","1","0","0","0","0","2","1","1","0","0","0","0","0","0","0","0","0","-2"
"115773","Humphreys University-Stockton and Modesto Campuses","2017","Not on tenure/no tenure system, assistant professors","9","1","8","0","0","0","0","0","0","0","0","0","3","0","3","0","0","0","6","1","5","0","0","0","0","0","0","0","0","0","-2"
"115773","Humphreys University-Stockton and Modesto Campuses","2017","Not on tenure/no tenure system, instructors","5","0","5","0","0","0","0","0","0","0","0","0","0","0","0","0","0","0","5","0","5","0","0","0","0","0","0","0","0","0","-2"
"115773","Humphreys University-Stockton and Modesto Campuses","2017","Not on tenure/no tenure system, no academic rank","2","0","2","0","0","0","0","0","0","0","0","0","0","0","0","0","0","0","2","0","2","0","0","0","0","0","0","0","0","0","-2"
"117104","Life Pacific University","2017","Not on tenure track/No tenure system system total","15","10","5","0","0","0","0","0","0","2","2","0","2","1","1","0","0","0","11","7","4","0","0","0","0","0","0","0","0","0","-2"
"117104","Life Pacific University","2017","Not on tenure/no tenure system, professors","4","3","1","0","0","0","0","0","0","0","0","0","0","0","0","0","0","0","4","3","1","0","0","0","0","0","0","0","0","0","-2"
"117104","Life Pacific University","2017","Not on tenure/no tenure system, associate professors","6","5","1","0","0","0","0","0","0","2","2","0","0","0","0","0","0","0","4","3","1","0","0","0","0","0","0","0","0","0","-2"
"117104","Life Pacific University","2017","Not on tenure/no tenure system, assistant professors","4","1","3","0","0","0","0","0","0","0","0","0","2","1","1","0","0","0","2","0","2","0","0","0","0","0","0","0","0","0","-2"
"117104","Life Pacific University","2017","Not on tenure/no tenure system, instructors","1","1","0","0","0","0","0","0","0","0","0","0","0","0","0","0","0","0","1","1","0","0","0","0","0","0","0","0","0","0","-2"
"117140","University of La Verne","2017","Tenured total","118","67","51","0","0","0","9","3","6","2","1","1","11","8","3","0","0","0","91","53","38","0","0","0","5","2","3","0","0","0","-2"
"117140","University of La Verne","2017","Tenured, professors","87","52","35","0","0","0","8","3","5","1","1","0","5","4","1","0","0","0","70","43","27","0","0","0","3","1","2","0","0","0","-2"
"117140","University of La Verne","2017","Tenured, associate professors","30","14","16","0","0","0","1","0","1","1","0","1","6","4","2","0","0","0","20","9","11","0","0","0","2","1","1","0","0","0","-2"
"117140","University of La Verne","2017","Tenured, assistant professors","1","1","0","0","0","0","0","0","0","0","0","0","0","0","0","0","0","0","1","1","0","0","0","0","0","0","0","0","0","0","-2"
"117140","University of La Verne","2017","On-Tenure track total","83","32","51","0","0","0","15","4","11","4","1","3","6","4","2","0","0","0","19","7","12","0","0","0","39","16","23","0","0","0","-2"
"117140","University of La Verne","2017","On-tenure track, professors","3","1","2","0","0","0","0","0","0","0","0","0","0","0","0","0","0","0","1","1","0","0","0","0","2","0","2","0","0","0","-2"
"117140","University of La Verne","2017","On-tenure track, associate professors","22","5","17","0","0","0","5","0","5","1","0","1","3","2","1","0","0","0","6","1","5","0","0","0","7","2","5","0","0","0","-2"
"117140","University of La Verne","2017","On-tenure track, assistant professors","58","26","32","0","0","0","10","4","6","3","1","2","3","2","1","0","0","0","12","5","7","0","0","0","30","14","16","0","0","0","-2"
"117140","University of La Verne","2017","Not on tenure track/No tenure system system total","63","20","43","0","0","0","2","0","2","5","2","3","8","3","5","0","0","0","33","10","23","0","0","0","15","5","10","0","0","0","-2"
"117140","University of La Verne","2017","Not on tenure/no tenure system, professors","6","1","5","0","0","0","0","0","0","0","0","0","0","0","0","0","0","0","5","1","4","0","0","0","1","0","1","0","0","0","-2"
"117140","University of La Verne","2017","Not on tenure/no tenure system, associate professors","7","1","6","0","0","0","1","0","1","1","0","1","0","0","0","0","0","0","4","1","3","0","0","0","1","0","1","0","0","0","-2"
"117140","University of La Verne","2017","Not on tenure/no tenure system, assistant professors","23","7","16","0","0","0","0","0","0","2","1","1","5","1","4","0","0","0","10","3","7","0","0","0","6","2","4","0","0","0","-2"
"117140","University of La Verne","2017","Not on tenure/no tenure system, instructors","27","11","16","0","0","0","1","0","1","2","1","1","3","2","1","0","0","0","14","5","9","0","0","0","7","3","4","0","0","0","-2"
"117627","La Sierra University","2017","Tenured total","40","30","10","1","1","0","1","0","1","2","2","0","2","2","0","3","3","0","24","16","8","0","0","0","0","0","0","7","6","1","-2"
"117627","La Sierra University","2017","Tenured, professors","19","16","3","1","1","0","0","0","0","0","0","0","1","1","0","1","1","0","11","9","2","0","0","0","0","0","0","5","4","1","-2"
"117627","La Sierra University","2017","Tenured, associate professors","19","13","6","0","0","0","1","0","1","2","2","0","1","1","0","1","1","0","12","7","5","0","0","0","0","0","0","2","2","0","-2"
"117627","La Sierra University","2017","Tenured, assistant professors","2","1","1","0","0","0","0","0","0","0","0","0","0","0","0","1","1","0","1","0","1","0","0","0","0","0","0","0","0","0","-2"
"117627","La Sierra University","2017","On-Tenure track total","23","12","11","0","0","0","1","1","0","0","0","0","6","4","2","3","0","3","10","5","5","0","0","0","0","0","0","3","2","1","-2"
"117627","La Sierra University","2017","On-tenure track, professors","5","4","1","0","0","0","0","0","0","0","0","0","1","1","0","1","0","1","2","2","0","0","0","0","0","0","0","1","1","0","-2"
"117627","La Sierra University","2017","On-tenure track, associate professors","9","4","5","0","0","0","1","1","0","0","0","0","2","1","1","1","0","1","4","1","3","0","0","0","0","0","0","1","1","0","-2"
"117627","La Sierra University","2017","On-tenure track, assistant professors","9","4","5","0","0","0","0","0","0","0","0","0","3","2","1","1","0","1","4","2","2","0","0","0","0","0","0","1","0","1","-2"
"117627","La Sierra University","2017","Not on tenure track/No tenure system system total","38","16","22","0","0","0","3","2","1","1","0","1","6","3","3","1","0","1","18","6","12","0","0","0","0","0","0","9","5","4","-2"
"117627","La Sierra University","2017","Not on tenure/no tenure system, professors","3","1","2","0","0","0","0","0","0","0","0","0","0","0","0","1","0","1","2","1","1","0","0","0","0","0","0","0","0","0","-2"
"117627","La Sierra University","2017","Not on tenure/no tenure system, associate professors","6","2","4","0","0","0","0","0","0","0","0","0","0","0","0","0","0","0","5","2","3","0","0","0","0","0","0","1","0","1","-2"
"117627","La Sierra University","2017","Not on tenure/no tenure system, assistant professors","21","12","9","0","0","0","1","1","0","1","0","1","6","3","3","0","0","0","7","3","4","0","0","0","0","0","0","6","5","1","-2"
"117627","La Sierra University","2017","Not on tenure/no tenure system, instructors","1","0","1","0","0","0","1","0","1","0","0","0","0","0","0","0","0","0","0","0","0","0","0","0","0","0","0","0","0","0","-2"
"117627","La Sierra University","2017","Not on tenure/no tenure system, lecturers","7","1","6","0","0","0","1","1","0","0","0","0","0","0","0","0","0","0","4","0","4","0","0","0","0","0","0","2","0","2","-2"
"117636","Loma Linda University","2017","Tenured total","21","13","8","0","0","0","3","1","2","1","1","0","1","1","0","0","0","0","15","10","5","0","0","0","0","0","0","1","0","1","-2"
"117636","Loma Linda University","2017","Tenured, professors","16","11","5","0","0","0","2","1","1","1","1","0","1","1","0","0","0","0","12","8","4","0","0","0","0","0","0","0","0","0","-2"
"117636","Loma Linda University","2017","Tenured, associate professors","1","1","0","0","0","0","0","0","0","0","0","0","0","0","0","0","0","0","1","1","0","0","0","0","0","0","0","0","0","0","-2"
"117636","Loma Linda University","2017","Tenured, assistant professors","3","1","2","0","0","0","0","0","0","0","0","0","0","0","0","0","0","0","2","1","1","0","0","0","0","0","0","1","0","1","-2"
"117636","Loma Linda University","2017","Tenured, instructors","1","0","1","0","0","0","1","0","1","0","0","0","0","0","0","0","0","0","0","0","0","0","0","0","0","0","0","0","0","0","-2"
"117636","Loma Linda University","2017","On-Tenure track total","50","27","23","0","0","0","5","2","3","5","2","3","6","5","1","1","1","0","33","17","16","0","0","0","0","0","0","0","0","0","-2"
"117636","Loma Linda University","2017","On-tenure track, professors","14","12","2","0","0","0","3","2","1","0","0","0","2","2","0","0","0","0","9","8","1","0","0","0","0","0","0","0","0","0","-2"
"117636","Loma Linda University","2017","On-tenure track, associate professors","14","5","9","0","0","0","1","0","1","1","1","0","0","0","0","0","0","0","12","4","8","0","0","0","0","0","0","0","0","0","-2"
"117636","Loma Linda University","2017","On-tenure track, assistant professors","20","9","11","0","0","0","1","0","1","4","1","3","4","3","1","1","1","0","10","4","6","0","0","0","0","0","0","0","0","0","-2"
"117636","Loma Linda University","2017","On-tenure track, instructors","2","1","1","0","0","0","0","0","0","0","0","0","0","0","0","0","0","0","2","1","1","0","0","0","0","0","0","0","0","0","-2"
"117636","Loma Linda University","2017","Not on tenure track/No tenure system system total","317","133","184","1","0","1","50","20","30","29","11","18","27","13","14","0","0","0","201","82","119","4","2","2","0","0","0","5","5","0","-2"
"117636","Loma Linda University","2017","Not on tenure/no tenure system, professors","37","23","14","0","0","0","5","4","1","4","3","1","2","1","1","0","0","0","26","15","11","0","0","0","0","0","0","0","0","0","-2"
"117636","Loma Linda University","2017","Not on tenure/no tenure system, associate professors","66","30","36","0","0","0","8","3","5","8","4","4","2","1","1","0","0","0","46","20","26","0","0","0","0","0","0","2","2","0","-2"
"117636","Loma Linda University","2017","Not on tenure/no tenure system, assistant professors","186","72","114","1","0","1","33","11","22","14","3","11","20","10","10","0","0","0","112","44","68","3","1","2","0","0","0","3","3","0","-2"
"117636","Loma Linda University","2017","Not on tenure/no tenure system, instructors","28","8","20","0","0","0","4","2","2","3","1","2","3","1","2","0","0","0","17","3","14","1","1","0","0","0","0","0","0","0","-2"
"118541","Marymount California University","2017","Not on tenure track/No tenure system system total","36","18","18","0","0","0","3","2","1","3","2","1","2","1","1","0","0","0","28","13","15","0","0","0","0","0","0","0","0","0","-2"
"118541","Marymount California University","2017","Not on tenure/no tenure system, professors","15","9","6","0","0","0","1","1","0","2","1","1","0","0","0","0","0","0","12","7","5","0","0","0","0","0","0","0","0","0","-2"
"118541","Marymount California University","2017","Not on tenure/no tenure system, associate professors","13","6","7","0","0","0","1","0","1","1","1","0","1","1","0","0","0","0","10","4","6","0","0","0","0","0","0","0","0","0","-2"
"118541","Marymount California University","2017","Not on tenure/no tenure system, assistant professors","7","3","4","0","0","0","1","1","0","0","0","0","1","0","1","0","0","0","5","2","3","0","0","0","0","0","0","0","0","0","-2"
"118541","Marymount California University","2017","Not on tenure/no tenure system, instructors","1","0","1","0","0","0","0","0","0","0","0","0","0","0","0","0","0","0","1","0","1","0","0","0","0","0","0","0","0","0","-2"
"118693","Menlo College","2017","Not on tenure track/No tenure system system total","26","11","15","0","0","0","7","3","4","2","0","2","0","0","0","0","0","0","17","8","9","0","0","0","0","0","0","0","0","0","-2"
"118693","Menlo College","2017","Not on tenure/no tenure system, professors","10","5","5","0","0","0","2","1","1","1","0","1","0","0","0","0","0","0","7","4","3","0","0","0","0","0","0","0","0","0","-2"
"118693","Menlo College","2017","Not on tenure/no tenure system, associate professors","8","3","5","0","0","0","2","1","1","0","0","0","0","0","0","0","0","0","6","2","4","0","0","0","0","0","0","0","0","0","-2"
"118693","Menlo College","2017","Not on tenure/no tenure system, assistant professors","4","1","3","0","0","0","2","1","1","1","0","1","0","0","0","0","0","0","1","0","1","0","0","0","0","0","0","0","0","0","-2"
"118693","Menlo College","2017","Not on tenure/no tenure system, instructors","1","1","0","0","0","0","0","0","0","0","0","0","0","0","0","0","0","0","1","1","0","0","0","0","0","0","0","0","0","0","-2"
"118693","Menlo College","2017","Not on tenure/no tenure system, lecturers","3","1","2","0","0","0","1","0","1","0","0","0","0","0","0","0","0","0","2","1","1","0","0","0","0","0","0","0","0","0","-2"
"118888","Mills College","2017","Tenured total","48","12","36","0","0","0","6","2","4","3","0","3","6","2","4","0","0","0","28","7","21","4","1","3","1","0","1","0","0","0","-2"
"118888","Mills College","2017","Tenured, professors","32","7","25","0","0","0","2","0","2","3","0","3","4","1","3","0","0","0","20","6","14","2","0","2","1","0","1","0","0","0","-2"
"118888","Mills College","2017","Tenured, associate professors","16","5","11","0","0","0","4","2","2","0","0","0","2","1","1","0","0","0","8","1","7","2","1","1","0","0","0","0","0","0","-2"
"118888","Mills College","2017","On-Tenure track total","15","5","10","2","1","1","2","1","1","2","0","2","2","1","1","0","0","0","7","2","5","0","0","0","0","0","0","0","0","0","-2"
"118888","Mills College","2017","On-tenure track, assistant professors","15","5","10","2","1","1","2","1","1","2","0","2","2","1","1","0","0","0","7","2","5","0","0","0","0","0","0","0","0","0","-2"
"118888","Mills College","2017","Not on tenure track/No tenure system system total","18","5","13","0","0","0","3","1","2","2","1","1","2","0","2","0","0","0","11","3","8","0","0","0","0","0","0","0","0","0","-2"
"118888","Mills College","2017","Not on tenure/no tenure system, professors","10","4","6","0","0","0","2","0","2","2","1","1","0","0","0","0","0","0","6","3","3","0","0","0","0","0","0","0","0","0","-2"
"118888","Mills College","2017","Not on tenure/no tenure system, associate professors","3","0","3","0","0","0","0","0","0","0","0","0","1","0","1","0","0","0","2","0","2","0","0","0","0","0","0","0","0","0","-2"
"118888","Mills College","2017","Not on tenure/no tenure system, assistant professors","3","0","3","0","0","0","0","0","0","0","0","0","1","0","1","0","0","0","2","0","2","0","0","0","0","0","0","0","0","0","-2"
"118888","Mills College","2017","Not on tenure/no tenure system, no academic rank","2","1","1","0","0","0","1","1","0","0","0","0","0","0","0","0","0","0","1","0","1","0","0","0","0","0","0","0","0","0","-2"
"118912","MiraCosta College","2017","Tenured total","157","73","84","2","0","2","1","0","1","11","8","3","28","11","17","0","0","0","99","44","55","1","1","0","15","9","6","0","0","0","-2"
"118912","MiraCosta College","2017","Tenured, instructors","157","73","84","2","0","2","1","0","1","11","8","3","28","11","17","0","0","0","99","44","55","1","1","0","15","9","6","0","0","0","-2"
"118912","MiraCosta College","2017","On-Tenure track total","38","13","25","0","0","0","0","0","0","0","0","0","9","1","8","0","0","0","21","8","13","0","0","0","8","4","4","0","0","0","-2"
"118912","MiraCosta College","2017","On-tenure track, instructors","38","13","25","0","0","0","0","0","0","0","0","0","9","1","8","0","0","0","21","8","13","0","0","0","8","4","4","0","0","0","-2"
"118912","MiraCosta College","2017","Not on tenure track/No tenure system system total","4","3","1","0","0","0","0","0","0","2","2","0","1","0","1","0","0","0","1","1","0","0","0","0","0","0","0","0","0","0","-2"
"118912","MiraCosta College","2017","Not on tenure/no tenure system, instructors","4","3","1","0","0","0","0","0","0","2","2","0","1","0","1","0","0","0","1","1","0","0","0","0","0","0","0","0","0","0","-2"
"118976","Modesto Junior College","2017","Tenured total","107","45","62","1","0","1","4","1","3","5","2","3","11","7","4","0","0","0","75","32","43","0","0","0","10","3","7","1","0","1","-2"
"118976","Modesto Junior College","2017","Tenured, instructors","107","45","62","1","0","1","4","1","3","5","2","3","11","7","4","0","0","0","75","32","43","0","0","0","10","3","7","1","0","1","-2"
"118976","Modesto Junior College","2017","On-Tenure track total","52","35","17","0","0","0","2","1","1","3","1","2","4","3","1","0","0","0","40","28","12","0","0","0","3","2","1","0","0","0","-2"
"118976","Modesto Junior College","2017","On-tenure track, instructors","52","35","17","0","0","0","2","1","1","3","1","2","4","3","1","0","0","0","40","28","12","0","0","0","3","2","1","0","0","0","-2"
"118976","Modesto Junior College","2017","Not on tenure track/No tenure system system total","84","32","52","1","1","0","4","0","4","6","3","3","12","4","8","1","0","1","57","24","33","0","0","0","2","0","2","1","0","1","-2"
"118976","Modesto Junior College","2017","Not on tenure/no tenure system, instructors","84","32","52","1","1","0","4","0","4","6","3","3","12","4","8","1","0","1","57","24","33","0","0","0","2","0","2","1","0","1","-2"
"119173","Mount Saint Mary's University","2017","Tenured total","59","17","42","0","0","0","6","3","3","5","0","5","5","2","3","0","0","0","43","12","31","0","0","0","0","0","0","0","0","0","-2"
"119173","Mount Saint Mary's University","2017","Tenured, professors","25","7","18","0","0","0","3","1","2","0","0","0","2","1","1","0","0","0","20","5","15","0","0","0","0","0","0","0","0","0","-2"
"119173","Mount Saint Mary's University","2017","Tenured, associate professors","25","7","18","0","0","0","3","2","1","2","0","2","2","0","2","0","0","0","18","5","13","0","0","0","0","0","0","0","0","0","-2"
"119173","Mount Saint Mary's University","2017","Tenured, assistant professors","9","3","6","0","0","0","0","0","0","3","0","3","1","1","0","0","0","0","5","2","3","0","0","0","0","0","0","0","0","0","-2"
"119173","Mount Saint Mary's University","2017","On-Tenure track total","23","6","17","0","0","0","3","1","2","4","1","3","2","1","1","0","0","0","11","3","8","2","0","2","1","0","1","0","0","0","-2"
"119173","Mount Saint Mary's University","2017","On-tenure track, professors","1","1","0","0","0","0","0","0","0","0","0","0","0","0","0","0","0","0","1","1","0","0","0","0","0","0","0","0","0","0","-2"
"119173","Mount Saint Mary's University","2017","On-tenure track, associate professors","5","1","4","0","0","0","0","0","0","1","0","1","0","0","0","0","0","0","4","1","3","0","0","0","0","0","0","0","0","0","-2"
"119173","Mount Saint Mary's University","2017","On-tenure track, assistant professors","17","4","13","0","0","0","3","1","2","3","1","2","2","1","1","0","0","0","6","1","5","2","0","2","1","0","1","0","0","0","-2"
"119173","Mount Saint Mary's University","2017","Not on tenure track/No tenure system system total","44","12","32","0","0","0","3","0","3","3","1","2","5","2","3","0","0","0","31","9","22","1","0","1","1","0","1","0","0","0","-2"
"119173","Mount Saint Mary's University","2017","Not on tenure/no tenure system, professors","1","0","1","0","0","0","0","0","0","0","0","0","0","0","0","0","0","0","1","0","1","0","0","0","0","0","0","0","0","0","-2"
"119173","Mount Saint Mary's University","2017","Not on tenure/no tenure system, associate professors","3","2","1","0","0","0","0","0","0","0","0","0","1","1","0","0","0","0","2","1","1","0","0","0","0","0","0","0","0","0","-2"
"119173","Mount Saint Mary's University","2017","Not on tenure/no tenure system, assistant professors","25","5","20","0","0","0","2","0","2","1","1","0","1","0","1","0","0","0","19","4","15","1","0","1","1","0","1","0","0","0","-2"
"119173","Mount Saint Mary's University","2017","Not on tenure/no tenure system, instructors","15","5","10","0","0","0","1","0","1","2","0","2","3","1","2","0","0","0","9","4","5","0","0","0","0","0","0","0","0","0","-2"
"119605","National University","2017","Not on tenure track/No tenure system system total","286","132","154","1","1","0","30","17","13","14","5","9","23","9","14","0","0","0","193","94","99","4","2","2","21","4","17","0","0","0","-2"
"119605","National University","2017","Not on tenure/no tenure system, professors","108","66","42","1","1","0","13","10","3","4","2","2","9","3","6","0","0","0","74","47","27","1","1","0","6","2","4","0","0","0","-2"
"119605","National University","2017","Not on tenure/no tenure system, associate professors","84","33","51","0","0","0","7","4","3","5","2","3","5","3","2","0","0","0","60","23","37","3","1","2","4","0","4","0","0","0","-2"
"119605","National University","2017","Not on tenure/no tenure system, assistant professors","82","28","54","0","0","0","8","2","6","5","1","4","9","3","6","0","0","0","50","20","30","0","0","0","10","2","8","0","0","0","-2"
"119605","National University","2017","Not on tenure/no tenure system, instructors","12","5","7","0","0","0","2","1","1","0","0","0","0","0","0","0","0","0","9","4","5","0","0","0","1","0","1","0","0","0","-2"
"120184","Notre Dame de Namur University","2017","Tenured total","27","15","12","0","0","0","5","2","3","1","1","0","1","1","0","0","0","0","20","11","9","0","0","0","0","0","0","0","0","0","-2"
"120184","Notre Dame de Namur University","2017","Tenured, professors","26","15","11","0","0","0","4","2","2","1","1","0","1","1","0","0","0","0","20","11","9","0","0","0","0","0","0","0","0","0","-2"
"120184","Notre Dame de Namur University","2017","Tenured, associate professors","1","0","1","0","0","0","1","0","1","0","0","0","0","0","0","0","0","0","0","0","0","0","0","0","0","0","0","0","0","0","-2"
"120184","Notre Dame de Namur University","2017","On-Tenure track total","8","1","7","0","0","0","2","0","2","0","0","0","0","0","0","0","0","0","6","1","5","0","0","0","0","0","0","0","0","0","-2"
"120184","Notre Dame de Namur University","2017","On-tenure track, associate professors","5","1","4","0","0","0","0","0","0","0","0","0","0","0","0","0","0","0","5","1","4","0","0","0","0","0","0","0","0","0","-2"
"120184","Notre Dame de Namur University","2017","On-tenure track, assistant professors","3","0","3","0","0","0","2","0","2","0","0","0","0","0","0","0","0","0","1","0","1","0","0","0","0","0","0","0","0","0","-2"
"120184","Notre Dame de Namur University","2017","Not on tenure track/No tenure system system total","14","4","10","1","1","0","5","2","3","1","0","1","0","0","0","0","0","0","7","1","6","0","0","0","0","0","0","0","0","0","-2"
"120184","Notre Dame de Namur University","2017","Not on tenure/no tenure system, professors","1","1","0","1","1","0","0","0","0","0","0","0","0","0","0","0","0","0","0","0","0","0","0","0","0","0","0","0","0","0","-2"
"120184","Notre Dame de Namur University","2017","Not on tenure/no tenure system, associate professors","2","1","1","0","0","0","2","1","1","0","0","0","0","0","0","0","0","0","0","0","0","0","0","0","0","0","0","0","0","0","-2"
"120184","Notre Dame de Namur University","2017","Not on tenure/no tenure system, assistant professors","9","1","8","0","0","0","3","1","2","1","0","1","0","0","0","0","0","0","5","0","5","0","0","0","0","0","0","0","0","0","-2"
"120184","Notre Dame de Namur University","2017","Not on tenure/no tenure system, instructors","2","1","1","0","0","0","0","0","0","0","0","0","0","0","0","0","0","0","2","1","1","0","0","0","0","0","0","0","0","0","-2"
"120537","Hope International University","2017","Not on tenure track/No tenure system system total","32","15","17","0","0","0","2","1","1","2","0","2","1","1","0","0","0","0","27","13","14","0","0","0","0","0","0","0","0","0","-2"
"120537","Hope International University","2017","Not on tenure/no tenure system, professors","9","7","2","0","0","0","1","1","0","1","0","1","0","0","0","0","0","0","7","6","1","0","0","0","0","0","0","0","0","0","-2"
"120537","Hope International University","2017","Not on tenure/no tenure system, associate professors","17","5","12","0","0","0","1","0","1","1","0","1","1","1","0","0","0","0","14","4","10","0","0","0","0","0","0","0","0","0","-2"
"120537","Hope International University","2017","Not on tenure/no tenure system, assistant professors","6","3","3","0","0","0","0","0","0","0","0","0","0","0","0","0","0","0","6","3","3","0","0","0","0","0","0","0","0","0","-2"
"120768","Pacific Oaks College","2017","Not on tenure track/No tenure system system total","20","6","14","0","0","0","1","0","1","7","2","5","4","1","3","1","1","0","7","2","5","0","0","0","0","0","0","0","0","0","-2"
"120768","Pacific Oaks College","2017","Not on tenure/no tenure system, no academic rank","20","6","14","0","0","0","1","0","1","7","2","5","4","1","3","1","1","0","7","2","5","0","0","0","0","0","0","0","0","0","-2"
"120865","Pacific Union College","2017","Tenured total","31","17","14","0","0","0","2","1","1","0","0","0","0","0","0","0","0","0","25","13","12","1","1","0","3","2","1","0","0","0","-2"
"120865","Pacific Union College","2017","Tenured, professors","24","13","11","0","0","0","2","1","1","0","0","0","0","0","0","0","0","0","19","10","9","0","0","0","3","2","1","0","0","0","-2"
"120865","Pacific Union College","2017","Tenured, associate professors","7","4","3","0","0","0","0","0","0","0","0","0","0","0","0","0","0","0","6","3","3","1","1","0","0","0","0","0","0","0","-2"
"120865","Pacific Union College","2017","On-Tenure track total","33","17","16","0","0","0","7","5","2","1","1","0","2","2","0","0","0","0","17","7","10","0","0","0","5","1","4","1","1","0","-2"
"120865","Pacific Union College","2017","On-tenure track, professors","5","3","2","0","0","0","2","2","0","0","0","0","0","0","0","0","0","0","2","0","2","0","0","0","1","1","0","0","0","0","-2"
"120865","Pacific Union College","2017","On-tenure track, associate professors","11","6","5","0","0","0","2","2","0","0","0","0","0","0","0","0","0","0","7","4","3","0","0","0","2","0","2","0","0","0","-2"
"120865","Pacific Union College","2017","On-tenure track, assistant professors","13","5","8","0","0","0","3","1","2","1","1","0","0","0","0","0","0","0","6","2","4","0","0","0","2","0","2","1","1","0","-2"
"120865","Pacific Union College","2017","On-tenure track, instructors","4","3","1","0","0","0","0","0","0","0","0","0","2","2","0","0","0","0","2","1","1","0","0","0","0","0","0","0","0","0","-2"
"120865","Pacific Union College","2017","Not on tenure track/No tenure system system total","22","10","12","0","0","0","1","0","1","2","1","1","2","0","2","0","0","0","14","7","7","1","1","0","0","0","0","2","1","1","-2"
"120865","Pacific Union College","2017","Not on tenure/no tenure system, professors","1","1","0","0","0","0","0","0","0","0","0","0","0","0","0","0","0","0","0","0","0","0","0","0","0","0","0","1","1","0","-2"
"120865","Pacific Union College","2017","Not on tenure/no tenure system, associate professors","3","1","2","0","0","0","0","0","0","0","0","0","0","0","0","0","0","0","2","0","2","1","1","0","0","0","0","0","0","0","-2"
"120865","Pacific Union College","2017","Not on tenure/no tenure system, assistant professors","14","6","8","0","0","0","1","0","1","2","1","1","2","0","2","0","0","0","8","5","3","0","0","0","0","0","0","1","0","1","-2"
"120865","Pacific Union College","2017","Not on tenure/no tenure system, instructors","4","2","2","0","0","0","0","0","0","0","0","0","0","0","0","0","0","0","4","2","2","0","0","0","0","0","0","0","0","0","-2"
"121619","Santa Ana College","2017","Tenured total","105","48","57","2","1","1","10","5","5","1","0","1","24","9","15","0","0","0","66","32","34","0","0","0","1","0","1","1","1","0","-2"
"121619","Santa Ana College","2017","Tenured, instructors","105","48","57","2","1","1","10","5","5","1","0","1","24","9","15","0","0","0","66","32","34","0","0","0","1","0","1","1","1","0","-2"
"121619","Santa Ana College","2017","On-Tenure track total","142","63","79","0","0","0","23","11","12","5","2","3","39","17","22","0","0","0","62","27","35","0","0","0","9","5","4","4","1","3","-2"
"121619","Santa Ana College","2017","On-tenure track, instructors","142","63","79","0","0","0","23","11","12","5","2","3","39","17","22","0","0","0","62","27","35","0","0","0","9","5","4","4","1","3","-2"
"121619","Santa Ana College","2017","Not on tenure track/No tenure system system total","8","1","7","0","0","0","2","0","2","0","0","0","1","0","1","0","0","0","5","1","4","0","0","0","0","0","0","0","0","0","-2"
"121619","Santa Ana College","2017","Not on tenure/no tenure system, instructors","8","1","7","0","0","0","2","0","2","0","0","0","1","0","1","0","0","0","5","1","4","0","0","0","0","0","0","0","0","0","-2"
"121691","University of Redlands","2017","Tenured total","153","77","76","1","1","0","20","11","9","5","2","3","5","3","2","0","0","0","121","59","62","0","0","0","1","1","0","0","0","0","-2"
"121691","University of Redlands","2017","Tenured, professors","114","59","55","0","0","0","12","8","4","3","2","1","3","2","1","0","0","0","95","46","49","0","0","0","1","1","0","0","0","0","-2"
"121691","University of Redlands","2017","Tenured, associate professors","39","18","21","1","1","0","8","3","5","2","0","2","2","1","1","0","0","0","26","13","13","0","0","0","0","0","0","0","0","0","-2"
"121691","University of Redlands","2017","On-Tenure track total","22","12","10","0","0","0","2","1","1","1","0","1","3","1","2","0","0","0","13","9","4","0","0","0","3","1","2","0","0","0","-2"
"121691","University of Redlands","2017","On-tenure track, associate professors","3","1","2","0","0","0","0","0","0","0","0","0","1","0","1","0","0","0","2","1","1","0","0","0","0","0","0","0","0","0","-2"
"121691","University of Redlands","2017","On-tenure track, assistant professors","19","11","8","0","0","0","2","1","1","1","0","1","2","1","1","0","0","0","11","8","3","0","0","0","3","1","2","0","0","0","-2"
"121691","University of Redlands","2017","Not on tenure track/No tenure system system total","43","19","24","0","0","0","4","1","3","2","1","1","2","1","1","0","0","0","30","13","17","0","0","0","5","3","2","0","0","0","-2"
"121691","University of Redlands","2017","Not on tenure/no tenure system, professors","2","2","0","0","0","0","1","1","0","0","0","0","0","0","0","0","0","0","1","1","0","0","0","0","0","0","0","0","0","0","-2"
"121691","University of Redlands","2017","Not on tenure/no tenure system, lecturers","12","6","6","0","0","0","0","0","0","1","1","0","1","1","0","0","0","0","9","4","5","0","0","0","1","0","1","0","0","0","-2"
"121691","University of Redlands","2017","Not on tenure/no tenure system, no academic rank","29","11","18","0","0","0","3","0","3","1","0","1","1","0","1","0","0","0","20","8","12","0","0","0","4","3","1","0","0","0","-2"
"121886","Rio Hondo College","2017","Tenured total","138","74","64","3","3","0","14","7","7","4","3","1","43","19","24","0","0","0","71","39","32","2","2","0","0","0","0","1","1","0","-2"
"121886","Rio Hondo College","2017","Tenured, instructors","138","74","64","3","3","0","14","7","7","4","3","1","43","19","24","0","0","0","71","39","32","2","2","0","0","0","0","1","1","0","-2"
"121886","Rio Hondo College","2017","On-Tenure track total","61","23","38","0","0","0","9","2","7","3","0","3","28","9","19","0","0","0","16","12","4","1","0","1","4","0","4","0","0","0","-2"
"121886","Rio Hondo College","2017","On-tenure track, instructors","61","23","38","0","0","0","9","2","7","3","0","3","28","9","19","0","0","0","16","12","4","1","0","1","4","0","4","0","0","0","-2"
"121886","Rio Hondo College","2017","Not on tenure track/No tenure system system total","1","1","0","1","1","0","0","0","0","0","0","0","0","0","0","0","0","0","0","0","0","0","0","0","0","0","0","0","0","0","-2"
"121886","Rio Hondo College","2017","Not on tenure/no tenure system, instructors","1","1","0","1","1","0","0","0","0","0","0","0","0","0","0","0","0","0","0","0","0","0","0","0","0","0","0","0","0","0","-2"
"122375","San Diego Mesa College","2017","Tenured total","139","75","64","2","1","1","18","6","12","11","7","4","16","8","8","0","0","0","77","44","33","0","0","0","15","9","6","0","0","0","-2"
"122375","San Diego Mesa College","2017","Tenured, instructors","139","75","64","2","1","1","18","6","12","11","7","4","16","8","8","0","0","0","77","44","33","0","0","0","15","9","6","0","0","0","-2"
"122375","San Diego Mesa College","2017","On-Tenure track total","76","28","48","0","0","0","6","1","5","5","0","5","8","5","3","0","0","0","45","17","28","0","0","0","11","5","6","1","0","1","-2"
"122375","San Diego Mesa College","2017","On-tenure track, instructors","76","28","48","0","0","0","6","1","5","5","0","5","8","5","3","0","0","0","45","17","28","0","0","0","11","5","6","1","0","1","-2"
"122375","San Diego Mesa College","2017","Not on tenure track/No tenure system system total","8","3","5","0","0","0","0","0","0","0","0","0","2","1","1","0","0","0","5","2","3","0","0","0","1","0","1","0","0","0","-2"
"122375","San Diego Mesa College","2017","Not on tenure/no tenure system, instructors","8","3","5","0","0","0","0","0","0","0","0","0","2","1","1","0","0","0","5","2","3","0","0","0","1","0","1","0","0","0","-2"
"122977","Santa Monica College","2017","Tenured total","240","110","130","0","0","0","28","12","16","28","14","14","30","11","19","1","0","1","133","67","66","1","0","1","1","1","0","18","5","13","-2"
"122977","Santa Monica College","2017","Tenured, instructors","240","110","130","0","0","0","28","12","16","28","14","14","30","11","19","1","0","1","133","67","66","1","0","1","1","1","0","18","5","13","-2"
"122977","Santa Monica College","2017","On-Tenure track total","99","39","60","0","0","0","5","0","5","13","4","9","12","6","6","0","0","0","46","20","26","2","0","2","0","0","0","21","9","12","-2"
"122977","Santa Monica College","2017","On-tenure track, instructors","99","39","60","0","0","0","5","0","5","13","4","9","12","6","6","0","0","0","46","20","26","2","0","2","0","0","0","21","9","12","-2"
"122977","Santa Monica College","2017","Not on tenure track/No tenure system system total","7","0","7","0","0","0","0","0","0","1","0","1","2","0","2","0","0","0","4","0","4","0","0","0","0","0","0","0","0","0","-2"
"122977","Santa Monica College","2017","Not on tenure/no tenure system, instructors","7","0","7","0","0","0","0","0","0","1","0","1","2","0","2","0","0","0","4","0","4","0","0","0","0","0","0","0","0","0","-2"
"123509","Skyline College","2017","Tenured total","95","48","47","0","0","0","21","10","11","7","6","1","13","5","8","0","0","0","47","24","23","0","0","0","7","3","4","0","0","0","-2"
"123509","Skyline College","2017","Tenured, instructors","95","48","47","0","0","0","21","10","11","7","6","1","13","5","8","0","0","0","47","24","23","0","0","0","7","3","4","0","0","0","-2"
"123509","Skyline College","2017","On-Tenure track total","42","17","25","0","0","0","6","1","5","10","3","7","9","7","2","0","0","0","14","5","9","0","0","0","2","1","1","1","0","1","-2"
"123509","Skyline College","2017","On-tenure track, instructors","42","17","25","0","0","0","6","1","5","10","3","7","9","7","2","0","0","0","14","5","9","0","0","0","2","1","1","1","0","1","-2"
"123509","Skyline College","2017","Not on tenure track/No tenure system system total","11","4","7","0","0","0","3","2","1","1","0","1","4","1","3","0","0","0","3","1","2","0","0","0","0","0","0","0","0","0","-2"
"123509","Skyline College","2017","Not on tenure/no tenure system, instructors","11","4","7","0","0","0","3","2","1","1","0","1","4","1","3","0","0","0","3","1","2","0","0","0","0","0","0","0","0","0","-2"
"123554","Saint Mary's College of California","2017","Tenured total","132","68","64","1","0","1","17","6","11","3","1","2","8","3","5","0","0","0","90","52","38","0","0","0","10","5","5","3","1","2","-2"
"123554","Saint Mary's College of California","2017","Tenured, professors","80","46","34","1","0","1","11","5","6","1","0","1","4","2","2","0","0","0","60","37","23","0","0","0","3","2","1","0","0","0","-2"
"123554","Saint Mary's College of California","2017","Tenured, associate professors","52","22","30","0","0","0","6","1","5","2","1","1","4","1","3","0","0","0","30","15","15","0","0","0","7","3","4","3","1","2","-2"
"123554","Saint Mary's College of California","2017","On-Tenure track total","72","24","48","0","0","0","5","1","4","5","1","4","12","3","9","0","0","0","19","9","10","0","0","0","20","7","13","11","3","8","-2"
"123554","Saint Mary's College of California","2017","On-tenure track, associate professors","17","5","12","0","0","0","2","1","1","2","0","2","2","0","2","0","0","0","6","2","4","0","0","0","3","1","2","2","1","1","-2"
"123554","Saint Mary's College of California","2017","On-tenure track, assistant professors","55","19","36","0","0","0","3","0","3","3","1","2","10","3","7","0","0","0","13","7","6","0","0","0","17","6","11","9","2","7","-2"
"123554","Saint Mary's College of California","2017","Not on tenure track/No tenure system system total","20","8","12","0","0","0","3","1","2","0","0","0","1","0","1","0","0","0","11","5","6","0","0","0","5","2","3","0","0","0","-2"
"123554","Saint Mary's College of California","2017","Not on tenure/no tenure system, associate professors","12","5","7","0","0","0","1","0","1","0","0","0","0","0","0","0","0","0","8","4","4","0","0","0","3","1","2","0","0","0","-2"
"123554","Saint Mary's College of California","2017","Not on tenure/no tenure system, assistant professors","8","3","5","0","0","0","2","1","1","0","0","0","1","0","1","0","0","0","3","1","2","0","0","0","2","1","1","0","0","0","-2"
"123563","Solano Community College","2017","Tenured total","97","45","52","0","0","0","5","3","2","7","3","4","11","4","7","0","0","0","74","35","39","0","0","0","0","0","0","0","0","0","-2"
"123563","Solano Community College","2017","Tenured, instructors","97","45","52","0","0","0","5","3","2","7","3","4","11","4","7","0","0","0","74","35","39","0","0","0","0","0","0","0","0","0","-2"
"123563","Solano Community College","2017","On-Tenure track total","51","20","31","0","0","0","3","0","3","8","4","4","5","4","1","0","0","0","35","12","23","0","0","0","0","0","0","0","0","0","-2"
"123563","Solano Community College","2017","On-tenure track, instructors","51","20","31","0","0","0","3","0","3","8","4","4","5","4","1","0","0","0","35","12","23","0","0","0","0","0","0","0","0","0","-2"
"123563","Solano Community College","2017","Not on tenure track/No tenure system system total","2","1","1","0","0","0","0","0","0","0","0","0","0","0","0","0","0","0","2","1","1","0","0","0","0","0","0","0","0","0","-2"
"123563","Solano Community College","2017","Not on tenure/no tenure system, instructors","2","1","1","0","0","0","0","0","0","0","0","0","0","0","0","0","0","0","2","1","1","0","0","0","0","0","0","0","0","0","-2"
"123572","Sonoma State University","2017","Tenured total","172","91","81","0","0","0","15","12","3","3","0","3","12","7","5","0","0","0","133","66","67","2","2","0","7","4","3","0","0","0","-2"
"123572","Sonoma State University","2017","Tenured, professors","129","64","65","0","0","0","10","7","3","2","0","2","9","5","4","0","0","0","103","49","54","1","1","0","4","2","2","0","0","0","-2"
"123572","Sonoma State University","2017","Tenured, associate professors","43","27","16","0","0","0","5","5","0","1","0","1","3","2","1","0","0","0","30","17","13","1","1","0","3","2","1","0","0","0","-2"
"123572","Sonoma State University","2017","On-Tenure track total","63","24","39","1","0","1","4","2","2","0","0","0","7","4","3","0","0","0","32","12","20","3","0","3","10","3","7","6","3","3","-2"
"123572","Sonoma State University","2017","On-tenure track, associate professors","2","2","0","0","0","0","0","0","0","0","0","0","0","0","0","0","0","0","1","1","0","0","0","0","0","0","0","1","1","0","-2"
"123572","Sonoma State University","2017","On-tenure track, assistant professors","61","22","39","1","0","1","4","2","2","0","0","0","7","4","3","0","0","0","31","11","20","3","0","3","10","3","7","5","2","3","-2"
"123572","Sonoma State University","2017","Not on tenure track/No tenure system system total","34","13","21","0","0","0","2","0","2","0","0","0","3","2","1","0","0","0","24","9","15","0","0","0","4","1","3","1","1","0","-2"
"123572","Sonoma State University","2017","Not on tenure/no tenure system, lecturers","34","13","21","0","0","0","2","0","2","0","0","0","3","2","1","0","0","0","24","9","15","0","0","0","4","1","3","1","1","0","-2"
"123651","Vanguard University of Southern California","2017","Tenured total","46","23","23","0","0","0","2","1","1","1","1","0","1","0","1","0","0","0","41","21","20","1","0","1","0","0","0","0","0","0","-2"
"123651","Vanguard University of Southern California","2017","Tenured, professors","32","19","13","0","0","0","0","0","0","0","0","0","1","0","1","0","0","0","30","19","11","1","0","1","0","0","0","0","0","0","-2"
"123651","Vanguard University of Southern California","2017","Tenured, associate professors","13","4","9","0","0","0","2","1","1","1","1","0","0","0","0","0","0","0","10","2","8","0","0","0","0","0","0","0","0","0","-2"
"123651","Vanguard University of Southern California","2017","Tenured, assistant professors","1","0","1","0","0","0","0","0","0","0","0","0","0","0","0","0","0","0","1","0","1","0","0","0","0","0","0","0","0","0","-2"
"123651","Vanguard University of Southern California","2017","On-Tenure track total","26","12","14","0","0","0","6","4","2","2","2","0","2","1","1","0","0","0","15","5","10","1","0","1","0","0","0","0","0","0","-2"
"123651","Vanguard University of Southern California","2017","On-tenure track, professors","2","2","0","0","0","0","1","1","0","0","0","0","0","0","0","0","0","0","1","1","0","0","0","0","0","0","0","0","0","0","-2"
"123651","Vanguard University of Southern California","2017","On-tenure track, associate professors","6","2","4","0","0","0","2","1","1","1","1","0","0","0","0","0","0","0","3","0","3","0","0","0","0","0","0","0","0","0","-2"
"123651","Vanguard University of Southern California","2017","On-tenure track, assistant professors","18","8","10","0","0","0","3","2","1","1","1","0","2","1","1","0","0","0","11","4","7","1","0","1","0","0","0","0","0","0","-2"
"123651","Vanguard University of Southern California","2017","Not on tenure track/No tenure system system total","10","4","6","0","0","0","0","0","0","1","1","0","1","0","1","1","1","0","7","2","5","0","0","0","0","0","0","0","0","0","-2"
"123651","Vanguard University of Southern California","2017","Not on tenure/no tenure system, associate professors","1","1","0","0","0","0","0","0","0","0","0","0","0","0","0","0","0","0","1","1","0","0","0","0","0","0","0","0","0","0","-2"
"123651","Vanguard University of Southern California","2017","Not on tenure/no tenure system, assistant professors","7","3","4","0","0","0","0","0","0","1","1","0","1","0","1","1","1","0","4","1","3","0","0","0","0","0","0","0","0","0","-2"
"123651","Vanguard University of Southern California","2017","Not on tenure/no tenure system, instructors","2","0","2","0","0","0","0","0","0","0","0","0","0","0","0","0","0","0","2","0","2","0","0","0","0","0","0","0","0","0","-2"
"125471","West Los Angeles College","2017","Tenured total","75","35","40","0","0","0","11","6","5","10","5","5","9","4","5","1","0","1","30","14","16","0","0","0","13","6","7","1","0","1","-2"
"125471","West Los Angeles College","2017","Tenured, instructors","75","35","40","0","0","0","11","6","5","10","5","5","9","4","5","1","0","1","30","14","16","0","0","0","13","6","7","1","0","1","-2"
"125471","West Los Angeles College","2017","On-Tenure track total","39","16","23","0","0","0","2","1","1","1","1","0","6","2","4","0","0","0","6","3","3","0","0","0","24","9","15","0","0","0","-2"
"125471","West Los Angeles College","2017","On-tenure track, instructors","39","16","23","0","0","0","2","1","1","1","1","0","6","2","4","0","0","0","6","3","3","0","0","0","24","9","15","0","0","0","-2"
"125471","West Los Angeles College","2017","Not on tenure track/No tenure system system total","2","0","2","0","0","0","0","0","0","0","0","0","0","0","0","0","0","0","1","0","1","0","0","0","1","0","1","0","0","0","-2"
"125471","West Los Angeles College","2017","Not on tenure/no tenure system, instructors","2","0","2","0","0","0","0","0","0","0","0","0","0","0","0","0","0","0","1","0","1","0","0","0","1","0","1","0","0","0","-2"
"125763","Whittier College","2017","Tenured total","79","42","37","0","0","0","3","1","2","2","0","2","12","8","4","0","0","0","55","29","26","1","0","1","0","0","0","6","4","2","-2"
"125763","Whittier College","2017","Tenured, professors","39","26","13","0","0","0","1","1","0","1","0","1","2","2","0","0","0","0","31","21","10","1","0","1","0","0","0","3","2","1","-2"
"125763","Whittier College","2017","Tenured, associate professors","38","16","22","0","0","0","2","0","2","1","0","1","10","6","4","0","0","0","22","8","14","0","0","0","0","0","0","3","2","1","-2"
"125763","Whittier College","2017","Tenured, assistant professors","2","0","2","0","0","0","0","0","0","0","0","0","0","0","0","0","0","0","2","0","2","0","0","0","0","0","0","0","0","0","-2"
"125763","Whittier College","2017","On-Tenure track total","20","11","9","0","0","0","2","1","1","1","1","0","2","0","2","0","0","0","13","7","6","2","2","0","0","0","0","0","0","0","-2"
"125763","Whittier College","2017","On-tenure track, associate professors","1","1","0","0","0","0","0","0","0","0","0","0","0","0","0","0","0","0","1","1","0","0","0","0","0","0","0","0","0","0","-2"
"125763","Whittier College","2017","On-tenure track, assistant professors","19","10","9","0","0","0","2","1","1","1","1","0","2","0","2","0","0","0","12","6","6","2","2","0","0","0","0","0","0","0","-2"
"125763","Whittier College","2017","Not on tenure track/No tenure system system total","43","17","26","0","0","0","2","1","1","1","0","1","11","3","8","0","0","0","28","12","16","1","1","0","0","0","0","0","0","0","-2"
"125763","Whittier College","2017","Not on tenure/no tenure system, professors","8","2","6","0","0","0","0","0","0","0","0","0","0","0","0","0","0","0","8","2","6","0","0","0","0","0","0","0","0","0","-2"
"125763","Whittier College","2017","Not on tenure/no tenure system, associate professors","2","1","1","0","0","0","0","0","0","0","0","0","0","0","0","0","0","0","2","1","1","0","0","0","0","0","0","0","0","0","-2"
"125763","Whittier College","2017","Not on tenure/no tenure system, assistant professors","21","11","10","0","0","0","2","1","1","1","0","1","6","3","3","0","0","0","11","6","5","1","1","0","0","0","0","0","0","0","-2"
"125763","Whittier College","2017","Not on tenure/no tenure system, instructors","7","2","5","0","0","0","0","0","0","0","0","0","2","0","2","0","0","0","5","2","3","0","0","0","0","0","0","0","0","0","-2"
"125763","Whittier College","2017","Not on tenure/no tenure system, lecturers","5","1","4","0","0","0","0","0","0","0","0","0","3","0","3","0","0","0","2","1","1","0","0","0","0","0","0","0","0","0","-2"
"125897","Woodbury University","2017","Not on tenure track/No tenure system system total","70","42","28","0","0","0","10","5","5","0","0","0","3","3","0","0","0","0","47","31","16","6","0","6","4","3","1","0","0","0","-2"
"125897","Woodbury University","2017","Not on tenure/no tenure system, professors","23","15","8","0","0","0","3","2","1","0","0","0","1","1","0","0","0","0","18","11","7","0","0","0","1","1","0","0","0","0","-2"
"125897","Woodbury University","2017","Not on tenure/no tenure system, associate professors","26","15","11","0","0","0","3","1","2","0","0","0","1","1","0","0","0","0","20","11","9","0","0","0","2","2","0","0","0","0","-2"
"125897","Woodbury University","2017","Not on tenure/no tenure system, assistant professors","21","12","9","0","0","0","4","2","2","0","0","0","1","1","0","0","0","0","9","9","0","6","0","6","1","0","1","0","0","0","-2"
"126182","Adams State University","2017","Tenured total","59","32","27","0","0","0","0","0","0","0","0","0","11","5","6","1","0","1","45","25","20","0","0","0","2","2","0","0","0","0","-2"
"126182","Adams State University","2017","Tenured, professors","39","25","14","0","0","0","0","0","0","0","0","0","5","4","1","0","0","0","32","19","13","0","0","0","2","2","0","0","0","0","-2"
"126182","Adams State University","2017","Tenured, associate professors","11","2","9","0","0","0","0","0","0","0","0","0","3","0","3","1","0","1","7","2","5","0","0","0","0","0","0","0","0","0","-2"
"126182","Adams State University","2017","Tenured, assistant professors","9","5","4","0","0","0","0","0","0","0","0","0","3","1","2","0","0","0","6","4","2","0","0","0","0","0","0","0","0","0","-2"
"126182","Adams State University","2017","On-Tenure track total","25","13","12","0","0","0","0","0","0","0","0","0","4","3","1","0","0","0","20","9","11","0","0","0","1","1","0","0","0","0","-2"
"126182","Adams State University","2017","On-tenure track, associate professors","1","1","0","0","0","0","0","0","0","0","0","0","0","0","0","0","0","0","1","1","0","0","0","0","0","0","0","0","0","0","-2"
"126182","Adams State University","2017","On-tenure track, assistant professors","24","12","12","0","0","0","0","0","0","0","0","0","4","3","1","0","0","0","19","8","11","0","0","0","1","1","0","0","0","0","-2"
"126182","Adams State University","2017","Not on tenure track/No tenure system system total","25","11","14","0","0","0","0","0","0","0","0","0","4","1","3","0","0","0","18","8","10","0","0","0","3","2","1","0","0","0","-2"
"126182","Adams State University","2017","Not on tenure/no tenure system, assistant professors","1","1","0","0","0","0","0","0","0","0","0","0","0","0","0","0","0","0","0","0","0","0","0","0","1","1","0","0","0","0","-2"
"126182","Adams State University","2017","Not on tenure/no tenure system, no academic rank","24","10","14","0","0","0","0","0","0","0","0","0","4","1","3","0","0","0","18","8","10","0","0","0","2","1","1","0","0","0","-2"
"126562","University of Colorado Denver/Anschutz Medical Campus","2017","Tenured total","599","413","186","3","1","2","54","38","16","7","4","3","35","26","9","0","0","0","480","331","149","1","0","1","19","13","6","0","0","0","-2"
"126562","University of Colorado Denver/Anschutz Medical Campus","2017","Tenured, professors","392","283","109","1","0","1","32","24","8","3","3","0","15","11","4","0","0","0","329","238","91","1","0","1","11","7","4","0","0","0","-2"
"126562","University of Colorado Denver/Anschutz Medical Campus","2017","Tenured, associate professors","207","130","77","2","1","1","22","14","8","4","1","3","20","15","5","0","0","0","151","93","58","0","0","0","8","6","2","0","0","0","-2"
"126562","University of Colorado Denver/Anschutz Medical Campus","2017","On-Tenure track total","1802","899","903","5","3","2","165","80","85","22","8","14","82","41","41","4","1","3","1187","599","588","11","4","7","295","146","149","31","17","14","-2"
"126562","University of Colorado Denver/Anschutz Medical Campus","2017","On-tenure track, professors","224","150","74","1","1","0","17","12","5","0","0","0","7","5","2","0","0","0","169","114","55","4","0","4","24","17","7","2","1","1","-2"
"126562","University of Colorado Denver/Anschutz Medical Campus","2017","On-tenure track, associate professors","577","307","270","4","2","2","48","27","21","5","2","3","27","13","14","1","0","1","420","220","200","3","2","1","67","40","27","2","1","1","-2"
"126562","University of Colorado Denver/Anschutz Medical Campus","2017","On-tenure track, assistant professors","1001","442","559","0","0","0","100","41","59","17","6","11","48","23","25","3","1","2","598","265","333","4","2","2","204","89","115","27","15","12","-2"
"126562","University of Colorado Denver/Anschutz Medical Campus","2017","Not on tenure track/No tenure system system total","1588","474","1114","7","1","6","77","35","42","12","4","8","73","30","43","1","0","1","1091","307","784","9","4","5","306","84","222","12","9","3","-2"
"126562","University of Colorado Denver/Anschutz Medical Campus","2017","Not on tenure/no tenure system, professors","13","5","8","0","0","0","0","0","0","0","0","0","0","0","0","0","0","0","13","5","8","0","0","0","0","0","0","0","0","0","-2"
"126562","University of Colorado Denver/Anschutz Medical Campus","2017","Not on tenure/no tenure system, associate professors","68","33","35","0","0","0","6","2","4","0","0","0","5","3","2","0","0","0","53","24","29","1","1","0","3","3","0","0","0","0","-2"
"126562","University of Colorado Denver/Anschutz Medical Campus","2017","Not on tenure/no tenure system, assistant professors","110","43","67","2","0","2","11","5","6","2","1","1","6","4","2","0","0","0","75","26","49","0","0","0","11","5","6","3","2","1","-2"
"126562","University of Colorado Denver/Anschutz Medical Campus","2017","Not on tenure/no tenure system, instructors","1397","393","1004","5","1","4","60","28","32","10","3","7","62","23","39","1","0","1","950","252","698","8","3","5","292","76","216","9","7","2","-2"
"126711","Colorado Mountain College","2017","Not on tenure track/No tenure system system total","116","61","55","1","1","0","2","1","1","0","0","0","6","2","4","0","0","0","102","54","48","1","1","0","4","2","2","0","0","0","-2"
"126711","Colorado Mountain College","2017","Not on tenure/no tenure system, professors","50","24","26","0","0","0","1","1","0","0","0","0","2","1","1","0","0","0","45","21","24","0","0","0","2","1","1","0","0","0","-2"
"126711","Colorado Mountain College","2017","Not on tenure/no tenure system, associate professors","47","24","23","1","1","0","1","0","1","0","0","0","3","1","2","0","0","0","39","20","19","1","1","0","2","1","1","0","0","0","-2"
"126711","Colorado Mountain College","2017","Not on tenure/no tenure system, assistant professors","16","10","6","0","0","0","0","0","0","0","0","0","1","0","1","0","0","0","15","10","5","0","0","0","0","0","0","0","0","0","-2"
"126711","Colorado Mountain College","2017","Not on tenure/no tenure system, instructors","3","3","0","0","0","0","0","0","0","0","0","0","0","0","0","0","0","0","3","3","0","0","0","0","0","0","0","0","0","0","-2"
"126942","Community College of Denver","2017","Not on tenure track/No tenure system system total","109","52","57","0","0","0","7","3","4","7","4","3","6","2","4","0","0","0","88","43","45","0","0","0","1","0","1","0","0","0","-2"
"126942","Community College of Denver","2017","Not on tenure/no tenure system, professors","37","19","18","0","0","0","4","2","2","3","2","1","1","0","1","0","0","0","29","15","14","0","0","0","0","0","0","0","0","0","-2"
"126942","Community College of Denver","2017","Not on tenure/no tenure system, associate professors","41","17","24","0","0","0","1","0","1","1","1","0","1","0","1","0","0","0","37","16","21","0","0","0","1","0","1","0","0","0","-2"
"126942","Community College of Denver","2017","Not on tenure/no tenure system, assistant professors","8","4","4","0","0","0","0","0","0","1","0","1","2","1","1","0","0","0","5","3","2","0","0","0","0","0","0","0","0","0","-2"
"126942","Community College of Denver","2017","Not on tenure/no tenure system, instructors","23","12","11","0","0","0","2","1","1","2","1","1","2","1","1","0","0","0","17","9","8","0","0","0","0","0","0","0","0","0","-2"
"127617","Morgan Community College","2017","Not on tenure track/No tenure system system total","30","11","19","0","0","0","0","0","0","0","0","0","0","0","0","0","0","0","30","11","19","0","0","0","0","0","0","0","0","0","-2"
"127617","Morgan Community College","2017","Not on tenure/no tenure system, no academic rank","30","11","19","0","0","0","0","0","0","0","0","0","0","0","0","0","0","0","30","11","19","0","0","0","0","0","0","0","0","0","-2"
"127884","Pueblo Community College","2017","Not on tenure track/No tenure system system total","97","45","52","0","0","0","0","0","0","0","0","0","13","7","6","0","0","0","83","37","46","0","0","0","1","1","0","0","0","0","-2"
"127884","Pueblo Community College","2017","Not on tenure/no tenure system, no academic rank","97","45","52","0","0","0","0","0","0","0","0","0","13","7","6","0","0","0","83","37","46","0","0","0","1","1","0","0","0","0","-2"
"128106","Colorado State University Pueblo","2017","Tenured total","94","58","36","0","0","0","7","4","3","4","3","1","11","5","6","0","0","0","65","43","22","1","0","1","6","3","3","0","0","0","-2"
"128106","Colorado State University Pueblo","2017","Tenured, professors","42","28","14","0","0","0","4","2","2","3","3","0","5","3","2","0","0","0","28","18","10","0","0","0","2","2","0","0","0","0","-2"
"128106","Colorado State University Pueblo","2017","Tenured, associate professors","47","27","20","0","0","0","3","2","1","0","0","0","6","2","4","0","0","0","33","22","11","1","0","1","4","1","3","0","0","0","-2"
"128106","Colorado State University Pueblo","2017","Tenured, assistant professors","5","3","2","0","0","0","0","0","0","1","0","1","0","0","0","0","0","0","4","3","1","0","0","0","0","0","0","0","0","0","-2"
"128106","Colorado State University Pueblo","2017","On-Tenure track total","35","16","19","0","0","0","2","1","1","0","0","0","5","3","2","0","0","0","24","9","15","0","0","0","1","1","0","3","2","1","-2"
"128106","Colorado State University Pueblo","2017","On-tenure track, assistant professors","35","16","19","0","0","0","2","1","1","0","0","0","5","3","2","0","0","0","24","9","15","0","0","0","1","1","0","3","2","1","-2"
"128106","Colorado State University Pueblo","2017","Not on tenure track/No tenure system system total","57","26","31","0","0","0","2","1","1","0","0","0","5","2","3","0","0","0","42","19","23","1","0","1","4","3","1","3","1","2","-2"
"128106","Colorado State University Pueblo","2017","Not on tenure/no tenure system, assistant professors","18","7","11","0","0","0","1","0","1","0","0","0","0","0","0","0","0","0","11","4","7","1","0","1","2","2","0","3","1","2","-2"
"128106","Colorado State University Pueblo","2017","Not on tenure/no tenure system, instructors","1","0","1","0","0","0","0","0","0","0","0","0","0","0","0","0","0","0","1","0","1","0","0","0","0","0","0","0","0","0","-2"
"128106","Colorado State University Pueblo","2017","Not on tenure/no tenure system, lecturers","33","14","19","0","0","0","0","0","0","0","0","0","5","2","3","0","0","0","26","11","15","0","0","0","2","1","1","0","0","0","-2"
"128106","Colorado State University Pueblo","2017","Not on tenure/no tenure system, no academic rank","5","5","0","0","0","0","1","1","0","0","0","0","0","0","0","0","0","0","4","4","0","0","0","0","0","0","0","0","0","0","-2"
"128744","University of Bridgeport","2017","Tenured total","61","40","21","0","0","0","13","10","3","3","2","1","0","0","0","0","0","0","45","28","17","0","0","0","0","0","0","0","0","0","-2"
"128744","University of Bridgeport","2017","Tenured, professors","19","14","5","0","0","0","7","5","2","0","0","0","0","0","0","0","0","0","12","9","3","0","0","0","0","0","0","0","0","0","-2"
"128744","University of Bridgeport","2017","Tenured, associate professors","39","26","13","0","0","0","6","5","1","2","2","0","0","0","0","0","0","0","31","19","12","0","0","0","0","0","0","0","0","0","-2"
"128744","University of Bridgeport","2017","Tenured, assistant professors","3","0","3","0","0","0","0","0","0","1","0","1","0","0","0","0","0","0","2","0","2","0","0","0","0","0","0","0","0","0","-2"
"128744","University of Bridgeport","2017","On-Tenure track total","37","14","23","0","0","0","3","1","2","3","1","2","1","1","0","0","0","0","30","11","19","0","0","0","0","0","0","0","0","0","-2"
"128744","University of Bridgeport","2017","On-tenure track, associate professors","9","5","4","0","0","0","1","1","0","0","0","0","1","1","0","0","0","0","7","3","4","0","0","0","0","0","0","0","0","0","-2"
"128744","University of Bridgeport","2017","On-tenure track, assistant professors","27","8","19","0","0","0","2","0","2","3","1","2","0","0","0","0","0","0","22","7","15","0","0","0","0","0","0","0","0","0","-2"
"128744","University of Bridgeport","2017","On-tenure track, lecturers","1","1","0","0","0","0","0","0","0","0","0","0","0","0","0","0","0","0","1","1","0","0","0","0","0","0","0","0","0","0","-2"
"128744","University of Bridgeport","2017","Not on tenure track/No tenure system system total","49","22","27","0","0","0","7","4","3","1","1","0","1","0","1","0","0","0","40","17","23","0","0","0","0","0","0","0","0","0","-2"
"128744","University of Bridgeport","2017","Not on tenure/no tenure system, associate professors","3","2","1","0","0","0","0","0","0","0","0","0","0","0","0","0","0","0","3","2","1","0","0","0","0","0","0","0","0","0","-2"
"128744","University of Bridgeport","2017","Not on tenure/no tenure system, assistant professors","21","11","10","0","0","0","5","3","2","1","1","0","1","0","1","0","0","0","14","7","7","0","0","0","0","0","0","0","0","0","-2"
"128744","University of Bridgeport","2017","Not on tenure/no tenure system, lecturers","25","9","16","0","0","0","2","1","1","0","0","0","0","0","0","0","0","0","23","8","15","0","0","0","0","0","0","0","0","0","-2"
"131876","Trinity Washington University","2017","Tenured total","26","6","20","0","0","0","3","2","1","6","2","4","1","1","0","0","0","0","16","1","15","0","0","0","0","0","0","0","0","0","-2"
"131876","Trinity Washington University","2017","Tenured, professors","5","0","5","0","0","0","0","0","0","0","0","0","0","0","0","0","0","0","5","0","5","0","0","0","0","0","0","0","0","0","-2"
"131876","Trinity Washington University","2017","Tenured, associate professors","21","6","15","0","0","0","3","2","1","6","2","4","1","1","0","0","0","0","11","1","10","0","0","0","0","0","0","0","0","0","-2"
"131876","Trinity Washington University","2017","On-Tenure track total","12","1","11","0","0","0","2","0","2","8","0","8","0","0","0","0","0","0","2","1","1","0","0","0","0","0","0","0","0","0","-2"
"131876","Trinity Washington University","2017","On-tenure track, assistant professors","12","1","11","0","0","0","2","0","2","8","0","8","0","0","0","0","0","0","2","1","1","0","0","0","0","0","0","0","0","0","-2"
"131876","Trinity Washington University","2017","Not on tenure track/No tenure system system total","22","7","15","0","0","0","1","0","1","9","3","6","0","0","0","0","0","0","12","4","8","0","0","0","0","0","0","0","0","0","-2"
"131876","Trinity Washington University","2017","Not on tenure/no tenure system, assistant professors","22","7","15","0","0","0","1","0","1","9","3","6","0","0","0","0","0","0","12","4","8","0","0","0","0","0","0","0","0","0","-2"
"132471","Barry University","2017","Tenured total","19","9","10","2","0","2","2","0","2","1","1","0","1","1","0","0","0","0","13","7","6","0","0","0","0","0","0","0","0","0","-2"
"132471","Barry University","2017","Tenured, professors","8","4","4","0","0","0","0","0","0","1","1","0","0","0","0","0","0","0","7","3","4","0","0","0","0","0","0","0","0","0","-2"
"132471","Barry University","2017","Tenured, associate professors","11","5","6","2","0","2","2","0","2","0","0","0","1","1","0","0","0","0","6","4","2","0","0","0","0","0","0","0","0","0","-2"
"132471","Barry University","2017","On-Tenure track total","10","5","5","0","0","0","2","1","1","1","0","1","0","0","0","0","0","0","5","3","2","0","0","0","2","1","1","0","0","0","-2"
"132471","Barry University","2017","On-tenure track, professors","1","1","0","0","0","0","0","0","0","0","0","0","0","0","0","0","0","0","1","1","0","0","0","0","0","0","0","0","0","0","-2"
"132471","Barry University","2017","On-tenure track, associate professors","3","2","1","0","0","0","0","0","0","0","0","0","0","0","0","0","0","0","3","2","1","0","0","0","0","0","0","0","0","0","-2"
"132471","Barry University","2017","On-tenure track, assistant professors","6","2","4","0","0","0","2","1","1","1","0","1","0","0","0","0","0","0","1","0","1","0","0","0","2","1","1","0","0","0","-2"
"132471","Barry University","2017","Not on tenure track/No tenure system system total","296","127","169","1","0","1","19","10","9","30","4","26","45","25","20","0","0","0","166","77","89","3","1","2","24","8","16","8","2","6","-2"
"132471","Barry University","2017","Not on tenure/no tenure system, professors","69","42","27","0","0","0","6","5","1","4","1","3","7","4","3","0","0","0","50","30","20","1","1","0","1","1","0","0","0","0","-2"
"132471","Barry University","2017","Not on tenure/no tenure system, associate professors","97","40","57","1","0","1","5","3","2","7","0","7","15","5","10","0","0","0","59","28","31","1","0","1","7","3","4","2","1","1","-2"
"132471","Barry University","2017","Not on tenure/no tenure system, assistant professors","100","30","70","0","0","0","7","2","5","18","3","15","12","8","4","0","0","0","46","13","33","1","0","1","11","4","7","5","0","5","-2"
"132471","Barry University","2017","Not on tenure/no tenure system, instructors","30","15","15","0","0","0","1","0","1","1","0","1","11","8","3","0","0","0","11","6","5","0","0","0","5","0","5","1","1","0","-2"
"132709","Broward College","2017","Tenured total","301","138","163","5","0","5","17","13","4","50","16","34","62","33","29","0","0","0","159","71","88","0","0","0","8","5","3","0","0","0","-2"
"132709","Broward College","2017","Tenured, professors","57","31","26","2","0","2","5","3","2","5","2","3","10","6","4","0","0","0","34","19","15","0","0","0","1","1","0","0","0","0","-2"
"132709","Broward College","2017","Tenured, associate professors","31","13","18","1","0","1","1","1","0","7","2","5","7","3","4","0","0","0","13","6","7","0","0","0","2","1","1","0","0","0","-2"
"132709","Broward College","2017","Tenured, assistant professors","195","88","107","2","0","2","11","9","2","36","12","24","42","22","20","0","0","0","99","42","57","0","0","0","5","3","2","0","0","0","-2"
"132709","Broward College","2017","Tenured, instructors","18","6","12","0","0","0","0","0","0","2","0","2","3","2","1","0","0","0","13","4","9","0","0","0","0","0","0","0","0","0","-2"
"132709","Broward College","2017","On-Tenure track total","96","43","53","1","0","1","3","1","2","15","4","11","14","6","8","0","0","0","48","24","24","0","0","0","15","8","7","0","0","0","-2"
"132709","Broward College","2017","On-tenure track, assistant professors","86","37","49","1","0","1","3","1","2","15","4","11","9","3","6","0","0","0","43","21","22","0","0","0","15","8","7","0","0","0","-2"
"132709","Broward College","2017","On-tenure track, instructors","10","6","4","0","0","0","0","0","0","0","0","0","5","3","2","0","0","0","5","3","2","0","0","0","0","0","0","0","0","0","-2"
"132903","University of Central Florida","2017","Tenured total","608","413","195","2","2","0","111","89","22","26","17","9","35","20","15","0","0","0","425","280","145","1","0","1","0","0","0","8","5","3","-2"
"132903","University of Central Florida","2017","Tenured, professors","268","200","68","1","1","0","54","48","6","4","2","2","15","11","4","0","0","0","189","135","54","1","0","1","0","0","0","4","3","1","-2"
"132903","University of Central Florida","2017","Tenured, associate professors","337","210","127","1","1","0","57","41","16","22","15","7","20","9","11","0","0","0","233","142","91","0","0","0","0","0","0","4","2","2","-2"
"132903","University of Central Florida","2017","Tenured, assistant professors","3","3","0","0","0","0","0","0","0","0","0","0","0","0","0","0","0","0","3","3","0","0","0","0","0","0","0","0","0","0","-2"
"132903","University of Central Florida","2017","On-Tenure track total","282","153","129","0","0","0","42","25","17","13","3","10","26","17","9","0","0","0","158","80","78","3","1","2","0","0","0","40","27","13","-2"
"132903","University of Central Florida","2017","On-tenure track, associate professors","15","12","3","0","0","0","1","1","0","0","0","0","0","0","0","0","0","0","13","11","2","0","0","0","0","0","0","1","0","1","-2"
"132903","University of Central Florida","2017","On-tenure track, assistant professors","267","141","126","0","0","0","41","24","17","13","3","10","26","17","9","0","0","0","145","69","76","3","1","2","0","0","0","39","27","12","-2"
"132903","University of Central Florida","2017","Not on tenure track/No tenure system system total","546","239","307","1","1","0","30","13","17","21","8","13","47","18","29","0","0","0","432","192","240","6","2","4","0","0","0","9","5","4","-2"
"132903","University of Central Florida","2017","Not on tenure/no tenure system, professors","8","4","4","0","0","0","2","2","0","0","0","0","1","0","1","0","0","0","5","2","3","0","0","0","0","0","0","0","0","0","-2"
"132903","University of Central Florida","2017","Not on tenure/no tenure system, associate professors","19","9","10","0","0","0","2","1","1","0","0","0","4","1","3","0","0","0","12","6","6","0","0","0","0","0","0","1","1","0","-2"
"132903","University of Central Florida","2017","Not on tenure/no tenure system, assistant professors","48","22","26","0","0","0","9","2","7","1","1","0","1","1","0","0","0","0","33","16","17","0","0","0","0","0","0","4","2","2","-2"
"132903","University of Central Florida","2017","Not on tenure/no tenure system, instructors","216","82","134","0","0","0","4","2","2","7","3","4","20","6","14","0","0","0","182","71","111","3","0","3","0","0","0","0","0","0","-2"
"132903","University of Central Florida","2017","Not on tenure/no tenure system, lecturers","252","121","131","1","1","0","13","6","7","13","4","9","21","10","11","0","0","0","197","96","101","3","2","1","0","0","0","4","2","2","-2"
"132903","University of Central Florida","2017","Not on tenure/no tenure system, no academic rank","3","1","2","0","0","0","0","0","0","0","0","0","0","0","0","0","0","0","3","1","2","0","0","0","0","0","0","0","0","0","-2"
"133508","Florida SouthWestern State College","2017","Tenured total","111","51","60","1","0","1","3","2","1","6","3","3","3","2","1","0","0","0","95","42","53","0","0","0","1","1","0","2","1","1","-2"
"133508","Florida SouthWestern State College","2017","Tenured, no academic rank","111","51","60","1","0","1","3","2","1","6","3","3","3","2","1","0","0","0","95","42","53","0","0","0","1","1","0","2","1","1","-2"
"133508","Florida SouthWestern State College","2017","On-Tenure track total","60","26","34","1","1","0","3","2","1","2","0","2","3","2","1","0","0","0","49","19","30","0","0","0","0","0","0","2","2","0","-2"
"133508","Florida SouthWestern State College","2017","On-tenure track, no academic rank","60","26","34","1","1","0","3","2","1","2","0","2","3","2","1","0","0","0","49","19","30","0","0","0","0","0","0","2","2","0","-2"
"133508","Florida SouthWestern State College","2017","Not on tenure track/No tenure system system total","7","3","4","1","0","1","0","0","0","0","0","0","0","0","0","0","0","0","6","3","3","0","0","0","0","0","0","0","0","0","-2"
"133508","Florida SouthWestern State College","2017","Not on tenure/no tenure system, no academic rank","7","3","4","1","0","1","0","0","0","0","0","0","0","0","0","0","0","0","6","3","3","0","0","0","0","0","0","0","0","0","-2"
"133669","Florida Atlantic University","2017","Tenured total","415","266","149","0","0","0","72","59","13","25","9","16","26","14","12","0","0","0","287","181","106","1","0","1","0","0","0","4","3","1","-2"
"133669","Florida Atlantic University","2017","Tenured, professors","218","158","60","0","0","0","41","38","3","10","5","5","10","5","5","0","0","0","156","109","47","0","0","0","0","0","0","1","1","0","-2"
"133669","Florida Atlantic University","2017","Tenured, associate professors","197","108","89","0","0","0","31","21","10","15","4","11","16","9","7","0","0","0","131","72","59","1","0","1","0","0","0","3","2","1","-2"
"133669","Florida Atlantic University","2017","On-Tenure track total","164","86","78","0","0","0","14","13","1","7","3","4","11","7","4","0","0","0","105","43","62","1","0","1","0","0","0","26","20","6","-2"
"133669","Florida Atlantic University","2017","On-tenure track, associate professors","15","5","10","0","0","0","2","1","1","1","0","1","2","0","2","0","0","0","9","4","5","1","0","1","0","0","0","0","0","0","-2"
"133669","Florida Atlantic University","2017","On-tenure track, assistant professors","149","81","68","0","0","0","12","12","0","6","3","3","9","7","2","0","0","0","96","39","57","0","0","0","0","0","0","26","20","6","-2"
"133669","Florida Atlantic University","2017","Not on tenure track/No tenure system system total","245","106","139","0","0","0","17","5","12","23","10","13","27","8","19","0","0","0","165","76","89","1","1","0","0","0","0","12","6","6","-2"
"133669","Florida Atlantic University","2017","Not on tenure/no tenure system, professors","3","3","0","0","0","0","1","1","0","0","0","0","0","0","0","0","0","0","2","2","0","0","0","0","0","0","0","0","0","0","-2"
"133669","Florida Atlantic University","2017","Not on tenure/no tenure system, associate professors","10","9","1","0","0","0","2","2","0","0","0","0","1","1","0","0","0","0","7","6","1","0","0","0","0","0","0","0","0","0","-2"
"133669","Florida Atlantic University","2017","Not on tenure/no tenure system, assistant professors","26","11","15","0","0","0","2","0","2","4","1","3","3","2","1","0","0","0","15","7","8","0","0","0","0","0","0","2","1","1","-2"
"133669","Florida Atlantic University","2017","Not on tenure/no tenure system, instructors","193","80","113","0","0","0","11","2","9","19","9","10","22","5","17","0","0","0","134","60","74","1","1","0","0","0","0","6","3","3","-2"
"133669","Florida Atlantic University","2017","Not on tenure/no tenure system, lecturers","3","0","3","0","0","0","0","0","0","0","0","0","0","0","0","0","0","0","3","0","3","0","0","0","0","0","0","0","0","0","-2"
"133669","Florida Atlantic University","2017","Not on tenure/no tenure system, no academic rank","10","3","7","0","0","0","1","0","1","0","0","0","1","0","1","0","0","0","4","1","3","0","0","0","0","0","0","4","2","2","-2"
"133872","AdventHealth University","2017","Not on tenure track/No tenure system system total","89","27","62","0","0","0","4","0","4","17","5","12","9","4","5","0","0","0","58","18","40","1","0","1","0","0","0","0","0","0","-2"
"133872","AdventHealth University","2017","Not on tenure/no tenure system, professors","13","6","7","0","0","0","0","0","0","3","0","3","2","2","0","0","0","0","8","4","4","0","0","0","0","0","0","0","0","0","-2"
"133872","AdventHealth University","2017","Not on tenure/no tenure system, associate professors","21","5","16","0","0","0","2","0","2","5","2","3","2","0","2","0","0","0","11","3","8","1","0","1","0","0","0","0","0","0","-2"
"133872","AdventHealth University","2017","Not on tenure/no tenure system, assistant professors","39","12","27","0","0","0","1","0","1","8","3","5","4","2","2","0","0","0","26","7","19","0","0","0","0","0","0","0","0","0","-2"
"133872","AdventHealth University","2017","Not on tenure/no tenure system, instructors","16","4","12","0","0","0","1","0","1","1","0","1","1","0","1","0","0","0","13","4","9","0","0","0","0","0","0","0","0","0","-2"
"133960","The College of the Florida Keys","2017","Tenured total","8","3","5","0","0","0","0","0","0","0","0","0","1","0","1","0","0","0","6","3","3","0","0","0","1","0","1","0","0","0","-2"
"133960","The College of the Florida Keys","2017","Tenured, professors","2","1","1","0","0","0","0","0","0","0","0","0","0","0","0","0","0","0","1","1","0","0","0","0","1","0","1","0","0","0","-2"
"133960","The College of the Florida Keys","2017","Tenured, associate professors","3","1","2","0","0","0","0","0","0","0","0","0","1","0","1","0","0","0","2","1","1","0","0","0","0","0","0","0","0","0","-2"
"133960","The College of the Florida Keys","2017","Tenured, assistant professors","3","1","2","0","0","0","0","0","0","0","0","0","0","0","0","0","0","0","3","1","2","0","0","0","0","0","0","0","0","0","-2"
"133960","The College of the Florida Keys","2017","On-Tenure track total","20","11","9","0","0","0","0","0","0","1","1","0","1","1","0","0","0","0","15","6","9","0","0","0","2","2","0","1","1","0","-2"
"133960","The College of the Florida Keys","2017","On-tenure track, professors","3","1","2","0","0","0","0","0","0","0","0","0","0","0","0","0","0","0","3","1","2","0","0","0","0","0","0","0","0","0","-2"
"133960","The College of the Florida Keys","2017","On-tenure track, associate professors","4","2","2","0","0","0","0","0","0","0","0","0","1","1","0","0","0","0","3","1","2","0","0","0","0","0","0","0","0","0","-2"
"133960","The College of the Florida Keys","2017","On-tenure track, assistant professors","6","3","3","0","0","0","0","0","0","0","0","0","0","0","0","0","0","0","4","1","3","0","0","0","1","1","0","1","1","0","-2"
"133960","The College of the Florida Keys","2017","On-tenure track, instructors","7","5","2","0","0","0","0","0","0","1","1","0","0","0","0","0","0","0","5","3","2","0","0","0","1","1","0","0","0","0","-2"
"134608","Indian River State College","2017","Tenured total","147","70","77","2","0","2","5","3","2","17","8","9","7","2","5","1","0","1","115","57","58","0","0","0","0","0","0","0","0","0","-2"
"134608","Indian River State College","2017","Tenured, professors","35","15","20","1","0","1","2","1","1","6","3","3","1","1","0","0","0","0","25","10","15","0","0","0","0","0","0","0","0","0","-2"
"134608","Indian River State College","2017","Tenured, associate professors","47","28","19","0","0","0","3","2","1","7","4","3","3","1","2","1","0","1","33","21","12","0","0","0","0","0","0","0","0","0","-2"
"134608","Indian River State College","2017","Tenured, assistant professors","58","25","33","1","0","1","0","0","0","3","1","2","3","0","3","0","0","0","51","24","27","0","0","0","0","0","0","0","0","0","-2"
"134608","Indian River State College","2017","Tenured, instructors","7","2","5","0","0","0","0","0","0","1","0","1","0","0","0","0","0","0","6","2","4","0","0","0","0","0","0","0","0","0","-2"
"134608","Indian River State College","2017","On-Tenure track total","63","30","33","1","1","0","4","2","2","6","2","4","3","1","2","1","0","1","48","24","24","0","0","0","0","0","0","0","0","0","-2"
"134608","Indian River State College","2017","On-tenure track, associate professors","1","0","1","0","0","0","0","0","0","0","0","0","0","0","0","0","0","0","1","0","1","0","0","0","0","0","0","0","0","0","-2"
"134608","Indian River State College","2017","On-tenure track, assistant professors","38","19","19","1","1","0","3","2","1","6","2","4","2","1","1","0","0","0","26","13","13","0","0","0","0","0","0","0","0","0","-2"
"134608","Indian River State College","2017","On-tenure track, instructors","24","11","13","0","0","0","1","0","1","0","0","0","1","0","1","1","0","1","21","11","10","0","0","0","0","0","0","0","0","0","-2"
"134608","Indian River State College","2017","Not on tenure track/No tenure system system total","38","13","25","0","0","0","1","1","0","3","1","2","3","1","2","0","0","0","31","10","21","0","0","0","0","0","0","0","0","0","-2"
"134608","Indian River State College","2017","Not on tenure/no tenure system, professors","1","0","1","0","0","0","0","0","0","0","0","0","0","0","0","0","0","0","1","0","1","0","0","0","0","0","0","0","0","0","-2"
"134608","Indian River State College","2017","Not on tenure/no tenure system, associate professors","1","0","1","0","0","0","0","0","0","0","0","0","0","0","0","0","0","0","1","0","1","0","0","0","0","0","0","0","0","0","-2"
"134608","Indian River State College","2017","Not on tenure/no tenure system, assistant professors","12","4","8","0","0","0","0","0","0","2","0","2","0","0","0","0","0","0","10","4","6","0","0","0","0","0","0","0","0","0","-2"
"134608","Indian River State College","2017","Not on tenure/no tenure system, instructors","8","4","4","0","0","0","1","1","0","0","0","0","2","0","2","0","0","0","5","3","2","0","0","0","0","0","0","0","0","0","-2"
"134608","Indian River State College","2017","Not on tenure/no tenure system, no academic rank","16","5","11","0","0","0","0","0","0","1","1","0","1","1","0","0","0","0","14","3","11","0","0","0","0","0","0","0","0","0","-2"
"135081","Keiser University-Ft Lauderdale","2017","Not on tenure track/No tenure system system total","1130","446","684","4","2","2","52","23","29","136","52","84","169","74","95","1","0","1","745","286","459","23","9","14","0","0","0","0","0","0","-2"
"135081","Keiser University-Ft Lauderdale","2017","Not on tenure/no tenure system, instructors","1130","446","684","4","2","2","52","23","29","136","52","84","169","74","95","1","0","1","745","286","459","23","9","14","0","0","0","0","0","0","-2"
"135610","Trinity International University-Florida","2017","Tenured total","2","0","2","0","0","0","0","0","0","0","0","0","0","0","0","0","0","0","2","0","2","0","0","0","0","0","0","0","0","0","-2"
"135610","Trinity International University-Florida","2017","Tenured, associate professors","2","0","2","0","0","0","0","0","0","0","0","0","0","0","0","0","0","0","2","0","2","0","0","0","0","0","0","0","0","0","-2"
"135717","Miami Dade College","2017","Tenured total","524","259","265","2","0","2","24","11","13","69","28","41","235","118","117","0","0","0","187","99","88","5","1","4","2","2","0","0","0","0","-2"
"135717","Miami Dade College","2017","Tenured, professors","170","85","85","0","0","0","10","4","6","17","9","8","77","36","41","0","0","0","62","34","28","3","1","2","1","1","0","0","0","0","-2"
"135717","Miami Dade College","2017","Tenured, associate professors","258","122","136","0","0","0","10","5","5","37","14","23","117","52","65","0","0","0","92","50","42","1","0","1","1","1","0","0","0","0","-2"
"135717","Miami Dade College","2017","Tenured, assistant professors","84","43","41","1","0","1","4","2","2","15","5","10","33","24","9","0","0","0","30","12","18","1","0","1","0","0","0","0","0","0","-2"
"135717","Miami Dade College","2017","Tenured, instructors","12","9","3","1","0","1","0","0","0","0","0","0","8","6","2","0","0","0","3","3","0","0","0","0","0","0","0","0","0","0","-2"
"135717","Miami Dade College","2017","On-Tenure track total","211","94","117","1","1","0","9","3","6","52","15","37","96","51","45","0","0","0","49","24","25","3","0","3","0","0","0","1","0","1","-2"
"135717","Miami Dade College","2017","On-tenure track, professors","12","7","5","1","1","0","2","2","0","0","0","0","1","0","1","0","0","0","8","4","4","0","0","0","0","0","0","0","0","0","-2"
"135717","Miami Dade College","2017","On-tenure track, associate professors","13","5","8","0","0","0","1","0","1","2","1","1","8","2","6","0","0","0","2","2","0","0","0","0","0","0","0","0","0","0","-2"
"135717","Miami Dade College","2017","On-tenure track, assistant professors","69","32","37","0","0","0","3","0","3","14","7","7","38","19","19","0","0","0","11","6","5","2","0","2","0","0","0","1","0","1","-2"
"135717","Miami Dade College","2017","On-tenure track, instructors","117","50","67","0","0","0","3","1","2","36","7","29","49","30","19","0","0","0","28","12","16","1","0","1","0","0","0","0","0","0","-2"
"136215","Nova Southeastern University","2017","Tenured total","25","17","8","0","0","0","1","1","0","1","1","0","1","1","0","0","0","0","21","14","7","0","0","0","0","0","0","1","0","1","-2"
"136215","Nova Southeastern University","2017","Tenured, professors","25","17","8","0","0","0","1","1","0","1","1","0","1","1","0","0","0","0","21","14","7","0","0","0","0","0","0","1","0","1","-2"
"136215","Nova Southeastern University","2017","Not on tenure track/No tenure system system total","768","355","413","1","0","1","38","21","17","53","16","37","94","37","57","3","2","1","463","224","239","3","2","1","2","0","2","111","53","58","-2"
"136215","Nova Southeastern University","2017","Not on tenure/no tenure system, professors","154","99","55","0","0","0","12","10","2","5","3","2","12","8","4","2","1","1","111","66","45","0","0","0","0","0","0","12","11","1","-2"
"136215","Nova Southeastern University","2017","Not on tenure/no tenure system, associate professors","265","121","144","0","0","0","11","5","6","22","5","17","28","10","18","1","1","0","157","76","81","0","0","0","2","0","2","44","24","20","-2"
"136215","Nova Southeastern University","2017","Not on tenure/no tenure system, assistant professors","303","116","187","1","0","1","10","3","7","22","7","15","49","16","33","0","0","0","173","77","96","1","0","1","0","0","0","47","13","34","-2"
"136215","Nova Southeastern University","2017","Not on tenure/no tenure system, instructors","30","7","23","0","0","0","3","1","2","3","0","3","4","2","2","0","0","0","16","2","14","1","1","0","0","0","0","3","1","2","-2"
"136215","Nova Southeastern University","2017","Not on tenure/no tenure system, lecturers","4","2","2","0","0","0","0","0","0","0","0","0","0","0","0","0","0","0","4","2","2","0","0","0","0","0","0","0","0","0","-2"
"136215","Nova Southeastern University","2017","Not on tenure/no tenure system, no academic rank","12","10","2","0","0","0","2","2","0","1","1","0","1","1","0","0","0","0","2","1","1","1","1","0","0","0","0","5","4","1","-2"
"136358","Palm Beach State College","2017","Tenured total","170","72","98","0","0","0","7","6","1","22","11","11","20","5","15","0","0","0","112","46","66","1","1","0","8","3","5","0","0","0","-2"
"136358","Palm Beach State College","2017","Tenured, professors","40","20","20","0","0","0","4","3","1","4","3","1","6","2","4","0","0","0","25","12","13","0","0","0","1","0","1","0","0","0","-2"
"136358","Palm Beach State College","2017","Tenured, associate professors","22","7","15","0","0","0","0","0","0","4","2","2","4","0","4","0","0","0","14","5","9","0","0","0","0","0","0","0","0","0","-2"
"136358","Palm Beach State College","2017","Tenured, assistant professors","23","7","16","0","0","0","1","1","0","3","1","2","2","0","2","0","0","0","14","4","10","0","0","0","3","1","2","0","0","0","-2"
"136358","Palm Beach State College","2017","Tenured, instructors","85","38","47","0","0","0","2","2","0","11","5","6","8","3","5","0","0","0","59","25","34","1","1","0","4","2","2","0","0","0","-2"
"136358","Palm Beach State College","2017","On-Tenure track total","132","53","79","2","0","2","7","2","5","17","5","12","10","3","7","0","0","0","90","40","50","1","0","1","4","3","1","1","0","1","-2"
"136358","Palm Beach State College","2017","On-tenure track, professors","6","0","6","0","0","0","1","0","1","0","0","0","0","0","0","0","0","0","5","0","5","0","0","0","0","0","0","0","0","0","-2"
"136358","Palm Beach State College","2017","On-tenure track, associate professors","22","12","10","0","0","0","3","2","1","3","1","2","3","1","2","0","0","0","13","8","5","0","0","0","0","0","0","0","0","0","-2"
"136358","Palm Beach State College","2017","On-tenure track, assistant professors","42","13","29","1","0","1","3","0","3","9","2","7","2","0","2","0","0","0","26","11","15","1","0","1","0","0","0","0","0","0","-2"
"136358","Palm Beach State College","2017","On-tenure track, instructors","62","28","34","1","0","1","0","0","0","5","2","3","5","2","3","0","0","0","46","21","25","0","0","0","4","3","1","1","0","1","-2"
"136358","Palm Beach State College","2017","Not on tenure track/No tenure system system total","21","9","12","0","0","0","2","1","1","5","2","3","1","1","0","0","0","0","13","5","8","0","0","0","0","0","0","0","0","0","-2"
"136358","Palm Beach State College","2017","Not on tenure/no tenure system, associate professors","1","0","1","0","0","0","0","0","0","0","0","0","0","0","0","0","0","0","1","0","1","0","0","0","0","0","0","0","0","0","-2"
"136358","Palm Beach State College","2017","Not on tenure/no tenure system, assistant professors","5","0","5","0","0","0","1","0","1","2","0","2","0","0","0","0","0","0","2","0","2","0","0","0","0","0","0","0","0","0","-2"
"136358","Palm Beach State College","2017","Not on tenure/no tenure system, instructors","4","2","2","0","0","0","1","1","0","1","0","1","0","0","0","0","0","0","2","1","1","0","0","0","0","0","0","0","0","0","-2"
"136358","Palm Beach State College","2017","Not on tenure/no tenure system, no academic rank","11","7","4","0","0","0","0","0","0","2","2","0","1","1","0","0","0","0","8","4","4","0","0","0","0","0","0","0","0","0","-2"
"136516","Polk State College","2017","Tenured total","111","49","62","1","0","1","1","1","0","8","4","4","5","2","3","0","0","0","95","41","54","0","0","0","0","0","0","1","1","0","-2"
"136516","Polk State College","2017","Tenured, no academic rank","111","49","62","1","0","1","1","1","0","8","4","4","5","2","3","0","0","0","95","41","54","0","0","0","0","0","0","1","1","0","-2"
"136516","Polk State College","2017","On-Tenure track total","50","25","25","0","0","0","1","1","0","3","2","1","2","1","1","0","0","0","43","20","23","0","0","0","1","1","0","0","0","0","-2"
"136516","Polk State College","2017","On-tenure track, no academic rank","50","25","25","0","0","0","1","1","0","3","2","1","2","1","1","0","0","0","43","20","23","0","0","0","1","1","0","0","0","0","-2"
"137209","Seminole State College of Florida","2017","Tenured total","147","55","92","0","0","0","6","4","2","8","3","5","12","4","8","1","1","0","118","42","76","2","1","1","0","0","0","0","0","0","-2"
"137209","Seminole State College of Florida","2017","Tenured, no academic rank","147","55","92","0","0","0","6","4","2","8","3","5","12","4","8","1","1","0","118","42","76","2","1","1","0","0","0","0","0","0","-2"
"137209","Seminole State College of Florida","2017","On-Tenure track total","62","24","38","0","0","0","2","1","1","7","2","5","6","3","3","0","0","0","47","18","29","0","0","0","0","0","0","0","0","0","-2"
"137209","Seminole State College of Florida","2017","On-tenure track, no academic rank","62","24","38","0","0","0","2","1","1","7","2","5","6","3","3","0","0","0","47","18","29","0","0","0","0","0","0","0","0","0","-2"
"137315","South Florida State College","2017","Tenured total","46","18","28","0","0","0","1","0","1","3","0","3","0","0","0","0","0","0","42","18","24","0","0","0","0","0","0","0","0","0","-2"
"137315","South Florida State College","2017","Tenured, instructors","46","18","28","0","0","0","1","0","1","3","0","3","0","0","0","0","0","0","42","18","24","0","0","0","0","0","0","0","0","0","-2"
"137315","South Florida State College","2017","On-Tenure track total","14","4","10","0","0","0","0","0","0","0","0","0","2","0","2","0","0","0","12","4","8","0","0","0","0","0","0","0","0","0","-2"
"137315","South Florida State College","2017","On-tenure track, instructors","14","4","10","0","0","0","0","0","0","0","0","0","2","0","2","0","0","0","12","4","8","0","0","0","0","0","0","0","0","0","-2"
"137476","St. Thomas University","2017","Tenured total","23","15","8","0","0","0","1","1","0","1","1","0","1","1","0","0","0","0","20","12","8","0","0","0","0","0","0","0","0","0","-2"
"137476","St. Thomas University","2017","Tenured, professors","23","15","8","0","0","0","1","1","0","1","1","0","1","1","0","0","0","0","20","12","8","0","0","0","0","0","0","0","0","0","-2"
"137476","St. Thomas University","2017","On-Tenure track total","2","2","0","0","0","0","0","0","0","1","1","0","0","0","0","0","0","0","1","1","0","0","0","0","0","0","0","0","0","0","-2"
"137476","St. Thomas University","2017","On-tenure track, associate professors","2","2","0","0","0","0","0","0","0","1","1","0","0","0","0","0","0","0","1","1","0","0","0","0","0","0","0","0","0","0","-2"
"137476","St. Thomas University","2017","Not on tenure track/No tenure system system total","70","39","31","0","0","0","4","2","2","8","5","3","14","7","7","0","0","0","44","25","19","0","0","0","0","0","0","0","0","0","-2"
"137476","St. Thomas University","2017","Not on tenure/no tenure system, professors","24","17","7","0","0","0","1","1","0","0","0","0","5","2","3","0","0","0","18","14","4","0","0","0","0","0","0","0","0","0","-2"
"137476","St. Thomas University","2017","Not on tenure/no tenure system, associate professors","27","12","15","0","0","0","2","1","1","5","2","3","4","3","1","0","0","0","16","6","10","0","0","0","0","0","0","0","0","0","-2"
"137476","St. Thomas University","2017","Not on tenure/no tenure system, assistant professors","17","8","9","0","0","0","1","0","1","2","2","0","4","1","3","0","0","0","10","5","5","0","0","0","0","0","0","0","0","0","-2"
"137476","St. Thomas University","2017","Not on tenure/no tenure system, instructors","1","1","0","0","0","0","0","0","0","1","1","0","0","0","0","0","0","0","0","0","0","0","0","0","0","0","0","0","0","0","-2"
"137476","St. Thomas University","2017","Not on tenure/no tenure system, lecturers","1","1","0","0","0","0","0","0","0","0","0","0","1","1","0","0","0","0","0","0","0","0","0","0","0","0","0","0","0","0","-2"
"138187","Valencia College","2017","Tenured total","285","125","160","3","1","2","15","6","9","23","13","10","28","10","18","0","0","0","213","93","120","0","0","0","3","2","1","0","0","0","-2"
"138187","Valencia College","2017","Tenured, no academic rank","285","125","160","3","1","2","15","6","9","23","13","10","28","10","18","0","0","0","213","93","120","0","0","0","3","2","1","0","0","0","-2"
"138187","Valencia College","2017","On-Tenure track total","158","59","99","1","1","0","9","4","5","19","5","14","14","8","6","0","0","0","107","39","68","0","0","0","8","2","6","0","0","0","-2"
"138187","Valencia College","2017","On-tenure track, no academic rank","158","59","99","1","1","0","9","4","5","19","5","14","14","8","6","0","0","0","107","39","68","0","0","0","8","2","6","0","0","0","-2"
"138187","Valencia College","2017","Not on tenure track/No tenure system system total","142","60","82","0","0","0","8","2","6","20","7","13","13","7","6","0","0","0","96","42","54","0","0","0","5","2","3","0","0","0","-2"
"138187","Valencia College","2017","Not on tenure/no tenure system, no academic rank","142","60","82","0","0","0","8","2","6","20","7","13","13","7","6","0","0","0","96","42","54","0","0","0","5","2","3","0","0","0","-2"
"139463","Dalton State College","2017","Tenured total","88","43","45","0","0","0","2","2","0","3","2","1","0","0","0","0","0","0","80","37","43","1","1","0","1","1","0","1","0","1","-2"
"139463","Dalton State College","2017","Tenured, professors","24","14","10","0","0","0","1","1","0","0","0","0","0","0","0","0","0","0","23","13","10","0","0","0","0","0","0","0","0","0","-2"
"139463","Dalton State College","2017","Tenured, associate professors","61","28","33","0","0","0","1","1","0","3","2","1","0","0","0","0","0","0","54","23","31","1","1","0","1","1","0","1","0","1","-2"
"139463","Dalton State College","2017","Tenured, assistant professors","3","1","2","0","0","0","0","0","0","0","0","0","0","0","0","0","0","0","3","1","2","0","0","0","0","0","0","0","0","0","-2"
"139463","Dalton State College","2017","On-Tenure track total","46","16","30","0","0","0","2","1","1","3","0","3","1","1","0","0","0","0","38","12","26","0","0","0","0","0","0","2","2","0","-2"
"139463","Dalton State College","2017","On-tenure track, professors","1","0","1","0","0","0","0","0","0","0","0","0","0","0","0","0","0","0","1","0","1","0","0","0","0","0","0","0","0","0","-2"
"139463","Dalton State College","2017","On-tenure track, associate professors","8","2","6","0","0","0","1","0","1","0","0","0","0","0","0","0","0","0","7","2","5","0","0","0","0","0","0","0","0","0","-2"
"139463","Dalton State College","2017","On-tenure track, assistant professors","37","14","23","0","0","0","1","1","0","3","0","3","1","1","0","0","0","0","30","10","20","0","0","0","0","0","0","2","2","0","-2"
"139463","Dalton State College","2017","Not on tenure track/No tenure system system total","26","9","17","0","0","0","2","1","1","0","0","0","1","0","1","0","0","0","23","8","15","0","0","0","0","0","0","0","0","0","-2"
"139463","Dalton State College","2017","Not on tenure/no tenure system, instructors","8","1","7","0","0","0","0","0","0","0","0","0","1","0","1","0","0","0","7","1","6","0","0","0","0","0","0","0","0","0","-2"
"139463","Dalton State College","2017","Not on tenure/no tenure system, lecturers","17","7","10","0","0","0","2","1","1","0","0","0","0","0","0","0","0","0","15","6","9","0","0","0","0","0","0","0","0","0","-2"
"139463","Dalton State College","2017","Not on tenure/no tenure system, no academic rank","1","1","0","0","0","0","0","0","0","0","0","0","0","0","0","0","0","0","1","1","0","0","0","0","0","0","0","0","0","0","-2"
"142887","American Academy of Art","2017","Not on tenure track/No tenure system system total","22","13","9","0","0","0","1","1","0","1","0","1","0","0","0","0","0","0","20","12","8","0","0","0","0","0","0","0","0","0","-2"
"142887","American Academy of Art","2017","Not on tenure/no tenure system, instructors","22","13","9","0","0","0","1","1","0","1","0","1","0","0","0","0","0","0","20","12","8","0","0","0","0","0","0","0","0","0","-2"
"143118","Aurora University","2017","Tenured total","52","22","30","0","0","0","1","0","1","0","0","0","2","0","2","0","0","0","49","22","27","0","0","0","0","0","0","0","0","0","-2"
"143118","Aurora University","2017","Tenured, professors","19","11","8","0","0","0","1","0","1","0","0","0","0","0","0","0","0","0","18","11","7","0","0","0","0","0","0","0","0","0","-2"
"143118","Aurora University","2017","Tenured, associate professors","33","11","22","0","0","0","0","0","0","0","0","0","2","0","2","0","0","0","31","11","20","0","0","0","0","0","0","0","0","0","-2"
"143118","Aurora University","2017","On-Tenure track total","29","18","11","0","0","0","2","2","0","1","1","0","1","0","1","0","0","0","24","14","10","0","0","0","1","1","0","0","0","0","-2"
"143118","Aurora University","2017","On-tenure track, assistant professors","29","18","11","0","0","0","2","2","0","1","1","0","1","0","1","0","0","0","24","14","10","0","0","0","1","1","0","0","0","0","-2"
"143118","Aurora University","2017","Not on tenure track/No tenure system system total","58","26","32","0","0","0","2","1","1","4","3","1","2","1","1","0","0","0","49","20","29","0","0","0","1","1","0","0","0","0","-2"
"143118","Aurora University","2017","Not on tenure/no tenure system, professors","3","2","1","0","0","0","0","0","0","0","0","0","0","0","0","0","0","0","3","2","1","0","0","0","0","0","0","0","0","0","-2"
"143118","Aurora University","2017","Not on tenure/no tenure system, associate professors","8","6","2","0","0","0","0","0","0","0","0","0","1","1","0","0","0","0","7","5","2","0","0","0","0","0","0","0","0","0","-2"
"143118","Aurora University","2017","Not on tenure/no tenure system, assistant professors","47","18","29","0","0","0","2","1","1","4","3","1","1","0","1","0","0","0","39","13","26","0","0","0","1","1","0","0","0","0","-2"
"143978","The Chicago School of Professional Psychology at Chicago","2017","Not on tenure track/No tenure system system total","100","37","63","1","0","1","5","1","4","13","4","9","7","3","4","0","0","0","66","26","40","3","0","3","5","3","2","0","0","0","-2"
"143978","The Chicago School of Professional Psychology at Chicago","2017","Not on tenure/no tenure system, professors","17","9","8","1","0","1","0","0","0","0","0","0","0","0","0","0","0","0","14","7","7","0","0","0","2","2","0","0","0","0","-2"
"143978","The Chicago School of Professional Psychology at Chicago","2017","Not on tenure/no tenure system, associate professors","48","15","33","0","0","0","3","1","2","7","1","6","5","1","4","0","0","0","29","11","18","1","0","1","3","1","2","0","0","0","-2"
"143978","The Chicago School of Professional Psychology at Chicago","2017","Not on tenure/no tenure system, assistant professors","35","13","22","0","0","0","2","0","2","6","3","3","2","2","0","0","0","0","23","8","15","2","0","2","0","0","0","0","0","0","-2"
"144351","Concordia University-Chicago","2017","Tenured total","55","24","31","0","0","0","2","1","1","2","0","2","0","0","0","0","0","0","51","23","28","0","0","0","0","0","0","0","0","0","-2"
"144351","Concordia University-Chicago","2017","Tenured, professors","44","18","26","0","0","0","1","0","1","2","0","2","0","0","0","0","0","0","41","18","23","0","0","0","0","0","0","0","0","0","-2"
"144351","Concordia University-Chicago","2017","Tenured, associate professors","11","6","5","0","0","0","1","1","0","0","0","0","0","0","0","0","0","0","10","5","5","0","0","0","0","0","0","0","0","0","-2"
"144351","Concordia University-Chicago","2017","On-Tenure track total","83","43","40","0","0","0","3","2","1","2","1","1","2","2","0","0","0","0","66","30","36","2","2","0","3","1","2","5","5","0","-2"
"144351","Concordia University-Chicago","2017","On-tenure track, professors","6","5","1","0","0","0","0","0","0","0","0","0","0","0","0","0","0","0","5","4","1","0","0","0","0","0","0","1","1","0","-2"
"144351","Concordia University-Chicago","2017","On-tenure track, associate professors","33","16","17","0","0","0","2","1","1","1","1","0","1","1","0","0","0","0","26","10","16","0","0","0","1","1","0","2","2","0","-2"
"144351","Concordia University-Chicago","2017","On-tenure track, assistant professors","44","22","22","0","0","0","1","1","0","1","0","1","1","1","0","0","0","0","35","16","19","2","2","0","2","0","2","2","2","0","-2"
"144351","Concordia University-Chicago","2017","Not on tenure track/No tenure system system total","162","68","94","1","0","1","4","1","3","19","7","12","4","2","2","0","0","0","121","50","71","0","0","0","13","8","5","0","0","0","-2"
"144351","Concordia University-Chicago","2017","Not on tenure/no tenure system, professors","1","1","0","0","0","0","0","0","0","0","0","0","0","0","0","0","0","0","1","1","0","0","0","0","0","0","0","0","0","0","-2"
"144351","Concordia University-Chicago","2017","Not on tenure/no tenure system, associate professors","3","2","1","0","0","0","0","0","0","1","1","0","1","0","1","0","0","0","1","1","0","0","0","0","0","0","0","0","0","0","-2"
"144351","Concordia University-Chicago","2017","Not on tenure/no tenure system, assistant professors","12","3","9","0","0","0","0","0","0","1","0","1","1","1","0","0","0","0","9","1","8","0","0","0","1","1","0","0","0","0","-2"
"144351","Concordia University-Chicago","2017","Not on tenure/no tenure system, instructors","146","62","84","1","0","1","4","1","3","17","6","11","2","1","1","0","0","0","110","47","63","0","0","0","12","7","5","0","0","0","-2"
"145600","University of Illinois Chicago","2017","Tenured total","863","532","331","1","0","1","166","111","55","33","16","17","63","29","34","1","0","1","570","357","213","6","2","4","19","13","6","4","4","0","-2"
"145600","University of Illinois Chicago","2017","Tenured, professors","455","310","145","0","0","0","73","56","17","14","7","7","22","12","10","0","0","0","335","227","108","2","1","1","7","5","2","2","2","0","-2"
"145600","University of Illinois Chicago","2017","Tenured, associate professors","392","211","181","1","0","1","89","51","38","18","9","9","39","16","23","1","0","1","227","125","102","4","1","3","11","7","4","2","2","0","-2"
"145600","University of Illinois Chicago","2017","Tenured, assistant professors","15","10","5","0","0","0","3","3","0","1","0","1","2","1","1","0","0","0","8","5","3","0","0","0","1","1","0","0","0","0","-2"
"145600","University of Illinois Chicago","2017","Tenured, no academic rank","1","1","0","0","0","0","1","1","0","0","0","0","0","0","0","0","0","0","0","0","0","0","0","0","0","0","0","0","0","0","-2"
"145600","University of Illinois Chicago","2017","On-Tenure track total","385","214","171","0","0","0","86","53","33","30","16","14","32","14","18","0","0","0","184","102","82","7","3","4","8","2","6","38","24","14","-2"
"145600","University of Illinois Chicago","2017","On-tenure track, professors","11","9","2","0","0","0","3","2","1","0","0","0","0","0","0","0","0","0","7","6","1","1","1","0","0","0","0","0","0","0","-2"
"145600","University of Illinois Chicago","2017","On-tenure track, associate professors","45","22","23","0","0","0","9","6","3","4","2","2","4","2","2","0","0","0","24","11","13","1","0","1","2","0","2","1","1","0","-2"
"145600","University of Illinois Chicago","2017","On-tenure track, assistant professors","329","183","146","0","0","0","74","45","29","26","14","12","28","12","16","0","0","0","153","85","68","5","2","3","6","2","4","37","23","14","-2"
"145600","University of Illinois Chicago","2017","Not on tenure track/No tenure system system total","805","339","466","0","0","0","136","47","89","40","15","25","45","22","23","0","0","0","524","229","295","9","1","8","14","7","7","37","18","19","-2"
"145600","University of Illinois Chicago","2017","Not on tenure/no tenure system, professors","41","24","17","0","0","0","7","5","2","1","1","0","0","0","0","0","0","0","32","18","14","0","0","0","1","0","1","0","0","0","-2"
"145600","University of Illinois Chicago","2017","Not on tenure/no tenure system, associate professors","93","36","57","0","0","0","14","4","10","3","1","2","5","3","2","0","0","0","68","28","40","1","0","1","2","0","2","0","0","0","-2"
"145600","University of Illinois Chicago","2017","Not on tenure/no tenure system, assistant professors","381","157","224","0","0","0","66","18","48","24","10","14","20","8","12","0","0","0","235","104","131","3","0","3","9","6","3","24","11","13","-2"
"145600","University of Illinois Chicago","2017","Not on tenure/no tenure system, instructors","126","43","83","0","0","0","40","18","22","6","1","5","4","3","1","0","0","0","65","16","49","1","0","1","1","0","1","9","5","4","-2"
"145600","University of Illinois Chicago","2017","Not on tenure/no tenure system, lecturers","151","75","76","0","0","0","9","2","7","5","1","4","14","6","8","0","0","0","115","62","53","3","1","2","1","1","0","4","2","2","-2"
"145600","University of Illinois Chicago","2017","Not on tenure/no tenure system, no academic rank","13","4","9","0","0","0","0","0","0","1","1","0","2","2","0","0","0","0","9","1","8","1","0","1","0","0","0","0","0","0","-2"
"147536","National Louis University","2017","Tenured total","54","23","31","0","0","0","5","1","4","4","4","0","1","1","0","0","0","0","43","16","27","1","1","0","0","0","0","0","0","0","-2"
"147536","National Louis University","2017","Tenured, professors","13","4","9","0","0","0","0","0","0","0","0","0","0","0","0","0","0","0","13","4","9","0","0","0","0","0","0","0","0","0","-2"
"147536","National Louis University","2017","Tenured, associate professors","35","14","21","0","0","0","5","1","4","3","3","0","1","1","0","0","0","0","26","9","17","0","0","0","0","0","0","0","0","0","-2"
"147536","National Louis University","2017","Tenured, assistant professors","6","5","1","0","0","0","0","0","0","1","1","0","0","0","0","0","0","0","4","3","1","1","1","0","0","0","0","0","0","0","-2"
"147536","National Louis University","2017","On-Tenure track total","11","2","9","0","0","0","2","0","2","2","1","1","1","0","1","0","0","0","4","1","3","0","0","0","0","0","0","2","0","2","-2"
"147536","National Louis University","2017","On-tenure track, associate professors","2","0","2","0","0","0","1","0","1","1","0","1","0","0","0","0","0","0","0","0","0","0","0","0","0","0","0","0","0","0","-2"
"147536","National Louis University","2017","On-tenure track, assistant professors","9","2","7","0","0","0","1","0","1","1","1","0","1","0","1","0","0","0","4","1","3","0","0","0","0","0","0","2","0","2","-2"
"147536","National Louis University","2017","Not on tenure track/No tenure system system total","73","23","50","1","0","1","2","2","0","9","1","8","4","1","3","0","0","0","53","18","35","0","0","0","4","1","3","0","0","0","-2"
"147536","National Louis University","2017","Not on tenure/no tenure system, professors","2","1","1","0","0","0","0","0","0","0","0","0","0","0","0","0","0","0","2","1","1","0","0","0","0","0","0","0","0","0","-2"
"147536","National Louis University","2017","Not on tenure/no tenure system, associate professors","9","3","6","0","0","0","1","1","0","0","0","0","0","0","0","0","0","0","8","2","6","0","0","0","0","0","0","0","0","0","-2"
"147536","National Louis University","2017","Not on tenure/no tenure system, assistant professors","40","10","30","1","0","1","0","0","0","7","0","7","3","1","2","0","0","0","29","9","20","0","0","0","0","0","0","0","0","0","-2"
"147536","National Louis University","2017","Not on tenure/no tenure system, instructors","21","9","12","0","0","0","1","1","0","2","1","1","1","0","1","0","0","0","14","6","8","0","0","0","3","1","2","0","0","0","-2"
"147536","National Louis University","2017","Not on tenure/no tenure system, lecturers","1","0","1","0","0","0","0","0","0","0","0","0","0","0","0","0","0","0","0","0","0","0","0","0","1","0","1","0","0","0","-2"
"147679","North Park University","2017","Tenured total","69","35","34","0","0","0","7","5","2","2","0","2","1","0","1","0","0","0","58","29","29","1","1","0","0","0","0","0","0","0","-2"
"147679","North Park University","2017","Tenured, professors","53","27","26","0","0","0","4","3","1","2","0","2","1","0","1","0","0","0","46","24","22","0","0","0","0","0","0","0","0","0","-2"
"147679","North Park University","2017","Tenured, associate professors","16","8","8","0","0","0","3","2","1","0","0","0","0","0","0","0","0","0","12","5","7","1","1","0","0","0","0","0","0","0","-2"
"147679","North Park University","2017","On-Tenure track total","35","15","20","0","0","0","2","0","2","7","3","4","0","0","0","0","0","0","25","12","13","1","0","1","0","0","0","0","0","0","-2"
"147679","North Park University","2017","On-tenure track, professors","3","3","0","0","0","0","0","0","0","1","1","0","0","0","0","0","0","0","2","2","0","0","0","0","0","0","0","0","0","0","-2"
"147679","North Park University","2017","On-tenure track, associate professors","10","6","4","0","0","0","2","0","2","1","1","0","0","0","0","0","0","0","7","5","2","0","0","0","0","0","0","0","0","0","-2"
"147679","North Park University","2017","On-tenure track, assistant professors","22","6","16","0","0","0","0","0","0","5","1","4","0","0","0","0","0","0","16","5","11","1","0","1","0","0","0","0","0","0","-2"
"147679","North Park University","2017","Not on tenure track/No tenure system system total","17","6","11","0","0","0","0","0","0","0","0","0","0","0","0","0","0","0","17","6","11","0","0","0","0","0","0","0","0","0","-2"
"147679","North Park University","2017","Not on tenure/no tenure system, professors","4","3","1","0","0","0","0","0","0","0","0","0","0","0","0","0","0","0","4","3","1","0","0","0","0","0","0","0","0","0","-2"
"147679","North Park University","2017","Not on tenure/no tenure system, associate professors","4","2","2","0","0","0","0","0","0","0","0","0","0","0","0","0","0","0","4","2","2","0","0","0","0","0","0","0","0","0","-2"
"147679","North Park University","2017","Not on tenure/no tenure system, assistant professors","9","1","8","0","0","0","0","0","0","0","0","0","0","0","0","0","0","0","9","1","8","0","0","0","0","0","0","0","0","0","-2"
"147776","Northeastern Illinois University","2017","Tenured total","154","70","84","0","0","0","13","7","6","13","7","6","12","7","5","0","0","0","54","24","30","0","0","0","6","4","2","56","21","35","-2"
"147776","Northeastern Illinois University","2017","Tenured, professors","57","27","30","0","0","0","8","4","4","3","3","0","5","3","2","0","0","0","26","10","16","0","0","0","1","1","0","14","6","8","-2"
"147776","Northeastern Illinois University","2017","Tenured, associate professors","96","43","53","0","0","0","5","3","2","10","4","6","7","4","3","0","0","0","28","14","14","0","0","0","5","3","2","41","15","26","-2"
"147776","Northeastern Illinois University","2017","Tenured, assistant professors","1","0","1","0","0","0","0","0","0","0","0","0","0","0","0","0","0","0","0","0","0","0","0","0","0","0","0","1","0","1","-2"
"147776","Northeastern Illinois University","2017","On-Tenure track total","59","25","34","1","1","0","2","0","2","3","2","1","5","2","3","0","0","0","28","10","18","0","0","0","4","4","0","16","6","10","-2"
"147776","Northeastern Illinois University","2017","On-tenure track, professors","1","0","1","0","0","0","0","0","0","0","0","0","0","0","0","0","0","0","1","0","1","0","0","0","0","0","0","0","0","0","-2"
"147776","Northeastern Illinois University","2017","On-tenure track, assistant professors","58","25","33","1","1","0","2","0","2","3","2","1","5","2","3","0","0","0","27","10","17","0","0","0","4","4","0","16","6","10","-2"
"147776","Northeastern Illinois University","2017","Not on tenure track/No tenure system system total","87","38","49","0","0","0","3","1","2","2","2","0","5","2","3","0","0","0","49","18","31","0","0","0","8","4","4","20","11","9","-2"
"147776","Northeastern Illinois University","2017","Not on tenure/no tenure system, instructors","87","38","49","0","0","0","3","1","2","2","2","0","5","2","3","0","0","0","49","18","31","0","0","0","8","4","4","20","11","9","-2"
"148335","Robert Morris University Illinois","2017","Not on tenure track/No tenure system system total","53","33","20","0","0","0","8","6","2","5","3","2","2","2","0","0","0","0","38","22","16","0","0","0","0","0","0","0","0","0","-2"
"148335","Robert Morris University Illinois","2017","Not on tenure/no tenure system, professors","53","33","20","0","0","0","8","6","2","5","3","2","2","2","0","0","0","0","38","22","16","0","0","0","0","0","0","0","0","0","-2"
"148487","Roosevelt University","2017","Tenured total","133","73","60","1","1","0","3","2","1","9","3","6","5","4","1","0","0","0","90","46","44","4","2","2","8","7","1","13","8","5","-2"
"148487","Roosevelt University","2017","Tenured, professors","44","28","16","0","0","0","2","2","0","4","2","2","3","2","1","0","0","0","30","17","13","1","1","0","2","2","0","2","2","0","-2"
"148487","Roosevelt University","2017","Tenured, associate professors","87","44","43","1","1","0","1","0","1","5","1","4","2","2","0","0","0","0","58","28","30","3","1","2","6","5","1","11","6","5","-2"
"148487","Roosevelt University","2017","Tenured, assistant professors","2","1","1","0","0","0","0","0","0","0","0","0","0","0","0","0","0","0","2","1","1","0","0","0","0","0","0","0","0","0","-2"
"148487","Roosevelt University","2017","On-Tenure track total","30","20","10","0","0","0","1","1","0","0","0","0","1","0","1","0","0","0","18","12","6","0","0","0","0","0","0","10","7","3","-2"
"148487","Roosevelt University","2017","On-tenure track, associate professors","2","2","0","0","0","0","0","0","0","0","0","0","0","0","0","0","0","0","1","1","0","0","0","0","0","0","0","1","1","0","-2"
"148487","Roosevelt University","2017","On-tenure track, assistant professors","28","18","10","0","0","0","1","1","0","0","0","0","1","0","1","0","0","0","17","11","6","0","0","0","0","0","0","9","6","3","-2"
"148487","Roosevelt University","2017","Not on tenure track/No tenure system system total","45","26","19","0","0","0","3","1","2","1","1","0","3","2","1","0","0","0","33","19","14","1","0","1","1","0","1","3","3","0","-2"
"148487","Roosevelt University","2017","Not on tenure/no tenure system, professors","1","1","0","0","0","0","0","0","0","0","0","0","0","0","0","0","0","0","1","1","0","0","0","0","0","0","0","0","0","0","-2"
"148487","Roosevelt University","2017","Not on tenure/no tenure system, associate professors","4","3","1","0","0","0","0","0","0","0","0","0","0","0","0","0","0","0","4","3","1","0","0","0","0","0","0","0","0","0","-2"
"148487","Roosevelt University","2017","Not on tenure/no tenure system, assistant professors","20","9","11","0","0","0","2","1","1","0","0","0","2","1","1","0","0","0","14","6","8","0","0","0","1","0","1","1","1","0","-2"
"148487","Roosevelt University","2017","Not on tenure/no tenure system, lecturers","18","11","7","0","0","0","1","0","1","1","1","0","1","1","0","0","0","0","13","8","5","1","0","1","0","0","0","1","1","0","-2"
"148487","Roosevelt University","2017","Not on tenure/no tenure system, no academic rank","2","2","0","0","0","0","0","0","0","0","0","0","0","0","0","0","0","0","1","1","0","0","0","0","0","0","0","1","1","0","-2"
"148496","Dominican University","2017","Tenured total","93","38","55","0","0","0","6","3","3","6","3","3","7","1","6","0","0","0","73","30","43","1","1","0","0","0","0","0","0","0","-2"
"148496","Dominican University","2017","Tenured, professors","49","25","24","0","0","0","4","2","2","1","1","0","2","1","1","0","0","0","42","21","21","0","0","0","0","0","0","0","0","0","-2"
"148496","Dominican University","2017","Tenured, associate professors","36","11","25","0","0","0","2","1","1","4","2","2","5","0","5","0","0","0","24","7","17","1","1","0","0","0","0","0","0","0","-2"
"148496","Dominican University","2017","Tenured, assistant professors","8","2","6","0","0","0","0","0","0","1","0","1","0","0","0","0","0","0","7","2","5","0","0","0","0","0","0","0","0","0","-2"
"148496","Dominican University","2017","On-Tenure track total","33","19","14","0","0","0","8","3","5","1","1","0","3","3","0","0","0","0","19","11","8","2","1","1","0","0","0","0","0","0","-2"
"148496","Dominican University","2017","On-tenure track, associate professors","9","4","5","0","0","0","2","0","2","0","0","0","1","1","0","0","0","0","5","2","3","1","1","0","0","0","0","0","0","0","-2"
"148496","Dominican University","2017","On-tenure track, assistant professors","21","14","7","0","0","0","6","3","3","1","1","0","1","1","0","0","0","0","12","9","3","1","0","1","0","0","0","0","0","0","-2"
"148496","Dominican University","2017","On-tenure track, instructors","2","1","1","0","0","0","0","0","0","0","0","0","1","1","0","0","0","0","1","0","1","0","0","0","0","0","0","0","0","0","-2"
"148496","Dominican University","2017","On-tenure track, lecturers","1","0","1","0","0","0","0","0","0","0","0","0","0","0","0","0","0","0","1","0","1","0","0","0","0","0","0","0","0","0","-2"
"148496","Dominican University","2017","Not on tenure track/No tenure system system total","32","10","22","0","0","0","1","1","0","2","1","1","4","1","3","0","0","0","23","7","16","0","0","0","2","0","2","0","0","0","-2"
"148496","Dominican University","2017","Not on tenure/no tenure system, assistant professors","3","1","2","0","0","0","0","0","0","0","0","0","0","0","0","0","0","0","2","1","1","0","0","0","1","0","1","0","0","0","-2"
"148496","Dominican University","2017","Not on tenure/no tenure system, lecturers","29","9","20","0","0","0","1","1","0","2","1","1","4","1","3","0","0","0","21","6","15","0","0","0","1","0","1","0","0","0","-2"
"148511","Rush University","2017","Tenured total","349","225","124","2","2","0","60","41","19","14","7","7","18","12","6","0","0","0","246","155","91","7","7","0","2","1","1","0","0","0","-2"
"148511","Rush University","2017","Tenured, professors","158","108","50","0","0","0","19","16","3","4","3","1","6","5","1","0","0","0","126","82","44","2","2","0","1","0","1","0","0","0","-2"
"148511","Rush University","2017","Tenured, associate professors","191","117","74","2","2","0","41","25","16","10","4","6","12","7","5","0","0","0","120","73","47","5","5","0","1","1","0","0","0","0","-2"
"148511","Rush University","2017","On-Tenure track total","1063","499","564","3","2","1","267","137","130","48","16","32","67","33","34","0","0","0","653","297","356","22","11","11","3","3","0","0","0","0","-2"
"148511","Rush University","2017","On-tenure track, assistant professors","840","413","427","3","2","1","222","111","111","41","16","25","47","25","22","0","0","0","509","250","259","16","7","9","2","2","0","0","0","0","-2"
"148511","Rush University","2017","On-tenure track, instructors","223","86","137","0","0","0","45","26","19","7","0","7","20","8","12","0","0","0","144","47","97","6","4","2","1","1","0","0","0","0","-2"
"148511","Rush University","2017","Not on tenure track/No tenure system system total","120","59","61","0","0","0","20","9","11","6","2","4","6","3","3","0","0","0","84","44","40","3","0","3","1","1","0","0","0","0","-2"
"148511","Rush University","2017","Not on tenure/no tenure system, lecturers","12","8","4","0","0","0","1","1","0","0","0","0","0","0","0","0","0","0","9","6","3","1","0","1","1","1","0","0","0","0","-2"
"148511","Rush University","2017","Not on tenure/no tenure system, no academic rank","108","51","57","0","0","0","19","8","11","6","2","4","6","3","3","0","0","0","75","38","37","2","0","2","0","0","0","0","0","0","-2"
"148627","Saint Xavier University","2017","Tenured total","80","36","44","0","0","0","7","4","3","4","2","2","1","0","1","0","0","0","65","28","37","0","0","0","3","2","1","0","0","0","-2"
"148627","Saint Xavier University","2017","Tenured, professors","25","12","13","0","0","0","1","1","0","1","1","0","0","0","0","0","0","0","23","10","13","0","0","0","0","0","0","0","0","0","-2"
"148627","Saint Xavier University","2017","Tenured, associate professors","55","24","31","0","0","0","6","3","3","3","1","2","1","0","1","0","0","0","42","18","24","0","0","0","3","2","1","0","0","0","-2"
"148627","Saint Xavier University","2017","On-Tenure track total","34","10","24","1","0","1","1","1","0","2","0","2","0","0","0","0","0","0","21","5","16","0","0","0","9","4","5","0","0","0","-2"
"148627","Saint Xavier University","2017","On-tenure track, professors","1","0","1","0","0","0","0","0","0","0","0","0","0","0","0","0","0","0","1","0","1","0","0","0","0","0","0","0","0","0","-2"
"148627","Saint Xavier University","2017","On-tenure track, associate professors","4","2","2","0","0","0","0","0","0","0","0","0","0","0","0","0","0","0","3","2","1","0","0","0","1","0","1","0","0","0","-2"
"148627","Saint Xavier University","2017","On-tenure track, assistant professors","29","8","21","1","0","1","1","1","0","2","0","2","0","0","0","0","0","0","17","3","14","0","0","0","8","4","4","0","0","0","-2"
"148627","Saint Xavier University","2017","Not on tenure track/No tenure system system total","26","8","18","0","0","0","1","1","0","3","2","1","0","0","0","0","0","0","14","3","11","0","0","0","8","2","6","0","0","0","-2"
"148627","Saint Xavier University","2017","Not on tenure/no tenure system, assistant professors","11","5","6","0","0","0","0","0","0","2","1","1","0","0","0","0","0","0","4","2","2","0","0","0","5","2","3","0","0","0","-2"
"148627","Saint Xavier University","2017","Not on tenure/no tenure system, instructors","3","0","3","0","0","0","0","0","0","0","0","0","0","0","0","0","0","0","3","0","3","0","0","0","0","0","0","0","0","0","-2"
"148627","Saint Xavier University","2017","Not on tenure/no tenure system, lecturers","8","3","5","0","0","0","1","1","0","1","1","0","0","0","0","0","0","0","3","1","2","0","0","0","3","0","3","0","0","0","-2"
"148627","Saint Xavier University","2017","Not on tenure/no tenure system, no academic rank","4","0","4","0","0","0","0","0","0","0","0","0","0","0","0","0","0","0","4","0","4","0","0","0","0","0","0","0","0","0","-2"
"148876","Saint Augustine College","2017","Not on tenure track/No tenure system system total","25","10","15","0","0","0","2","1","1","1","0","1","14","9","5","0","0","0","8","0","8","0","0","0","0","0","0","0","0","0","-2"
"148876","Saint Augustine College","2017","Not on tenure/no tenure system, associate professors","5","2","3","0","0","0","0","0","0","0","0","0","2","2","0","0","0","0","3","0","3","0","0","0","0","0","0","0","0","0","-2"
"148876","Saint Augustine College","2017","Not on tenure/no tenure system, assistant professors","18","6","12","0","0","0","1","0","1","1","0","1","11","6","5","0","0","0","5","0","5","0","0","0","0","0","0","0","0","0","-2"
"148876","Saint Augustine College","2017","Not on tenure/no tenure system, instructors","2","2","0","0","0","0","1","1","0","0","0","0","1","1","0","0","0","0","0","0","0","0","0","0","0","0","0","0","0","0","-2"
"149639","VanderCook College of Music","2017","Not on tenure track/No tenure system system total","12","5","7","0","0","0","2","0","2","1","1","0","0","0","0","0","0","0","9","4","5","0","0","0","0","0","0","0","0","0","-2"
"149639","VanderCook College of Music","2017","Not on tenure/no tenure system, professors","3","1","2","0","0","0","0","0","0","0","0","0","0","0","0","0","0","0","3","1","2","0","0","0","0","0","0","0","0","0","-2"
"149639","VanderCook College of Music","2017","Not on tenure/no tenure system, associate professors","6","3","3","0","0","0","2","0","2","1","1","0","0","0","0","0","0","0","3","2","1","0","0","0","0","0","0","0","0","0","-2"
"149639","VanderCook College of Music","2017","Not on tenure/no tenure system, assistant professors","3","1","2","0","0","0","0","0","0","0","0","0","0","0","0","0","0","0","3","1","2","0","0","0","0","0","0","0","0","0","-2"
"150172","Calumet College of Saint Joseph","2017","Tenured total","16","11","5","0","0","0","0","0","0","0","0","0","0","0","0","0","0","0","16","11","5","0","0","0","0","0","0","0","0","0","-2"
"150172","Calumet College of Saint Joseph","2017","Tenured, professors","3","3","0","0","0","0","0","0","0","0","0","0","0","0","0","0","0","0","3","3","0","0","0","0","0","0","0","0","0","0","-2"
"150172","Calumet College of Saint Joseph","2017","Tenured, associate professors","12","7","5","0","0","0","0","0","0","0","0","0","0","0","0","0","0","0","12","7","5","0","0","0","0","0","0","0","0","0","-2"
"150172","Calumet College of Saint Joseph","2017","Tenured, assistant professors","1","1","0","0","0","0","0","0","0","0","0","0","0","0","0","0","0","0","1","1","0","0","0","0","0","0","0","0","0","0","-2"
"150172","Calumet College of Saint Joseph","2017","On-Tenure track total","11","6","5","0","0","0","1","1","0","1","0","1","3","1","2","0","0","0","6","4","2","0","0","0","0","0","0","0","0","0","-2"
"150172","Calumet College of Saint Joseph","2017","On-tenure track, assistant professors","11","6","5","0","0","0","1","1","0","1","0","1","3","1","2","0","0","0","6","4","2","0","0","0","0","0","0","0","0","0","-2"
"150172","Calumet College of Saint Joseph","2017","Not on tenure track/No tenure system system total","3","1","2","0","0","0","0","0","0","1","0","1","0","0","0","0","0","0","2","1","1","0","0","0","0","0","0","0","0","0","-2"
"150172","Calumet College of Saint Joseph","2017","Not on tenure/no tenure system, instructors","3","1","2","0","0","0","0","0","0","1","0","1","0","0","0","0","0","0","2","1","1","0","0","0","0","0","0","0","0","0","-2"
"151360","Indiana University-Northwest","2017","Tenured total","61","39","22","0","0","0","9","5","4","4","4","0","6","4","2","0","0","0","41","25","16","1","1","0","0","0","0","0","0","0","-2"
"151360","Indiana University-Northwest","2017","Tenured, professors","29","17","12","0","0","0","5","3","2","2","2","0","2","0","2","0","0","0","19","11","8","1","1","0","0","0","0","0","0","0","-2"
"151360","Indiana University-Northwest","2017","Tenured, associate professors","32","22","10","0","0","0","4","2","2","2","2","0","4","4","0","0","0","0","22","14","8","0","0","0","0","0","0","0","0","0","-2"
"151360","Indiana University-Northwest","2017","On-Tenure track total","39","16","23","0","0","0","8","5","3","6","0","6","0","0","0","0","0","0","24","10","14","1","1","0","0","0","0","0","0","0","-2"
"151360","Indiana University-Northwest","2017","On-tenure track, associate professors","9","4","5","0","0","0","1","1","0","2","0","2","0","0","0","0","0","0","6","3","3","0","0","0","0","0","0","0","0","0","-2"
"151360","Indiana University-Northwest","2017","On-tenure track, assistant professors","30","12","18","0","0","0","7","4","3","4","0","4","0","0","0","0","0","0","18","7","11","1","1","0","0","0","0","0","0","0","-2"
"151360","Indiana University-Northwest","2017","Not on tenure track/No tenure system system total","52","16","36","0","0","0","1","0","1","4","0","4","5","3","2","0","0","0","41","13","28","1","0","1","0","0","0","0","0","0","-2"
"151360","Indiana University-Northwest","2017","Not on tenure/no tenure system, associate professors","6","0","6","0","0","0","0","0","0","0","0","0","0","0","0","0","0","0","6","0","6","0","0","0","0","0","0","0","0","0","-2"
"151360","Indiana University-Northwest","2017","Not on tenure/no tenure system, assistant professors","27","7","20","0","0","0","0","0","0","4","0","4","3","2","1","0","0","0","20","5","15","0","0","0","0","0","0","0","0","0","-2"
"151360","Indiana University-Northwest","2017","Not on tenure/no tenure system, lecturers","19","9","10","0","0","0","1","0","1","0","0","0","2","1","1","0","0","0","15","8","7","1","0","1","0","0","0","0","0","0","-2"
"155007","Donnelly College","2017","Not on tenure track/No tenure system system total","18","3","15","0","0","0","0","0","0","1","0","1","3","1","2","0","0","0","13","2","11","0","0","0","1","0","1","0","0","0","-2"
"155007","Donnelly College","2017","Not on tenure/no tenure system, professors","1","0","1","0","0","0","0","0","0","0","0","0","0","0","0","0","0","0","1","0","1","0","0","0","0","0","0","0","0","0","-2"
"155007","Donnelly College","2017","Not on tenure/no tenure system, assistant professors","15","2","13","0","0","0","0","0","0","1","0","1","2","0","2","0","0","0","11","2","9","0","0","0","1","0","1","0","0","0","-2"
"155007","Donnelly College","2017","Not on tenure/no tenure system, instructors","2","1","1","0","0","0","0","0","0","0","0","0","1","1","0","0","0","0","1","0","1","0","0","0","0","0","0","0","0","0","-2"
"160409","Saint Joseph Seminary College","2017","Not on tenure track/No tenure system system total","19","16","3","0","0","0","1","1","0","0","0","0","1","1","0","0","0","0","17","14","3","0","0","0","0","0","0","0","0","0","-2"
"160409","Saint Joseph Seminary College","2017","Not on tenure/no tenure system, professors","19","16","3","0","0","0","1","1","0","0","0","0","1","1","0","0","0","0","17","14","3","0","0","0","0","0","0","0","0","0","-2"
"165167","Cambridge College","2017","Not on tenure track/No tenure system system total","16","8","8","0","0","0","1","0","1","4","3","1","0","0","0","0","0","0","11","5","6","0","0","0","0","0","0","0","0","0","-2"
"165167","Cambridge College","2017","Not on tenure/no tenure system, professors","11","6","5","0","0","0","1","0","1","3","2","1","0","0","0","0","0","0","7","4","3","0","0","0","0","0","0","0","0","0","-2"
"165167","Cambridge College","2017","Not on tenure/no tenure system, associate professors","2","0","2","0","0","0","0","0","0","0","0","0","0","0","0","0","0","0","2","0","2","0","0","0","0","0","0","0","0","0","-2"
"165167","Cambridge College","2017","Not on tenure/no tenure system, assistant professors","2","1","1","0","0","0","0","0","0","0","0","0","0","0","0","0","0","0","2","1","1","0","0","0","0","0","0","0","0","0","-2"
"165167","Cambridge College","2017","Not on tenure/no tenure system, lecturers","1","1","0","0","0","0","0","0","0","1","1","0","0","0","0","0","0","0","0","0","0","0","0","0","0","0","0","0","0","0","-2"
"165884","Benjamin Franklin Institute of Technology","2017","Not on tenure track/No tenure system system total","37","28","9","0","0","0","1","1","0","2","2","0","1","1","0","0","0","0","31","22","9","0","0","0","2","2","0","0","0","0","-2"
"165884","Benjamin Franklin Institute of Technology","2017","Not on tenure/no tenure system, professors","9","5","4","0","0","0","0","0","0","0","0","0","0","0","0","0","0","0","9","5","4","0","0","0","0","0","0","0","0","0","-2"
"165884","Benjamin Franklin Institute of Technology","2017","Not on tenure/no tenure system, associate professors","6","6","0","0","0","0","1","1","0","1","1","0","0","0","0","0","0","0","4","4","0","0","0","0","0","0","0","0","0","0","-2"
"165884","Benjamin Franklin Institute of Technology","2017","Not on tenure/no tenure system, assistant professors","12","9","3","0","0","0","0","0","0","0","0","0","0","0","0","0","0","0","10","7","3","0","0","0","2","2","0","0","0","0","-2"
"165884","Benjamin Franklin Institute of Technology","2017","Not on tenure/no tenure system, instructors","10","8","2","0","0","0","0","0","0","1","1","0","1","1","0","0","0","0","8","6","2","0","0","0","0","0","0","0","0","0","-2"
"182005","College of Southern Nevada","2017","Tenured total","365","193","172","4","2","2","31","15","16","17","7","10","22","8","14","0","0","0","287","157","130","2","2","0","0","0","0","2","2","0","-2"
"182005","College of Southern Nevada","2017","Tenured, professors","365","193","172","4","2","2","31","15","16","17","7","10","22","8","14","0","0","0","287","157","130","2","2","0","0","0","0","2","2","0","-2"
"182005","College of Southern Nevada","2017","On-Tenure track total","91","41","50","0","0","0","8","4","4","7","1","6","6","4","2","0","0","0","67","31","36","3","1","2","0","0","0","0","0","0","-2"
"182005","College of Southern Nevada","2017","On-tenure track, instructors","91","41","50","0","0","0","8","4","4","7","1","6","6","4","2","0","0","0","67","31","36","3","1","2","0","0","0","0","0","0","-2"
"182005","College of Southern Nevada","2017","Not on tenure track/No tenure system system total","58","31","27","0","0","0","2","1","1","3","1","2","7","6","1","0","0","0","45","23","22","1","0","1","0","0","0","0","0","0","-2"
"182005","College of Southern Nevada","2017","Not on tenure/no tenure system, instructors","58","31","27","0","0","0","2","1","1","3","1","2","7","6","1","0","0","0","45","23","22","1","0","1","0","0","0","0","0","0","-2"
"182500","Truckee Meadows Community College","2017","Tenured total","101","49","52","1","1","0","4","1","3","1","0","1","5","2","3","0","0","0","89","45","44","1","0","1","0","0","0","0","0","0","-2"
"182500","Truckee Meadows Community College","2017","Tenured, professors","101","49","52","1","1","0","4","1","3","1","0","1","5","2","3","0","0","0","89","45","44","1","0","1","0","0","0","0","0","0","-2"
"182500","Truckee Meadows Community College","2017","On-Tenure track total","39","22","17","1","1","0","3","3","0","0","0","0","3","2","1","0","0","0","32","16","16","0","0","0","0","0","0","0","0","0","-2"
"182500","Truckee Meadows Community College","2017","On-tenure track, instructors","39","22","17","1","1","0","3","3","0","0","0","0","3","2","1","0","0","0","32","16","16","0","0","0","0","0","0","0","0","0","-2"
"182500","Truckee Meadows Community College","2017","Not on tenure track/No tenure system system total","24","15","9","0","0","0","2","2","0","0","0","0","1","1","0","0","0","0","21","12","9","0","0","0","0","0","0","0","0","0","-2"
"182500","Truckee Meadows Community College","2017","Not on tenure/no tenure system, professors","1","0","1","0","0","0","0","0","0","0","0","0","0","0","0","0","0","0","1","0","1","0","0","0","0","0","0","0","0","0","-2"
"182500","Truckee Meadows Community College","2017","Not on tenure/no tenure system, instructors","23","15","8","0","0","0","2","2","0","0","0","0","1","1","0","0","0","0","20","12","8","0","0","0","0","0","0","0","0","0","-2"
"183822","Bloomfield College","2017","Tenured total","46","19","27","0","0","0","2","1","1","6","2","4","3","1","2","0","0","0","35","15","20","0","0","0","0","0","0","0","0","0","-2"
"183822","Bloomfield College","2017","Tenured, professors","30","12","18","0","0","0","0","0","0","4","0","4","1","0","1","0","0","0","25","12","13","0","0","0","0","0","0","0","0","0","-2"
"183822","Bloomfield College","2017","Tenured, associate professors","16","7","9","0","0","0","2","1","1","2","2","0","2","1","1","0","0","0","10","3","7","0","0","0","0","0","0","0","0","0","-2"
"183822","Bloomfield College","2017","On-Tenure track total","21","6","15","0","0","0","1","0","1","3","0","3","2","1","1","0","0","0","15","5","10","0","0","0","0","0","0","0","0","0","-2"
"183822","Bloomfield College","2017","On-tenure track, associate professors","3","1","2","0","0","0","0","0","0","0","0","0","1","1","0","0","0","0","2","0","2","0","0","0","0","0","0","0","0","0","-2"
"183822","Bloomfield College","2017","On-tenure track, assistant professors","18","5","13","0","0","0","1","0","1","3","0","3","1","0","1","0","0","0","13","5","8","0","0","0","0","0","0","0","0","0","-2"
"183822","Bloomfield College","2017","Not on tenure track/No tenure system system total","1","1","0","0","0","0","0","0","0","0","0","0","0","0","0","0","0","0","1","1","0","0","0","0","0","0","0","0","0","0","-2"
"183822","Bloomfield College","2017","Not on tenure/no tenure system, associate professors","1","1","0","0","0","0","0","0","0","0","0","0","0","0","0","0","0","0","1","1","0","0","0","0","0","0","0","0","0","0","-2"
"183910","Caldwell University","2017","Tenured total","42","19","23","0","0","0","1","0","1","0","0","0","0","0","0","0","0","0","40","19","21","0","0","0","1","0","1","0","0","0","-2"
"183910","Caldwell University","2017","Tenured, professors","33","16","17","0","0","0","1","0","1","0","0","0","0","0","0","0","0","0","32","16","16","0","0","0","0","0","0","0","0","0","-2"
"183910","Caldwell University","2017","Tenured, associate professors","7","3","4","0","0","0","0","0","0","0","0","0","0","0","0","0","0","0","6","3","3","0","0","0","1","0","1","0","0","0","-2"
"183910","Caldwell University","2017","Tenured, assistant professors","2","0","2","0","0","0","0","0","0","0","0","0","0","0","0","0","0","0","2","0","2","0","0","0","0","0","0","0","0","0","-2"
"183910","Caldwell University","2017","On-Tenure track total","30","8","22","0","0","0","1","1","0","2","0","2","2","0","2","0","0","0","25","7","18","0","0","0","0","0","0","0","0","0","-2"
"183910","Caldwell University","2017","On-tenure track, associate professors","7","2","5","0","0","0","1","1","0","0","0","0","0","0","0","0","0","0","6","1","5","0","0","0","0","0","0","0","0","0","-2"
"183910","Caldwell University","2017","On-tenure track, assistant professors","23","6","17","0","0","0","0","0","0","2","0","2","2","0","2","0","0","0","19","6","13","0","0","0","0","0","0","0","0","0","-2"
"183910","Caldwell University","2017","Not on tenure track/No tenure system system total","5","0","5","0","0","0","0","0","0","0","0","0","1","0","1","0","0","0","4","0","4","0","0","0","0","0","0","0","0","0","-2"
"183910","Caldwell University","2017","Not on tenure/no tenure system, assistant professors","2","0","2","0","0","0","0","0","0","0","0","0","0","0","0","0","0","0","2","0","2","0","0","0","0","0","0","0","0","0","-2"
"183910","Caldwell University","2017","Not on tenure/no tenure system, instructors","3","0","3","0","0","0","0","0","0","0","0","0","1","0","1","0","0","0","2","0","2","0","0","0","0","0","0","0","0","0","-2"
"184603","Fairleigh Dickinson University-Metropolitan Campus","2017","Tenured total","84","52","32","0","0","0","15","9","6","4","4","0","2","2","0","0","0","0","63","37","26","0","0","0","0","0","0","0","0","0","-2"
"184603","Fairleigh Dickinson University-Metropolitan Campus","2017","Tenured, professors","46","30","16","0","0","0","7","4","3","2","2","0","1","1","0","0","0","0","36","23","13","0","0","0","0","0","0","0","0","0","-2"
"184603","Fairleigh Dickinson University-Metropolitan Campus","2017","Tenured, associate professors","33","18","15","0","0","0","8","5","3","2","2","0","0","0","0","0","0","0","23","11","12","0","0","0","0","0","0","0","0","0","-2"
"184603","Fairleigh Dickinson University-Metropolitan Campus","2017","Tenured, assistant professors","3","3","0","0","0","0","0","0","0","0","0","0","1","1","0","0","0","0","2","2","0","0","0","0","0","0","0","0","0","0","-2"
"184603","Fairleigh Dickinson University-Metropolitan Campus","2017","Tenured, lecturers","2","1","1","0","0","0","0","0","0","0","0","0","0","0","0","0","0","0","2","1","1","0","0","0","0","0","0","0","0","0","-2"
"184603","Fairleigh Dickinson University-Metropolitan Campus","2017","On-Tenure track total","38","19","19","0","0","0","7","4","3","1","1","0","6","2","4","0","0","0","24","12","12","0","0","0","0","0","0","0","0","0","-2"
"184603","Fairleigh Dickinson University-Metropolitan Campus","2017","On-tenure track, professors","1","0","1","0","0","0","0","0","0","0","0","0","0","0","0","0","0","0","1","0","1","0","0","0","0","0","0","0","0","0","-2"
"184603","Fairleigh Dickinson University-Metropolitan Campus","2017","On-tenure track, associate professors","6","2","4","0","0","0","3","1","2","0","0","0","0","0","0","0","0","0","3","1","2","0","0","0","0","0","0","0","0","0","-2"
"184603","Fairleigh Dickinson University-Metropolitan Campus","2017","On-tenure track, assistant professors","31","17","14","0","0","0","4","3","1","1","1","0","6","2","4","0","0","0","20","11","9","0","0","0","0","0","0","0","0","0","-2"
"184603","Fairleigh Dickinson University-Metropolitan Campus","2017","Not on tenure track/No tenure system system total","48","22","26","0","0","0","5","1","4","3","0","3","6","2","4","0","0","0","34","19","15","0","0","0","0","0","0","0","0","0","-2"
"184603","Fairleigh Dickinson University-Metropolitan Campus","2017","Not on tenure/no tenure system, assistant professors","5","0","5","0","0","0","1","0","1","2","0","2","0","0","0","0","0","0","2","0","2","0","0","0","0","0","0","0","0","0","-2"
"184603","Fairleigh Dickinson University-Metropolitan Campus","2017","Not on tenure/no tenure system, instructors","4","1","3","0","0","0","1","1","0","0","0","0","0","0","0","0","0","0","3","0","3","0","0","0","0","0","0","0","0","0","-2"
"184603","Fairleigh Dickinson University-Metropolitan Campus","2017","Not on tenure/no tenure system, lecturers","39","21","18","0","0","0","3","0","3","1","0","1","6","2","4","0","0","0","29","19","10","0","0","0","0","0","0","0","0","0","-2"
"184612","Felician University","2017","Not on tenure track/No tenure system system total","79","32","47","0","0","0","3","2","1","5","0","5","4","1","3","0","0","0","67","29","38","0","0","0","0","0","0","0","0","0","-2"
"184612","Felician University","2017","Not on tenure/no tenure system, professors","14","5","9","0","0","0","0","0","0","1","0","1","0","0","0","0","0","0","13","5","8","0","0","0","0","0","0","0","0","0","-2"
"184612","Felician University","2017","Not on tenure/no tenure system, associate professors","29","18","11","0","0","0","2","1","1","0","0","0","2","1","1","0","0","0","25","16","9","0","0","0","0","0","0","0","0","0","-2"
"184612","Felician University","2017","Not on tenure/no tenure system, assistant professors","22","7","15","0","0","0","0","0","0","3","0","3","2","0","2","0","0","0","17","7","10","0","0","0","0","0","0","0","0","0","-2"
"184612","Felician University","2017","Not on tenure/no tenure system, instructors","14","2","12","0","0","0","1","1","0","1","0","1","0","0","0","0","0","0","12","1","11","0","0","0","0","0","0","0","0","0","-2"
"185129","New Jersey City University","2017","Tenured total","172","82","90","0","0","0","20","8","12","25","9","16","18","6","12","0","0","0","109","59","50","0","0","0","0","0","0","0","0","0","-2"
"185129","New Jersey City University","2017","Tenured, professors","88","41","47","0","0","0","14","6","8","12","4","8","10","4","6","0","0","0","52","27","25","0","0","0","0","0","0","0","0","0","-2"
"185129","New Jersey City University","2017","Tenured, associate professors","61","32","29","0","0","0","4","2","2","9","3","6","5","2","3","0","0","0","43","25","18","0","0","0","0","0","0","0","0","0","-2"
"185129","New Jersey City University","2017","Tenured, assistant professors","23","9","14","0","0","0","2","0","2","4","2","2","3","0","3","0","0","0","14","7","7","0","0","0","0","0","0","0","0","0","-2"
"185129","New Jersey City University","2017","On-Tenure track total","73","40","33","0","0","0","18","12","6","4","1","3","9","6","3","0","0","0","37","17","20","0","0","0","5","4","1","0","0","0","-2"
"185129","New Jersey City University","2017","On-tenure track, professors","3","3","0","0","0","0","0","0","0","0","0","0","1","1","0","0","0","0","1","1","0","0","0","0","1","1","0","0","0","0","-2"
"185129","New Jersey City University","2017","On-tenure track, associate professors","13","4","9","0","0","0","4","1","3","0","0","0","0","0","0","0","0","0","8","2","6","0","0","0","1","1","0","0","0","0","-2"
"185129","New Jersey City University","2017","On-tenure track, assistant professors","57","33","24","0","0","0","14","11","3","4","1","3","8","5","3","0","0","0","28","14","14","0","0","0","3","2","1","0","0","0","-2"
"185129","New Jersey City University","2017","Not on tenure track/No tenure system system total","8","5","3","0","0","0","2","0","2","0","0","0","0","0","0","0","0","0","4","4","0","0","0","0","2","1","1","0","0","0","-2"
"185129","New Jersey City University","2017","Not on tenure/no tenure system, associate professors","1","1","0","0","0","0","0","0","0","0","0","0","0","0","0","0","0","0","1","1","0","0","0","0","0","0","0","0","0","0","-2"
"185129","New Jersey City University","2017","Not on tenure/no tenure system, assistant professors","7","4","3","0","0","0","2","0","2","0","0","0","0","0","0","0","0","0","3","3","0","0","0","0","2","1","1","0","0","0","-2"
"185590","Montclair State University","2017","Tenured total","420","224","196","0","0","0","66","34","32","31","15","16","32","18","14","0","0","0","275","145","130","7","6","1","8","5","3","1","1","0","-2"
"185590","Montclair State University","2017","Tenured, professors","184","100","84","0","0","0","26","15","11","12","5","7","15","10","5","0","0","0","128","67","61","2","2","0","1","1","0","0","0","0","-2"
"185590","Montclair State University","2017","Tenured, associate professors","218","116","102","0","0","0","39","19","20","16","10","6","16","7","9","0","0","0","136","72","64","5","4","1","6","4","2","0","0","0","-2"
"185590","Montclair State University","2017","Tenured, assistant professors","18","8","10","0","0","0","1","0","1","3","0","3","1","1","0","0","0","0","11","6","5","0","0","0","1","0","1","1","1","0","-2"
"185590","Montclair State University","2017","On-Tenure track total","118","54","64","0","0","0","8","4","4","3","2","1","3","2","1","0","0","0","48","21","27","1","0","1","37","14","23","18","11","7","-2"
"185590","Montclair State University","2017","On-tenure track, professors","1","0","1","0","0","0","0","0","0","0","0","0","0","0","0","0","0","0","0","0","0","0","0","0","1","0","1","0","0","0","-2"
"185590","Montclair State University","2017","On-tenure track, associate professors","9","4","5","0","0","0","2","0","2","1","1","0","1","1","0","0","0","0","3","1","2","0","0","0","1","0","1","1","1","0","-2"
"185590","Montclair State University","2017","On-tenure track, assistant professors","108","50","58","0","0","0","6","4","2","2","1","1","2","1","1","0","0","0","45","20","25","1","0","1","35","14","21","17","10","7","-2"
"185590","Montclair State University","2017","Not on tenure track/No tenure system system total","98","41","57","0","0","0","4","3","1","3","1","2","5","1","4","0","0","0","58","23","35","1","0","1","27","13","14","0","0","0","-2"
"185590","Montclair State University","2017","Not on tenure/no tenure system, associate professors","1","1","0","0","0","0","0","0","0","0","0","0","0","0","0","0","0","0","0","0","0","0","0","0","1","1","0","0","0","0","-2"
"185590","Montclair State University","2017","Not on tenure/no tenure system, assistant professors","6","4","2","0","0","0","1","1","0","0","0","0","0","0","0","0","0","0","2","1","1","0","0","0","3","2","1","0","0","0","-2"
"185590","Montclair State University","2017","Not on tenure/no tenure system, instructors","4","3","1","0","0","0","0","0","0","0","0","0","0","0","0","0","0","0","2","2","0","0","0","0","2","1","1","0","0","0","-2"
"185590","Montclair State University","2017","Not on tenure/no tenure system, no academic rank","87","33","54","0","0","0","3","2","1","3","1","2","5","1","4","0","0","0","54","20","34","1","0","1","21","9","12","0","0","0","-2"
"186399","Rutgers University-Newark","2017","Tenured total","304","203","101","1","0","1","37","27","10","20","10","10","11","9","2","0","0","0","177","123","54","1","1","0","29","16","13","28","17","11","-2"
"186399","Rutgers University-Newark","2017","Tenured, professors","176","127","49","0","0","0","23","18","5","8","5","3","5","5","0","0","0","0","123","92","31","0","0","0","9","3","6","8","4","4","-2"
"186399","Rutgers University-Newark","2017","Tenured, associate professors","128","76","52","1","0","1","14","9","5","12","5","7","6","4","2","0","0","0","54","31","23","1","1","0","20","13","7","20","13","7","-2"
"186399","Rutgers University-Newark","2017","On-Tenure track total","97","56","41","0","0","0","6","4","2","5","2","3","5","3","2","0","0","0","21","13","8","3","1","2","34","15","19","23","18","5","-2"
"186399","Rutgers University-Newark","2017","On-tenure track, professors","2","1","1","0","0","0","0","0","0","1","1","0","0","0","0","0","0","0","1","0","1","0","0","0","0","0","0","0","0","0","-2"
"186399","Rutgers University-Newark","2017","On-tenure track, associate professors","5","3","2","0","0","0","0","0","0","0","0","0","0","0","0","0","0","0","2","1","1","0","0","0","2","2","0","1","0","1","-2"
"186399","Rutgers University-Newark","2017","On-tenure track, assistant professors","90","52","38","0","0","0","6","4","2","4","1","3","5","3","2","0","0","0","18","12","6","3","1","2","32","13","19","22","18","4","-2"
"186399","Rutgers University-Newark","2017","Not on tenure track/No tenure system system total","154","95","59","0","0","0","9","5","4","16","11","5","4","3","1","0","0","0","74","48","26","0","0","0","43","23","20","8","5","3","-2"
"186399","Rutgers University-Newark","2017","Not on tenure/no tenure system, professors","13","8","5","0","0","0","0","0","0","2","1","1","1","1","0","0","0","0","8","4","4","0","0","0","2","2","0","0","0","0","-2"
"186399","Rutgers University-Newark","2017","Not on tenure/no tenure system, associate professors","16","12","4","0","0","0","0","0","0","2","2","0","0","0","0","0","0","0","11","9","2","0","0","0","3","1","2","0","0","0","-2"
"186399","Rutgers University-Newark","2017","Not on tenure/no tenure system, assistant professors","75","49","26","0","0","0","6","4","2","5","4","1","2","2","0","0","0","0","41","27","14","0","0","0","18","11","7","3","1","2","-2"
"186399","Rutgers University-Newark","2017","Not on tenure/no tenure system, instructors","43","20","23","0","0","0","3","1","2","7","4","3","1","0","1","0","0","0","13","7","6","0","0","0","18","8","10","1","0","1","-2"
"186399","Rutgers University-Newark","2017","Not on tenure/no tenure system, lecturers","7","6","1","0","0","0","0","0","0","0","0","0","0","0","0","0","0","0","1","1","0","0","0","0","2","1","1","4","4","0","-2"
"186432","Saint Peter's University","2017","Tenured total","69","38","31","0","0","0","3","2","1","4","2","2","3","1","2","0","0","0","59","33","26","0","0","0","0","0","0","0","0","0","-2"
"186432","Saint Peter's University","2017","Tenured, professors","30","18","12","0","0","0","0","0","0","0","0","0","2","0","2","0","0","0","28","18","10","0","0","0","0","0","0","0","0","0","-2"
"186432","Saint Peter's University","2017","Tenured, associate professors","32","15","17","0","0","0","2","2","0","1","0","1","1","1","0","0","0","0","28","12","16","0","0","0","0","0","0","0","0","0","-2"
"186432","Saint Peter's University","2017","Tenured, assistant professors","5","4","1","0","0","0","0","0","0","3","2","1","0","0","0","0","0","0","2","2","0","0","0","0","0","0","0","0","0","0","-2"
"186432","Saint Peter's University","2017","Tenured, lecturers","2","1","1","0","0","0","1","0","1","0","0","0","0","0","0","0","0","0","1","1","0","0","0","0","0","0","0","0","0","0","-2"
"186432","Saint Peter's University","2017","On-Tenure track total","32","19","13","0","0","0","2","1","1","3","1","2","4","3","1","0","0","0","23","14","9","0","0","0","0","0","0","0","0","0","-2"
"186432","Saint Peter's University","2017","On-tenure track, professors","1","1","0","0","0","0","0","0","0","0","0","0","1","1","0","0","0","0","0","0","0","0","0","0","0","0","0","0","0","0","-2"
"186432","Saint Peter's University","2017","On-tenure track, assistant professors","30","18","12","0","0","0","2","1","1","2","1","1","3","2","1","0","0","0","23","14","9","0","0","0","0","0","0","0","0","0","-2"
"186432","Saint Peter's University","2017","On-tenure track, instructors","1","0","1","0","0","0","0","0","0","1","0","1","0","0","0","0","0","0","0","0","0","0","0","0","0","0","0","0","0","0","-2"
"186432","Saint Peter's University","2017","Not on tenure track/No tenure system system total","18","6","12","0","0","0","1","0","1","2","0","2","0","0","0","0","0","0","15","6","9","0","0","0","0","0","0","0","0","0","-2"
"186432","Saint Peter's University","2017","Not on tenure/no tenure system, instructors","6","3","3","0","0","0","1","0","1","1","0","1","0","0","0","0","0","0","4","3","1","0","0","0","0","0","0","0","0","0","-2"
"186432","Saint Peter's University","2017","Not on tenure/no tenure system, lecturers","7","3","4","0","0","0","0","0","0","1","0","1","0","0","0","0","0","0","6","3","3","0","0","0","0","0","0","0","0","0","-2"
"186432","Saint Peter's University","2017","Not on tenure/no tenure system, no academic rank","5","0","5","0","0","0","0","0","0","0","0","0","0","0","0","0","0","0","5","0","5","0","0","0","0","0","0","0","0","0","-2"
"187444","William Paterson University of New Jersey","2017","Tenured total","314","164","150","0","0","0","60","35","25","28","21","7","25","11","14","0","0","0","194","95","99","4","1","3","2","1","1","1","0","1","-2"
"187444","William Paterson University of New Jersey","2017","Tenured, professors","180","110","70","0","0","0","41","28","13","15","12","3","13","8","5","0","0","0","106","60","46","3","1","2","2","1","1","0","0","0","-2"
"187444","William Paterson University of New Jersey","2017","Tenured, associate professors","120","50","70","0","0","0","18","7","11","11","8","3","10","3","7","0","0","0","79","32","47","1","0","1","0","0","0","1","0","1","-2"
"187444","William Paterson University of New Jersey","2017","Tenured, assistant professors","14","4","10","0","0","0","1","0","1","2","1","1","2","0","2","0","0","0","9","3","6","0","0","0","0","0","0","0","0","0","-2"
"187444","William Paterson University of New Jersey","2017","On-Tenure track total","69","33","36","0","0","0","12","2","10","6","2","4","3","2","1","1","1","0","41","22","19","0","0","0","1","0","1","5","4","1","-2"
"187444","William Paterson University of New Jersey","2017","On-tenure track, professors","1","1","0","0","0","0","0","0","0","0","0","0","0","0","0","0","0","0","1","1","0","0","0","0","0","0","0","0","0","0","-2"
"187444","William Paterson University of New Jersey","2017","On-tenure track, associate professors","5","3","2","0","0","0","0","0","0","0","0","0","0","0","0","0","0","0","5","3","2","0","0","0","0","0","0","0","0","0","-2"
"187444","William Paterson University of New Jersey","2017","On-tenure track, assistant professors","61","29","32","0","0","0","12","2","10","5","2","3","3","2","1","1","1","0","34","18","16","0","0","0","1","0","1","5","4","1","-2"
"187444","William Paterson University of New Jersey","2017","On-tenure track, instructors","2","0","2","0","0","0","0","0","0","1","0","1","0","0","0","0","0","0","1","0","1","0","0","0","0","0","0","0","0","0","-2"
"187444","William Paterson University of New Jersey","2017","Not on tenure track/No tenure system system total","27","10","17","0","0","0","2","1","1","3","1","2","2","0","2","0","0","0","19","7","12","0","0","0","0","0","0","1","1","0","-2"
"187444","William Paterson University of New Jersey","2017","Not on tenure/no tenure system, associate professors","1","1","0","0","0","0","0","0","0","0","0","0","0","0","0","0","0","0","1","1","0","0","0","0","0","0","0","0","0","0","-2"
"187444","William Paterson University of New Jersey","2017","Not on tenure/no tenure system, assistant professors","15","3","12","0","0","0","2","1","1","1","0","1","2","0","2","0","0","0","10","2","8","0","0","0","0","0","0","0","0","0","-2"
"187444","William Paterson University of New Jersey","2017","Not on tenure/no tenure system, instructors","11","6","5","0","0","0","0","0","0","2","1","1","0","0","0","0","0","0","8","4","4","0","0","0","0","0","0","1","1","0","-2"
"187648","Eastern New Mexico University-Main Campus","2017","Tenured total","61","35","26","0","0","0","2","2","0","0","0","0","3","1","2","0","0","0","49","28","21","0","0","0","0","0","0","7","4","3","-2"
"187648","Eastern New Mexico University-Main Campus","2017","Tenured, professors","31","21","10","0","0","0","2","2","0","0","0","0","2","1","1","0","0","0","25","16","9","0","0","0","0","0","0","2","2","0","-2"
"187648","Eastern New Mexico University-Main Campus","2017","Tenured, associate professors","21","8","13","0","0","0","0","0","0","0","0","0","1","0","1","0","0","0","15","6","9","0","0","0","0","0","0","5","2","3","-2"
"187648","Eastern New Mexico University-Main Campus","2017","Tenured, assistant professors","4","4","0","0","0","0","0","0","0","0","0","0","0","0","0","0","0","0","4","4","0","0","0","0","0","0","0","0","0","0","-2"
"187648","Eastern New Mexico University-Main Campus","2017","Tenured, instructors","5","2","3","0","0","0","0","0","0","0","0","0","0","0","0","0","0","0","5","2","3","0","0","0","0","0","0","0","0","0","-2"
"187648","Eastern New Mexico University-Main Campus","2017","On-Tenure track total","59","38","21","0","0","0","1","1","0","2","2","0","3","1","2","0","0","0","39","22","17","0","0","0","3","3","0","11","9","2","-2"
"187648","Eastern New Mexico University-Main Campus","2017","On-tenure track, associate professors","2","2","0","0","0","0","0","0","0","1","1","0","0","0","0","0","0","0","1","1","0","0","0","0","0","0","0","0","0","0","-2"
"187648","Eastern New Mexico University-Main Campus","2017","On-tenure track, assistant professors","36","21","15","0","0","0","0","0","0","1","1","0","1","1","0","0","0","0","26","12","14","0","0","0","1","1","0","7","6","1","-2"
"187648","Eastern New Mexico University-Main Campus","2017","On-tenure track, instructors","3","2","1","0","0","0","0","0","0","0","0","0","1","0","1","0","0","0","1","1","0","0","0","0","1","1","0","0","0","0","-2"
"187648","Eastern New Mexico University-Main Campus","2017","On-tenure track, no academic rank","18","13","5","0","0","0","1","1","0","0","0","0","1","0","1","0","0","0","11","8","3","0","0","0","1","1","0","4","3","1","-2"
"187648","Eastern New Mexico University-Main Campus","2017","Not on tenure track/No tenure system system total","41","11","30","0","0","0","0","0","0","0","0","0","3","1","2","0","0","0","35","10","25","1","0","1","2","0","2","0","0","0","-2"
"187648","Eastern New Mexico University-Main Campus","2017","Not on tenure/no tenure system, assistant professors","2","1","1","0","0","0","0","0","0","0","0","0","0","0","0","0","0","0","2","1","1","0","0","0","0","0","0","0","0","0","-2"
"187648","Eastern New Mexico University-Main Campus","2017","Not on tenure/no tenure system, instructors","31","8","23","0","0","0","0","0","0","0","0","0","3","1","2","0","0","0","26","7","19","1","0","1","1","0","1","0","0","0","-2"
"187648","Eastern New Mexico University-Main Campus","2017","Not on tenure/no tenure system, lecturers","2","1","1","0","0","0","0","0","0","0","0","0","0","0","0","0","0","0","2","1","1","0","0","0","0","0","0","0","0","0","-2"
"187648","Eastern New Mexico University-Main Campus","2017","Not on tenure/no tenure system, no academic rank","6","1","5","0","0","0","0","0","0","0","0","0","0","0","0","0","0","0","5","1","4","0","0","0","1","0","1","0","0","0","-2"
"187897","New Mexico Highlands University","2017","Tenured total","53","31","22","0","0","0","2","1","1","2","1","1","11","7","4","0","0","0","33","20","13","2","1","1","1","0","1","2","1","1","-2"
"187897","New Mexico Highlands University","2017","Tenured, professors","27","14","13","0","0","0","0","0","0","0","0","0","4","3","1","0","0","0","21","11","10","0","0","0","1","0","1","1","0","1","-2"
"187897","New Mexico Highlands University","2017","Tenured, associate professors","25","16","9","0","0","0","2","1","1","2","1","1","6","3","3","0","0","0","12","9","3","2","1","1","0","0","0","1","1","0","-2"
"187897","New Mexico Highlands University","2017","Tenured, assistant professors","1","1","0","0","0","0","0","0","0","0","0","0","1","1","0","0","0","0","0","0","0","0","0","0","0","0","0","0","0","0","-2"
"187897","New Mexico Highlands University","2017","On-Tenure track total","37","15","22","1","1","0","2","2","0","0","0","0","10","4","6","0","0","0","17","6","11","0","0","0","2","0","2","5","2","3","-2"
"187897","New Mexico Highlands University","2017","On-tenure track, professors","1","1","0","1","1","0","0","0","0","0","0","0","0","0","0","0","0","0","0","0","0","0","0","0","0","0","0","0","0","0","-2"
"187897","New Mexico Highlands University","2017","On-tenure track, associate professors","6","3","3","0","0","0","1","1","0","0","0","0","1","1","0","0","0","0","4","1","3","0","0","0","0","0","0","0","0","0","-2"
"187897","New Mexico Highlands University","2017","On-tenure track, assistant professors","30","11","19","0","0","0","1","1","0","0","0","0","9","3","6","0","0","0","13","5","8","0","0","0","2","0","2","5","2","3","-2"
"187897","New Mexico Highlands University","2017","Not on tenure track/No tenure system system total","51","28","23","0","0","0","1","0","1","0","0","0","19","9","10","0","0","0","26","16","10","0","0","0","2","1","1","3","2","1","-2"
"187897","New Mexico Highlands University","2017","Not on tenure/no tenure system, assistant professors","1","1","0","0","0","0","0","0","0","0","0","0","1","1","0","0","0","0","0","0","0","0","0","0","0","0","0","0","0","0","-2"
"187897","New Mexico Highlands University","2017","Not on tenure/no tenure system, instructors","12","6","6","0","0","0","1","0","1","0","0","0","5","2","3","0","0","0","5","3","2","0","0","0","1","1","0","0","0","0","-2"
"187897","New Mexico Highlands University","2017","Not on tenure/no tenure system, lecturers","24","12","12","0","0","0","0","0","0","0","0","0","6","2","4","0","0","0","14","8","6","0","0","0","1","0","1","3","2","1","-2"
"187897","New Mexico Highlands University","2017","Not on tenure/no tenure system, no academic rank","14","9","5","0","0","0","0","0","0","0","0","0","7","4","3","0","0","0","7","5","2","0","0","0","0","0","0","0","0","0","-2"
"187985","University of New Mexico-Main Campus","2017","Tenured total","599","339","260","18","7","11","64","43","21","8","4","4","77","33","44","0","0","0","396","232","164","2","0","2","29","15","14","5","5","0","-2"
"187985","University of New Mexico-Main Campus","2017","Tenured, professors","313","201","112","10","4","6","36","26","10","1","1","0","32","16","16","0","0","0","227","150","77","0","0","0","6","3","3","1","1","0","-2"
"187985","University of New Mexico-Main Campus","2017","Tenured, associate professors","285","137","148","8","3","5","28","17","11","7","3","4","44","16","28","0","0","0","169","82","87","2","0","2","23","12","11","4","4","0","-2"
"187985","University of New Mexico-Main Campus","2017","Tenured, assistant professors","1","1","0","0","0","0","0","0","0","0","0","0","1","1","0","0","0","0","0","0","0","0","0","0","0","0","0","0","0","0","-2"
"187985","University of New Mexico-Main Campus","2017","On-Tenure track total","291","148","143","10","2","8","31","20","11","5","1","4","34","13","21","0","0","0","137","69","68","3","2","1","41","24","17","30","17","13","-2"
"187985","University of New Mexico-Main Campus","2017","On-tenure track, professors","6","5","1","0","0","0","0","0","0","0","0","0","0","0","0","0","0","0","6","5","1","0","0","0","0","0","0","0","0","0","-2"
"187985","University of New Mexico-Main Campus","2017","On-tenure track, associate professors","22","8","14","1","0","1","1","0","1","0","0","0","2","0","2","0","0","0","14","6","8","0","0","0","3","1","2","1","1","0","-2"
"187985","University of New Mexico-Main Campus","2017","On-tenure track, assistant professors","261","133","128","9","2","7","30","20","10","5","1","4","32","13","19","0","0","0","116","57","59","3","2","1","37","22","15","29","16","13","-2"
"187985","University of New Mexico-Main Campus","2017","On-tenure track, no academic rank","2","2","0","0","0","0","0","0","0","0","0","0","0","0","0","0","0","0","1","1","0","0","0","0","1","1","0","0","0","0","-2"
"187985","University of New Mexico-Main Campus","2017","Not on tenure track/No tenure system system total","851","377","474","5","2","3","71","41","30","15","4","11","125","46","79","1","0","1","555","247","308","14","3","11","23","9","14","42","25","17","-2"
"187985","University of New Mexico-Main Campus","2017","Not on tenure/no tenure system, professors","103","59","44","1","1","0","6","4","2","0","0","0","5","3","2","0","0","0","86","48","38","1","1","0","4","2","2","0","0","0","-2"
"187985","University of New Mexico-Main Campus","2017","Not on tenure/no tenure system, associate professors","158","77","81","1","0","1","21","12","9","5","2","3","23","10","13","1","0","1","102","49","53","1","1","0","3","2","1","1","1","0","-2"
"187985","University of New Mexico-Main Campus","2017","Not on tenure/no tenure system, assistant professors","323","139","184","0","0","0","38","22","16","4","0","4","47","17","30","0","0","0","185","78","107","8","1","7","5","0","5","36","21","15","-2"
"187985","University of New Mexico-Main Campus","2017","Not on tenure/no tenure system, instructors","66","25","41","0","0","0","3","2","1","0","0","0","11","1","10","0","0","0","48","20","28","1","0","1","2","1","1","1","1","0","-2"
"187985","University of New Mexico-Main Campus","2017","Not on tenure/no tenure system, lecturers","198","75","123","3","1","2","3","1","2","6","2","4","38","14","24","0","0","0","132","51","81","3","0","3","9","4","5","4","2","2","-2"
"187985","University of New Mexico-Main Campus","2017","Not on tenure/no tenure system, no academic rank","3","2","1","0","0","0","0","0","0","0","0","0","1","1","0","0","0","0","2","1","1","0","0","0","0","0","0","0","0","0","-2"
"188030","New Mexico State University-Main Campus","2017","Tenured total","378","240","138","2","2","0","45","35","10","5","4","1","53","26","27","1","0","1","261","164","97","4","3","1","0","0","0","7","6","1","-2"
"188030","New Mexico State University-Main Campus","2017","Tenured, professors","201","142","59","2","2","0","22","18","4","3","3","0","15","9","6","0","0","0","155","106","49","1","1","0","0","0","0","3","3","0","-2"
"188030","New Mexico State University-Main Campus","2017","Tenured, associate professors","169","96","73","0","0","0","23","17","6","2","1","1","35","17","18","1","0","1","101","56","45","3","2","1","0","0","0","4","3","1","-2"
"188030","New Mexico State University-Main Campus","2017","Tenured, assistant professors","8","2","6","0","0","0","0","0","0","0","0","0","3","0","3","0","0","0","5","2","3","0","0","0","0","0","0","0","0","0","-2"
"188030","New Mexico State University-Main Campus","2017","On-Tenure track total","143","76","67","0","0","0","11","6","5","3","1","2","26","14","12","0","0","0","81","41","40","1","0","1","0","0","0","21","14","7","-2"
"188030","New Mexico State University-Main Campus","2017","On-tenure track, associate professors","4","2","2","0","0","0","0","0","0","0","0","0","0","0","0","0","0","0","4","2","2","0","0","0","0","0","0","0","0","0","-2"
"188030","New Mexico State University-Main Campus","2017","On-tenure track, assistant professors","139","74","65","0","0","0","11","6","5","3","1","2","26","14","12","0","0","0","77","39","38","1","0","1","0","0","0","21","14","7","-2"
"188030","New Mexico State University-Main Campus","2017","Not on tenure track/No tenure system system total","118","45","73","1","1","0","4","1","3","0","0","0","26","3","23","0","0","0","82","37","45","4","2","2","0","0","0","1","1","0","-2"
"188030","New Mexico State University-Main Campus","2017","Not on tenure/no tenure system, professors","13","5","8","0","0","0","0","0","0","0","0","0","0","0","0","0","0","0","13","5","8","0","0","0","0","0","0","0","0","0","-2"
"188030","New Mexico State University-Main Campus","2017","Not on tenure/no tenure system, associate professors","24","7","17","0","0","0","0","0","0","0","0","0","5","0","5","0","0","0","17","5","12","2","2","0","0","0","0","0","0","0","-2"
"188030","New Mexico State University-Main Campus","2017","Not on tenure/no tenure system, assistant professors","52","18","34","0","0","0","2","0","2","0","0","0","14","2","12","0","0","0","33","15","18","2","0","2","0","0","0","1","1","0","-2"
"188030","New Mexico State University-Main Campus","2017","Not on tenure/no tenure system, instructors","5","2","3","0","0","0","1","1","0","0","0","0","2","0","2","0","0","0","2","1","1","0","0","0","0","0","0","0","0","0","-2"
"188030","New Mexico State University-Main Campus","2017","Not on tenure/no tenure system, no academic rank","24","13","11","1","1","0","1","0","1","0","0","0","5","1","4","0","0","0","17","11","6","0","0","0","0","0","0","0","0","0","-2"
"188058","Northern New Mexico College","2017","Tenured total","15","5","10","0","0","0","1","1","0","0","0","0","9","2","7","0","0","0","4","2","2","0","0","0","1","0","1","0","0","0","-2"
"188058","Northern New Mexico College","2017","Tenured, associate professors","15","5","10","0","0","0","1","1","0","0","0","0","9","2","7","0","0","0","4","2","2","0","0","0","1","0","1","0","0","0","-2"
"188058","Northern New Mexico College","2017","On-Tenure track total","18","7","11","0","0","0","3","2","1","0","0","0","5","2","3","0","0","0","7","3","4","0","0","0","3","0","3","0","0","0","-2"
"188058","Northern New Mexico College","2017","On-tenure track, assistant professors","18","7","11","0","0","0","3","2","1","0","0","0","5","2","3","0","0","0","7","3","4","0","0","0","3","0","3","0","0","0","-2"
"188058","Northern New Mexico College","2017","Not on tenure track/No tenure system system total","4","1","3","0","0","0","0","0","0","0","0","0","2","0","2","0","0","0","2","1","1","0","0","0","0","0","0","0","0","0","-2"
"188058","Northern New Mexico College","2017","Not on tenure/no tenure system, no academic rank","4","1","3","0","0","0","0","0","0","0","0","0","2","0","2","0","0","0","2","1","1","0","0","0","0","0","0","0","0","0","-2"
"188182","University of the Southwest","2017","Not on tenure track/No tenure system system total","24","12","12","0","0","0","1","1","0","1","0","1","1","1","0","0","0","0","9","2","7","0","0","0","12","8","4","0","0","0","-2"
"188182","University of the Southwest","2017","Not on tenure/no tenure system, professors","2","1","1","0","0","0","0","0","0","0","0","0","0","0","0","0","0","0","1","0","1","0","0","0","1","1","0","0","0","0","-2"
"188182","University of the Southwest","2017","Not on tenure/no tenure system, associate professors","2","1","1","0","0","0","0","0","0","0","0","0","0","0","0","0","0","0","1","0","1","0","0","0","1","1","0","0","0","0","-2"
"188182","University of the Southwest","2017","Not on tenure/no tenure system, assistant professors","14","6","8","0","0","0","1","1","0","1","0","1","1","1","0","0","0","0","4","1","3","0","0","0","7","3","4","0","0","0","-2"
"188182","University of the Southwest","2017","Not on tenure/no tenure system, instructors","3","2","1","0","0","0","0","0","0","0","0","0","0","0","0","0","0","0","1","0","1","0","0","0","2","2","0","0","0","0","-2"
"188182","University of the Southwest","2017","Not on tenure/no tenure system, lecturers","3","2","1","0","0","0","0","0","0","0","0","0","0","0","0","0","0","0","2","1","1","0","0","0","1","1","0","0","0","0","-2"
"188304","Western New Mexico University","2017","Tenured total","36","22","14","0","0","0","0","0","0","0","0","0","8","5","3","0","0","0","21","13","8","0","0","0","7","4","3","0","0","0","-2"
"188304","Western New Mexico University","2017","Tenured, professors","20","12","8","0","0","0","0","0","0","0","0","0","1","0","1","0","0","0","14","9","5","0","0","0","5","3","2","0","0","0","-2"
"188304","Western New Mexico University","2017","Tenured, associate professors","16","10","6","0","0","0","0","0","0","0","0","0","7","5","2","0","0","0","7","4","3","0","0","0","2","1","1","0","0","0","-2"
"188304","Western New Mexico University","2017","On-Tenure track total","52","17","35","0","0","0","6","3","3","1","1","0","9","3","6","0","0","0","30","8","22","0","0","0","6","2","4","0","0","0","-2"
"188304","Western New Mexico University","2017","On-tenure track, associate professors","5","0","5","0","0","0","0","0","0","0","0","0","0","0","0","0","0","0","4","0","4","0","0","0","1","0","1","0","0","0","-2"
"188304","Western New Mexico University","2017","On-tenure track, assistant professors","46","17","29","0","0","0","6","3","3","1","1","0","9","3","6","0","0","0","25","8","17","0","0","0","5","2","3","0","0","0","-2"
"188304","Western New Mexico University","2017","On-tenure track, instructors","1","0","1","0","0","0","0","0","0","0","0","0","0","0","0","0","0","0","1","0","1","0","0","0","0","0","0","0","0","0","-2"
"188304","Western New Mexico University","2017","Not on tenure track/No tenure system system total","12","5","7","0","0","0","0","0","0","0","0","0","1","0","1","0","0","0","7","2","5","0","0","0","4","3","1","0","0","0","-2"
"188304","Western New Mexico University","2017","Not on tenure/no tenure system, assistant professors","8","1","7","0","0","0","0","0","0","0","0","0","1","0","1","0","0","0","6","1","5","0","0","0","1","0","1","0","0","0","-2"
"188304","Western New Mexico University","2017","Not on tenure/no tenure system, lecturers","4","4","0","0","0","0","0","0","0","0","0","0","0","0","0","0","0","0","1","1","0","0","0","0","3","3","0","0","0","0","-2"
"188340","Vaughn College of Aeronautics and Technology","2017","Tenured total","18","13","5","0","0","0","1","0","1","1","0","1","0","0","0","4","4","0","12","9","3","0","0","0","0","0","0","0","0","0","-2"
"188340","Vaughn College of Aeronautics and Technology","2017","Tenured, professors","12","10","2","0","0","0","0","0","0","1","0","1","0","0","0","2","2","0","9","8","1","0","0","0","0","0","0","0","0","0","-2"
"188340","Vaughn College of Aeronautics and Technology","2017","Tenured, associate professors","6","3","3","0","0","0","1","0","1","0","0","0","0","0","0","2","2","0","3","1","2","0","0","0","0","0","0","0","0","0","-2"
"188340","Vaughn College of Aeronautics and Technology","2017","On-Tenure track total","8","5","3","0","0","0","2","1","1","0","0","0","0","0","0","0","0","0","6","4","2","0","0","0","0","0","0","0","0","0","-2"
"188340","Vaughn College of Aeronautics and Technology","2017","On-tenure track, associate professors","1","1","0","0","0","0","0","0","0","0","0","0","0","0","0","0","0","0","1","1","0","0","0","0","0","0","0","0","0","0","-2"
"188340","Vaughn College of Aeronautics and Technology","2017","On-tenure track, assistant professors","7","4","3","0","0","0","2","1","1","0","0","0","0","0","0","0","0","0","5","3","2","0","0","0","0","0","0","0","0","0","-2"
"188340","Vaughn College of Aeronautics and Technology","2017","Not on tenure track/No tenure system system total","11","9","2","0","0","0","0","0","0","2","2","0","1","0","1","2","2","0","5","4","1","1","1","0","0","0","0","0","0","0","-2"
"188340","Vaughn College of Aeronautics and Technology","2017","Not on tenure/no tenure system, associate professors","2","2","0","0","0","0","0","0","0","1","1","0","0","0","0","0","0","0","1","1","0","0","0","0","0","0","0","0","0","0","-2"
"188340","Vaughn College of Aeronautics and Technology","2017","Not on tenure/no tenure system, assistant professors","5","3","2","0","0","0","0","0","0","0","0","0","1","0","1","1","1","0","3","2","1","0","0","0","0","0","0","0","0","0","-2"
"188340","Vaughn College of Aeronautics and Technology","2017","Not on tenure/no tenure system, instructors","4","4","0","0","0","0","0","0","0","1","1","0","0","0","0","1","1","0","1","1","0","1","1","0","0","0","0","0","0","0","-2"
"189413","Boricua College","2017","Not on tenure track/No tenure system system total","42","20","22","1","0","1","0","0","0","3","1","2","33","19","14","0","0","0","5","0","5","0","0","0","0","0","0","0","0","0","-2"
"189413","Boricua College","2017","Not on tenure/no tenure system, professors","4","2","2","0","0","0","0","0","0","1","1","0","3","1","2","0","0","0","0","0","0","0","0","0","0","0","0","0","0","0","-2"
"189413","Boricua College","2017","Not on tenure/no tenure system, associate professors","9","5","4","0","0","0","0","0","0","0","0","0","7","5","2","0","0","0","2","0","2","0","0","0","0","0","0","0","0","0","-2"
"189413","Boricua College","2017","Not on tenure/no tenure system, assistant professors","19","11","8","0","0","0","0","0","0","1","0","1","17","11","6","0","0","0","1","0","1","0","0","0","0","0","0","0","0","0","-2"
"189413","Boricua College","2017","Not on tenure/no tenure system, instructors","10","2","8","1","0","1","0","0","0","1","0","1","6","2","4","0","0","0","2","0","2","0","0","0","0","0","0","0","0","0","-2"
"190114","Metropolitan College of New York","2017","Not on tenure track/No tenure system system total","21","12","9","0","0","0","1","0","1","4","2","2","1","0","1","0","0","0","14","10","4","1","0","1","0","0","0","0","0","0","-2"
"190114","Metropolitan College of New York","2017","Not on tenure/no tenure system, professors","11","7","4","0","0","0","1","0","1","0","0","0","1","0","1","0","0","0","9","7","2","0","0","0","0","0","0","0","0","0","-2"
"190114","Metropolitan College of New York","2017","Not on tenure/no tenure system, associate professors","7","5","2","0","0","0","0","0","0","3","2","1","0","0","0","0","0","0","4","3","1","0","0","0","0","0","0","0","0","0","-2"
"190114","Metropolitan College of New York","2017","Not on tenure/no tenure system, assistant professors","3","0","3","0","0","0","0","0","0","1","0","1","0","0","0","0","0","0","1","0","1","1","0","1","0","0","0","0","0","0","-2"
"190558","College of Staten Island CUNY","2017","Tenured total","265","150","115","1","1","0","41","23","18","9","6","3","18","11","7","0","0","0","195","108","87","0","0","0","1","1","0","0","0","0","-2"
"190558","College of Staten Island CUNY","2017","Tenured, professors","121","78","43","0","0","0","19","12","7","3","2","1","9","7","2","0","0","0","89","56","33","0","0","0","1","1","0","0","0","0","-2"
"190558","College of Staten Island CUNY","2017","Tenured, associate professors","109","56","53","1","1","0","21","11","10","5","3","2","7","4","3","0","0","0","75","37","38","0","0","0","0","0","0","0","0","0","-2"
"190558","College of Staten Island CUNY","2017","Tenured, assistant professors","15","8","7","0","0","0","0","0","0","1","1","0","0","0","0","0","0","0","14","7","7","0","0","0","0","0","0","0","0","0","-2"
"190558","College of Staten Island CUNY","2017","Tenured, lecturers","20","8","12","0","0","0","1","0","1","0","0","0","2","0","2","0","0","0","17","8","9","0","0","0","0","0","0","0","0","0","-2"
"190558","College of Staten Island CUNY","2017","On-Tenure track total","91","45","46","0","0","0","16","5","11","3","0","3","5","3","2","0","0","0","46","24","22","2","0","2","0","0","0","19","13","6","-2"
"190558","College of Staten Island CUNY","2017","On-tenure track, professors","2","2","0","0","0","0","1","1","0","0","0","0","0","0","0","0","0","0","1","1","0","0","0","0","0","0","0","0","0","0","-2"
"190558","College of Staten Island CUNY","2017","On-tenure track, associate professors","5","2","3","0","0","0","0","0","0","1","0","1","0","0","0","0","0","0","3","1","2","0","0","0","0","0","0","1","1","0","-2"
"190558","College of Staten Island CUNY","2017","On-tenure track, assistant professors","74","37","37","0","0","0","13","4","9","2","0","2","4","3","1","0","0","0","36","18","18","1","0","1","0","0","0","18","12","6","-2"
"190558","College of Staten Island CUNY","2017","On-tenure track, lecturers","10","4","6","0","0","0","2","0","2","0","0","0","1","0","1","0","0","0","6","4","2","1","0","1","0","0","0","0","0","0","-2"
"190558","College of Staten Island CUNY","2017","Not on tenure track/No tenure system system total","15","5","10","0","0","0","2","2","0","1","0","1","3","2","1","0","0","0","9","1","8","0","0","0","0","0","0","0","0","0","-2"
"190558","College of Staten Island CUNY","2017","Not on tenure/no tenure system, professors","2","0","2","0","0","0","0","0","0","0","0","0","0","0","0","0","0","0","2","0","2","0","0","0","0","0","0","0","0","0","-2"
"190558","College of Staten Island CUNY","2017","Not on tenure/no tenure system, assistant professors","1","0","1","0","0","0","0","0","0","1","0","1","0","0","0","0","0","0","0","0","0","0","0","0","0","0","0","0","0","0","-2"
"190558","College of Staten Island CUNY","2017","Not on tenure/no tenure system, lecturers","12","5","7","0","0","0","2","2","0","0","0","0","3","2","1","0","0","0","7","1","6","0","0","0","0","0","0","0","0","0","-2"
"190594","CUNY Hunter College","2017","Tenured total","469","239","230","0","0","0","49","22","27","47","24","23","53","20","33","0","0","0","315","172","143","3","1","2","0","0","0","2","0","2","-2"
"190594","CUNY Hunter College","2017","Tenured, professors","233","126","107","0","0","0","17","10","7","18","10","8","21","9","12","0","0","0","176","96","80","1","1","0","0","0","0","0","0","0","-2"
"190594","CUNY Hunter College","2017","Tenured, associate professors","191","93","98","0","0","0","28","12","16","22","12","10","25","8","17","0","0","0","113","61","52","2","0","2","0","0","0","1","0","1","-2"
"190594","CUNY Hunter College","2017","Tenured, assistant professors","15","8","7","0","0","0","1","0","1","2","1","1","2","2","0","0","0","0","10","5","5","0","0","0","0","0","0","0","0","0","-2"
"190594","CUNY Hunter College","2017","Tenured, lecturers","30","12","18","0","0","0","3","0","3","5","1","4","5","1","4","0","0","0","16","10","6","0","0","0","0","0","0","1","0","1","-2"
"190594","CUNY Hunter College","2017","On-Tenure track total","117","49","68","1","0","1","15","4","11","6","2","4","10","3","7","0","0","0","73","33","40","2","1","1","0","0","0","10","6","4","-2"
"190594","CUNY Hunter College","2017","On-tenure track, professors","2","0","2","0","0","0","1","0","1","0","0","0","0","0","0","0","0","0","1","0","1","0","0","0","0","0","0","0","0","0","-2"
"190594","CUNY Hunter College","2017","On-tenure track, associate professors","15","10","5","0","0","0","4","1","3","1","1","0","1","1","0","0","0","0","9","7","2","0","0","0","0","0","0","0","0","0","-2"
"190594","CUNY Hunter College","2017","On-tenure track, assistant professors","69","27","42","1","0","1","7","1","6","4","1","3","5","1","4","0","0","0","43","17","26","1","1","0","0","0","0","8","6","2","-2"
"190594","CUNY Hunter College","2017","On-tenure track, lecturers","31","12","19","0","0","0","3","2","1","1","0","1","4","1","3","0","0","0","20","9","11","1","0","1","0","0","0","2","0","2","-2"
"190594","CUNY Hunter College","2017","Not on tenure track/No tenure system system total","58","21","37","0","0","0","2","0","2","3","0","3","4","4","0","0","0","0","45","16","29","2","0","2","0","0","0","2","1","1","-2"
"190594","CUNY Hunter College","2017","Not on tenure/no tenure system, professors","49","16","33","0","0","0","2","0","2","2","0","2","3","3","0","0","0","0","40","13","27","1","0","1","0","0","0","1","0","1","-2"
"190594","CUNY Hunter College","2017","Not on tenure/no tenure system, assistant professors","3","3","0","0","0","0","0","0","0","0","0","0","1","1","0","0","0","0","1","1","0","0","0","0","0","0","0","1","1","0","-2"
"190594","CUNY Hunter College","2017","Not on tenure/no tenure system, instructors","1","0","1","0","0","0","0","0","0","0","0","0","0","0","0","0","0","0","1","0","1","0","0","0","0","0","0","0","0","0","-2"
"190594","CUNY Hunter College","2017","Not on tenure/no tenure system, lecturers","5","2","3","0","0","0","0","0","0","1","0","1","0","0","0","0","0","0","3","2","1","1","0","1","0","0","0","0","0","0","-2"
"190600","CUNY John Jay College of Criminal Justice","2017","Tenured total","303","165","138","0","0","0","25","9","16","37","19","18","31","12","19","2","0","2","195","120","75","0","0","0","0","0","0","13","5","8","-2"
"190600","CUNY John Jay College of Criminal Justice","2017","Tenured, professors","102","63","39","0","0","0","6","2","4","7","2","5","6","3","3","0","0","0","81","55","26","0","0","0","0","0","0","2","1","1","-2"
"190600","CUNY John Jay College of Criminal Justice","2017","Tenured, associate professors","152","80","72","0","0","0","15","6","9","21","13","8","17","6","11","1","0","1","88","52","36","0","0","0","0","0","0","10","3","7","-2"
"190600","CUNY John Jay College of Criminal Justice","2017","Tenured, assistant professors","21","8","13","0","0","0","3","1","2","4","1","3","5","3","2","0","0","0","9","3","6","0","0","0","0","0","0","0","0","0","-2"
"190600","CUNY John Jay College of Criminal Justice","2017","Tenured, lecturers","28","14","14","0","0","0","1","0","1","5","3","2","3","0","3","1","0","1","17","10","7","0","0","0","0","0","0","1","1","0","-2"
"190600","CUNY John Jay College of Criminal Justice","2017","On-Tenure track total","71","34","37","0","0","0","3","2","1","5","2","3","7","6","1","2","1","1","42","18","24","2","2","0","0","0","0","10","3","7","-2"
"190600","CUNY John Jay College of Criminal Justice","2017","On-tenure track, associate professors","7","4","3","0","0","0","1","0","1","0","0","0","1","1","0","0","0","0","5","3","2","0","0","0","0","0","0","0","0","0","-2"
"190600","CUNY John Jay College of Criminal Justice","2017","On-tenure track, assistant professors","56","24","32","0","0","0","2","2","0","3","0","3","3","2","1","1","1","0","36","15","21","1","1","0","0","0","0","10","3","7","-2"
"190600","CUNY John Jay College of Criminal Justice","2017","On-tenure track, lecturers","8","6","2","0","0","0","0","0","0","2","2","0","3","3","0","1","0","1","1","0","1","1","1","0","0","0","0","0","0","0","-2"
"190600","CUNY John Jay College of Criminal Justice","2017","Not on tenure track/No tenure system system total","24","14","10","0","0","0","0","0","0","2","1","1","1","0","1","0","0","0","21","13","8","0","0","0","0","0","0","0","0","0","-2"
"190600","CUNY John Jay College of Criminal Justice","2017","Not on tenure/no tenure system, professors","4","3","1","0","0","0","0","0","0","0","0","0","0","0","0","0","0","0","4","3","1","0","0","0","0","0","0","0","0","0","-2"
"190600","CUNY John Jay College of Criminal Justice","2017","Not on tenure/no tenure system, associate professors","1","1","0","0","0","0","0","0","0","0","0","0","0","0","0","0","0","0","1","1","0","0","0","0","0","0","0","0","0","0","-2"
"190600","CUNY John Jay College of Criminal Justice","2017","Not on tenure/no tenure system, assistant professors","10","4","6","0","0","0","0","0","0","1","0","1","1","0","1","0","0","0","8","4","4","0","0","0","0","0","0","0","0","0","-2"
"190600","CUNY John Jay College of Criminal Justice","2017","Not on tenure/no tenure system, lecturers","9","6","3","0","0","0","0","0","0","1","1","0","0","0","0","0","0","0","8","5","3","0","0","0","0","0","0","0","0","0","-2"
"190637","CUNY Lehman College","2017","Tenured total","237","122","115","2","0","2","14","10","4","24","9","15","33","21","12","0","0","0","162","81","81","0","0","0","0","0","0","2","1","1","-2"
"190637","CUNY Lehman College","2017","Tenured, professors","81","51","30","1","0","1","3","2","1","3","2","1","8","6","2","0","0","0","66","41","25","0","0","0","0","0","0","0","0","0","-2"
"190637","CUNY Lehman College","2017","Tenured, associate professors","112","51","61","1","0","1","7","4","3","12","6","6","17","9","8","0","0","0","74","31","43","0","0","0","0","0","0","1","1","0","-2"
"190637","CUNY Lehman College","2017","Tenured, assistant professors","14","6","8","0","0","0","3","3","0","4","0","4","1","1","0","0","0","0","6","2","4","0","0","0","0","0","0","0","0","0","-2"
"190637","CUNY Lehman College","2017","Tenured, lecturers","30","14","16","0","0","0","1","1","0","5","1","4","7","5","2","0","0","0","16","7","9","0","0","0","0","0","0","1","0","1","-2"
"190637","CUNY Lehman College","2017","On-Tenure track total","102","40","62","0","0","0","10","3","7","12","3","9","8","2","6","0","0","0","59","25","34","1","1","0","0","0","0","12","6","6","-2"
"190637","CUNY Lehman College","2017","On-tenure track, associate professors","5","3","2","0","0","0","2","2","0","0","0","0","0","0","0","0","0","0","3","1","2","0","0","0","0","0","0","0","0","0","-2"
"190637","CUNY Lehman College","2017","On-tenure track, assistant professors","77","31","46","0","0","0","6","1","5","9","3","6","8","2","6","0","0","0","44","20","24","0","0","0","0","0","0","10","5","5","-2"
"190637","CUNY Lehman College","2017","On-tenure track, lecturers","20","6","14","0","0","0","2","0","2","3","0","3","0","0","0","0","0","0","12","4","8","1","1","0","0","0","0","2","1","1","-2"
"190637","CUNY Lehman College","2017","Not on tenure track/No tenure system system total","23","9","14","0","0","0","3","2","1","2","1","1","5","3","2","0","0","0","12","3","9","0","0","0","0","0","0","1","0","1","-2"
"190637","CUNY Lehman College","2017","Not on tenure/no tenure system, professors","2","1","1","0","0","0","0","0","0","1","1","0","0","0","0","0","0","0","1","0","1","0","0","0","0","0","0","0","0","0","-2"
"190637","CUNY Lehman College","2017","Not on tenure/no tenure system, assistant professors","6","1","5","0","0","0","0","0","0","0","0","0","1","0","1","0","0","0","4","1","3","0","0","0","0","0","0","1","0","1","-2"
"190637","CUNY Lehman College","2017","Not on tenure/no tenure system, instructors","3","2","1","0","0","0","1","1","0","0","0","0","0","0","0","0","0","0","2","1","1","0","0","0","0","0","0","0","0","0","-2"
"190637","CUNY Lehman College","2017","Not on tenure/no tenure system, lecturers","12","5","7","0","0","0","2","1","1","1","0","1","4","3","1","0","0","0","5","1","4","0","0","0","0","0","0","0","0","0","-2"
"190655","CUNY New York City College of Technology","2017","Tenured total","278","147","131","2","1","1","38","18","20","36","20","16","20","11","9","0","0","0","170","89","81","0","0","0","0","0","0","12","8","4","-2"
"190655","CUNY New York City College of Technology","2017","Tenured, professors","76","42","34","0","0","0","9","2","7","12","8","4","5","3","2","0","0","0","48","27","21","0","0","0","0","0","0","2","2","0","-2"
"190655","CUNY New York City College of Technology","2017","Tenured, associate professors","122","60","62","1","0","1","17","8","9","13","6","7","8","5","3","0","0","0","76","37","39","0","0","0","0","0","0","7","4","3","-2"
"190655","CUNY New York City College of Technology","2017","Tenured, assistant professors","60","35","25","1","1","0","12","8","4","4","2","2","6","3","3","0","0","0","34","19","15","0","0","0","0","0","0","3","2","1","-2"
"190655","CUNY New York City College of Technology","2017","Tenured, lecturers","20","10","10","0","0","0","0","0","0","7","4","3","1","0","1","0","0","0","12","6","6","0","0","0","0","0","0","0","0","0","-2"
"190655","CUNY New York City College of Technology","2017","On-Tenure track total","121","60","61","0","0","0","27","17","10","13","3","10","10","6","4","0","0","0","64","28","36","0","0","0","1","1","0","6","5","1","-2"
"190655","CUNY New York City College of Technology","2017","On-tenure track, associate professors","6","4","2","0","0","0","2","2","0","1","0","1","0","0","0","0","0","0","1","1","0","0","0","0","0","0","0","2","1","1","-2"
"190655","CUNY New York City College of Technology","2017","On-tenure track, assistant professors","113","54","59","0","0","0","24","14","10","11","2","9","10","6","4","0","0","0","63","27","36","0","0","0","1","1","0","4","4","0","-2"
"190655","CUNY New York City College of Technology","2017","On-tenure track, lecturers","2","2","0","0","0","0","1","1","0","1","1","0","0","0","0","0","0","0","0","0","0","0","0","0","0","0","0","0","0","0","-2"
"190655","CUNY New York City College of Technology","2017","Not on tenure track/No tenure system system total","12","5","7","0","0","0","0","0","0","3","1","2","0","0","0","0","0","0","7","3","4","0","0","0","0","0","0","2","1","1","-2"
"190655","CUNY New York City College of Technology","2017","Not on tenure/no tenure system, assistant professors","5","3","2","0","0","0","0","0","0","1","1","0","0","0","0","0","0","0","2","1","1","0","0","0","0","0","0","2","1","1","-2"
"190655","CUNY New York City College of Technology","2017","Not on tenure/no tenure system, instructors","1","0","1","0","0","0","0","0","0","0","0","0","0","0","0","0","0","0","1","0","1","0","0","0","0","0","0","0","0","0","-2"
"190655","CUNY New York City College of Technology","2017","Not on tenure/no tenure system, lecturers","6","2","4","0","0","0","0","0","0","2","0","2","0","0","0","0","0","0","4","2","2","0","0","0","0","0","0","0","0","0","-2"
"190664","CUNY Queens College","2017","Tenured total","446","247","199","0","0","0","49","21","28","20","13","7","25","10","15","0","0","0","329","195","134","3","3","0","0","0","0","20","5","15","-2"
"190664","CUNY Queens College","2017","Tenured, professors","193","131","62","0","0","0","21","12","9","9","6","3","11","5","6","0","0","0","148","105","43","1","1","0","0","0","0","3","2","1","-2"
"190664","CUNY Queens College","2017","Tenured, associate professors","176","82","94","0","0","0","23","8","15","9","5","4","13","4","9","0","0","0","114","60","54","2","2","0","0","0","0","15","3","12","-2"
"190664","CUNY Queens College","2017","Tenured, assistant professors","14","7","7","0","0","0","2","1","1","1","1","0","0","0","0","0","0","0","10","5","5","0","0","0","0","0","0","1","0","1","-2"
"190664","CUNY Queens College","2017","Tenured, lecturers","63","27","36","0","0","0","3","0","3","1","1","0","1","1","0","0","0","0","57","25","32","0","0","0","0","0","0","1","0","1","-2"
"190664","CUNY Queens College","2017","On-Tenure track total","99","51","48","0","0","0","9","5","4","11","4","7","12","8","4","0","0","0","46","23","23","2","1","1","1","1","0","18","9","9","-2"
"190664","CUNY Queens College","2017","On-tenure track, professors","1","1","0","0","0","0","0","0","0","1","1","0","0","0","0","0","0","0","0","0","0","0","0","0","0","0","0","0","0","0","-2"
"190664","CUNY Queens College","2017","On-tenure track, associate professors","6","4","2","0","0","0","0","0","0","0","0","0","1","1","0","0","0","0","3","2","1","0","0","0","1","1","0","1","0","1","-2"
"190664","CUNY Queens College","2017","On-tenure track, assistant professors","70","38","32","0","0","0","6","5","1","8","2","6","9","6","3","0","0","0","29","15","14","2","1","1","0","0","0","16","9","7","-2"
"190664","CUNY Queens College","2017","On-tenure track, lecturers","22","8","14","0","0","0","3","0","3","2","1","1","2","1","1","0","0","0","14","6","8","0","0","0","0","0","0","1","0","1","-2"
"190664","CUNY Queens College","2017","Not on tenure track/No tenure system system total","35","18","17","0","0","0","3","2","1","5","1","4","0","0","0","0","0","0","26","15","11","0","0","0","0","0","0","1","0","1","-2"
"190664","CUNY Queens College","2017","Not on tenure/no tenure system, professors","7","3","4","0","0","0","0","0","0","3","0","3","0","0","0","0","0","0","4","3","1","0","0","0","0","0","0","0","0","0","-2"
"190664","CUNY Queens College","2017","Not on tenure/no tenure system, associate professors","2","2","0","0","0","0","0","0","0","0","0","0","0","0","0","0","0","0","2","2","0","0","0","0","0","0","0","0","0","0","-2"
"190664","CUNY Queens College","2017","Not on tenure/no tenure system, assistant professors","5","3","2","0","0","0","1","1","0","0","0","0","0","0","0","0","0","0","4","2","2","0","0","0","0","0","0","0","0","0","-2"
"190664","CUNY Queens College","2017","Not on tenure/no tenure system, lecturers","21","10","11","0","0","0","2","1","1","2","1","1","0","0","0","0","0","0","16","8","8","0","0","0","0","0","0","1","0","1","-2"
"190691","CUNY York College","2017","Tenured total","138","77","61","0","0","0","18","12","6","25","13","12","11","5","6","0","0","0","81","46","35","0","0","0","0","0","0","3","1","2","-2"
"190691","CUNY York College","2017","Tenured, professors","41","24","17","0","0","0","5","5","0","4","3","1","3","1","2","0","0","0","28","14","14","0","0","0","0","0","0","1","1","0","-2"
"190691","CUNY York College","2017","Tenured, associate professors","71","38","33","0","0","0","12","7","5","14","5","9","7","4","3","0","0","0","36","22","14","0","0","0","0","0","0","2","0","2","-2"
"190691","CUNY York College","2017","Tenured, assistant professors","9","7","2","0","0","0","0","0","0","3","2","1","0","0","0","0","0","0","6","5","1","0","0","0","0","0","0","0","0","0","-2"
"190691","CUNY York College","2017","Tenured, lecturers","17","8","9","0","0","0","1","0","1","4","3","1","1","0","1","0","0","0","11","5","6","0","0","0","0","0","0","0","0","0","-2"
"190691","CUNY York College","2017","On-Tenure track total","44","20","24","0","0","0","7","4","3","12","3","9","5","3","2","0","0","0","18","9","9","0","0","0","0","0","0","2","1","1","-2"
"190691","CUNY York College","2017","On-tenure track, associate professors","7","3","4","0","0","0","2","1","1","1","0","1","1","1","0","0","0","0","3","1","2","0","0","0","0","0","0","0","0","0","-2"
"190691","CUNY York College","2017","On-tenure track, assistant professors","33","15","18","0","0","0","5","3","2","9","2","7","3","2","1","0","0","0","14","7","7","0","0","0","0","0","0","2","1","1","-2"
"190691","CUNY York College","2017","On-tenure track, lecturers","4","2","2","0","0","0","0","0","0","2","1","1","1","0","1","0","0","0","1","1","0","0","0","0","0","0","0","0","0","0","-2"
"190691","CUNY York College","2017","Not on tenure track/No tenure system system total","12","4","8","0","0","0","1","1","0","6","2","4","0","0","0","0","0","0","3","0","3","0","0","0","0","0","0","2","1","1","-2"
"190691","CUNY York College","2017","Not on tenure/no tenure system, professors","5","1","4","0","0","0","0","0","0","3","1","2","0","0","0","0","0","0","1","0","1","0","0","0","0","0","0","1","0","1","-2"
"190691","CUNY York College","2017","Not on tenure/no tenure system, assistant professors","1","1","0","0","0","0","0","0","0","0","0","0","0","0","0","0","0","0","0","0","0","0","0","0","0","0","0","1","1","0","-2"
"190691","CUNY York College","2017","Not on tenure/no tenure system, lecturers","6","2","4","0","0","0","1","1","0","3","1","2","0","0","0","0","0","0","2","0","2","0","0","0","0","0","0","0","0","0","-2"
"190761","Dominican College of Blauvelt","2017","Tenured total","29","11","18","0","0","0","1","1","0","0","0","0","1","1","0","0","0","0","27","9","18","0","0","0","0","0","0","0","0","0","-2"
"190761","Dominican College of Blauvelt","2017","Tenured, professors","3","0","3","0","0","0","0","0","0","0","0","0","0","0","0","0","0","0","3","0","3","0","0","0","0","0","0","0","0","0","-2"
"190761","Dominican College of Blauvelt","2017","Tenured, associate professors","11","4","7","0","0","0","1","1","0","0","0","0","0","0","0","0","0","0","10","3","7","0","0","0","0","0","0","0","0","0","-2"
"190761","Dominican College of Blauvelt","2017","Tenured, assistant professors","15","7","8","0","0","0","0","0","0","0","0","0","1","1","0","0","0","0","14","6","8","0","0","0","0","0","0","0","0","0","-2"
"190761","Dominican College of Blauvelt","2017","On-Tenure track total","27","11","16","0","0","0","5","3","2","2","0","2","2","0","2","0","0","0","17","7","10","0","0","0","1","1","0","0","0","0","-2"
"190761","Dominican College of Blauvelt","2017","On-tenure track, associate professors","2","2","0","0","0","0","1","1","0","0","0","0","0","0","0","0","0","0","1","1","0","0","0","0","0","0","0","0","0","0","-2"
"190761","Dominican College of Blauvelt","2017","On-tenure track, assistant professors","23","8","15","0","0","0","4","2","2","2","0","2","2","0","2","0","0","0","14","5","9","0","0","0","1","1","0","0","0","0","-2"
"190761","Dominican College of Blauvelt","2017","On-tenure track, instructors","2","1","1","0","0","0","0","0","0","0","0","0","0","0","0","0","0","0","2","1","1","0","0","0","0","0","0","0","0","0","-2"
"190761","Dominican College of Blauvelt","2017","Not on tenure track/No tenure system system total","21","6","15","0","0","0","0","0","0","0","0","0","1","0","1","0","0","0","20","6","14","0","0","0","0","0","0","0","0","0","-2"
"190761","Dominican College of Blauvelt","2017","Not on tenure/no tenure system, associate professors","1","0","1","0","0","0","0","0","0","0","0","0","1","0","1","0","0","0","0","0","0","0","0","0","0","0","0","0","0","0","-2"
"190761","Dominican College of Blauvelt","2017","Not on tenure/no tenure system, assistant professors","14","5","9","0","0","0","0","0","0","0","0","0","0","0","0","0","0","0","14","5","9","0","0","0","0","0","0","0","0","0","-2"
"190761","Dominican College of Blauvelt","2017","Not on tenure/no tenure system, instructors","6","1","5","0","0","0","0","0","0","0","0","0","0","0","0","0","0","0","6","1","5","0","0","0","0","0","0","0","0","0","-2"
"192749","Manhattanville College","2017","Tenured total","63","34","29","0","0","0","5","1","4","4","3","1","1","0","1","0","0","0","51","29","22","0","0","0","2","1","1","0","0","0","-2"
"192749","Manhattanville College","2017","Tenured, professors","44","25","19","0","0","0","4","1","3","3","3","0","1","0","1","0","0","0","36","21","15","0","0","0","0","0","0","0","0","0","-2"
"192749","Manhattanville College","2017","Tenured, associate professors","14","7","7","0","0","0","0","0","0","0","0","0","0","0","0","0","0","0","12","6","6","0","0","0","2","1","1","0","0","0","-2"
"192749","Manhattanville College","2017","Tenured, assistant professors","5","2","3","0","0","0","1","0","1","1","0","1","0","0","0","0","0","0","3","2","1","0","0","0","0","0","0","0","0","0","-2"
"192749","Manhattanville College","2017","On-Tenure track total","33","15","18","1","1","0","2","1","1","0","0","0","1","1","0","0","0","0","26","10","16","1","0","1","2","2","0","0","0","0","-2"
"192749","Manhattanville College","2017","On-tenure track, professors","4","2","2","1","1","0","0","0","0","0","0","0","0","0","0","0","0","0","3","1","2","0","0","0","0","0","0","0","0","0","-2"
"192749","Manhattanville College","2017","On-tenure track, associate professors","12","6","6","0","0","0","1","0","1","0","0","0","0","0","0","0","0","0","11","6","5","0","0","0","0","0","0","0","0","0","-2"
"192749","Manhattanville College","2017","On-tenure track, assistant professors","17","7","10","0","0","0","1","1","0","0","0","0","1","1","0","0","0","0","12","3","9","1","0","1","2","2","0","0","0","0","-2"
"192749","Manhattanville College","2017","Not on tenure track/No tenure system system total","21","8","13","0","0","0","2","0","2","0","0","0","2","1","1","0","0","0","16","7","9","1","0","1","0","0","0","0","0","0","-2"
"192749","Manhattanville College","2017","Not on tenure/no tenure system, professors","3","1","2","0","0","0","0","0","0","0","0","0","0","0","0","0","0","0","2","1","1","1","0","1","0","0","0","0","0","0","-2"
"192749","Manhattanville College","2017","Not on tenure/no tenure system, assistant professors","3","1","2","0","0","0","0","0","0","0","0","0","0","0","0","0","0","0","3","1","2","0","0","0","0","0","0","0","0","0","-2"
"192749","Manhattanville College","2017","Not on tenure/no tenure system, instructors","1","0","1","0","0","0","1","0","1","0","0","0","0","0","0","0","0","0","0","0","0","0","0","0","0","0","0","0","0","0","-2"
"192749","Manhattanville College","2017","Not on tenure/no tenure system, lecturers","14","6","8","0","0","0","1","0","1","0","0","0","2","1","1","0","0","0","11","5","6","0","0","0","0","0","0","0","0","0","-2"
"193016","Mercy College","2017","Tenured total","60","24","36","0","0","0","10","3","7","5","2","3","2","1","1","0","0","0","42","17","25","1","1","0","0","0","0","0","0","0","-2"
"193016","Mercy College","2017","Tenured, professors","18","10","8","0","0","0","2","2","0","1","1","0","0","0","0","0","0","0","14","6","8","1","1","0","0","0","0","0","0","0","-2"
"193016","Mercy College","2017","Tenured, associate professors","32","11","21","0","0","0","5","0","5","4","1","3","1","0","1","0","0","0","22","10","12","0","0","0","0","0","0","0","0","0","-2"
"193016","Mercy College","2017","Tenured, assistant professors","10","3","7","0","0","0","3","1","2","0","0","0","1","1","0","0","0","0","6","1","5","0","0","0","0","0","0","0","0","0","-2"
"193016","Mercy College","2017","On-Tenure track total","32","14","18","0","0","0","8","5","3","2","0","2","3","1","2","0","0","0","19","8","11","0","0","0","0","0","0","0","0","0","-2"
"193016","Mercy College","2017","On-tenure track, professors","1","1","0","0","0","0","0","0","0","0","0","0","1","1","0","0","0","0","0","0","0","0","0","0","0","0","0","0","0","0","-2"
"193016","Mercy College","2017","On-tenure track, associate professors","8","2","6","0","0","0","0","0","0","0","0","0","2","0","2","0","0","0","6","2","4","0","0","0","0","0","0","0","0","0","-2"
"193016","Mercy College","2017","On-tenure track, assistant professors","22","10","12","0","0","0","8","5","3","2","0","2","0","0","0","0","0","0","12","5","7","0","0","0","0","0","0","0","0","0","-2"
"193016","Mercy College","2017","On-tenure track, instructors","1","1","0","0","0","0","0","0","0","0","0","0","0","0","0","0","0","0","1","1","0","0","0","0","0","0","0","0","0","0","-2"
"193016","Mercy College","2017","Not on tenure track/No tenure system system total","111","43","68","0","0","0","5","3","2","12","3","9","7","2","5","0","0","0","85","34","51","0","0","0","2","1","1","0","0","0","-2"
"193016","Mercy College","2017","Not on tenure/no tenure system, professors","3","0","3","0","0","0","0","0","0","1","0","1","0","0","0","0","0","0","2","0","2","0","0","0","0","0","0","0","0","0","-2"
"193016","Mercy College","2017","Not on tenure/no tenure system, associate professors","32","15","17","0","0","0","3","2","1","0","0","0","1","0","1","0","0","0","28","13","15","0","0","0","0","0","0","0","0","0","-2"
"193016","Mercy College","2017","Not on tenure/no tenure system, assistant professors","65","22","43","0","0","0","1","0","1","10","2","8","6","2","4","0","0","0","47","17","30","0","0","0","1","1","0","0","0","0","-2"
"193016","Mercy College","2017","Not on tenure/no tenure system, instructors","11","6","5","0","0","0","1","1","0","1","1","0","0","0","0","0","0","0","8","4","4","0","0","0","1","0","1","0","0","0","-2"
"193399","College of Mount Saint Vincent","2017","Tenured total","31","19","12","0","0","0","1","0","1","0","0","0","0","0","0","0","0","0","29","18","11","1","1","0","0","0","0","0","0","0","-2"
"193399","College of Mount Saint Vincent","2017","Tenured, professors","8","6","2","0","0","0","0","0","0","0","0","0","0","0","0","0","0","0","7","5","2","1","1","0","0","0","0","0","0","0","-2"
"193399","College of Mount Saint Vincent","2017","Tenured, associate professors","21","11","10","0","0","0","1","0","1","0","0","0","0","0","0","0","0","0","20","11","9","0","0","0","0","0","0","0","0","0","-2"
"193399","College of Mount Saint Vincent","2017","Tenured, assistant professors","2","2","0","0","0","0","0","0","0","0","0","0","0","0","0","0","0","0","2","2","0","0","0","0","0","0","0","0","0","0","-2"
"193399","College of Mount Saint Vincent","2017","On-Tenure track total","41","14","27","0","0","0","4","1","3","1","0","1","6","1","5","0","0","0","26","10","16","4","2","2","0","0","0","0","0","0","-2"
"193399","College of Mount Saint Vincent","2017","On-tenure track, professors","1","0","1","0","0","0","0","0","0","0","0","0","0","0","0","0","0","0","1","0","1","0","0","0","0","0","0","0","0","0","-2"
"193399","College of Mount Saint Vincent","2017","On-tenure track, associate professors","15","4","11","0","0","0","2","1","1","0","0","0","2","0","2","0","0","0","9","2","7","2","1","1","0","0","0","0","0","0","-2"
"193399","College of Mount Saint Vincent","2017","On-tenure track, assistant professors","23","10","13","0","0","0","2","0","2","1","0","1","4","1","3","0","0","0","14","8","6","2","1","1","0","0","0","0","0","0","-2"
"193399","College of Mount Saint Vincent","2017","On-tenure track, instructors","2","0","2","0","0","0","0","0","0","0","0","0","0","0","0","0","0","0","2","0","2","0","0","0","0","0","0","0","0","0","-2"
"193399","College of Mount Saint Vincent","2017","Not on tenure track/No tenure system system total","9","3","6","0","0","0","0","0","0","0","0","0","0","0","0","0","0","0","9","3","6","0","0","0","0","0","0","0","0","0","-2"
"193399","College of Mount Saint Vincent","2017","Not on tenure/no tenure system, professors","1","1","0","0","0","0","0","0","0","0","0","0","0","0","0","0","0","0","1","1","0","0","0","0","0","0","0","0","0","0","-2"
"193399","College of Mount Saint Vincent","2017","Not on tenure/no tenure system, assistant professors","3","1","2","0","0","0","0","0","0","0","0","0","0","0","0","0","0","0","3","1","2","0","0","0","0","0","0","0","0","0","-2"
"193399","College of Mount Saint Vincent","2017","Not on tenure/no tenure system, instructors","5","1","4","0","0","0","0","0","0","0","0","0","0","0","0","0","0","0","5","1","4","0","0","0","0","0","0","0","0","0","-2"
"194161","Nyack College","2017","Tenured total","33","19","14","0","0","0","4","2","2","5","3","2","1","0","1","0","0","0","23","14","9","0","0","0","0","0","0","0","0","0","-2"
"194161","Nyack College","2017","Tenured, professors","28","17","11","0","0","0","4","2","2","4","2","2","1","0","1","0","0","0","19","13","6","0","0","0","0","0","0","0","0","0","-2"
"194161","Nyack College","2017","Tenured, associate professors","5","2","3","0","0","0","0","0","0","1","1","0","0","0","0","0","0","0","4","1","3","0","0","0","0","0","0","0","0","0","-2"
"194161","Nyack College","2017","On-Tenure track total","42","23","19","0","0","0","9","2","7","5","2","3","6","3","3","0","0","0","20","14","6","0","0","0","0","0","0","2","2","0","-2"
"194161","Nyack College","2017","On-tenure track, professors","7","3","4","0","0","0","1","0","1","1","0","1","0","0","0","0","0","0","5","3","2","0","0","0","0","0","0","0","0","0","-2"
"194161","Nyack College","2017","On-tenure track, associate professors","16","11","5","0","0","0","4","2","2","1","0","1","0","0","0","0","0","0","10","8","2","0","0","0","0","0","0","1","1","0","-2"
"194161","Nyack College","2017","On-tenure track, assistant professors","19","9","10","0","0","0","4","0","4","3","2","1","6","3","3","0","0","0","5","3","2","0","0","0","0","0","0","1","1","0","-2"
"194161","Nyack College","2017","Not on tenure track/No tenure system system total","7","3","4","0","0","0","0","0","0","5","2","3","0","0","0","0","0","0","2","1","1","0","0","0","0","0","0","0","0","0","-2"
"194161","Nyack College","2017","Not on tenure/no tenure system, lecturers","7","3","4","0","0","0","0","0","0","5","2","3","0","0","0","0","0","0","2","1","1","0","0","0","0","0","0","0","0","0","-2"
"195173","St Francis College","2017","Tenured total","47","23","24","0","0","0","2","1","1","3","0","3","3","1","2","0","0","0","39","21","18","0","0","0","0","0","0","0","0","0","-2"
"195173","St Francis College","2017","Tenured, professors","27","16","11","0","0","0","1","1","0","1","0","1","1","0","1","0","0","0","24","15","9","0","0","0","0","0","0","0","0","0","-2"
"195173","St Francis College","2017","Tenured, associate professors","20","7","13","0","0","0","1","0","1","2","0","2","2","1","1","0","0","0","15","6","9","0","0","0","0","0","0","0","0","0","-2"
"195173","St Francis College","2017","On-Tenure track total","28","8","20","0","0","0","2","1","1","2","0","2","1","0","1","0","0","0","20","6","14","1","0","1","0","0","0","2","1","1","-2"
"195173","St Francis College","2017","On-tenure track, associate professors","3","0","3","0","0","0","0","0","0","0","0","0","0","0","0","0","0","0","3","0","3","0","0","0","0","0","0","0","0","0","-2"
"195173","St Francis College","2017","On-tenure track, assistant professors","25","8","17","0","0","0","2","1","1","2","0","2","1","0","1","0","0","0","17","6","11","1","0","1","0","0","0","2","1","1","-2"
"195173","St Francis College","2017","Not on tenure track/No tenure system system total","13","9","4","0","0","0","1","1","0","1","0","1","0","0","0","0","0","0","11","8","3","0","0","0","0","0","0","0","0","0","-2"
"195173","St Francis College","2017","Not on tenure/no tenure system, lecturers","13","9","4","0","0","0","1","1","0","1","0","1","0","0","0","0","0","0","11","8","3","0","0","0","0","0","0","0","0","0","-2"
"196219","SUNY at Purchase College","2017","Tenured total","90","43","47","0","0","0","4","2","2","3","2","1","2","2","0","0","0","0","78","36","42","3","1","2","0","0","0","0","0","0","-2"
"196219","SUNY at Purchase College","2017","Tenured, professors","30","14","16","0","0","0","2","1","1","1","1","0","0","0","0","0","0","0","27","12","15","0","0","0","0","0","0","0","0","0","-2"
"196219","SUNY at Purchase College","2017","Tenured, associate professors","60","29","31","0","0","0","2","1","1","2","1","1","2","2","0","0","0","0","51","24","27","3","1","2","0","0","0","0","0","0","-2"
"196219","SUNY at Purchase College","2017","On-Tenure track total","53","28","25","0","0","0","6","2","4","3","0","3","3","2","1","0","0","0","34","18","16","2","2","0","0","0","0","5","4","1","-2"
"196219","SUNY at Purchase College","2017","On-tenure track, associate professors","5","3","2","0","0","0","0","0","0","0","0","0","0","0","0","0","0","0","4","3","1","0","0","0","0","0","0","1","0","1","-2"
"196219","SUNY at Purchase College","2017","On-tenure track, assistant professors","48","25","23","0","0","0","6","2","4","3","0","3","3","2","1","0","0","0","30","15","15","2","2","0","0","0","0","4","4","0","-2"
"196219","SUNY at Purchase College","2017","Not on tenure track/No tenure system system total","30","9","21","0","0","0","2","0","2","1","0","1","2","0","2","0","0","0","24","8","16","0","0","0","0","0","0","1","1","0","-2"
"196219","SUNY at Purchase College","2017","Not on tenure/no tenure system, associate professors","4","1","3","0","0","0","0","0","0","0","0","0","0","0","0","0","0","0","4","1","3","0","0","0","0","0","0","0","0","0","-2"
"196219","SUNY at Purchase College","2017","Not on tenure/no tenure system, assistant professors","24","8","16","0","0","0","1","0","1","1","0","1","2","0","2","0","0","0","19","7","12","0","0","0","0","0","0","1","1","0","-2"
"196219","SUNY at Purchase College","2017","Not on tenure/no tenure system, lecturers","2","0","2","0","0","0","1","0","1","0","0","0","0","0","0","0","0","0","1","0","1","0","0","0","0","0","0","0","0","0","-2"
"196237","SUNY College at Old Westbury","2017","Tenured total","84","40","44","0","0","0","15","5","10","10","6","4","9","7","2","0","0","0","50","22","28","0","0","0","0","0","0","0","0","0","-2"
"196237","SUNY College at Old Westbury","2017","Tenured, professors","27","12","15","0","0","0","6","3","3","1","1","0","5","4","1","0","0","0","15","4","11","0","0","0","0","0","0","0","0","0","-2"
"196237","SUNY College at Old Westbury","2017","Tenured, associate professors","56","27","29","0","0","0","9","2","7","9","5","4","4","3","1","0","0","0","34","17","17","0","0","0","0","0","0","0","0","0","-2"
"196237","SUNY College at Old Westbury","2017","Tenured, instructors","1","1","0","0","0","0","0","0","0","0","0","0","0","0","0","0","0","0","1","1","0","0","0","0","0","0","0","0","0","0","-2"
"196237","SUNY College at Old Westbury","2017","On-Tenure track total","59","28","31","1","1","0","9","4","5","8","4","4","5","2","3","0","0","0","32","15","17","1","0","1","0","0","0","3","2","1","-2"
"196237","SUNY College at Old Westbury","2017","On-tenure track, associate professors","1","0","1","0","0","0","0","0","0","0","0","0","0","0","0","0","0","0","1","0","1","0","0","0","0","0","0","0","0","0","-2"
"196237","SUNY College at Old Westbury","2017","On-tenure track, assistant professors","58","28","30","1","1","0","9","4","5","8","4","4","5","2","3","0","0","0","31","15","16","1","0","1","0","0","0","3","2","1","-2"
"196237","SUNY College at Old Westbury","2017","Not on tenure track/No tenure system system total","23","7","16","0","0","0","5","1","4","7","1","6","2","0","2","0","0","0","9","5","4","0","0","0","0","0","0","0","0","0","-2"
"196237","SUNY College at Old Westbury","2017","Not on tenure/no tenure system, associate professors","2","1","1","0","0","0","0","0","0","2","1","1","0","0","0","0","0","0","0","0","0","0","0","0","0","0","0","0","0","0","-2"
"196237","SUNY College at Old Westbury","2017","Not on tenure/no tenure system, assistant professors","7","1","6","0","0","0","2","1","1","1","0","1","1","0","1","0","0","0","3","0","3","0","0","0","0","0","0","0","0","0","-2"
"196237","SUNY College at Old Westbury","2017","Not on tenure/no tenure system, instructors","3","1","2","0","0","0","0","0","0","1","0","1","1","0","1","0","0","0","1","1","0","0","0","0","0","0","0","0","0","0","-2"
"196237","SUNY College at Old Westbury","2017","Not on tenure/no tenure system, lecturers","11","4","7","0","0","0","3","0","3","3","0","3","0","0","0","0","0","0","5","4","1","0","0","0","0","0","0","0","0","0","-2"
"206279","Union Institute & University","2017","Not on tenure track/No tenure system system total","36","16","20","0","0","0","1","0","1","6","1","5","2","1","1","0","0","0","25","14","11","0","0","0","2","0","2","0","0","0","-2"
"206279","Union Institute & University","2017","Not on tenure/no tenure system, no academic rank","36","16","20","0","0","0","1","0","1","6","1","5","2","1","1","0","0","0","25","14","11","0","0","0","2","0","2","0","0","0","-2"
"207351","Oklahoma Panhandle State University","2017","Tenured total","10","6","4","0","0","0","0","0","0","0","0","0","0","0","0","0","0","0","10","6","4","0","0","0","0","0","0","0","0","0","-2"
"207351","Oklahoma Panhandle State University","2017","Tenured, professors","8","5","3","0","0","0","0","0","0","0","0","0","0","0","0","0","0","0","8","5","3","0","0","0","0","0","0","0","0","0","-2"
"207351","Oklahoma Panhandle State University","2017","Tenured, associate professors","2","1","1","0","0","0","0","0","0","0","0","0","0","0","0","0","0","0","2","1","1","0","0","0","0","0","0","0","0","0","-2"
"207351","Oklahoma Panhandle State University","2017","On-Tenure track total","23","8","15","1","1","0","1","0","1","0","0","0","0","0","0","0","0","0","19","6","13","2","1","1","0","0","0","0","0","0","-2"
"207351","Oklahoma Panhandle State University","2017","On-tenure track, associate professors","5","3","2","1","1","0","0","0","0","0","0","0","0","0","0","0","0","0","3","2","1","1","0","1","0","0","0","0","0","0","-2"
"207351","Oklahoma Panhandle State University","2017","On-tenure track, assistant professors","15","5","10","0","0","0","1","0","1","0","0","0","0","0","0","0","0","0","13","4","9","1","1","0","0","0","0","0","0","0","-2"
"207351","Oklahoma Panhandle State University","2017","On-tenure track, instructors","3","0","3","0","0","0","0","0","0","0","0","0","0","0","0","0","0","0","3","0","3","0","0","0","0","0","0","0","0","0","-2"
"207351","Oklahoma Panhandle State University","2017","Not on tenure track/No tenure system system total","17","11","6","0","0","0","1","0","1","0","0","0","1","1","0","0","0","0","15","10","5","0","0","0","0","0","0","0","0","0","-2"
"207351","Oklahoma Panhandle State University","2017","Not on tenure/no tenure system, instructors","16","11","5","0","0","0","0","0","0","0","0","0","1","1","0","0","0","0","15","10","5","0","0","0","0","0","0","0","0","0","-2"
"207351","Oklahoma Panhandle State University","2017","Not on tenure/no tenure system, lecturers","1","0","1","0","0","0","1","0","1","0","0","0","0","0","0","0","0","0","0","0","0","0","0","0","0","0","0","0","0","0","-2"
"209241","Mount Angel Seminary","2017","Not on tenure track/No tenure system system total","16","11","5","0","0","0","1","0","1","0","0","0","0","0","0","0","0","0","15","11","4","0","0","0","0","0","0","0","0","0","-2"
"209241","Mount Angel Seminary","2017","Not on tenure/no tenure system, professors","5","5","0","0","0","0","0","0","0","0","0","0","0","0","0","0","0","0","5","5","0","0","0","0","0","0","0","0","0","0","-2"
"209241","Mount Angel Seminary","2017","Not on tenure/no tenure system, associate professors","10","6","4","0","0","0","1","0","1","0","0","0","0","0","0","0","0","0","9","6","3","0","0","0","0","0","0","0","0","0","-2"
"209241","Mount Angel Seminary","2017","Not on tenure/no tenure system, assistant professors","1","0","1","0","0","0","0","0","0","0","0","0","0","0","0","0","0","0","1","0","1","0","0","0","0","0","0","0","0","0","-2"
"210304","Warner Pacific University","2017","Not on tenure track/No tenure system system total","30","16","14","0","0","0","1","1","0","2","2","0","6","3","3","0","0","0","19","9","10","0","0","0","2","1","1","0","0","0","-2"
"210304","Warner Pacific University","2017","Not on tenure/no tenure system, professors","4","3","1","0","0","0","0","0","0","0","0","0","1","1","0","0","0","0","3","2","1","0","0","0","0","0","0","0","0","0","-2"
"210304","Warner Pacific University","2017","Not on tenure/no tenure system, associate professors","13","6","7","0","0","0","1","1","0","0","0","0","2","1","1","0","0","0","9","3","6","0","0","0","1","1","0","0","0","0","-2"
"210304","Warner Pacific University","2017","Not on tenure/no tenure system, assistant professors","8","3","5","0","0","0","0","0","0","1","1","0","2","0","2","0","0","0","5","2","3","0","0","0","0","0","0","0","0","0","-2"
"210304","Warner Pacific University","2017","Not on tenure/no tenure system, instructors","5","4","1","0","0","0","0","0","0","1","1","0","1","1","0","0","0","0","2","2","0","0","0","0","1","0","1","0","0","0","-2"
"222831","Angelo State University","2017","Tenured total","133","86","47","2","1","1","7","5","2","6","2","4","8","3","5","0","0","0","110","75","35","0","0","0","0","0","0","0","0","0","-2"
"222831","Angelo State University","2017","Tenured, professors","81","56","25","1","1","0","3","2","1","2","1","1","4","2","2","0","0","0","71","50","21","0","0","0","0","0","0","0","0","0","-2"
"222831","Angelo State University","2017","Tenured, associate professors","50","29","21","1","0","1","4","3","1","4","1","3","3","1","2","0","0","0","38","24","14","0","0","0","0","0","0","0","0","0","-2"
"222831","Angelo State University","2017","Tenured, assistant professors","2","1","1","0","0","0","0","0","0","0","0","0","1","0","1","0","0","0","1","1","0","0","0","0","0","0","0","0","0","0","-2"
"222831","Angelo State University","2017","On-Tenure track total","73","42","31","0","0","0","7","6","1","1","1","0","6","4","2","0","0","0","56","28","28","0","0","0","3","3","0","0","0","0","-2"
"222831","Angelo State University","2017","On-tenure track, assistant professors","73","42","31","0","0","0","7","6","1","1","1","0","6","4","2","0","0","0","56","28","28","0","0","0","3","3","0","0","0","0","-2"
"222831","Angelo State University","2017","Not on tenure track/No tenure system system total","102","36","66","2","0","2","1","0","1","0","0","0","11","6","5","0","0","0","88","30","58","0","0","0","0","0","0","0","0","0","-2"
"222831","Angelo State University","2017","Not on tenure/no tenure system, assistant professors","1","1","0","0","0","0","0","0","0","0","0","0","0","0","0","0","0","0","1","1","0","0","0","0","0","0","0","0","0","0","-2"
"222831","Angelo State University","2017","Not on tenure/no tenure system, instructors","74","29","45","0","0","0","0","0","0","0","0","0","8","5","3","0","0","0","66","24","42","0","0","0","0","0","0","0","0","0","-2"
"222831","Angelo State University","2017","Not on tenure/no tenure system, no academic rank","27","6","21","2","0","2","1","0","1","0","0","0","3","1","2","0","0","0","21","5","16","0","0","0","0","0","0","0","0","0","-2"
"222992","Austin Community College District","2017","Not on tenure track/No tenure system system total","567","251","316","2","0","2","25","9","16","40","18","22","83","43","40","2","2","0","406","175","231","9","4","5","0","0","0","0","0","0","-2"
"222992","Austin Community College District","2017","Not on tenure/no tenure system, professors","336","170","166","2","0","2","13","5","8","24","14","10","46","27","19","1","1","0","245","122","123","5","1","4","0","0","0","0","0","0","-2"
"222992","Austin Community College District","2017","Not on tenure/no tenure system, associate professors","149","49","100","0","0","0","10","3","7","11","3","8","24","10","14","0","0","0","103","32","71","1","1","0","0","0","0","0","0","0","-2"
"222992","Austin Community College District","2017","Not on tenure/no tenure system, assistant professors","49","22","27","0","0","0","2","1","1","3","1","2","8","4","4","1","1","0","33","14","19","2","1","1","0","0","0","0","0","0","-2"
"222992","Austin Community College District","2017","Not on tenure/no tenure system, instructors","4","2","2","0","0","0","0","0","0","0","0","0","1","1","0","0","0","0","3","1","2","0","0","0","0","0","0","0","0","0","-2"
"222992","Austin Community College District","2017","Not on tenure/no tenure system, no academic rank","29","8","21","0","0","0","0","0","0","2","0","2","4","1","3","0","0","0","22","6","16","1","1","0","0","0","0","0","0","0","-2"
"223506","Brazosport College","2017","Tenured total","51","29","22","1","1","0","2","0","2","2","2","0","3","1","2","0","0","0","43","25","18","0","0","0","0","0","0","0","0","0","-2"
"223506","Brazosport College","2017","Tenured, professors","17","11","6","0","0","0","1","0","1","0","0","0","0","0","0","0","0","0","16","11","5","0","0","0","0","0","0","0","0","0","-2"
"223506","Brazosport College","2017","Tenured, associate professors","19","10","9","1","1","0","1","0","1","2","2","0","1","1","0","0","0","0","14","6","8","0","0","0","0","0","0","0","0","0","-2"
"223506","Brazosport College","2017","Tenured, assistant professors","15","8","7","0","0","0","0","0","0","0","0","0","2","0","2","0","0","0","13","8","5","0","0","0","0","0","0","0","0","0","-2"
"223506","Brazosport College","2017","On-Tenure track total","1","0","1","0","0","0","0","0","0","1","0","1","0","0","0","0","0","0","0","0","0","0","0","0","0","0","0","0","0","0","-2"
"223506","Brazosport College","2017","On-tenure track, assistant professors","1","0","1","0","0","0","0","0","0","1","0","1","0","0","0","0","0","0","0","0","0","0","0","0","0","0","0","0","0","0","-2"
"223506","Brazosport College","2017","Not on tenure track/No tenure system system total","45","26","19","1","1","0","1","1","0","2","0","2","3","3","0","0","0","0","37","20","17","1","1","0","0","0","0","0","0","0","-2"
"223506","Brazosport College","2017","Not on tenure/no tenure system, associate professors","1","1","0","0","0","0","0","0","0","0","0","0","0","0","0","0","0","0","1","1","0","0","0","0","0","0","0","0","0","0","-2"
"223506","Brazosport College","2017","Not on tenure/no tenure system, assistant professors","9","6","3","1","1","0","1","1","0","0","0","0","1","1","0","0","0","0","6","3","3","0","0","0","0","0","0","0","0","0","-2"
"223506","Brazosport College","2017","Not on tenure/no tenure system, instructors","35","19","16","0","0","0","0","0","0","2","0","2","2","2","0","0","0","0","30","16","14","1","1","0","0","0","0","0","0","0","-2"
"224004","Concordia University Texas","2017","Tenured total","13","10","3","0","0","0","0","0","0","1","1","0","0","0","0","0","0","0","12","9","3","0","0","0","0","0","0","0","0","0","-2"
"224004","Concordia University Texas","2017","Tenured, professors","9","6","3","0","0","0","0","0","0","0","0","0","0","0","0","0","0","0","9","6","3","0","0","0","0","0","0","0","0","0","-2"
"224004","Concordia University Texas","2017","Tenured, associate professors","2","2","0","0","0","0","0","0","0","0","0","0","0","0","0","0","0","0","2","2","0","0","0","0","0","0","0","0","0","0","-2"
"224004","Concordia University Texas","2017","Tenured, assistant professors","2","2","0","0","0","0","0","0","0","1","1","0","0","0","0","0","0","0","1","1","0","0","0","0","0","0","0","0","0","0","-2"
"224004","Concordia University Texas","2017","On-Tenure track total","45","20","25","2","0","2","1","1","0","2","0","2","1","1","0","0","0","0","36","17","19","1","1","0","0","0","0","2","0","2","-2"
"224004","Concordia University Texas","2017","On-tenure track, professors","1","0","1","0","0","0","0","0","0","0","0","0","0","0","0","0","0","0","1","0","1","0","0","0","0","0","0","0","0","0","-2"
"224004","Concordia University Texas","2017","On-tenure track, associate professors","17","8","9","1","0","1","0","0","0","0","0","0","0","0","0","0","0","0","16","8","8","0","0","0","0","0","0","0","0","0","-2"
"224004","Concordia University Texas","2017","On-tenure track, assistant professors","26","12","14","1","0","1","1","1","0","2","0","2","1","1","0","0","0","0","18","9","9","1","1","0","0","0","0","2","0","2","-2"
"224004","Concordia University Texas","2017","On-tenure track, instructors","1","0","1","0","0","0","0","0","0","0","0","0","0","0","0","0","0","0","1","0","1","0","0","0","0","0","0","0","0","0","-2"
"224004","Concordia University Texas","2017","Not on tenure track/No tenure system system total","1","0","1","0","0","0","0","0","0","0","0","0","0","0","0","0","0","0","1","0","1","0","0","0","0","0","0","0","0","0","-2"
"224004","Concordia University Texas","2017","Not on tenure/no tenure system, no academic rank","1","0","1","0","0","0","0","0","0","0","0","0","0","0","0","0","0","0","1","0","1","0","0","0","0","0","0","0","0","0","-2"
"224961","Galveston College","2017","Tenured total","20","12","8","1","1","0","1","1","0","3","1","2","3","1","2","0","0","0","12","8","4","0","0","0","0","0","0","0","0","0","-2"
"224961","Galveston College","2017","Tenured, professors","4","3","1","0","0","0","0","0","0","1","1","0","0","0","0","0","0","0","3","2","1","0","0","0","0","0","0","0","0","0","-2"
"224961","Galveston College","2017","Tenured, associate professors","6","4","2","0","0","0","0","0","0","0","0","0","2","1","1","0","0","0","4","3","1","0","0","0","0","0","0","0","0","0","-2"
"224961","Galveston College","2017","Tenured, assistant professors","5","2","3","0","0","0","1","1","0","2","0","2","0","0","0","0","0","0","2","1","1","0","0","0","0","0","0","0","0","0","-2"
"224961","Galveston College","2017","Tenured, instructors","5","3","2","1","1","0","0","0","0","0","0","0","1","0","1","0","0","0","3","2","1","0","0","0","0","0","0","0","0","0","-2"
"224961","Galveston College","2017","On-Tenure track total","34","15","19","1","0","1","2","0","2","3","2","1","4","2","2","0","0","0","24","11","13","0","0","0","0","0","0","0","0","0","-2"
"224961","Galveston College","2017","On-tenure track, associate professors","2","1","1","0","0","0","0","0","0","1","0","1","0","0","0","0","0","0","1","1","0","0","0","0","0","0","0","0","0","0","-2"
"224961","Galveston College","2017","On-tenure track, assistant professors","1","1","0","0","0","0","0","0","0","0","0","0","0","0","0","0","0","0","1","1","0","0","0","0","0","0","0","0","0","0","-2"
"224961","Galveston College","2017","On-tenure track, instructors","31","13","18","1","0","1","2","0","2","2","2","0","4","2","2","0","0","0","22","9","13","0","0","0","0","0","0","0","0","0","-2"
"225201","Hallmark University","2017","Not on tenure track/No tenure system system total","28","19","9","0","0","0","1","1","0","3","1","2","7","6","1","0","0","0","17","11","6","0","0","0","0","0","0","0","0","0","-2"
"225201","Hallmark University","2017","Not on tenure/no tenure system, instructors","28","19","9","0","0","0","1","1","0","3","1","2","7","6","1","0","0","0","17","11","6","0","0","0","0","0","0","0","0","0","-2"
"225399","Houston Baptist University","2017","Not on tenure track/No tenure system system total","151","82","69","1","1","0","4","3","1","10","3","7","9","7","2","0","0","0","117","63","54","3","2","1","4","1","3","3","2","1","-2"
"225399","Houston Baptist University","2017","Not on tenure/no tenure system, professors","34","22","12","0","0","0","0","0","0","3","0","3","0","0","0","0","0","0","29","21","8","1","1","0","1","0","1","0","0","0","-2"
"225399","Houston Baptist University","2017","Not on tenure/no tenure system, associate professors","40","27","13","0","0","0","2","2","0","3","2","1","7","6","1","0","0","0","26","17","9","1","0","1","1","0","1","0","0","0","-2"
"225399","Houston Baptist University","2017","Not on tenure/no tenure system, assistant professors","75","32","43","1","1","0","1","1","0","4","1","3","2","1","1","0","0","0","61","24","37","1","1","0","2","1","1","3","2","1","-2"
"225399","Houston Baptist University","2017","Not on tenure/no tenure system, instructors","2","1","1","0","0","0","1","0","1","0","0","0","0","0","0","0","0","0","1","1","0","0","0","0","0","0","0","0","0","0","-2"
"225414","University of Houston-Clear Lake","2017","Tenured total","151","94","57","0","0","0","23","17","6","7","4","3","6","1","5","0","0","0","113","70","43","2","2","0","0","0","0","0","0","0","-2"
"225414","University of Houston-Clear Lake","2017","Tenured, professors","54","35","19","0","0","0","10","7","3","2","1","1","2","0","2","0","0","0","40","27","13","0","0","0","0","0","0","0","0","0","-2"
"225414","University of Houston-Clear Lake","2017","Tenured, associate professors","97","59","38","0","0","0","13","10","3","5","3","2","4","1","3","0","0","0","73","43","30","2","2","0","0","0","0","0","0","0","-2"
"225414","University of Houston-Clear Lake","2017","On-Tenure track total","100","50","50","0","0","0","19","9","10","5","2","3","9","2","7","1","0","1","50","27","23","2","0","2","1","0","1","13","10","3","-2"
"225414","University of Houston-Clear Lake","2017","On-tenure track, associate professors","7","4","3","0","0","0","1","0","1","0","0","0","0","0","0","0","0","0","6","4","2","0","0","0","0","0","0","0","0","0","-2"
"225414","University of Houston-Clear Lake","2017","On-tenure track, assistant professors","93","46","47","0","0","0","18","9","9","5","2","3","9","2","7","1","0","1","44","23","21","2","0","2","1","0","1","13","10","3","-2"
"225414","University of Houston-Clear Lake","2017","Not on tenure track/No tenure system system total","49","20","29","0","0","0","5","2","3","3","0","3","5","0","5","0","0","0","32","16","16","1","0","1","0","0","0","3","2","1","-2"
"225414","University of Houston-Clear Lake","2017","Not on tenure/no tenure system, lecturers","33","12","21","0","0","0","2","0","2","2","0","2","3","0","3","0","0","0","24","11","13","1","0","1","0","0","0","1","1","0","-2"
"225414","University of Houston-Clear Lake","2017","Not on tenure/no tenure system, no academic rank","16","8","8","0","0","0","3","2","1","1","0","1","2","0","2","0","0","0","8","5","3","0","0","0","0","0","0","2","1","1","-2"
"225432","University of Houston-Downtown","2017","Tenured total","164","89","75","1","0","1","28","19","9","14","4","10","12","7","5","0","0","0","106","56","50","2","2","0","0","0","0","1","1","0","-2"
"225432","University of Houston-Downtown","2017","Tenured, professors","56","34","22","0","0","0","11","8","3","6","2","4","4","4","0","0","0","0","34","19","15","1","1","0","0","0","0","0","0","0","-2"
"225432","University of Houston-Downtown","2017","Tenured, associate professors","108","55","53","1","0","1","17","11","6","8","2","6","8","3","5","0","0","0","72","37","35","1","1","0","0","0","0","1","1","0","-2"
"225432","University of Houston-Downtown","2017","On-Tenure track total","78","45","33","0","0","0","13","9","4","14","7","7","8","5","3","0","0","0","36","20","16","0","0","0","0","0","0","7","4","3","-2"
"225432","University of Houston-Downtown","2017","On-tenure track, associate professors","3","3","0","0","0","0","2","2","0","0","0","0","0","0","0","0","0","0","1","1","0","0","0","0","0","0","0","0","0","0","-2"
"225432","University of Houston-Downtown","2017","On-tenure track, assistant professors","73","40","33","0","0","0","11","7","4","13","6","7","8","5","3","0","0","0","35","19","16","0","0","0","0","0","0","6","3","3","-2"
"225432","University of Houston-Downtown","2017","On-tenure track, instructors","2","2","0","0","0","0","0","0","0","1","1","0","0","0","0","0","0","0","0","0","0","0","0","0","0","0","0","1","1","0","-2"
"225432","University of Houston-Downtown","2017","Not on tenure track/No tenure system system total","120","55","65","0","0","0","20","9","11","15","4","11","13","6","7","0","0","0","64","30","34","4","3","1","0","0","0","4","3","1","-2"
"225432","University of Houston-Downtown","2017","Not on tenure/no tenure system, lecturers","111","49","62","0","0","0","18","8","10","13","4","9","12","5","7","0","0","0","60","26","34","4","3","1","0","0","0","4","3","1","-2"
"225432","University of Houston-Downtown","2017","Not on tenure/no tenure system, no academic rank","9","6","3","0","0","0","2","1","1","2","0","2","1","1","0","0","0","0","4","4","0","0","0","0","0","0","0","0","0","0","-2"
"225502","University of Houston-Victoria","2017","Tenured total","67","40","27","0","0","0","18","14","4","1","1","0","7","3","4","1","1","0","33","18","15","0","0","0","0","0","0","7","3","4","-2"
"225502","University of Houston-Victoria","2017","Tenured, professors","26","18","8","0","0","0","8","5","3","0","0","0","3","2","1","1","1","0","13","9","4","0","0","0","0","0","0","1","1","0","-2"
"225502","University of Houston-Victoria","2017","Tenured, associate professors","41","22","19","0","0","0","10","9","1","1","1","0","4","1","3","0","0","0","20","9","11","0","0","0","0","0","0","6","2","4","-2"
"225502","University of Houston-Victoria","2017","On-Tenure track total","47","23","24","0","0","0","2","2","0","6","2","4","2","1","1","0","0","0","21","11","10","1","0","1","1","0","1","14","7","7","-2"
"225502","University of Houston-Victoria","2017","On-tenure track, assistant professors","47","23","24","0","0","0","2","2","0","6","2","4","2","1","1","0","0","0","21","11","10","1","0","1","1","0","1","14","7","7","-2"
"225502","University of Houston-Victoria","2017","Not on tenure track/No tenure system system total","19","9","10","0","0","0","0","0","0","0","0","0","3","2","1","0","0","0","13","6","7","0","0","0","0","0","0","3","1","2","-2"
"225502","University of Houston-Victoria","2017","Not on tenure/no tenure system, lecturers","13","8","5","0","0","0","0","0","0","0","0","0","3","2","1","0","0","0","7","5","2","0","0","0","0","0","0","3","1","2","-2"
"225502","University of Houston-Victoria","2017","Not on tenure/no tenure system, no academic rank","6","1","5","0","0","0","0","0","0","0","0","0","0","0","0","0","0","0","6","1","5","0","0","0","0","0","0","0","0","0","-2"
"225548","Howard Payne University","2017","Tenured total","2","1","1","0","0","0","0","0","0","0","0","0","0","0","0","0","0","0","2","1","1","0","0","0","0","0","0","0","0","0","-2"
"225548","Howard Payne University","2017","Tenured, professors","2","1","1","0","0","0","0","0","0","0","0","0","0","0","0","0","0","0","2","1","1","0","0","0","0","0","0","0","0","0","-2"
"225548","Howard Payne University","2017","Not on tenure track/No tenure system system total","79","50","29","0","0","0","1","1","0","2","1","1","4","4","0","0","0","0","72","44","28","0","0","0","0","0","0","0","0","0","-2"
"225548","Howard Payne University","2017","Not on tenure/no tenure system, professors","23","15","8","0","0","0","0","0","0","0","0","0","1","1","0","0","0","0","22","14","8","0","0","0","0","0","0","0","0","0","-2"
"225548","Howard Payne University","2017","Not on tenure/no tenure system, associate professors","24","18","6","0","0","0","0","0","0","2","1","1","2","2","0","0","0","0","20","15","5","0","0","0","0","0","0","0","0","0","-2"
"225548","Howard Payne University","2017","Not on tenure/no tenure system, assistant professors","14","8","6","0","0","0","1","1","0","0","0","0","0","0","0","0","0","0","13","7","6","0","0","0","0","0","0","0","0","0","-2"
"225548","Howard Payne University","2017","Not on tenure/no tenure system, instructors","18","9","9","0","0","0","0","0","0","0","0","0","1","1","0","0","0","0","17","8","9","0","0","0","0","0","0","0","0","0","-2"
"225575","Huston-Tillotson University","2017","Tenured total","11","5","6","0","0","0","0","0","0","5","1","4","0","0","0","0","0","0","6","4","2","0","0","0","0","0","0","0","0","0","-2"
"225575","Huston-Tillotson University","2017","Tenured, professors","10","4","6","0","0","0","0","0","0","5","1","4","0","0","0","0","0","0","5","3","2","0","0","0","0","0","0","0","0","0","-2"
"225575","Huston-Tillotson University","2017","Tenured, associate professors","1","1","0","0","0","0","0","0","0","0","0","0","0","0","0","0","0","0","1","1","0","0","0","0","0","0","0","0","0","0","-2"
"225575","Huston-Tillotson University","2017","On-Tenure track total","25","13","12","0","0","0","3","1","2","11","5","6","7","4","3","0","0","0","3","2","1","0","0","0","0","0","0","1","1","0","-2"
"225575","Huston-Tillotson University","2017","On-tenure track, professors","2","2","0","0","0","0","0","0","0","0","0","0","1","1","0","0","0","0","1","1","0","0","0","0","0","0","0","0","0","0","-2"
"225575","Huston-Tillotson University","2017","On-tenure track, associate professors","4","1","3","0","0","0","0","0","0","3","1","2","0","0","0","0","0","0","1","0","1","0","0","0","0","0","0","0","0","0","-2"
"225575","Huston-Tillotson University","2017","On-tenure track, assistant professors","19","10","9","0","0","0","3","1","2","8","4","4","6","3","3","0","0","0","1","1","0","0","0","0","0","0","0","1","1","0","-2"
"225575","Huston-Tillotson University","2017","Not on tenure track/No tenure system system total","16","7","9","0","0","0","0","0","0","9","4","5","2","1","1","0","0","0","5","2","3","0","0","0","0","0","0","0","0","0","-2"
"225575","Huston-Tillotson University","2017","Not on tenure/no tenure system, associate professors","3","1","2","0","0","0","0","0","0","1","1","0","1","0","1","0","0","0","1","0","1","0","0","0","0","0","0","0","0","0","-2"
"225575","Huston-Tillotson University","2017","Not on tenure/no tenure system, assistant professors","7","3","4","0","0","0","0","0","0","4","2","2","0","0","0","0","0","0","3","1","2","0","0","0","0","0","0","0","0","0","-2"
"225575","Huston-Tillotson University","2017","Not on tenure/no tenure system, instructors","4","2","2","0","0","0","0","0","0","3","1","2","0","0","0","0","0","0","1","1","0","0","0","0","0","0","0","0","0","0","-2"
"225575","Huston-Tillotson University","2017","Not on tenure/no tenure system, lecturers","2","1","1","0","0","0","0","0","0","1","0","1","1","1","0","0","0","0","0","0","0","0","0","0","0","0","0","0","0","0","-2"
"226134","Laredo College","2017","Tenured total","129","72","57","1","0","1","3","2","1","1","0","1","101","56","45","0","0","0","22","13","9","0","0","0","1","1","0","0","0","0","-2"
"226134","Laredo College","2017","Tenured, instructors","129","72","57","1","0","1","3","2","1","1","0","1","101","56","45","0","0","0","22","13","9","0","0","0","1","1","0","0","0","0","-2"
"226134","Laredo College","2017","On-Tenure track total","45","25","20","0","0","0","5","3","2","1","1","0","36","19","17","0","0","0","3","2","1","0","0","0","0","0","0","0","0","0","-2"
"226134","Laredo College","2017","On-tenure track, instructors","45","25","20","0","0","0","5","3","2","1","1","0","36","19","17","0","0","0","3","2","1","0","0","0","0","0","0","0","0","0","-2"
"226134","Laredo College","2017","Not on tenure track/No tenure system system total","12","7","5","0","0","0","0","0","0","0","0","0","12","7","5","0","0","0","0","0","0","0","0","0","0","0","0","0","0","0","-2"
"226134","Laredo College","2017","Not on tenure/no tenure system, instructors","12","7","5","0","0","0","0","0","0","0","0","0","12","7","5","0","0","0","0","0","0","0","0","0","0","0","0","0","0","0","-2"
"226152","Texas A & M International University","2017","Tenured total","69","48","21","0","0","0","15","10","5","1","1","0","23","17","6","0","0","0","29","19","10","0","0","0","0","0","0","1","1","0","-2"
"226152","Texas A & M International University","2017","Tenured, professors","24","20","4","0","0","0","6","5","1","1","1","0","10","10","0","0","0","0","7","4","3","0","0","0","0","0","0","0","0","0","-2"
"226152","Texas A & M International University","2017","Tenured, associate professors","44","27","17","0","0","0","9","5","4","0","0","0","13","7","6","0","0","0","21","14","7","0","0","0","0","0","0","1","1","0","-2"
"226152","Texas A & M International University","2017","Tenured, assistant professors","1","1","0","0","0","0","0","0","0","0","0","0","0","0","0","0","0","0","1","1","0","0","0","0","0","0","0","0","0","0","-2"
"226152","Texas A & M International University","2017","On-Tenure track total","65","30","35","0","0","0","12","4","8","1","1","0","9","4","5","0","0","0","30","14","16","0","0","0","0","0","0","13","7","6","-2"
"226152","Texas A & M International University","2017","On-tenure track, professors","1","0","1","0","0","0","0","0","0","0","0","0","0","0","0","0","0","0","1","0","1","0","0","0","0","0","0","0","0","0","-2"
"226152","Texas A & M International University","2017","On-tenure track, associate professors","4","2","2","0","0","0","3","1","2","1","1","0","0","0","0","0","0","0","0","0","0","0","0","0","0","0","0","0","0","0","-2"
"226152","Texas A & M International University","2017","On-tenure track, assistant professors","59","28","31","0","0","0","9","3","6","0","0","0","9","4","5","0","0","0","28","14","14","0","0","0","0","0","0","13","7","6","-2"
"226152","Texas A & M International University","2017","On-tenure track, lecturers","1","0","1","0","0","0","0","0","0","0","0","0","0","0","0","0","0","0","1","0","1","0","0","0","0","0","0","0","0","0","-2"
"226152","Texas A & M International University","2017","Not on tenure track/No tenure system system total","84","36","48","0","0","0","3","0","3","3","3","0","41","16","25","0","0","0","31","14","17","0","0","0","0","0","0","6","3","3","-2"
"226152","Texas A & M International University","2017","Not on tenure/no tenure system, professors","1","1","0","0","0","0","0","0","0","0","0","0","0","0","0","0","0","0","0","0","0","0","0","0","0","0","0","1","1","0","-2"
"226152","Texas A & M International University","2017","Not on tenure/no tenure system, associate professors","8","5","3","0","0","0","1","0","1","1","1","0","2","1","1","0","0","0","4","3","1","0","0","0","0","0","0","0","0","0","-2"
"226152","Texas A & M International University","2017","Not on tenure/no tenure system, assistant professors","44","15","29","0","0","0","2","0","2","2","2","0","19","4","15","0","0","0","18","8","10","0","0","0","0","0","0","3","1","2","-2"
"226152","Texas A & M International University","2017","Not on tenure/no tenure system, instructors","25","11","14","0","0","0","0","0","0","0","0","0","16","8","8","0","0","0","7","2","5","0","0","0","0","0","0","2","1","1","-2"
"226152","Texas A & M International University","2017","Not on tenure/no tenure system, lecturers","6","4","2","0","0","0","0","0","0","0","0","0","4","3","1","0","0","0","2","1","1","0","0","0","0","0","0","0","0","0","-2"
"226587","McMurry University","2017","Tenured total","46","31","15","1","1","0","1","0","1","0","0","0","4","1","3","0","0","0","40","29","11","0","0","0","0","0","0","0","0","0","-2"
"226587","McMurry University","2017","Tenured, professors","28","21","7","1","1","0","1","0","1","0","0","0","0","0","0","0","0","0","26","20","6","0","0","0","0","0","0","0","0","0","-2"
"226587","McMurry University","2017","Tenured, associate professors","17","10","7","0","0","0","0","0","0","0","0","0","4","1","3","0","0","0","13","9","4","0","0","0","0","0","0","0","0","0","-2"
"226587","McMurry University","2017","Tenured, assistant professors","1","0","1","0","0","0","0","0","0","0","0","0","0","0","0","0","0","0","1","0","1","0","0","0","0","0","0","0","0","0","-2"
"226587","McMurry University","2017","On-Tenure track total","10","5","5","0","0","0","0","0","0","0","0","0","0","0","0","0","0","0","8","4","4","0","0","0","0","0","0","2","1","1","-2"
"226587","McMurry University","2017","On-tenure track, assistant professors","9","5","4","0","0","0","0","0","0","0","0","0","0","0","0","0","0","0","7","4","3","0","0","0","0","0","0","2","1","1","-2"
"226587","McMurry University","2017","On-tenure track, instructors","1","0","1","0","0","0","0","0","0","0","0","0","0","0","0","0","0","0","1","0","1","0","0","0","0","0","0","0","0","0","-2"
"226587","McMurry University","2017","Not on tenure track/No tenure system system total","21","7","14","0","0","0","0","0","0","0","0","0","1","1","0","0","0","0","19","6","13","0","0","0","0","0","0","1","0","1","-2"
"226587","McMurry University","2017","Not on tenure/no tenure system, assistant professors","3","3","0","0","0","0","0","0","0","0","0","0","1","1","0","0","0","0","2","2","0","0","0","0","0","0","0","0","0","0","-2"
"226587","McMurry University","2017","Not on tenure/no tenure system, instructors","18","4","14","0","0","0","0","0","0","0","0","0","0","0","0","0","0","0","17","4","13","0","0","0","0","0","0","1","0","1","-2"
"226806","Midland College","2017","Not on tenure track/No tenure system system total","134","61","73","0","0","0","1","1","0","4","1","3","16","8","8","0","0","0","111","50","61","0","0","0","2","1","1","0","0","0","-2"
"226806","Midland College","2017","Not on tenure/no tenure system, professors","45","20","25","0","0","0","1","1","0","0","0","0","7","3","4","0","0","0","36","16","20","0","0","0","1","0","1","0","0","0","-2"
"226806","Midland College","2017","Not on tenure/no tenure system, associate professors","45","19","26","0","0","0","0","0","0","1","0","1","7","4","3","0","0","0","37","15","22","0","0","0","0","0","0","0","0","0","-2"
"226806","Midland College","2017","Not on tenure/no tenure system, assistant professors","18","9","9","0","0","0","0","0","0","0","0","0","2","1","1","0","0","0","16","8","8","0","0","0","0","0","0","0","0","0","-2"
"226806","Midland College","2017","Not on tenure/no tenure system, instructors","26","13","13","0","0","0","0","0","0","3","1","2","0","0","0","0","0","0","22","11","11","0","0","0","1","1","0","0","0","0","-2"
"227216","University of North Texas","2017","Tenured total","609","410","199","1","1","0","99","70","29","23","12","11","37","23","14","0","0","0","413","280","133","5","4","1","18","14","4","13","6","7","-2"
"227216","University of North Texas","2017","Tenured, professors","325","239","86","1","1","0","40","33","7","9","5","4","17","11","6","0","0","0","241","175","66","2","1","1","11","9","2","4","4","0","-2"
"227216","University of North Texas","2017","Tenured, associate professors","283","170","113","0","0","0","59","37","22","14","7","7","20","12","8","0","0","0","171","104","67","3","3","0","7","5","2","9","2","7","-2"
"227216","University of North Texas","2017","Tenured, assistant professors","1","1","0","0","0","0","0","0","0","0","0","0","0","0","0","0","0","0","1","1","0","0","0","0","0","0","0","0","0","0","-2"
"227216","University of North Texas","2017","On-Tenure track total","158","77","81","0","0","0","31","17","14","13","3","10","13","7","6","0","0","0","86","46","40","3","1","2","8","1","7","4","2","2","-2"
"227216","University of North Texas","2017","On-tenure track, associate professors","5","3","2","0","0","0","1","1","0","0","0","0","0","0","0","0","0","0","4","2","2","0","0","0","0","0","0","0","0","0","-2"
"227216","University of North Texas","2017","On-tenure track, assistant professors","153","74","79","0","0","0","30","16","14","13","3","10","13","7","6","0","0","0","82","44","38","3","1","2","8","1","7","4","2","2","-2"
"227216","University of North Texas","2017","Not on tenure track/No tenure system system total","335","134","201","0","0","0","24","8","16","17","7","10","30","11","19","1","0","1","240","100","140","8","0","8","8","3","5","7","5","2","-2"
"227216","University of North Texas","2017","Not on tenure/no tenure system, instructors","71","27","44","0","0","0","3","1","2","1","1","0","12","5","7","0","0","0","48","16","32","2","0","2","2","1","1","3","3","0","-2"
"227216","University of North Texas","2017","Not on tenure/no tenure system, lecturers","263","107","156","0","0","0","21","7","14","16","6","10","18","6","12","1","0","1","191","84","107","6","0","6","6","2","4","4","2","2","-2"
"227216","University of North Texas","2017","Not on tenure/no tenure system, no academic rank","1","0","1","0","0","0","0","0","0","0","0","0","0","0","0","0","0","0","1","0","1","0","0","0","0","0","0","0","0","0","-2"
"227331","Our Lady of the Lake University","2017","Tenured total","40","15","25","0","0","0","1","1","0","1","0","1","12","4","8","0","0","0","26","10","16","0","0","0","0","0","0","0","0","0","-2"
"227331","Our Lady of the Lake University","2017","Tenured, professors","23","9","14","0","0","0","1","1","0","1","0","1","5","1","4","0","0","0","16","7","9","0","0","0","0","0","0","0","0","0","-2"
"227331","Our Lady of the Lake University","2017","Tenured, associate professors","17","6","11","0","0","0","0","0","0","0","0","0","7","3","4","0","0","0","10","3","7","0","0","0","0","0","0","0","0","0","-2"
"227331","Our Lady of the Lake University","2017","On-Tenure track total","24","6","18","0","0","0","4","2","2","2","0","2","6","2","4","0","0","0","10","1","9","0","0","0","0","0","0","2","1","1","-2"
"227331","Our Lady of the Lake University","2017","On-tenure track, assistant professors","24","6","18","0","0","0","4","2","2","2","0","2","6","2","4","0","0","0","10","1","9","0","0","0","0","0","0","2","1","1","-2"
"227331","Our Lady of the Lake University","2017","Not on tenure track/No tenure system system total","38","13","25","0","0","0","0","0","0","0","0","0","14","3","11","0","0","0","23","9","14","0","0","0","0","0","0","1","1","0","-2"
"227331","Our Lady of the Lake University","2017","Not on tenure/no tenure system, professors","5","1","4","0","0","0","0","0","0","0","0","0","2","0","2","0","0","0","3","1","2","0","0","0","0","0","0","0","0","0","-2"
"227331","Our Lady of the Lake University","2017","Not on tenure/no tenure system, associate professors","4","2","2","0","0","0","0","0","0","0","0","0","1","0","1","0","0","0","3","2","1","0","0","0","0","0","0","0","0","0","-2"
"227331","Our Lady of the Lake University","2017","Not on tenure/no tenure system, assistant professors","28","9","19","0","0","0","0","0","0","0","0","0","11","3","8","0","0","0","16","5","11","0","0","0","0","0","0","1","1","0","-2"
"227331","Our Lady of the Lake University","2017","Not on tenure/no tenure system, instructors","1","1","0","0","0","0","0","0","0","0","0","0","0","0","0","0","0","0","1","1","0","0","0","0","0","0","0","0","0","0","-2"
"227368","The University of Texas Rio Grande Valley","2017","Tenured total","439","305","134","2","1","1","81","61","20","13","11","2","103","51","52","0","0","0","217","162","55","13","12","1","6","4","2","4","3","1","-2"
"227368","The University of Texas Rio Grande Valley","2017","Tenured, professors","193","149","44","2","1","1","38","33","5","2","2","0","42","25","17","0","0","0","96","76","20","9","8","1","4","4","0","0","0","0","-2"
"227368","The University of Texas Rio Grande Valley","2017","Tenured, associate professors","246","156","90","0","0","0","43","28","15","11","9","2","61","26","35","0","0","0","121","86","35","4","4","0","2","0","2","4","3","1","-2"
"227368","The University of Texas Rio Grande Valley","2017","On-Tenure track total","234","133","101","1","1","0","33","21","12","8","5","3","63","34","29","0","0","0","90","48","42","2","0","2","5","4","1","32","20","12","-2"
"227368","The University of Texas Rio Grande Valley","2017","On-tenure track, professors","8","6","2","0","0","0","1","1","0","0","0","0","2","1","1","0","0","0","1","1","0","0","0","0","4","3","1","0","0","0","-2"
"227368","The University of Texas Rio Grande Valley","2017","On-tenure track, assistant professors","226","127","99","1","1","0","32","20","12","8","5","3","61","33","28","0","0","0","89","47","42","2","0","2","1","1","0","32","20","12","-2"
"227368","The University of Texas Rio Grande Valley","2017","Not on tenure track/No tenure system system total","501","239","262","1","0","1","45","20","25","8","3","5","251","115","136","0","0","0","144","69","75","5","2","3","18","10","8","29","20","9","-2"
"227368","The University of Texas Rio Grande Valley","2017","Not on tenure/no tenure system, professors","7","4","3","0","0","0","1","1","0","0","0","0","1","1","0","0","0","0","5","2","3","0","0","0","0","0","0","0","0","0","-2"
"227368","The University of Texas Rio Grande Valley","2017","Not on tenure/no tenure system, associate professors","11","6","5","0","0","0","2","1","1","0","0","0","2","1","1","0","0","0","4","2","2","0","0","0","2","1","1","1","1","0","-2"
"227368","The University of Texas Rio Grande Valley","2017","Not on tenure/no tenure system, assistant professors","21","6","15","0","0","0","1","0","1","1","0","1","11","4","7","0","0","0","5","1","4","1","0","1","0","0","0","2","1","1","-2"
"227368","The University of Texas Rio Grande Valley","2017","Not on tenure/no tenure system, lecturers","451","218","233","1","0","1","41","18","23","6","2","4","229","107","122","0","0","0","130","64","66","4","2","2","15","8","7","25","17","8","-2"
"227368","The University of Texas Rio Grande Valley","2017","Not on tenure/no tenure system, no academic rank","11","5","6","0","0","0","0","0","0","1","1","0","8","2","6","0","0","0","0","0","0","0","0","0","1","1","0","1","1","0","-2"
"227845","Saint Edward's University","2017","Tenured total","81","35","46","0","0","0","2","1","1","2","0","2","6","1","5","0","0","0","70","32","38","1","1","0","0","0","0","0","0","0","-2"
"227845","Saint Edward's University","2017","Tenured, professors","35","15","20","0","0","0","0","0","0","1","0","1","2","0","2","0","0","0","31","14","17","1","1","0","0","0","0","0","0","0","-2"
"227845","Saint Edward's University","2017","Tenured, associate professors","46","20","26","0","0","0","2","1","1","1","0","1","4","1","3","0","0","0","39","18","21","0","0","0","0","0","0","0","0","0","-2"
"227845","Saint Edward's University","2017","On-Tenure track total","83","39","44","1","1","0","4","3","1","2","0","2","8","2","6","0","0","0","65","33","32","1","0","1","0","0","0","2","0","2","-2"
"227845","Saint Edward's University","2017","On-tenure track, professors","2","1","1","1","1","0","0","0","0","0","0","0","0","0","0","0","0","0","1","0","1","0","0","0","0","0","0","0","0","0","-2"
"227845","Saint Edward's University","2017","On-tenure track, associate professors","32","16","16","0","0","0","1","0","1","0","0","0","3","1","2","0","0","0","26","15","11","1","0","1","0","0","0","1","0","1","-2"
"227845","Saint Edward's University","2017","On-tenure track, assistant professors","49","22","27","0","0","0","3","3","0","2","0","2","5","1","4","0","0","0","38","18","20","0","0","0","0","0","0","1","0","1","-2"
"227845","Saint Edward's University","2017","Not on tenure track/No tenure system system total","28","15","13","0","0","0","2","1","1","1","1","0","3","2","1","0","0","0","21","11","10","0","0","0","0","0","0","1","0","1","-2"
"227845","Saint Edward's University","2017","Not on tenure/no tenure system, assistant professors","23","14","9","0","0","0","1","1","0","1","1","0","2","1","1","0","0","0","19","11","8","0","0","0","0","0","0","0","0","0","-2"
"227845","Saint Edward's University","2017","Not on tenure/no tenure system, instructors","5","1","4","0","0","0","1","0","1","0","0","0","1","1","0","0","0","0","2","0","2","0","0","0","0","0","0","1","0","1","-2"
"227863","University of St Thomas","2017","Tenured total","76","47","29","0","0","0","4","2","2","2","2","0","7","3","4","0","0","0","57","37","20","3","3","0","1","0","1","2","0","2","-2"
"227863","University of St Thomas","2017","Tenured, professors","33","21","12","0","0","0","2","1","1","0","0","0","2","1","1","0","0","0","29","19","10","0","0","0","0","0","0","0","0","0","-2"
"227863","University of St Thomas","2017","Tenured, associate professors","42","25","17","0","0","0","2","1","1","2","2","0","4","1","3","0","0","0","28","18","10","3","3","0","1","0","1","2","0","2","-2"
"227863","University of St Thomas","2017","Tenured, assistant professors","1","1","0","0","0","0","0","0","0","0","0","0","1","1","0","0","0","0","0","0","0","0","0","0","0","0","0","0","0","0","-2"
"227863","University of St Thomas","2017","On-Tenure track total","34","18","16","0","0","0","5","3","2","2","1","1","7","5","2","0","0","0","11","6","5","0","0","0","2","1","1","7","2","5","-2"
"227863","University of St Thomas","2017","On-tenure track, associate professors","8","6","2","0","0","0","1","1","0","0","0","0","4","3","1","0","0","0","3","2","1","0","0","0","0","0","0","0","0","0","-2"
"227863","University of St Thomas","2017","On-tenure track, assistant professors","26","12","14","0","0","0","4","2","2","2","1","1","3","2","1","0","0","0","8","4","4","0","0","0","2","1","1","7","2","5","-2"
"227863","University of St Thomas","2017","Not on tenure track/No tenure system system total","42","17","25","0","0","0","5","1","4","7","2","5","4","3","1","0","0","0","23","9","14","0","0","0","1","1","0","2","1","1","-2"
"227863","University of St Thomas","2017","Not on tenure/no tenure system, professors","4","1","3","0","0","0","0","0","0","2","0","2","1","1","0","0","0","0","1","0","1","0","0","0","0","0","0","0","0","0","-2"
"227863","University of St Thomas","2017","Not on tenure/no tenure system, associate professors","3","1","2","0","0","0","1","0","1","0","0","0","0","0","0","0","0","0","2","1","1","0","0","0","0","0","0","0","0","0","-2"
"227863","University of St Thomas","2017","Not on tenure/no tenure system, assistant professors","27","12","15","0","0","0","3","1","2","3","1","2","3","2","1","0","0","0","16","7","9","0","0","0","1","1","0","1","0","1","-2"
"227863","University of St Thomas","2017","Not on tenure/no tenure system, instructors","7","3","4","0","0","0","1","0","1","2","1","1","0","0","0","0","0","0","3","1","2","0","0","0","0","0","0","1","1","0","-2"
"227863","University of St Thomas","2017","Not on tenure/no tenure system, no academic rank","1","0","1","0","0","0","0","0","0","0","0","0","0","0","0","0","0","0","1","0","1","0","0","0","0","0","0","0","0","0","-2"
"228042","Schreiner University","2017","Tenured total","23","13","10","0","0","0","0","0","0","0","0","0","0","0","0","0","0","0","23","13","10","0","0","0","0","0","0","0","0","0","-2"
"228042","Schreiner University","2017","Tenured, professors","14","8","6","0","0","0","0","0","0","0","0","0","0","0","0","0","0","0","14","8","6","0","0","0","0","0","0","0","0","0","-2"
"228042","Schreiner University","2017","Tenured, associate professors","9","5","4","0","0","0","0","0","0","0","0","0","0","0","0","0","0","0","9","5","4","0","0","0","0","0","0","0","0","0","-2"
"228042","Schreiner University","2017","On-Tenure track total","28","17","11","0","0","0","0","0","0","0","0","0","4","3","1","0","0","0","24","14","10","0","0","0","0","0","0","0","0","0","-2"
"228042","Schreiner University","2017","On-tenure track, associate professors","1","0","1","0","0","0","0","0","0","0","0","0","0","0","0","0","0","0","1","0","1","0","0","0","0","0","0","0","0","0","-2"
"228042","Schreiner University","2017","On-tenure track, assistant professors","27","17","10","0","0","0","0","0","0","0","0","0","4","3","1","0","0","0","23","14","9","0","0","0","0","0","0","0","0","0","-2"
"228042","Schreiner University","2017","Not on tenure track/No tenure system system total","29","10","19","0","0","0","1","0","1","0","0","0","6","4","2","0","0","0","22","6","16","0","0","0","0","0","0","0","0","0","-2"
"228042","Schreiner University","2017","Not on tenure/no tenure system, professors","1","1","0","0","0","0","0","0","0","0","0","0","0","0","0","0","0","0","1","1","0","0","0","0","0","0","0","0","0","0","-2"
"228042","Schreiner University","2017","Not on tenure/no tenure system, assistant professors","8","4","4","0","0","0","0","0","0","0","0","0","2","2","0","0","0","0","6","2","4","0","0","0","0","0","0","0","0","0","-2"
"228042","Schreiner University","2017","Not on tenure/no tenure system, instructors","15","3","12","0","0","0","1","0","1","0","0","0","2","1","1","0","0","0","12","2","10","0","0","0","0","0","0","0","0","0","-2"
"228042","Schreiner University","2017","Not on tenure/no tenure system, no academic rank","5","2","3","0","0","0","0","0","0","0","0","0","2","1","1","0","0","0","3","1","2","0","0","0","0","0","0","0","0","0","-2"
"228149","St. Mary's University","2017","Tenured total","141","94","47","1","1","0","7","7","0","5","4","1","19","12","7","1","1","0","102","63","39","0","0","0","0","0","0","6","6","0","-2"
"228149","St. Mary's University","2017","Tenured, professors","88","61","27","0","0","0","7","7","0","4","4","0","8","4","4","1","1","0","66","43","23","0","0","0","0","0","0","2","2","0","-2"
"228149","St. Mary's University","2017","Tenured, associate professors","50","30","20","1","1","0","0","0","0","1","0","1","11","8","3","0","0","0","33","17","16","0","0","0","0","0","0","4","4","0","-2"
"228149","St. Mary's University","2017","Tenured, assistant professors","3","3","0","0","0","0","0","0","0","0","0","0","0","0","0","0","0","0","3","3","0","0","0","0","0","0","0","0","0","0","-2"
"228149","St. Mary's University","2017","On-Tenure track total","34","19","15","0","0","0","2","1","1","0","0","0","4","4","0","0","0","0","18","7","11","0","0","0","1","1","0","9","6","3","-2"
"228149","St. Mary's University","2017","On-tenure track, associate professors","1","0","1","0","0","0","0","0","0","0","0","0","0","0","0","0","0","0","1","0","1","0","0","0","0","0","0","0","0","0","-2"
"228149","St. Mary's University","2017","On-tenure track, assistant professors","33","19","14","0","0","0","2","1","1","0","0","0","4","4","0","0","0","0","17","7","10","0","0","0","1","1","0","9","6","3","-2"
"228149","St. Mary's University","2017","Not on tenure track/No tenure system system total","50","24","26","1","1","0","0","0","0","2","1","1","12","5","7","0","0","0","34","16","18","0","0","0","0","0","0","1","1","0","-2"
"228149","St. Mary's University","2017","Not on tenure/no tenure system, professors","8","2","6","0","0","0","0","0","0","0","0","0","2","1","1","0","0","0","6","1","5","0","0","0","0","0","0","0","0","0","-2"
"228149","St. Mary's University","2017","Not on tenure/no tenure system, associate professors","1","1","0","0","0","0","0","0","0","0","0","0","0","0","0","0","0","0","1","1","0","0","0","0","0","0","0","0","0","0","-2"
"228149","St. Mary's University","2017","Not on tenure/no tenure system, assistant professors","11","8","3","1","1","0","0","0","0","0","0","0","2","1","1","0","0","0","8","6","2","0","0","0","0","0","0","0","0","0","-2"
"228149","St. Mary's University","2017","Not on tenure/no tenure system, instructors","25","13","12","0","0","0","0","0","0","2","1","1","5","3","2","0","0","0","17","8","9","0","0","0","0","0","0","1","1","0","-2"
"228149","St. Mary's University","2017","Not on tenure/no tenure system, lecturers","5","0","5","0","0","0","0","0","0","0","0","0","3","0","3","0","0","0","2","0","2","0","0","0","0","0","0","0","0","0","-2"
"228468","Southwestern Adventist University","2017","Not on tenure track/No tenure system system total","49","30","19","0","0","0","1","1","0","5","4","1","8","5","3","1","0","1","33","19","14","0","0","0","0","0","0","1","1","0","-2"
"228468","Southwestern Adventist University","2017","Not on tenure/no tenure system, professors","14","12","2","0","0","0","0","0","0","3","3","0","1","1","0","0","0","0","10","8","2","0","0","0","0","0","0","0","0","0","-2"
"228468","Southwestern Adventist University","2017","Not on tenure/no tenure system, associate professors","11","9","2","0","0","0","1","1","0","1","1","0","1","1","0","0","0","0","7","5","2","0","0","0","0","0","0","1","1","0","-2"
"228468","Southwestern Adventist University","2017","Not on tenure/no tenure system, assistant professors","23","8","15","0","0","0","0","0","0","1","0","1","5","2","3","1","0","1","16","6","10","0","0","0","0","0","0","0","0","0","-2"
"228468","Southwestern Adventist University","2017","Not on tenure/no tenure system, instructors","1","1","0","0","0","0","0","0","0","0","0","0","1","1","0","0","0","0","0","0","0","0","0","0","0","0","0","0","0","0","-2"
"228501","Sul Ross State University","2017","Tenured total","52","31","21","1","1","0","1","1","0","1","1","0","9","6","3","0","0","0","37","21","16","1","0","1","0","0","0","2","1","1","-2"
"228501","Sul Ross State University","2017","Tenured, professors","37","22","15","1","1","0","1","1","0","1","1","0","6","3","3","0","0","0","26","16","10","1","0","1","0","0","0","1","0","1","-2"
"228501","Sul Ross State University","2017","Tenured, associate professors","15","9","6","0","0","0","0","0","0","0","0","0","3","3","0","0","0","0","11","5","6","0","0","0","0","0","0","1","1","0","-2"
"228501","Sul Ross State University","2017","On-Tenure track total","38","21","17","0","0","0","1","1","0","0","0","0","10","3","7","0","0","0","23","13","10","0","0","0","0","0","0","4","4","0","-2"
"228501","Sul Ross State University","2017","On-tenure track, associate professors","6","3","3","0","0","0","0","0","0","0","0","0","1","1","0","0","0","0","5","2","3","0","0","0","0","0","0","0","0","0","-2"
"228501","Sul Ross State University","2017","On-tenure track, assistant professors","29","17","12","0","0","0","1","1","0","0","0","0","8","2","6","0","0","0","16","10","6","0","0","0","0","0","0","4","4","0","-2"
"228501","Sul Ross State University","2017","On-tenure track, instructors","3","1","2","0","0","0","0","0","0","0","0","0","1","0","1","0","0","0","2","1","1","0","0","0","0","0","0","0","0","0","-2"
"228501","Sul Ross State University","2017","Not on tenure track/No tenure system system total","24","8","16","0","0","0","1","0","1","2","1","1","7","2","5","0","0","0","14","5","9","0","0","0","0","0","0","0","0","0","-2"
"228501","Sul Ross State University","2017","Not on tenure/no tenure system, assistant professors","3","0","3","0","0","0","1","0","1","1","0","1","1","0","1","0","0","0","0","0","0","0","0","0","0","0","0","0","0","0","-2"
"228501","Sul Ross State University","2017","Not on tenure/no tenure system, instructors","1","0","1","0","0","0","0","0","0","0","0","0","0","0","0","0","0","0","1","0","1","0","0","0","0","0","0","0","0","0","-2"
"228501","Sul Ross State University","2017","Not on tenure/no tenure system, lecturers","19","7","12","0","0","0","0","0","0","0","0","0","6","2","4","0","0","0","13","5","8","0","0","0","0","0","0","0","0","0","-2"
"228501","Sul Ross State University","2017","Not on tenure/no tenure system, no academic rank","1","1","0","0","0","0","0","0","0","1","1","0","0","0","0","0","0","0","0","0","0","0","0","0","0","0","0","0","0","0","-2"
"228644","The University of Texas Health Science Center at San Antonio","2017","Tenured total","238","168","70","0","0","0","39","29","10","4","4","0","27","13","14","0","0","0","163","119","44","0","0","0","5","3","2","0","0","0","-2"
"228644","The University of Texas Health Science Center at San Antonio","2017","Tenured, professors","165","125","40","0","0","0","24","21","3","3","3","0","16","11","5","0","0","0","119","88","31","0","0","0","3","2","1","0","0","0","-2"
"228644","The University of Texas Health Science Center at San Antonio","2017","Tenured, associate professors","70","43","27","0","0","0","15","8","7","1","1","0","10","2","8","0","0","0","42","31","11","0","0","0","2","1","1","0","0","0","-2"
"228644","The University of Texas Health Science Center at San Antonio","2017","Tenured, assistant professors","3","0","3","0","0","0","0","0","0","0","0","0","1","0","1","0","0","0","2","0","2","0","0","0","0","0","0","0","0","0","-2"
"228644","The University of Texas Health Science Center at San Antonio","2017","On-Tenure track total","64","35","29","1","1","0","22","12","10","4","2","2","8","5","3","0","0","0","26","13","13","0","0","0","3","2","1","0","0","0","-2"
"228644","The University of Texas Health Science Center at San Antonio","2017","On-tenure track, professors","1","1","0","0","0","0","0","0","0","0","0","0","0","0","0","0","0","0","1","1","0","0","0","0","0","0","0","0","0","0","-2"
"228644","The University of Texas Health Science Center at San Antonio","2017","On-tenure track, associate professors","10","5","5","0","0","0","1","1","0","0","0","0","0","0","0","0","0","0","9","4","5","0","0","0","0","0","0","0","0","0","-2"
"228644","The University of Texas Health Science Center at San Antonio","2017","On-tenure track, assistant professors","53","29","24","1","1","0","21","11","10","4","2","2","8","5","3","0","0","0","16","8","8","0","0","0","3","2","1","0","0","0","-2"
"228644","The University of Texas Health Science Center at San Antonio","2017","Not on tenure track/No tenure system system total","513","254","259","0","0","0","83","41","42","14","3","11","106","46","60","2","0","2","286","152","134","0","0","0","22","12","10","0","0","0","-2"
"228644","The University of Texas Health Science Center at San Antonio","2017","Not on tenure/no tenure system, professors","59","40","19","0","0","0","8","5","3","2","1","1","5","3","2","0","0","0","44","31","13","0","0","0","0","0","0","0","0","0","-2"
"228644","The University of Texas Health Science Center at San Antonio","2017","Not on tenure/no tenure system, associate professors","119","76","43","0","0","0","22","14","8","0","0","0","17","9","8","1","0","1","78","52","26","0","0","0","1","1","0","0","0","0","-2"
"228644","The University of Texas Health Science Center at San Antonio","2017","Not on tenure/no tenure system, assistant professors","271","115","156","0","0","0","49","21","28","10","1","9","66","29","37","1","0","1","124","53","71","0","0","0","21","11","10","0","0","0","-2"
"228644","The University of Texas Health Science Center at San Antonio","2017","Not on tenure/no tenure system, instructors","25","11","14","0","0","0","1","1","0","0","0","0","10","4","6","0","0","0","14","6","8","0","0","0","0","0","0","0","0","0","-2"
"228644","The University of Texas Health Science Center at San Antonio","2017","Not on tenure/no tenure system, lecturers","6","2","4","0","0","0","1","0","1","0","0","0","0","0","0","0","0","0","5","2","3","0","0","0","0","0","0","0","0","0","-2"
"228644","The University of Texas Health Science Center at San Antonio","2017","Not on tenure/no tenure system, no academic rank","33","10","23","0","0","0","2","0","2","2","1","1","8","1","7","0","0","0","21","8","13","0","0","0","0","0","0","0","0","0","-2"
"228705","Texas A & M University-Kingsville","2017","Tenured total","169","119","50","2","2","0","26","22","4","6","6","0","26","18","8","0","0","0","106","70","36","0","0","0","1","1","0","2","0","2","-2"
"228705","Texas A & M University-Kingsville","2017","Tenured, professors","96","71","25","1","1","0","18","15","3","4","4","0","13","9","4","0","0","0","58","41","17","0","0","0","1","1","0","1","0","1","-2"
"228705","Texas A & M University-Kingsville","2017","Tenured, associate professors","70","48","22","1","1","0","7","7","0","2","2","0","13","9","4","0","0","0","46","29","17","0","0","0","0","0","0","1","0","1","-2"
"228705","Texas A & M University-Kingsville","2017","Tenured, assistant professors","3","0","3","0","0","0","1","0","1","0","0","0","0","0","0","0","0","0","2","0","2","0","0","0","0","0","0","0","0","0","-2"
"228705","Texas A & M University-Kingsville","2017","On-Tenure track total","121","73","48","1","1","0","17","11","6","2","1","1","14","5","9","0","0","0","57","34","23","1","1","0","3","2","1","26","18","8","-2"
"228705","Texas A & M University-Kingsville","2017","On-tenure track, professors","1","1","0","0","0","0","0","0","0","0","0","0","0","0","0","0","0","0","1","1","0","0","0","0","0","0","0","0","0","0","-2"
"228705","Texas A & M University-Kingsville","2017","On-tenure track, associate professors","9","9","0","0","0","0","0","0","0","0","0","0","2","2","0","0","0","0","6","6","0","0","0","0","1","1","0","0","0","0","-2"
"228705","Texas A & M University-Kingsville","2017","On-tenure track, assistant professors","110","63","47","1","1","0","17","11","6","2","1","1","12","3","9","0","0","0","49","27","22","1","1","0","2","1","1","26","18","8","-2"
"228705","Texas A & M University-Kingsville","2017","On-tenure track, no academic rank","1","0","1","0","0","0","0","0","0","0","0","0","0","0","0","0","0","0","1","0","1","0","0","0","0","0","0","0","0","0","-2"
"228705","Texas A & M University-Kingsville","2017","Not on tenure track/No tenure system system total","92","53","39","2","2","0","7","5","2","3","3","0","23","10","13","0","0","0","43","22","21","2","2","0","0","0","0","12","9","3","-2"
"228705","Texas A & M University-Kingsville","2017","Not on tenure/no tenure system, professors","1","1","0","0","0","0","0","0","0","0","0","0","1","1","0","0","0","0","0","0","0","0","0","0","0","0","0","0","0","0","-2"
"228705","Texas A & M University-Kingsville","2017","Not on tenure/no tenure system, associate professors","2","1","1","0","0","0","0","0","0","0","0","0","1","0","1","0","0","0","1","1","0","0","0","0","0","0","0","0","0","0","-2"
"228705","Texas A & M University-Kingsville","2017","Not on tenure/no tenure system, assistant professors","7","7","0","0","0","0","2","2","0","0","0","0","1","1","0","0","0","0","1","1","0","0","0","0","0","0","0","3","3","0","-2"
"228705","Texas A & M University-Kingsville","2017","Not on tenure/no tenure system, instructors","1","0","1","0","0","0","0","0","0","0","0","0","0","0","0","0","0","0","0","0","0","0","0","0","0","0","0","1","0","1","-2"
"228705","Texas A & M University-Kingsville","2017","Not on tenure/no tenure system, lecturers","68","37","31","2","2","0","3","2","1","2","2","0","18","8","10","0","0","0","33","15","18","2","2","0","0","0","0","8","6","2","-2"
"228705","Texas A & M University-Kingsville","2017","Not on tenure/no tenure system, no academic rank","13","7","6","0","0","0","2","1","1","1","1","0","2","0","2","0","0","0","8","5","3","0","0","0","0","0","0","0","0","0","-2"
"228981","Texas Lutheran University","2017","Tenured total","47","26","21","0","0","0","1","0","1","1","1","0","2","1","1","0","0","0","42","23","19","0","0","0","1","1","0","0","0","0","-2"
"228981","Texas Lutheran University","2017","Tenured, professors","27","15","12","0","0","0","0","0","0","0","0","0","0","0","0","0","0","0","27","15","12","0","0","0","0","0","0","0","0","0","-2"
"228981","Texas Lutheran University","2017","Tenured, associate professors","17","8","9","0","0","0","1","0","1","0","0","0","2","1","1","0","0","0","13","6","7","0","0","0","1","1","0","0","0","0","-2"
"228981","Texas Lutheran University","2017","Tenured, assistant professors","3","3","0","0","0","0","0","0","0","1","1","0","0","0","0","0","0","0","2","2","0","0","0","0","0","0","0","0","0","0","-2"
"228981","Texas Lutheran University","2017","On-Tenure track total","26","9","17","0","0","0","0","0","0","0","0","0","3","0","3","0","0","0","22","9","13","0","0","0","1","0","1","0","0","0","-2"
"228981","Texas Lutheran University","2017","On-tenure track, associate professors","2","0","2","0","0","0","0","0","0","0","0","0","0","0","0","0","0","0","2","0","2","0","0","0","0","0","0","0","0","0","-2"
"228981","Texas Lutheran University","2017","On-tenure track, assistant professors","22","9","13","0","0","0","0","0","0","0","0","0","2","0","2","0","0","0","19","9","10","0","0","0","1","0","1","0","0","0","-2"
"228981","Texas Lutheran University","2017","On-tenure track, instructors","2","0","2","0","0","0","0","0","0","0","0","0","1","0","1","0","0","0","1","0","1","0","0","0","0","0","0","0","0","0","-2"
"228981","Texas Lutheran University","2017","Not on tenure track/No tenure system system total","9","3","6","0","0","0","0","0","0","0","0","0","2","1","1","0","0","0","6","1","5","0","0","0","0","0","0","1","1","0","-2"
"228981","Texas Lutheran University","2017","Not on tenure/no tenure system, assistant professors","3","2","1","0","0","0","0","0","0","0","0","0","1","1","0","0","0","0","1","0","1","0","0","0","0","0","0","1","1","0","-2"
"228981","Texas Lutheran University","2017","Not on tenure/no tenure system, lecturers","6","1","5","0","0","0","0","0","0","0","0","0","1","0","1","0","0","0","5","1","4","0","0","0","0","0","0","0","0","0","-2"
"229018","The University of Texas Permian Basin","2017","Tenured total","51","35","16","0","0","0","7","6","1","0","0","0","5","2","3","0","0","0","39","27","12","0","0","0","0","0","0","0","0","0","-2"
"229018","The University of Texas Permian Basin","2017","Tenured, professors","16","12","4","0","0","0","1","1","0","0","0","0","1","0","1","0","0","0","14","11","3","0","0","0","0","0","0","0","0","0","-2"
"229018","The University of Texas Permian Basin","2017","Tenured, associate professors","34","22","12","0","0","0","6","5","1","0","0","0","3","1","2","0","0","0","25","16","9","0","0","0","0","0","0","0","0","0","-2"
"229018","The University of Texas Permian Basin","2017","Tenured, assistant professors","1","1","0","0","0","0","0","0","0","0","0","0","1","1","0","0","0","0","0","0","0","0","0","0","0","0","0","0","0","0","-2"
"229018","The University of Texas Permian Basin","2017","On-Tenure track total","37","18","19","0","0","0","4","4","0","1","0","1","2","1","1","0","0","0","21","9","12","4","1","3","0","0","0","5","3","2","-2"
"229018","The University of Texas Permian Basin","2017","On-tenure track, professors","2","1","1","0","0","0","0","0","0","0","0","0","1","1","0","0","0","0","0","0","0","0","0","0","0","0","0","1","0","1","-2"
"229018","The University of Texas Permian Basin","2017","On-tenure track, associate professors","6","4","2","0","0","0","1","1","0","0","0","0","0","0","0","0","0","0","4","2","2","0","0","0","0","0","0","1","1","0","-2"
"229018","The University of Texas Permian Basin","2017","On-tenure track, assistant professors","29","13","16","0","0","0","3","3","0","1","0","1","1","0","1","0","0","0","17","7","10","4","1","3","0","0","0","3","2","1","-2"
"229018","The University of Texas Permian Basin","2017","Not on tenure track/No tenure system system total","44","17","27","0","0","0","1","0","1","1","0","1","1","1","0","0","0","0","35","11","24","3","2","1","0","0","0","3","3","0","-2"
"229018","The University of Texas Permian Basin","2017","Not on tenure/no tenure system, professors","1","1","0","0","0","0","0","0","0","0","0","0","0","0","0","0","0","0","1","1","0","0","0","0","0","0","0","0","0","0","-2"
"229018","The University of Texas Permian Basin","2017","Not on tenure/no tenure system, associate professors","1","1","0","0","0","0","0","0","0","0","0","0","0","0","0","0","0","0","1","1","0","0","0","0","0","0","0","0","0","0","-2"
"229018","The University of Texas Permian Basin","2017","Not on tenure/no tenure system, assistant professors","2","2","0","0","0","0","0","0","0","0","0","0","0","0","0","0","0","0","2","2","0","0","0","0","0","0","0","0","0","0","-2"
"229018","The University of Texas Permian Basin","2017","Not on tenure/no tenure system, instructors","5","0","5","0","0","0","0","0","0","0","0","0","0","0","0","0","0","0","5","0","5","0","0","0","0","0","0","0","0","0","-2"
"229018","The University of Texas Permian Basin","2017","Not on tenure/no tenure system, lecturers","35","13","22","0","0","0","1","0","1","1","0","1","1","1","0","0","0","0","26","7","19","3","2","1","0","0","0","3","3","0","-2"
"229027","The University of Texas at San Antonio","2017","Tenured total","443","309","134","4","3","1","91","75","16","19","11","8","78","43","35","0","0","0","243","172","71","1","1","0","5","3","2","2","1","1","-2"
"229027","The University of Texas at San Antonio","2017","Tenured, professors","244","187","57","2","2","0","56","48","8","8","5","3","37","23","14","0","0","0","136","106","30","0","0","0","5","3","2","0","0","0","-2"
"229027","The University of Texas at San Antonio","2017","Tenured, associate professors","199","122","77","2","1","1","35","27","8","11","6","5","41","20","21","0","0","0","107","66","41","1","1","0","0","0","0","2","1","1","-2"
"229027","The University of Texas at San Antonio","2017","On-Tenure track total","165","102","63","0","0","0","22","15","7","4","3","1","22","9","13","0","0","0","74","47","27","0","0","0","21","12","9","22","16","6","-2"
"229027","The University of Texas at San Antonio","2017","On-tenure track, associate professors","9","8","1","0","0","0","1","1","0","0","0","0","1","0","1","0","0","0","5","5","0","0","0","0","2","2","0","0","0","0","-2"
"229027","The University of Texas at San Antonio","2017","On-tenure track, assistant professors","156","94","62","0","0","0","21","14","7","4","3","1","21","9","12","0","0","0","69","42","27","0","0","0","19","10","9","22","16","6","-2"
"229027","The University of Texas at San Antonio","2017","Not on tenure track/No tenure system system total","268","134","134","0","0","0","14","9","5","10","4","6","53","29","24","0","0","0","170","83","87","2","0","2","16","7","9","3","2","1","-2"
"229027","The University of Texas at San Antonio","2017","Not on tenure/no tenure system, assistant professors","10","4","6","0","0","0","1","1","0","1","0","1","4","1","3","0","0","0","2","1","1","0","0","0","1","0","1","1","1","0","-2"
"229027","The University of Texas at San Antonio","2017","Not on tenure/no tenure system, lecturers","258","130","128","0","0","0","13","8","5","9","4","5","49","28","21","0","0","0","168","82","86","2","0","2","15","7","8","2","1","1","-2"
"229160","Texas Wesleyan University","2017","Tenured total","79","40","39","0","0","0","5","3","2","1","1","0","5","3","2","0","0","0","66","31","35","2","2","0","0","0","0","0","0","0","-2"
"229160","Texas Wesleyan University","2017","Tenured, professors","37","22","15","0","0","0","2","2","0","1","1","0","4","3","1","0","0","0","29","15","14","1","1","0","0","0","0","0","0","0","-2"
"229160","Texas Wesleyan University","2017","Tenured, associate professors","41","18","23","0","0","0","3","1","2","0","0","0","1","0","1","0","0","0","36","16","20","1","1","0","0","0","0","0","0","0","-2"
"229160","Texas Wesleyan University","2017","Tenured, assistant professors","1","0","1","0","0","0","0","0","0","0","0","0","0","0","0","0","0","0","1","0","1","0","0","0","0","0","0","0","0","0","-2"
"229160","Texas Wesleyan University","2017","On-Tenure track total","32","16","16","0","0","0","1","0","1","1","0","1","5","3","2","0","0","0","24","13","11","1","0","1","0","0","0","0","0","0","-2"
"229160","Texas Wesleyan University","2017","On-tenure track, professors","1","0","1","0","0","0","0","0","0","0","0","0","0","0","0","0","0","0","1","0","1","0","0","0","0","0","0","0","0","0","-2"
"229160","Texas Wesleyan University","2017","On-tenure track, associate professors","2","0","2","0","0","0","0","0","0","0","0","0","1","0","1","0","0","0","1","0","1","0","0","0","0","0","0","0","0","0","-2"
"229160","Texas Wesleyan University","2017","On-tenure track, assistant professors","27","15","12","0","0","0","1","0","1","1","0","1","3","3","0","0","0","0","21","12","9","1","0","1","0","0","0","0","0","0","-2"
"229160","Texas Wesleyan University","2017","On-tenure track, instructors","1","1","0","0","0","0","0","0","0","0","0","0","0","0","0","0","0","0","1","1","0","0","0","0","0","0","0","0","0","0","-2"
"229160","Texas Wesleyan University","2017","On-tenure track, no academic rank","1","0","1","0","0","0","0","0","0","0","0","0","1","0","1","0","0","0","0","0","0","0","0","0","0","0","0","0","0","0","-2"
"229160","Texas Wesleyan University","2017","Not on tenure track/No tenure system system total","25","11","14","0","0","0","3","1","2","0","0","0","1","1","0","0","0","0","20","9","11","1","0","1","0","0","0","0","0","0","-2"
"229160","Texas Wesleyan University","2017","Not on tenure/no tenure system, professors","2","2","0","0","0","0","0","0","0","0","0","0","0","0","0","0","0","0","2","2","0","0","0","0","0","0","0","0","0","0","-2"
"229160","Texas Wesleyan University","2017","Not on tenure/no tenure system, associate professors","4","1","3","0","0","0","1","0","1","0","0","0","1","1","0","0","0","0","2","0","2","0","0","0","0","0","0","0","0","0","-2"
"229160","Texas Wesleyan University","2017","Not on tenure/no tenure system, assistant professors","9","3","6","0","0","0","1","0","1","0","0","0","0","0","0","0","0","0","7","3","4","1","0","1","0","0","0","0","0","0","-2"
"229160","Texas Wesleyan University","2017","Not on tenure/no tenure system, instructors","9","4","5","0","0","0","0","0","0","0","0","0","0","0","0","0","0","0","9","4","5","0","0","0","0","0","0","0","0","0","-2"
"229160","Texas Wesleyan University","2017","Not on tenure/no tenure system, no academic rank","1","1","0","0","0","0","1","1","0","0","0","0","0","0","0","0","0","0","0","0","0","0","0","0","0","0","0","0","0","0","-2"
"229179","Texas Woman's University","2017","Tenured total","218","61","157","1","0","1","23","10","13","9","1","8","6","2","4","2","1","1","175","45","130","2","2","0","0","0","0","0","0","0","-2"
"229179","Texas Woman's University","2017","Tenured, professors","112","34","78","1","0","1","14","7","7","3","0","3","4","2","2","0","0","0","89","24","65","1","1","0","0","0","0","0","0","0","-2"
"229179","Texas Woman's University","2017","Tenured, associate professors","103","27","76","0","0","0","9","3","6","5","1","4","2","0","2","2","1","1","84","21","63","1","1","0","0","0","0","0","0","0","-2"
"229179","Texas Woman's University","2017","Tenured, assistant professors","3","0","3","0","0","0","0","0","0","1","0","1","0","0","0","0","0","0","2","0","2","0","0","0","0","0","0","0","0","0","-2"
"229179","Texas Woman's University","2017","On-Tenure track total","116","41","75","2","0","2","11","3","8","10","4","6","11","2","9","0","0","0","77","30","47","3","0","3","2","2","0","0","0","0","-2"
"229179","Texas Woman's University","2017","On-tenure track, professors","1","0","1","0","0","0","0","0","0","0","0","0","0","0","0","0","0","0","1","0","1","0","0","0","0","0","0","0","0","0","-2"
"229179","Texas Woman's University","2017","On-tenure track, associate professors","10","1","9","0","0","0","2","0","2","0","0","0","1","0","1","0","0","0","6","1","5","1","0","1","0","0","0","0","0","0","-2"
"229179","Texas Woman's University","2017","On-tenure track, assistant professors","105","40","65","2","0","2","9","3","6","10","4","6","10","2","8","0","0","0","70","29","41","2","0","2","2","2","0","0","0","0","-2"
"229179","Texas Woman's University","2017","Not on tenure track/No tenure system system total","122","15","107","1","0","1","10","2","8","7","0","7","6","1","5","0","0","0","97","11","86","1","1","0","0","0","0","0","0","0","-2"
"229179","Texas Woman's University","2017","Not on tenure/no tenure system, professors","3","1","2","0","0","0","0","0","0","0","0","0","0","0","0","0","0","0","3","1","2","0","0","0","0","0","0","0","0","0","-2"
"229179","Texas Woman's University","2017","Not on tenure/no tenure system, associate professors","44","3","41","1","0","1","4","1","3","3","0","3","0","0","0","0","0","0","36","2","34","0","0","0","0","0","0","0","0","0","-2"
"229179","Texas Woman's University","2017","Not on tenure/no tenure system, assistant professors","62","8","54","0","0","0","6","1","5","3","0","3","6","1","5","0","0","0","46","5","41","1","1","0","0","0","0","0","0","0","-2"
"229179","Texas Woman's University","2017","Not on tenure/no tenure system, instructors","2","0","2","0","0","0","0","0","0","0","0","0","0","0","0","0","0","0","2","0","2","0","0","0","0","0","0","0","0","0","-2"
"229179","Texas Woman's University","2017","Not on tenure/no tenure system, lecturers","11","3","8","0","0","0","0","0","0","1","0","1","0","0","0","0","0","0","10","3","7","0","0","0","0","0","0","0","0","0","-2"
"229300","The University of Texas Health Science Center at Houston","2017","Tenured total","267","176","91","0","0","0","26","22","4","5","5","0","13","8","5","0","0","0","161","97","64","1","1","0","5","4","1","56","39","17","-2"
"229300","The University of Texas Health Science Center at Houston","2017","Tenured, professors","195","137","58","0","0","0","22","19","3","4","4","0","8","7","1","0","0","0","125","80","45","1","1","0","5","4","1","30","22","8","-2"
"229300","The University of Texas Health Science Center at Houston","2017","Tenured, associate professors","72","39","33","0","0","0","4","3","1","1","1","0","5","1","4","0","0","0","36","17","19","0","0","0","0","0","0","26","17","9","-2"
"229300","The University of Texas Health Science Center at Houston","2017","On-Tenure track total","166","101","65","0","0","0","21","14","7","5","1","4","11","6","5","0","0","0","62","35","27","0","0","0","2","1","1","65","44","21","-2"
"229300","The University of Texas Health Science Center at Houston","2017","On-tenure track, professors","16","13","3","0","0","0","4","4","0","0","0","0","1","1","0","0","0","0","10","8","2","0","0","0","0","0","0","1","0","1","-2"
"229300","The University of Texas Health Science Center at Houston","2017","On-tenure track, associate professors","39","23","16","0","0","0","8","6","2","1","0","1","3","1","2","0","0","0","11","6","5","0","0","0","0","0","0","16","10","6","-2"
"229300","The University of Texas Health Science Center at Houston","2017","On-tenure track, assistant professors","111","65","46","0","0","0","9","4","5","4","1","3","7","4","3","0","0","0","41","21","20","0","0","0","2","1","1","48","34","14","-2"
"229300","The University of Texas Health Science Center at Houston","2017","Not on tenure track/No tenure system system total","1337","691","646","4","4","0","234","118","116","86","24","62","91","40","51","0","0","0","527","272","255","11","5","6","55","33","22","329","195","134","-2"
"229300","The University of Texas Health Science Center at Houston","2017","Not on tenure/no tenure system, professors","122","80","42","1","1","0","12","8","4","3","0","3","7","4","3","0","0","0","67","46","21","0","0","0","6","4","2","26","17","9","-2"
"229300","The University of Texas Health Science Center at Houston","2017","Not on tenure/no tenure system, associate professors","245","136","109","1","1","0","39","18","21","11","3","8","18","7","11","0","0","0","108","64","44","1","1","0","6","3","3","61","39","22","-2"
"229300","The University of Texas Health Science Center at Houston","2017","Not on tenure/no tenure system, assistant professors","873","442","431","2","2","0","172","86","86","66","20","46","64","29","35","0","0","0","313","154","159","10","4","6","42","25","17","204","122","82","-2"
"229300","The University of Texas Health Science Center at Houston","2017","Not on tenure/no tenure system, instructors","75","28","47","0","0","0","11","6","5","5","1","4","0","0","0","0","0","0","27","5","22","0","0","0","1","1","0","31","15","16","-2"
"229300","The University of Texas Health Science Center at Houston","2017","Not on tenure/no tenure system, no academic rank","22","5","17","0","0","0","0","0","0","1","0","1","2","0","2","0","0","0","12","3","9","0","0","0","0","0","0","7","2","5","-2"
"229337","Texas Tech University Health Sciences Center","2017","Tenured total","149","101","48","0","0","0","28","18","10","1","1","0","9","8","1","0","0","0","111","74","37","0","0","0","0","0","0","0","0","0","-2"
"229337","Texas Tech University Health Sciences Center","2017","Tenured, professors","104","77","27","0","0","0","22","16","6","0","0","0","5","5","0","0","0","0","77","56","21","0","0","0","0","0","0","0","0","0","-2"
"229337","Texas Tech University Health Sciences Center","2017","Tenured, associate professors","45","24","21","0","0","0","6","2","4","1","1","0","4","3","1","0","0","0","34","18","16","0","0","0","0","0","0","0","0","0","-2"
"229337","Texas Tech University Health Sciences Center","2017","On-Tenure track total","87","52","35","0","0","0","24","13","11","1","1","0","9","5","4","0","0","0","53","33","20","0","0","0","0","0","0","0","0","0","-2"
"229337","Texas Tech University Health Sciences Center","2017","On-tenure track, professors","17","15","2","0","0","0","7","5","2","0","0","0","1","1","0","0","0","0","9","9","0","0","0","0","0","0","0","0","0","0","-2"
"229337","Texas Tech University Health Sciences Center","2017","On-tenure track, associate professors","25","14","11","0","0","0","8","4","4","0","0","0","2","1","1","0","0","0","15","9","6","0","0","0","0","0","0","0","0","0","-2"
"229337","Texas Tech University Health Sciences Center","2017","On-tenure track, assistant professors","45","23","22","0","0","0","9","4","5","1","1","0","6","3","3","0","0","0","29","15","14","0","0","0","0","0","0","0","0","0","-2"
"229337","Texas Tech University Health Sciences Center","2017","Not on tenure track/No tenure system system total","762","354","408","2","2","0","135","83","52","46","15","31","128","58","70","0","0","0","450","195","255","0","0","0","1","1","0","0","0","0","-2"
"229337","Texas Tech University Health Sciences Center","2017","Not on tenure/no tenure system, professors","47","31","16","0","0","0","6","5","1","1","0","1","1","1","0","0","0","0","39","25","14","0","0","0","0","0","0","0","0","0","-2"
"229337","Texas Tech University Health Sciences Center","2017","Not on tenure/no tenure system, associate professors","193","99","94","2","2","0","34","21","13","14","5","9","25","14","11","0","0","0","118","57","61","0","0","0","0","0","0","0","0","0","-2"
"229337","Texas Tech University Health Sciences Center","2017","Not on tenure/no tenure system, assistant professors","401","194","207","0","0","0","83","53","30","25","9","16","71","34","37","0","0","0","221","97","124","0","0","0","1","1","0","0","0","0","-2"
"229337","Texas Tech University Health Sciences Center","2017","Not on tenure/no tenure system, instructors","61","11","50","0","0","0","7","3","4","5","1","4","13","3","10","0","0","0","36","4","32","0","0","0","0","0","0","0","0","0","-2"
"229337","Texas Tech University Health Sciences Center","2017","Not on tenure/no tenure system, no academic rank","60","19","41","0","0","0","5","1","4","1","0","1","18","6","12","0","0","0","36","12","24","0","0","0","0","0","0","0","0","0","-2"
"229355","Tyler Junior College","2017","Not on tenure track/No tenure system system total","310","135","175","2","0","2","0","0","0","19","5","14","8","4","4","1","0","1","277","125","152","0","0","0","1","0","1","2","1","1","-2"
"229355","Tyler Junior College","2017","Not on tenure/no tenure system, professors","310","135","175","2","0","2","0","0","0","19","5","14","8","4","4","1","0","1","277","125","152","0","0","0","1","0","1","2","1","1","-2"
"229780","Wayland Baptist University","2017","Not on tenure track/No tenure system system total","142","92","50","2","1","1","5","3","2","10","5","5","5","4","1","0","0","0","105","71","34","4","1","3","11","7","4","0","0","0","-2"
"229780","Wayland Baptist University","2017","Not on tenure/no tenure system, professors","60","43","17","1","1","0","2","1","1","1","1","0","1","1","0","0","0","0","54","38","16","0","0","0","1","1","0","0","0","0","-2"
"229780","Wayland Baptist University","2017","Not on tenure/no tenure system, associate professors","38","28","10","0","0","0","3","2","1","5","2","3","2","1","1","0","0","0","22","19","3","1","0","1","5","4","1","0","0","0","-2"
"229780","Wayland Baptist University","2017","Not on tenure/no tenure system, assistant professors","33","12","21","1","0","1","0","0","0","4","2","2","1","1","0","0","0","0","20","6","14","2","1","1","5","2","3","0","0","0","-2"
"229780","Wayland Baptist University","2017","Not on tenure/no tenure system, instructors","7","7","0","0","0","0","0","0","0","0","0","0","0","0","0","0","0","0","7","7","0","0","0","0","0","0","0","0","0","0","-2"
"229780","Wayland Baptist University","2017","Not on tenure/no tenure system, lecturers","4","2","2","0","0","0","0","0","0","0","0","0","1","1","0","0","0","0","2","1","1","1","0","1","0","0","0","0","0","0","-2"
"229814","West Texas A & M University","2017","Tenured total","111","75","36","3","3","0","11","7","4","1","1","0","3","2","1","0","0","0","92","62","30","0","0","0","1","0","1","0","0","0","-2"
"229814","West Texas A & M University","2017","Tenured, professors","55","36","19","2","2","0","3","3","0","0","0","0","1","1","0","0","0","0","49","30","19","0","0","0","0","0","0","0","0","0","-2"
"229814","West Texas A & M University","2017","Tenured, associate professors","55","38","17","1","1","0","8","4","4","1","1","0","2","1","1","0","0","0","42","31","11","0","0","0","1","0","1","0","0","0","-2"
"229814","West Texas A & M University","2017","Tenured, assistant professors","1","1","0","0","0","0","0","0","0","0","0","0","0","0","0","0","0","0","1","1","0","0","0","0","0","0","0","0","0","0","-2"
"229814","West Texas A & M University","2017","On-Tenure track total","54","28","26","0","0","0","1","1","0","2","2","0","2","0","2","0","0","0","47","23","24","0","0","0","0","0","0","2","2","0","-2"
"229814","West Texas A & M University","2017","On-tenure track, professors","1","0","1","0","0","0","0","0","0","0","0","0","0","0","0","0","0","0","1","0","1","0","0","0","0","0","0","0","0","0","-2"
"229814","West Texas A & M University","2017","On-tenure track, associate professors","15","7","8","0","0","0","0","0","0","0","0","0","1","0","1","0","0","0","14","7","7","0","0","0","0","0","0","0","0","0","-2"
"229814","West Texas A & M University","2017","On-tenure track, assistant professors","36","20","16","0","0","0","0","0","0","2","2","0","1","0","1","0","0","0","31","16","15","0","0","0","0","0","0","2","2","0","-2"
"229814","West Texas A & M University","2017","On-tenure track, instructors","2","1","1","0","0","0","1","1","0","0","0","0","0","0","0","0","0","0","1","0","1","0","0","0","0","0","0","0","0","0","-2"
"229814","West Texas A & M University","2017","Not on tenure track/No tenure system system total","170","78","92","0","0","0","5","2","3","1","1","0","9","3","6","0","0","0","133","60","73","0","0","0","1","1","0","21","11","10","-2"
"229814","West Texas A & M University","2017","Not on tenure/no tenure system, professors","3","3","0","0","0","0","0","0","0","0","0","0","1","1","0","0","0","0","2","2","0","0","0","0","0","0","0","0","0","0","-2"
"229814","West Texas A & M University","2017","Not on tenure/no tenure system, assistant professors","74","40","34","0","0","0","3","0","3","0","0","0","1","0","1","0","0","0","52","31","21","0","0","0","1","1","0","17","8","9","-2"
"229814","West Texas A & M University","2017","Not on tenure/no tenure system, instructors","91","35","56","0","0","0","2","2","0","1","1","0","7","2","5","0","0","0","77","27","50","0","0","0","0","0","0","4","3","1","-2"
"229814","West Texas A & M University","2017","Not on tenure/no tenure system, lecturers","2","0","2","0","0","0","0","0","0","0","0","0","0","0","0","0","0","0","2","0","2","0","0","0","0","0","0","0","0","0","-2"
"234979","Columbia Basin College","2017","Tenured total","77","39","38","1","1","0","8","4","4","3","2","1","4","1","3","0","0","0","61","31","30","0","0","0","0","0","0","0","0","0","-2"
"234979","Columbia Basin College","2017","Tenured, no academic rank","77","39","38","1","1","0","8","4","4","3","2","1","4","1","3","0","0","0","61","31","30","0","0","0","0","0","0","0","0","0","-2"
"234979","Columbia Basin College","2017","On-Tenure track total","29","13","16","0","0","0","1","0","1","0","0","0","2","1","1","0","0","0","25","11","14","1","1","0","0","0","0","0","0","0","-2"
"234979","Columbia Basin College","2017","On-tenure track, no academic rank","29","13","16","0","0","0","1","0","1","0","0","0","2","1","1","0","0","0","25","11","14","1","1","0","0","0","0","0","0","0","-2"
"234979","Columbia Basin College","2017","Not on tenure track/No tenure system system total","20","6","14","0","0","0","0","0","0","0","0","0","4","2","2","1","0","1","15","4","11","0","0","0","0","0","0","0","0","0","-2"
"234979","Columbia Basin College","2017","Not on tenure/no tenure system, no academic rank","20","6","14","0","0","0","0","0","0","0","0","0","4","2","2","1","0","1","15","4","11","0","0","0","0","0","0","0","0","0","-2"
"235422","Heritage University","2017","Not on tenure track/No tenure system system total","73","35","38","5","2","3","2","2","0","2","1","1","7","2","5","1","1","0","55","26","29","1","1","0","0","0","0","0","0","0","-2"
"235422","Heritage University","2017","Not on tenure/no tenure system, professors","8","4","4","0","0","0","0","0","0","0","0","0","0","0","0","0","0","0","7","3","4","1","1","0","0","0","0","0","0","0","-2"
"235422","Heritage University","2017","Not on tenure/no tenure system, associate professors","25","14","11","3","0","3","1","1","0","0","0","0","3","0","3","1","1","0","17","12","5","0","0","0","0","0","0","0","0","0","-2"
"235422","Heritage University","2017","Not on tenure/no tenure system, assistant professors","35","16","19","2","2","0","1","1","0","2","1","1","3","2","1","0","0","0","27","10","17","0","0","0","0","0","0","0","0","0","-2"
"235422","Heritage University","2017","Not on tenure/no tenure system, instructors","5","1","4","0","0","0","0","0","0","0","0","0","1","0","1","0","0","0","4","1","3","0","0","0","0","0","0","0","0","0","-2"
"236975","Wenatchee Valley College","2017","Tenured total","47","27","20","0","0","0","2","0","2","1","0","1","3","3","0","0","0","0","39","23","16","2","1","1","0","0","0","0","0","0","-2"
"236975","Wenatchee Valley College","2017","Tenured, no academic rank","47","27","20","0","0","0","2","0","2","1","0","1","3","3","0","0","0","0","39","23","16","2","1","1","0","0","0","0","0","0","-2"
"236975","Wenatchee Valley College","2017","On-Tenure track total","23","12","11","0","0","0","0","0","0","0","0","0","1","1","0","0","0","0","19","8","11","3","3","0","0","0","0","0","0","0","-2"
"236975","Wenatchee Valley College","2017","On-tenure track, no academic rank","23","12","11","0","0","0","0","0","0","0","0","0","1","1","0","0","0","0","19","8","11","3","3","0","0","0","0","0","0","0","-2"
"236975","Wenatchee Valley College","2017","Not on tenure track/No tenure system system total","5","3","2","0","0","0","0","0","0","0","0","0","0","0","0","0","0","0","5","3","2","0","0","0","0","0","0","0","0","0","-2"
"236975","Wenatchee Valley College","2017","Not on tenure/no tenure system, no academic rank","5","3","2","0","0","0","0","0","0","0","0","0","0","0","0","0","0","0","5","3","2","0","0","0","0","0","0","0","0","0","-2"
"237109","Yakima Valley College","2017","Tenured total","71","31","40","1","1","0","2","1","1","0","0","0","5","1","4","0","0","0","63","28","35","0","0","0","0","0","0","0","0","0","-2"
"237109","Yakima Valley College","2017","Tenured, instructors","71","31","40","1","1","0","2","1","1","0","0","0","5","1","4","0","0","0","63","28","35","0","0","0","0","0","0","0","0","0","-2"
"237109","Yakima Valley College","2017","On-Tenure track total","13","6","7","0","0","0","0","0","0","0","0","0","2","1","1","0","0","0","11","5","6","0","0","0","0","0","0","0","0","0","-2"
"237109","Yakima Valley College","2017","On-tenure track, instructors","13","6","7","0","0","0","0","0","0","0","0","0","2","1","1","0","0","0","11","5","6","0","0","0","0","0","0","0","0","0","-2"
"237109","Yakima Valley College","2017","Not on tenure track/No tenure system system total","45","22","23","0","0","0","1","0","1","0","0","0","2","1","1","0","0","0","42","21","21","0","0","0","0","0","0","0","0","0","-2"
"237109","Yakima Valley College","2017","Not on tenure/no tenure system, instructors","45","22","23","0","0","0","1","0","1","0","0","0","2","1","1","0","0","0","42","21","21","0","0","0","0","0","0","0","0","0","-2"
"238193","Alverno College","2017","Tenured total","51","13","38","0","0","0","1","0","1","2","0","2","0","0","0","0","0","0","47","12","35","0","0","0","1","1","0","0","0","0","-2"
"238193","Alverno College","2017","Tenured, professors","30","8","22","0","0","0","1","0","1","0","0","0","0","0","0","0","0","0","29","8","21","0","0","0","0","0","0","0","0","0","-2"
"238193","Alverno College","2017","Tenured, associate professors","17","4","13","0","0","0","0","0","0","1","0","1","0","0","0","0","0","0","15","3","12","0","0","0","1","1","0","0","0","0","-2"
"238193","Alverno College","2017","Tenured, assistant professors","4","1","3","0","0","0","0","0","0","1","0","1","0","0","0","0","0","0","3","1","2","0","0","0","0","0","0","0","0","0","-2"
"238193","Alverno College","2017","On-Tenure track total","35","5","30","0","0","0","0","0","0","2","0","2","2","0","2","0","0","0","31","5","26","0","0","0","0","0","0","0","0","0","-2"
"238193","Alverno College","2017","On-tenure track, associate professors","5","0","5","0","0","0","0","0","0","0","0","0","0","0","0","0","0","0","5","0","5","0","0","0","0","0","0","0","0","0","-2"
"238193","Alverno College","2017","On-tenure track, assistant professors","30","5","25","0","0","0","0","0","0","2","0","2","2","0","2","0","0","0","26","5","21","0","0","0","0","0","0","0","0","0","-2"
"238193","Alverno College","2017","Not on tenure track/No tenure system system total","1","0","1","0","0","0","0","0","0","0","0","0","0","0","0","0","0","0","1","0","1","0","0","0","0","0","0","0","0","0","-2"
"238193","Alverno College","2017","Not on tenure/no tenure system, assistant professors","1","0","1","0","0","0","0","0","0","0","0","0","0","0","0","0","0","0","1","0","1","0","0","0","0","0","0","0","0","0","-2"
"239390","Mount Mary University","2017","Tenured total","34","4","30","0","0","0","1","0","1","1","0","1","0","0","0","0","0","0","32","4","28","0","0","0","0","0","0","0","0","0","-2"
"239390","Mount Mary University","2017","Tenured, professors","10","2","8","0","0","0","0","0","0","0","0","0","0","0","0","0","0","0","10","2","8","0","0","0","0","0","0","0","0","0","-2"
"239390","Mount Mary University","2017","Tenured, associate professors","19","2","17","0","0","0","1","0","1","1","0","1","0","0","0","0","0","0","17","2","15","0","0","0","0","0","0","0","0","0","-2"
"239390","Mount Mary University","2017","Tenured, assistant professors","5","0","5","0","0","0","0","0","0","0","0","0","0","0","0","0","0","0","5","0","5","0","0","0","0","0","0","0","0","0","-2"
"239390","Mount Mary University","2017","On-Tenure track total","16","3","13","0","0","0","0","0","0","0","0","0","1","1","0","0","0","0","15","2","13","0","0","0","0","0","0","0","0","0","-2"
"239390","Mount Mary University","2017","On-tenure track, associate professors","2","0","2","0","0","0","0","0","0","0","0","0","0","0","0","0","0","0","2","0","2","0","0","0","0","0","0","0","0","0","-2"
"239390","Mount Mary University","2017","On-tenure track, assistant professors","14","3","11","0","0","0","0","0","0","0","0","0","1","1","0","0","0","0","13","2","11","0","0","0","0","0","0","0","0","0","-2"
"239390","Mount Mary University","2017","Not on tenure track/No tenure system system total","18","1","17","0","0","0","0","0","0","1","0","1","0","0","0","0","0","0","17","1","16","0","0","0","0","0","0","0","0","0","-2"
"239390","Mount Mary University","2017","Not on tenure/no tenure system, associate professors","1","0","1","0","0","0","0","0","0","0","0","0","0","0","0","0","0","0","1","0","1","0","0","0","0","0","0","0","0","0","-2"
"239390","Mount Mary University","2017","Not on tenure/no tenure system, assistant professors","9","1","8","0","0","0","0","0","0","1","0","1","0","0","0","0","0","0","8","1","7","0","0","0","0","0","0","0","0","0","-2"
"239390","Mount Mary University","2017","Not on tenure/no tenure system, instructors","8","0","8","0","0","0","0","0","0","0","0","0","0","0","0","0","0","0","8","0","8","0","0","0","0","0","0","0","0","0","-2"
"241100","American University of Puerto Rico","2017","Tenured total","13","6","7","0","0","0","0","0","0","0","0","0","13","6","7","0","0","0","0","0","0","0","0","0","0","0","0","0","0","0","-2"
"241100","American University of Puerto Rico","2017","Tenured, associate professors","3","1","2","0","0","0","0","0","0","0","0","0","3","1","2","0","0","0","0","0","0","0","0","0","0","0","0","0","0","0","-2"
"241100","American University of Puerto Rico","2017","Tenured, assistant professors","8","4","4","0","0","0","0","0","0","0","0","0","8","4","4","0","0","0","0","0","0","0","0","0","0","0","0","0","0","0","-2"
"241100","American University of Puerto Rico","2017","Tenured, instructors","2","1","1","0","0","0","0","0","0","0","0","0","2","1","1","0","0","0","0","0","0","0","0","0","0","0","0","0","0","0","-2"
"241128","American University of Puerto Rico","2017","Tenured total","8","4","4","0","0","0","0","0","0","0","0","0","7","3","4","0","0","0","1","1","0","0","0","0","0","0","0","0","0","0","-2"
"241128","American University of Puerto Rico","2017","Tenured, associate professors","3","0","3","0","0","0","0","0","0","0","0","0","3","0","3","0","0","0","0","0","0","0","0","0","0","0","0","0","0","0","-2"
"241128","American University of Puerto Rico","2017","Tenured, assistant professors","2","1","1","0","0","0","0","0","0","0","0","0","1","0","1","0","0","0","1","1","0","0","0","0","0","0","0","0","0","0","-2"
"241128","American University of Puerto Rico","2017","Tenured, instructors","3","3","0","0","0","0","0","0","0","0","0","0","3","3","0","0","0","0","0","0","0","0","0","0","0","0","0","0","0","0","-2"
"241191","Universidad Adventista de las Antillas","2017","Tenured total","21","11","10","0","0","0","0","0","0","0","0","0","21","11","10","0","0","0","0","0","0","0","0","0","0","0","0","0","0","0","-2"
"241191","Universidad Adventista de las Antillas","2017","Tenured, professors","1","0","1","0","0","0","0","0","0","0","0","0","1","0","1","0","0","0","0","0","0","0","0","0","0","0","0","0","0","0","-2"
"241191","Universidad Adventista de las Antillas","2017","Tenured, associate professors","10","5","5","0","0","0","0","0","0","0","0","0","10","5","5","0","0","0","0","0","0","0","0","0","0","0","0","0","0","0","-2"
"241191","Universidad Adventista de las Antillas","2017","Tenured, assistant professors","9","5","4","0","0","0","0","0","0","0","0","0","9","5","4","0","0","0","0","0","0","0","0","0","0","0","0","0","0","0","-2"
"241191","Universidad Adventista de las Antillas","2017","Tenured, instructors","1","1","0","0","0","0","0","0","0","0","0","0","1","1","0","0","0","0","0","0","0","0","0","0","0","0","0","0","0","0","-2"
"241191","Universidad Adventista de las Antillas","2017","On-Tenure track total","17","8","9","0","0","0","0","0","0","0","0","0","17","8","9","0","0","0","0","0","0","0","0","0","0","0","0","0","0","0","-2"
"241191","Universidad Adventista de las Antillas","2017","On-tenure track, assistant professors","11","6","5","0","0","0","0","0","0","0","0","0","11","6","5","0","0","0","0","0","0","0","0","0","0","0","0","0","0","0","-2"
"241191","Universidad Adventista de las Antillas","2017","On-tenure track, instructors","6","2","4","0","0","0","0","0","0","0","0","0","6","2","4","0","0","0","0","0","0","0","0","0","0","0","0","0","0","0","-2"
"241191","Universidad Adventista de las Antillas","2017","Not on tenure track/No tenure system system total","5","2","3","0","0","0","0","0","0","0","0","0","5","2","3","0","0","0","0","0","0","0","0","0","0","0","0","0","0","0","-2"
"241191","Universidad Adventista de las Antillas","2017","Not on tenure/no tenure system, no academic rank","5","2","3","0","0","0","0","0","0","0","0","0","5","2","3","0","0","0","0","0","0","0","0","0","0","0","0","0","0","0","-2"
"241216","Atlantic University College","2017","Not on tenure track/No tenure system system total","55","32","23","0","0","0","0","0","0","0","0","0","55","32","23","0","0","0","0","0","0","0","0","0","0","0","0","0","0","0","-2"
"241216","Atlantic University College","2017","Not on tenure/no tenure system, professors","55","32","23","0","0","0","0","0","0","0","0","0","55","32","23","0","0","0","0","0","0","0","0","0","0","0","0","0","0","0","-2"
"241225","Universidad Central de Bayamon","2017","Not on tenure track/No tenure system system total","40","10","30","0","0","0","0","0","0","0","0","0","40","10","30","0","0","0","0","0","0","0","0","0","0","0","0","0","0","0","-2"
"241225","Universidad Central de Bayamon","2017","Not on tenure/no tenure system, professors","2","1","1","0","0","0","0","0","0","0","0","0","2","1","1","0","0","0","0","0","0","0","0","0","0","0","0","0","0","0","-2"
"241225","Universidad Central de Bayamon","2017","Not on tenure/no tenure system, associate professors","17","5","12","0","0","0","0","0","0","0","0","0","17","5","12","0","0","0","0","0","0","0","0","0","0","0","0","0","0","0","-2"
"241225","Universidad Central de Bayamon","2017","Not on tenure/no tenure system, assistant professors","7","2","5","0","0","0","0","0","0","0","0","0","7","2","5","0","0","0","0","0","0","0","0","0","0","0","0","0","0","0","-2"
"241225","Universidad Central de Bayamon","2017","Not on tenure/no tenure system, instructors","14","2","12","0","0","0","0","0","0","0","0","0","14","2","12","0","0","0","0","0","0","0","0","0","0","0","0","0","0","0","-2"
"241377","Caribbean University-Bayamon","2017","Not on tenure track/No tenure system system total","36","22","14","0","0","0","0","0","0","0","0","0","36","22","14","0","0","0","0","0","0","0","0","0","0","0","0","0","0","0","-2"
"241377","Caribbean University-Bayamon","2017","Not on tenure/no tenure system, professors","1","1","0","0","0","0","0","0","0","0","0","0","1","1","0","0","0","0","0","0","0","0","0","0","0","0","0","0","0","0","-2"
"241377","Caribbean University-Bayamon","2017","Not on tenure/no tenure system, associate professors","2","1","1","0","0","0","0","0","0","0","0","0","2","1","1","0","0","0","0","0","0","0","0","0","0","0","0","0","0","0","-2"
"241377","Caribbean University-Bayamon","2017","Not on tenure/no tenure system, assistant professors","7","4","3","0","0","0","0","0","0","0","0","0","7","4","3","0","0","0","0","0","0","0","0","0","0","0","0","0","0","0","-2"
"241377","Caribbean University-Bayamon","2017","Not on tenure/no tenure system, instructors","26","16","10","0","0","0","0","0","0","0","0","0","26","16","10","0","0","0","0","0","0","0","0","0","0","0","0","0","0","0","-2"
"241386","Caribbean University-Carolina","2017","Not on tenure track/No tenure system system total","8","4","4","0","0","0","0","0","0","0","0","0","8","4","4","0","0","0","0","0","0","0","0","0","0","0","0","0","0","0","-2"
"241386","Caribbean University-Carolina","2017","Not on tenure/no tenure system, assistant professors","1","1","0","0","0","0","0","0","0","0","0","0","1","1","0","0","0","0","0","0","0","0","0","0","0","0","0","0","0","0","-2"
"241386","Caribbean University-Carolina","2017","Not on tenure/no tenure system, instructors","7","3","4","0","0","0","0","0","0","0","0","0","7","3","4","0","0","0","0","0","0","0","0","0","0","0","0","0","0","0","-2"
"241395","Pontifical Catholic University of Puerto Rico-Arecibo","2017","Not on tenure track/No tenure system system total","25","11","14","0","0","0","0","0","0","0","0","0","25","11","14","0","0","0","0","0","0","0","0","0","0","0","0","0","0","0","-2"
"241395","Pontifical Catholic University of Puerto Rico-Arecibo","2017","Not on tenure/no tenure system, professors","2","1","1","0","0","0","0","0","0","0","0","0","2","1","1","0","0","0","0","0","0","0","0","0","0","0","0","0","0","0","-2"
"241395","Pontifical Catholic University of Puerto Rico-Arecibo","2017","Not on tenure/no tenure system, associate professors","2","1","1","0","0","0","0","0","0","0","0","0","2","1","1","0","0","0","0","0","0","0","0","0","0","0","0","0","0","0","-2"
"241395","Pontifical Catholic University of Puerto Rico-Arecibo","2017","Not on tenure/no tenure system, assistant professors","7","2","5","0","0","0","0","0","0","0","0","0","7","2","5","0","0","0","0","0","0","0","0","0","0","0","0","0","0","0","-2"
"241395","Pontifical Catholic University of Puerto Rico-Arecibo","2017","Not on tenure/no tenure system, instructors","2","2","0","0","0","0","0","0","0","0","0","0","2","2","0","0","0","0","0","0","0","0","0","0","0","0","0","0","0","0","-2"
"241395","Pontifical Catholic University of Puerto Rico-Arecibo","2017","Not on tenure/no tenure system, no academic rank","12","5","7","0","0","0","0","0","0","0","0","0","12","5","7","0","0","0","0","0","0","0","0","0","0","0","0","0","0","0","-2"
"241410","Pontifical Catholic University of Puerto Rico-Ponce","2017","Not on tenure track/No tenure system system total","235","94","141","0","0","0","0","0","0","0","0","0","220","88","132","0","0","0","12","6","6","0","0","0","3","0","3","0","0","0","-2"
"241410","Pontifical Catholic University of Puerto Rico-Ponce","2017","Not on tenure/no tenure system, professors","36","17","19","0","0","0","0","0","0","0","0","0","34","15","19","0","0","0","2","2","0","0","0","0","0","0","0","0","0","0","-2"
"241410","Pontifical Catholic University of Puerto Rico-Ponce","2017","Not on tenure/no tenure system, associate professors","52","25","27","0","0","0","0","0","0","0","0","0","48","23","25","0","0","0","4","2","2","0","0","0","0","0","0","0","0","0","-2"
"241410","Pontifical Catholic University of Puerto Rico-Ponce","2017","Not on tenure/no tenure system, assistant professors","71","30","41","0","0","0","0","0","0","0","0","0","68","29","39","0","0","0","3","1","2","0","0","0","0","0","0","0","0","0","-2"
"241410","Pontifical Catholic University of Puerto Rico-Ponce","2017","Not on tenure/no tenure system, instructors","19","6","13","0","0","0","0","0","0","0","0","0","18","6","12","0","0","0","1","0","1","0","0","0","0","0","0","0","0","0","-2"
"241410","Pontifical Catholic University of Puerto Rico-Ponce","2017","Not on tenure/no tenure system, no academic rank","57","16","41","0","0","0","0","0","0","0","0","0","52","15","37","0","0","0","2","1","1","0","0","0","3","0","3","0","0","0","-2"
"241614","Universidad Teologica del Caribe","2017","Tenured total","2","0","2","0","0","0","0","0","0","0","0","0","2","0","2","0","0","0","0","0","0","0","0","0","0","0","0","0","0","0","-2"
"241614","Universidad Teologica del Caribe","2017","Tenured, professors","1","0","1","0","0","0","0","0","0","0","0","0","1","0","1","0","0","0","0","0","0","0","0","0","0","0","0","0","0","0","-2"
"241614","Universidad Teologica del Caribe","2017","Tenured, instructors","1","0","1","0","0","0","0","0","0","0","0","0","1","0","1","0","0","0","0","0","0","0","0","0","0","0","0","0","0","0","-2"
"241614","Universidad Teologica del Caribe","2017","Not on tenure track/No tenure system system total","10","6","4","0","0","0","0","0","0","0","0","0","10","6","4","0","0","0","0","0","0","0","0","0","0","0","0","0","0","0","-2"
"241614","Universidad Teologica del Caribe","2017","Not on tenure/no tenure system, instructors","10","6","4","0","0","0","0","0","0","0","0","0","10","6","4","0","0","0","0","0","0","0","0","0","0","0","0","0","0","0","-2"
"241720","Colegio Universitario de San Juan","2017","Tenured total","24","10","14","0","0","0","0","0","0","0","0","0","24","10","14","0","0","0","0","0","0","0","0","0","0","0","0","0","0","0","-2"
"241720","Colegio Universitario de San Juan","2017","Tenured, professors","1","1","0","0","0","0","0","0","0","0","0","0","1","1","0","0","0","0","0","0","0","0","0","0","0","0","0","0","0","0","-2"
"241720","Colegio Universitario de San Juan","2017","Tenured, associate professors","2","1","1","0","0","0","0","0","0","0","0","0","2","1","1","0","0","0","0","0","0","0","0","0","0","0","0","0","0","0","-2"
"241720","Colegio Universitario de San Juan","2017","Tenured, assistant professors","7","4","3","0","0","0","0","0","0","0","0","0","7","4","3","0","0","0","0","0","0","0","0","0","0","0","0","0","0","0","-2"
"241720","Colegio Universitario de San Juan","2017","Tenured, instructors","14","4","10","0","0","0","0","0","0","0","0","0","14","4","10","0","0","0","0","0","0","0","0","0","0","0","0","0","0","0","-2"
"241739","Universidad Ana G. Mendez-Cupey Campus","2017","Tenured total","22","4","18","0","0","0","0","0","0","0","0","0","22","4","18","0","0","0","0","0","0","0","0","0","0","0","0","0","0","0","-2"
"241739","Universidad Ana G. Mendez-Cupey Campus","2017","Tenured, professors","16","2","14","0","0","0","0","0","0","0","0","0","16","2","14","0","0","0","0","0","0","0","0","0","0","0","0","0","0","0","-2"
"241739","Universidad Ana G. Mendez-Cupey Campus","2017","Tenured, associate professors","5","2","3","0","0","0","0","0","0","0","0","0","5","2","3","0","0","0","0","0","0","0","0","0","0","0","0","0","0","0","-2"
"241739","Universidad Ana G. Mendez-Cupey Campus","2017","Tenured, assistant professors","1","0","1","0","0","0","0","0","0","0","0","0","1","0","1","0","0","0","0","0","0","0","0","0","0","0","0","0","0","0","-2"
"241739","Universidad Ana G. Mendez-Cupey Campus","2017","Not on tenure track/No tenure system system total","173","53","120","1","1","0","0","0","0","0","0","0","168","49","119","0","0","0","4","3","1","0","0","0","0","0","0","0","0","0","-2"
"241739","Universidad Ana G. Mendez-Cupey Campus","2017","Not on tenure/no tenure system, professors","18","10","8","0","0","0","0","0","0","0","0","0","17","9","8","0","0","0","1","1","0","0","0","0","0","0","0","0","0","0","-2"
"241739","Universidad Ana G. Mendez-Cupey Campus","2017","Not on tenure/no tenure system, associate professors","19","7","12","0","0","0","0","0","0","0","0","0","17","6","11","0","0","0","2","1","1","0","0","0","0","0","0","0","0","0","-2"
"241739","Universidad Ana G. Mendez-Cupey Campus","2017","Not on tenure/no tenure system, assistant professors","48","17","31","1","1","0","0","0","0","0","0","0","47","16","31","0","0","0","0","0","0","0","0","0","0","0","0","0","0","0","-2"
"241739","Universidad Ana G. Mendez-Cupey Campus","2017","Not on tenure/no tenure system, instructors","88","19","69","0","0","0","0","0","0","0","0","0","87","18","69","0","0","0","1","1","0","0","0","0","0","0","0","0","0","0","-2"
"241766","Conservatory of Music of Puerto Rico","2017","Tenured total","35","25","10","0","0","0","0","0","0","0","0","0","34","25","9","0","0","0","1","0","1","0","0","0","0","0","0","0","0","0","-2"
"241766","Conservatory of Music of Puerto Rico","2017","Tenured, professors","8","4","4","0","0","0","0","0","0","0","0","0","7","4","3","0","0","0","1","0","1","0","0","0","0","0","0","0","0","0","-2"
"241766","Conservatory of Music of Puerto Rico","2017","Tenured, associate professors","16","12","4","0","0","0","0","0","0","0","0","0","16","12","4","0","0","0","0","0","0","0","0","0","0","0","0","0","0","0","-2"
"241766","Conservatory of Music of Puerto Rico","2017","Tenured, assistant professors","9","8","1","0","0","0","0","0","0","0","0","0","9","8","1","0","0","0","0","0","0","0","0","0","0","0","0","0","0","0","-2"
"241766","Conservatory of Music of Puerto Rico","2017","Tenured, instructors","2","1","1","0","0","0","0","0","0","0","0","0","2","1","1","0","0","0","0","0","0","0","0","0","0","0","0","0","0","0","-2"
"241766","Conservatory of Music of Puerto Rico","2017","On-Tenure track total","2","2","0","0","0","0","0","0","0","0","0","0","2","2","0","0","0","0","0","0","0","0","0","0","0","0","0","0","0","0","-2"
"241766","Conservatory of Music of Puerto Rico","2017","On-tenure track, assistant professors","1","1","0","0","0","0","0","0","0","0","0","0","1","1","0","0","0","0","0","0","0","0","0","0","0","0","0","0","0","0","-2"
"241766","Conservatory of Music of Puerto Rico","2017","On-tenure track, instructors","1","1","0","0","0","0","0","0","0","0","0","0","1","1","0","0","0","0","0","0","0","0","0","0","0","0","0","0","0","0","-2"
"241766","Conservatory of Music of Puerto Rico","2017","Not on tenure track/No tenure system system total","11","10","1","0","0","0","0","0","0","0","0","0","10","9","1","0","0","0","1","1","0","0","0","0","0","0","0","0","0","0","-2"
"241766","Conservatory of Music of Puerto Rico","2017","Not on tenure/no tenure system, instructors","1","1","0","0","0","0","0","0","0","0","0","0","0","0","0","0","0","0","1","1","0","0","0","0","0","0","0","0","0","0","-2"
"241766","Conservatory of Music of Puerto Rico","2017","Not on tenure/no tenure system, no academic rank","10","9","1","0","0","0","0","0","0","0","0","0","10","9","1","0","0","0","0","0","0","0","0","0","0","0","0","0","0","0","-2"
"241836","EDP University of Puerto Rico Inc-San Sebastian","2017","Not on tenure track/No tenure system system total","26","7","19","0","0","0","0","0","0","0","0","0","26","7","19","0","0","0","0","0","0","0","0","0","0","0","0","0","0","0","-2"
"241836","EDP University of Puerto Rico Inc-San Sebastian","2017","Not on tenure/no tenure system, instructors","26","7","19","0","0","0","0","0","0","0","0","0","26","7","19","0","0","0","0","0","0","0","0","0","0","0","0","0","0","0","-2"
"241951","Escuela de Artes Plasticas y Diseno de Puerto Rico","2017","Tenured total","14","9","5","0","0","0","0","0","0","0","0","0","14","9","5","0","0","0","0","0","0","0","0","0","0","0","0","0","0","0","-2"
"241951","Escuela de Artes Plasticas y Diseno de Puerto Rico","2017","Tenured, professors","3","2","1","0","0","0","0","0","0","0","0","0","3","2","1","0","0","0","0","0","0","0","0","0","0","0","0","0","0","0","-2"
"241951","Escuela de Artes Plasticas y Diseno de Puerto Rico","2017","Tenured, associate professors","1","0","1","0","0","0","0","0","0","0","0","0","1","0","1","0","0","0","0","0","0","0","0","0","0","0","0","0","0","0","-2"
"241951","Escuela de Artes Plasticas y Diseno de Puerto Rico","2017","Tenured, assistant professors","1","1","0","0","0","0","0","0","0","0","0","0","1","1","0","0","0","0","0","0","0","0","0","0","0","0","0","0","0","0","-2"
"241951","Escuela de Artes Plasticas y Diseno de Puerto Rico","2017","Tenured, instructors","9","6","3","0","0","0","0","0","0","0","0","0","9","6","3","0","0","0","0","0","0","0","0","0","0","0","0","0","0","0","-2"
"241951","Escuela de Artes Plasticas y Diseno de Puerto Rico","2017","On-Tenure track total","1","1","0","0","0","0","0","0","0","0","0","0","1","1","0","0","0","0","0","0","0","0","0","0","0","0","0","0","0","0","-2"
"241951","Escuela de Artes Plasticas y Diseno de Puerto Rico","2017","On-tenure track, instructors","1","1","0","0","0","0","0","0","0","0","0","0","1","1","0","0","0","0","0","0","0","0","0","0","0","0","0","0","0","0","-2"
"241951","Escuela de Artes Plasticas y Diseno de Puerto Rico","2017","Not on tenure track/No tenure system system total","3","0","3","0","0","0","0","0","0","0","0","0","3","0","3","0","0","0","0","0","0","0","0","0","0","0","0","0","0","0","-2"
"241951","Escuela de Artes Plasticas y Diseno de Puerto Rico","2017","Not on tenure/no tenure system, no academic rank","3","0","3","0","0","0","0","0","0","0","0","0","3","0","3","0","0","0","0","0","0","0","0","0","0","0","0","0","0","0","-2"
"242121","Humacao Community College","2017","Not on tenure track/No tenure system system total","18","10","8","0","0","0","0","0","0","0","0","0","18","10","8","0","0","0","0","0","0","0","0","0","0","0","0","0","0","0","-2"
"242121","Humacao Community College","2017","Not on tenure/no tenure system, professors","18","10","8","0","0","0","0","0","0","0","0","0","18","10","8","0","0","0","0","0","0","0","0","0","0","0","0","0","0","0","-2"
"242617","Inter American University of Puerto Rico-San German","2017","Tenured total","79","35","44","0","0","0","0","0","0","1","1","0","77","33","44","0","0","0","1","1","0","0","0","0","0","0","0","0","0","0","-2"
"242617","Inter American University of Puerto Rico-San German","2017","Tenured, professors","26","14","12","0","0","0","0","0","0","0","0","0","25","13","12","0","0","0","1","1","0","0","0","0","0","0","0","0","0","0","-2"
"242617","Inter American University of Puerto Rico-San German","2017","Tenured, associate professors","36","16","20","0","0","0","0","0","0","1","1","0","35","15","20","0","0","0","0","0","0","0","0","0","0","0","0","0","0","0","-2"
"242617","Inter American University of Puerto Rico-San German","2017","Tenured, assistant professors","17","5","12","0","0","0","0","0","0","0","0","0","17","5","12","0","0","0","0","0","0","0","0","0","0","0","0","0","0","0","-2"
"242617","Inter American University of Puerto Rico-San German","2017","On-Tenure track total","19","8","11","0","0","0","0","0","0","0","0","0","19","8","11","0","0","0","0","0","0","0","0","0","0","0","0","0","0","0","-2"
"242617","Inter American University of Puerto Rico-San German","2017","On-tenure track, associate professors","4","1","3","0","0","0","0","0","0","0","0","0","4","1","3","0","0","0","0","0","0","0","0","0","0","0","0","0","0","0","-2"
"242617","Inter American University of Puerto Rico-San German","2017","On-tenure track, assistant professors","14","6","8","0","0","0","0","0","0","0","0","0","14","6","8","0","0","0","0","0","0","0","0","0","0","0","0","0","0","0","-2"
"242617","Inter American University of Puerto Rico-San German","2017","On-tenure track, instructors","1","1","0","0","0","0","0","0","0","0","0","0","1","1","0","0","0","0","0","0","0","0","0","0","0","0","0","0","0","0","-2"
"242617","Inter American University of Puerto Rico-San German","2017","Not on tenure track/No tenure system system total","4","2","2","0","0","0","0","0","0","0","0","0","4","2","2","0","0","0","0","0","0","0","0","0","0","0","0","0","0","0","-2"
"242617","Inter American University of Puerto Rico-San German","2017","Not on tenure/no tenure system, assistant professors","3","2","1","0","0","0","0","0","0","0","0","0","3","2","1","0","0","0","0","0","0","0","0","0","0","0","0","0","0","0","-2"
"242617","Inter American University of Puerto Rico-San German","2017","Not on tenure/no tenure system, instructors","1","0","1","0","0","0","0","0","0","0","0","0","1","0","1","0","0","0","0","0","0","0","0","0","0","0","0","0","0","0","-2"
"242626","Inter American University of Puerto Rico-Aguadilla","2017","Tenured total","54","21","33","0","0","0","0","0","0","1","0","1","53","21","32","0","0","0","0","0","0","0","0","0","0","0","0","0","0","0","-2"
"242626","Inter American University of Puerto Rico-Aguadilla","2017","Tenured, professors","9","1","8","0","0","0","0","0","0","1","0","1","8","1","7","0","0","0","0","0","0","0","0","0","0","0","0","0","0","0","-2"
"242626","Inter American University of Puerto Rico-Aguadilla","2017","Tenured, associate professors","20","6","14","0","0","0","0","0","0","0","0","0","20","6","14","0","0","0","0","0","0","0","0","0","0","0","0","0","0","0","-2"
"242626","Inter American University of Puerto Rico-Aguadilla","2017","Tenured, assistant professors","25","14","11","0","0","0","0","0","0","0","0","0","25","14","11","0","0","0","0","0","0","0","0","0","0","0","0","0","0","0","-2"
"242626","Inter American University of Puerto Rico-Aguadilla","2017","On-Tenure track total","12","3","9","0","0","0","0","0","0","0","0","0","12","3","9","0","0","0","0","0","0","0","0","0","0","0","0","0","0","0","-2"
"242626","Inter American University of Puerto Rico-Aguadilla","2017","On-tenure track, associate professors","2","1","1","0","0","0","0","0","0","0","0","0","2","1","1","0","0","0","0","0","0","0","0","0","0","0","0","0","0","0","-2"
"242626","Inter American University of Puerto Rico-Aguadilla","2017","On-tenure track, assistant professors","5","2","3","0","0","0","0","0","0","0","0","0","5","2","3","0","0","0","0","0","0","0","0","0","0","0","0","0","0","0","-2"
"242626","Inter American University of Puerto Rico-Aguadilla","2017","On-tenure track, instructors","5","0","5","0","0","0","0","0","0","0","0","0","5","0","5","0","0","0","0","0","0","0","0","0","0","0","0","0","0","0","-2"
"242626","Inter American University of Puerto Rico-Aguadilla","2017","Not on tenure track/No tenure system system total","10","4","6","0","0","0","0","0","0","0","0","0","10","4","6","0","0","0","0","0","0","0","0","0","0","0","0","0","0","0","-2"
"242626","Inter American University of Puerto Rico-Aguadilla","2017","Not on tenure/no tenure system, assistant professors","3","0","3","0","0","0","0","0","0","0","0","0","3","0","3","0","0","0","0","0","0","0","0","0","0","0","0","0","0","0","-2"
"242626","Inter American University of Puerto Rico-Aguadilla","2017","Not on tenure/no tenure system, instructors","7","4","3","0","0","0","0","0","0","0","0","0","7","4","3","0","0","0","0","0","0","0","0","0","0","0","0","0","0","0","-2"
"242635","Inter American University of Puerto Rico-Arecibo","2017","Tenured total","51","26","25","0","0","0","0","0","0","0","0","0","51","26","25","0","0","0","0","0","0","0","0","0","0","0","0","0","0","0","-2"
"242635","Inter American University of Puerto Rico-Arecibo","2017","Tenured, professors","20","10","10","0","0","0","0","0","0","0","0","0","20","10","10","0","0","0","0","0","0","0","0","0","0","0","0","0","0","0","-2"
"242635","Inter American University of Puerto Rico-Arecibo","2017","Tenured, associate professors","15","9","6","0","0","0","0","0","0","0","0","0","15","9","6","0","0","0","0","0","0","0","0","0","0","0","0","0","0","0","-2"
"242635","Inter American University of Puerto Rico-Arecibo","2017","Tenured, assistant professors","16","7","9","0","0","0","0","0","0","0","0","0","16","7","9","0","0","0","0","0","0","0","0","0","0","0","0","0","0","0","-2"
"242635","Inter American University of Puerto Rico-Arecibo","2017","On-Tenure track total","19","5","14","0","0","0","0","0","0","0","0","0","19","5","14","0","0","0","0","0","0","0","0","0","0","0","0","0","0","0","-2"
"242635","Inter American University of Puerto Rico-Arecibo","2017","On-tenure track, associate professors","1","0","1","0","0","0","0","0","0","0","0","0","1","0","1","0","0","0","0","0","0","0","0","0","0","0","0","0","0","0","-2"
"242635","Inter American University of Puerto Rico-Arecibo","2017","On-tenure track, assistant professors","13","4","9","0","0","0","0","0","0","0","0","0","13","4","9","0","0","0","0","0","0","0","0","0","0","0","0","0","0","0","-2"
"242635","Inter American University of Puerto Rico-Arecibo","2017","On-tenure track, instructors","5","1","4","0","0","0","0","0","0","0","0","0","5","1","4","0","0","0","0","0","0","0","0","0","0","0","0","0","0","0","-2"
"242635","Inter American University of Puerto Rico-Arecibo","2017","Not on tenure track/No tenure system system total","8","5","3","0","0","0","0","0","0","0","0","0","8","5","3","0","0","0","0","0","0","0","0","0","0","0","0","0","0","0","-2"
"242635","Inter American University of Puerto Rico-Arecibo","2017","Not on tenure/no tenure system, assistant professors","2","2","0","0","0","0","0","0","0","0","0","0","2","2","0","0","0","0","0","0","0","0","0","0","0","0","0","0","0","0","-2"
"242635","Inter American University of Puerto Rico-Arecibo","2017","Not on tenure/no tenure system, instructors","6","3","3","0","0","0","0","0","0","0","0","0","6","3","3","0","0","0","0","0","0","0","0","0","0","0","0","0","0","0","-2"
"242644","Inter American University of Puerto Rico-Barranquitas","2017","Tenured total","14","5","9","0","0","0","0","0","0","0","0","0","14","5","9","0","0","0","0","0","0","0","0","0","0","0","0","0","0","0","-2"
"242644","Inter American University of Puerto Rico-Barranquitas","2017","Tenured, professors","1","1","0","0","0","0","0","0","0","0","0","0","1","1","0","0","0","0","0","0","0","0","0","0","0","0","0","0","0","0","-2"
"242644","Inter American University of Puerto Rico-Barranquitas","2017","Tenured, associate professors","3","1","2","0","0","0","0","0","0","0","0","0","3","1","2","0","0","0","0","0","0","0","0","0","0","0","0","0","0","0","-2"
"242644","Inter American University of Puerto Rico-Barranquitas","2017","Tenured, assistant professors","10","3","7","0","0","0","0","0","0","0","0","0","10","3","7","0","0","0","0","0","0","0","0","0","0","0","0","0","0","0","-2"
"242644","Inter American University of Puerto Rico-Barranquitas","2017","On-Tenure track total","11","6","5","0","0","0","0","0","0","0","0","0","11","6","5","0","0","0","0","0","0","0","0","0","0","0","0","0","0","0","-2"
"242644","Inter American University of Puerto Rico-Barranquitas","2017","On-tenure track, associate professors","2","1","1","0","0","0","0","0","0","0","0","0","2","1","1","0","0","0","0","0","0","0","0","0","0","0","0","0","0","0","-2"
"242644","Inter American University of Puerto Rico-Barranquitas","2017","On-tenure track, assistant professors","6","4","2","0","0","0","0","0","0","0","0","0","6","4","2","0","0","0","0","0","0","0","0","0","0","0","0","0","0","0","-2"
"242644","Inter American University of Puerto Rico-Barranquitas","2017","On-tenure track, instructors","3","1","2","0","0","0","0","0","0","0","0","0","3","1","2","0","0","0","0","0","0","0","0","0","0","0","0","0","0","0","-2"
"242644","Inter American University of Puerto Rico-Barranquitas","2017","Not on tenure track/No tenure system system total","7","3","4","0","0","0","0","0","0","0","0","0","5","2","3","0","0","0","2","1","1","0","0","0","0","0","0","0","0","0","-2"
"242644","Inter American University of Puerto Rico-Barranquitas","2017","Not on tenure/no tenure system, assistant professors","4","2","2","0","0","0","0","0","0","0","0","0","2","1","1","0","0","0","2","1","1","0","0","0","0","0","0","0","0","0","-2"
"242644","Inter American University of Puerto Rico-Barranquitas","2017","Not on tenure/no tenure system, instructors","3","1","2","0","0","0","0","0","0","0","0","0","3","1","2","0","0","0","0","0","0","0","0","0","0","0","0","0","0","0","-2"
"242653","Inter American University of Puerto Rico-Metro","2017","Tenured total","150","70","80","0","0","0","0","0","0","0","0","0","149","69","80","0","0","0","1","1","0","0","0","0","0","0","0","0","0","0","-2"
"242653","Inter American University of Puerto Rico-Metro","2017","Tenured, professors","61","26","35","0","0","0","0","0","0","0","0","0","60","25","35","0","0","0","1","1","0","0","0","0","0","0","0","0","0","0","-2"
"242653","Inter American University of Puerto Rico-Metro","2017","Tenured, associate professors","68","34","34","0","0","0","0","0","0","0","0","0","68","34","34","0","0","0","0","0","0","0","0","0","0","0","0","0","0","0","-2"
"242653","Inter American University of Puerto Rico-Metro","2017","Tenured, assistant professors","21","10","11","0","0","0","0","0","0","0","0","0","21","10","11","0","0","0","0","0","0","0","0","0","0","0","0","0","0","0","-2"
"242653","Inter American University of Puerto Rico-Metro","2017","On-Tenure track total","14","4","10","0","0","0","0","0","0","0","0","0","14","4","10","0","0","0","0","0","0","0","0","0","0","0","0","0","0","0","-2"
"242653","Inter American University of Puerto Rico-Metro","2017","On-tenure track, professors","2","1","1","0","0","0","0","0","0","0","0","0","2","1","1","0","0","0","0","0","0","0","0","0","0","0","0","0","0","0","-2"
"242653","Inter American University of Puerto Rico-Metro","2017","On-tenure track, associate professors","1","0","1","0","0","0","0","0","0","0","0","0","1","0","1","0","0","0","0","0","0","0","0","0","0","0","0","0","0","0","-2"
"242653","Inter American University of Puerto Rico-Metro","2017","On-tenure track, assistant professors","7","2","5","0","0","0","0","0","0","0","0","0","7","2","5","0","0","0","0","0","0","0","0","0","0","0","0","0","0","0","-2"
"242653","Inter American University of Puerto Rico-Metro","2017","On-tenure track, instructors","4","1","3","0","0","0","0","0","0","0","0","0","4","1","3","0","0","0","0","0","0","0","0","0","0","0","0","0","0","0","-2"
"242653","Inter American University of Puerto Rico-Metro","2017","Not on tenure track/No tenure system system total","27","10","17","0","0","0","0","0","0","0","0","0","27","10","17","0","0","0","0","0","0","0","0","0","0","0","0","0","0","0","-2"
"242653","Inter American University of Puerto Rico-Metro","2017","Not on tenure/no tenure system, professors","8","2","6","0","0","0","0","0","0","0","0","0","8","2","6","0","0","0","0","0","0","0","0","0","0","0","0","0","0","0","-2"
"242653","Inter American University of Puerto Rico-Metro","2017","Not on tenure/no tenure system, associate professors","2","2","0","0","0","0","0","0","0","0","0","0","2","2","0","0","0","0","0","0","0","0","0","0","0","0","0","0","0","0","-2"
"242653","Inter American University of Puerto Rico-Metro","2017","Not on tenure/no tenure system, assistant professors","8","2","6","0","0","0","0","0","0","0","0","0","8","2","6","0","0","0","0","0","0","0","0","0","0","0","0","0","0","0","-2"
"242653","Inter American University of Puerto Rico-Metro","2017","Not on tenure/no tenure system, instructors","9","4","5","0","0","0","0","0","0","0","0","0","9","4","5","0","0","0","0","0","0","0","0","0","0","0","0","0","0","0","-2"
"242662","Inter American University of Puerto Rico-Ponce","2017","Tenured total","59","27","32","0","0","0","0","0","0","0","0","0","59","27","32","0","0","0","0","0","0","0","0","0","0","0","0","0","0","0","-2"
"242662","Inter American University of Puerto Rico-Ponce","2017","Tenured, professors","10","4","6","0","0","0","0","0","0","0","0","0","10","4","6","0","0","0","0","0","0","0","0","0","0","0","0","0","0","0","-2"
"242662","Inter American University of Puerto Rico-Ponce","2017","Tenured, associate professors","29","17","12","0","0","0","0","0","0","0","0","0","29","17","12","0","0","0","0","0","0","0","0","0","0","0","0","0","0","0","-2"
"242662","Inter American University of Puerto Rico-Ponce","2017","Tenured, assistant professors","20","6","14","0","0","0","0","0","0","0","0","0","20","6","14","0","0","0","0","0","0","0","0","0","0","0","0","0","0","0","-2"
"242662","Inter American University of Puerto Rico-Ponce","2017","On-Tenure track total","30","12","18","0","0","0","0","0","0","0","0","0","28","11","17","0","0","0","2","1","1","0","0","0","0","0","0","0","0","0","-2"
"242662","Inter American University of Puerto Rico-Ponce","2017","On-tenure track, professors","1","1","0","0","0","0","0","0","0","0","0","0","1","1","0","0","0","0","0","0","0","0","0","0","0","0","0","0","0","0","-2"
"242662","Inter American University of Puerto Rico-Ponce","2017","On-tenure track, associate professors","6","4","2","0","0","0","0","0","0","0","0","0","5","3","2","0","0","0","1","1","0","0","0","0","0","0","0","0","0","0","-2"
"242662","Inter American University of Puerto Rico-Ponce","2017","On-tenure track, assistant professors","14","4","10","0","0","0","0","0","0","0","0","0","13","4","9","0","0","0","1","0","1","0","0","0","0","0","0","0","0","0","-2"
"242662","Inter American University of Puerto Rico-Ponce","2017","On-tenure track, instructors","9","3","6","0","0","0","0","0","0","0","0","0","9","3","6","0","0","0","0","0","0","0","0","0","0","0","0","0","0","0","-2"
"242662","Inter American University of Puerto Rico-Ponce","2017","Not on tenure track/No tenure system system total","8","4","4","0","0","0","0","0","0","0","0","0","8","4","4","0","0","0","0","0","0","0","0","0","0","0","0","0","0","0","-2"
"242662","Inter American University of Puerto Rico-Ponce","2017","Not on tenure/no tenure system, assistant professors","5","1","4","0","0","0","0","0","0","0","0","0","5","1","4","0","0","0","0","0","0","0","0","0","0","0","0","0","0","0","-2"
"242662","Inter American University of Puerto Rico-Ponce","2017","Not on tenure/no tenure system, instructors","3","3","0","0","0","0","0","0","0","0","0","0","3","3","0","0","0","0","0","0","0","0","0","0","0","0","0","0","0","0","-2"
"242680","Inter American University of Puerto Rico-Fajardo","2017","Tenured total","30","15","15","0","0","0","0","0","0","0","0","0","30","15","15","0","0","0","0","0","0","0","0","0","0","0","0","0","0","0","-2"
"242680","Inter American University of Puerto Rico-Fajardo","2017","Tenured, professors","4","3","1","0","0","0","0","0","0","0","0","0","4","3","1","0","0","0","0","0","0","0","0","0","0","0","0","0","0","0","-2"
"242680","Inter American University of Puerto Rico-Fajardo","2017","Tenured, associate professors","10","5","5","0","0","0","0","0","0","0","0","0","10","5","5","0","0","0","0","0","0","0","0","0","0","0","0","0","0","0","-2"
"242680","Inter American University of Puerto Rico-Fajardo","2017","Tenured, assistant professors","16","7","9","0","0","0","0","0","0","0","0","0","16","7","9","0","0","0","0","0","0","0","0","0","0","0","0","0","0","0","-2"
"242680","Inter American University of Puerto Rico-Fajardo","2017","On-Tenure track total","9","0","9","0","0","0","0","0","0","0","0","0","9","0","9","0","0","0","0","0","0","0","0","0","0","0","0","0","0","0","-2"
"242680","Inter American University of Puerto Rico-Fajardo","2017","On-tenure track, associate professors","1","0","1","0","0","0","0","0","0","0","0","0","1","0","1","0","0","0","0","0","0","0","0","0","0","0","0","0","0","0","-2"
"242680","Inter American University of Puerto Rico-Fajardo","2017","On-tenure track, assistant professors","8","0","8","0","0","0","0","0","0","0","0","0","8","0","8","0","0","0","0","0","0","0","0","0","0","0","0","0","0","0","-2"
"242680","Inter American University of Puerto Rico-Fajardo","2017","Not on tenure track/No tenure system system total","2","1","1","0","0","0","0","0","0","0","0","0","2","1","1","0","0","0","0","0","0","0","0","0","0","0","0","0","0","0","-2"
"242680","Inter American University of Puerto Rico-Fajardo","2017","Not on tenure/no tenure system, instructors","2","1","1","0","0","0","0","0","0","0","0","0","2","1","1","0","0","0","0","0","0","0","0","0","0","0","0","0","0","0","-2"
"242699","Inter American University of Puerto Rico-Guayama","2017","Tenured total","32","15","17","0","0","0","0","0","0","0","0","0","32","15","17","0","0","0","0","0","0","0","0","0","0","0","0","0","0","0","-2"
"242699","Inter American University of Puerto Rico-Guayama","2017","Tenured, professors","6","4","2","0","0","0","0","0","0","0","0","0","6","4","2","0","0","0","0","0","0","0","0","0","0","0","0","0","0","0","-2"
"242699","Inter American University of Puerto Rico-Guayama","2017","Tenured, associate professors","11","4","7","0","0","0","0","0","0","0","0","0","11","4","7","0","0","0","0","0","0","0","0","0","0","0","0","0","0","0","-2"
"242699","Inter American University of Puerto Rico-Guayama","2017","Tenured, assistant professors","15","7","8","0","0","0","0","0","0","0","0","0","15","7","8","0","0","0","0","0","0","0","0","0","0","0","0","0","0","0","-2"
"242699","Inter American University of Puerto Rico-Guayama","2017","On-Tenure track total","6","5","1","0","0","0","0","0","0","0","0","0","6","5","1","0","0","0","0","0","0","0","0","0","0","0","0","0","0","0","-2"
"242699","Inter American University of Puerto Rico-Guayama","2017","On-tenure track, associate professors","1","1","0","0","0","0","0","0","0","0","0","0","1","1","0","0","0","0","0","0","0","0","0","0","0","0","0","0","0","0","-2"
"242699","Inter American University of Puerto Rico-Guayama","2017","On-tenure track, assistant professors","5","4","1","0","0","0","0","0","0","0","0","0","5","4","1","0","0","0","0","0","0","0","0","0","0","0","0","0","0","0","-2"
"242699","Inter American University of Puerto Rico-Guayama","2017","Not on tenure track/No tenure system system total","5","0","5","0","0","0","0","0","0","0","0","0","5","0","5","0","0","0","0","0","0","0","0","0","0","0","0","0","0","0","-2"
"242699","Inter American University of Puerto Rico-Guayama","2017","Not on tenure/no tenure system, assistant professors","1","0","1","0","0","0","0","0","0","0","0","0","1","0","1","0","0","0","0","0","0","0","0","0","0","0","0","0","0","0","-2"
"242699","Inter American University of Puerto Rico-Guayama","2017","Not on tenure/no tenure system, instructors","4","0","4","0","0","0","0","0","0","0","0","0","4","0","4","0","0","0","0","0","0","0","0","0","0","0","0","0","0","0","-2"
"242705","Inter American University of Puerto Rico-Bayamon","2017","Tenured total","50","31","19","0","0","0","0","0","0","0","0","0","49","30","19","0","0","0","1","1","0","0","0","0","0","0","0","0","0","0","-2"
"242705","Inter American University of Puerto Rico-Bayamon","2017","Tenured, professors","11","10","1","0","0","0","0","0","0","0","0","0","10","9","1","0","0","0","1","1","0","0","0","0","0","0","0","0","0","0","-2"
"242705","Inter American University of Puerto Rico-Bayamon","2017","Tenured, associate professors","17","8","9","0","0","0","0","0","0","0","0","0","17","8","9","0","0","0","0","0","0","0","0","0","0","0","0","0","0","0","-2"
"242705","Inter American University of Puerto Rico-Bayamon","2017","Tenured, assistant professors","22","13","9","0","0","0","0","0","0","0","0","0","22","13","9","0","0","0","0","0","0","0","0","0","0","0","0","0","0","0","-2"
"242705","Inter American University of Puerto Rico-Bayamon","2017","On-Tenure track total","29","18","11","0","0","0","0","0","0","0","0","0","28","17","11","0","0","0","1","1","0","0","0","0","0","0","0","0","0","0","-2"
"242705","Inter American University of Puerto Rico-Bayamon","2017","On-tenure track, professors","2","2","0","0","0","0","0","0","0","0","0","0","2","2","0","0","0","0","0","0","0","0","0","0","0","0","0","0","0","0","-2"
"242705","Inter American University of Puerto Rico-Bayamon","2017","On-tenure track, associate professors","10","7","3","0","0","0","0","0","0","0","0","0","10","7","3","0","0","0","0","0","0","0","0","0","0","0","0","0","0","0","-2"
"242705","Inter American University of Puerto Rico-Bayamon","2017","On-tenure track, assistant professors","12","5","7","0","0","0","0","0","0","0","0","0","11","4","7","0","0","0","1","1","0","0","0","0","0","0","0","0","0","0","-2"
"242705","Inter American University of Puerto Rico-Bayamon","2017","On-tenure track, instructors","5","4","1","0","0","0","0","0","0","0","0","0","5","4","1","0","0","0","0","0","0","0","0","0","0","0","0","0","0","0","-2"
"242705","Inter American University of Puerto Rico-Bayamon","2017","Not on tenure track/No tenure system system total","15","8","7","0","0","0","0","0","0","0","0","0","14","8","6","0","0","0","1","0","1","0","0","0","0","0","0","0","0","0","-2"
"242705","Inter American University of Puerto Rico-Bayamon","2017","Not on tenure/no tenure system, assistant professors","5","2","3","0","0","0","0","0","0","0","0","0","5","2","3","0","0","0","0","0","0","0","0","0","0","0","0","0","0","0","-2"
"242705","Inter American University of Puerto Rico-Bayamon","2017","Not on tenure/no tenure system, instructors","10","6","4","0","0","0","0","0","0","0","0","0","9","6","3","0","0","0","1","0","1","0","0","0","0","0","0","0","0","0","-2"
"243106","University of Puerto Rico-Aguadilla","2017","Tenured total","84","42","42","0","0","0","0","0","0","0","0","0","82","41","41","0","0","0","2","1","1","0","0","0","0","0","0","0","0","0","-2"
"243106","University of Puerto Rico-Aguadilla","2017","Tenured, professors","38","21","17","0","0","0","0","0","0","0","0","0","37","21","16","0","0","0","1","0","1","0","0","0","0","0","0","0","0","0","-2"
"243106","University of Puerto Rico-Aguadilla","2017","Tenured, associate professors","28","14","14","0","0","0","0","0","0","0","0","0","28","14","14","0","0","0","0","0","0","0","0","0","0","0","0","0","0","0","-2"
"243106","University of Puerto Rico-Aguadilla","2017","Tenured, assistant professors","16","6","10","0","0","0","0","0","0","0","0","0","15","5","10","0","0","0","1","1","0","0","0","0","0","0","0","0","0","0","-2"
"243106","University of Puerto Rico-Aguadilla","2017","Tenured, instructors","2","1","1","0","0","0","0","0","0","0","0","0","2","1","1","0","0","0","0","0","0","0","0","0","0","0","0","0","0","0","-2"
"243106","University of Puerto Rico-Aguadilla","2017","On-Tenure track total","3","3","0","0","0","0","0","0","0","0","0","0","3","3","0","0","0","0","0","0","0","0","0","0","0","0","0","0","0","0","-2"
"243106","University of Puerto Rico-Aguadilla","2017","On-tenure track, assistant professors","2","2","0","0","0","0","0","0","0","0","0","0","2","2","0","0","0","0","0","0","0","0","0","0","0","0","0","0","0","0","-2"
"243106","University of Puerto Rico-Aguadilla","2017","On-tenure track, instructors","1","1","0","0","0","0","0","0","0","0","0","0","1","1","0","0","0","0","0","0","0","0","0","0","0","0","0","0","0","0","-2"
"243106","University of Puerto Rico-Aguadilla","2017","Not on tenure track/No tenure system system total","31","16","15","0","0","0","0","0","0","0","0","0","31","16","15","0","0","0","0","0","0","0","0","0","0","0","0","0","0","0","-2"
"243106","University of Puerto Rico-Aguadilla","2017","Not on tenure/no tenure system, assistant professors","14","6","8","0","0","0","0","0","0","0","0","0","14","6","8","0","0","0","0","0","0","0","0","0","0","0","0","0","0","0","-2"
"243106","University of Puerto Rico-Aguadilla","2017","Not on tenure/no tenure system, instructors","17","10","7","0","0","0","0","0","0","0","0","0","17","10","7","0","0","0","0","0","0","0","0","0","0","0","0","0","0","0","-2"
"243115","University of Puerto Rico-Arecibo","2017","Tenured total","118","62","56","0","0","0","0","0","0","0","0","0","118","62","56","0","0","0","0","0","0","0","0","0","0","0","0","0","0","0","-2"
"243115","University of Puerto Rico-Arecibo","2017","Tenured, professors","69","35","34","0","0","0","0","0","0","0","0","0","69","35","34","0","0","0","0","0","0","0","0","0","0","0","0","0","0","0","-2"
"243115","University of Puerto Rico-Arecibo","2017","Tenured, associate professors","24","12","12","0","0","0","0","0","0","0","0","0","24","12","12","0","0","0","0","0","0","0","0","0","0","0","0","0","0","0","-2"
"243115","University of Puerto Rico-Arecibo","2017","Tenured, assistant professors","23","13","10","0","0","0","0","0","0","0","0","0","23","13","10","0","0","0","0","0","0","0","0","0","0","0","0","0","0","0","-2"
"243115","University of Puerto Rico-Arecibo","2017","Tenured, instructors","2","2","0","0","0","0","0","0","0","0","0","0","2","2","0","0","0","0","0","0","0","0","0","0","0","0","0","0","0","0","-2"
"243115","University of Puerto Rico-Arecibo","2017","On-Tenure track total","11","4","7","0","0","0","0","0","0","0","0","0","11","4","7","0","0","0","0","0","0","0","0","0","0","0","0","0","0","0","-2"
"243115","University of Puerto Rico-Arecibo","2017","On-tenure track, associate professors","1","0","1","0","0","0","0","0","0","0","0","0","1","0","1","0","0","0","0","0","0","0","0","0","0","0","0","0","0","0","-2"
"243115","University of Puerto Rico-Arecibo","2017","On-tenure track, assistant professors","9","4","5","0","0","0","0","0","0","0","0","0","9","4","5","0","0","0","0","0","0","0","0","0","0","0","0","0","0","0","-2"
"243115","University of Puerto Rico-Arecibo","2017","On-tenure track, instructors","1","0","1","0","0","0","0","0","0","0","0","0","1","0","1","0","0","0","0","0","0","0","0","0","0","0","0","0","0","0","-2"
"243115","University of Puerto Rico-Arecibo","2017","Not on tenure track/No tenure system system total","1","1","0","0","0","0","0","0","0","0","0","0","1","1","0","0","0","0","0","0","0","0","0","0","0","0","0","0","0","0","-2"
"243115","University of Puerto Rico-Arecibo","2017","Not on tenure/no tenure system, instructors","1","1","0","0","0","0","0","0","0","0","0","0","1","1","0","0","0","0","0","0","0","0","0","0","0","0","0","0","0","0","-2"
"243133","University of Puerto Rico-Bayamon","2017","Tenured total","131","66","65","0","0","0","0","0","0","0","0","0","131","66","65","0","0","0","0","0","0","0","0","0","0","0","0","0","0","0","-2"
"243133","University of Puerto Rico-Bayamon","2017","Tenured, professors","57","32","25","0","0","0","0","0","0","0","0","0","57","32","25","0","0","0","0","0","0","0","0","0","0","0","0","0","0","0","-2"
"243133","University of Puerto Rico-Bayamon","2017","Tenured, associate professors","40","17","23","0","0","0","0","0","0","0","0","0","40","17","23","0","0","0","0","0","0","0","0","0","0","0","0","0","0","0","-2"
"243133","University of Puerto Rico-Bayamon","2017","Tenured, assistant professors","24","11","13","0","0","0","0","0","0","0","0","0","24","11","13","0","0","0","0","0","0","0","0","0","0","0","0","0","0","0","-2"
"243133","University of Puerto Rico-Bayamon","2017","Tenured, instructors","1","1","0","0","0","0","0","0","0","0","0","0","1","1","0","0","0","0","0","0","0","0","0","0","0","0","0","0","0","0","-2"
"243133","University of Puerto Rico-Bayamon","2017","Tenured, no academic rank","9","5","4","0","0","0","0","0","0","0","0","0","9","5","4","0","0","0","0","0","0","0","0","0","0","0","0","0","0","0","-2"
"243133","University of Puerto Rico-Bayamon","2017","On-Tenure track total","23","8","15","0","0","0","0","0","0","0","0","0","23","8","15","0","0","0","0","0","0","0","0","0","0","0","0","0","0","0","-2"
"243133","University of Puerto Rico-Bayamon","2017","On-tenure track, associate professors","3","1","2","0","0","0","0","0","0","0","0","0","3","1","2","0","0","0","0","0","0","0","0","0","0","0","0","0","0","0","-2"
"243133","University of Puerto Rico-Bayamon","2017","On-tenure track, assistant professors","15","6","9","0","0","0","0","0","0","0","0","0","15","6","9","0","0","0","0","0","0","0","0","0","0","0","0","0","0","0","-2"
"243133","University of Puerto Rico-Bayamon","2017","On-tenure track, instructors","2","0","2","0","0","0","0","0","0","0","0","0","2","0","2","0","0","0","0","0","0","0","0","0","0","0","0","0","0","0","-2"
"243133","University of Puerto Rico-Bayamon","2017","On-tenure track, no academic rank","3","1","2","0","0","0","0","0","0","0","0","0","3","1","2","0","0","0","0","0","0","0","0","0","0","0","0","0","0","0","-2"
"243133","University of Puerto Rico-Bayamon","2017","Not on tenure track/No tenure system system total","32","15","17","0","0","0","0","0","0","0","0","0","32","15","17","0","0","0","0","0","0","0","0","0","0","0","0","0","0","0","-2"
"243133","University of Puerto Rico-Bayamon","2017","Not on tenure/no tenure system, assistant professors","16","5","11","0","0","0","0","0","0","0","0","0","16","5","11","0","0","0","0","0","0","0","0","0","0","0","0","0","0","0","-2"
"243133","University of Puerto Rico-Bayamon","2017","Not on tenure/no tenure system, instructors","14","9","5","0","0","0","0","0","0","0","0","0","14","9","5","0","0","0","0","0","0","0","0","0","0","0","0","0","0","0","-2"
"243133","University of Puerto Rico-Bayamon","2017","Not on tenure/no tenure system, no academic rank","2","1","1","0","0","0","0","0","0","0","0","0","2","1","1","0","0","0","0","0","0","0","0","0","0","0","0","0","0","0","-2"
"243142","University of Puerto Rico-Carolina","2017","Tenured total","60","35","25","0","0","0","0","0","0","0","0","0","59","34","25","0","0","0","1","1","0","0","0","0","0","0","0","0","0","0","-2"
"243142","University of Puerto Rico-Carolina","2017","Tenured, professors","18","12","6","0","0","0","0","0","0","0","0","0","17","11","6","0","0","0","1","1","0","0","0","0","0","0","0","0","0","0","-2"
"243142","University of Puerto Rico-Carolina","2017","Tenured, associate professors","27","13","14","0","0","0","0","0","0","0","0","0","27","13","14","0","0","0","0","0","0","0","0","0","0","0","0","0","0","0","-2"
"243142","University of Puerto Rico-Carolina","2017","Tenured, assistant professors","13","8","5","0","0","0","0","0","0","0","0","0","13","8","5","0","0","0","0","0","0","0","0","0","0","0","0","0","0","0","-2"
"243142","University of Puerto Rico-Carolina","2017","Tenured, instructors","2","2","0","0","0","0","0","0","0","0","0","0","2","2","0","0","0","0","0","0","0","0","0","0","0","0","0","0","0","0","-2"
"243142","University of Puerto Rico-Carolina","2017","On-Tenure track total","12","5","7","0","0","0","0","0","0","0","0","0","12","5","7","0","0","0","0","0","0","0","0","0","0","0","0","0","0","0","-2"
"243142","University of Puerto Rico-Carolina","2017","On-tenure track, assistant professors","5","3","2","0","0","0","0","0","0","0","0","0","5","3","2","0","0","0","0","0","0","0","0","0","0","0","0","0","0","0","-2"
"243142","University of Puerto Rico-Carolina","2017","On-tenure track, instructors","7","2","5","0","0","0","0","0","0","0","0","0","7","2","5","0","0","0","0","0","0","0","0","0","0","0","0","0","0","0","-2"
"243142","University of Puerto Rico-Carolina","2017","Not on tenure track/No tenure system system total","16","6","10","0","0","0","0","0","0","0","0","0","16","6","10","0","0","0","0","0","0","0","0","0","0","0","0","0","0","0","-2"
"243142","University of Puerto Rico-Carolina","2017","Not on tenure/no tenure system, assistant professors","4","1","3","0","0","0","0","0","0","0","0","0","4","1","3","0","0","0","0","0","0","0","0","0","0","0","0","0","0","0","-2"
"243142","University of Puerto Rico-Carolina","2017","Not on tenure/no tenure system, instructors","12","5","7","0","0","0","0","0","0","0","0","0","12","5","7","0","0","0","0","0","0","0","0","0","0","0","0","0","0","0","-2"
"243151","University of Puerto Rico-Cayey","2017","Tenured total","74","41","33","0","0","0","0","0","0","0","0","0","74","41","33","0","0","0","0","0","0","0","0","0","0","0","0","0","0","0","-2"
"243151","University of Puerto Rico-Cayey","2017","Tenured, professors","42","21","21","0","0","0","0","0","0","0","0","0","42","21","21","0","0","0","0","0","0","0","0","0","0","0","0","0","0","0","-2"
"243151","University of Puerto Rico-Cayey","2017","Tenured, associate professors","19","11","8","0","0","0","0","0","0","0","0","0","19","11","8","0","0","0","0","0","0","0","0","0","0","0","0","0","0","0","-2"
"243151","University of Puerto Rico-Cayey","2017","Tenured, assistant professors","12","8","4","0","0","0","0","0","0","0","0","0","12","8","4","0","0","0","0","0","0","0","0","0","0","0","0","0","0","0","-2"
"243151","University of Puerto Rico-Cayey","2017","Tenured, instructors","1","1","0","0","0","0","0","0","0","0","0","0","1","1","0","0","0","0","0","0","0","0","0","0","0","0","0","0","0","0","-2"
"243151","University of Puerto Rico-Cayey","2017","On-Tenure track total","28","13","15","0","0","0","0","0","0","0","0","0","28","13","15","0","0","0","0","0","0","0","0","0","0","0","0","0","0","0","-2"
"243151","University of Puerto Rico-Cayey","2017","On-tenure track, professors","1","1","0","0","0","0","0","0","0","0","0","0","1","1","0","0","0","0","0","0","0","0","0","0","0","0","0","0","0","0","-2"
"243151","University of Puerto Rico-Cayey","2017","On-tenure track, associate professors","24","12","12","0","0","0","0","0","0","0","0","0","24","12","12","0","0","0","0","0","0","0","0","0","0","0","0","0","0","0","-2"
"243151","University of Puerto Rico-Cayey","2017","On-tenure track, assistant professors","2","0","2","0","0","0","0","0","0","0","0","0","2","0","2","0","0","0","0","0","0","0","0","0","0","0","0","0","0","0","-2"
"243151","University of Puerto Rico-Cayey","2017","On-tenure track, instructors","1","0","1","0","0","0","0","0","0","0","0","0","1","0","1","0","0","0","0","0","0","0","0","0","0","0","0","0","0","0","-2"
"243151","University of Puerto Rico-Cayey","2017","Not on tenure track/No tenure system system total","37","14","23","0","0","0","0","0","0","0","0","0","37","14","23","0","0","0","0","0","0","0","0","0","0","0","0","0","0","0","-2"
"243151","University of Puerto Rico-Cayey","2017","Not on tenure/no tenure system, professors","1","0","1","0","0","0","0","0","0","0","0","0","1","0","1","0","0","0","0","0","0","0","0","0","0","0","0","0","0","0","-2"
"243151","University of Puerto Rico-Cayey","2017","Not on tenure/no tenure system, associate professors","31","12","19","0","0","0","0","0","0","0","0","0","31","12","19","0","0","0","0","0","0","0","0","0","0","0","0","0","0","0","-2"
"243151","University of Puerto Rico-Cayey","2017","Not on tenure/no tenure system, instructors","5","2","3","0","0","0","0","0","0","0","0","0","5","2","3","0","0","0","0","0","0","0","0","0","0","0","0","0","0","0","-2"
"243179","University of Puerto Rico-Humacao","2017","Tenured total","132","68","64","1","1","0","0","0","0","0","0","0","126","65","61","0","0","0","5","2","3","0","0","0","0","0","0","0","0","0","-2"
"243179","University of Puerto Rico-Humacao","2017","Tenured, professors","82","44","38","1","1","0","0","0","0","0","0","0","77","42","35","0","0","0","4","1","3","0","0","0","0","0","0","0","0","0","-2"
"243179","University of Puerto Rico-Humacao","2017","Tenured, associate professors","39","15","24","0","0","0","0","0","0","0","0","0","38","14","24","0","0","0","1","1","0","0","0","0","0","0","0","0","0","0","-2"
"243179","University of Puerto Rico-Humacao","2017","Tenured, assistant professors","10","8","2","0","0","0","0","0","0","0","0","0","10","8","2","0","0","0","0","0","0","0","0","0","0","0","0","0","0","0","-2"
"243179","University of Puerto Rico-Humacao","2017","Tenured, instructors","1","1","0","0","0","0","0","0","0","0","0","0","1","1","0","0","0","0","0","0","0","0","0","0","0","0","0","0","0","0","-2"
"243179","University of Puerto Rico-Humacao","2017","On-Tenure track total","13","5","8","0","0","0","0","0","0","0","0","0","13","5","8","0","0","0","0","0","0","0","0","0","0","0","0","0","0","0","-2"
"243179","University of Puerto Rico-Humacao","2017","On-tenure track, assistant professors","12","5","7","0","0","0","0","0","0","0","0","0","12","5","7","0","0","0","0","0","0","0","0","0","0","0","0","0","0","0","-2"
"243179","University of Puerto Rico-Humacao","2017","On-tenure track, instructors","1","0","1","0","0","0","0","0","0","0","0","0","1","0","1","0","0","0","0","0","0","0","0","0","0","0","0","0","0","0","-2"
"243179","University of Puerto Rico-Humacao","2017","Not on tenure track/No tenure system system total","7","1","6","0","0","0","0","0","0","0","0","0","5","0","5","0","0","0","0","0","0","0","0","0","1","0","1","1","1","0","-2"
"243179","University of Puerto Rico-Humacao","2017","Not on tenure/no tenure system, assistant professors","1","1","0","0","0","0","0","0","0","0","0","0","0","0","0","0","0","0","0","0","0","0","0","0","0","0","0","1","1","0","-2"
"243179","University of Puerto Rico-Humacao","2017","Not on tenure/no tenure system, instructors","6","0","6","0","0","0","0","0","0","0","0","0","5","0","5","0","0","0","0","0","0","0","0","0","1","0","1","0","0","0","-2"
"243188","University of Puerto Rico-Utuado","2017","Tenured total","44","26","18","0","0","0","0","0","0","0","0","0","44","26","18","0","0","0","0","0","0","0","0","0","0","0","0","0","0","0","-2"
"243188","University of Puerto Rico-Utuado","2017","Tenured, professors","17","10","7","0","0","0","0","0","0","0","0","0","17","10","7","0","0","0","0","0","0","0","0","0","0","0","0","0","0","0","-2"
"243188","University of Puerto Rico-Utuado","2017","Tenured, associate professors","13","6","7","0","0","0","0","0","0","0","0","0","13","6","7","0","0","0","0","0","0","0","0","0","0","0","0","0","0","0","-2"
"243188","University of Puerto Rico-Utuado","2017","Tenured, assistant professors","11","7","4","0","0","0","0","0","0","0","0","0","11","7","4","0","0","0","0","0","0","0","0","0","0","0","0","0","0","0","-2"
"243188","University of Puerto Rico-Utuado","2017","Tenured, instructors","3","3","0","0","0","0","0","0","0","0","0","0","3","3","0","0","0","0","0","0","0","0","0","0","0","0","0","0","0","0","-2"
"243188","University of Puerto Rico-Utuado","2017","On-Tenure track total","4","2","2","0","0","0","0","0","0","0","0","0","3","1","2","0","0","0","0","0","0","0","0","0","1","1","0","0","0","0","-2"
"243188","University of Puerto Rico-Utuado","2017","On-tenure track, assistant professors","4","2","2","0","0","0","0","0","0","0","0","0","3","1","2","0","0","0","0","0","0","0","0","0","1","1","0","0","0","0","-2"
"243188","University of Puerto Rico-Utuado","2017","Not on tenure track/No tenure system system total","12","5","7","0","0","0","0","0","0","0","0","0","11","5","6","0","0","0","0","0","0","0","0","0","1","0","1","0","0","0","-2"
"243188","University of Puerto Rico-Utuado","2017","Not on tenure/no tenure system, assistant professors","2","1","1","0","0","0","0","0","0","0","0","0","2","1","1","0","0","0","0","0","0","0","0","0","0","0","0","0","0","0","-2"
"243188","University of Puerto Rico-Utuado","2017","Not on tenure/no tenure system, instructors","10","4","6","0","0","0","0","0","0","0","0","0","9","4","5","0","0","0","0","0","0","0","0","0","1","0","1","0","0","0","-2"
"243197","University of Puerto Rico-Mayaguez","2017","Tenured total","436","278","158","0","0","0","1","1","0","0","0","0","434","276","158","0","0","0","1","1","0","0","0","0","0","0","0","0","0","0","-2"
"243197","University of Puerto Rico-Mayaguez","2017","Tenured, professors","338","225","113","0","0","0","0","0","0","0","0","0","337","224","113","0","0","0","1","1","0","0","0","0","0","0","0","0","0","0","-2"
"243197","University of Puerto Rico-Mayaguez","2017","Tenured, associate professors","83","45","38","0","0","0","1","1","0","0","0","0","82","44","38","0","0","0","0","0","0","0","0","0","0","0","0","0","0","0","-2"
"243197","University of Puerto Rico-Mayaguez","2017","Tenured, assistant professors","14","7","7","0","0","0","0","0","0","0","0","0","14","7","7","0","0","0","0","0","0","0","0","0","0","0","0","0","0","0","-2"
"243197","University of Puerto Rico-Mayaguez","2017","Tenured, instructors","1","1","0","0","0","0","0","0","0","0","0","0","1","1","0","0","0","0","0","0","0","0","0","0","0","0","0","0","0","0","-2"
"243197","University of Puerto Rico-Mayaguez","2017","On-Tenure track total","69","37","32","0","0","0","0","0","0","0","0","0","67","35","32","0","0","0","0","0","0","0","0","0","2","2","0","0","0","0","-2"
"243197","University of Puerto Rico-Mayaguez","2017","On-tenure track, professors","1","0","1","0","0","0","0","0","0","0","0","0","1","0","1","0","0","0","0","0","0","0","0","0","0","0","0","0","0","0","-2"
"243197","University of Puerto Rico-Mayaguez","2017","On-tenure track, associate professors","7","4","3","0","0","0","0","0","0","0","0","0","7","4","3","0","0","0","0","0","0","0","0","0","0","0","0","0","0","0","-2"
"243197","University of Puerto Rico-Mayaguez","2017","On-tenure track, assistant professors","61","33","28","0","0","0","0","0","0","0","0","0","59","31","28","0","0","0","0","0","0","0","0","0","2","2","0","0","0","0","-2"
"243197","University of Puerto Rico-Mayaguez","2017","Not on tenure track/No tenure system system total","47","19","28","0","0","0","0","0","0","0","0","0","39","17","22","0","0","0","0","0","0","0","0","0","8","2","6","0","0","0","-2"
"243197","University of Puerto Rico-Mayaguez","2017","Not on tenure/no tenure system, professors","2","2","0","0","0","0","0","0","0","0","0","0","2","2","0","0","0","0","0","0","0","0","0","0","0","0","0","0","0","0","-2"
"243197","University of Puerto Rico-Mayaguez","2017","Not on tenure/no tenure system, associate professors","2","1","1","0","0","0","0","0","0","0","0","0","2","1","1","0","0","0","0","0","0","0","0","0","0","0","0","0","0","0","-2"
"243197","University of Puerto Rico-Mayaguez","2017","Not on tenure/no tenure system, assistant professors","14","6","8","0","0","0","0","0","0","0","0","0","13","6","7","0","0","0","0","0","0","0","0","0","1","0","1","0","0","0","-2"
"243197","University of Puerto Rico-Mayaguez","2017","Not on tenure/no tenure system, instructors","29","10","19","0","0","0","0","0","0","0","0","0","22","8","14","0","0","0","0","0","0","0","0","0","7","2","5","0","0","0","-2"
"243203","University of Puerto Rico-Medical Sciences","2017","Tenured total","383","162","221","0","0","0","2","1","1","1","1","0","366","152","214","0","0","0","14","8","6","0","0","0","0","0","0","0","0","0","-2"
"243203","University of Puerto Rico-Medical Sciences","2017","Tenured, professors","261","117","144","0","0","0","2","1","1","1","1","0","247","108","139","0","0","0","11","7","4","0","0","0","0","0","0","0","0","0","-2"
"243203","University of Puerto Rico-Medical Sciences","2017","Tenured, associate professors","84","31","53","0","0","0","0","0","0","0","0","0","83","30","53","0","0","0","1","1","0","0","0","0","0","0","0","0","0","0","-2"
"243203","University of Puerto Rico-Medical Sciences","2017","Tenured, assistant professors","34","13","21","0","0","0","0","0","0","0","0","0","33","13","20","0","0","0","1","0","1","0","0","0","0","0","0","0","0","0","-2"
"243203","University of Puerto Rico-Medical Sciences","2017","Tenured, instructors","4","1","3","0","0","0","0","0","0","0","0","0","3","1","2","0","0","0","1","0","1","0","0","0","0","0","0","0","0","0","-2"
"243203","University of Puerto Rico-Medical Sciences","2017","On-Tenure track total","80","36","44","1","1","0","1","0","1","0","0","0","74","32","42","0","0","0","4","3","1","0","0","0","0","0","0","0","0","0","-2"
"243203","University of Puerto Rico-Medical Sciences","2017","On-tenure track, professors","15","10","5","0","0","0","1","0","1","0","0","0","14","10","4","0","0","0","0","0","0","0","0","0","0","0","0","0","0","0","-2"
"243203","University of Puerto Rico-Medical Sciences","2017","On-tenure track, associate professors","17","8","9","0","0","0","0","0","0","0","0","0","17","8","9","0","0","0","0","0","0","0","0","0","0","0","0","0","0","0","-2"
"243203","University of Puerto Rico-Medical Sciences","2017","On-tenure track, assistant professors","41","17","24","1","1","0","0","0","0","0","0","0","36","13","23","0","0","0","4","3","1","0","0","0","0","0","0","0","0","0","-2"
"243203","University of Puerto Rico-Medical Sciences","2017","On-tenure track, instructors","7","1","6","0","0","0","0","0","0","0","0","0","7","1","6","0","0","0","0","0","0","0","0","0","0","0","0","0","0","0","-2"
"243203","University of Puerto Rico-Medical Sciences","2017","Not on tenure track/No tenure system system total","186","60","126","0","0","0","1","0","1","0","0","0","174","59","115","1","0","1","10","1","9","0","0","0","0","0","0","0","0","0","-2"
"243203","University of Puerto Rico-Medical Sciences","2017","Not on tenure/no tenure system, professors","14","6","8","0","0","0","0","0","0","0","0","0","12","5","7","0","0","0","2","1","1","0","0","0","0","0","0","0","0","0","-2"
"243203","University of Puerto Rico-Medical Sciences","2017","Not on tenure/no tenure system, associate professors","28","14","14","0","0","0","0","0","0","0","0","0","27","14","13","1","0","1","0","0","0","0","0","0","0","0","0","0","0","0","-2"
"243203","University of Puerto Rico-Medical Sciences","2017","Not on tenure/no tenure system, assistant professors","86","32","54","0","0","0","0","0","0","0","0","0","86","32","54","0","0","0","0","0","0","0","0","0","0","0","0","0","0","0","-2"
"243203","University of Puerto Rico-Medical Sciences","2017","Not on tenure/no tenure system, instructors","16","4","12","0","0","0","0","0","0","0","0","0","15","4","11","0","0","0","1","0","1","0","0","0","0","0","0","0","0","0","-2"
"243203","University of Puerto Rico-Medical Sciences","2017","Not on tenure/no tenure system, no academic rank","42","4","38","0","0","0","1","0","1","0","0","0","34","4","30","0","0","0","7","0","7","0","0","0","0","0","0","0","0","0","-2"
"243212","University of Puerto Rico-Ponce","2017","Tenured total","71","31","40","0","0","0","0","0","0","0","0","0","71","31","40","0","0","0","0","0","0","0","0","0","0","0","0","0","0","0","-2"
"243212","University of Puerto Rico-Ponce","2017","Tenured, professors","30","12","18","0","0","0","0","0","0","0","0","0","30","12","18","0","0","0","0","0","0","0","0","0","0","0","0","0","0","0","-2"
"243212","University of Puerto Rico-Ponce","2017","Tenured, associate professors","12","5","7","0","0","0","0","0","0","0","0","0","12","5","7","0","0","0","0","0","0","0","0","0","0","0","0","0","0","0","-2"
"243212","University of Puerto Rico-Ponce","2017","Tenured, assistant professors","23","9","14","0","0","0","0","0","0","0","0","0","23","9","14","0","0","0","0","0","0","0","0","0","0","0","0","0","0","0","-2"
"243212","University of Puerto Rico-Ponce","2017","Tenured, instructors","6","5","1","0","0","0","0","0","0","0","0","0","6","5","1","0","0","0","0","0","0","0","0","0","0","0","0","0","0","0","-2"
"243212","University of Puerto Rico-Ponce","2017","On-Tenure track total","6","3","3","0","0","0","0","0","0","0","0","0","6","3","3","0","0","0","0","0","0","0","0","0","0","0","0","0","0","0","-2"
"243212","University of Puerto Rico-Ponce","2017","On-tenure track, assistant professors","6","3","3","0","0","0","0","0","0","0","0","0","6","3","3","0","0","0","0","0","0","0","0","0","0","0","0","0","0","0","-2"
"243212","University of Puerto Rico-Ponce","2017","Not on tenure track/No tenure system system total","5","0","5","0","0","0","0","0","0","0","0","0","5","0","5","0","0","0","0","0","0","0","0","0","0","0","0","0","0","0","-2"
"243212","University of Puerto Rico-Ponce","2017","Not on tenure/no tenure system, assistant professors","3","0","3","0","0","0","0","0","0","0","0","0","3","0","3","0","0","0","0","0","0","0","0","0","0","0","0","0","0","0","-2"
"243212","University of Puerto Rico-Ponce","2017","Not on tenure/no tenure system, instructors","2","0","2","0","0","0","0","0","0","0","0","0","2","0","2","0","0","0","0","0","0","0","0","0","0","0","0","0","0","0","-2"
"243221","University of Puerto Rico-Rio Piedras","2017","Tenured total","641","314","327","0","0","0","4","4","0","0","0","0","626","302","324","0","0","0","9","6","3","0","0","0","2","2","0","0","0","0","-2"
"243221","University of Puerto Rico-Rio Piedras","2017","Tenured, professors","462","246","216","0","0","0","3","3","0","0","0","0","451","237","214","0","0","0","7","5","2","0","0","0","1","1","0","0","0","0","-2"
"243221","University of Puerto Rico-Rio Piedras","2017","Tenured, associate professors","129","54","75","0","0","0","1","1","0","0","0","0","126","52","74","0","0","0","1","0","1","0","0","0","1","1","0","0","0","0","-2"
"243221","University of Puerto Rico-Rio Piedras","2017","Tenured, assistant professors","35","11","24","0","0","0","0","0","0","0","0","0","34","10","24","0","0","0","1","1","0","0","0","0","0","0","0","0","0","0","-2"
"243221","University of Puerto Rico-Rio Piedras","2017","Tenured, instructors","14","2","12","0","0","0","0","0","0","0","0","0","14","2","12","0","0","0","0","0","0","0","0","0","0","0","0","0","0","0","-2"
"243221","University of Puerto Rico-Rio Piedras","2017","Tenured, no academic rank","1","1","0","0","0","0","0","0","0","0","0","0","1","1","0","0","0","0","0","0","0","0","0","0","0","0","0","0","0","0","-2"
"243221","University of Puerto Rico-Rio Piedras","2017","On-Tenure track total","64","35","29","0","0","0","1","1","0","0","0","0","56","29","27","0","0","0","3","2","1","0","0","0","4","3","1","0","0","0","-2"
"243221","University of Puerto Rico-Rio Piedras","2017","On-tenure track, associate professors","20","10","10","0","0","0","1","1","0","0","0","0","18","9","9","0","0","0","1","0","1","0","0","0","0","0","0","0","0","0","-2"
"243221","University of Puerto Rico-Rio Piedras","2017","On-tenure track, assistant professors","42","23","19","0","0","0","0","0","0","0","0","0","36","18","18","0","0","0","2","2","0","0","0","0","4","3","1","0","0","0","-2"
"243221","University of Puerto Rico-Rio Piedras","2017","On-tenure track, instructors","2","2","0","0","0","0","0","0","0","0","0","0","2","2","0","0","0","0","0","0","0","0","0","0","0","0","0","0","0","0","-2"
"243221","University of Puerto Rico-Rio Piedras","2017","Not on tenure track/No tenure system system total","230","107","123","0","0","0","3","1","2","1","1","0","212","99","113","0","0","0","2","2","0","0","0","0","12","4","8","0","0","0","-2"
"243221","University of Puerto Rico-Rio Piedras","2017","Not on tenure/no tenure system, professors","7","2","5","0","0","0","0","0","0","0","0","0","7","2","5","0","0","0","0","0","0","0","0","0","0","0","0","0","0","0","-2"
"243221","University of Puerto Rico-Rio Piedras","2017","Not on tenure/no tenure system, associate professors","3","3","0","0","0","0","0","0","0","0","0","0","3","3","0","0","0","0","0","0","0","0","0","0","0","0","0","0","0","0","-2"
"243221","University of Puerto Rico-Rio Piedras","2017","Not on tenure/no tenure system, assistant professors","124","58","66","0","0","0","0","0","0","1","1","0","114","52","62","0","0","0","1","1","0","0","0","0","8","4","4","0","0","0","-2"
"243221","University of Puerto Rico-Rio Piedras","2017","Not on tenure/no tenure system, instructors","89","39","50","0","0","0","1","0","1","0","0","0","84","39","45","0","0","0","0","0","0","0","0","0","4","0","4","0","0","0","-2"
"243221","University of Puerto Rico-Rio Piedras","2017","Not on tenure/no tenure system, no academic rank","7","5","2","0","0","0","2","1","1","0","0","0","4","3","1","0","0","0","1","1","0","0","0","0","0","0","0","0","0","0","-2"
"243346","Universidad Ana G. Mendez-Carolina Campus","2017","Tenured total","19","6","13","0","0","0","0","0","0","0","0","0","19","6","13","0","0","0","0","0","0","0","0","0","0","0","0","0","0","0","-2"
"243346","Universidad Ana G. Mendez-Carolina Campus","2017","Tenured, professors","9","2","7","0","0","0","0","0","0","0","0","0","9","2","7","0","0","0","0","0","0","0","0","0","0","0","0","0","0","0","-2"
"243346","Universidad Ana G. Mendez-Carolina Campus","2017","Tenured, associate professors","6","2","4","0","0","0","0","0","0","0","0","0","6","2","4","0","0","0","0","0","0","0","0","0","0","0","0","0","0","0","-2"
"243346","Universidad Ana G. Mendez-Carolina Campus","2017","Tenured, assistant professors","4","2","2","0","0","0","0","0","0","0","0","0","4","2","2","0","0","0","0","0","0","0","0","0","0","0","0","0","0","0","-2"
"243346","Universidad Ana G. Mendez-Carolina Campus","2017","Not on tenure track/No tenure system system total","141","57","84","0","0","0","0","0","0","1","1","0","135","53","82","0","0","0","4","2","2","0","0","0","1","1","0","0","0","0","-2"
"243346","Universidad Ana G. Mendez-Carolina Campus","2017","Not on tenure/no tenure system, professors","17","5","12","0","0","0","0","0","0","0","0","0","17","5","12","0","0","0","0","0","0","0","0","0","0","0","0","0","0","0","-2"
"243346","Universidad Ana G. Mendez-Carolina Campus","2017","Not on tenure/no tenure system, associate professors","21","6","15","0","0","0","0","0","0","0","0","0","19","5","14","0","0","0","1","0","1","0","0","0","1","1","0","0","0","0","-2"
"243346","Universidad Ana G. Mendez-Carolina Campus","2017","Not on tenure/no tenure system, assistant professors","35","16","19","0","0","0","0","0","0","1","1","0","33","15","18","0","0","0","1","0","1","0","0","0","0","0","0","0","0","0","-2"
"243346","Universidad Ana G. Mendez-Carolina Campus","2017","Not on tenure/no tenure system, instructors","67","29","38","0","0","0","0","0","0","0","0","0","65","27","38","0","0","0","2","2","0","0","0","0","0","0","0","0","0","0","-2"
"243346","Universidad Ana G. Mendez-Carolina Campus","2017","Not on tenure/no tenure system, lecturers","1","1","0","0","0","0","0","0","0","0","0","0","1","1","0","0","0","0","0","0","0","0","0","0","0","0","0","0","0","0","-2"
"243443","Universidad del Sagrado Corazon","2017","Tenured total","73","24","49","0","0","0","1","1","0","0","0","0","71","22","49","0","0","0","1","1","0","0","0","0","0","0","0","0","0","0","-2"
"243443","Universidad del Sagrado Corazon","2017","Tenured, professors","44","18","26","0","0","0","1","1","0","0","0","0","42","16","26","0","0","0","1","1","0","0","0","0","0","0","0","0","0","0","-2"
"243443","Universidad del Sagrado Corazon","2017","Tenured, associate professors","12","1","11","0","0","0","0","0","0","0","0","0","12","1","11","0","0","0","0","0","0","0","0","0","0","0","0","0","0","0","-2"
"243443","Universidad del Sagrado Corazon","2017","Tenured, assistant professors","8","2","6","0","0","0","0","0","0","0","0","0","8","2","6","0","0","0","0","0","0","0","0","0","0","0","0","0","0","0","-2"
"243443","Universidad del Sagrado Corazon","2017","Tenured, instructors","9","3","6","0","0","0","0","0","0","0","0","0","9","3","6","0","0","0","0","0","0","0","0","0","0","0","0","0","0","0","-2"
"243443","Universidad del Sagrado Corazon","2017","On-Tenure track total","10","5","5","0","0","0","0","0","0","0","0","0","10","5","5","0","0","0","0","0","0","0","0","0","0","0","0","0","0","0","-2"
"243443","Universidad del Sagrado Corazon","2017","On-tenure track, assistant professors","3","2","1","0","0","0","0","0","0","0","0","0","3","2","1","0","0","0","0","0","0","0","0","0","0","0","0","0","0","0","-2"
"243443","Universidad del Sagrado Corazon","2017","On-tenure track, instructors","7","3","4","0","0","0","0","0","0","0","0","0","7","3","4","0","0","0","0","0","0","0","0","0","0","0","0","0","0","0","-2"
"243568","Universidad Central Del Caribe","2017","Not on tenure track/No tenure system system total","46","22","24","0","0","0","0","0","0","0","0","0","34","15","19","0","0","0","12","7","5","0","0","0","0","0","0","0","0","0","-2"
"243568","Universidad Central Del Caribe","2017","Not on tenure/no tenure system, professors","17","11","6","0","0","0","0","0","0","0","0","0","11","8","3","0","0","0","6","3","3","0","0","0","0","0","0","0","0","0","-2"
"243568","Universidad Central Del Caribe","2017","Not on tenure/no tenure system, associate professors","15","5","10","0","0","0","0","0","0","0","0","0","12","4","8","0","0","0","3","1","2","0","0","0","0","0","0","0","0","0","-2"
"243568","Universidad Central Del Caribe","2017","Not on tenure/no tenure system, assistant professors","13","6","7","0","0","0","0","0","0","0","0","0","10","3","7","0","0","0","3","3","0","0","0","0","0","0","0","0","0","0","-2"
"243568","Universidad Central Del Caribe","2017","Not on tenure/no tenure system, instructors","1","0","1","0","0","0","0","0","0","0","0","0","1","0","1","0","0","0","0","0","0","0","0","0","0","0","0","0","0","0","-2"
"243577","Universidad Politecnica de Puerto Rico","2017","Tenured total","25","17","8","0","0","0","0","0","0","0","0","0","24","16","8","0","0","0","1","1","0","0","0","0","0","0","0","0","0","0","-2"
"243577","Universidad Politecnica de Puerto Rico","2017","Tenured, professors","17","14","3","0","0","0","0","0","0","0","0","0","17","14","3","0","0","0","0","0","0","0","0","0","0","0","0","0","0","0","-2"
"243577","Universidad Politecnica de Puerto Rico","2017","Tenured, associate professors","8","3","5","0","0","0","0","0","0","0","0","0","7","2","5","0","0","0","1","1","0","0","0","0","0","0","0","0","0","0","-2"
"243577","Universidad Politecnica de Puerto Rico","2017","Not on tenure track/No tenure system system total","108","70","38","0","0","0","1","1","0","0","0","0","100","63","37","0","0","0","1","1","0","0","0","0","6","5","1","0","0","0","-2"
"243577","Universidad Politecnica de Puerto Rico","2017","Not on tenure/no tenure system, professors","20","15","5","0","0","0","1","1","0","0","0","0","18","13","5","0","0","0","1","1","0","0","0","0","0","0","0","0","0","0","-2"
"243577","Universidad Politecnica de Puerto Rico","2017","Not on tenure/no tenure system, associate professors","67","44","23","0","0","0","0","0","0","0","0","0","61","39","22","0","0","0","0","0","0","0","0","0","6","5","1","0","0","0","-2"
"243577","Universidad Politecnica de Puerto Rico","2017","Not on tenure/no tenure system, assistant professors","17","10","7","0","0","0","0","0","0","0","0","0","17","10","7","0","0","0","0","0","0","0","0","0","0","0","0","0","0","0","-2"
"243577","Universidad Politecnica de Puerto Rico","2017","Not on tenure/no tenure system, instructors","4","1","3","0","0","0","0","0","0","0","0","0","4","1","3","0","0","0","0","0","0","0","0","0","0","0","0","0","0","0","-2"
"243586","Pontifical Catholic University of Puerto Rico-Mayaguez","2017","Not on tenure track/No tenure system system total","39","20","19","0","0","0","0","0","0","0","0","0","38","19","19","0","0","0","1","1","0","0","0","0","0","0","0","0","0","0","-2"
"243586","Pontifical Catholic University of Puerto Rico-Mayaguez","2017","Not on tenure/no tenure system, professors","2","1","1","0","0","0","0","0","0","0","0","0","2","1","1","0","0","0","0","0","0","0","0","0","0","0","0","0","0","0","-2"
"243586","Pontifical Catholic University of Puerto Rico-Mayaguez","2017","Not on tenure/no tenure system, associate professors","7","6","1","0","0","0","0","0","0","0","0","0","7","6","1","0","0","0","0","0","0","0","0","0","0","0","0","0","0","0","-2"
"243586","Pontifical Catholic University of Puerto Rico-Mayaguez","2017","Not on tenure/no tenure system, assistant professors","21","9","12","0","0","0","0","0","0","0","0","0","21","9","12","0","0","0","0","0","0","0","0","0","0","0","0","0","0","0","-2"
"243586","Pontifical Catholic University of Puerto Rico-Mayaguez","2017","Not on tenure/no tenure system, instructors","5","2","3","0","0","0","0","0","0","0","0","0","4","1","3","0","0","0","1","1","0","0","0","0","0","0","0","0","0","0","-2"
"243586","Pontifical Catholic University of Puerto Rico-Mayaguez","2017","Not on tenure/no tenure system, no academic rank","4","2","2","0","0","0","0","0","0","0","0","0","4","2","2","0","0","0","0","0","0","0","0","0","0","0","0","0","0","0","-2"
"243601","Universidad Ana G. Mendez-Gurabo Campus","2017","Tenured total","33","16","17","0","0","0","0","0","0","0","0","0","33","16","17","0","0","0","0","0","0","0","0","0","0","0","0","0","0","0","-2"
"243601","Universidad Ana G. Mendez-Gurabo Campus","2017","Tenured, professors","19","9","10","0","0","0","0","0","0","0","0","0","19","9","10","0","0","0","0","0","0","0","0","0","0","0","0","0","0","0","-2"
"243601","Universidad Ana G. Mendez-Gurabo Campus","2017","Tenured, associate professors","13","6","7","0","0","0","0","0","0","0","0","0","13","6","7","0","0","0","0","0","0","0","0","0","0","0","0","0","0","0","-2"
"243601","Universidad Ana G. Mendez-Gurabo Campus","2017","Tenured, assistant professors","1","1","0","0","0","0","0","0","0","0","0","0","1","1","0","0","0","0","0","0","0","0","0","0","0","0","0","0","0","0","-2"
"243601","Universidad Ana G. Mendez-Gurabo Campus","2017","Not on tenure track/No tenure system system total","146","69","77","0","0","0","0","0","0","0","0","0","120","46","74","0","0","0","3","2","1","0","0","0","4","2","2","19","19","0","-2"
"243601","Universidad Ana G. Mendez-Gurabo Campus","2017","Not on tenure/no tenure system, professors","17","13","4","0","0","0","0","0","0","0","0","0","14","10","4","0","0","0","1","1","0","0","0","0","2","2","0","0","0","0","-2"
"243601","Universidad Ana G. Mendez-Gurabo Campus","2017","Not on tenure/no tenure system, associate professors","32","12","20","0","0","0","0","0","0","0","0","0","30","12","18","0","0","0","0","0","0","0","0","0","2","0","2","0","0","0","-2"
"243601","Universidad Ana G. Mendez-Gurabo Campus","2017","Not on tenure/no tenure system, assistant professors","59","25","34","0","0","0","0","0","0","0","0","0","52","18","34","0","0","0","0","0","0","0","0","0","0","0","0","7","7","0","-2"
"243601","Universidad Ana G. Mendez-Gurabo Campus","2017","Not on tenure/no tenure system, instructors","38","19","19","0","0","0","0","0","0","0","0","0","24","6","18","0","0","0","2","1","1","0","0","0","0","0","0","12","12","0","-2"
"243832","EDP University of Puerto Rico Inc-San Juan","2017","Not on tenure track/No tenure system system total","46","16","30","0","0","0","0","0","0","0","0","0","46","16","30","0","0","0","0","0","0","0","0","0","0","0","0","0","0","0","-2"
"243832","EDP University of Puerto Rico Inc-San Juan","2017","Not on tenure/no tenure system, instructors","46","16","30","0","0","0","0","0","0","0","0","0","46","16","30","0","0","0","0","0","0","0","0","0","0","0","0","0","0","0","-2"
"245953","Mid-America Christian University","2017","Not on tenure track/No tenure system system total","31","18","13","3","3","0","0","0","0","1","0","1","0","0","0","0","0","0","24","13","11","1","1","0","2","1","1","0","0","0","-2"
"245953","Mid-America Christian University","2017","Not on tenure/no tenure system, professors","6","5","1","2","2","0","0","0","0","1","0","1","0","0","0","0","0","0","3","3","0","0","0","0","0","0","0","0","0","0","-2"
"245953","Mid-America Christian University","2017","Not on tenure/no tenure system, associate professors","10","6","4","1","1","0","0","0","0","0","0","0","0","0","0","0","0","0","9","5","4","0","0","0","0","0","0","0","0","0","-2"
"245953","Mid-America Christian University","2017","Not on tenure/no tenure system, assistant professors","12","6","6","0","0","0","0","0","0","0","0","0","0","0","0","0","0","0","9","4","5","1","1","0","2","1","1","0","0","0","-2"
"245953","Mid-America Christian University","2017","Not on tenure/no tenure system, instructors","3","1","2","0","0","0","0","0","0","0","0","0","0","0","0","0","0","0","3","1","2","0","0","0","0","0","0","0","0","0","-2"
"363907","Caribbean University-Ponce","2017","Not on tenure track/No tenure system system total","26","10","16","0","0","0","0","0","0","0","0","0","26","10","16","0","0","0","0","0","0","0","0","0","0","0","0","0","0","0","-2"
"363907","Caribbean University-Ponce","2017","Not on tenure/no tenure system, professors","1","1","0","0","0","0","0","0","0","0","0","0","1","1","0","0","0","0","0","0","0","0","0","0","0","0","0","0","0","0","-2"
"363907","Caribbean University-Ponce","2017","Not on tenure/no tenure system, assistant professors","7","3","4","0","0","0","0","0","0","0","0","0","7","3","4","0","0","0","0","0","0","0","0","0","0","0","0","0","0","0","-2"
"363907","Caribbean University-Ponce","2017","Not on tenure/no tenure system, instructors","18","6","12","0","0","0","0","0","0","0","0","0","18","6","12","0","0","0","0","0","0","0","0","0","0","0","0","0","0","0","-2"
"363916","Caribbean University-Vega Baja","2017","Not on tenure track/No tenure system system total","12","4","8","0","0","0","0","0","0","0","0","0","12","4","8","0","0","0","0","0","0","0","0","0","0","0","0","0","0","0","-2"
"363916","Caribbean University-Vega Baja","2017","Not on tenure/no tenure system, assistant professors","2","0","2","0","0","0","0","0","0","0","0","0","2","0","2","0","0","0","0","0","0","0","0","0","0","0","0","0","0","0","-2"
"363916","Caribbean University-Vega Baja","2017","Not on tenure/no tenure system, instructors","10","4","6","0","0","0","0","0","0","0","0","0","10","4","6","0","0","0","0","0","0","0","0","0","0","0","0","0","0","0","-2"
"366711","California State University-San Marcos","2017","Tenured total","187","95","92","3","1","2","28","18","10","6","5","1","30","13","17","1","1","0","107","50","57","5","1","4","5","4","1","2","2","0","-2"
"366711","California State University-San Marcos","2017","Tenured, professors","105","49","56","1","0","1","13","9","4","2","1","1","13","6","7","0","0","0","69","30","39","3","0","3","2","1","1","2","2","0","-2"
"366711","California State University-San Marcos","2017","Tenured, associate professors","79","44","35","2","1","1","14","9","5","4","4","0","16","6","10","1","1","0","38","20","18","2","1","1","2","2","0","0","0","0","-2"
"366711","California State University-San Marcos","2017","Tenured, no academic rank","3","2","1","0","0","0","1","0","1","0","0","0","1","1","0","0","0","0","0","0","0","0","0","0","1","1","0","0","0","0","-2"
"366711","California State University-San Marcos","2017","On-Tenure track total","87","44","43","1","1","0","12","7","5","3","2","1","11","7","4","0","0","0","45","20","25","1","0","1","4","2","2","10","5","5","-2"
"366711","California State University-San Marcos","2017","On-tenure track, associate professors","2","2","0","0","0","0","1","1","0","0","0","0","0","0","0","0","0","0","1","1","0","0","0","0","0","0","0","0","0","0","-2"
"366711","California State University-San Marcos","2017","On-tenure track, assistant professors","85","42","43","1","1","0","11","6","5","3","2","1","11","7","4","0","0","0","44","19","25","1","0","1","4","2","2","10","5","5","-2"
"366711","California State University-San Marcos","2017","Not on tenure track/No tenure system system total","121","32","89","1","0","1","8","4","4","1","0","1","17","3","14","0","0","0","89","24","65","4","1","3","0","0","0","1","0","1","-2"
"366711","California State University-San Marcos","2017","Not on tenure/no tenure system, lecturers","121","32","89","1","0","1","8","4","4","1","0","1","17","3","14","0","0","0","89","24","65","4","1","3","0","0","0","1","0","1","-2"
"367884","Hodges University","2017","Not on tenure track/No tenure system system total","39","18","21","0","0","0","0","0","0","0","0","0","7","5","2","0","0","0","31","13","18","1","0","1","0","0","0","0","0","0","-2"
"367884","Hodges University","2017","Not on tenure/no tenure system, professors","7","3","4","0","0","0","0","0","0","0","0","0","0","0","0","0","0","0","7","3","4","0","0","0","0","0","0","0","0","0","-2"
"367884","Hodges University","2017","Not on tenure/no tenure system, associate professors","13","7","6","0","0","0","0","0","0","0","0","0","2","2","0","0","0","0","11","5","6","0","0","0","0","0","0","0","0","0","-2"
"367884","Hodges University","2017","Not on tenure/no tenure system, assistant professors","17","7","10","0","0","0","0","0","0","0","0","0","4","2","2","0","0","0","12","5","7","1","0","1","0","0","0","0","0","0","-2"
"367884","Hodges University","2017","Not on tenure/no tenure system, instructors","1","0","1","0","0","0","0","0","0","0","0","0","0","0","0","0","0","0","1","0","1","0","0","0","0","0","0","0","0","0","-2"
"367884","Hodges University","2017","Not on tenure/no tenure system, no academic rank","1","1","0","0","0","0","0","0","0","0","0","0","1","1","0","0","0","0","0","0","0","0","0","0","0","0","0","0","0","0","-2"
"376385","Universal Technology College of Puerto Rico","2017","Not on tenure track/No tenure system system total","29","15","14","0","0","0","0","0","0","0","0","0","29","15","14","0","0","0","0","0","0","0","0","0","0","0","0","0","0","0","-2"
"376385","Universal Technology College of Puerto Rico","2017","Not on tenure/no tenure system, professors","29","15","14","0","0","0","0","0","0","0","0","0","29","15","14","0","0","0","0","0","0","0","0","0","0","0","0","0","0","0","-2"
"401223","World Mission University","2017","Not on tenure track/No tenure system system total","5","3","2","0","0","0","5","3","2","0","0","0","0","0","0","0","0","0","0","0","0","0","0","0","0","0","0","0","0","0","-2"
"401223","World Mission University","2017","Not on tenure/no tenure system, associate professors","1","1","0","0","0","0","1","1","0","0","0","0","0","0","0","0","0","0","0","0","0","0","0","0","0","0","0","0","0","0","-2"
"401223","World Mission University","2017","Not on tenure/no tenure system, assistant professors","4","2","2","0","0","0","4","2","2","0","0","0","0","0","0","0","0","0","0","0","0","0","0","0","0","0","0","0","0","0","-2"
"407009","Arizona State University-West","2017","Tenured total","99","58","41","0","0","0","9","5","4","2","1","1","15","9","6","0","0","0","70","42","28","1","0","1","2","1","1","0","0","0","-2"
"407009","Arizona State University-West","2017","Tenured, professors","33","21","12","0","0","0","4","2","2","0","0","0","3","3","0","0","0","0","26","16","10","0","0","0","0","0","0","0","0","0","-2"
"407009","Arizona State University-West","2017","Tenured, associate professors","66","37","29","0","0","0","5","3","2","2","1","1","12","6","6","0","0","0","44","26","18","1","0","1","2","1","1","0","0","0","-2"
"407009","Arizona State University-West","2017","On-Tenure track total","33","8","25","1","1","0","5","0","5","2","0","2","4","1","3","0","0","0","19","5","14","2","1","1","0","0","0","0","0","0","-2"
"407009","Arizona State University-West","2017","On-tenure track, associate professors","2","1","1","0","0","0","1","0","1","0","0","0","0","0","0","0","0","0","1","1","0","0","0","0","0","0","0","0","0","0","-2"
"407009","Arizona State University-West","2017","On-tenure track, assistant professors","31","7","24","1","1","0","4","0","4","2","0","2","4","1","3","0","0","0","18","4","14","2","1","1","0","0","0","0","0","0","-2"
"407009","Arizona State University-West","2017","Not on tenure track/No tenure system system total","129","42","87","2","0","2","5","0","5","4","2","2","14","5","9","1","0","1","98","33","65","1","0","1","3","1","2","1","1","0","-2"
"407009","Arizona State University-West","2017","Not on tenure/no tenure system, professors","3","3","0","0","0","0","0","0","0","0","0","0","1","1","0","0","0","0","1","1","0","0","0","0","1","1","0","0","0","0","-2"
"407009","Arizona State University-West","2017","Not on tenure/no tenure system, associate professors","8","4","4","0","0","0","0","0","0","0","0","0","2","1","1","0","0","0","6","3","3","0","0","0","0","0","0","0","0","0","-2"
"407009","Arizona State University-West","2017","Not on tenure/no tenure system, assistant professors","39","7","32","0","0","0","1","0","1","1","1","0","4","1","3","1","0","1","32","5","27","0","0","0","0","0","0","0","0","0","-2"
"407009","Arizona State University-West","2017","Not on tenure/no tenure system, instructors","28","7","21","0","0","0","1","0","1","0","0","0","4","1","3","0","0","0","20","6","14","1","0","1","2","0","2","0","0","0","-2"
"407009","Arizona State University-West","2017","Not on tenure/no tenure system, lecturers","50","21","29","2","0","2","3","0","3","3","1","2","3","1","2","0","0","0","38","18","20","0","0","0","0","0","0","1","1","0","-2"
"407009","Arizona State University-West","2017","Not on tenure/no tenure system, no academic rank","1","0","1","0","0","0","0","0","0","0","0","0","0","0","0","0","0","0","1","0","1","0","0","0","0","0","0","0","0","0","-2"
"409315","South Texas College","2017","Not on tenure track/No tenure system system total","629","374","255","4","3","1","54","27","27","12","11","1","375","221","154","0","0","0","180","109","71","0","0","0","4","3","1","0","0","0","-2"
"409315","South Texas College","2017","Not on tenure/no tenure system, professors","10","6","4","0","0","0","1","1","0","1","1","0","2","1","1","0","0","0","6","3","3","0","0","0","0","0","0","0","0","0","-2"
"409315","South Texas College","2017","Not on tenure/no tenure system, associate professors","30","19","11","0","0","0","1","1","0","0","0","0","16","10","6","0","0","0","13","8","5","0","0","0","0","0","0","0","0","0","-2"
"409315","South Texas College","2017","Not on tenure/no tenure system, assistant professors","40","24","16","0","0","0","4","2","2","0","0","0","17","9","8","0","0","0","19","13","6","0","0","0","0","0","0","0","0","0","-2"
"409315","South Texas College","2017","Not on tenure/no tenure system, instructors","463","265","198","2","1","1","45","22","23","9","8","1","278","158","120","0","0","0","127","75","52","0","0","0","2","1","1","0","0","0","-2"
"409315","South Texas College","2017","Not on tenure/no tenure system, lecturers","86","60","26","2","2","0","3","1","2","2","2","0","62","43","19","0","0","0","15","10","5","0","0","0","2","2","0","0","0","0","-2"
"409698","California State University-Monterey Bay","2017","Tenured total","91","47","44","1","1","0","17","7","10","4","3","1","18","11","7","1","0","1","44","23","21","1","0","1","5","2","3","0","0","0","-2"
"409698","California State University-Monterey Bay","2017","Tenured, professors","59","33","26","1","1","0","13","6","7","2","1","1","10","7","3","1","0","1","30","18","12","1","0","1","1","0","1","0","0","0","-2"
"409698","California State University-Monterey Bay","2017","Tenured, associate professors","31","14","17","0","0","0","4","1","3","2","2","0","8","4","4","0","0","0","13","5","8","0","0","0","4","2","2","0","0","0","-2"
"409698","California State University-Monterey Bay","2017","Tenured, no academic rank","1","0","1","0","0","0","0","0","0","0","0","0","0","0","0","0","0","0","1","0","1","0","0","0","0","0","0","0","0","0","-2"
"409698","California State University-Monterey Bay","2017","On-Tenure track total","65","29","36","1","1","0","6","3","3","2","1","1","10","4","6","0","0","0","40","16","24","1","1","0","1","1","0","4","2","2","-2"
"409698","California State University-Monterey Bay","2017","On-tenure track, associate professors","5","4","1","0","0","0","0","0","0","0","0","0","0","0","0","0","0","0","4","3","1","0","0","0","0","0","0","1","1","0","-2"
"409698","California State University-Monterey Bay","2017","On-tenure track, assistant professors","60","25","35","1","1","0","6","3","3","2","1","1","10","4","6","0","0","0","36","13","23","1","1","0","1","1","0","3","1","2","-2"
"409698","California State University-Monterey Bay","2017","Not on tenure track/No tenure system system total","43","17","26","0","0","0","2","1","1","1","0","1","9","4","5","0","0","0","28","10","18","1","1","0","2","1","1","0","0","0","-2"
"409698","California State University-Monterey Bay","2017","Not on tenure/no tenure system, lecturers","43","17","26","0","0","0","2","1","1","1","0","1","9","4","5","0","0","0","28","10","18","1","1","0","2","1","1","0","0","0","-2"
"414823","Johnson & Wales University-North Miami","2017","Not on tenure track/No tenure system system total","51","33","18","0","0","0","4","1","3","7","4","3","5","3","2","0","0","0","32","24","8","3","1","2","0","0","0","0","0","0","-2"
"414823","Johnson & Wales University-North Miami","2017","Not on tenure/no tenure system, professors","13","7","6","0","0","0","1","0","1","2","1","1","1","0","1","0","0","0","9","6","3","0","0","0","0","0","0","0","0","0","-2"
"414823","Johnson & Wales University-North Miami","2017","Not on tenure/no tenure system, associate professors","15","9","6","0","0","0","1","1","0","3","2","1","1","0","1","0","0","0","8","6","2","2","0","2","0","0","0","0","0","0","-2"
"414823","Johnson & Wales University-North Miami","2017","Not on tenure/no tenure system, assistant professors","12","9","3","0","0","0","0","0","0","2","1","1","0","0","0","0","0","0","9","7","2","1","1","0","0","0","0","0","0","0","-2"
"414823","Johnson & Wales University-North Miami","2017","Not on tenure/no tenure system, instructors","11","8","3","0","0","0","2","0","2","0","0","0","3","3","0","0","0","0","6","5","1","0","0","0","0","0","0","0","0","0","-2"
"416801","The University of Texas MD Anderson Cancer Center","2017","Tenured total","1","1","0","0","0","0","1","1","0","0","0","0","0","0","0","0","0","0","0","0","0","0","0","0","0","0","0","0","0","0","-2"
"416801","The University of Texas MD Anderson Cancer Center","2017","Tenured, professors","1","1","0","0","0","0","1","1","0","0","0","0","0","0","0","0","0","0","0","0","0","0","0","0","0","0","0","0","0","0","-2"
"416801","The University of Texas MD Anderson Cancer Center","2017","Not on tenure track/No tenure system system total","17","6","11","0","0","0","3","3","0","3","1","2","0","0","0","0","0","0","11","2","9","0","0","0","0","0","0","0","0","0","-2"
"416801","The University of Texas MD Anderson Cancer Center","2017","Not on tenure/no tenure system, lecturers","17","6","11","0","0","0","3","3","0","3","1","2","0","0","0","0","0","0","11","2","9","0","0","0","0","0","0","0","0","0","-2"
"430670","San Juan Bautista School of Medicine","2017","Tenured total","11","6","5","0","0","0","0","0","0","0","0","0","11","6","5","0","0","0","0","0","0","0","0","0","0","0","0","0","0","0","-2"
"430670","San Juan Bautista School of Medicine","2017","Tenured, associate professors","5","5","0","0","0","0","0","0","0","0","0","0","5","5","0","0","0","0","0","0","0","0","0","0","0","0","0","0","0","0","-2"
"430670","San Juan Bautista School of Medicine","2017","Tenured, assistant professors","5","1","4","0","0","0","0","0","0","0","0","0","5","1","4","0","0","0","0","0","0","0","0","0","0","0","0","0","0","0","-2"
"430670","San Juan Bautista School of Medicine","2017","Tenured, instructors","1","0","1","0","0","0","0","0","0","0","0","0","1","0","1","0","0","0","0","0","0","0","0","0","0","0","0","0","0","0","-2"
"430670","San Juan Bautista School of Medicine","2017","On-Tenure track total","10","3","7","0","0","0","0","0","0","0","0","0","10","3","7","0","0","0","0","0","0","0","0","0","0","0","0","0","0","0","-2"
"430670","San Juan Bautista School of Medicine","2017","On-tenure track, associate professors","1","0","1","0","0","0","0","0","0","0","0","0","1","0","1","0","0","0","0","0","0","0","0","0","0","0","0","0","0","0","-2"
"430670","San Juan Bautista School of Medicine","2017","On-tenure track, assistant professors","3","0","3","0","0","0","0","0","0","0","0","0","3","0","3","0","0","0","0","0","0","0","0","0","0","0","0","0","0","0","-2"
"430670","San Juan Bautista School of Medicine","2017","On-tenure track, instructors","6","3","3","0","0","0","0","0","0","0","0","0","6","3","3","0","0","0","0","0","0","0","0","0","0","0","0","0","0","0","-2"
"430670","San Juan Bautista School of Medicine","2017","Not on tenure track/No tenure system system total","20","16","4","0","0","0","0","0","0","0","0","0","20","16","4","0","0","0","0","0","0","0","0","0","0","0","0","0","0","0","-2"
"430670","San Juan Bautista School of Medicine","2017","Not on tenure/no tenure system, professors","1","1","0","0","0","0","0","0","0","0","0","0","1","1","0","0","0","0","0","0","0","0","0","0","0","0","0","0","0","0","-2"
"430670","San Juan Bautista School of Medicine","2017","Not on tenure/no tenure system, associate professors","2","2","0","0","0","0","0","0","0","0","0","0","2","2","0","0","0","0","0","0","0","0","0","0","0","0","0","0","0","0","-2"
"430670","San Juan Bautista School of Medicine","2017","Not on tenure/no tenure system, assistant professors","15","12","3","0","0","0","0","0","0","0","0","0","15","12","3","0","0","0","0","0","0","0","0","0","0","0","0","0","0","0","-2"
"430670","San Juan Bautista School of Medicine","2017","Not on tenure/no tenure system, instructors","2","1","1","0","0","0","0","0","0","0","0","0","2","1","1","0","0","0","0","0","0","0","0","0","0","0","0","0","0","0","-2"
"434539","City College-Miami","2017","Not on tenure track/No tenure system system total","4","1","3","0","0","0","0","0","0","0","0","0","0","0","0","0","0","0","2","1","1","0","0","0","2","0","2","0","0","0","-2"
"434539","City College-Miami","2017","Not on tenure/no tenure system, instructors","4","1","3","0","0","0","0","0","0","0","0","0","0","0","0","0","0","0","2","1","1","0","0","0","2","0","2","0","0","0","-2"
"434900","Dewey University-Carolina","2017","Not on tenure track/No tenure system system total","50","22","28","0","0","0","0","0","0","0","0","0","50","22","28","0","0","0","0","0","0","0","0","0","0","0","0","0","0","0","-2"
"434900","Dewey University-Carolina","2017","Not on tenure/no tenure system, professors","50","22","28","0","0","0","0","0","0","0","0","0","50","22","28","0","0","0","0","0","0","0","0","0","0","0","0","0","0","0","-2"
"439446","Atlantic Institute of Oriental Medicine","2017","Not on tenure track/No tenure system system total","5","3","2","0","0","0","3","2","1","1","1","0","0","0","0","0","0","0","1","0","1","0","0","0","0","0","0","0","0","0","-2"
"439446","Atlantic Institute of Oriental Medicine","2017","Not on tenure/no tenure system, instructors","5","3","2","0","0","0","3","2","1","1","1","0","0","0","0","0","0","0","1","0","1","0","0","0","0","0","0","0","0","0","-2"
"440651","Atenas College","2017","Tenured total","14","2","12","0","0","0","0","0","0","0","0","0","14","2","12","0","0","0","0","0","0","0","0","0","0","0","0","0","0","0","-2"
"440651","Atenas College","2017","Tenured, professors","14","2","12","0","0","0","0","0","0","0","0","0","14","2","12","0","0","0","0","0","0","0","0","0","0","0","0","0","0","0","-2"
"440651","Atenas College","2017","Not on tenure track/No tenure system system total","10","4","6","0","0","0","0","0","0","0","0","0","10","4","6","0","0","0","0","0","0","0","0","0","0","0","0","0","0","0","-2"
"440651","Atenas College","2017","Not on tenure/no tenure system, professors","10","4","6","0","0","0","0","0","0","0","0","0","10","4","6","0","0","0","0","0","0","0","0","0","0","0","0","0","0","0","-2"
"440794","Pillar College","2017","Tenured total","3","2","1","0","0","0","1","1","0","1","0","1","0","0","0","0","0","0","1","1","0","0","0","0","0","0","0","0","0","0","-2"
"440794","Pillar College","2017","Tenured, professors","2","1","1","0","0","0","0","0","0","1","0","1","0","0","0","0","0","0","1","1","0","0","0","0","0","0","0","0","0","0","-2"
"440794","Pillar College","2017","Tenured, associate professors","1","1","0","0","0","0","1","1","0","0","0","0","0","0","0","0","0","0","0","0","0","0","0","0","0","0","0","0","0","0","-2"
"440794","Pillar College","2017","Not on tenure track/No tenure system system total","11","5","6","0","0","0","0","0","0","5","0","5","1","1","0","0","0","0","5","4","1","0","0","0","0","0","0","0","0","0","-2"
"440794","Pillar College","2017","Not on tenure/no tenure system, professors","2","1","1","0","0","0","0","0","0","1","0","1","0","0","0","0","0","0","1","1","0","0","0","0","0","0","0","0","0","0","-2"
"440794","Pillar College","2017","Not on tenure/no tenure system, associate professors","2","1","1","0","0","0","0","0","0","1","0","1","0","0","0","0","0","0","1","1","0","0","0","0","0","0","0","0","0","0","-2"
"440794","Pillar College","2017","Not on tenure/no tenure system, assistant professors","4","1","3","0","0","0","0","0","0","3","0","3","0","0","0","0","0","0","1","1","0","0","0","0","0","0","0","0","0","0","-2"
"440794","Pillar College","2017","Not on tenure/no tenure system, no academic rank","3","2","1","0","0","0","0","0","0","0","0","0","1","1","0","0","0","0","2","1","1","0","0","0","0","0","0","0","0","0","-2"
"441900","Nevada State College","2017","Tenured total","15","9","6","0","0","0","1","1","0","2","2","0","1","0","1","0","0","0","11","6","5","0","0","0","0","0","0","0","0","0","-2"
"441900","Nevada State College","2017","Tenured, professors","4","3","1","0","0","0","0","0","0","0","0","0","0","0","0","0","0","0","4","3","1","0","0","0","0","0","0","0","0","0","-2"
"441900","Nevada State College","2017","Tenured, associate professors","11","6","5","0","0","0","1","1","0","2","2","0","1","0","1","0","0","0","7","3","4","0","0","0","0","0","0","0","0","0","-2"
"441900","Nevada State College","2017","On-Tenure track total","33","7","26","0","0","0","1","0","1","1","0","1","4","1","3","0","0","0","24","6","18","3","0","3","0","0","0","0","0","0","-2"
"441900","Nevada State College","2017","On-tenure track, associate professors","1","0","1","0","0","0","0","0","0","0","0","0","0","0","0","0","0","0","1","0","1","0","0","0","0","0","0","0","0","0","-2"
"441900","Nevada State College","2017","On-tenure track, assistant professors","32","7","25","0","0","0","1","0","1","1","0","1","4","1","3","0","0","0","23","6","17","3","0","3","0","0","0","0","0","0","-2"
"441900","Nevada State College","2017","Not on tenure track/No tenure system system total","27","8","19","0","0","0","4","1","3","1","0","1","4","1","3","0","0","0","17","5","12","1","1","0","0","0","0","0","0","0","-2"
"441900","Nevada State College","2017","Not on tenure/no tenure system, assistant professors","1","0","1","0","0","0","1","0","1","0","0","0","0","0","0","0","0","0","0","0","0","0","0","0","0","0","0","0","0","0","-2"
"441900","Nevada State College","2017","Not on tenure/no tenure system, lecturers","26","8","18","0","0","0","3","1","2","1","0","1","4","1","3","0","0","0","17","5","12","1","1","0","0","0","0","0","0","0","-2"
"441937","California State University-Channel Islands","2017","Tenured total","62","33","29","0","0","0","5","1","4","1","1","0","12","6","6","0","0","0","39","21","18","0","0","0","4","3","1","1","1","0","-2"
"441937","California State University-Channel Islands","2017","Tenured, professors","51","28","23","0","0","0","4","1","3","1","1","0","11","5","6","0","0","0","31","17","14","0","0","0","3","3","0","1","1","0","-2"
"441937","California State University-Channel Islands","2017","Tenured, associate professors","11","5","6","0","0","0","1","0","1","0","0","0","1","1","0","0","0","0","8","4","4","0","0","0","1","0","1","0","0","0","-2"
"441937","California State University-Channel Islands","2017","On-Tenure track total","74","27","47","0","0","0","4","1","3","3","0","3","18","7","11","0","0","0","37","14","23","2","0","2","2","2","0","8","3","5","-2"
"441937","California State University-Channel Islands","2017","On-tenure track, associate professors","7","2","5","0","0","0","0","0","0","0","0","0","1","0","1","0","0","0","5","2","3","1","0","1","0","0","0","0","0","0","-2"
"441937","California State University-Channel Islands","2017","On-tenure track, assistant professors","67","25","42","0","0","0","4","1","3","3","0","3","17","7","10","0","0","0","32","12","20","1","0","1","2","2","0","8","3","5","-2"
"441937","California State University-Channel Islands","2017","Not on tenure track/No tenure system system total","76","41","35","0","0","0","8","4","4","0","0","0","14","9","5","0","0","0","50","24","26","4","4","0","0","0","0","0","0","0","-2"
"441937","California State University-Channel Islands","2017","Not on tenure/no tenure system, lecturers","76","41","35","0","0","0","8","4","4","0","0","0","14","9","5","0","0","0","50","24","26","4","4","0","0","0","0","0","0","0","-2"
"443562","Dewey University-Hato Rey","2017","Not on tenure track/No tenure system system total","269","118","151","0","0","0","0","0","0","0","0","0","269","118","151","0","0","0","0","0","0","0","0","0","0","0","0","0","0","0","-2"
"443562","Dewey University-Hato Rey","2017","Not on tenure/no tenure system, professors","269","118","151","0","0","0","0","0","0","0","0","0","269","118","151","0","0","0","0","0","0","0","0","0","0","0","0","0","0","0","-2"
"444398","Baptist University of the Americas","2017","Tenured total","3","2","1","0","0","0","0","0","0","0","0","0","3","2","1","0","0","0","0","0","0","0","0","0","0","0","0","0","0","0","-2"
"444398","Baptist University of the Americas","2017","Tenured, professors","3","2","1","0","0","0","0","0","0","0","0","0","3","2","1","0","0","0","0","0","0","0","0","0","0","0","0","0","0","0","-2"
"444398","Baptist University of the Americas","2017","Not on tenure track/No tenure system system total","6","2","4","0","0","0","0","0","0","0","0","0","4","0","4","0","0","0","2","2","0","0","0","0","0","0","0","0","0","0","-2"
"444398","Baptist University of the Americas","2017","Not on tenure/no tenure system, assistant professors","3","2","1","0","0","0","0","0","0","0","0","0","1","0","1","0","0","0","2","2","0","0","0","0","0","0","0","0","0","0","-2"
"444398","Baptist University of the Americas","2017","Not on tenure/no tenure system, instructors","3","0","3","0","0","0","0","0","0","0","0","0","3","0","3","0","0","0","0","0","0","0","0","0","0","0","0","0","0","0","-2"
"448752","CollegeAmerica-Colorado Springs","2017","Not on tenure track/No tenure system system total","2","2","0","0","0","0","0","0","0","0","0","0","0","0","0","0","0","0","2","2","0","0","0","0","0","0","0","0","0","0","-2"
"448752","CollegeAmerica-Colorado Springs","2017","Not on tenure/no tenure system, no academic rank","2","2","0","0","0","0","0","0","0","0","0","0","0","0","0","0","0","0","2","2","0","0","0","0","0","0","0","0","0","0","-2"
"448886","Arizona State University-Downtown Phoenix","2017","Tenured total","145","72","73","0","0","0","12","4","8","6","2","4","11","6","5","0","0","0","111","57","54","3","2","1","2","1","1","0","0","0","-2"
"448886","Arizona State University-Downtown Phoenix","2017","Tenured, professors","77","49","28","0","0","0","3","2","1","3","2","1","6","5","1","0","0","0","62","38","24","2","2","0","1","0","1","0","0","0","-2"
"448886","Arizona State University-Downtown Phoenix","2017","Tenured, associate professors","68","23","45","0","0","0","9","2","7","3","0","3","5","1","4","0","0","0","49","19","30","1","0","1","1","1","0","0","0","0","-2"
"448886","Arizona State University-Downtown Phoenix","2017","On-Tenure track total","69","29","40","0","0","0","11","6","5","0","0","0","8","2","6","0","0","0","35","17","18","4","1","3","5","0","5","6","3","3","-2"
"448886","Arizona State University-Downtown Phoenix","2017","On-tenure track, associate professors","10","4","6","0","0","0","1","1","0","0","0","0","0","0","0","0","0","0","5","2","3","1","1","0","3","0","3","0","0","0","-2"
"448886","Arizona State University-Downtown Phoenix","2017","On-tenure track, assistant professors","59","25","34","0","0","0","10","5","5","0","0","0","8","2","6","0","0","0","30","15","15","3","0","3","2","0","2","6","3","3","-2"
"448886","Arizona State University-Downtown Phoenix","2017","Not on tenure track/No tenure system system total","308","89","219","1","1","0","9","2","7","19","3","16","23","6","17","1","0","1","242","73","169","4","0","4","6","3","3","3","1","2","-2"
"448886","Arizona State University-Downtown Phoenix","2017","Not on tenure/no tenure system, professors","44","15","29","0","0","0","0","0","0","3","0","3","3","0","3","0","0","0","35","14","21","0","0","0","3","1","2","0","0","0","-2"
"448886","Arizona State University-Downtown Phoenix","2017","Not on tenure/no tenure system, associate professors","27","4","23","0","0","0","0","0","0","2","0","2","2","0","2","0","0","0","22","4","18","1","0","1","0","0","0","0","0","0","-2"
"448886","Arizona State University-Downtown Phoenix","2017","Not on tenure/no tenure system, assistant professors","46","7","39","0","0","0","3","1","2","2","0","2","6","1","5","1","0","1","33","4","29","0","0","0","0","0","0","1","1","0","-2"
"448886","Arizona State University-Downtown Phoenix","2017","Not on tenure/no tenure system, instructors","94","34","60","1","1","0","2","1","1","10","3","7","9","3","6","0","0","0","66","24","42","2","0","2","3","2","1","1","0","1","-2"
"448886","Arizona State University-Downtown Phoenix","2017","Not on tenure/no tenure system, lecturers","97","29","68","0","0","0","4","0","4","2","0","2","3","2","1","0","0","0","86","27","59","1","0","1","0","0","0","1","0","1","-2"
"449870","University of the West","2017","Tenured total","5","4","1","0","0","0","5","4","1","0","0","0","0","0","0","0","0","0","0","0","0","0","0","0","0","0","0","0","0","0","-2"
"449870","University of the West","2017","Tenured, professors","2","2","0","0","0","0","2","2","0","0","0","0","0","0","0","0","0","0","0","0","0","0","0","0","0","0","0","0","0","0","-2"
"449870","University of the West","2017","Tenured, associate professors","3","2","1","0","0","0","3","2","1","0","0","0","0","0","0","0","0","0","0","0","0","0","0","0","0","0","0","0","0","0","-2"
"449870","University of the West","2017","On-Tenure track total","6","3","3","0","0","0","3","3","0","2","0","2","0","0","0","0","0","0","1","0","1","0","0","0","0","0","0","0","0","0","-2"
"449870","University of the West","2017","On-tenure track, assistant professors","6","3","3","0","0","0","3","3","0","2","0","2","0","0","0","0","0","0","1","0","1","0","0","0","0","0","0","0","0","0","-2"
"449870","University of the West","2017","Not on tenure track/No tenure system system total","4","2","2","0","0","0","1","0","1","0","0","0","1","1","0","0","0","0","2","1","1","0","0","0","0","0","0","0","0","0","-2"
"449870","University of the West","2017","Not on tenure/no tenure system, assistant professors","1","0","1","0","0","0","1","0","1","0","0","0","0","0","0","0","0","0","0","0","0","0","0","0","0","0","0","0","0","0","-2"
"449870","University of the West","2017","Not on tenure/no tenure system, instructors","3","2","1","0","0","0","0","0","0","0","0","0","1","1","0","0","0","0","2","1","1","0","0","0","0","0","0","0","0","0","-2"
"455770","Providence Christian College","2017","Not on tenure track/No tenure system system total","5","3","2","0","0","0","1","0","1","0","0","0","0","0","0","0","0","0","4","3","1","0","0","0","0","0","0","0","0","0","-2"
"455770","Providence Christian College","2017","Not on tenure/no tenure system, professors","1","1","0","0","0","0","0","0","0","0","0","0","0","0","0","0","0","0","1","1","0","0","0","0","0","0","0","0","0","0","-2"
"455770","Providence Christian College","2017","Not on tenure/no tenure system, assistant professors","4","2","2","0","0","0","1","0","1","0","0","0","0","0","0","0","0","0","3","2","1","0","0","0","0","0","0","0","0","0","-2"
"456490","Polytechnic University of Puerto Rico-Orlando","2017","Not on tenure track/No tenure system system total","6","4","2","0","0","0","0","0","0","0","0","0","6","4","2","0","0","0","0","0","0","0","0","0","0","0","0","0","0","0","-2"
"456490","Polytechnic University of Puerto Rico-Orlando","2017","Not on tenure/no tenure system, professors","2","0","2","0","0","0","0","0","0","0","0","0","2","0","2","0","0","0","0","0","0","0","0","0","0","0","0","0","0","0","-2"
"456490","Polytechnic University of Puerto Rico-Orlando","2017","Not on tenure/no tenure system, associate professors","4","4","0","0","0","0","0","0","0","0","0","0","4","4","0","0","0","0","0","0","0","0","0","0","0","0","0","0","0","0","-2"
"459949","Texas A&M University-San Antonio","2017","Tenured total","40","19","21","0","0","0","4","4","0","1","0","1","4","3","1","0","0","0","31","12","19","0","0","0","0","0","0","0","0","0","-2"
"459949","Texas A&M University-San Antonio","2017","Tenured, professors","10","5","5","0","0","0","2","2","0","0","0","0","2","1","1","0","0","0","6","2","4","0","0","0","0","0","0","0","0","0","-2"
"459949","Texas A&M University-San Antonio","2017","Tenured, associate professors","30","14","16","0","0","0","2","2","0","1","0","1","2","2","0","0","0","0","25","10","15","0","0","0","0","0","0","0","0","0","-2"
"459949","Texas A&M University-San Antonio","2017","On-Tenure track total","61","30","31","1","0","1","15","8","7","1","1","0","10","4","6","0","0","0","33","16","17","0","0","0","1","1","0","0","0","0","-2"
"459949","Texas A&M University-San Antonio","2017","On-tenure track, associate professors","2","0","2","0","0","0","2","0","2","0","0","0","0","0","0","0","0","0","0","0","0","0","0","0","0","0","0","0","0","0","-2"
"459949","Texas A&M University-San Antonio","2017","On-tenure track, assistant professors","59","30","29","1","0","1","13","8","5","1","1","0","10","4","6","0","0","0","33","16","17","0","0","0","1","1","0","0","0","0","-2"
"459949","Texas A&M University-San Antonio","2017","Not on tenure track/No tenure system system total","64","31","33","1","0","1","4","1","3","4","2","2","14","8","6","0","0","0","41","20","21","0","0","0","0","0","0","0","0","0","-2"
"459949","Texas A&M University-San Antonio","2017","Not on tenure/no tenure system, associate professors","5","3","2","0","0","0","0","0","0","0","0","0","1","1","0","0","0","0","4","2","2","0","0","0","0","0","0","0","0","0","-2"
"459949","Texas A&M University-San Antonio","2017","Not on tenure/no tenure system, assistant professors","21","12","9","1","0","1","2","0","2","2","1","1","7","4","3","0","0","0","9","7","2","0","0","0","0","0","0","0","0","0","-2"
"459949","Texas A&M University-San Antonio","2017","Not on tenure/no tenure system, lecturers","38","16","22","0","0","0","2","1","1","2","1","1","6","3","3","0","0","0","28","11","17","0","0","0","0","0","0","0","0","0","-2"
"462354","John Paul the Great Catholic University","2017","Not on tenure track/No tenure system system total","10","9","1","0","0","0","0","0","0","0","0","0","0","0","0","0","0","0","10","9","1","0","0","0","0","0","0","0","0","0","-2"
"462354","John Paul the Great Catholic University","2017","Not on tenure/no tenure system, professors","9","8","1","0","0","0","0","0","0","0","0","0","0","0","0","0","0","0","9","8","1","0","0","0","0","0","0","0","0","0","-2"
"462354","John Paul the Great Catholic University","2017","Not on tenure/no tenure system, associate professors","1","1","0","0","0","0","0","0","0","0","0","0","0","0","0","0","0","0","1","1","0","0","0","0","0","0","0","0","0","0","-2"
"474863","Los Angeles Pacific University","2017","Not on tenure track/No tenure system system total","13","9","4","0","0","0","2","1","1","2","1","1","0","0","0","0","0","0","9","7","2","0","0","0","0","0","0","0","0","0","-2"
"474863","Los Angeles Pacific University","2017","Not on tenure/no tenure system, lecturers","13","9","4","0","0","0","2","1","1","2","1","1","0","0","0","0","0","0","9","7","2","0","0","0","0","0","0","0","0","0","-2"
"474906","Stevens-Henager College","2017","Not on tenure track/No tenure system system total","6","1","5","0","0","0","0","0","0","0","0","0","0","0","0","0","0","0","6","1","5","0","0","0","0","0","0","0","0","0","-2"
"474906","Stevens-Henager College","2017","Not on tenure/no tenure system, no academic rank","6","1","5","0","0","0","0","0","0","0","0","0","0","0","0","0","0","0","6","1","5","0","0","0","0","0","0","0","0","0","-2"
"475273","Springfield College-Regional, Online, and Continuing Education","2017","Tenured total","4","2","2","0","0","0","0","0","0","2","1","1","0","0","0","0","0","0","2","1","1","0","0","0","0","0","0","0","0","0","-2"
"475273","Springfield College-Regional, Online, and Continuing Education","2017","Tenured, professors","4","2","2","0","0","0","0","0","0","2","1","1","0","0","0","0","0","0","2","1","1","0","0","0","0","0","0","0","0","0","-2"
"475273","Springfield College-Regional, Online, and Continuing Education","2017","Not on tenure track/No tenure system system total","11","6","5","0","0","0","1","1","0","2","1","1","1","0","1","0","0","0","4","2","2","1","1","0","2","1","1","0","0","0","-2"
"475273","Springfield College-Regional, Online, and Continuing Education","2017","Not on tenure/no tenure system, professors","2","1","1","0","0","0","0","0","0","0","0","0","0","0","0","0","0","0","2","1","1","0","0","0","0","0","0","0","0","0","-2"
"475273","Springfield College-Regional, Online, and Continuing Education","2017","Not on tenure/no tenure system, associate professors","2","1","1","0","0","0","0","0","0","1","1","0","1","0","1","0","0","0","0","0","0","0","0","0","0","0","0","0","0","0","-2"
"475273","Springfield College-Regional, Online, and Continuing Education","2017","Not on tenure/no tenure system, assistant professors","7","4","3","0","0","0","1","1","0","1","0","1","0","0","0","0","0","0","2","1","1","1","1","0","2","1","1","0","0","0","-2"
"478634","California College San Diego","2017","Not on tenure track/No tenure system system total","8","6","2","0","0","0","1","0","1","1","1","0","1","1","0","0","0","0","5","4","1","0","0","0","0","0","0","0","0","0","-2"
"478634","California College San Diego","2017","Not on tenure/no tenure system, no academic rank","8","6","2","0","0","0","1","0","1","1","1","0","1","1","0","0","0","0","5","4","1","0","0","0","0","0","0","0","0","0","-2"
"483036","Texas A&M University-Central Texas","2017","Tenured total","9","5","4","0","0","0","0","0","0","0","0","0","1","0","1","0","0","0","8","5","3","0","0","0","0","0","0","0","0","0","-2"
"483036","Texas A&M University-Central Texas","2017","Tenured, professors","2","1","1","0","0","0","0","0","0","0","0","0","0","0","0","0","0","0","2","1","1","0","0","0","0","0","0","0","0","0","-2"
"483036","Texas A&M University-Central Texas","2017","Tenured, associate professors","5","3","2","0","0","0","0","0","0","0","0","0","0","0","0","0","0","0","5","3","2","0","0","0","0","0","0","0","0","0","-2"
"483036","Texas A&M University-Central Texas","2017","Tenured, assistant professors","2","1","1","0","0","0","0","0","0","0","0","0","1","0","1","0","0","0","1","1","0","0","0","0","0","0","0","0","0","0","-2"
"483036","Texas A&M University-Central Texas","2017","On-Tenure track total","19","13","6","0","0","0","1","0","1","0","0","0","0","0","0","0","0","0","18","13","5","0","0","0","0","0","0","0","0","0","-2"
"483036","Texas A&M University-Central Texas","2017","On-tenure track, professors","3","3","0","0","0","0","0","0","0","0","0","0","0","0","0","0","0","0","3","3","0","0","0","0","0","0","0","0","0","0","-2"
"483036","Texas A&M University-Central Texas","2017","On-tenure track, associate professors","12","6","6","0","0","0","1","0","1","0","0","0","0","0","0","0","0","0","11","6","5","0","0","0","0","0","0","0","0","0","-2"
"483036","Texas A&M University-Central Texas","2017","On-tenure track, assistant professors","1","1","0","0","0","0","0","0","0","0","0","0","0","0","0","0","0","0","1","1","0","0","0","0","0","0","0","0","0","0","-2"
"483036","Texas A&M University-Central Texas","2017","On-tenure track, lecturers","3","3","0","0","0","0","0","0","0","0","0","0","0","0","0","0","0","0","3","3","0","0","0","0","0","0","0","0","0","0","-2"
"483036","Texas A&M University-Central Texas","2017","Not on tenure track/No tenure system system total","67","28","39","0","0","0","4","1","3","7","2","5","6","1","5","0","0","0","43","20","23","0","0","0","1","0","1","6","4","2","-2"
"483036","Texas A&M University-Central Texas","2017","Not on tenure/no tenure system, professors","6","2","4","0","0","0","0","0","0","0","0","0","0","0","0","0","0","0","6","2","4","0","0","0","0","0","0","0","0","0","-2"
"483036","Texas A&M University-Central Texas","2017","Not on tenure/no tenure system, associate professors","7","3","4","0","0","0","0","0","0","0","0","0","0","0","0","0","0","0","7","3","4","0","0","0","0","0","0","0","0","0","-2"
"483036","Texas A&M University-Central Texas","2017","Not on tenure/no tenure system, assistant professors","44","21","23","0","0","0","4","1","3","5","1","4","4","1","3","0","0","0","24","14","10","0","0","0","1","0","1","6","4","2","-2"
"483036","Texas A&M University-Central Texas","2017","Not on tenure/no tenure system, lecturers","10","2","8","0","0","0","0","0","0","2","1","1","2","0","2","0","0","0","6","1","5","0","0","0","0","0","0","0","0","0","-2"
"483595","Universidad Ana G. Mendez-Online Campus","2017","Not on tenure track/No tenure system system total","1","0","1","0","0","0","0","0","0","0","0","0","1","0","1","0","0","0","0","0","0","0","0","0","0","0","0","0","0","0","-2"
"483595","Universidad Ana G. Mendez-Online Campus","2017","Not on tenure/no tenure system, assistant professors","1","0","1","0","0","0","0","0","0","0","0","0","1","0","1","0","0","0","0","0","0","0","0","0","0","0","0","0","0","0","-2"
"484905","University of North Texas at Dallas","2017","Tenured total","14","6","8","0","0","0","4","3","1","1","0","1","3","2","1","0","0","0","6","1","5","0","0","0","0","0","0","0","0","0","-2"
"484905","University of North Texas at Dallas","2017","Tenured, professors","8","4","4","0","0","0","2","2","0","1","0","1","2","1","1","0","0","0","3","1","2","0","0","0","0","0","0","0","0","0","-2"
"484905","University of North Texas at Dallas","2017","Tenured, associate professors","6","2","4","0","0","0","2","1","1","0","0","0","1","1","0","0","0","0","3","0","3","0","0","0","0","0","0","0","0","0","-2"
"484905","University of North Texas at Dallas","2017","On-Tenure track total","42","27","15","0","0","0","4","2","2","7","6","1","3","1","2","0","0","0","25","17","8","0","0","0","1","0","1","2","1","1","-2"
"484905","University of North Texas at Dallas","2017","On-tenure track, associate professors","2","2","0","0","0","0","0","0","0","0","0","0","1","1","0","0","0","0","1","1","0","0","0","0","0","0","0","0","0","0","-2"
"484905","University of North Texas at Dallas","2017","On-tenure track, assistant professors","39","24","15","0","0","0","4","2","2","7","6","1","2","0","2","0","0","0","23","15","8","0","0","0","1","0","1","2","1","1","-2"
"484905","University of North Texas at Dallas","2017","On-tenure track, lecturers","1","1","0","0","0","0","0","0","0","0","0","0","0","0","0","0","0","0","1","1","0","0","0","0","0","0","0","0","0","0","-2"
"484905","University of North Texas at Dallas","2017","Not on tenure track/No tenure system system total","38","17","21","1","1","0","4","2","2","4","1","3","3","0","3","0","0","0","24","13","11","1","0","1","1","0","1","0","0","0","-2"
"484905","University of North Texas at Dallas","2017","Not on tenure/no tenure system, professors","2","2","0","0","0","0","0","0","0","0","0","0","0","0","0","0","0","0","2","2","0","0","0","0","0","0","0","0","0","0","-2"
"484905","University of North Texas at Dallas","2017","Not on tenure/no tenure system, instructors","10","3","7","1","1","0","0","0","0","2","0","2","1","0","1","0","0","0","5","2","3","1","0","1","0","0","0","0","0","0","-2"
"484905","University of North Texas at Dallas","2017","Not on tenure/no tenure system, lecturers","25","11","14","0","0","0","4","2","2","2","1","1","2","0","2","0","0","0","16","8","8","0","0","0","1","0","1","0","0","0","-2"
"484905","University of North Texas at Dallas","2017","Not on tenure/no tenure system, no academic rank","1","1","0","0","0","0","0","0","0","0","0","0","0","0","0","0","0","0","1","1","0","0","0","0","0","0","0","0","0","0","-2"
"485263","California College San Diego","2017","Not on tenure track/No tenure system system total","14","10","4","0","0","0","5","5","0","0","0","0","3","2","1","0","0","0","6","3","3","0","0","0","0","0","0","0","0","0","-2"
"485263","California College San Diego","2017","Not on tenure/no tenure system, no academic rank","14","10","4","0","0","0","5","5","0","0","0","0","3","2","1","0","0","0","6","3","3","0","0","0","0","0","0","0","0","0","-2"
"487296","University of Arizona-Sierra Vista","2017","Tenured total","5","3","2","0","0","0","1","0","1","0","0","0","1","1","0","0","0","0","3","2","1","0","0","0","0","0","0","0","0","0","-2"
"487296","University of Arizona-Sierra Vista","2017","Tenured, professors","1","0","1","0","0","0","1","0","1","0","0","0","0","0","0","0","0","0","0","0","0","0","0","0","0","0","0","0","0","0","-2"
"487296","University of Arizona-Sierra Vista","2017","Tenured, associate professors","4","3","1","0","0","0","0","0","0","0","0","0","1","1","0","0","0","0","3","2","1","0","0","0","0","0","0","0","0","0","-2"
"487296","University of Arizona-Sierra Vista","2017","On-Tenure track total","3","1","2","1","0","1","0","0","0","0","0","0","1","1","0","0","0","0","1","0","1","0","0","0","0","0","0","0","0","0","-2"
"487296","University of Arizona-Sierra Vista","2017","On-tenure track, assistant professors","3","1","2","1","0","1","0","0","0","0","0","0","1","1","0","0","0","0","1","0","1","0","0","0","0","0","0","0","0","0","-2"
"487296","University of Arizona-Sierra Vista","2017","Not on tenure track/No tenure system system total","16","8","8","1","0","1","0","0","0","0","0","0","2","1","1","0","0","0","12","6","6","0","0","0","1","1","0","0","0","0","-2"
"487296","University of Arizona-Sierra Vista","2017","Not on tenure/no tenure system, professors","1","1","0","0","0","0","0","0","0","0","0","0","0","0","0","0","0","0","1","1","0","0","0","0","0","0","0","0","0","0","-2"
"487296","University of Arizona-Sierra Vista","2017","Not on tenure/no tenure system, associate professors","1","1","0","0","0","0","0","0","0","0","0","0","0","0","0","0","0","0","1","1","0","0","0","0","0","0","0","0","0","0","-2"
"487296","University of Arizona-Sierra Vista","2017","Not on tenure/no tenure system, assistant professors","12","5","7","1","0","1","0","0","0","0","0","0","2","1","1","0","0","0","8","3","5","0","0","0","1","1","0","0","0","0","-2"
"487296","University of Arizona-Sierra Vista","2017","Not on tenure/no tenure system, instructors","2","1","1","0","0","0","0","0","0","0","0","0","0","0","0","0","0","0","2","1","1","0","0","0","0","0","0","0","0","0","-2"
