"unitid","institution name","year","S2019_IS.Instructional staff category","S2019_IS.Grand total","S2019_IS.Grand total men","S2019_IS.Grand total women","S2019_IS.American Indian or Alaska Native total","S2019_IS.American Indian or Alaska Native men","S2019_IS.American Indian or Alaska Native women","S2019_IS.Asian total","S2019_IS.Asian men","S2019_IS.Asian women","S2019_IS.Black or African American total","S2019_IS.Black or African American men","S2019_IS.Black or African American women","S2019_IS.Hispanic or Latino total","S2019_IS.Hispanic or Latino men","S2019_IS.Hispanic or Latino women","S2019_IS.Native Hawaiian or Other Pacific Islander total","S2019_IS.Native Hawaiian or Other Pacific Islander men","S2019_IS.Native Hawaiian or Other Pacific Islander women","S2019_IS.White total","S2019_IS.White men","S2019_IS.White women","S2019_IS.Two or more races total","S2019_IS.Two or more races men","S2019_IS.Two or more races women","S2019_IS.Race/ethnicity unknown total","S2019_IS.Race/ethnicity unknown men","S2019_IS.Race/ethnicity unknown women","S2019_IS.Nonresident alien total","S2019_IS.Nonresident alien men","S2019_IS.Nonresident alien women","IDX_HR"
"105367","Ottawa University-Phoenix","2019","Tenured total","1","0","1","0","0","0","0","0","0","0","0","0","0","0","0","0","0","0","1","0","1","0","0","0","0","0","0","0","0","0","-2"
"105367","Ottawa University-Phoenix","2019","Tenured, professors","1","0","1","0","0","0","0","0","0","0","0","0","0","0","0","0","0","0","1","0","1","0","0","0","0","0","0","0","0","0","-2"
"105367","Ottawa University-Phoenix","2019","Not on tenure track/No tenure system system total","3","1","2","0","0","0","0","0","0","0","0","0","0","0","0","0","0","0","3","1","2","0","0","0","0","0","0","0","0","0","-2"
"105367","Ottawa University-Phoenix","2019","Not on tenure/no tenure system, associate professors","1","0","1","0","0","0","0","0","0","0","0","0","0","0","0","0","0","0","1","0","1","0","0","0","0","0","0","0","0","0","-2"
"105367","Ottawa University-Phoenix","2019","Not on tenure/no tenure system, assistant professors","2","1","1","0","0","0","0","0","0","0","0","0","0","0","0","0","0","0","2","1","1","0","0","0","0","0","0","0","0","0","-2"
"109350","Antelope Valley College","2019","Tenured total","130","76","54","2","1","1","10","7","3","11","5","6","13","8","5","1","0","1","85","50","35","6","4","2","2","1","1","0","0","0","-2"
"109350","Antelope Valley College","2019","Tenured, professors","50","26","24","1","1","0","2","0","2","4","0","4","6","4","2","0","0","0","34","19","15","3","2","1","0","0","0","0","0","0","-2"
"109350","Antelope Valley College","2019","Tenured, associate professors","65","42","23","1","0","1","8","7","1","4","4","0","4","3","1","0","0","0","46","28","18","1","0","1","1","0","1","0","0","0","-2"
"109350","Antelope Valley College","2019","Tenured, instructors","12","6","6","0","0","0","0","0","0","3","1","2","1","0","1","1","0","1","5","3","2","1","1","0","1","1","0","0","0","0","-2"
"109350","Antelope Valley College","2019","Tenured, no academic rank","3","2","1","0","0","0","0","0","0","0","0","0","2","1","1","0","0","0","0","0","0","1","1","0","0","0","0","0","0","0","-2"
"109350","Antelope Valley College","2019","On-Tenure track total","32","17","15","0","0","0","3","0","3","1","0","1","2","1","1","2","0","2","19","14","5","4","2","2","1","0","1","0","0","0","-2"
"109350","Antelope Valley College","2019","On-tenure track, professors","1","0","1","0","0","0","0","0","0","0","0","0","0","0","0","1","0","1","0","0","0","0","0","0","0","0","0","0","0","0","-2"
"109350","Antelope Valley College","2019","On-tenure track, instructors","12","7","5","0","0","0","2","0","2","1","0","1","1","1","0","0","0","0","5","5","0","2","1","1","1","0","1","0","0","0","-2"
"109350","Antelope Valley College","2019","On-tenure track, no academic rank","19","10","9","0","0","0","1","0","1","0","0","0","1","0","1","1","0","1","14","9","5","2","1","1","0","0","0","0","0","0","-2"
"109785","Azusa Pacific University","2019","Not on tenure track/No tenure system system total","447","193","254","2","1","1","62","23","39","30","9","21","30","13","17","3","2","1","288","128","160","6","3","3","26","14","12","0","0","0","-2"
"109785","Azusa Pacific University","2019","Not on tenure/no tenure system, professors","135","78","57","1","1","0","17","10","7","10","5","5","7","3","4","1","0","1","89","52","37","0","0","0","10","7","3","0","0","0","-2"
"109785","Azusa Pacific University","2019","Not on tenure/no tenure system, associate professors","117","60","57","1","0","1","18","9","9","9","2","7","8","4","4","0","0","0","75","43","32","0","0","0","6","2","4","0","0","0","-2"
"109785","Azusa Pacific University","2019","Not on tenure/no tenure system, assistant professors","175","54","121","0","0","0","24","4","20","10","2","8","14","6","8","2","2","0","110","32","78","6","3","3","9","5","4","0","0","0","-2"
"109785","Azusa Pacific University","2019","Not on tenure/no tenure system, instructors","20","1","19","0","0","0","3","0","3","1","0","1","1","0","1","0","0","0","14","1","13","0","0","0","1","0","1","0","0","0","-2"
"109819","Bakersfield College","2019","Tenured total","178","95","83","2","1","1","7","2","5","12","8","4","22","12","10","1","1","0","120","66","54","2","1","1","7","3","4","5","1","4","-2"
"109819","Bakersfield College","2019","Tenured, instructors","178","95","83","2","1","1","7","2","5","12","8","4","22","12","10","1","1","0","120","66","54","2","1","1","7","3","4","5","1","4","-2"
"109819","Bakersfield College","2019","On-Tenure track total","153","79","74","2","2","0","4","3","1","6","4","2","40","16","24","0","0","0","96","53","43","1","0","1","0","0","0","4","1","3","-2"
"109819","Bakersfield College","2019","On-tenure track, instructors","153","79","74","2","2","0","4","3","1","6","4","2","40","16","24","0","0","0","96","53","43","1","0","1","0","0","0","4","1","3","-2"
"109819","Bakersfield College","2019","Not on tenure track/No tenure system system total","36","19","17","0","0","0","0","0","0","2","2","0","12","4","8","0","0","0","20","12","8","1","1","0","0","0","0","1","0","1","-2"
"109819","Bakersfield College","2019","Not on tenure/no tenure system, instructors","36","19","17","0","0","0","0","0","0","2","2","0","12","4","8","0","0","0","20","12","8","1","1","0","0","0","0","1","0","1","-2"
"110361","California Baptist University","2019","Tenured total","136","77","59","0","0","0","22","14","8","2","1","1","5","2","3","0","0","0","104","59","45","3","1","2","0","0","0","0","0","0","-2"
"110361","California Baptist University","2019","Tenured, professors","93","60","33","0","0","0","18","13","5","1","0","1","4","1","3","0","0","0","67","45","22","3","1","2","0","0","0","0","0","0","-2"
"110361","California Baptist University","2019","Tenured, associate professors","43","17","26","0","0","0","4","1","3","1","1","0","1","1","0","0","0","0","37","14","23","0","0","0","0","0","0","0","0","0","-2"
"110361","California Baptist University","2019","On-Tenure track total","192","100","92","2","0","2","29","14","15","22","9","13","23","9","14","1","0","1","106","66","40","2","1","1","7","1","6","0","0","0","-2"
"110361","California Baptist University","2019","On-tenure track, professors","19","16","3","0","0","0","2","2","0","2","1","1","1","1","0","0","0","0","14","12","2","0","0","0","0","0","0","0","0","0","-2"
"110361","California Baptist University","2019","On-tenure track, associate professors","52","30","22","1","0","1","12","7","5","3","1","2","5","2","3","0","0","0","30","19","11","0","0","0","1","1","0","0","0","0","-2"
"110361","California Baptist University","2019","On-tenure track, assistant professors","121","54","67","1","0","1","15","5","10","17","7","10","17","6","11","1","0","1","62","35","27","2","1","1","6","0","6","0","0","0","-2"
"110361","California Baptist University","2019","Not on tenure track/No tenure system system total","25","14","11","0","0","0","0","0","0","0","0","0","2","1","1","0","0","0","23","13","10","0","0","0","0","0","0","0","0","0","-2"
"110361","California Baptist University","2019","Not on tenure/no tenure system, instructors","10","5","5","0","0","0","0","0","0","0","0","0","1","1","0","0","0","0","9","4","5","0","0","0","0","0","0","0","0","0","-2"
"110361","California Baptist University","2019","Not on tenure/no tenure system, lecturers","15","9","6","0","0","0","0","0","0","0","0","0","1","0","1","0","0","0","14","9","5","0","0","0","0","0","0","0","0","0","-2"
"110413","California Lutheran University","2019","Tenured total","111","56","55","0","0","0","10","5","5","5","2","3","10","2","8","0","0","0","84","46","38","1","1","0","0","0","0","1","0","1","-2"
"110413","California Lutheran University","2019","Tenured, professors","57","30","27","0","0","0","5","2","3","4","2","2","3","1","2","0","0","0","45","25","20","0","0","0","0","0","0","0","0","0","-2"
"110413","California Lutheran University","2019","Tenured, associate professors","50","23","27","0","0","0","5","3","2","1","0","1","6","0","6","0","0","0","36","19","17","1","1","0","0","0","0","1","0","1","-2"
"110413","California Lutheran University","2019","Tenured, assistant professors","4","3","1","0","0","0","0","0","0","0","0","0","1","1","0","0","0","0","3","2","1","0","0","0","0","0","0","0","0","0","-2"
"110413","California Lutheran University","2019","On-Tenure track total","39","18","21","0","0","0","10","6","4","3","1","2","7","2","5","0","0","0","17","9","8","1","0","1","1","0","1","0","0","0","-2"
"110413","California Lutheran University","2019","On-tenure track, professors","1","1","0","0","0","0","0","0","0","0","0","0","1","1","0","0","0","0","0","0","0","0","0","0","0","0","0","0","0","0","-2"
"110413","California Lutheran University","2019","On-tenure track, associate professors","2","1","1","0","0","0","1","0","1","0","0","0","0","0","0","0","0","0","1","1","0","0","0","0","0","0","0","0","0","0","-2"
"110413","California Lutheran University","2019","On-tenure track, assistant professors","34","15","19","0","0","0","8","6","2","3","1","2","6","1","5","0","0","0","15","7","8","1","0","1","1","0","1","0","0","0","-2"
"110413","California Lutheran University","2019","On-tenure track, instructors","1","0","1","0","0","0","1","0","1","0","0","0","0","0","0","0","0","0","0","0","0","0","0","0","0","0","0","0","0","0","-2"
"110413","California Lutheran University","2019","On-tenure track, lecturers","1","1","0","0","0","0","0","0","0","0","0","0","0","0","0","0","0","0","1","1","0","0","0","0","0","0","0","0","0","0","-2"
"110413","California Lutheran University","2019","Not on tenure track/No tenure system system total","46","22","24","0","0","0","3","2","1","2","1","1","4","2","2","0","0","0","36","16","20","0","0","0","1","1","0","0","0","0","-2"
"110413","California Lutheran University","2019","Not on tenure/no tenure system, professors","5","3","2","0","0","0","0","0","0","0","0","0","0","0","0","0","0","0","5","3","2","0","0","0","0","0","0","0","0","0","-2"
"110413","California Lutheran University","2019","Not on tenure/no tenure system, assistant professors","11","7","4","0","0","0","0","0","0","1","1","0","2","2","0","0","0","0","7","3","4","0","0","0","1","1","0","0","0","0","-2"
"110413","California Lutheran University","2019","Not on tenure/no tenure system, instructors","1","1","0","0","0","0","0","0","0","0","0","0","0","0","0","0","0","0","1","1","0","0","0","0","0","0","0","0","0","0","-2"
"110413","California Lutheran University","2019","Not on tenure/no tenure system, lecturers","29","11","18","0","0","0","3","2","1","1","0","1","2","0","2","0","0","0","23","9","14","0","0","0","0","0","0","0","0","0","-2"
"110486","California State University-Bakersfield","2019","Tenured total","119","72","47","0","0","0","17","12","5","6","3","3","21","14","7","1","1","0","66","36","30","0","0","0","5","4","1","3","2","1","-2"
"110486","California State University-Bakersfield","2019","Tenured, professors","77","47","30","0","0","0","15","12","3","3","2","1","10","6","4","1","1","0","46","24","22","0","0","0","2","2","0","0","0","0","-2"
"110486","California State University-Bakersfield","2019","Tenured, associate professors","42","25","17","0","0","0","2","0","2","3","1","2","11","8","3","0","0","0","20","12","8","0","0","0","3","2","1","3","2","1","-2"
"110486","California State University-Bakersfield","2019","On-Tenure track total","102","58","44","1","1","0","25","15","10","5","2","3","10","4","6","0","0","0","46","26","20","0","0","0","1","1","0","14","9","5","-2"
"110486","California State University-Bakersfield","2019","On-tenure track, associate professors","2","0","2","0","0","0","1","0","1","0","0","0","0","0","0","0","0","0","1","0","1","0","0","0","0","0","0","0","0","0","-2"
"110486","California State University-Bakersfield","2019","On-tenure track, assistant professors","100","58","42","1","1","0","24","15","9","5","2","3","10","4","6","0","0","0","45","26","19","0","0","0","1","1","0","14","9","5","-2"
"110486","California State University-Bakersfield","2019","Not on tenure track/No tenure system system total","97","46","51","0","0","0","8","4","4","1","1","0","19","8","11","0","0","0","61","27","34","3","3","0","2","1","1","3","2","1","-2"
"110486","California State University-Bakersfield","2019","Not on tenure/no tenure system, lecturers","97","46","51","0","0","0","8","4","4","1","1","0","19","8","11","0","0","0","61","27","34","3","3","0","2","1","1","3","2","1","-2"
"110495","California State University-Stanislaus","2019","Tenured total","183","110","73","1","0","1","33","16","17","9","6","3","18","10","8","0","0","0","112","72","40","1","1","0","6","3","3","3","2","1","-2"
"110495","California State University-Stanislaus","2019","Tenured, professors","134","79","55","1","0","1","19","6","13","5","4","1","13","9","4","0","0","0","91","57","34","0","0","0","5","3","2","0","0","0","-2"
"110495","California State University-Stanislaus","2019","Tenured, associate professors","49","31","18","0","0","0","14","10","4","4","2","2","5","1","4","0","0","0","21","15","6","1","1","0","1","0","1","3","2","1","-2"
"110495","California State University-Stanislaus","2019","On-Tenure track total","87","39","48","1","0","1","9","6","3","5","2","3","8","4","4","0","0","0","51","20","31","0","0","0","6","2","4","7","5","2","-2"
"110495","California State University-Stanislaus","2019","On-tenure track, associate professors","4","2","2","0","0","0","1","1","0","1","1","0","0","0","0","0","0","0","2","0","2","0","0","0","0","0","0","0","0","0","-2"
"110495","California State University-Stanislaus","2019","On-tenure track, assistant professors","83","37","46","1","0","1","8","5","3","4","1","3","8","4","4","0","0","0","49","20","29","0","0","0","6","2","4","7","5","2","-2"
"110495","California State University-Stanislaus","2019","Not on tenure track/No tenure system system total","85","41","44","0","0","0","7","3","4","2","0","2","11","3","8","1","0","1","59","32","27","1","0","1","4","3","1","0","0","0","-2"
"110495","California State University-Stanislaus","2019","Not on tenure/no tenure system, lecturers","85","41","44","0","0","0","7","3","4","2","0","2","11","3","8","1","0","1","59","32","27","1","0","1","4","3","1","0","0","0","-2"
"110510","California State University-San Bernardino","2019","Tenured total","255","144","111","1","1","0","47","25","22","11","4","7","23","9","14","0","0","0","153","94","59","1","1","0","15","9","6","4","1","3","-2"
"110510","California State University-San Bernardino","2019","Tenured, professors","191","112","79","1","1","0","37","20","17","9","4","5","14","7","7","0","0","0","119","74","45","1","1","0","10","5","5","0","0","0","-2"
"110510","California State University-San Bernardino","2019","Tenured, associate professors","60","29","31","0","0","0","9","4","5","2","0","2","9","2","7","0","0","0","31","18","13","0","0","0","5","4","1","4","1","3","-2"
"110510","California State University-San Bernardino","2019","Tenured, assistant professors","4","3","1","0","0","0","1","1","0","0","0","0","0","0","0","0","0","0","3","2","1","0","0","0","0","0","0","0","0","0","-2"
"110510","California State University-San Bernardino","2019","On-Tenure track total","129","58","71","2","0","2","21","8","13","8","3","5","23","13","10","0","0","0","59","27","32","1","0","1","8","2","6","7","5","2","-2"
"110510","California State University-San Bernardino","2019","On-tenure track, professors","1","0","1","0","0","0","0","0","0","0","0","0","0","0","0","0","0","0","1","0","1","0","0","0","0","0","0","0","0","0","-2"
"110510","California State University-San Bernardino","2019","On-tenure track, associate professors","7","2","5","0","0","0","1","0","1","2","0","2","0","0","0","0","0","0","4","2","2","0","0","0","0","0","0","0","0","0","-2"
"110510","California State University-San Bernardino","2019","On-tenure track, assistant professors","121","56","65","2","0","2","20","8","12","6","3","3","23","13","10","0","0","0","54","25","29","1","0","1","8","2","6","7","5","2","-2"
"110510","California State University-San Bernardino","2019","Not on tenure track/No tenure system system total","120","47","73","0","0","0","17","6","11","9","4","5","12","5","7","0","0","0","69","28","41","3","0","3","8","3","5","2","1","1","-2"
"110510","California State University-San Bernardino","2019","Not on tenure/no tenure system, lecturers","120","47","73","0","0","0","17","6","11","9","4","5","12","5","7","0","0","0","69","28","41","3","0","3","8","3","5","2","1","1","-2"
"110529","California State Polytechnic University-Pomona","2019","Tenured total","340","204","136","1","0","1","110","64","46","9","6","3","30","17","13","1","1","0","172","107","65","0","0","0","15","9","6","2","0","2","-2"
"110529","California State Polytechnic University-Pomona","2019","Tenured, professors","252","155","97","1","0","1","80","49","31","7","5","2","24","14","10","1","1","0","131","81","50","0","0","0","8","5","3","0","0","0","-2"
"110529","California State Polytechnic University-Pomona","2019","Tenured, associate professors","88","49","39","0","0","0","30","15","15","2","1","1","6","3","3","0","0","0","41","26","15","0","0","0","7","4","3","2","0","2","-2"
"110529","California State Polytechnic University-Pomona","2019","On-Tenure track total","186","105","81","1","1","0","26","12","14","4","2","2","19","12","7","0","0","0","90","48","42","2","2","0","11","4","7","33","24","9","-2"
"110529","California State Polytechnic University-Pomona","2019","On-tenure track, associate professors","9","4","5","0","0","0","4","2","2","0","0","0","0","0","0","0","0","0","3","1","2","0","0","0","2","1","1","0","0","0","-2"
"110529","California State Polytechnic University-Pomona","2019","On-tenure track, assistant professors","177","101","76","1","1","0","22","10","12","4","2","2","19","12","7","0","0","0","87","47","40","2","2","0","9","3","6","33","24","9","-2"
"110529","California State Polytechnic University-Pomona","2019","Not on tenure track/No tenure system system total","114","61","53","1","1","0","20","9","11","3","0","3","14","10","4","1","1","0","72","38","34","0","0","0","2","2","0","1","0","1","-2"
"110529","California State Polytechnic University-Pomona","2019","Not on tenure/no tenure system, lecturers","114","61","53","1","1","0","20","9","11","3","0","3","14","10","4","1","1","0","72","38","34","0","0","0","2","2","0","1","0","1","-2"
"110547","California State University-Dominguez Hills","2019","Tenured total","155","78","77","1","1","0","34","17","17","13","6","7","16","10","6","0","0","0","77","37","40","5","3","2","9","4","5","0","0","0","-2"
"110547","California State University-Dominguez Hills","2019","Tenured, professors","101","58","43","0","0","0","22","13","9","9","4","5","9","5","4","0","0","0","54","31","23","2","2","0","5","3","2","0","0","0","-2"
"110547","California State University-Dominguez Hills","2019","Tenured, associate professors","54","20","34","1","1","0","12","4","8","4","2","2","7","5","2","0","0","0","23","6","17","3","1","2","4","1","3","0","0","0","-2"
"110547","California State University-Dominguez Hills","2019","On-Tenure track total","120","50","70","1","0","1","21","6","15","11","6","5","17","6","11","0","0","0","41","15","26","4","2","2","7","4","3","18","11","7","-2"
"110547","California State University-Dominguez Hills","2019","On-tenure track, professors","2","2","0","0","0","0","0","0","0","0","0","0","0","0","0","0","0","0","2","2","0","0","0","0","0","0","0","0","0","0","-2"
"110547","California State University-Dominguez Hills","2019","On-tenure track, associate professors","8","4","4","0","0","0","4","1","3","2","2","0","0","0","0","0","0","0","1","0","1","0","0","0","1","1","0","0","0","0","-2"
"110547","California State University-Dominguez Hills","2019","On-tenure track, assistant professors","110","44","66","1","0","1","17","5","12","9","4","5","17","6","11","0","0","0","38","13","25","4","2","2","6","3","3","18","11","7","-2"
"110547","California State University-Dominguez Hills","2019","Not on tenure track/No tenure system system total","128","59","69","2","1","1","9","3","6","19","6","13","25","12","13","0","0","0","59","31","28","2","1","1","11","5","6","1","0","1","-2"
"110547","California State University-Dominguez Hills","2019","Not on tenure/no tenure system, lecturers","128","59","69","2","1","1","9","3","6","19","6","13","25","12","13","0","0","0","59","31","28","2","1","1","11","5","6","1","0","1","-2"
"110556","California State University-Fresno","2019","Tenured total","349","212","137","0","0","0","63","46","17","12","6","6","35","20","15","0","0","0","221","130","91","5","4","1","6","2","4","7","4","3","-2"
"110556","California State University-Fresno","2019","Tenured, professors","227","153","74","0","0","0","37","29","8","6","3","3","21","15","6","0","0","0","153","100","53","3","2","1","4","2","2","3","2","1","-2"
"110556","California State University-Fresno","2019","Tenured, associate professors","119","56","63","0","0","0","26","17","9","6","3","3","14","5","9","0","0","0","66","28","38","1","1","0","2","0","2","4","2","2","-2"
"110556","California State University-Fresno","2019","Tenured, no academic rank","3","3","0","0","0","0","0","0","0","0","0","0","0","0","0","0","0","0","2","2","0","1","1","0","0","0","0","0","0","0","-2"
"110556","California State University-Fresno","2019","On-Tenure track total","239","120","119","3","1","2","35","19","16","12","6","6","43","23","20","0","0","0","111","51","60","3","2","1","6","5","1","26","13","13","-2"
"110556","California State University-Fresno","2019","On-tenure track, professors","1","1","0","0","0","0","1","1","0","0","0","0","0","0","0","0","0","0","0","0","0","0","0","0","0","0","0","0","0","0","-2"
"110556","California State University-Fresno","2019","On-tenure track, associate professors","9","5","4","0","0","0","5","2","3","0","0","0","3","2","1","0","0","0","1","1","0","0","0","0","0","0","0","0","0","0","-2"
"110556","California State University-Fresno","2019","On-tenure track, assistant professors","227","113","114","3","1","2","29","16","13","12","6","6","39","21","18","0","0","0","109","49","60","3","2","1","6","5","1","26","13","13","-2"
"110556","California State University-Fresno","2019","On-tenure track, no academic rank","2","1","1","0","0","0","0","0","0","0","0","0","1","0","1","0","0","0","1","1","0","0","0","0","0","0","0","0","0","0","-2"
"110556","California State University-Fresno","2019","Not on tenure track/No tenure system system total","199","80","119","3","0","3","19","9","10","3","0","3","29","10","19","1","1","0","125","50","75","3","1","2","9","4","5","7","5","2","-2"
"110556","California State University-Fresno","2019","Not on tenure/no tenure system, lecturers","199","80","119","3","0","3","19","9","10","3","0","3","29","10","19","1","1","0","125","50","75","3","1","2","9","4","5","7","5","2","-2"
"110565","California State University-Fullerton","2019","Tenured total","552","295","257","1","1","0","127","66","61","16","8","8","51","27","24","1","1","0","349","188","161","0","0","0","1","1","0","6","3","3","-2"
"110565","California State University-Fullerton","2019","Tenured, professors","348","200","148","1","1","0","75","43","32","5","2","3","26","15","11","1","1","0","239","138","101","0","0","0","0","0","0","1","0","1","-2"
"110565","California State University-Fullerton","2019","Tenured, associate professors","204","95","109","0","0","0","52","23","29","11","6","5","25","12","13","0","0","0","110","50","60","0","0","0","1","1","0","5","3","2","-2"
"110565","California State University-Fullerton","2019","On-Tenure track total","238","113","125","2","1","1","50","22","28","16","4","12","29","12","17","0","0","0","103","55","48","2","0","2","6","2","4","30","17","13","-2"
"110565","California State University-Fullerton","2019","On-tenure track, associate professors","16","10","6","0","0","0","4","2","2","0","0","0","2","1","1","0","0","0","9","6","3","0","0","0","1","1","0","0","0","0","-2"
"110565","California State University-Fullerton","2019","On-tenure track, assistant professors","222","103","119","2","1","1","46","20","26","16","4","12","27","11","16","0","0","0","94","49","45","2","0","2","5","1","4","30","17","13","-2"
"110565","California State University-Fullerton","2019","Not on tenure track/No tenure system system total","217","90","127","0","0","0","35","15","20","4","1","3","22","7","15","0","0","0","135","59","76","2","1","1","17","7","10","2","0","2","-2"
"110565","California State University-Fullerton","2019","Not on tenure/no tenure system, lecturers","217","90","127","0","0","0","35","15","20","4","1","3","22","7","15","0","0","0","135","59","76","2","1","1","17","7","10","2","0","2","-2"
"110574","California State University-East Bay","2019","Tenured total","193","98","95","0","0","0","44","20","24","10","4","6","18","9","9","1","0","1","110","59","51","2","1","1","7","4","3","1","1","0","-2"
"110574","California State University-East Bay","2019","Tenured, professors","123","67","56","0","0","0","29","12","17","6","4","2","10","4","6","1","0","1","71","43","28","2","1","1","3","2","1","1","1","0","-2"
"110574","California State University-East Bay","2019","Tenured, associate professors","67","30","37","0","0","0","14","8","6","4","0","4","8","5","3","0","0","0","37","15","22","0","0","0","4","2","2","0","0","0","-2"
"110574","California State University-East Bay","2019","Tenured, assistant professors","3","1","2","0","0","0","1","0","1","0","0","0","0","0","0","0","0","0","2","1","1","0","0","0","0","0","0","0","0","0","-2"
"110574","California State University-East Bay","2019","On-Tenure track total","133","68","65","0","0","0","27","16","11","7","2","5","10","7","3","0","0","0","58","24","34","1","1","0","14","7","7","16","11","5","-2"
"110574","California State University-East Bay","2019","On-tenure track, professors","3","1","2","0","0","0","1","0","1","1","0","1","0","0","0","0","0","0","1","1","0","0","0","0","0","0","0","0","0","0","-2"
"110574","California State University-East Bay","2019","On-tenure track, associate professors","7","7","0","0","0","0","3","3","0","0","0","0","0","0","0","0","0","0","2","2","0","0","0","0","1","1","0","1","1","0","-2"
"110574","California State University-East Bay","2019","On-tenure track, assistant professors","123","60","63","0","0","0","23","13","10","6","2","4","10","7","3","0","0","0","55","21","34","1","1","0","13","6","7","15","10","5","-2"
"110574","California State University-East Bay","2019","Not on tenure track/No tenure system system total","57","21","36","0","0","0","4","0","4","8","2","6","3","1","2","2","0","2","37","17","20","0","0","0","3","1","2","0","0","0","-2"
"110574","California State University-East Bay","2019","Not on tenure/no tenure system, lecturers","57","21","36","0","0","0","4","0","4","8","2","6","3","1","2","2","0","2","37","17","20","0","0","0","3","1","2","0","0","0","-2"
"110583","California State University-Long Beach","2019","Tenured total","557","296","261","3","1","2","127","57","70","19","11","8","53","28","25","0","0","0","329","182","147","4","1","3","20","15","5","2","1","1","-2"
"110583","California State University-Long Beach","2019","Tenured, professors","381","212","169","1","1","0","86","41","45","10","7","3","31","18","13","0","0","0","238","135","103","3","1","2","10","8","2","2","1","1","-2"
"110583","California State University-Long Beach","2019","Tenured, associate professors","172","84","88","2","0","2","41","16","25","9","4","5","21","10","11","0","0","0","88","47","41","1","0","1","10","7","3","0","0","0","-2"
"110583","California State University-Long Beach","2019","Tenured, assistant professors","2","0","2","0","0","0","0","0","0","0","0","0","0","0","0","0","0","0","2","0","2","0","0","0","0","0","0","0","0","0","-2"
"110583","California State University-Long Beach","2019","Tenured, no academic rank","2","0","2","0","0","0","0","0","0","0","0","0","1","0","1","0","0","0","1","0","1","0","0","0","0","0","0","0","0","0","-2"
"110583","California State University-Long Beach","2019","On-Tenure track total","230","96","134","1","0","1","49","17","32","10","4","6","22","7","15","0","0","0","110","49","61","5","1","4","10","5","5","23","13","10","-2"
"110583","California State University-Long Beach","2019","On-tenure track, associate professors","5","2","3","0","0","0","2","1","1","1","0","1","1","0","1","0","0","0","1","1","0","0","0","0","0","0","0","0","0","0","-2"
"110583","California State University-Long Beach","2019","On-tenure track, assistant professors","225","94","131","1","0","1","47","16","31","9","4","5","21","7","14","0","0","0","109","48","61","5","1","4","10","5","5","23","13","10","-2"
"110583","California State University-Long Beach","2019","Not on tenure track/No tenure system system total","290","128","162","2","0","2","32","17","15","14","6","8","41","13","28","0","0","0","183","83","100","9","3","6","8","5","3","1","1","0","-2"
"110583","California State University-Long Beach","2019","Not on tenure/no tenure system, lecturers","290","128","162","2","0","2","32","17","15","14","6","8","41","13","28","0","0","0","183","83","100","9","3","6","8","5","3","1","1","0","-2"
"110592","California State University-Los Angeles","2019","Tenured total","339","179","160","1","0","1","88","48","40","15","9","6","50","30","20","1","1","0","167","83","84","1","0","1","15","7","8","1","1","0","-2"
"110592","California State University-Los Angeles","2019","Tenured, professors","256","144","112","0","0","0","69","39","30","11","7","4","35","20","15","1","1","0","128","70","58","1","0","1","10","6","4","1","1","0","-2"
"110592","California State University-Los Angeles","2019","Tenured, associate professors","83","35","48","1","0","1","19","9","10","4","2","2","15","10","5","0","0","0","39","13","26","0","0","0","5","1","4","0","0","0","-2"
"110592","California State University-Los Angeles","2019","On-Tenure track total","176","76","100","1","0","1","38","15","23","17","10","7","33","13","20","0","0","0","46","22","24","6","0","6","7","5","2","28","11","17","-2"
"110592","California State University-Los Angeles","2019","On-tenure track, associate professors","1","1","0","0","0","0","1","1","0","0","0","0","0","0","0","0","0","0","0","0","0","0","0","0","0","0","0","0","0","0","-2"
"110592","California State University-Los Angeles","2019","On-tenure track, assistant professors","175","75","100","1","0","1","37","14","23","17","10","7","33","13","20","0","0","0","46","22","24","6","0","6","7","5","2","28","11","17","-2"
"110592","California State University-Los Angeles","2019","Not on tenure track/No tenure system system total","166","71","95","0","0","0","33","14","19","11","7","4","36","12","24","0","0","0","77","35","42","4","2","2","5","1","4","0","0","0","-2"
"110592","California State University-Los Angeles","2019","Not on tenure/no tenure system, lecturers","166","71","95","0","0","0","33","14","19","11","7","4","36","12","24","0","0","0","77","35","42","4","2","2","5","1","4","0","0","0","-2"
"110608","California State University-Northridge","2019","Tenured total","549","282","267","3","1","2","103","55","48","28","9","19","59","30","29","0","0","0","335","175","160","7","3","4","14","9","5","0","0","0","-2"
"110608","California State University-Northridge","2019","Tenured, professors","393","212","181","3","1","2","69","40","29","21","6","15","49","23","26","0","0","0","242","135","107","5","3","2","4","4","0","0","0","0","-2"
"110608","California State University-Northridge","2019","Tenured, associate professors","147","67","80","0","0","0","31","14","17","7","3","4","8","7","1","0","0","0","89","38","51","2","0","2","10","5","5","0","0","0","-2"
"110608","California State University-Northridge","2019","Tenured, assistant professors","1","0","1","0","0","0","1","0","1","0","0","0","0","0","0","0","0","0","0","0","0","0","0","0","0","0","0","0","0","0","-2"
"110608","California State University-Northridge","2019","Tenured, no academic rank","8","3","5","0","0","0","2","1","1","0","0","0","2","0","2","0","0","0","4","2","2","0","0","0","0","0","0","0","0","0","-2"
"110608","California State University-Northridge","2019","On-Tenure track total","205","101","104","2","0","2","37","13","24","12","5","7","20","10","10","0","0","0","95","52","43","7","4","3","11","6","5","21","11","10","-2"
"110608","California State University-Northridge","2019","On-tenure track, professors","1","0","1","0","0","0","0","0","0","0","0","0","1","0","1","0","0","0","0","0","0","0","0","0","0","0","0","0","0","0","-2"
"110608","California State University-Northridge","2019","On-tenure track, associate professors","19","7","12","0","0","0","7","2","5","1","0","1","1","1","0","0","0","0","8","3","5","0","0","0","1","0","1","1","1","0","-2"
"110608","California State University-Northridge","2019","On-tenure track, assistant professors","183","93","90","2","0","2","30","11","19","11","5","6","18","9","9","0","0","0","85","48","37","7","4","3","10","6","4","20","10","10","-2"
"110608","California State University-Northridge","2019","On-tenure track, no academic rank","2","1","1","0","0","0","0","0","0","0","0","0","0","0","0","0","0","0","2","1","1","0","0","0","0","0","0","0","0","0","-2"
"110608","California State University-Northridge","2019","Not on tenure track/No tenure system system total","148","66","82","2","0","2","10","5","5","8","4","4","22","11","11","0","0","0","96","42","54","1","0","1","9","4","5","0","0","0","-2"
"110608","California State University-Northridge","2019","Not on tenure/no tenure system, lecturers","148","66","82","2","0","2","10","5","5","8","4","4","22","11","11","0","0","0","96","42","54","1","0","1","9","4","5","0","0","0","-2"
"110617","California State University-Sacramento","2019","Tenured total","429","233","196","4","2","2","72","45","27","18","8","10","37","19","18","0","0","0","270","142","128","3","2","1","11","7","4","14","8","6","-2"
"110617","California State University-Sacramento","2019","Tenured, professors","325","177","148","3","1","2","55","32","23","11","4","7","32","16","16","0","0","0","207","114","93","2","1","1","6","4","2","9","5","4","-2"
"110617","California State University-Sacramento","2019","Tenured, associate professors","97","51","46","1","1","0","15","11","4","6","3","3","5","3","2","0","0","0","59","26","33","1","1","0","5","3","2","5","3","2","-2"
"110617","California State University-Sacramento","2019","Tenured, assistant professors","2","1","1","0","0","0","1","1","0","0","0","0","0","0","0","0","0","0","1","0","1","0","0","0","0","0","0","0","0","0","-2"
"110617","California State University-Sacramento","2019","Tenured, no academic rank","5","4","1","0","0","0","1","1","0","1","1","0","0","0","0","0","0","0","3","2","1","0","0","0","0","0","0","0","0","0","-2"
"110617","California State University-Sacramento","2019","On-Tenure track total","251","109","142","3","2","1","30","13","17","15","3","12","15","5","10","0","0","0","121","58","63","4","1","3","58","24","34","5","3","2","-2"
"110617","California State University-Sacramento","2019","On-tenure track, professors","7","4","3","0","0","0","2","1","1","1","0","1","1","0","1","0","0","0","3","3","0","0","0","0","0","0","0","0","0","0","-2"
"110617","California State University-Sacramento","2019","On-tenure track, associate professors","2","2","0","0","0","0","0","0","0","0","0","0","0","0","0","0","0","0","1","1","0","0","0","0","1","1","0","0","0","0","-2"
"110617","California State University-Sacramento","2019","On-tenure track, assistant professors","241","103","138","3","2","1","28","12","16","14","3","11","14","5","9","0","0","0","116","54","62","4","1","3","57","23","34","5","3","2","-2"
"110617","California State University-Sacramento","2019","On-tenure track, no academic rank","1","0","1","0","0","0","0","0","0","0","0","0","0","0","0","0","0","0","1","0","1","0","0","0","0","0","0","0","0","0","-2"
"110617","California State University-Sacramento","2019","Not on tenure track/No tenure system system total","150","59","91","1","0","1","10","6","4","4","1","3","4","0","4","0","0","0","122","48","74","2","1","1","6","2","4","1","1","0","-2"
"110617","California State University-Sacramento","2019","Not on tenure/no tenure system, lecturers","150","59","91","1","0","1","10","6","4","4","1","3","4","0","4","0","0","0","122","48","74","2","1","1","6","2","4","1","1","0","-2"
"110671","University of California-Riverside","2019","Tenured total","586","404","182","5","3","2","75","51","24","14","9","5","27","19","8","0","0","0","292","202","90","0","0","0","14","8","6","159","112","47","-2"
"110671","University of California-Riverside","2019","Tenured, professors","363","272","91","1","1","0","47","36","11","7","5","2","10","8","2","0","0","0","198","146","52","0","0","0","12","8","4","88","68","20","-2"
"110671","University of California-Riverside","2019","Tenured, associate professors","213","124","89","3","1","2","28","15","13","7","4","3","16","10","6","0","0","0","87","51","36","0","0","0","2","0","2","70","43","27","-2"
"110671","University of California-Riverside","2019","Tenured, lecturers","10","8","2","1","1","0","0","0","0","0","0","0","1","1","0","0","0","0","7","5","2","0","0","0","0","0","0","1","1","0","-2"
"110671","University of California-Riverside","2019","On-Tenure track total","266","155","111","3","2","1","27","12","15","11","4","7","18","10","8","0","0","0","77","43","34","0","0","0","19","12","7","111","72","39","-2"
"110671","University of California-Riverside","2019","On-tenure track, assistant professors","248","147","101","3","2","1","25","11","14","10","3","7","17","10","7","0","0","0","67","39","28","0","0","0","17","10","7","109","72","37","-2"
"110671","University of California-Riverside","2019","On-tenure track, lecturers","18","8","10","0","0","0","2","1","1","1","1","0","1","0","1","0","0","0","10","4","6","0","0","0","2","2","0","2","0","2","-2"
"110671","University of California-Riverside","2019","Not on tenure track/No tenure system system total","209","107","102","0","0","0","21","12","9","9","3","6","16","8","8","0","0","0","114","64","50","0","0","0","18","9","9","31","11","20","-2"
"110671","University of California-Riverside","2019","Not on tenure/no tenure system, professors","12","9","3","0","0","0","3","3","0","1","0","1","0","0","0","0","0","0","8","6","2","0","0","0","0","0","0","0","0","0","-2"
"110671","University of California-Riverside","2019","Not on tenure/no tenure system, associate professors","14","8","6","0","0","0","3","2","1","1","1","0","0","0","0","0","0","0","5","3","2","0","0","0","4","2","2","1","0","1","-2"
"110671","University of California-Riverside","2019","Not on tenure/no tenure system, assistant professors","59","33","26","0","0","0","7","5","2","5","2","3","3","3","0","0","0","0","28","15","13","0","0","0","5","3","2","11","5","6","-2"
"110671","University of California-Riverside","2019","Not on tenure/no tenure system, instructors","3","1","2","0","0","0","1","0","1","0","0","0","0","0","0","0","0","0","0","0","0","0","0","0","0","0","0","2","1","1","-2"
"110671","University of California-Riverside","2019","Not on tenure/no tenure system, lecturers","114","54","60","0","0","0","7","2","5","1","0","1","11","4","7","0","0","0","70","39","31","0","0","0","8","4","4","17","5","12","-2"
"110671","University of California-Riverside","2019","Not on tenure/no tenure system, no academic rank","7","2","5","0","0","0","0","0","0","1","0","1","2","1","1","0","0","0","3","1","2","0","0","0","1","0","1","0","0","0","-2"
"110705","University of California-Santa Barbara","2019","Tenured total","687","442","245","6","1","5","68","43","25","18","10","8","52","31","21","0","0","0","486","318","168","0","0","0","30","21","9","27","18","9","-2"
"110705","University of California-Santa Barbara","2019","Tenured, professors","505","344","161","1","0","1","54","35","19","8","5","3","36","23","13","0","0","0","369","256","113","0","0","0","16","10","6","21","15","6","-2"
"110705","University of California-Santa Barbara","2019","Tenured, associate professors","154","82","72","5","1","4","14","8","6","9","4","5","13","7","6","0","0","0","94","48","46","0","0","0","14","11","3","5","3","2","-2"
"110705","University of California-Santa Barbara","2019","Tenured, lecturers","28","16","12","0","0","0","0","0","0","1","1","0","3","1","2","0","0","0","23","14","9","0","0","0","0","0","0","1","0","1","-2"
"110705","University of California-Santa Barbara","2019","On-Tenure track total","207","114","93","0","0","0","21","12","9","4","2","2","16","4","12","0","0","0","83","43","40","0","0","0","29","14","15","54","39","15","-2"
"110705","University of California-Santa Barbara","2019","On-tenure track, professors","1","1","0","0","0","0","0","0","0","0","0","0","0","0","0","0","0","0","0","0","0","0","0","0","0","0","0","1","1","0","-2"
"110705","University of California-Santa Barbara","2019","On-tenure track, assistant professors","188","105","83","0","0","0","19","11","8","4","2","2","15","4","11","0","0","0","74","39","35","0","0","0","25","12","13","51","37","14","-2"
"110705","University of California-Santa Barbara","2019","On-tenure track, lecturers","18","8","10","0","0","0","2","1","1","0","0","0","1","0","1","0","0","0","9","4","5","0","0","0","4","2","2","2","1","1","-2"
"110705","University of California-Santa Barbara","2019","Not on tenure track/No tenure system system total","184","78","106","1","1","0","9","1","8","5","2","3","2","0","2","1","0","1","112","44","68","0","0","0","26","15","11","28","15","13","-2"
"110705","University of California-Santa Barbara","2019","Not on tenure/no tenure system, assistant professors","18","12","6","0","0","0","0","0","0","1","0","1","0","0","0","0","0","0","1","0","1","0","0","0","4","4","0","12","8","4","-2"
"110705","University of California-Santa Barbara","2019","Not on tenure/no tenure system, lecturers","166","66","100","1","1","0","9","1","8","4","2","2","2","0","2","1","0","1","111","44","67","0","0","0","22","11","11","16","7","9","-2"
"110714","University of California-Santa Cruz","2019","Tenured total","429","262","167","8","1","7","69","42","27","8","6","2","42","22","20","0","0","0","293","186","107","0","0","0","8","5","3","1","0","1","-2"
"110714","University of California-Santa Cruz","2019","Tenured, professors","295","194","101","5","1","4","44","29","15","3","3","0","21","13","8","0","0","0","216","144","72","0","0","0","6","4","2","0","0","0","-2"
"110714","University of California-Santa Cruz","2019","Tenured, associate professors","122","63","59","3","0","3","24","12","12","5","3","2","19","9","10","0","0","0","69","39","30","0","0","0","1","0","1","1","0","1","-2"
"110714","University of California-Santa Cruz","2019","Tenured, lecturers","12","5","7","0","0","0","1","1","0","0","0","0","2","0","2","0","0","0","8","3","5","0","0","0","1","1","0","0","0","0","-2"
"110714","University of California-Santa Cruz","2019","On-Tenure track total","150","80","70","1","1","0","18","9","9","7","2","5","17","8","9","0","0","0","61","38","23","0","0","0","10","4","6","36","18","18","-2"
"110714","University of California-Santa Cruz","2019","On-tenure track, professors","3","3","0","0","0","0","0","0","0","0","0","0","0","0","0","0","0","0","0","0","0","0","0","0","0","0","0","3","3","0","-2"
"110714","University of California-Santa Cruz","2019","On-tenure track, associate professors","2","1","1","0","0","0","0","0","0","0","0","0","0","0","0","0","0","0","2","1","1","0","0","0","0","0","0","0","0","0","-2"
"110714","University of California-Santa Cruz","2019","On-tenure track, assistant professors","137","73","64","1","1","0","18","9","9","6","1","5","16","8","8","0","0","0","57","36","21","0","0","0","9","4","5","30","14","16","-2"
"110714","University of California-Santa Cruz","2019","On-tenure track, lecturers","8","3","5","0","0","0","0","0","0","1","1","0","1","0","1","0","0","0","2","1","1","0","0","0","1","0","1","3","1","2","-2"
"110714","University of California-Santa Cruz","2019","Not on tenure track/No tenure system system total","100","42","58","1","0","1","9","4","5","1","0","1","12","3","9","0","0","0","64","28","36","0","0","0","6","3","3","7","4","3","-2"
"110714","University of California-Santa Cruz","2019","Not on tenure/no tenure system, professors","1","1","0","0","0","0","0","0","0","0","0","0","0","0","0","0","0","0","1","1","0","0","0","0","0","0","0","0","0","0","-2"
"110714","University of California-Santa Cruz","2019","Not on tenure/no tenure system, assistant professors","9","4","5","0","0","0","1","1","0","0","0","0","2","1","1","0","0","0","3","1","2","0","0","0","0","0","0","3","1","2","-2"
"110714","University of California-Santa Cruz","2019","Not on tenure/no tenure system, lecturers","85","35","50","1","0","1","8","3","5","1","0","1","9","2","7","0","0","0","56","24","32","0","0","0","6","3","3","4","3","1","-2"
"110714","University of California-Santa Cruz","2019","Not on tenure/no tenure system, no academic rank","5","2","3","0","0","0","0","0","0","0","0","0","1","0","1","0","0","0","4","2","2","0","0","0","0","0","0","0","0","0","-2"
"111966","Charles R Drew University of Medicine and Science","2019","Not on tenure track/No tenure system system total","55","20","35","0","0","0","6","3","3","20","5","15","7","4","3","0","0","0","19","8","11","2","0","2","1","0","1","0","0","0","-2"
"111966","Charles R Drew University of Medicine and Science","2019","Not on tenure/no tenure system, professors","5","3","2","0","0","0","0","0","0","1","0","1","0","0","0","0","0","0","4","3","1","0","0","0","0","0","0","0","0","0","-2"
"111966","Charles R Drew University of Medicine and Science","2019","Not on tenure/no tenure system, associate professors","12","6","6","0","0","0","1","0","1","2","1","1","3","2","1","0","0","0","6","3","3","0","0","0","0","0","0","0","0","0","-2"
"111966","Charles R Drew University of Medicine and Science","2019","Not on tenure/no tenure system, assistant professors","26","7","19","0","0","0","4","2","2","11","2","9","2","2","0","0","0","0","6","1","5","2","0","2","1","0","1","0","0","0","-2"
"111966","Charles R Drew University of Medicine and Science","2019","Not on tenure/no tenure system, instructors","12","4","8","0","0","0","1","1","0","6","2","4","2","0","2","0","0","0","3","1","2","0","0","0","0","0","0","0","0","0","-2"
"112075","Concordia University-Irvine","2019","Not on tenure track/No tenure system system total","109","54","55","1","1","0","7","5","2","3","0","3","6","2","4","0","0","0","91","46","45","0","0","0","1","0","1","0","0","0","-2"
"112075","Concordia University-Irvine","2019","Not on tenure/no tenure system, professors","35","23","12","0","0","0","1","1","0","0","0","0","2","2","0","0","0","0","32","20","12","0","0","0","0","0","0","0","0","0","-2"
"112075","Concordia University-Irvine","2019","Not on tenure/no tenure system, associate professors","25","11","14","0","0","0","1","1","0","1","0","1","2","0","2","0","0","0","21","10","11","0","0","0","0","0","0","0","0","0","-2"
"112075","Concordia University-Irvine","2019","Not on tenure/no tenure system, assistant professors","49","20","29","1","1","0","5","3","2","2","0","2","2","0","2","0","0","0","38","16","22","0","0","0","1","0","1","0","0","0","-2"
"112084","San Diego Christian College","2019","Not on tenure track/No tenure system system total","10","7","3","0","0","0","0","0","0","1","0","1","0","0","0","0","0","0","9","7","2","0","0","0","0","0","0","0","0","0","-2"
"112084","San Diego Christian College","2019","Not on tenure/no tenure system, professors","2","2","0","0","0","0","0","0","0","0","0","0","0","0","0","0","0","0","2","2","0","0","0","0","0","0","0","0","0","0","-2"
"112084","San Diego Christian College","2019","Not on tenure/no tenure system, associate professors","2","1","1","0","0","0","0","0","0","0","0","0","0","0","0","0","0","0","2","1","1","0","0","0","0","0","0","0","0","0","-2"
"112084","San Diego Christian College","2019","Not on tenure/no tenure system, assistant professors","6","4","2","0","0","0","0","0","0","1","0","1","0","0","0","0","0","0","5","4","1","0","0","0","0","0","0","0","0","0","-2"
"113236","Cypress College","2019","Tenured total","154","66","88","0","0","0","20","5","15","8","2","6","23","10","13","1","0","1","80","39","41","6","1","5","16","9","7","0","0","0","-2"
"113236","Cypress College","2019","Tenured, instructors","154","66","88","0","0","0","20","5","15","8","2","6","23","10","13","1","0","1","80","39","41","6","1","5","16","9","7","0","0","0","-2"
"113236","Cypress College","2019","On-Tenure track total","64","24","40","0","0","0","12","2","10","3","3","0","13","6","7","0","0","0","30","11","19","3","1","2","3","1","2","0","0","0","-2"
"113236","Cypress College","2019","On-tenure track, instructors","64","24","40","0","0","0","12","2","10","3","3","0","13","6","7","0","0","0","30","11","19","3","1","2","3","1","2","0","0","0","-2"
"113698","Dominican University of California","2019","Tenured total","42","18","24","0","0","0","3","1","2","3","2","1","0","0","0","0","0","0","36","15","21","0","0","0","0","0","0","0","0","0","-2"
"113698","Dominican University of California","2019","Tenured, professors","27","12","15","0","0","0","1","0","1","3","2","1","0","0","0","0","0","0","23","10","13","0","0","0","0","0","0","0","0","0","-2"
"113698","Dominican University of California","2019","Tenured, associate professors","15","6","9","0","0","0","2","1","1","0","0","0","0","0","0","0","0","0","13","5","8","0","0","0","0","0","0","0","0","0","-2"
"113698","Dominican University of California","2019","On-Tenure track total","35","16","19","0","0","0","4","1","3","1","0","1","3","3","0","0","0","0","18","7","11","1","1","0","5","2","3","3","2","1","-2"
"113698","Dominican University of California","2019","On-tenure track, professors","1","0","1","0","0","0","0","0","0","0","0","0","0","0","0","0","0","0","1","0","1","0","0","0","0","0","0","0","0","0","-2"
"113698","Dominican University of California","2019","On-tenure track, associate professors","1","0","1","0","0","0","0","0","0","0","0","0","0","0","0","0","0","0","1","0","1","0","0","0","0","0","0","0","0","0","-2"
"113698","Dominican University of California","2019","On-tenure track, assistant professors","33","16","17","0","0","0","4","1","3","1","0","1","3","3","0","0","0","0","16","7","9","1","1","0","5","2","3","3","2","1","-2"
"113698","Dominican University of California","2019","Not on tenure track/No tenure system system total","29","13","16","0","0","0","1","0","1","2","2","0","1","1","0","0","0","0","20","7","13","1","0","1","4","3","1","0","0","0","-2"
"113698","Dominican University of California","2019","Not on tenure/no tenure system, professors","1","0","1","0","0","0","0","0","0","0","0","0","0","0","0","0","0","0","1","0","1","0","0","0","0","0","0","0","0","0","-2"
"113698","Dominican University of California","2019","Not on tenure/no tenure system, associate professors","2","1","1","0","0","0","0","0","0","0","0","0","0","0","0","0","0","0","0","0","0","0","0","0","2","1","1","0","0","0","-2"
"113698","Dominican University of California","2019","Not on tenure/no tenure system, assistant professors","26","12","14","0","0","0","1","0","1","2","2","0","1","1","0","0","0","0","19","7","12","1","0","1","2","2","0","0","0","0","-2"
"114433","Feather River Community College District","2019","Tenured total","13","7","6","0","0","0","0","0","0","0","0","0","0","0","0","0","0","0","12","7","5","0","0","0","0","0","0","1","0","1","-2"
"114433","Feather River Community College District","2019","Tenured, instructors","13","7","6","0","0","0","0","0","0","0","0","0","0","0","0","0","0","0","12","7","5","0","0","0","0","0","0","1","0","1","-2"
"114433","Feather River Community College District","2019","On-Tenure track total","8","5","3","0","0","0","0","0","0","0","0","0","0","0","0","1","1","0","7","4","3","0","0","0","0","0","0","0","0","0","-2"
"114433","Feather River Community College District","2019","On-tenure track, instructors","8","5","3","0","0","0","0","0","0","0","0","0","0","0","0","1","1","0","7","4","3","0","0","0","0","0","0","0","0","0","-2"
"114716","Foothill College","2019","Tenured total","137","57","80","0","0","0","20","6","14","6","2","4","22","9","13","0","0","0","85","37","48","3","3","0","1","0","1","0","0","0","-2"
"114716","Foothill College","2019","Tenured, instructors","137","57","80","0","0","0","20","6","14","6","2","4","22","9","13","0","0","0","85","37","48","3","3","0","1","0","1","0","0","0","-2"
"114716","Foothill College","2019","On-Tenure track total","30","14","16","0","0","0","5","3","2","4","1","3","6","4","2","0","0","0","13","5","8","2","1","1","0","0","0","0","0","0","-2"
"114716","Foothill College","2019","On-tenure track, instructors","30","14","16","0","0","0","5","3","2","4","1","3","6","4","2","0","0","0","13","5","8","2","1","1","0","0","0","0","0","0","-2"
"114716","Foothill College","2019","Not on tenure track/No tenure system system total","2","0","2","0","0","0","0","0","0","0","0","0","2","0","2","0","0","0","0","0","0","0","0","0","0","0","0","0","0","0","-2"
"114716","Foothill College","2019","Not on tenure/no tenure system, instructors","2","0","2","0","0","0","0","0","0","0","0","0","2","0","2","0","0","0","0","0","0","0","0","0","0","0","0","0","0","0","-2"
"114813","Fresno Pacific University","2019","Tenured total","53","34","19","0","0","0","3","1","2","1","1","0","1","0","1","0","0","0","46","31","15","2","1","1","0","0","0","0","0","0","-2"
"114813","Fresno Pacific University","2019","Tenured, professors","13","9","4","0","0","0","0","0","0","0","0","0","1","0","1","0","0","0","12","9","3","0","0","0","0","0","0","0","0","0","-2"
"114813","Fresno Pacific University","2019","Tenured, associate professors","38","24","14","0","0","0","3","1","2","0","0","0","0","0","0","0","0","0","33","22","11","2","1","1","0","0","0","0","0","0","-2"
"114813","Fresno Pacific University","2019","Tenured, assistant professors","2","1","1","0","0","0","0","0","0","1","1","0","0","0","0","0","0","0","1","0","1","0","0","0","0","0","0","0","0","0","-2"
"114813","Fresno Pacific University","2019","On-Tenure track total","29","8","21","0","0","0","1","1","0","1","0","1","4","0","4","0","0","0","23","7","16","0","0","0","0","0","0","0","0","0","-2"
"114813","Fresno Pacific University","2019","On-tenure track, associate professors","2","1","1","0","0","0","1","1","0","0","0","0","0","0","0","0","0","0","1","0","1","0","0","0","0","0","0","0","0","0","-2"
"114813","Fresno Pacific University","2019","On-tenure track, assistant professors","24","5","19","0","0","0","0","0","0","1","0","1","4","0","4","0","0","0","19","5","14","0","0","0","0","0","0","0","0","0","-2"
"114813","Fresno Pacific University","2019","On-tenure track, instructors","3","2","1","0","0","0","0","0","0","0","0","0","0","0","0","0","0","0","3","2","1","0","0","0","0","0","0","0","0","0","-2"
"114813","Fresno Pacific University","2019","Not on tenure track/No tenure system system total","24","6","18","0","0","0","1","0","1","0","0","0","5","0","5","0","0","0","17","6","11","0","0","0","1","0","1","0","0","0","-2"
"114813","Fresno Pacific University","2019","Not on tenure/no tenure system, professors","3","2","1","0","0","0","0","0","0","0","0","0","0","0","0","0","0","0","2","2","0","0","0","0","1","0","1","0","0","0","-2"
"114813","Fresno Pacific University","2019","Not on tenure/no tenure system, associate professors","3","2","1","0","0","0","0","0","0","0","0","0","0","0","0","0","0","0","3","2","1","0","0","0","0","0","0","0","0","0","-2"
"114813","Fresno Pacific University","2019","Not on tenure/no tenure system, assistant professors","15","2","13","0","0","0","1","0","1","0","0","0","4","0","4","0","0","0","10","2","8","0","0","0","0","0","0","0","0","0","-2"
"114813","Fresno Pacific University","2019","Not on tenure/no tenure system, instructors","3","0","3","0","0","0","0","0","0","0","0","0","1","0","1","0","0","0","2","0","2","0","0","0","0","0","0","0","0","0","-2"
"115728","Holy Names University","2019","Tenured total","17","11","6","0","0","0","5","3","2","1","1","0","1","0","1","0","0","0","10","7","3","0","0","0","0","0","0","0","0","0","-2"
"115728","Holy Names University","2019","Tenured, professors","6","3","3","0","0","0","1","0","1","0","0","0","1","0","1","0","0","0","4","3","1","0","0","0","0","0","0","0","0","0","-2"
"115728","Holy Names University","2019","Tenured, associate professors","11","8","3","0","0","0","4","3","1","1","1","0","0","0","0","0","0","0","6","4","2","0","0","0","0","0","0","0","0","0","-2"
"115728","Holy Names University","2019","On-Tenure track total","8","2","6","0","0","0","4","1","3","2","1","1","0","0","0","0","0","0","1","0","1","1","0","1","0","0","0","0","0","0","-2"
"115728","Holy Names University","2019","On-tenure track, associate professors","2","0","2","0","0","0","1","0","1","0","0","0","0","0","0","0","0","0","1","0","1","0","0","0","0","0","0","0","0","0","-2"
"115728","Holy Names University","2019","On-tenure track, assistant professors","6","2","4","0","0","0","3","1","2","2","1","1","0","0","0","0","0","0","0","0","0","1","0","1","0","0","0","0","0","0","-2"
"115728","Holy Names University","2019","Not on tenure track/No tenure system system total","17","5","12","0","0","0","3","1","2","0","0","0","2","1","1","0","0","0","10","2","8","0","0","0","1","1","0","1","0","1","-2"
"115728","Holy Names University","2019","Not on tenure/no tenure system, associate professors","1","1","0","0","0","0","0","0","0","0","0","0","0","0","0","0","0","0","1","1","0","0","0","0","0","0","0","0","0","0","-2"
"115728","Holy Names University","2019","Not on tenure/no tenure system, assistant professors","12","2","10","0","0","0","2","0","2","0","0","0","1","0","1","0","0","0","7","1","6","0","0","0","1","1","0","1","0","1","-2"
"115728","Holy Names University","2019","Not on tenure/no tenure system, instructors","4","2","2","0","0","0","1","1","0","0","0","0","1","1","0","0","0","0","2","0","2","0","0","0","0","0","0","0","0","0","-2"
"115773","Humphreys University-Stockton and Modesto Campuses","2019","Not on tenure track/No tenure system system total","12","2","10","0","0","0","0","0","0","0","0","0","1","0","1","0","0","0","11","2","9","0","0","0","0","0","0","0","0","0","-2"
"115773","Humphreys University-Stockton and Modesto Campuses","2019","Not on tenure/no tenure system, professors","4","2","2","0","0","0","0","0","0","0","0","0","0","0","0","0","0","0","4","2","2","0","0","0","0","0","0","0","0","0","-2"
"115773","Humphreys University-Stockton and Modesto Campuses","2019","Not on tenure/no tenure system, associate professors","6","0","6","0","0","0","0","0","0","0","0","0","1","0","1","0","0","0","5","0","5","0","0","0","0","0","0","0","0","0","-2"
"115773","Humphreys University-Stockton and Modesto Campuses","2019","Not on tenure/no tenure system, instructors","2","0","2","0","0","0","0","0","0","0","0","0","0","0","0","0","0","0","2","0","2","0","0","0","0","0","0","0","0","0","-2"
"117104","Life Pacific University","2019","Not on tenure track/No tenure system system total","15","11","4","0","0","0","0","0","0","3","3","0","4","3","1","1","1","0","7","4","3","0","0","0","0","0","0","0","0","0","-2"
"117104","Life Pacific University","2019","Not on tenure/no tenure system, professors","3","3","0","0","0","0","0","0","0","0","0","0","0","0","0","1","1","0","2","2","0","0","0","0","0","0","0","0","0","0","-2"
"117104","Life Pacific University","2019","Not on tenure/no tenure system, associate professors","5","4","1","0","0","0","0","0","0","2","2","0","0","0","0","0","0","0","3","2","1","0","0","0","0","0","0","0","0","0","-2"
"117104","Life Pacific University","2019","Not on tenure/no tenure system, assistant professors","5","3","2","0","0","0","0","0","0","0","0","0","4","3","1","0","0","0","1","0","1","0","0","0","0","0","0","0","0","0","-2"
"117104","Life Pacific University","2019","Not on tenure/no tenure system, instructors","2","1","1","0","0","0","0","0","0","1","1","0","0","0","0","0","0","0","1","0","1","0","0","0","0","0","0","0","0","0","-2"
"117140","University of La Verne","2019","Tenured total","133","67","66","0","0","0","18","4","14","4","1","3","14","9","5","0","0","0","87","50","37","0","0","0","10","3","7","0","0","0","-2"
"117140","University of La Verne","2019","Tenured, professors","73","44","29","0","0","0","9","3","6","1","1","0","4","3","1","0","0","0","56","36","20","0","0","0","3","1","2","0","0","0","-2"
"117140","University of La Verne","2019","Tenured, associate professors","49","18","31","0","0","0","6","1","5","3","0","3","9","5","4","0","0","0","25","11","14","0","0","0","6","1","5","0","0","0","-2"
"117140","University of La Verne","2019","Tenured, assistant professors","11","5","6","0","0","0","3","0","3","0","0","0","1","1","0","0","0","0","6","3","3","0","0","0","1","1","0","0","0","0","-2"
"117140","University of La Verne","2019","On-Tenure track total","58","27","31","0","0","0","7","2","5","6","5","1","6","3","3","0","0","0","9","3","6","0","0","0","30","14","16","0","0","0","-2"
"117140","University of La Verne","2019","On-tenure track, professors","4","2","2","0","0","0","0","0","0","1","1","0","0","0","0","0","0","0","1","1","0","0","0","0","2","0","2","0","0","0","-2"
"117140","University of La Verne","2019","On-tenure track, associate professors","11","5","6","0","0","0","0","0","0","0","0","0","2","1","1","0","0","0","1","1","0","0","0","0","8","3","5","0","0","0","-2"
"117140","University of La Verne","2019","On-tenure track, assistant professors","43","20","23","0","0","0","7","2","5","5","4","1","4","2","2","0","0","0","7","1","6","0","0","0","20","11","9","0","0","0","-2"
"117140","University of La Verne","2019","Not on tenure track/No tenure system system total","63","20","43","0","0","0","2","0","2","4","0","4","10","4","6","0","0","0","36","12","24","0","0","0","11","4","7","0","0","0","-2"
"117140","University of La Verne","2019","Not on tenure/no tenure system, professors","8","2","6","0","0","0","0","0","0","1","0","1","0","0","0","0","0","0","6","2","4","0","0","0","1","0","1","0","0","0","-2"
"117140","University of La Verne","2019","Not on tenure/no tenure system, associate professors","9","1","8","0","0","0","1","0","1","1","0","1","1","0","1","0","0","0","5","1","4","0","0","0","1","0","1","0","0","0","-2"
"117140","University of La Verne","2019","Not on tenure/no tenure system, assistant professors","22","8","14","0","0","0","0","0","0","1","0","1","6","2","4","0","0","0","12","4","8","0","0","0","3","2","1","0","0","0","-2"
"117140","University of La Verne","2019","Not on tenure/no tenure system, instructors","24","9","15","0","0","0","1","0","1","1","0","1","3","2","1","0","0","0","13","5","8","0","0","0","6","2","4","0","0","0","-2"
"117627","La Sierra University","2019","Tenured total","33","24","9","1","1","0","1","0","1","2","2","0","2","2","0","2","1","1","20","13","7","0","0","0","0","0","0","5","5","0","-2"
"117627","La Sierra University","2019","Tenured, professors","16","13","3","1","1","0","1","0","1","1","1","0","1","1","0","1","1","0","8","6","2","0","0","0","0","0","0","3","3","0","-2"
"117627","La Sierra University","2019","Tenured, associate professors","16","10","6","0","0","0","0","0","0","1","1","0","1","1","0","1","0","1","11","6","5","0","0","0","0","0","0","2","2","0","-2"
"117627","La Sierra University","2019","Tenured, assistant professors","1","1","0","0","0","0","0","0","0","0","0","0","0","0","0","0","0","0","1","1","0","0","0","0","0","0","0","0","0","0","-2"
"117627","La Sierra University","2019","On-Tenure track total","23","12","11","0","0","0","3","2","1","0","0","0","6","4","2","2","1","1","7","2","5","0","0","0","0","0","0","5","3","2","-2"
"117627","La Sierra University","2019","On-tenure track, professors","4","3","1","0","0","0","0","0","0","0","0","0","1","1","0","0","0","0","2","1","1","0","0","0","0","0","0","1","1","0","-2"
"117627","La Sierra University","2019","On-tenure track, associate professors","8","6","2","0","0","0","2","1","1","0","0","0","4","3","1","0","0","0","1","1","0","0","0","0","0","0","0","1","1","0","-2"
"117627","La Sierra University","2019","On-tenure track, assistant professors","9","3","6","0","0","0","1","1","0","0","0","0","1","0","1","2","1","1","3","0","3","0","0","0","0","0","0","2","1","1","-2"
"117627","La Sierra University","2019","On-tenure track, lecturers","2","0","2","0","0","0","0","0","0","0","0","0","0","0","0","0","0","0","1","0","1","0","0","0","0","0","0","1","0","1","-2"
"117627","La Sierra University","2019","Not on tenure track/No tenure system system total","36","17","19","0","0","0","1","1","0","1","0","1","6","3","3","4","1","3","17","7","10","0","0","0","0","0","0","7","5","2","-2"
"117627","La Sierra University","2019","Not on tenure/no tenure system, professors","2","1","1","0","0","0","0","0","0","0","0","0","0","0","0","1","0","1","1","1","0","0","0","0","0","0","0","0","0","0","-2"
"117627","La Sierra University","2019","Not on tenure/no tenure system, associate professors","7","2","5","0","0","0","0","0","0","0","0","0","0","0","0","1","1","0","5","1","4","0","0","0","0","0","0","1","0","1","-2"
"117627","La Sierra University","2019","Not on tenure/no tenure system, assistant professors","19","11","8","0","0","0","0","0","0","0","0","0","5","2","3","1","0","1","7","4","3","0","0","0","0","0","0","6","5","1","-2"
"117627","La Sierra University","2019","Not on tenure/no tenure system, instructors","2","1","1","0","0","0","0","0","0","0","0","0","0","0","0","1","0","1","1","1","0","0","0","0","0","0","0","0","0","0","-2"
"117627","La Sierra University","2019","Not on tenure/no tenure system, lecturers","6","2","4","0","0","0","1","1","0","1","0","1","1","1","0","0","0","0","3","0","3","0","0","0","0","0","0","0","0","0","-2"
"117636","Loma Linda University","2019","Tenured total","19","13","6","0","0","0","2","0","2","1","1","0","1","1","0","0","0","0","13","10","3","0","0","0","0","0","0","2","1","1","-2"
"117636","Loma Linda University","2019","Tenured, professors","13","10","3","0","0","0","1","0","1","1","1","0","1","1","0","0","0","0","10","8","2","0","0","0","0","0","0","0","0","0","-2"
"117636","Loma Linda University","2019","Tenured, associate professors","1","1","0","0","0","0","0","0","0","0","0","0","0","0","0","0","0","0","1","1","0","0","0","0","0","0","0","0","0","0","-2"
"117636","Loma Linda University","2019","Tenured, assistant professors","5","2","3","0","0","0","1","0","1","0","0","0","0","0","0","0","0","0","2","1","1","0","0","0","0","0","0","2","1","1","-2"
"117636","Loma Linda University","2019","On-Tenure track total","51","23","28","0","0","0","6","2","4","5","2","3","4","3","1","1","1","0","35","15","20","0","0","0","0","0","0","0","0","0","-2"
"117636","Loma Linda University","2019","On-tenure track, professors","14","9","5","0","0","0","3","2","1","0","0","0","1","1","0","0","0","0","10","6","4","0","0","0","0","0","0","0","0","0","-2"
"117636","Loma Linda University","2019","On-tenure track, associate professors","14","5","9","0","0","0","2","0","2","2","1","1","0","0","0","0","0","0","10","4","6","0","0","0","0","0","0","0","0","0","-2"
"117636","Loma Linda University","2019","On-tenure track, assistant professors","22","9","13","0","0","0","1","0","1","3","1","2","3","2","1","1","1","0","14","5","9","0","0","0","0","0","0","0","0","0","-2"
"117636","Loma Linda University","2019","On-tenure track, instructors","1","0","1","0","0","0","0","0","0","0","0","0","0","0","0","0","0","0","1","0","1","0","0","0","0","0","0","0","0","0","-2"
"117636","Loma Linda University","2019","Not on tenure track/No tenure system system total","330","138","192","0","0","0","63","22","41","25","10","15","27","13","14","0","0","0","196","79","117","7","4","3","0","0","0","12","10","2","-2"
"117636","Loma Linda University","2019","Not on tenure/no tenure system, professors","31","20","11","0","0","0","4","4","0","3","1","2","3","2","1","0","0","0","21","13","8","0","0","0","0","0","0","0","0","0","-2"
"117636","Loma Linda University","2019","Not on tenure/no tenure system, associate professors","64","26","38","0","0","0","14","4","10","5","4","1","2","2","0","0","0","0","42","16","26","1","0","1","0","0","0","0","0","0","-2"
"117636","Loma Linda University","2019","Not on tenure/no tenure system, assistant professors","193","80","113","0","0","0","38","11","27","16","5","11","15","7","8","0","0","0","108","45","63","5","3","2","0","0","0","11","9","2","-2"
"117636","Loma Linda University","2019","Not on tenure/no tenure system, instructors","42","12","30","0","0","0","7","3","4","1","0","1","7","2","5","0","0","0","25","5","20","1","1","0","0","0","0","1","1","0","-2"
"118541","Marymount California University","2019","Not on tenure track/No tenure system system total","31","17","14","0","0","0","3","2","1","3","2","1","2","1","1","0","0","0","23","12","11","0","0","0","0","0","0","0","0","0","-2"
"118541","Marymount California University","2019","Not on tenure/no tenure system, professors","14","9","5","0","0","0","1","1","0","2","1","1","0","0","0","0","0","0","11","7","4","0","0","0","0","0","0","0","0","0","-2"
"118541","Marymount California University","2019","Not on tenure/no tenure system, associate professors","12","5","7","0","0","0","2","1","1","1","1","0","2","1","1","0","0","0","7","2","5","0","0","0","0","0","0","0","0","0","-2"
"118541","Marymount California University","2019","Not on tenure/no tenure system, assistant professors","5","3","2","0","0","0","0","0","0","0","0","0","0","0","0","0","0","0","5","3","2","0","0","0","0","0","0","0","0","0","-2"
"118693","Menlo College","2019","Not on tenure track/No tenure system system total","23","11","12","0","0","0","7","4","3","1","0","1","0","0","0","0","0","0","15","7","8","0","0","0","0","0","0","0","0","0","-2"
"118693","Menlo College","2019","Not on tenure/no tenure system, professors","10","4","6","0","0","0","3","1","2","1","0","1","0","0","0","0","0","0","6","3","3","0","0","0","0","0","0","0","0","0","-2"
"118693","Menlo College","2019","Not on tenure/no tenure system, associate professors","6","4","2","0","0","0","2","2","0","0","0","0","0","0","0","0","0","0","4","2","2","0","0","0","0","0","0","0","0","0","-2"
"118693","Menlo College","2019","Not on tenure/no tenure system, assistant professors","4","1","3","0","0","0","2","1","1","0","0","0","0","0","0","0","0","0","2","0","2","0","0","0","0","0","0","0","0","0","-2"
"118693","Menlo College","2019","Not on tenure/no tenure system, instructors","1","1","0","0","0","0","0","0","0","0","0","0","0","0","0","0","0","0","1","1","0","0","0","0","0","0","0","0","0","0","-2"
"118693","Menlo College","2019","Not on tenure/no tenure system, lecturers","2","1","1","0","0","0","0","0","0","0","0","0","0","0","0","0","0","0","2","1","1","0","0","0","0","0","0","0","0","0","-2"
"118888","Mills College","2019","Tenured total","44","10","34","1","1","0","5","2","3","3","0","3","4","1","3","0","0","0","26","5","21","3","1","2","1","0","1","1","0","1","-2"
"118888","Mills College","2019","Tenured, professors","30","6","24","0","0","0","3","1","2","3","0","3","3","1","2","0","0","0","17","4","13","2","0","2","1","0","1","1","0","1","-2"
"118888","Mills College","2019","Tenured, associate professors","14","4","10","1","1","0","2","1","1","0","0","0","1","0","1","0","0","0","9","1","8","1","1","0","0","0","0","0","0","0","-2"
"118888","Mills College","2019","On-Tenure track total","11","3","8","1","0","1","1","1","0","3","0","3","1","1","0","0","0","0","4","0","4","1","1","0","0","0","0","0","0","0","-2"
"118888","Mills College","2019","On-tenure track, professors","1","0","1","0","0","0","0","0","0","1","0","1","0","0","0","0","0","0","0","0","0","0","0","0","0","0","0","0","0","0","-2"
"118888","Mills College","2019","On-tenure track, associate professors","3","1","2","0","0","0","1","1","0","1","0","1","0","0","0","0","0","0","1","0","1","0","0","0","0","0","0","0","0","0","-2"
"118888","Mills College","2019","On-tenure track, assistant professors","7","2","5","1","0","1","0","0","0","1","0","1","1","1","0","0","0","0","3","0","3","1","1","0","0","0","0","0","0","0","-2"
"118888","Mills College","2019","Not on tenure track/No tenure system system total","28","9","19","0","0","0","2","0","2","5","2","3","2","0","2","0","0","0","17","7","10","2","0","2","0","0","0","0","0","0","-2"
"118888","Mills College","2019","Not on tenure/no tenure system, professors","10","2","8","0","0","0","1","0","1","2","1","1","1","0","1","0","0","0","6","1","5","0","0","0","0","0","0","0","0","0","-2"
"118888","Mills College","2019","Not on tenure/no tenure system, associate professors","3","1","2","0","0","0","0","0","0","1","1","0","0","0","0","0","0","0","2","0","2","0","0","0","0","0","0","0","0","0","-2"
"118888","Mills College","2019","Not on tenure/no tenure system, assistant professors","15","6","9","0","0","0","1","0","1","2","0","2","1","0","1","0","0","0","9","6","3","2","0","2","0","0","0","0","0","0","-2"
"118912","MiraCosta College","2019","Tenured total","125","63","62","0","0","0","0","0","0","7","6","1","19","10","9","0","0","0","80","39","41","5","1","4","14","7","7","0","0","0","-2"
"118912","MiraCosta College","2019","Tenured, instructors","125","63","62","0","0","0","0","0","0","7","6","1","19","10","9","0","0","0","80","39","41","5","1","4","14","7","7","0","0","0","-2"
"118912","MiraCosta College","2019","On-Tenure track total","16","6","10","0","0","0","0","0","0","1","1","0","4","0","4","0","0","0","5","2","3","0","0","0","6","3","3","0","0","0","-2"
"118912","MiraCosta College","2019","On-tenure track, instructors","16","6","10","0","0","0","0","0","0","1","1","0","4","0","4","0","0","0","5","2","3","0","0","0","6","3","3","0","0","0","-2"
"118912","MiraCosta College","2019","Not on tenure track/No tenure system system total","45","17","28","1","0","1","1","0","1","3","1","2","8","3","5","0","0","0","26","8","18","2","1","1","3","3","0","1","1","0","-2"
"118912","MiraCosta College","2019","Not on tenure/no tenure system, instructors","45","17","28","1","0","1","1","0","1","3","1","2","8","3","5","0","0","0","26","8","18","2","1","1","3","3","0","1","1","0","-2"
"118976","Modesto Junior College","2019","Tenured total","96","41","55","1","0","1","4","1","3","7","2","5","8","4","4","0","0","0","69","32","37","0","0","0","7","2","5","0","0","0","-2"
"118976","Modesto Junior College","2019","Tenured, instructors","96","41","55","1","0","1","4","1","3","7","2","5","8","4","4","0","0","0","69","32","37","0","0","0","7","2","5","0","0","0","-2"
"118976","Modesto Junior College","2019","On-Tenure track total","53","36","17","0","0","0","3","1","2","1","1","0","6","3","3","0","0","0","41","29","12","0","0","0","2","2","0","0","0","0","-2"
"118976","Modesto Junior College","2019","On-tenure track, instructors","53","36","17","0","0","0","3","1","2","1","1","0","6","3","3","0","0","0","41","29","12","0","0","0","2","2","0","0","0","0","-2"
"118976","Modesto Junior College","2019","Not on tenure track/No tenure system system total","106","38","68","1","1","0","4","0","4","6","2","4","21","7","14","0","0","0","69","27","42","1","0","1","3","1","2","1","0","1","-2"
"118976","Modesto Junior College","2019","Not on tenure/no tenure system, instructors","106","38","68","1","1","0","4","0","4","6","2","4","21","7","14","0","0","0","69","27","42","1","0","1","3","1","2","1","0","1","-2"
"119173","Mount Saint Mary's University","2019","Tenured total","57","17","40","0","0","0","4","2","2","4","0","4","5","2","3","0","0","0","43","13","30","1","0","1","0","0","0","0","0","0","-2"
"119173","Mount Saint Mary's University","2019","Tenured, professors","29","10","19","0","0","0","2","1","1","1","0","1","2","1","1","0","0","0","24","8","16","0","0","0","0","0","0","0","0","0","-2"
"119173","Mount Saint Mary's University","2019","Tenured, associate professors","20","5","15","0","0","0","2","1","1","1","0","1","3","1","2","0","0","0","13","3","10","1","0","1","0","0","0","0","0","0","-2"
"119173","Mount Saint Mary's University","2019","Tenured, assistant professors","8","2","6","0","0","0","0","0","0","2","0","2","0","0","0","0","0","0","6","2","4","0","0","0","0","0","0","0","0","0","-2"
"119173","Mount Saint Mary's University","2019","On-Tenure track total","27","8","19","0","0","0","5","2","3","3","0","3","5","1","4","0","0","0","11","4","7","1","0","1","2","1","1","0","0","0","-2"
"119173","Mount Saint Mary's University","2019","On-tenure track, associate professors","9","4","5","0","0","0","3","1","2","1","0","1","0","0","0","0","0","0","3","2","1","1","0","1","1","1","0","0","0","0","-2"
"119173","Mount Saint Mary's University","2019","On-tenure track, assistant professors","18","4","14","0","0","0","2","1","1","2","0","2","5","1","4","0","0","0","8","2","6","0","0","0","1","0","1","0","0","0","-2"
"119173","Mount Saint Mary's University","2019","Not on tenure track/No tenure system system total","48","13","35","0","0","0","5","1","4","3","2","1","9","4","5","0","0","0","28","6","22","2","0","2","1","0","1","0","0","0","-2"
"119173","Mount Saint Mary's University","2019","Not on tenure/no tenure system, professors","2","1","1","0","0","0","0","0","0","0","0","0","1","1","0","0","0","0","1","0","1","0","0","0","0","0","0","0","0","0","-2"
"119173","Mount Saint Mary's University","2019","Not on tenure/no tenure system, associate professors","4","1","3","0","0","0","0","0","0","0","0","0","0","0","0","0","0","0","4","1","3","0","0","0","0","0","0","0","0","0","-2"
"119173","Mount Saint Mary's University","2019","Not on tenure/no tenure system, assistant professors","30","6","24","0","0","0","5","1","4","3","2","1","4","1","3","0","0","0","16","2","14","2","0","2","0","0","0","0","0","0","-2"
"119173","Mount Saint Mary's University","2019","Not on tenure/no tenure system, instructors","12","5","7","0","0","0","0","0","0","0","0","0","4","2","2","0","0","0","7","3","4","0","0","0","1","0","1","0","0","0","-2"
"119605","National University","2019","Not on tenure track/No tenure system system total","237","120","117","0","0","0","23","14","9","12","4","8","18","8","10","1","0","1","161","86","75","6","3","3","16","5","11","0","0","0","-2"
"119605","National University","2019","Not on tenure/no tenure system, professors","126","71","55","0","0","0","15","10","5","4","2","2","8","3","5","0","0","0","88","52","36","2","0","2","9","4","5","0","0","0","-2"
"119605","National University","2019","Not on tenure/no tenure system, associate professors","72","29","43","0","0","0","5","2","3","7","2","5","5","3","2","1","0","1","48","20","28","3","2","1","3","0","3","0","0","0","-2"
"119605","National University","2019","Not on tenure/no tenure system, assistant professors","39","20","19","0","0","0","3","2","1","1","0","1","5","2","3","0","0","0","25","14","11","1","1","0","4","1","3","0","0","0","-2"
"120184","Notre Dame de Namur University","2019","Tenured total","22","11","11","0","0","0","5","2","3","1","1","0","0","0","0","0","0","0","16","8","8","0","0","0","0","0","0","0","0","0","-2"
"120184","Notre Dame de Namur University","2019","Tenured, professors","19","11","8","0","0","0","5","2","3","1","1","0","0","0","0","0","0","0","13","8","5","0","0","0","0","0","0","0","0","0","-2"
"120184","Notre Dame de Namur University","2019","Tenured, associate professors","3","0","3","0","0","0","0","0","0","0","0","0","0","0","0","0","0","0","3","0","3","0","0","0","0","0","0","0","0","0","-2"
"120184","Notre Dame de Namur University","2019","On-Tenure track total","3","0","3","0","0","0","2","0","2","0","0","0","0","0","0","0","0","0","1","0","1","0","0","0","0","0","0","0","0","0","-2"
"120184","Notre Dame de Namur University","2019","On-tenure track, associate professors","1","0","1","0","0","0","0","0","0","0","0","0","0","0","0","0","0","0","1","0","1","0","0","0","0","0","0","0","0","0","-2"
"120184","Notre Dame de Namur University","2019","On-tenure track, assistant professors","2","0","2","0","0","0","2","0","2","0","0","0","0","0","0","0","0","0","0","0","0","0","0","0","0","0","0","0","0","0","-2"
"120184","Notre Dame de Namur University","2019","Not on tenure track/No tenure system system total","10","3","7","0","0","0","2","1","1","0","0","0","0","0","0","0","0","0","8","2","6","0","0","0","0","0","0","0","0","0","-2"
"120184","Notre Dame de Namur University","2019","Not on tenure/no tenure system, associate professors","3","2","1","0","0","0","2","1","1","0","0","0","0","0","0","0","0","0","1","1","0","0","0","0","0","0","0","0","0","0","-2"
"120184","Notre Dame de Namur University","2019","Not on tenure/no tenure system, assistant professors","6","1","5","0","0","0","0","0","0","0","0","0","0","0","0","0","0","0","6","1","5","0","0","0","0","0","0","0","0","0","-2"
"120184","Notre Dame de Namur University","2019","Not on tenure/no tenure system, instructors","1","0","1","0","0","0","0","0","0","0","0","0","0","0","0","0","0","0","1","0","1","0","0","0","0","0","0","0","0","0","-2"
"120537","Hope International University","2019","Not on tenure track/No tenure system system total","34","17","17","0","0","0","2","1","1","3","1","2","1","1","0","0","0","0","28","14","14","0","0","0","0","0","0","0","0","0","-2"
"120537","Hope International University","2019","Not on tenure/no tenure system, professors","5","2","3","0","0","0","1","1","0","0","0","0","0","0","0","0","0","0","4","1","3","0","0","0","0","0","0","0","0","0","-2"
"120537","Hope International University","2019","Not on tenure/no tenure system, associate professors","20","11","9","0","0","0","1","0","1","2","1","1","1","1","0","0","0","0","16","9","7","0","0","0","0","0","0","0","0","0","-2"
"120537","Hope International University","2019","Not on tenure/no tenure system, assistant professors","9","4","5","0","0","0","0","0","0","1","0","1","0","0","0","0","0","0","8","4","4","0","0","0","0","0","0","0","0","0","-2"
"120768","Pacific Oaks College","2019","Not on tenure track/No tenure system system total","20","5","15","0","0","0","0","0","0","7","2","5","5","1","4","0","0","0","8","2","6","0","0","0","0","0","0","0","0","0","-2"
"120768","Pacific Oaks College","2019","Not on tenure/no tenure system, no academic rank","20","5","15","0","0","0","0","0","0","7","2","5","5","1","4","0","0","0","8","2","6","0","0","0","0","0","0","0","0","0","-2"
"120865","Pacific Union College","2019","Tenured total","30","16","14","0","0","0","0","0","0","0","0","0","0","0","0","0","0","0","19","11","8","9","3","6","2","2","0","0","0","0","-2"
"120865","Pacific Union College","2019","Tenured, professors","22","12","10","0","0","0","0","0","0","0","0","0","0","0","0","0","0","0","13","9","4","7","1","6","2","2","0","0","0","0","-2"
"120865","Pacific Union College","2019","Tenured, associate professors","8","4","4","0","0","0","0","0","0","0","0","0","0","0","0","0","0","0","6","2","4","2","2","0","0","0","0","0","0","0","-2"
"120865","Pacific Union College","2019","On-Tenure track total","25","14","11","0","0","0","6","4","2","0","0","0","1","1","0","0","0","0","7","4","3","7","5","2","4","0","4","0","0","0","-2"
"120865","Pacific Union College","2019","On-tenure track, professors","7","4","3","0","0","0","1","1","0","0","0","0","0","0","0","0","0","0","2","1","1","2","2","0","2","0","2","0","0","0","-2"
"120865","Pacific Union College","2019","On-tenure track, associate professors","4","4","0","0","0","0","1","1","0","0","0","0","0","0","0","0","0","0","2","2","0","1","1","0","0","0","0","0","0","0","-2"
"120865","Pacific Union College","2019","On-tenure track, assistant professors","12","4","8","0","0","0","4","2","2","0","0","0","0","0","0","0","0","0","3","1","2","3","1","2","2","0","2","0","0","0","-2"
"120865","Pacific Union College","2019","On-tenure track, instructors","2","2","0","0","0","0","0","0","0","0","0","0","1","1","0","0","0","0","0","0","0","1","1","0","0","0","0","0","0","0","-2"
"120865","Pacific Union College","2019","Not on tenure track/No tenure system system total","22","6","16","0","0","0","1","1","0","0","0","0","3","0","3","0","0","0","7","0","7","11","5","6","0","0","0","0","0","0","-2"
"120865","Pacific Union College","2019","Not on tenure/no tenure system, professors","1","0","1","0","0","0","0","0","0","0","0","0","0","0","0","0","0","0","1","0","1","0","0","0","0","0","0","0","0","0","-2"
"120865","Pacific Union College","2019","Not on tenure/no tenure system, associate professors","4","1","3","0","0","0","0","0","0","0","0","0","0","0","0","0","0","0","1","0","1","3","1","2","0","0","0","0","0","0","-2"
"120865","Pacific Union College","2019","Not on tenure/no tenure system, assistant professors","14","4","10","0","0","0","1","1","0","0","0","0","3","0","3","0","0","0","3","0","3","7","3","4","0","0","0","0","0","0","-2"
"120865","Pacific Union College","2019","Not on tenure/no tenure system, instructors","3","1","2","0","0","0","0","0","0","0","0","0","0","0","0","0","0","0","2","0","2","1","1","0","0","0","0","0","0","0","-2"
"121619","Santa Ana College","2019","Tenured total","110","46","64","1","1","0","14","4","10","1","0","1","30","13","17","0","0","0","60","27","33","0","0","0","2","0","2","2","1","1","-2"
"121619","Santa Ana College","2019","Tenured, instructors","110","46","64","1","1","0","14","4","10","1","0","1","30","13","17","0","0","0","60","27","33","0","0","0","2","0","2","2","1","1","-2"
"121619","Santa Ana College","2019","On-Tenure track total","137","62","75","0","0","0","24","11","13","4","2","2","34","15","19","0","0","0","65","27","38","0","0","0","8","6","2","2","1","1","-2"
"121619","Santa Ana College","2019","On-tenure track, instructors","137","62","75","0","0","0","24","11","13","4","2","2","34","15","19","0","0","0","65","27","38","0","0","0","8","6","2","2","1","1","-2"
"121619","Santa Ana College","2019","Not on tenure track/No tenure system system total","1","1","0","0","0","0","0","0","0","0","0","0","1","1","0","0","0","0","0","0","0","0","0","0","0","0","0","0","0","0","-2"
"121619","Santa Ana College","2019","Not on tenure/no tenure system, instructors","1","1","0","0","0","0","0","0","0","0","0","0","1","1","0","0","0","0","0","0","0","0","0","0","0","0","0","0","0","0","-2"
"121691","University of Redlands","2019","Tenured total","147","72","75","1","1","0","19","10","9","5","2","3","6","3","3","0","0","0","114","55","59","0","0","0","2","1","1","0","0","0","121691"
"121691","University of Redlands","2019","Tenured, professors","116","55","61","0","0","0","14","7","7","3","2","1","4","2","2","0","0","0","93","43","50","0","0","0","2","1","1","0","0","0","121691"
"121691","University of Redlands","2019","Tenured, associate professors","31","17","14","1","1","0","5","3","2","2","0","2","2","1","1","0","0","0","21","12","9","0","0","0","0","0","0","0","0","0","121691"
"121691","University of Redlands","2019","On-Tenure track total","23","11","12","0","0","0","5","2","3","2","0","2","2","1","1","0","0","0","10","7","3","0","0","0","4","1","3","0","0","0","121691"
"121691","University of Redlands","2019","On-tenure track, associate professors","5","3","2","0","0","0","2","1","1","0","0","0","0","0","0","0","0","0","3","2","1","0","0","0","0","0","0","0","0","0","121691"
"121691","University of Redlands","2019","On-tenure track, assistant professors","18","8","10","0","0","0","3","1","2","2","0","2","2","1","1","0","0","0","7","5","2","0","0","0","4","1","3","0","0","0","121691"
"121691","University of Redlands","2019","Not on tenure track/No tenure system system total","47","20","27","0","0","0","4","2","2","2","1","1","7","3","4","0","0","0","27","8","19","0","0","0","7","6","1","0","0","0","121691"
"121691","University of Redlands","2019","Not on tenure/no tenure system, professors","2","2","0","0","0","0","1","1","0","0","0","0","0","0","0","0","0","0","1","1","0","0","0","0","0","0","0","0","0","0","121691"
"121691","University of Redlands","2019","Not on tenure/no tenure system, lecturers","9","4","5","0","0","0","0","0","0","1","1","0","1","1","0","0","0","0","7","2","5","0","0","0","0","0","0","0","0","0","121691"
"121691","University of Redlands","2019","Not on tenure/no tenure system, no academic rank","36","14","22","0","0","0","3","1","2","1","0","1","6","2","4","0","0","0","19","5","14","0","0","0","7","6","1","0","0","0","121691"
"121886","Rio Hondo College","2019","Tenured total","143","75","68","2","2","0","16","7","9","6","3","3","48","21","27","0","0","0","68","39","29","3","3","0","0","0","0","0","0","0","-2"
"121886","Rio Hondo College","2019","Tenured, instructors","143","75","68","2","2","0","16","7","9","6","3","3","48","21","27","0","0","0","68","39","29","3","3","0","0","0","0","0","0","0","-2"
"121886","Rio Hondo College","2019","On-Tenure track total","62","23","39","0","0","0","7","2","5","0","0","0","24","10","14","1","0","1","21","10","11","1","0","1","3","0","3","5","1","4","-2"
"121886","Rio Hondo College","2019","On-tenure track, instructors","62","23","39","0","0","0","7","2","5","0","0","0","24","10","14","1","0","1","21","10","11","1","0","1","3","0","3","5","1","4","-2"
"121886","Rio Hondo College","2019","Not on tenure track/No tenure system system total","1","1","0","0","0","0","0","0","0","0","0","0","1","1","0","0","0","0","0","0","0","0","0","0","0","0","0","0","0","0","-2"
"121886","Rio Hondo College","2019","Not on tenure/no tenure system, instructors","1","1","0","0","0","0","0","0","0","0","0","0","1","1","0","0","0","0","0","0","0","0","0","0","0","0","0","0","0","0","-2"
"122375","San Diego Mesa College","2019","Tenured total","17","11","6","0","0","0","1","0","1","2","1","1","2","2","0","0","0","0","11","8","3","0","0","0","1","0","1","0","0","0","-2"
"122375","San Diego Mesa College","2019","Tenured, instructors","17","11","6","0","0","0","1","0","1","2","1","1","2","2","0","0","0","0","11","8","3","0","0","0","1","0","1","0","0","0","-2"
"122375","San Diego Mesa College","2019","On-Tenure track total","239","104","135","0","0","0","14","3","11","19","7","12","25","16","9","1","1","0","126","51","75","2","2","0","52","24","28","0","0","0","-2"
"122375","San Diego Mesa College","2019","On-tenure track, instructors","239","104","135","0","0","0","14","3","11","19","7","12","25","16","9","1","1","0","126","51","75","2","2","0","52","24","28","0","0","0","-2"
"122375","San Diego Mesa College","2019","Not on tenure track/No tenure system system total","6","1","5","0","0","0","0","0","0","1","0","1","1","0","1","0","0","0","3","1","2","0","0","0","1","0","1","0","0","0","-2"
"122375","San Diego Mesa College","2019","Not on tenure/no tenure system, instructors","6","1","5","0","0","0","0","0","0","1","0","1","1","0","1","0","0","0","3","1","2","0","0","0","1","0","1","0","0","0","-2"
"122977","Santa Monica College","2019","Tenured total","211","97","114","0","0","0","28","11","17","22","10","12","26","11","15","1","0","1","111","58","53","1","0","1","2","1","1","20","6","14","-2"
"122977","Santa Monica College","2019","Tenured, instructors","211","97","114","0","0","0","28","11","17","22","10","12","26","11","15","1","0","1","111","58","53","1","0","1","2","1","1","20","6","14","-2"
"122977","Santa Monica College","2019","On-Tenure track total","125","49","76","0","0","0","7","1","6","16","4","12","19","9","10","0","0","0","58","24","34","2","0","2","0","0","0","23","11","12","-2"
"122977","Santa Monica College","2019","On-tenure track, instructors","125","49","76","0","0","0","7","1","6","16","4","12","19","9","10","0","0","0","58","24","34","2","0","2","0","0","0","23","11","12","-2"
"122977","Santa Monica College","2019","Not on tenure track/No tenure system system total","16","5","11","0","0","0","0","0","0","2","0","2","3","0","3","0","0","0","6","3","3","0","0","0","2","2","0","3","0","3","-2"
"122977","Santa Monica College","2019","Not on tenure/no tenure system, instructors","16","5","11","0","0","0","0","0","0","2","0","2","3","0","3","0","0","0","6","3","3","0","0","0","2","2","0","3","0","3","-2"
"123509","Skyline College","2019","Tenured total","91","44","47","0","0","0","16","8","8","11","9","2","14","6","8","0","0","0","40","17","23","0","0","0","10","4","6","0","0","0","-2"
"123509","Skyline College","2019","Tenured, instructors","91","44","47","0","0","0","16","8","8","11","9","2","14","6","8","0","0","0","40","17","23","0","0","0","10","4","6","0","0","0","-2"
"123509","Skyline College","2019","On-Tenure track total","40","13","27","1","1","0","9","3","6","7","2","5","11","5","6","0","0","0","11","2","9","0","0","0","0","0","0","1","0","1","-2"
"123509","Skyline College","2019","On-tenure track, instructors","40","13","27","1","1","0","9","3","6","7","2","5","11","5","6","0","0","0","11","2","9","0","0","0","0","0","0","1","0","1","-2"
"123509","Skyline College","2019","Not on tenure track/No tenure system system total","16","11","5","0","0","0","4","3","1","1","1","0","1","0","1","0","0","0","9","6","3","0","0","0","1","1","0","0","0","0","-2"
"123509","Skyline College","2019","Not on tenure/no tenure system, instructors","16","11","5","0","0","0","4","3","1","1","1","0","1","0","1","0","0","0","9","6","3","0","0","0","1","1","0","0","0","0","-2"
"123554","Saint Mary's College of California","2019","Tenured total","131","60","71","1","0","1","18","6","12","3","1","2","10","3","7","0","0","0","79","42","37","0","0","0","13","6","7","7","2","5","-2"
"123554","Saint Mary's College of California","2019","Tenured, professors","75","40","35","1","0","1","12","5","7","1","0","1","4","2","2","0","0","0","54","31","23","0","0","0","3","2","1","0","0","0","-2"
"123554","Saint Mary's College of California","2019","Tenured, associate professors","56","20","36","0","0","0","6","1","5","2","1","1","6","1","5","0","0","0","25","11","14","0","0","0","10","4","6","7","2","5","-2"
"123554","Saint Mary's College of California","2019","On-Tenure track total","55","19","36","0","0","0","3","0","3","6","1","5","9","3","6","0","0","0","20","11","9","0","0","0","13","3","10","4","1","3","-2"
"123554","Saint Mary's College of California","2019","On-tenure track, associate professors","17","8","9","0","0","0","1","0","1","2","1","1","4","1","3","0","0","0","7","4","3","0","0","0","3","2","1","0","0","0","-2"
"123554","Saint Mary's College of California","2019","On-tenure track, assistant professors","38","11","27","0","0","0","2","0","2","4","0","4","5","2","3","0","0","0","13","7","6","0","0","0","10","1","9","4","1","3","-2"
"123554","Saint Mary's College of California","2019","Not on tenure track/No tenure system system total","30","11","19","0","0","0","4","1","3","1","0","1","1","1","0","0","0","0","16","7","9","0","0","0","6","1","5","2","1","1","-2"
"123554","Saint Mary's College of California","2019","Not on tenure/no tenure system, associate professors","13","5","8","0","0","0","2","0","2","0","0","0","1","1","0","0","0","0","9","4","5","0","0","0","1","0","1","0","0","0","-2"
"123554","Saint Mary's College of California","2019","Not on tenure/no tenure system, assistant professors","17","6","11","0","0","0","2","1","1","1","0","1","0","0","0","0","0","0","7","3","4","0","0","0","5","1","4","2","1","1","-2"
"123563","Solano Community College","2019","Tenured total","112","49","63","0","0","0","6","2","4","11","4","7","13","6","7","0","0","0","82","37","45","0","0","0","0","0","0","0","0","0","-2"
"123563","Solano Community College","2019","Tenured, instructors","112","49","63","0","0","0","6","2","4","11","4","7","13","6","7","0","0","0","82","37","45","0","0","0","0","0","0","0","0","0","-2"
"123563","Solano Community College","2019","On-Tenure track total","25","11","14","0","0","0","2","0","2","4","2","2","2","2","0","0","0","0","17","7","10","0","0","0","0","0","0","0","0","0","-2"
"123563","Solano Community College","2019","On-tenure track, instructors","25","11","14","0","0","0","2","0","2","4","2","2","2","2","0","0","0","0","17","7","10","0","0","0","0","0","0","0","0","0","-2"
"123572","Sonoma State University","2019","Tenured total","170","91","79","0","0","0","16","11","5","2","0","2","11","5","6","0","0","0","132","69","63","2","2","0","6","3","3","1","1","0","-2"
"123572","Sonoma State University","2019","Tenured, professors","135","73","62","0","0","0","12","8","4","1","0","1","7","3","4","0","0","0","109","57","52","2","2","0","3","2","1","1","1","0","-2"
"123572","Sonoma State University","2019","Tenured, associate professors","35","18","17","0","0","0","4","3","1","1","0","1","4","2","2","0","0","0","23","12","11","0","0","0","3","1","2","0","0","0","-2"
"123572","Sonoma State University","2019","On-Tenure track total","74","27","47","1","0","1","10","6","4","1","1","0","7","3","4","0","0","0","36","12","24","3","0","3","6","2","4","10","3","7","-2"
"123572","Sonoma State University","2019","On-tenure track, associate professors","4","2","2","0","0","0","0","0","0","0","0","0","0","0","0","0","0","0","2","1","1","0","0","0","0","0","0","2","1","1","-2"
"123572","Sonoma State University","2019","On-tenure track, assistant professors","70","25","45","1","0","1","10","6","4","1","1","0","7","3","4","0","0","0","34","11","23","3","0","3","6","2","4","8","2","6","-2"
"123572","Sonoma State University","2019","Not on tenure track/No tenure system system total","32","17","15","0","0","0","1","1","0","0","0","0","2","2","0","0","0","0","22","10","12","1","0","1","6","4","2","0","0","0","-2"
"123572","Sonoma State University","2019","Not on tenure/no tenure system, lecturers","32","17","15","0","0","0","1","1","0","0","0","0","2","2","0","0","0","0","22","10","12","1","0","1","6","4","2","0","0","0","-2"
"123651","Vanguard University of Southern California","2019","Tenured total","39","18","21","0","0","0","1","0","1","1","1","0","0","0","0","0","0","0","36","17","19","1","0","1","0","0","0","0","0","0","-2"
"123651","Vanguard University of Southern California","2019","Tenured, professors","25","16","9","0","0","0","0","0","0","0","0","0","0","0","0","0","0","0","24","16","8","1","0","1","0","0","0","0","0","0","-2"
"123651","Vanguard University of Southern California","2019","Tenured, associate professors","13","2","11","0","0","0","1","0","1","1","1","0","0","0","0","0","0","0","11","1","10","0","0","0","0","0","0","0","0","0","-2"
"123651","Vanguard University of Southern California","2019","Tenured, assistant professors","1","0","1","0","0","0","0","0","0","0","0","0","0","0","0","0","0","0","1","0","1","0","0","0","0","0","0","0","0","0","-2"
"123651","Vanguard University of Southern California","2019","On-Tenure track total","23","10","13","0","0","0","8","3","5","2","2","0","2","1","1","0","0","0","10","4","6","1","0","1","0","0","0","0","0","0","-2"
"123651","Vanguard University of Southern California","2019","On-tenure track, professors","1","1","0","0","0","0","0","0","0","0","0","0","0","0","0","0","0","0","1","1","0","0","0","0","0","0","0","0","0","0","-2"
"123651","Vanguard University of Southern California","2019","On-tenure track, associate professors","5","3","2","0","0","0","2","1","1","1","1","0","0","0","0","0","0","0","2","1","1","0","0","0","0","0","0","0","0","0","-2"
"123651","Vanguard University of Southern California","2019","On-tenure track, assistant professors","17","6","11","0","0","0","6","2","4","1","1","0","2","1","1","0","0","0","7","2","5","1","0","1","0","0","0","0","0","0","-2"
"123651","Vanguard University of Southern California","2019","Not on tenure track/No tenure system system total","23","8","15","0","0","0","3","1","2","3","1","2","1","0","1","0","0","0","15","5","10","0","0","0","0","0","0","1","1","0","-2"
"123651","Vanguard University of Southern California","2019","Not on tenure/no tenure system, associate professors","4","2","2","0","0","0","1","0","1","1","1","0","0","0","0","0","0","0","2","1","1","0","0","0","0","0","0","0","0","0","-2"
"123651","Vanguard University of Southern California","2019","Not on tenure/no tenure system, assistant professors","14","4","10","0","0","0","1","1","0","2","0","2","1","0","1","0","0","0","10","3","7","0","0","0","0","0","0","0","0","0","-2"
"123651","Vanguard University of Southern California","2019","Not on tenure/no tenure system, instructors","5","2","3","0","0","0","1","0","1","0","0","0","0","0","0","0","0","0","3","1","2","0","0","0","0","0","0","1","1","0","-2"
"125471","West Los Angeles College","2019","Tenured total","94","44","50","0","0","0","11","8","3","12","8","4","14","5","9","1","0","1","39","17","22","0","0","0","16","6","10","1","0","1","-2"
"125471","West Los Angeles College","2019","Tenured, instructors","94","44","50","0","0","0","11","8","3","12","8","4","14","5","9","1","0","1","39","17","22","0","0","0","16","6","10","1","0","1","-2"
"125471","West Los Angeles College","2019","On-Tenure track total","27","10","17","0","0","0","1","1","0","3","1","2","4","0","4","0","0","0","6","4","2","0","0","0","13","4","9","0","0","0","-2"
"125471","West Los Angeles College","2019","On-tenure track, instructors","27","10","17","0","0","0","1","1","0","3","1","2","4","0","4","0","0","0","6","4","2","0","0","0","13","4","9","0","0","0","-2"
"125471","West Los Angeles College","2019","Not on tenure track/No tenure system system total","6","3","3","0","0","0","0","0","0","0","0","0","0","0","0","0","0","0","3","0","3","0","0","0","3","3","0","0","0","0","-2"
"125471","West Los Angeles College","2019","Not on tenure/no tenure system, instructors","6","3","3","0","0","0","0","0","0","0","0","0","0","0","0","0","0","0","3","0","3","0","0","0","3","3","0","0","0","0","-2"
"125763","Whittier College","2019","Tenured total","71","37","34","0","0","0","3","1","2","2","0","2","11","7","4","0","0","0","48","24","24","1","1","0","0","0","0","6","4","2","-2"
"125763","Whittier College","2019","Tenured, professors","35","21","14","0","0","0","2","1","1","1","0","1","4","2","2","0","0","0","25","16","9","0","0","0","0","0","0","3","2","1","-2"
"125763","Whittier College","2019","Tenured, associate professors","36","16","20","0","0","0","1","0","1","1","0","1","7","5","2","0","0","0","23","8","15","1","1","0","0","0","0","3","2","1","-2"
"125763","Whittier College","2019","On-Tenure track total","21","9","12","1","0","1","2","0","2","3","1","2","3","0","3","0","0","0","8","7","1","4","1","3","0","0","0","0","0","0","-2"
"125763","Whittier College","2019","On-tenure track, associate professors","3","2","1","0","0","0","0","0","0","0","0","0","0","0","0","0","0","0","3","2","1","0","0","0","0","0","0","0","0","0","-2"
"125763","Whittier College","2019","On-tenure track, assistant professors","18","7","11","1","0","1","2","0","2","3","1","2","3","0","3","0","0","0","5","5","0","4","1","3","0","0","0","0","0","0","-2"
"125763","Whittier College","2019","Not on tenure track/No tenure system system total","37","20","17","0","0","0","5","2","3","0","0","0","7","5","2","0","0","0","24","13","11","0","0","0","1","0","1","0","0","0","-2"
"125763","Whittier College","2019","Not on tenure/no tenure system, professors","4","2","2","0","0","0","0","0","0","0","0","0","0","0","0","0","0","0","4","2","2","0","0","0","0","0","0","0","0","0","-2"
"125763","Whittier College","2019","Not on tenure/no tenure system, associate professors","3","2","1","0","0","0","0","0","0","0","0","0","1","1","0","0","0","0","2","1","1","0","0","0","0","0","0","0","0","0","-2"
"125763","Whittier College","2019","Not on tenure/no tenure system, assistant professors","18","10","8","0","0","0","3","0","3","0","0","0","4","4","0","0","0","0","11","6","5","0","0","0","0","0","0","0","0","0","-2"
"125763","Whittier College","2019","Not on tenure/no tenure system, instructors","7","3","4","0","0","0","0","0","0","0","0","0","0","0","0","0","0","0","6","3","3","0","0","0","1","0","1","0","0","0","-2"
"125763","Whittier College","2019","Not on tenure/no tenure system, lecturers","5","3","2","0","0","0","2","2","0","0","0","0","2","0","2","0","0","0","1","1","0","0","0","0","0","0","0","0","0","0","-2"
"125897","Woodbury University","2019","Not on tenure track/No tenure system system total","67","39","28","2","0","2","8","4","4","1","0","1","3","3","0","0","0","0","47","28","19","0","0","0","6","4","2","0","0","0","-2"
"125897","Woodbury University","2019","Not on tenure/no tenure system, professors","27","17","10","0","0","0","4","3","1","0","0","0","1","1","0","0","0","0","22","13","9","0","0","0","0","0","0","0","0","0","-2"
"125897","Woodbury University","2019","Not on tenure/no tenure system, associate professors","28","15","13","1","0","1","3","0","3","1","0","1","2","2","0","0","0","0","17","10","7","0","0","0","4","3","1","0","0","0","-2"
"125897","Woodbury University","2019","Not on tenure/no tenure system, assistant professors","12","7","5","1","0","1","1","1","0","0","0","0","0","0","0","0","0","0","8","5","3","0","0","0","2","1","1","0","0","0","-2"
"126182","Adams State University","2019","Tenured total","38","19","19","0","0","0","0","0","0","0","0","0","6","2","4","1","0","1","31","17","14","0","0","0","0","0","0","0","0","0","-2"
"126182","Adams State University","2019","Tenured, professors","22","11","11","0","0","0","0","0","0","0","0","0","2","1","1","0","0","0","20","10","10","0","0","0","0","0","0","0","0","0","-2"
"126182","Adams State University","2019","Tenured, associate professors","12","5","7","0","0","0","0","0","0","0","0","0","2","0","2","1","0","1","9","5","4","0","0","0","0","0","0","0","0","0","-2"
"126182","Adams State University","2019","Tenured, assistant professors","4","3","1","0","0","0","0","0","0","0","0","0","2","1","1","0","0","0","2","2","0","0","0","0","0","0","0","0","0","0","-2"
"126182","Adams State University","2019","On-Tenure track total","15","6","9","0","0","0","0","0","0","0","0","0","2","1","1","0","0","0","13","5","8","0","0","0","0","0","0","0","0","0","-2"
"126182","Adams State University","2019","On-tenure track, associate professors","1","0","1","0","0","0","0","0","0","0","0","0","1","0","1","0","0","0","0","0","0","0","0","0","0","0","0","0","0","0","-2"
"126182","Adams State University","2019","On-tenure track, assistant professors","13","5","8","0","0","0","0","0","0","0","0","0","1","1","0","0","0","0","12","4","8","0","0","0","0","0","0","0","0","0","-2"
"126182","Adams State University","2019","On-tenure track, no academic rank","1","1","0","0","0","0","0","0","0","0","0","0","0","0","0","0","0","0","1","1","0","0","0","0","0","0","0","0","0","0","-2"
"126182","Adams State University","2019","Not on tenure track/No tenure system system total","50","21","29","0","0","0","1","1","0","1","0","1","9","3","6","1","1","0","35","14","21","0","0","0","3","2","1","0","0","0","-2"
"126182","Adams State University","2019","Not on tenure/no tenure system, assistant professors","1","1","0","0","0","0","0","0","0","0","0","0","0","0","0","0","0","0","1","1","0","0","0","0","0","0","0","0","0","0","-2"
"126182","Adams State University","2019","Not on tenure/no tenure system, no academic rank","49","20","29","0","0","0","1","1","0","1","0","1","9","3","6","1","1","0","34","13","21","0","0","0","3","2","1","0","0","0","-2"
"126562","University of Colorado Denver/Anschutz Medical Campus","2019","Tenured total","603","399","204","4","2","2","56","39","17","6","4","2","33","22","11","0","0","0","481","319","162","1","0","1","21","12","9","1","1","0","-2"
"126562","University of Colorado Denver/Anschutz Medical Campus","2019","Tenured, professors","391","263","128","2","1","1","33","23","10","3","3","0","14","9","5","0","0","0","327","222","105","1","0","1","11","5","6","0","0","0","-2"
"126562","University of Colorado Denver/Anschutz Medical Campus","2019","Tenured, associate professors","212","136","76","2","1","1","23","16","7","3","1","2","19","13","6","0","0","0","154","97","57","0","0","0","10","7","3","1","1","0","-2"
"126562","University of Colorado Denver/Anschutz Medical Campus","2019","On-Tenure track total","2003","954","1049","5","3","2","185","83","102","28","11","17","99","47","52","4","1","3","1289","613","676","13","6","7","360","179","181","20","11","9","-2"
"126562","University of Colorado Denver/Anschutz Medical Campus","2019","On-tenure track, professors","270","180","90","2","2","0","20","16","4","0","0","0","12","8","4","0","0","0","202","131","71","3","0","3","31","23","8","0","0","0","-2"
"126562","University of Colorado Denver/Anschutz Medical Campus","2019","On-tenure track, associate professors","628","312","316","2","1","1","58","26","32","9","4","5","34","14","20","3","1","2","447","224","223","4","3","1","70","38","32","1","1","0","-2"
"126562","University of Colorado Denver/Anschutz Medical Campus","2019","On-tenure track, assistant professors","1105","462","643","1","0","1","107","41","66","19","7","12","53","25","28","1","0","1","640","258","382","6","3","3","259","118","141","19","10","9","-2"
"126562","University of Colorado Denver/Anschutz Medical Campus","2019","Not on tenure track/No tenure system system total","1875","529","1346","4","1","3","76","30","46","24","6","18","85","29","56","0","0","0","1237","321","916","12","3","9","426","133","293","11","6","5","-2"
"126562","University of Colorado Denver/Anschutz Medical Campus","2019","Not on tenure/no tenure system, professors","15","5","10","0","0","0","0","0","0","0","0","0","0","0","0","0","0","0","15","5","10","0","0","0","0","0","0","0","0","0","-2"
"126562","University of Colorado Denver/Anschutz Medical Campus","2019","Not on tenure/no tenure system, associate professors","75","35","40","0","0","0","10","2","8","1","0","1","7","5","2","0","0","0","51","22","29","1","1","0","5","5","0","0","0","0","-2"
"126562","University of Colorado Denver/Anschutz Medical Campus","2019","Not on tenure/no tenure system, assistant professors","116","38","78","1","0","1","9","4","5","3","1","2","5","3","2","0","0","0","88","25","63","0","0","0","8","3","5","2","2","0","-2"
"126562","University of Colorado Denver/Anschutz Medical Campus","2019","Not on tenure/no tenure system, instructors","1669","451","1218","3","1","2","57","24","33","20","5","15","73","21","52","0","0","0","1083","269","814","11","2","9","413","125","288","9","4","5","-2"
"126711","Colorado Mountain College","2019","Not on tenure track/No tenure system system total","117","59","58","0","0","0","2","1","1","1","1","0","5","2","3","0","0","0","103","52","51","1","1","0","4","1","3","1","1","0","-2"
"126711","Colorado Mountain College","2019","Not on tenure/no tenure system, professors","50","26","24","0","0","0","1","1","0","0","0","0","1","1","0","0","0","0","47","24","23","0","0","0","1","0","1","0","0","0","-2"
"126711","Colorado Mountain College","2019","Not on tenure/no tenure system, associate professors","44","20","24","0","0","0","1","0","1","0","0","0","4","1","3","0","0","0","35","17","18","1","1","0","3","1","2","0","0","0","-2"
"126711","Colorado Mountain College","2019","Not on tenure/no tenure system, assistant professors","23","13","10","0","0","0","0","0","0","1","1","0","0","0","0","0","0","0","21","11","10","0","0","0","0","0","0","1","1","0","-2"
"126942","Community College of Denver","2019","Not on tenure track/No tenure system system total","111","55","56","2","2","0","6","2","4","6","4","2","5","2","3","0","0","0","91","45","46","0","0","0","1","0","1","0","0","0","-2"
"126942","Community College of Denver","2019","Not on tenure/no tenure system, professors","39","20","19","0","0","0","4","2","2","2","1","1","0","0","0","0","0","0","33","17","16","0","0","0","0","0","0","0","0","0","-2"
"126942","Community College of Denver","2019","Not on tenure/no tenure system, associate professors","30","14","16","0","0","0","1","0","1","2","2","0","1","0","1","0","0","0","26","12","14","0","0","0","0","0","0","0","0","0","-2"
"126942","Community College of Denver","2019","Not on tenure/no tenure system, assistant professors","5","4","1","0","0","0","0","0","0","0","0","0","0","0","0","0","0","0","5","4","1","0","0","0","0","0","0","0","0","0","-2"
"126942","Community College of Denver","2019","Not on tenure/no tenure system, instructors","37","17","20","2","2","0","1","0","1","2","1","1","4","2","2","0","0","0","27","12","15","0","0","0","1","0","1","0","0","0","-2"
"127617","Morgan Community College","2019","Not on tenure track/No tenure system system total","38","21","17","0","0","0","0","0","0","0","0","0","2","0","2","0","0","0","34","20","14","1","0","1","0","0","0","1","1","0","-2"
"127617","Morgan Community College","2019","Not on tenure/no tenure system, no academic rank","38","21","17","0","0","0","0","0","0","0","0","0","2","0","2","0","0","0","34","20","14","1","0","1","0","0","0","1","1","0","-2"
"127884","Pueblo Community College","2019","Not on tenure track/No tenure system system total","89","39","50","1","0","1","2","1","1","1","0","1","9","4","5","0","0","0","75","33","42","0","0","0","1","1","0","0","0","0","-2"
"127884","Pueblo Community College","2019","Not on tenure/no tenure system, no academic rank","89","39","50","1","0","1","2","1","1","1","0","1","9","4","5","0","0","0","75","33","42","0","0","0","1","1","0","0","0","0","-2"
"128106","Colorado State University Pueblo","2019","Tenured total","82","54","28","0","0","0","4","3","1","3","2","1","11","5","6","0","0","0","57","40","17","1","0","1","6","4","2","0","0","0","-2"
"128106","Colorado State University Pueblo","2019","Tenured, professors","42","31","11","0","0","0","3","2","1","2","2","0","4","3","1","0","0","0","31","22","9","0","0","0","2","2","0","0","0","0","-2"
"128106","Colorado State University Pueblo","2019","Tenured, associate professors","35","20","15","0","0","0","1","1","0","0","0","0","6","1","5","0","0","0","23","16","7","1","0","1","4","2","2","0","0","0","-2"
"128106","Colorado State University Pueblo","2019","Tenured, assistant professors","5","3","2","0","0","0","0","0","0","1","0","1","1","1","0","0","0","0","3","2","1","0","0","0","0","0","0","0","0","0","-2"
"128106","Colorado State University Pueblo","2019","On-Tenure track total","35","17","18","0","0","0","2","1","1","0","0","0","2","0","2","0","0","0","25","11","14","0","0","0","1","0","1","5","5","0","-2"
"128106","Colorado State University Pueblo","2019","On-tenure track, assistant professors","35","17","18","0","0","0","2","1","1","0","0","0","2","0","2","0","0","0","25","11","14","0","0","0","1","0","1","5","5","0","-2"
"128106","Colorado State University Pueblo","2019","Not on tenure track/No tenure system system total","47","23","24","0","0","0","4","3","1","1","0","1","5","3","2","0","0","0","36","17","19","0","0","0","1","0","1","0","0","0","-2"
"128106","Colorado State University Pueblo","2019","Not on tenure/no tenure system, assistant professors","16","8","8","0","0","0","2","2","0","1","0","1","1","1","0","0","0","0","12","5","7","0","0","0","0","0","0","0","0","0","-2"
"128106","Colorado State University Pueblo","2019","Not on tenure/no tenure system, instructors","1","0","1","0","0","0","0","0","0","0","0","0","0","0","0","0","0","0","1","0","1","0","0","0","0","0","0","0","0","0","-2"
"128106","Colorado State University Pueblo","2019","Not on tenure/no tenure system, lecturers","26","11","15","0","0","0","1","0","1","0","0","0","4","2","2","0","0","0","20","9","11","0","0","0","1","0","1","0","0","0","-2"
"128106","Colorado State University Pueblo","2019","Not on tenure/no tenure system, no academic rank","4","4","0","0","0","0","1","1","0","0","0","0","0","0","0","0","0","0","3","3","0","0","0","0","0","0","0","0","0","0","-2"
"128744","University of Bridgeport","2019","Tenured total","69","44","25","0","0","0","12","9","3","3","2","1","0","0","0","0","0","0","53","32","21","1","1","0","0","0","0","0","0","0","-2"
"128744","University of Bridgeport","2019","Tenured, professors","21","15","6","0","0","0","6","4","2","0","0","0","0","0","0","0","0","0","15","11","4","0","0","0","0","0","0","0","0","0","-2"
"128744","University of Bridgeport","2019","Tenured, associate professors","41","27","14","0","0","0","6","5","1","2","2","0","0","0","0","0","0","0","32","19","13","1","1","0","0","0","0","0","0","0","-2"
"128744","University of Bridgeport","2019","Tenured, assistant professors","5","1","4","0","0","0","0","0","0","1","0","1","0","0","0","0","0","0","4","1","3","0","0","0","0","0","0","0","0","0","-2"
"128744","University of Bridgeport","2019","Tenured, no academic rank","2","1","1","0","0","0","0","0","0","0","0","0","0","0","0","0","0","0","2","1","1","0","0","0","0","0","0","0","0","0","-2"
"128744","University of Bridgeport","2019","On-Tenure track total","39","13","26","0","0","0","5","1","4","2","1","1","2","0","2","0","0","0","30","11","19","0","0","0","0","0","0","0","0","0","-2"
"128744","University of Bridgeport","2019","On-tenure track, professors","1","0","1","0","0","0","0","0","0","0","0","0","0","0","0","0","0","0","1","0","1","0","0","0","0","0","0","0","0","0","-2"
"128744","University of Bridgeport","2019","On-tenure track, associate professors","8","2","6","0","0","0","0","0","0","0","0","0","0","0","0","0","0","0","8","2","6","0","0","0","0","0","0","0","0","0","-2"
"128744","University of Bridgeport","2019","On-tenure track, assistant professors","24","8","16","0","0","0","5","1","4","1","0","1","1","0","1","0","0","0","17","7","10","0","0","0","0","0","0","0","0","0","-2"
"128744","University of Bridgeport","2019","On-tenure track, lecturers","1","0","1","0","0","0","0","0","0","0","0","0","0","0","0","0","0","0","1","0","1","0","0","0","0","0","0","0","0","0","-2"
"128744","University of Bridgeport","2019","On-tenure track, no academic rank","5","3","2","0","0","0","0","0","0","1","1","0","1","0","1","0","0","0","3","2","1","0","0","0","0","0","0","0","0","0","-2"
"128744","University of Bridgeport","2019","Not on tenure track/No tenure system system total","41","21","20","0","0","0","3","1","2","0","0","0","2","2","0","0","0","0","35","18","17","0","0","0","1","0","1","0","0","0","-2"
"128744","University of Bridgeport","2019","Not on tenure/no tenure system, associate professors","4","3","1","0","0","0","0","0","0","0","0","0","0","0","0","0","0","0","4","3","1","0","0","0","0","0","0","0","0","0","-2"
"128744","University of Bridgeport","2019","Not on tenure/no tenure system, assistant professors","11","4","7","0","0","0","1","0","1","0","0","0","2","2","0","0","0","0","8","2","6","0","0","0","0","0","0","0","0","0","-2"
"128744","University of Bridgeport","2019","Not on tenure/no tenure system, lecturers","18","11","7","0","0","0","2","1","1","0","0","0","0","0","0","0","0","0","16","10","6","0","0","0","0","0","0","0","0","0","-2"
"128744","University of Bridgeport","2019","Not on tenure/no tenure system, no academic rank","8","3","5","0","0","0","0","0","0","0","0","0","0","0","0","0","0","0","7","3","4","0","0","0","1","0","1","0","0","0","-2"
"131876","Trinity Washington University","2019","Tenured total","24","7","17","0","0","0","4","2","2","6","2","4","1","0","1","0","0","0","13","3","10","0","0","0","0","0","0","0","0","0","-2"
"131876","Trinity Washington University","2019","Tenured, professors","3","0","3","0","0","0","0","0","0","0","0","0","0","0","0","0","0","0","3","0","3","0","0","0","0","0","0","0","0","0","-2"
"131876","Trinity Washington University","2019","Tenured, associate professors","21","7","14","0","0","0","4","2","2","6","2","4","1","0","1","0","0","0","10","3","7","0","0","0","0","0","0","0","0","0","-2"
"131876","Trinity Washington University","2019","On-Tenure track total","15","3","12","0","0","0","1","0","1","9","2","7","1","0","1","0","0","0","4","1","3","0","0","0","0","0","0","0","0","0","-2"
"131876","Trinity Washington University","2019","On-tenure track, associate professors","3","1","2","0","0","0","0","0","0","1","1","0","0","0","0","0","0","0","2","0","2","0","0","0","0","0","0","0","0","0","-2"
"131876","Trinity Washington University","2019","On-tenure track, assistant professors","12","2","10","0","0","0","1","0","1","8","1","7","1","0","1","0","0","0","2","1","1","0","0","0","0","0","0","0","0","0","-2"
"131876","Trinity Washington University","2019","Not on tenure track/No tenure system system total","21","7","14","0","0","0","1","0","1","10","3","7","0","0","0","0","0","0","8","4","4","2","0","2","0","0","0","0","0","0","-2"
"131876","Trinity Washington University","2019","Not on tenure/no tenure system, assistant professors","21","7","14","0","0","0","1","0","1","10","3","7","0","0","0","0","0","0","8","4","4","2","0","2","0","0","0","0","0","0","-2"
"132471","Barry University","2019","Tenured total","17","8","9","2","0","2","1","0","1","1","1","0","0","0","0","0","0","0","13","7","6","0","0","0","0","0","0","0","0","0","-2"
"132471","Barry University","2019","Tenured, professors","8","5","3","0","0","0","0","0","0","1","1","0","0","0","0","0","0","0","7","4","3","0","0","0","0","0","0","0","0","0","-2"
"132471","Barry University","2019","Tenured, associate professors","9","3","6","2","0","2","1","0","1","0","0","0","0","0","0","0","0","0","6","3","3","0","0","0","0","0","0","0","0","0","-2"
"132471","Barry University","2019","On-Tenure track total","11","5","6","1","0","1","1","1","0","2","1","1","1","0","1","0","0","0","3","1","2","0","0","0","2","1","1","1","1","0","-2"
"132471","Barry University","2019","On-tenure track, associate professors","4","2","2","1","0","1","0","0","0","0","0","0","0","0","0","0","0","0","1","1","0","0","0","0","2","1","1","0","0","0","-2"
"132471","Barry University","2019","On-tenure track, assistant professors","7","3","4","0","0","0","1","1","0","2","1","1","1","0","1","0","0","0","2","0","2","0","0","0","0","0","0","1","1","0","-2"
"132471","Barry University","2019","Not on tenure track/No tenure system system total","275","117","158","1","0","1","17","9","8","26","5","21","48","22","26","0","0","0","155","72","83","1","0","1","21","6","15","6","3","3","-2"
"132471","Barry University","2019","Not on tenure/no tenure system, professors","69","41","28","0","0","0","5","5","0","1","1","0","12","5","7","0","0","0","49","29","20","0","0","0","2","1","1","0","0","0","-2"
"132471","Barry University","2019","Not on tenure/no tenure system, associate professors","86","34","52","1","0","1","6","3","3","7","0","7","12","6","6","0","0","0","51","21","30","0","0","0","8","3","5","1","1","0","-2"
"132471","Barry University","2019","Not on tenure/no tenure system, assistant professors","97","32","65","0","0","0","6","1","5","15","3","12","14","6","8","0","0","0","47","18","29","1","0","1","9","2","7","5","2","3","-2"
"132471","Barry University","2019","Not on tenure/no tenure system, instructors","23","10","13","0","0","0","0","0","0","3","1","2","10","5","5","0","0","0","8","4","4","0","0","0","2","0","2","0","0","0","-2"
"132709","Broward College","2019","Tenured total","283","133","150","5","0","5","16","12","4","46","14","32","61","30","31","0","0","0","141","67","74","0","0","0","14","10","4","0","0","0","-2"
"132709","Broward College","2019","Tenured, professors","51","30","21","1","0","1","6","4","2","3","1","2","9","6","3","0","0","0","31","18","13","0","0","0","1","1","0","0","0","0","-2"
"132709","Broward College","2019","Tenured, associate professors","30","9","21","1","0","1","1","0","1","7","1","6","7","3","4","0","0","0","12","4","8","0","0","0","2","1","1","0","0","0","-2"
"132709","Broward College","2019","Tenured, assistant professors","186","87","99","3","0","3","9","8","1","34","12","22","40","18","22","0","0","0","89","41","48","0","0","0","11","8","3","0","0","0","-2"
"132709","Broward College","2019","Tenured, instructors","16","7","9","0","0","0","0","0","0","2","0","2","5","3","2","0","0","0","9","4","5","0","0","0","0","0","0","0","0","0","-2"
"132709","Broward College","2019","On-Tenure track total","80","31","49","0","0","0","3","1","2","11","1","10","9","5","4","0","0","0","44","21","23","0","0","0","13","3","10","0","0","0","-2"
"132709","Broward College","2019","On-tenure track, assistant professors","72","26","46","0","0","0","3","1","2","11","1","10","7","3","4","0","0","0","39","19","20","0","0","0","12","2","10","0","0","0","-2"
"132709","Broward College","2019","On-tenure track, instructors","8","5","3","0","0","0","0","0","0","0","0","0","2","2","0","0","0","0","5","2","3","0","0","0","1","1","0","0","0","0","-2"
"132903","University of Central Florida","2019","Tenured total","700","478","222","4","4","0","138","109","29","28","15","13","40","24","16","0","0","0","479","320","159","2","1","1","0","0","0","9","5","4","-2"
"132903","University of Central Florida","2019","Tenured, professors","334","251","83","1","1","0","71","61","10","10","6","4","20","14","6","0","0","0","229","168","61","1","0","1","0","0","0","2","1","1","-2"
"132903","University of Central Florida","2019","Tenured, associate professors","364","225","139","3","3","0","67","48","19","18","9","9","20","10","10","0","0","0","248","150","98","1","1","0","0","0","0","7","4","3","-2"
"132903","University of Central Florida","2019","Tenured, assistant professors","2","2","0","0","0","0","0","0","0","0","0","0","0","0","0","0","0","0","2","2","0","0","0","0","0","0","0","0","0","0","-2"
"132903","University of Central Florida","2019","On-Tenure track total","356","205","151","0","0","0","68","46","22","16","6","10","26","17","9","0","0","0","196","104","92","4","2","2","0","0","0","46","30","16","-2"
"132903","University of Central Florida","2019","On-tenure track, associate professors","9","7","2","0","0","0","1","1","0","0","0","0","0","0","0","0","0","0","8","6","2","0","0","0","0","0","0","0","0","0","-2"
"132903","University of Central Florida","2019","On-tenure track, assistant professors","347","198","149","0","0","0","67","45","22","16","6","10","26","17","9","0","0","0","188","98","90","4","2","2","0","0","0","46","30","16","-2"
"132903","University of Central Florida","2019","Not on tenure track/No tenure system system total","568","250","318","0","0","0","35","16","19","23","7","16","55","17","38","0","0","0","432","196","236","7","3","4","0","0","0","16","11","5","-2"
"132903","University of Central Florida","2019","Not on tenure/no tenure system, professors","12","8","4","0","0","0","4","4","0","0","0","0","1","0","1","0","0","0","7","4","3","0","0","0","0","0","0","0","0","0","-2"
"132903","University of Central Florida","2019","Not on tenure/no tenure system, associate professors","23","9","14","0","0","0","2","0","2","1","0","1","5","1","4","0","0","0","13","7","6","0","0","0","0","0","0","2","1","1","-2"
"132903","University of Central Florida","2019","Not on tenure/no tenure system, assistant professors","41","18","23","0","0","0","7","3","4","0","0","0","1","0","1","0","0","0","29","12","17","0","0","0","0","0","0","4","3","1","-2"
"132903","University of Central Florida","2019","Not on tenure/no tenure system, instructors","215","83","132","0","0","0","6","2","4","7","3","4","23","6","17","0","0","0","176","71","105","2","0","2","0","0","0","1","1","0","-2"
"132903","University of Central Florida","2019","Not on tenure/no tenure system, lecturers","277","132","145","0","0","0","16","7","9","15","4","11","25","10","15","0","0","0","207","102","105","5","3","2","0","0","0","9","6","3","-2"
"133508","Florida SouthWestern State College","2019","Tenured total","104","49","55","2","1","1","4","2","2","6","2","4","4","3","1","0","0","0","84","38","46","0","0","0","1","1","0","3","2","1","-2"
"133508","Florida SouthWestern State College","2019","Tenured, no academic rank","104","49","55","2","1","1","4","2","2","6","2","4","4","3","1","0","0","0","84","38","46","0","0","0","1","1","0","3","2","1","-2"
"133508","Florida SouthWestern State College","2019","On-Tenure track total","79","36","43","0","0","0","4","3","1","4","1","3","2","1","1","0","0","0","66","29","37","1","0","1","1","1","0","1","1","0","-2"
"133508","Florida SouthWestern State College","2019","On-tenure track, no academic rank","79","36","43","0","0","0","4","3","1","4","1","3","2","1","1","0","0","0","66","29","37","1","0","1","1","1","0","1","1","0","-2"
"133508","Florida SouthWestern State College","2019","Not on tenure track/No tenure system system total","11","5","6","0","0","0","0","0","0","0","0","0","0","0","0","0","0","0","11","5","6","0","0","0","0","0","0","0","0","0","-2"
"133508","Florida SouthWestern State College","2019","Not on tenure/no tenure system, no academic rank","11","5","6","0","0","0","0","0","0","0","0","0","0","0","0","0","0","0","11","5","6","0","0","0","0","0","0","0","0","0","-2"
"133669","Florida Atlantic University","2019","Tenured total","429","272","157","0","0","0","73","59","14","23","8","15","29","17","12","0","0","0","298","185","113","1","0","1","0","0","0","5","3","2","-2"
"133669","Florida Atlantic University","2019","Tenured, professors","240","172","68","0","0","0","44","39","5","10","5","5","16","9","7","0","0","0","167","117","50","1","0","1","0","0","0","2","2","0","-2"
"133669","Florida Atlantic University","2019","Tenured, associate professors","189","100","89","0","0","0","29","20","9","13","3","10","13","8","5","0","0","0","131","68","63","0","0","0","0","0","0","3","1","2","-2"
"133669","Florida Atlantic University","2019","On-Tenure track total","176","96","80","0","0","0","20","18","2","8","4","4","12","7","5","0","0","0","110","48","62","1","0","1","0","0","0","25","19","6","-2"
"133669","Florida Atlantic University","2019","On-tenure track, professors","2","2","0","0","0","0","0","0","0","0","0","0","0","0","0","0","0","0","2","2","0","0","0","0","0","0","0","0","0","0","-2"
"133669","Florida Atlantic University","2019","On-tenure track, associate professors","16","10","6","0","0","0","4","4","0","1","1","0","0","0","0","0","0","0","10","4","6","0","0","0","0","0","0","1","1","0","-2"
"133669","Florida Atlantic University","2019","On-tenure track, assistant professors","158","84","74","0","0","0","16","14","2","7","3","4","12","7","5","0","0","0","98","42","56","1","0","1","0","0","0","24","18","6","-2"
"133669","Florida Atlantic University","2019","Not on tenure track/No tenure system system total","282","116","166","1","1","0","19","4","15","33","12","21","30","8","22","0","0","0","194","89","105","0","0","0","0","0","0","5","2","3","-2"
"133669","Florida Atlantic University","2019","Not on tenure/no tenure system, professors","7","4","3","0","0","0","1","1","0","0","0","0","0","0","0","0","0","0","6","3","3","0","0","0","0","0","0","0","0","0","-2"
"133669","Florida Atlantic University","2019","Not on tenure/no tenure system, associate professors","15","8","7","0","0","0","3","1","2","0","0","0","3","1","2","0","0","0","9","6","3","0","0","0","0","0","0","0","0","0","-2"
"133669","Florida Atlantic University","2019","Not on tenure/no tenure system, assistant professors","35","15","20","0","0","0","4","0","4","6","2","4","3","2","1","0","0","0","21","11","10","0","0","0","0","0","0","1","0","1","-2"
"133669","Florida Atlantic University","2019","Not on tenure/no tenure system, instructors","224","89","135","1","1","0","11","2","9","27","10","17","24","5","19","0","0","0","157","69","88","0","0","0","0","0","0","4","2","2","-2"
"133669","Florida Atlantic University","2019","Not on tenure/no tenure system, lecturers","1","0","1","0","0","0","0","0","0","0","0","0","0","0","0","0","0","0","1","0","1","0","0","0","0","0","0","0","0","0","-2"
"133872","AdventHealth University","2019","Not on tenure track/No tenure system system total","91","25","66","0","0","0","5","0","5","17","6","11","8","3","5","0","0","0","59","16","43","2","0","2","0","0","0","0","0","0","-2"
"133872","AdventHealth University","2019","Not on tenure/no tenure system, professors","14","6","8","0","0","0","0","0","0","5","1","4","2","2","0","0","0","0","7","3","4","0","0","0","0","0","0","0","0","0","-2"
"133872","AdventHealth University","2019","Not on tenure/no tenure system, associate professors","27","4","23","0","0","0","3","0","3","4","2","2","3","0","3","0","0","0","16","2","14","1","0","1","0","0","0","0","0","0","-2"
"133872","AdventHealth University","2019","Not on tenure/no tenure system, assistant professors","37","12","25","0","0","0","2","0","2","7","3","4","2","1","1","0","0","0","25","8","17","1","0","1","0","0","0","0","0","0","-2"
"133872","AdventHealth University","2019","Not on tenure/no tenure system, instructors","13","3","10","0","0","0","0","0","0","1","0","1","1","0","1","0","0","0","11","3","8","0","0","0","0","0","0","0","0","0","-2"
"133960","The College of the Florida Keys","2019","Tenured total","7","1","6","0","0","0","0","0","0","0","0","0","1","0","1","0","0","0","5","1","4","0","0","0","1","0","1","0","0","0","-2"
"133960","The College of the Florida Keys","2019","Tenured, professors","5","1","4","0","0","0","0","0","0","0","0","0","1","0","1","0","0","0","3","1","2","0","0","0","1","0","1","0","0","0","-2"
"133960","The College of the Florida Keys","2019","Tenured, associate professors","2","0","2","0","0","0","0","0","0","0","0","0","0","0","0","0","0","0","2","0","2","0","0","0","0","0","0","0","0","0","-2"
"133960","The College of the Florida Keys","2019","On-Tenure track total","19","10","9","0","0","0","0","0","0","1","1","0","2","2","0","0","0","0","14","5","9","0","0","0","2","2","0","0","0","0","-2"
"133960","The College of the Florida Keys","2019","On-tenure track, professors","5","4","1","0","0","0","0","0","0","1","1","0","0","0","0","0","0","0","3","2","1","0","0","0","1","1","0","0","0","0","-2"
"133960","The College of the Florida Keys","2019","On-tenure track, associate professors","8","3","5","0","0","0","0","0","0","0","0","0","2","2","0","0","0","0","5","0","5","0","0","0","1","1","0","0","0","0","-2"
"133960","The College of the Florida Keys","2019","On-tenure track, assistant professors","5","2","3","0","0","0","0","0","0","0","0","0","0","0","0","0","0","0","5","2","3","0","0","0","0","0","0","0","0","0","-2"
"133960","The College of the Florida Keys","2019","On-tenure track, instructors","1","1","0","0","0","0","0","0","0","0","0","0","0","0","0","0","0","0","1","1","0","0","0","0","0","0","0","0","0","0","-2"
"134608","Indian River State College","2019","Tenured total","151","75","76","2","0","2","7","4","3","18","8","10","8","2","6","1","0","1","114","60","54","1","1","0","0","0","0","0","0","0","-2"
"134608","Indian River State College","2019","Tenured, professors","37","17","20","1","0","1","4","2","2","5","2","3","0","0","0","1","0","1","26","13","13","0","0","0","0","0","0","0","0","0","-2"
"134608","Indian River State College","2019","Tenured, associate professors","47","28","19","0","0","0","1","1","0","5","4","1","4","1","3","0","0","0","36","21","15","1","1","0","0","0","0","0","0","0","-2"
"134608","Indian River State College","2019","Tenured, assistant professors","47","22","25","0","0","0","2","1","1","4","1","3","3","0","3","0","0","0","38","20","18","0","0","0","0","0","0","0","0","0","-2"
"134608","Indian River State College","2019","Tenured, no academic rank","20","8","12","1","0","1","0","0","0","4","1","3","1","1","0","0","0","0","14","6","8","0","0","0","0","0","0","0","0","0","-2"
"134608","Indian River State College","2019","On-Tenure track total","68","29","39","0","0","0","2","1","1","8","2","6","4","1","3","0","0","0","53","25","28","1","0","1","0","0","0","0","0","0","-2"
"134608","Indian River State College","2019","On-tenure track, associate professors","2","1","1","0","0","0","0","0","0","0","0","0","0","0","0","0","0","0","2","1","1","0","0","0","0","0","0","0","0","0","-2"
"134608","Indian River State College","2019","On-tenure track, assistant professors","23","9","14","0","0","0","0","0","0","4","1","3","1","1","0","0","0","0","18","7","11","0","0","0","0","0","0","0","0","0","-2"
"134608","Indian River State College","2019","On-tenure track, no academic rank","43","19","24","0","0","0","2","1","1","4","1","3","3","0","3","0","0","0","33","17","16","1","0","1","0","0","0","0","0","0","-2"
"134608","Indian River State College","2019","Not on tenure track/No tenure system system total","27","10","17","0","0","0","0","0","0","3","2","1","2","2","0","0","0","0","21","6","15","1","0","1","0","0","0","0","0","0","-2"
"134608","Indian River State College","2019","Not on tenure/no tenure system, assistant professors","2","1","1","0","0","0","0","0","0","0","0","0","0","0","0","0","0","0","2","1","1","0","0","0","0","0","0","0","0","0","-2"
"134608","Indian River State College","2019","Not on tenure/no tenure system, no academic rank","25","9","16","0","0","0","0","0","0","3","2","1","2","2","0","0","0","0","19","5","14","1","0","1","0","0","0","0","0","0","-2"
"135081","Keiser University-Ft Lauderdale","2019","Not on tenure track/No tenure system system total","1253","467","786","2","2","0","61","25","36","172","52","120","179","82","97","2","1","1","806","292","514","31","13","18","0","0","0","0","0","0","-2"
"135081","Keiser University-Ft Lauderdale","2019","Not on tenure/no tenure system, instructors","1253","467","786","2","2","0","61","25","36","172","52","120","179","82","97","2","1","1","806","292","514","31","13","18","0","0","0","0","0","0","-2"
"135717","Miami Dade College","2019","Tenured total","537","266","271","1","0","1","21","12","9","80","30","50","255","130","125","0","0","0","171","91","80","6","1","5","3","2","1","0","0","0","-2"
"135717","Miami Dade College","2019","Tenured, professors","164","82","82","0","0","0","8","5","3","19","10","9","81","38","43","0","0","0","52","27","25","3","1","2","1","1","0","0","0","0","-2"
"135717","Miami Dade College","2019","Tenured, associate professors","261","130","131","0","0","0","10","5","5","38","15","23","123","59","64","0","0","0","86","50","36","2","0","2","2","1","1","0","0","0","-2"
"135717","Miami Dade College","2019","Tenured, assistant professors","102","48","54","1","0","1","3","2","1","23","5","18","43","28","15","0","0","0","31","13","18","1","0","1","0","0","0","0","0","0","-2"
"135717","Miami Dade College","2019","Tenured, instructors","10","6","4","0","0","0","0","0","0","0","0","0","8","5","3","0","0","0","2","1","1","0","0","0","0","0","0","0","0","0","-2"
"135717","Miami Dade College","2019","On-Tenure track total","171","78","93","0","0","0","8","3","5","35","10","25","70","38","32","0","0","0","52","27","25","5","0","5","1","0","1","0","0","0","-2"
"135717","Miami Dade College","2019","On-tenure track, professors","14","5","9","0","0","0","1","0","1","3","0","3","2","0","2","0","0","0","8","5","3","0","0","0","0","0","0","0","0","0","-2"
"135717","Miami Dade College","2019","On-tenure track, associate professors","6","1","5","0","0","0","0","0","0","1","0","1","2","1","1","0","0","0","3","0","3","0","0","0","0","0","0","0","0","0","-2"
"135717","Miami Dade College","2019","On-tenure track, assistant professors","59","26","33","0","0","0","1","1","0","13","4","9","25","13","12","0","0","0","17","8","9","2","0","2","1","0","1","0","0","0","-2"
"135717","Miami Dade College","2019","On-tenure track, instructors","92","46","46","0","0","0","6","2","4","18","6","12","41","24","17","0","0","0","24","14","10","3","0","3","0","0","0","0","0","0","-2"
"136215","Nova Southeastern University","2019","Tenured total","29","16","13","0","0","0","1","1","0","4","2","2","2","1","1","0","0","0","22","12","10","0","0","0","0","0","0","0","0","0","-2"
"136215","Nova Southeastern University","2019","Tenured, professors","28","15","13","0","0","0","1","1","0","3","1","2","2","1","1","0","0","0","22","12","10","0","0","0","0","0","0","0","0","0","-2"
"136215","Nova Southeastern University","2019","Tenured, associate professors","1","1","0","0","0","0","0","0","0","1","1","0","0","0","0","0","0","0","0","0","0","0","0","0","0","0","0","0","0","0","-2"
"136215","Nova Southeastern University","2019","Not on tenure track/No tenure system system total","801","358","443","1","0","1","70","38","32","55","13","42","134","47","87","3","2","1","500","240","260","7","1","6","9","4","5","22","13","9","-2"
"136215","Nova Southeastern University","2019","Not on tenure/no tenure system, professors","170","97","73","0","0","0","22","16","6","6","4","2","20","9","11","2","1","1","117","66","51","1","0","1","1","0","1","1","1","0","-2"
"136215","Nova Southeastern University","2019","Not on tenure/no tenure system, associate professors","264","120","144","0","0","0","16","8","8","21","4","17","37","12","25","1","1","0","184","92","92","1","0","1","0","0","0","4","3","1","-2"
"136215","Nova Southeastern University","2019","Not on tenure/no tenure system, assistant professors","329","130","199","1","0","1","29","13","16","25","5","20","68","22","46","0","0","0","182","80","102","3","0","3","6","3","3","15","7","8","-2"
"136215","Nova Southeastern University","2019","Not on tenure/no tenure system, instructors","35","11","24","0","0","0","3","1","2","3","0","3","8","4","4","0","0","0","15","2","13","2","1","1","2","1","1","2","2","0","-2"
"136215","Nova Southeastern University","2019","Not on tenure/no tenure system, lecturers","3","0","3","0","0","0","0","0","0","0","0","0","1","0","1","0","0","0","2","0","2","0","0","0","0","0","0","0","0","0","-2"
"136358","Palm Beach State College","2019","Tenured total","163","71","92","0","0","0","7","6","1","19","10","9","17","5","12","0","0","0","114","46","68","1","1","0","5","3","2","0","0","0","-2"
"136358","Palm Beach State College","2019","Tenured, professors","47","21","26","0","0","0","4","3","1","4","3","1","4","1","3","0","0","0","35","14","21","0","0","0","0","0","0","0","0","0","-2"
"136358","Palm Beach State College","2019","Tenured, associate professors","16","6","10","0","0","0","0","0","0","3","1","2","4","1","3","0","0","0","9","4","5","0","0","0","0","0","0","0","0","0","-2"
"136358","Palm Beach State College","2019","Tenured, assistant professors","33","17","16","0","0","0","1","1","0","1","1","0","3","1","2","0","0","0","26","13","13","0","0","0","2","1","1","0","0","0","-2"
"136358","Palm Beach State College","2019","Tenured, instructors","67","27","40","0","0","0","2","2","0","11","5","6","6","2","4","0","0","0","44","15","29","1","1","0","3","2","1","0","0","0","-2"
"136358","Palm Beach State College","2019","On-Tenure track total","154","66","88","2","0","2","9","4","5","26","9","17","19","9","10","0","0","0","92","42","50","1","0","1","2","2","0","3","0","3","-2"
"136358","Palm Beach State College","2019","On-tenure track, professors","10","4","6","0","0","0","2","1","1","2","1","1","2","1","1","0","0","0","4","1","3","0","0","0","0","0","0","0","0","0","-2"
"136358","Palm Beach State College","2019","On-tenure track, associate professors","26","13","13","1","0","1","2","1","1","6","1","5","2","1","1","0","0","0","15","10","5","0","0","0","0","0","0","0","0","0","-2"
"136358","Palm Beach State College","2019","On-tenure track, assistant professors","54","20","34","1","0","1","4","1","3","9","3","6","5","1","4","0","0","0","32","14","18","1","0","1","1","1","0","1","0","1","-2"
"136358","Palm Beach State College","2019","On-tenure track, instructors","64","29","35","0","0","0","1","1","0","9","4","5","10","6","4","0","0","0","41","17","24","0","0","0","1","1","0","2","0","2","-2"
"136358","Palm Beach State College","2019","Not on tenure track/No tenure system system total","39","17","22","0","0","0","1","1","0","10","3","7","4","1","3","0","0","0","23","11","12","1","1","0","0","0","0","0","0","0","-2"
"136358","Palm Beach State College","2019","Not on tenure/no tenure system, professors","1","1","0","0","0","0","0","0","0","0","0","0","0","0","0","0","0","0","1","1","0","0","0","0","0","0","0","0","0","0","-2"
"136358","Palm Beach State College","2019","Not on tenure/no tenure system, assistant professors","2","0","2","0","0","0","0","0","0","0","0","0","0","0","0","0","0","0","2","0","2","0","0","0","0","0","0","0","0","0","-2"
"136358","Palm Beach State College","2019","Not on tenure/no tenure system, instructors","36","16","20","0","0","0","1","1","0","10","3","7","4","1","3","0","0","0","20","10","10","1","1","0","0","0","0","0","0","0","-2"
"136516","Polk State College","2019","Tenured total","116","51","65","0","0","0","1","1","0","11","6","5","6","3","3","0","0","0","98","41","57","0","0","0","0","0","0","0","0","0","-2"
"136516","Polk State College","2019","Tenured, no academic rank","116","51","65","0","0","0","1","1","0","11","6","5","6","3","3","0","0","0","98","41","57","0","0","0","0","0","0","0","0","0","-2"
"136516","Polk State College","2019","On-Tenure track total","43","21","22","0","0","0","2","2","0","3","2","1","1","0","1","0","0","0","36","16","20","0","0","0","1","1","0","0","0","0","-2"
"136516","Polk State College","2019","On-tenure track, no academic rank","43","21","22","0","0","0","2","2","0","3","2","1","1","0","1","0","0","0","36","16","20","0","0","0","1","1","0","0","0","0","-2"
"137209","Seminole State College of Florida","2019","Tenured total","144","54","90","0","0","0","6","4","2","6","2","4","13","4","9","1","1","0","117","42","75","1","1","0","0","0","0","0","0","0","-2"
"137209","Seminole State College of Florida","2019","Tenured, no academic rank","144","54","90","0","0","0","6","4","2","6","2","4","13","4","9","1","1","0","117","42","75","1","1","0","0","0","0","0","0","0","-2"
"137209","Seminole State College of Florida","2019","On-Tenure track total","70","28","42","0","0","0","3","2","1","10","1","9","7","5","2","0","0","0","49","19","30","0","0","0","0","0","0","1","1","0","-2"
"137209","Seminole State College of Florida","2019","On-tenure track, no academic rank","70","28","42","0","0","0","3","2","1","10","1","9","7","5","2","0","0","0","49","19","30","0","0","0","0","0","0","1","1","0","-2"
"137315","South Florida State College","2019","Tenured total","43","18","25","0","0","0","1","0","1","2","0","2","1","0","1","0","0","0","39","18","21","0","0","0","0","0","0","0","0","0","-2"
"137315","South Florida State College","2019","Tenured, instructors","43","18","25","0","0","0","1","0","1","2","0","2","1","0","1","0","0","0","39","18","21","0","0","0","0","0","0","0","0","0","-2"
"137315","South Florida State College","2019","On-Tenure track total","22","1","21","0","0","0","0","0","0","1","0","1","3","0","3","0","0","0","18","1","17","0","0","0","0","0","0","0","0","0","-2"
"137315","South Florida State College","2019","On-tenure track, instructors","22","1","21","0","0","0","0","0","0","1","0","1","3","0","3","0","0","0","18","1","17","0","0","0","0","0","0","0","0","0","-2"
"137315","South Florida State College","2019","Not on tenure track/No tenure system system total","1","1","0","0","0","0","0","0","0","0","0","0","1","1","0","0","0","0","0","0","0","0","0","0","0","0","0","0","0","0","-2"
"137315","South Florida State College","2019","Not on tenure/no tenure system, instructors","1","1","0","0","0","0","0","0","0","0","0","0","1","1","0","0","0","0","0","0","0","0","0","0","0","0","0","0","0","0","-2"
"137476","St. Thomas University","2019","Tenured total","19","13","6","0","0","0","0","0","0","2","1","1","1","1","0","0","0","0","16","11","5","0","0","0","0","0","0","0","0","0","-2"
"137476","St. Thomas University","2019","Tenured, professors","19","13","6","0","0","0","0","0","0","2","1","1","1","1","0","0","0","0","16","11","5","0","0","0","0","0","0","0","0","0","-2"
"137476","St. Thomas University","2019","On-Tenure track total","1","0","1","0","0","0","0","0","0","0","0","0","0","0","0","0","0","0","1","0","1","0","0","0","0","0","0","0","0","0","-2"
"137476","St. Thomas University","2019","On-tenure track, professors","1","0","1","0","0","0","0","0","0","0","0","0","0","0","0","0","0","0","1","0","1","0","0","0","0","0","0","0","0","0","-2"
"137476","St. Thomas University","2019","Not on tenure track/No tenure system system total","70","31","39","0","0","0","4","2","2","11","5","6","12","5","7","0","0","0","43","19","24","0","0","0","0","0","0","0","0","0","-2"
"137476","St. Thomas University","2019","Not on tenure/no tenure system, professors","21","13","8","0","0","0","1","1","0","1","1","0","4","1","3","0","0","0","15","10","5","0","0","0","0","0","0","0","0","0","-2"
"137476","St. Thomas University","2019","Not on tenure/no tenure system, associate professors","24","9","15","0","0","0","2","0","2","4","1","3","4","2","2","0","0","0","14","6","8","0","0","0","0","0","0","0","0","0","-2"
"137476","St. Thomas University","2019","Not on tenure/no tenure system, assistant professors","14","4","10","0","0","0","1","1","0","3","1","2","3","1","2","0","0","0","7","1","6","0","0","0","0","0","0","0","0","0","-2"
"137476","St. Thomas University","2019","Not on tenure/no tenure system, instructors","1","1","0","0","0","0","0","0","0","1","1","0","0","0","0","0","0","0","0","0","0","0","0","0","0","0","0","0","0","0","-2"
"137476","St. Thomas University","2019","Not on tenure/no tenure system, lecturers","1","1","0","0","0","0","0","0","0","0","0","0","1","1","0","0","0","0","0","0","0","0","0","0","0","0","0","0","0","0","-2"
"137476","St. Thomas University","2019","Not on tenure/no tenure system, no academic rank","9","3","6","0","0","0","0","0","0","2","1","1","0","0","0","0","0","0","7","2","5","0","0","0","0","0","0","0","0","0","-2"
"138187","Valencia College","2019","Tenured total","316","142","174","4","2","2","17","7","10","29","14","15","31","12","19","0","0","0","231","105","126","0","0","0","4","2","2","0","0","0","-2"
"138187","Valencia College","2019","Tenured, no academic rank","316","142","174","4","2","2","17","7","10","29","14","15","31","12","19","0","0","0","231","105","126","0","0","0","4","2","2","0","0","0","-2"
"138187","Valencia College","2019","On-Tenure track total","151","53","98","0","0","0","11","3","8","20","9","11","11","7","4","0","0","0","101","31","70","0","0","0","8","3","5","0","0","0","-2"
"138187","Valencia College","2019","On-tenure track, no academic rank","151","53","98","0","0","0","11","3","8","20","9","11","11","7","4","0","0","0","101","31","70","0","0","0","8","3","5","0","0","0","-2"
"138187","Valencia College","2019","Not on tenure track/No tenure system system total","152","72","80","0","0","0","8","3","5","23","8","15","22","13","9","0","0","0","94","46","48","0","0","0","5","2","3","0","0","0","-2"
"138187","Valencia College","2019","Not on tenure/no tenure system, no academic rank","152","72","80","0","0","0","8","3","5","23","8","15","22","13","9","0","0","0","94","46","48","0","0","0","5","2","3","0","0","0","-2"
"139463","Dalton State College","2019","Tenured total","87","40","47","0","0","0","3","2","1","3","2","1","0","0","0","0","0","0","77","33","44","0","0","0","2","2","0","2","1","1","-2"
"139463","Dalton State College","2019","Tenured, professors","26","16","10","0","0","0","1","1","0","1","1","0","0","0","0","0","0","0","23","13","10","0","0","0","1","1","0","0","0","0","-2"
"139463","Dalton State College","2019","Tenured, associate professors","57","24","33","0","0","0","2","1","1","2","1","1","0","0","0","0","0","0","50","20","30","0","0","0","1","1","0","2","1","1","-2"
"139463","Dalton State College","2019","Tenured, assistant professors","4","0","4","0","0","0","0","0","0","0","0","0","0","0","0","0","0","0","4","0","4","0","0","0","0","0","0","0","0","0","-2"
"139463","Dalton State College","2019","On-Tenure track total","48","24","24","0","0","0","3","2","1","3","1","2","1","1","0","0","0","0","37","18","19","0","0","0","3","1","2","1","1","0","-2"
"139463","Dalton State College","2019","On-tenure track, professors","1","0","1","0","0","0","0","0","0","0","0","0","0","0","0","0","0","0","1","0","1","0","0","0","0","0","0","0","0","0","-2"
"139463","Dalton State College","2019","On-tenure track, associate professors","4","2","2","0","0","0","0","0","0","0","0","0","0","0","0","0","0","0","4","2","2","0","0","0","0","0","0","0","0","0","-2"
"139463","Dalton State College","2019","On-tenure track, assistant professors","42","21","21","0","0","0","2","1","1","3","1","2","1","1","0","0","0","0","32","16","16","0","0","0","3","1","2","1","1","0","-2"
"139463","Dalton State College","2019","On-tenure track, lecturers","1","1","0","0","0","0","1","1","0","0","0","0","0","0","0","0","0","0","0","0","0","0","0","0","0","0","0","0","0","0","-2"
"139463","Dalton State College","2019","Not on tenure track/No tenure system system total","31","12","19","0","0","0","2","1","1","0","0","0","1","0","1","0","0","0","28","11","17","0","0","0","0","0","0","0","0","0","-2"
"139463","Dalton State College","2019","Not on tenure/no tenure system, assistant professors","2","1","1","0","0","0","0","0","0","0","0","0","0","0","0","0","0","0","2","1","1","0","0","0","0","0","0","0","0","0","-2"
"139463","Dalton State College","2019","Not on tenure/no tenure system, instructors","7","2","5","0","0","0","0","0","0","0","0","0","1","0","1","0","0","0","6","2","4","0","0","0","0","0","0","0","0","0","-2"
"139463","Dalton State College","2019","Not on tenure/no tenure system, lecturers","20","8","12","0","0","0","2","1","1","0","0","0","0","0","0","0","0","0","18","7","11","0","0","0","0","0","0","0","0","0","-2"
"139463","Dalton State College","2019","Not on tenure/no tenure system, no academic rank","2","1","1","0","0","0","0","0","0","0","0","0","0","0","0","0","0","0","2","1","1","0","0","0","0","0","0","0","0","0","-2"
"142887","American Academy of Art","2019","Not on tenure track/No tenure system system total","20","12","8","0","0","0","1","1","0","1","0","1","0","0","0","0","0","0","18","11","7","0","0","0","0","0","0","0","0","0","-2"
"142887","American Academy of Art","2019","Not on tenure/no tenure system, instructors","20","12","8","0","0","0","1","1","0","1","0","1","0","0","0","0","0","0","18","11","7","0","0","0","0","0","0","0","0","0","-2"
"143118","Aurora University","2019","Tenured total","54","23","31","0","0","0","2","1","1","0","0","0","2","0","2","0","0","0","50","22","28","0","0","0","0","0","0","0","0","0","-2"
"143118","Aurora University","2019","Tenured, professors","20","10","10","0","0","0","1","0","1","0","0","0","0","0","0","0","0","0","19","10","9","0","0","0","0","0","0","0","0","0","-2"
"143118","Aurora University","2019","Tenured, associate professors","34","13","21","0","0","0","1","1","0","0","0","0","2","0","2","0","0","0","31","12","19","0","0","0","0","0","0","0","0","0","-2"
"143118","Aurora University","2019","On-Tenure track total","35","22","13","0","0","0","3","1","2","1","1","0","1","1","0","0","0","0","27","18","9","1","0","1","2","1","1","0","0","0","-2"
"143118","Aurora University","2019","On-tenure track, professors","1","0","1","0","0","0","0","0","0","0","0","0","0","0","0","0","0","0","1","0","1","0","0","0","0","0","0","0","0","0","-2"
"143118","Aurora University","2019","On-tenure track, associate professors","2","1","1","0","0","0","1","0","1","0","0","0","0","0","0","0","0","0","1","1","0","0","0","0","0","0","0","0","0","0","-2"
"143118","Aurora University","2019","On-tenure track, assistant professors","32","21","11","0","0","0","2","1","1","1","1","0","1","1","0","0","0","0","25","17","8","1","0","1","2","1","1","0","0","0","-2"
"143118","Aurora University","2019","Not on tenure track/No tenure system system total","50","18","32","0","0","0","0","0","0","3","3","0","0","0","0","0","0","0","47","15","32","0","0","0","0","0","0","0","0","0","-2"
"143118","Aurora University","2019","Not on tenure/no tenure system, professors","3","2","1","0","0","0","0","0","0","0","0","0","0","0","0","0","0","0","3","2","1","0","0","0","0","0","0","0","0","0","-2"
"143118","Aurora University","2019","Not on tenure/no tenure system, associate professors","7","5","2","0","0","0","0","0","0","0","0","0","0","0","0","0","0","0","7","5","2","0","0","0","0","0","0","0","0","0","-2"
"143118","Aurora University","2019","Not on tenure/no tenure system, assistant professors","40","11","29","0","0","0","0","0","0","3","3","0","0","0","0","0","0","0","37","8","29","0","0","0","0","0","0","0","0","0","-2"
"143978","The Chicago School of Professional Psychology at Chicago","2019","Not on tenure track/No tenure system system total","87","41","46","2","1","1","5","1","4","11","2","9","4","2","2","0","0","0","61","31","30","2","2","0","2","2","0","0","0","0","-2"
"143978","The Chicago School of Professional Psychology at Chicago","2019","Not on tenure/no tenure system, professors","10","4","6","1","0","1","1","0","1","0","0","0","0","0","0","0","0","0","8","4","4","0","0","0","0","0","0","0","0","0","-2"
"143978","The Chicago School of Professional Psychology at Chicago","2019","Not on tenure/no tenure system, associate professors","32","10","22","0","0","0","1","0","1","4","0","4","3","1","2","0","0","0","23","8","15","0","0","0","1","1","0","0","0","0","-2"
"143978","The Chicago School of Professional Psychology at Chicago","2019","Not on tenure/no tenure system, assistant professors","43","25","18","1","1","0","3","1","2","7","2","5","1","1","0","0","0","0","29","18","11","2","2","0","0","0","0","0","0","0","-2"
"143978","The Chicago School of Professional Psychology at Chicago","2019","Not on tenure/no tenure system, instructors","2","2","0","0","0","0","0","0","0","0","0","0","0","0","0","0","0","0","1","1","0","0","0","0","1","1","0","0","0","0","-2"
"144351","Concordia University-Chicago","2019","Tenured total","58","26","32","0","0","0","2","1","1","2","0","2","0","0","0","0","0","0","54","25","29","0","0","0","0","0","0","0","0","0","-2"
"144351","Concordia University-Chicago","2019","Tenured, professors","47","20","27","0","0","0","1","0","1","2","0","2","0","0","0","0","0","0","44","20","24","0","0","0","0","0","0","0","0","0","-2"
"144351","Concordia University-Chicago","2019","Tenured, associate professors","11","6","5","0","0","0","1","1","0","0","0","0","0","0","0","0","0","0","10","5","5","0","0","0","0","0","0","0","0","0","-2"
"144351","Concordia University-Chicago","2019","On-Tenure track total","83","34","49","0","0","0","2","2","0","3","1","2","4","3","1","0","0","0","72","26","46","0","0","0","0","0","0","2","2","0","-2"
"144351","Concordia University-Chicago","2019","On-tenure track, professors","7","3","4","0","0","0","0","0","0","0","0","0","0","0","0","0","0","0","7","3","4","0","0","0","0","0","0","0","0","0","-2"
"144351","Concordia University-Chicago","2019","On-tenure track, associate professors","42","17","25","0","0","0","2","2","0","2","1","1","3","2","1","0","0","0","33","10","23","0","0","0","0","0","0","2","2","0","-2"
"144351","Concordia University-Chicago","2019","On-tenure track, assistant professors","34","14","20","0","0","0","0","0","0","1","0","1","1","1","0","0","0","0","32","13","19","0","0","0","0","0","0","0","0","0","-2"
"144351","Concordia University-Chicago","2019","Not on tenure track/No tenure system system total","160","73","87","0","0","0","4","2","2","14","7","7","5","4","1","1","0","1","123","54","69","0","0","0","12","6","6","1","0","1","-2"
"144351","Concordia University-Chicago","2019","Not on tenure/no tenure system, professors","2","2","0","0","0","0","0","0","0","0","0","0","0","0","0","0","0","0","2","2","0","0","0","0","0","0","0","0","0","0","-2"
"144351","Concordia University-Chicago","2019","Not on tenure/no tenure system, associate professors","7","3","4","0","0","0","0","0","0","1","1","0","0","0","0","0","0","0","5","2","3","0","0","0","0","0","0","1","0","1","-2"
"144351","Concordia University-Chicago","2019","Not on tenure/no tenure system, assistant professors","17","8","9","0","0","0","1","1","0","1","1","0","2","2","0","0","0","0","13","4","9","0","0","0","0","0","0","0","0","0","-2"
"144351","Concordia University-Chicago","2019","Not on tenure/no tenure system, instructors","134","60","74","0","0","0","3","1","2","12","5","7","3","2","1","1","0","1","103","46","57","0","0","0","12","6","6","0","0","0","-2"
"145600","University of Illinois Chicago","2019","Tenured total","887","538","349","1","0","1","180","119","61","37","20","17","64","31","33","1","0","1","567","347","220","7","3","4","26","14","12","4","4","0","-2"
"145600","University of Illinois Chicago","2019","Tenured, professors","466","313","153","1","0","1","76","56","20","11","6","5","27","17","10","0","0","0","333","223","110","2","2","0","16","9","7","0","0","0","-2"
"145600","University of Illinois Chicago","2019","Tenured, associate professors","401","215","186","0","0","0","99","60","39","25","14","11","37","14","23","1","0","1","223","118","105","4","1","3","9","5","4","3","3","0","-2"
"145600","University of Illinois Chicago","2019","Tenured, assistant professors","19","9","10","0","0","0","4","2","2","1","0","1","0","0","0","0","0","0","11","6","5","1","0","1","1","0","1","1","1","0","-2"
"145600","University of Illinois Chicago","2019","Tenured, no academic rank","1","1","0","0","0","0","1","1","0","0","0","0","0","0","0","0","0","0","0","0","0","0","0","0","0","0","0","0","0","0","-2"
"145600","University of Illinois Chicago","2019","On-Tenure track total","398","220","178","0","0","0","92","57","35","27","13","14","33","15","18","0","0","0","184","99","85","9","3","6","9","4","5","44","29","15","-2"
"145600","University of Illinois Chicago","2019","On-tenure track, professors","15","11","4","0","0","0","5","2","3","0","0","0","0","0","0","0","0","0","9","8","1","1","1","0","0","0","0","0","0","0","-2"
"145600","University of Illinois Chicago","2019","On-tenure track, associate professors","49","28","21","0","0","0","15","11","4","5","3","2","5","2","3","0","0","0","22","12","10","1","0","1","1","0","1","0","0","0","-2"
"145600","University of Illinois Chicago","2019","On-tenure track, assistant professors","334","181","153","0","0","0","72","44","28","22","10","12","28","13","15","0","0","0","153","79","74","7","2","5","8","4","4","44","29","15","-2"
"145600","University of Illinois Chicago","2019","Not on tenure track/No tenure system system total","900","373","527","0","0","0","154","56","98","46","17","29","49","25","24","1","0","1","584","244","340","10","3","7","15","8","7","41","20","21","-2"
"145600","University of Illinois Chicago","2019","Not on tenure/no tenure system, professors","41","18","23","0","0","0","3","2","1","2","2","0","0","0","0","0","0","0","33","13","20","1","0","1","1","0","1","1","1","0","-2"
"145600","University of Illinois Chicago","2019","Not on tenure/no tenure system, associate professors","117","49","68","0","0","0","19","6","13","5","1","4","5","2","3","0","0","0","82","38","44","0","0","0","6","2","4","0","0","0","-2"
"145600","University of Illinois Chicago","2019","Not on tenure/no tenure system, assistant professors","396","164","232","0","0","0","69","23","46","27","11","16","22","11","11","0","0","0","243","103","140","3","0","3","5","3","2","27","13","14","-2"
"145600","University of Illinois Chicago","2019","Not on tenure/no tenure system, instructors","138","48","90","0","0","0","46","18","28","4","1","3","3","2","1","0","0","0","76","21","55","0","0","0","1","1","0","8","5","3","-2"
"145600","University of Illinois Chicago","2019","Not on tenure/no tenure system, lecturers","198","93","105","0","0","0","16","7","9","8","2","6","19","10","9","1","0","1","141","68","73","6","3","3","2","2","0","5","1","4","-2"
"145600","University of Illinois Chicago","2019","Not on tenure/no tenure system, no academic rank","10","1","9","0","0","0","1","0","1","0","0","0","0","0","0","0","0","0","9","1","8","0","0","0","0","0","0","0","0","0","-2"
"147536","National Louis University","2019","Tenured total","48","20","28","0","0","0","5","1","4","4","4","0","2","1","1","0","0","0","36","13","23","1","1","0","0","0","0","0","0","0","-2"
"147536","National Louis University","2019","Tenured, professors","10","3","7","0","0","0","0","0","0","0","0","0","0","0","0","0","0","0","10","3","7","0","0","0","0","0","0","0","0","0","-2"
"147536","National Louis University","2019","Tenured, associate professors","34","14","20","0","0","0","5","1","4","3","3","0","2","1","1","0","0","0","24","9","15","0","0","0","0","0","0","0","0","0","-2"
"147536","National Louis University","2019","Tenured, assistant professors","4","3","1","0","0","0","0","0","0","1","1","0","0","0","0","0","0","0","2","1","1","1","1","0","0","0","0","0","0","0","-2"
"147536","National Louis University","2019","On-Tenure track total","5","1","4","0","0","0","1","0","1","1","0","1","0","0","0","0","0","0","1","1","0","0","0","0","0","0","0","2","0","2","-2"
"147536","National Louis University","2019","On-tenure track, associate professors","1","0","1","0","0","0","0","0","0","1","0","1","0","0","0","0","0","0","0","0","0","0","0","0","0","0","0","0","0","0","-2"
"147536","National Louis University","2019","On-tenure track, assistant professors","4","1","3","0","0","0","1","0","1","0","0","0","0","0","0","0","0","0","1","1","0","0","0","0","0","0","0","2","0","2","-2"
"147536","National Louis University","2019","Not on tenure track/No tenure system system total","129","41","88","0","0","0","3","1","2","15","1","14","6","3","3","0","0","0","103","34","69","1","1","0","0","0","0","1","1","0","-2"
"147536","National Louis University","2019","Not on tenure/no tenure system, professors","8","2","6","0","0","0","0","0","0","1","0","1","0","0","0","0","0","0","7","2","5","0","0","0","0","0","0","0","0","0","-2"
"147536","National Louis University","2019","Not on tenure/no tenure system, associate professors","15","2","13","0","0","0","0","0","0","0","0","0","1","0","1","0","0","0","14","2","12","0","0","0","0","0","0","0","0","0","-2"
"147536","National Louis University","2019","Not on tenure/no tenure system, assistant professors","99","31","68","0","0","0","3","1","2","14","1","13","5","3","2","0","0","0","75","24","51","1","1","0","0","0","0","1","1","0","-2"
"147536","National Louis University","2019","Not on tenure/no tenure system, lecturers","7","6","1","0","0","0","0","0","0","0","0","0","0","0","0","0","0","0","7","6","1","0","0","0","0","0","0","0","0","0","-2"
"147679","North Park University","2019","Tenured total","68","36","32","0","0","0","6","3","3","1","0","1","2","2","0","0","0","0","56","29","27","2","1","1","0","0","0","1","1","0","-2"
"147679","North Park University","2019","Tenured, professors","51","27","24","0","0","0","4","2","2","1","0","1","1","1","0","0","0","0","43","23","20","2","1","1","0","0","0","0","0","0","-2"
"147679","North Park University","2019","Tenured, associate professors","16","9","7","0","0","0","2","1","1","0","0","0","1","1","0","0","0","0","12","6","6","0","0","0","0","0","0","1","1","0","-2"
"147679","North Park University","2019","Tenured, assistant professors","1","0","1","0","0","0","0","0","0","0","0","0","0","0","0","0","0","0","1","0","1","0","0","0","0","0","0","0","0","0","-2"
"147679","North Park University","2019","On-Tenure track total","22","11","11","0","0","0","2","2","0","8","3","5","0","0","0","0","0","0","12","6","6","0","0","0","0","0","0","0","0","0","-2"
"147679","North Park University","2019","On-tenure track, professors","7","5","2","0","0","0","2","2","0","1","1","0","0","0","0","0","0","0","4","2","2","0","0","0","0","0","0","0","0","0","-2"
"147679","North Park University","2019","On-tenure track, associate professors","8","3","5","0","0","0","0","0","0","3","2","1","0","0","0","0","0","0","5","1","4","0","0","0","0","0","0","0","0","0","-2"
"147679","North Park University","2019","On-tenure track, assistant professors","7","3","4","0","0","0","0","0","0","4","0","4","0","0","0","0","0","0","3","3","0","0","0","0","0","0","0","0","0","0","-2"
"147679","North Park University","2019","Not on tenure track/No tenure system system total","34","13","21","0","0","0","0","0","0","1","0","1","1","0","1","0","0","0","32","13","19","0","0","0","0","0","0","0","0","0","-2"
"147679","North Park University","2019","Not on tenure/no tenure system, professors","3","2","1","0","0","0","0","0","0","0","0","0","0","0","0","0","0","0","3","2","1","0","0","0","0","0","0","0","0","0","-2"
"147679","North Park University","2019","Not on tenure/no tenure system, associate professors","14","7","7","0","0","0","0","0","0","0","0","0","0","0","0","0","0","0","14","7","7","0","0","0","0","0","0","0","0","0","-2"
"147679","North Park University","2019","Not on tenure/no tenure system, assistant professors","14","1","13","0","0","0","0","0","0","1","0","1","1","0","1","0","0","0","12","1","11","0","0","0","0","0","0","0","0","0","-2"
"147679","North Park University","2019","Not on tenure/no tenure system, instructors","3","3","0","0","0","0","0","0","0","0","0","0","0","0","0","0","0","0","3","3","0","0","0","0","0","0","0","0","0","0","-2"
"147776","Northeastern Illinois University","2019","Tenured total","145","67","78","0","0","0","23","10","13","14","7","7","15","6","9","0","0","0","81","37","44","0","0","0","10","7","3","2","0","2","-2"
"147776","Northeastern Illinois University","2019","Tenured, professors","64","33","31","0","0","0","11","5","6","7","4","3","6","3","3","0","0","0","37","19","18","0","0","0","2","2","0","1","0","1","-2"
"147776","Northeastern Illinois University","2019","Tenured, associate professors","80","34","46","0","0","0","12","5","7","7","3","4","9","3","6","0","0","0","43","18","25","0","0","0","8","5","3","1","0","1","-2"
"147776","Northeastern Illinois University","2019","Tenured, assistant professors","1","0","1","0","0","0","0","0","0","0","0","0","0","0","0","0","0","0","1","0","1","0","0","0","0","0","0","0","0","0","-2"
"147776","Northeastern Illinois University","2019","On-Tenure track total","73","30","43","1","1","0","9","4","5","5","2","3","9","4","5","0","0","0","36","12","24","0","0","0","8","5","3","5","2","3","-2"
"147776","Northeastern Illinois University","2019","On-tenure track, professors","1","0","1","0","0","0","0","0","0","0","0","0","0","0","0","0","0","0","1","0","1","0","0","0","0","0","0","0","0","0","-2"
"147776","Northeastern Illinois University","2019","On-tenure track, associate professors","16","7","9","1","1","0","2","1","1","2","1","1","1","0","1","0","0","0","9","3","6","0","0","0","1","1","0","0","0","0","-2"
"147776","Northeastern Illinois University","2019","On-tenure track, assistant professors","56","23","33","0","0","0","7","3","4","3","1","2","8","4","4","0","0","0","26","9","17","0","0","0","7","4","3","5","2","3","-2"
"147776","Northeastern Illinois University","2019","Not on tenure track/No tenure system system total","79","34","45","0","0","0","5","3","2","2","2","0","6","3","3","0","0","0","60","24","36","0","0","0","6","2","4","0","0","0","-2"
"147776","Northeastern Illinois University","2019","Not on tenure/no tenure system, instructors","79","34","45","0","0","0","5","3","2","2","2","0","6","3","3","0","0","0","60","24","36","0","0","0","6","2","4","0","0","0","-2"
"148335","Robert Morris University Illinois","2019","Not on tenure track/No tenure system system total","41","26","15","0","0","0","8","6","2","3","2","1","3","2","1","0","0","0","27","16","11","0","0","0","0","0","0","0","0","0","-2"
"148335","Robert Morris University Illinois","2019","Not on tenure/no tenure system, professors","41","26","15","0","0","0","8","6","2","3","2","1","3","2","1","0","0","0","27","16","11","0","0","0","0","0","0","0","0","0","-2"
"148487","Roosevelt University","2019","Tenured total","118","63","55","0","0","0","2","1","1","7","3","4","4","3","1","0","0","0","79","37","42","4","2","2","6","6","0","16","11","5","-2"
"148487","Roosevelt University","2019","Tenured, professors","37","23","14","0","0","0","1","1","0","3","2","1","3","2","1","0","0","0","25","13","12","1","1","0","2","2","0","2","2","0","-2"
"148487","Roosevelt University","2019","Tenured, associate professors","78","38","40","0","0","0","1","0","1","4","1","3","1","1","0","0","0","0","52","23","29","3","1","2","4","4","0","13","8","5","-2"
"148487","Roosevelt University","2019","Tenured, assistant professors","2","1","1","0","0","0","0","0","0","0","0","0","0","0","0","0","0","0","2","1","1","0","0","0","0","0","0","0","0","0","-2"
"148487","Roosevelt University","2019","Tenured, no academic rank","1","1","0","0","0","0","0","0","0","0","0","0","0","0","0","0","0","0","0","0","0","0","0","0","0","0","0","1","1","0","-2"
"148487","Roosevelt University","2019","On-Tenure track total","21","14","7","0","0","0","0","0","0","0","0","0","0","0","0","0","0","0","10","6","4","0","0","0","3","2","1","8","6","2","-2"
"148487","Roosevelt University","2019","On-tenure track, assistant professors","21","14","7","0","0","0","0","0","0","0","0","0","0","0","0","0","0","0","10","6","4","0","0","0","3","2","1","8","6","2","-2"
"148487","Roosevelt University","2019","Not on tenure track/No tenure system system total","58","29","29","0","0","0","0","0","0","4","1","3","1","0","1","0","0","0","33","18","15","1","0","1","11","5","6","8","5","3","-2"
"148487","Roosevelt University","2019","Not on tenure/no tenure system, professors","1","1","0","0","0","0","0","0","0","0","0","0","0","0","0","0","0","0","1","1","0","0","0","0","0","0","0","0","0","0","-2"
"148487","Roosevelt University","2019","Not on tenure/no tenure system, associate professors","4","2","2","0","0","0","0","0","0","1","0","1","0","0","0","0","0","0","1","0","1","0","0","0","1","1","0","1","1","0","-2"
"148487","Roosevelt University","2019","Not on tenure/no tenure system, assistant professors","29","15","14","0","0","0","0","0","0","1","0","1","1","0","1","0","0","0","14","8","6","0","0","0","9","4","5","4","3","1","-2"
"148487","Roosevelt University","2019","Not on tenure/no tenure system, lecturers","20","10","10","0","0","0","0","0","0","2","1","1","0","0","0","0","0","0","15","8","7","1","0","1","0","0","0","2","1","1","-2"
"148487","Roosevelt University","2019","Not on tenure/no tenure system, no academic rank","4","1","3","0","0","0","0","0","0","0","0","0","0","0","0","0","0","0","2","1","1","0","0","0","1","0","1","1","0","1","-2"
"148496","Dominican University","2019","Tenured total","90","38","52","0","0","0","8","4","4","6","3","3","6","2","4","0","0","0","68","27","41","1","1","0","1","1","0","0","0","0","-2"
"148496","Dominican University","2019","Tenured, professors","50","20","30","0","0","0","4","2","2","2","1","1","3","1","2","0","0","0","41","16","25","0","0","0","0","0","0","0","0","0","-2"
"148496","Dominican University","2019","Tenured, associate professors","35","15","20","0","0","0","4","2","2","3","2","1","3","1","2","0","0","0","23","8","15","1","1","0","1","1","0","0","0","0","-2"
"148496","Dominican University","2019","Tenured, assistant professors","5","3","2","0","0","0","0","0","0","1","0","1","0","0","0","0","0","0","4","3","1","0","0","0","0","0","0","0","0","0","-2"
"148496","Dominican University","2019","On-Tenure track total","28","14","14","0","0","0","7","3","4","2","1","1","4","1","3","0","0","0","14","9","5","0","0","0","1","0","1","0","0","0","-2"
"148496","Dominican University","2019","On-tenure track, associate professors","3","2","1","0","0","0","1","0","1","0","0","0","0","0","0","0","0","0","2","2","0","0","0","0","0","0","0","0","0","0","-2"
"148496","Dominican University","2019","On-tenure track, assistant professors","25","12","13","0","0","0","6","3","3","2","1","1","4","1","3","0","0","0","12","7","5","0","0","0","1","0","1","0","0","0","-2"
"148496","Dominican University","2019","Not on tenure track/No tenure system system total","37","11","26","0","0","0","0","0","0","2","1","1","2","0","2","0","0","0","31","9","22","1","0","1","0","0","0","1","1","0","-2"
"148496","Dominican University","2019","Not on tenure/no tenure system, professors","4","2","2","0","0","0","0","0","0","0","0","0","0","0","0","0","0","0","4","2","2","0","0","0","0","0","0","0","0","0","-2"
"148496","Dominican University","2019","Not on tenure/no tenure system, associate professors","1","1","0","0","0","0","0","0","0","0","0","0","0","0","0","0","0","0","1","1","0","0","0","0","0","0","0","0","0","0","-2"
"148496","Dominican University","2019","Not on tenure/no tenure system, assistant professors","11","2","9","0","0","0","0","0","0","0","0","0","1","0","1","0","0","0","8","1","7","1","0","1","0","0","0","1","1","0","-2"
"148496","Dominican University","2019","Not on tenure/no tenure system, lecturers","21","6","15","0","0","0","0","0","0","2","1","1","1","0","1","0","0","0","18","5","13","0","0","0","0","0","0","0","0","0","-2"
"148511","Rush University","2019","Tenured total","272","147","125","0","0","0","52","28","24","11","2","9","10","5","5","0","0","0","195","108","87","4","4","0","0","0","0","0","0","0","-2"
"148511","Rush University","2019","Tenured, professors","115","70","45","0","0","0","13","9","4","3","1","2","2","2","0","0","0","0","95","56","39","2","2","0","0","0","0","0","0","0","-2"
"148511","Rush University","2019","Tenured, associate professors","157","77","80","0","0","0","39","19","20","8","1","7","8","3","5","0","0","0","100","52","48","2","2","0","0","0","0","0","0","0","-2"
"148511","Rush University","2019","On-Tenure track total","701","271","430","0","0","0","184","73","111","36","10","26","40","15","25","0","0","0","423","164","259","17","8","9","1","1","0","0","0","0","-2"
"148511","Rush University","2019","On-tenure track, assistant professors","571","227","344","0","0","0","164","67","97","27","8","19","35","13","22","0","0","0","333","135","198","12","4","8","0","0","0","0","0","0","-2"
"148511","Rush University","2019","On-tenure track, instructors","130","44","86","0","0","0","20","6","14","9","2","7","5","2","3","0","0","0","90","29","61","5","4","1","1","1","0","0","0","0","-2"
"148511","Rush University","2019","Not on tenure track/No tenure system system total","95","31","64","0","0","0","6","1","5","6","0","6","6","2","4","0","0","0","73","25","48","3","2","1","1","1","0","0","0","0","-2"
"148511","Rush University","2019","Not on tenure/no tenure system, lecturers","16","3","13","0","0","0","3","0","3","1","0","1","1","1","0","0","0","0","10","1","9","0","0","0","1","1","0","0","0","0","-2"
"148511","Rush University","2019","Not on tenure/no tenure system, no academic rank","79","28","51","0","0","0","3","1","2","5","0","5","5","1","4","0","0","0","63","24","39","3","2","1","0","0","0","0","0","0","-2"
"148627","Saint Xavier University","2019","Tenured total","68","31","37","0","0","0","7","4","3","1","0","1","1","0","1","0","0","0","58","26","32","0","0","0","1","1","0","0","0","0","-2"
"148627","Saint Xavier University","2019","Tenured, professors","24","10","14","0","0","0","1","1","0","0","0","0","0","0","0","0","0","0","22","8","14","0","0","0","1","1","0","0","0","0","-2"
"148627","Saint Xavier University","2019","Tenured, associate professors","44","21","23","0","0","0","6","3","3","1","0","1","1","0","1","0","0","0","36","18","18","0","0","0","0","0","0","0","0","0","-2"
"148627","Saint Xavier University","2019","On-Tenure track total","24","10","14","0","0","0","0","0","0","1","0","1","1","0","1","0","0","0","16","7","9","0","0","0","6","3","3","0","0","0","-2"
"148627","Saint Xavier University","2019","On-tenure track, associate professors","1","0","1","0","0","0","0","0","0","1","0","1","0","0","0","0","0","0","0","0","0","0","0","0","0","0","0","0","0","0","-2"
"148627","Saint Xavier University","2019","On-tenure track, assistant professors","23","10","13","0","0","0","0","0","0","0","0","0","1","0","1","0","0","0","16","7","9","0","0","0","6","3","3","0","0","0","-2"
"148627","Saint Xavier University","2019","Not on tenure track/No tenure system system total","30","12","18","0","0","0","2","1","1","4","3","1","2","1","1","0","0","0","13","3","10","1","0","1","8","4","4","0","0","0","-2"
"148627","Saint Xavier University","2019","Not on tenure/no tenure system, professors","1","0","1","0","0","0","0","0","0","0","0","0","0","0","0","0","0","0","1","0","1","0","0","0","0","0","0","0","0","0","-2"
"148627","Saint Xavier University","2019","Not on tenure/no tenure system, lecturers","29","12","17","0","0","0","2","1","1","4","3","1","2","1","1","0","0","0","12","3","9","1","0","1","8","4","4","0","0","0","-2"
"148876","Saint Augustine College","2019","Not on tenure track/No tenure system system total","15","7","8","0","0","0","1","0","1","0","0","0","5","4","1","0","0","0","8","3","5","1","0","1","0","0","0","0","0","0","-2"
"148876","Saint Augustine College","2019","Not on tenure/no tenure system, associate professors","7","5","2","0","0","0","0","0","0","0","0","0","3","3","0","0","0","0","4","2","2","0","0","0","0","0","0","0","0","0","-2"
"148876","Saint Augustine College","2019","Not on tenure/no tenure system, assistant professors","4","2","2","0","0","0","0","0","0","0","0","0","2","1","1","0","0","0","2","1","1","0","0","0","0","0","0","0","0","0","-2"
"148876","Saint Augustine College","2019","Not on tenure/no tenure system, instructors","4","0","4","0","0","0","1","0","1","0","0","0","0","0","0","0","0","0","2","0","2","1","0","1","0","0","0","0","0","0","-2"
"149639","VanderCook College of Music","2019","Not on tenure track/No tenure system system total","10","5","5","0","0","0","2","1","1","0","0","0","0","0","0","0","0","0","8","4","4","0","0","0","0","0","0","0","0","0","-2"
"149639","VanderCook College of Music","2019","Not on tenure/no tenure system, professors","4","1","3","0","0","0","0","0","0","0","0","0","0","0","0","0","0","0","4","1","3","0","0","0","0","0","0","0","0","0","-2"
"149639","VanderCook College of Music","2019","Not on tenure/no tenure system, associate professors","4","2","2","0","0","0","1","0","1","0","0","0","0","0","0","0","0","0","3","2","1","0","0","0","0","0","0","0","0","0","-2"
"149639","VanderCook College of Music","2019","Not on tenure/no tenure system, assistant professors","2","2","0","0","0","0","1","1","0","0","0","0","0","0","0","0","0","0","1","1","0","0","0","0","0","0","0","0","0","0","-2"
"150172","Calumet College of Saint Joseph","2019","Tenured total","7","4","3","0","0","0","0","0","0","0","0","0","0","0","0","0","0","0","7","4","3","0","0","0","0","0","0","0","0","0","-2"
"150172","Calumet College of Saint Joseph","2019","Tenured, professors","1","1","0","0","0","0","0","0","0","0","0","0","0","0","0","0","0","0","1","1","0","0","0","0","0","0","0","0","0","0","-2"
"150172","Calumet College of Saint Joseph","2019","Tenured, associate professors","5","2","3","0","0","0","0","0","0","0","0","0","0","0","0","0","0","0","5","2","3","0","0","0","0","0","0","0","0","0","-2"
"150172","Calumet College of Saint Joseph","2019","Tenured, assistant professors","1","1","0","0","0","0","0","0","0","0","0","0","0","0","0","0","0","0","1","1","0","0","0","0","0","0","0","0","0","0","-2"
"150172","Calumet College of Saint Joseph","2019","On-Tenure track total","8","4","4","0","0","0","0","0","0","2","1","1","3","1","2","0","0","0","3","2","1","0","0","0","0","0","0","0","0","0","-2"
"150172","Calumet College of Saint Joseph","2019","On-tenure track, assistant professors","8","4","4","0","0","0","0","0","0","2","1","1","3","1","2","0","0","0","3","2","1","0","0","0","0","0","0","0","0","0","-2"
"150172","Calumet College of Saint Joseph","2019","Not on tenure track/No tenure system system total","6","3","3","0","0","0","0","0","0","2","1","1","0","0","0","0","0","0","4","2","2","0","0","0","0","0","0","0","0","0","-2"
"150172","Calumet College of Saint Joseph","2019","Not on tenure/no tenure system, instructors","6","3","3","0","0","0","0","0","0","2","1","1","0","0","0","0","0","0","4","2","2","0","0","0","0","0","0","0","0","0","-2"
"151360","Indiana University-Northwest","2019","Tenured total","69","42","27","0","0","0","11","6","5","6","4","2","5","3","2","0","0","0","46","28","18","1","1","0","0","0","0","0","0","0","-2"
"151360","Indiana University-Northwest","2019","Tenured, professors","31","19","12","0","0","0","5","3","2","2","2","0","2","0","2","0","0","0","21","13","8","1","1","0","0","0","0","0","0","0","-2"
"151360","Indiana University-Northwest","2019","Tenured, associate professors","38","23","15","0","0","0","6","3","3","4","2","2","3","3","0","0","0","0","25","15","10","0","0","0","0","0","0","0","0","0","-2"
"151360","Indiana University-Northwest","2019","On-Tenure track total","26","11","15","0","0","0","3","2","1","2","0","2","0","0","0","0","0","0","18","7","11","1","1","0","0","0","0","2","1","1","-2"
"151360","Indiana University-Northwest","2019","On-tenure track, associate professors","5","2","3","0","0","0","0","0","0","0","0","0","0","0","0","0","0","0","5","2","3","0","0","0","0","0","0","0","0","0","-2"
"151360","Indiana University-Northwest","2019","On-tenure track, assistant professors","21","9","12","0","0","0","3","2","1","2","0","2","0","0","0","0","0","0","13","5","8","1","1","0","0","0","0","2","1","1","-2"
"151360","Indiana University-Northwest","2019","Not on tenure track/No tenure system system total","57","17","40","0","0","0","3","1","2","6","0","6","5","3","2","0","0","0","41","13","28","2","0","2","0","0","0","0","0","0","-2"
"151360","Indiana University-Northwest","2019","Not on tenure/no tenure system, associate professors","4","1","3","0","0","0","0","0","0","0","0","0","0","0","0","0","0","0","4","1","3","0","0","0","0","0","0","0","0","0","-2"
"151360","Indiana University-Northwest","2019","Not on tenure/no tenure system, assistant professors","33","8","25","0","0","0","1","0","1","6","0","6","2","2","0","0","0","0","23","6","17","1","0","1","0","0","0","0","0","0","-2"
"151360","Indiana University-Northwest","2019","Not on tenure/no tenure system, lecturers","20","8","12","0","0","0","2","1","1","0","0","0","3","1","2","0","0","0","14","6","8","1","0","1","0","0","0","0","0","0","-2"
"155007","Donnelly College","2019","Not on tenure track/No tenure system system total","14","4","10","0","0","0","0","0","0","1","0","1","2","0","2","0","0","0","8","3","5","0","0","0","3","1","2","0","0","0","-2"
"155007","Donnelly College","2019","Not on tenure/no tenure system, associate professors","1","0","1","0","0","0","0","0","0","0","0","0","0","0","0","0","0","0","1","0","1","0","0","0","0","0","0","0","0","0","-2"
"155007","Donnelly College","2019","Not on tenure/no tenure system, assistant professors","11","4","7","0","0","0","0","0","0","1","0","1","1","0","1","0","0","0","6","3","3","0","0","0","3","1","2","0","0","0","-2"
"155007","Donnelly College","2019","Not on tenure/no tenure system, instructors","2","0","2","0","0","0","0","0","0","0","0","0","1","0","1","0","0","0","1","0","1","0","0","0","0","0","0","0","0","0","-2"
"160409","Saint Joseph Seminary College","2019","Not on tenure track/No tenure system system total","26","20","6","0","0","0","1","1","0","0","0","0","1","1","0","0","0","0","23","17","6","1","1","0","0","0","0","0","0","0","-2"
"160409","Saint Joseph Seminary College","2019","Not on tenure/no tenure system, professors","26","20","6","0","0","0","1","1","0","0","0","0","1","1","0","0","0","0","23","17","6","1","1","0","0","0","0","0","0","0","-2"
"165167","Cambridge College","2019","Not on tenure track/No tenure system system total","16","7","9","0","0","0","0","0","0","2","1","1","0","0","0","0","0","0","14","6","8","0","0","0","0","0","0","0","0","0","-2"
"165167","Cambridge College","2019","Not on tenure/no tenure system, professors","11","5","6","0","0","0","0","0","0","2","1","1","0","0","0","0","0","0","9","4","5","0","0","0","0","0","0","0","0","0","-2"
"165167","Cambridge College","2019","Not on tenure/no tenure system, associate professors","2","1","1","0","0","0","0","0","0","0","0","0","0","0","0","0","0","0","2","1","1","0","0","0","0","0","0","0","0","0","-2"
"165167","Cambridge College","2019","Not on tenure/no tenure system, assistant professors","2","1","1","0","0","0","0","0","0","0","0","0","0","0","0","0","0","0","2","1","1","0","0","0","0","0","0","0","0","0","-2"
"165167","Cambridge College","2019","Not on tenure/no tenure system, lecturers","1","0","1","0","0","0","0","0","0","0","0","0","0","0","0","0","0","0","1","0","1","0","0","0","0","0","0","0","0","0","-2"
"165884","Benjamin Franklin Institute of Technology","2019","Not on tenure track/No tenure system system total","43","32","11","0","0","0","5","4","1","1","1","0","1","1","0","0","0","0","36","26","10","0","0","0","0","0","0","0","0","0","-2"
"165884","Benjamin Franklin Institute of Technology","2019","Not on tenure/no tenure system, professors","7","4","3","0","0","0","0","0","0","0","0","0","0","0","0","0","0","0","7","4","3","0","0","0","0","0","0","0","0","0","-2"
"165884","Benjamin Franklin Institute of Technology","2019","Not on tenure/no tenure system, associate professors","12","12","0","0","0","0","2","2","0","1","1","0","0","0","0","0","0","0","9","9","0","0","0","0","0","0","0","0","0","0","-2"
"165884","Benjamin Franklin Institute of Technology","2019","Not on tenure/no tenure system, assistant professors","14","9","5","0","0","0","3","2","1","0","0","0","1","1","0","0","0","0","10","6","4","0","0","0","0","0","0","0","0","0","-2"
"165884","Benjamin Franklin Institute of Technology","2019","Not on tenure/no tenure system, instructors","10","7","3","0","0","0","0","0","0","0","0","0","0","0","0","0","0","0","10","7","3","0","0","0","0","0","0","0","0","0","-2"
"182005","College of Southern Nevada","2019","Tenured total","371","198","173","4","2","2","33","18","15","18","7","11","21","9","12","0","0","0","290","158","132","3","2","1","0","0","0","2","2","0","-2"
"182005","College of Southern Nevada","2019","Tenured, professors","369","197","172","4","2","2","32","17","15","18","7","11","21","9","12","0","0","0","289","158","131","3","2","1","0","0","0","2","2","0","-2"
"182005","College of Southern Nevada","2019","Tenured, no academic rank","2","1","1","0","0","0","1","1","0","0","0","0","0","0","0","0","0","0","1","0","1","0","0","0","0","0","0","0","0","0","-2"
"182005","College of Southern Nevada","2019","On-Tenure track total","90","44","46","0","0","0","9","4","5","9","2","7","4","3","1","0","0","0","60","30","30","2","2","0","5","2","3","1","1","0","-2"
"182005","College of Southern Nevada","2019","On-tenure track, instructors","77","41","36","0","0","0","8","3","5","7","2","5","4","3","1","0","0","0","51","28","23","2","2","0","4","2","2","1","1","0","-2"
"182005","College of Southern Nevada","2019","On-tenure track, lecturers","1","0","1","0","0","0","0","0","0","0","0","0","0","0","0","0","0","0","1","0","1","0","0","0","0","0","0","0","0","0","-2"
"182005","College of Southern Nevada","2019","On-tenure track, no academic rank","12","3","9","0","0","0","1","1","0","2","0","2","0","0","0","0","0","0","8","2","6","0","0","0","1","0","1","0","0","0","-2"
"182005","College of Southern Nevada","2019","Not on tenure track/No tenure system system total","80","40","40","1","0","1","2","1","1","3","0","3","8","7","1","0","0","0","61","30","31","2","1","1","2","1","1","1","0","1","-2"
"182005","College of Southern Nevada","2019","Not on tenure/no tenure system, instructors","35","19","16","0","0","0","1","1","0","1","0","1","4","4","0","0","0","0","28","14","14","0","0","0","1","0","1","0","0","0","-2"
"182005","College of Southern Nevada","2019","Not on tenure/no tenure system, no academic rank","45","21","24","1","0","1","1","0","1","2","0","2","4","3","1","0","0","0","33","16","17","2","1","1","1","1","0","1","0","1","-2"
"182500","Truckee Meadows Community College","2019","Tenured total","106","55","51","0","0","0","5","1","4","1","0","1","6","3","3","0","0","0","93","51","42","1","0","1","0","0","0","0","0","0","-2"
"182500","Truckee Meadows Community College","2019","Tenured, professors","106","55","51","0","0","0","5","1","4","1","0","1","6","3","3","0","0","0","93","51","42","1","0","1","0","0","0","0","0","0","-2"
"182500","Truckee Meadows Community College","2019","On-Tenure track total","44","18","26","0","0","0","3","3","0","3","2","1","2","1","1","0","0","0","33","10","23","1","0","1","0","0","0","2","2","0","-2"
"182500","Truckee Meadows Community College","2019","On-tenure track, instructors","44","18","26","0","0","0","3","3","0","3","2","1","2","1","1","0","0","0","33","10","23","1","0","1","0","0","0","2","2","0","-2"
"182500","Truckee Meadows Community College","2019","Not on tenure track/No tenure system system total","16","9","7","0","0","0","2","2","0","1","1","0","1","1","0","0","0","0","12","5","7","0","0","0","0","0","0","0","0","0","-2"
"182500","Truckee Meadows Community College","2019","Not on tenure/no tenure system, instructors","16","9","7","0","0","0","2","2","0","1","1","0","1","1","0","0","0","0","12","5","7","0","0","0","0","0","0","0","0","0","-2"
"183822","Bloomfield College","2019","Tenured total","42","18","24","0","0","0","1","1","0","6","1","5","4","1","3","0","0","0","31","15","16","0","0","0","0","0","0","0","0","0","-2"
"183822","Bloomfield College","2019","Tenured, professors","28","11","17","0","0","0","0","0","0","4","0","4","2","0","2","0","0","0","22","11","11","0","0","0","0","0","0","0","0","0","-2"
"183822","Bloomfield College","2019","Tenured, associate professors","14","7","7","0","0","0","1","1","0","2","1","1","2","1","1","0","0","0","9","4","5","0","0","0","0","0","0","0","0","0","-2"
"183822","Bloomfield College","2019","On-Tenure track total","18","5","13","0","0","0","1","0","1","2","1","1","2","1","1","0","0","0","13","3","10","0","0","0","0","0","0","0","0","0","-2"
"183822","Bloomfield College","2019","On-tenure track, associate professors","5","2","3","0","0","0","0","0","0","1","1","0","2","1","1","0","0","0","2","0","2","0","0","0","0","0","0","0","0","0","-2"
"183822","Bloomfield College","2019","On-tenure track, assistant professors","13","3","10","0","0","0","1","0","1","1","0","1","0","0","0","0","0","0","11","3","8","0","0","0","0","0","0","0","0","0","-2"
"183822","Bloomfield College","2019","Not on tenure track/No tenure system system total","1","1","0","0","0","0","0","0","0","0","0","0","0","0","0","0","0","0","1","1","0","0","0","0","0","0","0","0","0","0","-2"
"183822","Bloomfield College","2019","Not on tenure/no tenure system, associate professors","1","1","0","0","0","0","0","0","0","0","0","0","0","0","0","0","0","0","1","1","0","0","0","0","0","0","0","0","0","0","-2"
"183910","Caldwell University","2019","Tenured total","42","20","22","0","0","0","2","1","1","0","0","0","1","1","0","0","0","0","37","18","19","0","0","0","2","0","2","0","0","0","-2"
"183910","Caldwell University","2019","Tenured, professors","35","17","18","0","0","0","2","1","1","0","0","0","1","1","0","0","0","0","30","15","15","0","0","0","2","0","2","0","0","0","-2"
"183910","Caldwell University","2019","Tenured, associate professors","6","3","3","0","0","0","0","0","0","0","0","0","0","0","0","0","0","0","6","3","3","0","0","0","0","0","0","0","0","0","-2"
"183910","Caldwell University","2019","Tenured, assistant professors","1","0","1","0","0","0","0","0","0","0","0","0","0","0","0","0","0","0","1","0","1","0","0","0","0","0","0","0","0","0","-2"
"183910","Caldwell University","2019","On-Tenure track total","33","8","25","0","0","0","2","0","2","2","0","2","2","0","2","0","0","0","26","8","18","1","0","1","0","0","0","0","0","0","-2"
"183910","Caldwell University","2019","On-tenure track, associate professors","6","1","5","0","0","0","0","0","0","0","0","0","2","0","2","0","0","0","4","1","3","0","0","0","0","0","0","0","0","0","-2"
"183910","Caldwell University","2019","On-tenure track, assistant professors","27","7","20","0","0","0","2","0","2","2","0","2","0","0","0","0","0","0","22","7","15","1","0","1","0","0","0","0","0","0","-2"
"183910","Caldwell University","2019","Not on tenure track/No tenure system system total","4","1","3","0","0","0","0","0","0","1","1","0","1","0","1","0","0","0","2","0","2","0","0","0","0","0","0","0","0","0","-2"
"183910","Caldwell University","2019","Not on tenure/no tenure system, assistant professors","1","1","0","0","0","0","0","0","0","1","1","0","0","0","0","0","0","0","0","0","0","0","0","0","0","0","0","0","0","0","-2"
"183910","Caldwell University","2019","Not on tenure/no tenure system, instructors","3","0","3","0","0","0","0","0","0","0","0","0","1","0","1","0","0","0","2","0","2","0","0","0","0","0","0","0","0","0","-2"
"184603","Fairleigh Dickinson University-Metropolitan Campus","2019","Tenured total","78","48","30","0","0","0","15","9","6","4","4","0","0","0","0","0","0","0","57","33","24","2","2","0","0","0","0","0","0","0","-2"
"184603","Fairleigh Dickinson University-Metropolitan Campus","2019","Tenured, professors","48","31","17","0","0","0","8","5","3","2","2","0","0","0","0","0","0","0","37","23","14","1","1","0","0","0","0","0","0","0","-2"
"184603","Fairleigh Dickinson University-Metropolitan Campus","2019","Tenured, associate professors","25","14","11","0","0","0","7","4","3","2","2","0","0","0","0","0","0","0","15","7","8","1","1","0","0","0","0","0","0","0","-2"
"184603","Fairleigh Dickinson University-Metropolitan Campus","2019","Tenured, assistant professors","5","3","2","0","0","0","0","0","0","0","0","0","0","0","0","0","0","0","5","3","2","0","0","0","0","0","0","0","0","0","-2"
"184603","Fairleigh Dickinson University-Metropolitan Campus","2019","On-Tenure track total","42","26","16","0","0","0","14","10","4","2","1","1","0","0","0","0","0","0","23","13","10","2","1","1","1","1","0","0","0","0","-2"
"184603","Fairleigh Dickinson University-Metropolitan Campus","2019","On-tenure track, associate professors","5","3","2","0","0","0","2","1","1","0","0","0","0","0","0","0","0","0","3","2","1","0","0","0","0","0","0","0","0","0","-2"
"184603","Fairleigh Dickinson University-Metropolitan Campus","2019","On-tenure track, assistant professors","37","23","14","0","0","0","12","9","3","2","1","1","0","0","0","0","0","0","20","11","9","2","1","1","1","1","0","0","0","0","-2"
"184603","Fairleigh Dickinson University-Metropolitan Campus","2019","Not on tenure track/No tenure system system total","43","17","26","0","0","0","4","1","3","3","0","3","0","0","0","0","0","0","29","14","15","7","2","5","0","0","0","0","0","0","-2"
"184603","Fairleigh Dickinson University-Metropolitan Campus","2019","Not on tenure/no tenure system, associate professors","1","0","1","0","0","0","0","0","0","0","0","0","0","0","0","0","0","0","0","0","0","1","0","1","0","0","0","0","0","0","-2"
"184603","Fairleigh Dickinson University-Metropolitan Campus","2019","Not on tenure/no tenure system, assistant professors","4","0","4","0","0","0","2","0","2","1","0","1","0","0","0","0","0","0","1","0","1","0","0","0","0","0","0","0","0","0","-2"
"184603","Fairleigh Dickinson University-Metropolitan Campus","2019","Not on tenure/no tenure system, instructors","4","0","4","0","0","0","0","0","0","1","0","1","0","0","0","0","0","0","3","0","3","0","0","0","0","0","0","0","0","0","-2"
"184603","Fairleigh Dickinson University-Metropolitan Campus","2019","Not on tenure/no tenure system, lecturers","34","17","17","0","0","0","2","1","1","1","0","1","0","0","0","0","0","0","25","14","11","6","2","4","0","0","0","0","0","0","-2"
"184612","Felician University","2019","Not on tenure track/No tenure system system total","82","32","50","0","0","0","8","4","4","5","1","4","6","1","5","0","0","0","62","26","36","0","0","0","1","0","1","0","0","0","-2"
"184612","Felician University","2019","Not on tenure/no tenure system, professors","14","6","8","0","0","0","0","0","0","1","0","1","0","0","0","0","0","0","13","6","7","0","0","0","0","0","0","0","0","0","-2"
"184612","Felician University","2019","Not on tenure/no tenure system, associate professors","26","15","11","0","0","0","3","2","1","0","0","0","3","1","2","0","0","0","20","12","8","0","0","0","0","0","0","0","0","0","-2"
"184612","Felician University","2019","Not on tenure/no tenure system, assistant professors","30","11","19","0","0","0","4","2","2","4","1","3","3","0","3","0","0","0","19","8","11","0","0","0","0","0","0","0","0","0","-2"
"184612","Felician University","2019","Not on tenure/no tenure system, instructors","12","0","12","0","0","0","1","0","1","0","0","0","0","0","0","0","0","0","10","0","10","0","0","0","1","0","1","0","0","0","-2"
"185129","New Jersey City University","2019","Tenured total","162","77","85","0","0","0","24","10","14","22","8","14","14","5","9","0","0","0","102","54","48","0","0","0","0","0","0","0","0","0","-2"
"185129","New Jersey City University","2019","Tenured, professors","73","35","38","0","0","0","14","6","8","10","4","6","6","3","3","0","0","0","43","22","21","0","0","0","0","0","0","0","0","0","-2"
"185129","New Jersey City University","2019","Tenured, associate professors","67","36","31","0","0","0","6","3","3","9","3","6","5","2","3","0","0","0","47","28","19","0","0","0","0","0","0","0","0","0","-2"
"185129","New Jersey City University","2019","Tenured, assistant professors","22","6","16","0","0","0","4","1","3","3","1","2","3","0","3","0","0","0","12","4","8","0","0","0","0","0","0","0","0","0","-2"
"185129","New Jersey City University","2019","On-Tenure track total","82","47","35","0","0","0","20","14","6","6","3","3","9","7","2","0","0","0","33","16","17","2","1","1","12","6","6","0","0","0","-2"
"185129","New Jersey City University","2019","On-tenure track, professors","4","4","0","0","0","0","1","1","0","0","0","0","2","2","0","0","0","0","1","1","0","0","0","0","0","0","0","0","0","0","-2"
"185129","New Jersey City University","2019","On-tenure track, associate professors","16","7","9","0","0","0","7","4","3","0","0","0","1","0","1","0","0","0","7","2","5","0","0","0","1","1","0","0","0","0","-2"
"185129","New Jersey City University","2019","On-tenure track, assistant professors","62","36","26","0","0","0","12","9","3","6","3","3","6","5","1","0","0","0","25","13","12","2","1","1","11","5","6","0","0","0","-2"
"185129","New Jersey City University","2019","Not on tenure track/No tenure system system total","5","5","0","0","0","0","0","0","0","1","1","0","0","0","0","0","0","0","4","4","0","0","0","0","0","0","0","0","0","0","-2"
"185129","New Jersey City University","2019","Not on tenure/no tenure system, associate professors","1","1","0","0","0","0","0","0","0","0","0","0","0","0","0","0","0","0","1","1","0","0","0","0","0","0","0","0","0","0","-2"
"185129","New Jersey City University","2019","Not on tenure/no tenure system, assistant professors","4","4","0","0","0","0","0","0","0","1","1","0","0","0","0","0","0","0","3","3","0","0","0","0","0","0","0","0","0","0","-2"
"185590","Montclair State University","2019","Tenured total","408","213","195","0","0","0","65","31","34","29","14","15","31","17","14","0","0","0","263","138","125","5","4","1","11","7","4","4","2","2","-2"
"185590","Montclair State University","2019","Tenured, professors","193","101","92","0","0","0","29","16","13","11","5","6","18","11","7","0","0","0","131","66","65","1","1","0","3","2","1","0","0","0","-2"
"185590","Montclair State University","2019","Tenured, associate professors","199","106","93","0","0","0","36","15","21","16","9","7","11","5","6","0","0","0","123","68","55","4","3","1","7","5","2","2","1","1","-2"
"185590","Montclair State University","2019","Tenured, assistant professors","16","6","10","0","0","0","0","0","0","2","0","2","2","1","1","0","0","0","9","4","5","0","0","0","1","0","1","2","1","1","-2"
"185590","Montclair State University","2019","On-Tenure track total","131","69","62","0","0","0","8","5","3","6","3","3","8","4","4","0","0","0","49","24","25","1","0","1","41","21","20","18","12","6","-2"
"185590","Montclair State University","2019","On-tenure track, professors","2","1","1","0","0","0","0","0","0","0","0","0","0","0","0","0","0","0","0","0","0","0","0","0","2","1","1","0","0","0","-2"
"185590","Montclair State University","2019","On-tenure track, associate professors","13","7","6","0","0","0","0","0","0","1","1","0","1","1","0","0","0","0","5","3","2","0","0","0","5","1","4","1","1","0","-2"
"185590","Montclair State University","2019","On-tenure track, assistant professors","116","61","55","0","0","0","8","5","3","5","2","3","7","3","4","0","0","0","44","21","23","1","0","1","34","19","15","17","11","6","-2"
"185590","Montclair State University","2019","Not on tenure track/No tenure system system total","104","46","58","0","0","0","8","6","2","6","3","3","5","1","4","0","0","0","58","25","33","2","1","1","24","9","15","1","1","0","-2"
"185590","Montclair State University","2019","Not on tenure/no tenure system, assistant professors","17","11","6","0","0","0","2","1","1","2","2","0","0","0","0","0","0","0","4","4","0","1","1","0","8","3","5","0","0","0","-2"
"185590","Montclair State University","2019","Not on tenure/no tenure system, instructors","1","0","1","0","0","0","0","0","0","0","0","0","0","0","0","0","0","0","0","0","0","0","0","0","1","0","1","0","0","0","-2"
"185590","Montclair State University","2019","Not on tenure/no tenure system, no academic rank","86","35","51","0","0","0","6","5","1","4","1","3","5","1","4","0","0","0","54","21","33","1","0","1","15","6","9","1","1","0","-2"
"186399","Rutgers University-Newark","2019","Tenured total","290","192","98","1","0","1","41","30","11","20","12","8","11","9","2","0","0","0","163","110","53","3","1","2","26","15","11","25","15","10","-2"
"186399","Rutgers University-Newark","2019","Tenured, professors","176","125","51","0","0","0","27","21","6","9","7","2","6","6","0","0","0","0","118","85","33","0","0","0","10","3","7","6","3","3","-2"
"186399","Rutgers University-Newark","2019","Tenured, associate professors","114","67","47","1","0","1","14","9","5","11","5","6","5","3","2","0","0","0","45","25","20","3","1","2","16","12","4","19","12","7","-2"
"186399","Rutgers University-Newark","2019","On-Tenure track total","111","60","51","0","0","0","5","3","2","5","3","2","7","3","4","0","0","0","21","14","7","0","0","0","46","17","29","27","20","7","-2"
"186399","Rutgers University-Newark","2019","On-tenure track, professors","9","3","6","0","0","0","0","0","0","1","1","0","0","0","0","0","0","0","1","0","1","0","0","0","6","2","4","1","0","1","-2"
"186399","Rutgers University-Newark","2019","On-tenure track, associate professors","14","10","4","0","0","0","0","0","0","1","0","1","0","0","0","0","0","0","5","3","2","0","0","0","5","4","1","3","3","0","-2"
"186399","Rutgers University-Newark","2019","On-tenure track, assistant professors","88","47","41","0","0","0","5","3","2","3","2","1","7","3","4","0","0","0","15","11","4","0","0","0","35","11","24","23","17","6","-2"
"186399","Rutgers University-Newark","2019","Not on tenure track/No tenure system system total","179","102","77","0","0","0","13","4","9","18","13","5","5","4","1","0","0","0","74","45","29","0","0","0","54","27","27","15","9","6","-2"
"186399","Rutgers University-Newark","2019","Not on tenure/no tenure system, professors","16","8","8","0","0","0","0","0","0","2","1","1","1","1","0","0","0","0","11","4","7","0","0","0","2","2","0","0","0","0","-2"
"186399","Rutgers University-Newark","2019","Not on tenure/no tenure system, associate professors","22","14","8","0","0","0","1","0","1","1","1","0","0","0","0","0","0","0","12","9","3","0","0","0","8","4","4","0","0","0","-2"
"186399","Rutgers University-Newark","2019","Not on tenure/no tenure system, assistant professors","108","67","41","0","0","0","9","4","5","10","8","2","3","3","0","0","0","0","43","30","13","0","0","0","31","14","17","12","8","4","-2"
"186399","Rutgers University-Newark","2019","Not on tenure/no tenure system, instructors","28","10","18","0","0","0","3","0","3","4","2","2","1","0","1","0","0","0","5","1","4","0","0","0","12","6","6","3","1","2","-2"
"186399","Rutgers University-Newark","2019","Not on tenure/no tenure system, lecturers","5","3","2","0","0","0","0","0","0","1","1","0","0","0","0","0","0","0","3","1","2","0","0","0","1","1","0","0","0","0","-2"
"186432","Saint Peter's University","2019","Tenured total","65","34","31","0","0","0","2","1","1","3","2","1","5","2","3","0","0","0","55","29","26","0","0","0","0","0","0","0","0","0","-2"
"186432","Saint Peter's University","2019","Tenured, professors","29","16","13","0","0","0","0","0","0","0","0","0","3","1","2","0","0","0","26","15","11","0","0","0","0","0","0","0","0","0","-2"
"186432","Saint Peter's University","2019","Tenured, associate professors","30","14","16","0","0","0","1","1","0","1","0","1","2","1","1","0","0","0","26","12","14","0","0","0","0","0","0","0","0","0","-2"
"186432","Saint Peter's University","2019","Tenured, assistant professors","5","4","1","0","0","0","0","0","0","2","2","0","0","0","0","0","0","0","3","2","1","0","0","0","0","0","0","0","0","0","-2"
"186432","Saint Peter's University","2019","Tenured, lecturers","1","0","1","0","0","0","1","0","1","0","0","0","0","0","0","0","0","0","0","0","0","0","0","0","0","0","0","0","0","0","-2"
"186432","Saint Peter's University","2019","On-Tenure track total","30","14","16","0","0","0","3","2","1","3","1","2","4","2","2","0","0","0","19","9","10","1","0","1","0","0","0","0","0","0","-2"
"186432","Saint Peter's University","2019","On-tenure track, associate professors","4","4","0","0","0","0","0","0","0","0","0","0","0","0","0","0","0","0","4","4","0","0","0","0","0","0","0","0","0","0","-2"
"186432","Saint Peter's University","2019","On-tenure track, assistant professors","25","10","15","0","0","0","3","2","1","3","1","2","4","2","2","0","0","0","15","5","10","0","0","0","0","0","0","0","0","0","-2"
"186432","Saint Peter's University","2019","On-tenure track, instructors","1","0","1","0","0","0","0","0","0","0","0","0","0","0","0","0","0","0","0","0","0","1","0","1","0","0","0","0","0","0","-2"
"186432","Saint Peter's University","2019","Not on tenure track/No tenure system system total","19","7","12","0","0","0","4","2","2","1","0","1","0","0","0","0","0","0","14","5","9","0","0","0","0","0","0","0","0","0","-2"
"186432","Saint Peter's University","2019","Not on tenure/no tenure system, assistant professors","3","1","2","0","0","0","3","1","2","0","0","0","0","0","0","0","0","0","0","0","0","0","0","0","0","0","0","0","0","0","-2"
"186432","Saint Peter's University","2019","Not on tenure/no tenure system, instructors","7","3","4","0","0","0","1","1","0","0","0","0","0","0","0","0","0","0","6","2","4","0","0","0","0","0","0","0","0","0","-2"
"186432","Saint Peter's University","2019","Not on tenure/no tenure system, lecturers","6","3","3","0","0","0","0","0","0","1","0","1","0","0","0","0","0","0","5","3","2","0","0","0","0","0","0","0","0","0","-2"
"186432","Saint Peter's University","2019","Not on tenure/no tenure system, no academic rank","3","0","3","0","0","0","0","0","0","0","0","0","0","0","0","0","0","0","3","0","3","0","0","0","0","0","0","0","0","0","-2"
"187444","William Paterson University of New Jersey","2019","Tenured total","287","140","147","0","0","0","58","33","25","25","18","7","22","9","13","0","0","0","176","78","98","4","1","3","2","1","1","0","0","0","-2"
"187444","William Paterson University of New Jersey","2019","Tenured, professors","194","106","88","0","0","0","46","29","17","16","13","3","13","8","5","0","0","0","114","54","60","3","1","2","2","1","1","0","0","0","-2"
"187444","William Paterson University of New Jersey","2019","Tenured, associate professors","87","32","55","0","0","0","12","4","8","7","4","3","8","1","7","0","0","0","59","23","36","1","0","1","0","0","0","0","0","0","-2"
"187444","William Paterson University of New Jersey","2019","Tenured, assistant professors","6","2","4","0","0","0","0","0","0","2","1","1","1","0","1","0","0","0","3","1","2","0","0","0","0","0","0","0","0","0","-2"
"187444","William Paterson University of New Jersey","2019","On-Tenure track total","87","40","47","0","0","0","17","7","10","9","4","5","4","2","2","0","0","0","51","25","26","0","0","0","1","0","1","5","2","3","-2"
"187444","William Paterson University of New Jersey","2019","On-tenure track, professors","1","1","0","0","0","0","0","0","0","0","0","0","0","0","0","0","0","0","1","1","0","0","0","0","0","0","0","0","0","0","-2"
"187444","William Paterson University of New Jersey","2019","On-tenure track, associate professors","5","3","2","0","0","0","2","2","0","0","0","0","0","0","0","0","0","0","3","1","2","0","0","0","0","0","0","0","0","0","-2"
"187444","William Paterson University of New Jersey","2019","On-tenure track, assistant professors","78","34","44","0","0","0","15","5","10","9","4","5","4","2","2","0","0","0","44","21","23","0","0","0","1","0","1","5","2","3","-2"
"187444","William Paterson University of New Jersey","2019","On-tenure track, instructors","3","2","1","0","0","0","0","0","0","0","0","0","0","0","0","0","0","0","3","2","1","0","0","0","0","0","0","0","0","0","-2"
"187444","William Paterson University of New Jersey","2019","Not on tenure track/No tenure system system total","17","9","8","0","0","0","2","1","1","2","0","2","2","1","1","0","0","0","11","7","4","0","0","0","0","0","0","0","0","0","-2"
"187444","William Paterson University of New Jersey","2019","Not on tenure/no tenure system, assistant professors","10","4","6","0","0","0","2","1","1","1","0","1","1","0","1","0","0","0","6","3","3","0","0","0","0","0","0","0","0","0","-2"
"187444","William Paterson University of New Jersey","2019","Not on tenure/no tenure system, instructors","7","5","2","0","0","0","0","0","0","1","0","1","1","1","0","0","0","0","5","4","1","0","0","0","0","0","0","0","0","0","-2"
"187648","Eastern New Mexico University-Main Campus","2019","Tenured total","52","30","22","0","0","0","3","3","0","0","0","0","2","1","1","0","0","0","42","23","19","0","0","0","0","0","0","5","3","2","-2"
"187648","Eastern New Mexico University-Main Campus","2019","Tenured, professors","32","21","11","0","0","0","3","3","0","0","0","0","2","1","1","0","0","0","24","15","9","0","0","0","0","0","0","3","2","1","-2"
"187648","Eastern New Mexico University-Main Campus","2019","Tenured, associate professors","17","7","10","0","0","0","0","0","0","0","0","0","0","0","0","0","0","0","15","6","9","0","0","0","0","0","0","2","1","1","-2"
"187648","Eastern New Mexico University-Main Campus","2019","Tenured, instructors","3","2","1","0","0","0","0","0","0","0","0","0","0","0","0","0","0","0","3","2","1","0","0","0","0","0","0","0","0","0","-2"
"187648","Eastern New Mexico University-Main Campus","2019","On-Tenure track total","69","45","24","0","0","0","1","1","0","1","0","1","4","2","2","0","0","0","44","27","17","0","0","0","5","4","1","14","11","3","-2"
"187648","Eastern New Mexico University-Main Campus","2019","On-tenure track, associate professors","2","1","1","0","0","0","0","0","0","1","0","1","0","0","0","0","0","0","0","0","0","0","0","0","0","0","0","1","1","0","-2"
"187648","Eastern New Mexico University-Main Campus","2019","On-tenure track, assistant professors","67","44","23","0","0","0","1","1","0","0","0","0","4","2","2","0","0","0","44","27","17","0","0","0","5","4","1","13","10","3","-2"
"187648","Eastern New Mexico University-Main Campus","2019","Not on tenure track/No tenure system system total","42","12","30","0","0","0","0","0","0","1","1","0","4","1","3","0","0","0","32","8","24","1","0","1","3","1","2","1","1","0","-2"
"187648","Eastern New Mexico University-Main Campus","2019","Not on tenure/no tenure system, professors","1","1","0","0","0","0","0","0","0","1","1","0","0","0","0","0","0","0","0","0","0","0","0","0","0","0","0","0","0","0","-2"
"187648","Eastern New Mexico University-Main Campus","2019","Not on tenure/no tenure system, assistant professors","2","0","2","0","0","0","0","0","0","0","0","0","1","0","1","0","0","0","1","0","1","0","0","0","0","0","0","0","0","0","-2"
"187648","Eastern New Mexico University-Main Campus","2019","Not on tenure/no tenure system, instructors","39","11","28","0","0","0","0","0","0","0","0","0","3","1","2","0","0","0","31","8","23","1","0","1","3","1","2","1","1","0","-2"
"187897","New Mexico Highlands University","2019","Tenured total","56","32","24","1","1","0","4","3","1","2","1","1","11","7","4","0","0","0","33","18","15","1","0","1","1","0","1","3","2","1","-2"
"187897","New Mexico Highlands University","2019","Tenured, professors","25","14","11","1","1","0","0","0","0","0","0","0","6","5","1","0","0","0","16","8","8","0","0","0","1","0","1","1","0","1","-2"
"187897","New Mexico Highlands University","2019","Tenured, associate professors","30","17","13","0","0","0","4","3","1","2","1","1","4","1","3","0","0","0","17","10","7","1","0","1","0","0","0","2","2","0","-2"
"187897","New Mexico Highlands University","2019","Tenured, assistant professors","1","1","0","0","0","0","0","0","0","0","0","0","1","1","0","0","0","0","0","0","0","0","0","0","0","0","0","0","0","0","-2"
"187897","New Mexico Highlands University","2019","On-Tenure track total","28","12","16","0","0","0","0","0","0","0","0","0","7","2","5","0","0","0","16","8","8","0","0","0","3","2","1","2","0","2","-2"
"187897","New Mexico Highlands University","2019","On-tenure track, associate professors","3","3","0","0","0","0","0","0","0","0","0","0","0","0","0","0","0","0","1","1","0","0","0","0","2","2","0","0","0","0","-2"
"187897","New Mexico Highlands University","2019","On-tenure track, assistant professors","25","9","16","0","0","0","0","0","0","0","0","0","7","2","5","0","0","0","15","7","8","0","0","0","1","0","1","2","0","2","-2"
"187897","New Mexico Highlands University","2019","Not on tenure track/No tenure system system total","48","22","26","0","0","0","2","0","2","0","0","0","18","7","11","0","0","0","24","13","11","1","1","0","0","0","0","3","1","2","-2"
"187897","New Mexico Highlands University","2019","Not on tenure/no tenure system, assistant professors","4","3","1","0","0","0","0","0","0","0","0","0","2","1","1","0","0","0","2","2","0","0","0","0","0","0","0","0","0","0","-2"
"187897","New Mexico Highlands University","2019","Not on tenure/no tenure system, instructors","44","19","25","0","0","0","2","0","2","0","0","0","16","6","10","0","0","0","22","11","11","1","1","0","0","0","0","3","1","2","-2"
"187985","University of New Mexico-Main Campus","2019","Tenured total","591","345","246","20","7","13","73","51","22","8","4","4","82","37","45","0","0","0","361","221","140","3","1","2","38","18","20","6","6","0","-2"
"187985","University of New Mexico-Main Campus","2019","Tenured, professors","296","186","110","10","3","7","41","29","12","2","0","2","32","14","18","0","0","0","203","136","67","0","0","0","7","3","4","1","1","0","-2"
"187985","University of New Mexico-Main Campus","2019","Tenured, associate professors","294","158","136","10","4","6","32","22","10","6","4","2","49","22","27","0","0","0","158","85","73","3","1","2","31","15","16","5","5","0","-2"
"187985","University of New Mexico-Main Campus","2019","Tenured, assistant professors","1","1","0","0","0","0","0","0","0","0","0","0","1","1","0","0","0","0","0","0","0","0","0","0","0","0","0","0","0","0","-2"
"187985","University of New Mexico-Main Campus","2019","On-Tenure track total","253","119","134","8","2","6","20","13","7","3","1","2","33","11","22","0","0","0","122","54","68","4","3","1","23","13","10","40","22","18","-2"
"187985","University of New Mexico-Main Campus","2019","On-tenure track, professors","3","2","1","0","0","0","0","0","0","0","0","0","0","0","0","0","0","0","3","2","1","0","0","0","0","0","0","0","0","0","-2"
"187985","University of New Mexico-Main Campus","2019","On-tenure track, associate professors","19","6","13","0","0","0","3","2","1","0","0","0","3","1","2","0","0","0","10","2","8","0","0","0","3","1","2","0","0","0","-2"
"187985","University of New Mexico-Main Campus","2019","On-tenure track, assistant professors","231","111","120","8","2","6","17","11","6","3","1","2","30","10","20","0","0","0","109","50","59","4","3","1","20","12","8","40","22","18","-2"
"187985","University of New Mexico-Main Campus","2019","Not on tenure track/No tenure system system total","882","391","491","11","3","8","67","39","28","15","5","10","141","44","97","0","0","0","562","260","302","18","6","12","24","11","13","44","23","21","-2"
"187985","University of New Mexico-Main Campus","2019","Not on tenure/no tenure system, professors","108","65","43","2","2","0","5","3","2","1","0","1","4","2","2","0","0","0","89","53","36","1","1","0","5","3","2","1","1","0","-2"
"187985","University of New Mexico-Main Campus","2019","Not on tenure/no tenure system, associate professors","183","84","99","1","0","1","26","16","10","3","0","3","31","13","18","0","0","0","111","51","60","3","1","2","3","1","2","5","2","3","-2"
"187985","University of New Mexico-Main Campus","2019","Not on tenure/no tenure system, assistant professors","317","142","175","2","0","2","28","14","14","5","2","3","51","16","35","0","0","0","190","90","100","7","4","3","4","1","3","30","15","15","-2"
"187985","University of New Mexico-Main Campus","2019","Not on tenure/no tenure system, instructors","64","28","36","0","0","0","4","4","0","2","2","0","9","1","8","0","0","0","41","19","22","4","0","4","3","2","1","1","0","1","-2"
"187985","University of New Mexico-Main Campus","2019","Not on tenure/no tenure system, lecturers","209","71","138","6","1","5","4","2","2","4","1","3","46","12","34","0","0","0","131","47","84","3","0","3","9","4","5","6","4","2","-2"
"187985","University of New Mexico-Main Campus","2019","Not on tenure/no tenure system, no academic rank","1","1","0","0","0","0","0","0","0","0","0","0","0","0","0","0","0","0","0","0","0","0","0","0","0","0","0","1","1","0","-2"
"188030","New Mexico State University-Main Campus","2019","Tenured total","351","226","125","2","2","0","43","33","10","5","4","1","57","31","26","0","0","0","236","149","87","2","2","0","0","0","0","6","5","1","-2"
"188030","New Mexico State University-Main Campus","2019","Tenured, professors","182","126","56","2","2","0","23","17","6","3","3","0","15","9","6","0","0","0","133","89","44","2","2","0","0","0","0","4","4","0","-2"
"188030","New Mexico State University-Main Campus","2019","Tenured, associate professors","163","98","65","0","0","0","20","16","4","2","1","1","41","22","19","0","0","0","98","58","40","0","0","0","0","0","0","2","1","1","-2"
"188030","New Mexico State University-Main Campus","2019","Tenured, assistant professors","6","2","4","0","0","0","0","0","0","0","0","0","1","0","1","0","0","0","5","2","3","0","0","0","0","0","0","0","0","0","-2"
"188030","New Mexico State University-Main Campus","2019","On-Tenure track total","142","77","65","2","1","1","15","8","7","4","1","3","17","9","8","0","0","0","72","34","38","2","2","0","0","0","0","30","22","8","-2"
"188030","New Mexico State University-Main Campus","2019","On-tenure track, associate professors","3","1","2","0","0","0","1","1","0","0","0","0","0","0","0","0","0","0","2","0","2","0","0","0","0","0","0","0","0","0","-2"
"188030","New Mexico State University-Main Campus","2019","On-tenure track, assistant professors","139","76","63","2","1","1","14","7","7","4","1","3","17","9","8","0","0","0","70","34","36","2","2","0","0","0","0","30","22","8","-2"
"188030","New Mexico State University-Main Campus","2019","Not on tenure track/No tenure system system total","135","46","89","2","2","0","8","4","4","1","1","0","35","7","28","0","0","0","81","28","53","4","2","2","1","0","1","3","2","1","-2"
"188030","New Mexico State University-Main Campus","2019","Not on tenure/no tenure system, professors","20","10","10","1","1","0","0","0","0","0","0","0","1","1","0","0","0","0","18","8","10","0","0","0","0","0","0","0","0","0","-2"
"188030","New Mexico State University-Main Campus","2019","Not on tenure/no tenure system, associate professors","24","4","20","0","0","0","0","0","0","0","0","0","7","0","7","0","0","0","14","2","12","3","2","1","0","0","0","0","0","0","-2"
"188030","New Mexico State University-Main Campus","2019","Not on tenure/no tenure system, assistant professors","57","19","38","0","0","0","2","0","2","0","0","0","20","3","17","0","0","0","34","15","19","0","0","0","0","0","0","1","1","0","-2"
"188030","New Mexico State University-Main Campus","2019","Not on tenure/no tenure system, instructors","5","3","2","0","0","0","1","1","0","0","0","0","1","0","1","0","0","0","2","2","0","1","0","1","0","0","0","0","0","0","-2"
"188030","New Mexico State University-Main Campus","2019","Not on tenure/no tenure system, no academic rank","29","10","19","1","1","0","5","3","2","1","1","0","6","3","3","0","0","0","13","1","12","0","0","0","1","0","1","2","1","1","-2"
"188058","Northern New Mexico College","2019","Tenured total","18","6","12","0","0","0","2","2","0","0","0","0","9","3","6","0","0","0","5","1","4","0","0","0","2","0","2","0","0","0","-2"
"188058","Northern New Mexico College","2019","Tenured, associate professors","18","6","12","0","0","0","2","2","0","0","0","0","9","3","6","0","0","0","5","1","4","0","0","0","2","0","2","0","0","0","-2"
"188058","Northern New Mexico College","2019","On-Tenure track total","22","7","15","0","0","0","1","0","1","0","0","0","3","0","3","0","0","0","8","3","5","0","0","0","10","4","6","0","0","0","-2"
"188058","Northern New Mexico College","2019","On-tenure track, assistant professors","22","7","15","0","0","0","1","0","1","0","0","0","3","0","3","0","0","0","8","3","5","0","0","0","10","4","6","0","0","0","-2"
"188058","Northern New Mexico College","2019","Not on tenure track/No tenure system system total","6","2","4","0","0","0","0","0","0","0","0","0","1","0","1","0","0","0","4","1","3","0","0","0","1","1","0","0","0","0","-2"
"188058","Northern New Mexico College","2019","Not on tenure/no tenure system, instructors","3","1","2","0","0","0","0","0","0","0","0","0","1","0","1","0","0","0","1","0","1","0","0","0","1","1","0","0","0","0","-2"
"188058","Northern New Mexico College","2019","Not on tenure/no tenure system, lecturers","3","1","2","0","0","0","0","0","0","0","0","0","0","0","0","0","0","0","3","1","2","0","0","0","0","0","0","0","0","0","-2"
"188182","University of the Southwest","2019","Not on tenure track/No tenure system system total","27","10","17","0","0","0","1","1","0","1","0","1","2","1","1","0","0","0","9","2","7","0","0","0","14","6","8","0","0","0","-2"
"188182","University of the Southwest","2019","Not on tenure/no tenure system, professors","3","1","2","0","0","0","0","0","0","0","0","0","0","0","0","0","0","0","1","0","1","0","0","0","2","1","1","0","0","0","-2"
"188182","University of the Southwest","2019","Not on tenure/no tenure system, associate professors","5","2","3","0","0","0","0","0","0","0","0","0","0","0","0","0","0","0","1","0","1","0","0","0","4","2","2","0","0","0","-2"
"188182","University of the Southwest","2019","Not on tenure/no tenure system, assistant professors","13","5","8","0","0","0","1","1","0","1","0","1","2","1","1","0","0","0","5","1","4","0","0","0","4","2","2","0","0","0","-2"
"188182","University of the Southwest","2019","Not on tenure/no tenure system, instructors","5","1","4","0","0","0","0","0","0","0","0","0","0","0","0","0","0","0","2","1","1","0","0","0","3","0","3","0","0","0","-2"
"188182","University of the Southwest","2019","Not on tenure/no tenure system, lecturers","1","1","0","0","0","0","0","0","0","0","0","0","0","0","0","0","0","0","0","0","0","0","0","0","1","1","0","0","0","0","-2"
"188304","Western New Mexico University","2019","Tenured total","43","22","21","0","0","0","3","2","1","0","0","0","12","7","5","0","0","0","22","10","12","0","0","0","6","3","3","0","0","0","-2"
"188304","Western New Mexico University","2019","Tenured, professors","17","11","6","0","0","0","0","0","0","0","0","0","3","2","1","0","0","0","9","6","3","0","0","0","5","3","2","0","0","0","-2"
"188304","Western New Mexico University","2019","Tenured, associate professors","26","11","15","0","0","0","3","2","1","0","0","0","9","5","4","0","0","0","13","4","9","0","0","0","1","0","1","0","0","0","-2"
"188304","Western New Mexico University","2019","On-Tenure track total","36","15","21","0","0","0","3","2","1","3","1","2","4","1","3","0","0","0","20","9","11","0","0","0","6","2","4","0","0","0","-2"
"188304","Western New Mexico University","2019","On-tenure track, associate professors","5","2","3","0","0","0","0","0","0","1","1","0","0","0","0","0","0","0","3","1","2","0","0","0","1","0","1","0","0","0","-2"
"188304","Western New Mexico University","2019","On-tenure track, assistant professors","30","13","17","0","0","0","3","2","1","2","0","2","4","1","3","0","0","0","17","8","9","0","0","0","4","2","2","0","0","0","-2"
"188304","Western New Mexico University","2019","On-tenure track, instructors","1","0","1","0","0","0","0","0","0","0","0","0","0","0","0","0","0","0","0","0","0","0","0","0","1","0","1","0","0","0","-2"
"188304","Western New Mexico University","2019","Not on tenure track/No tenure system system total","13","7","6","0","0","0","0","0","0","0","0","0","3","3","0","0","0","0","7","3","4","0","0","0","3","1","2","0","0","0","-2"
"188304","Western New Mexico University","2019","Not on tenure/no tenure system, assistant professors","4","0","4","0","0","0","0","0","0","0","0","0","0","0","0","0","0","0","2","0","2","0","0","0","2","0","2","0","0","0","-2"
"188304","Western New Mexico University","2019","Not on tenure/no tenure system, instructors","9","7","2","0","0","0","0","0","0","0","0","0","3","3","0","0","0","0","5","3","2","0","0","0","1","1","0","0","0","0","-2"
"188340","Vaughn College of Aeronautics and Technology","2019","Tenured total","16","12","4","0","0","0","2","1","1","1","0","1","0","0","0","4","4","0","9","7","2","0","0","0","0","0","0","0","0","0","-2"
"188340","Vaughn College of Aeronautics and Technology","2019","Tenured, professors","11","8","3","0","0","0","1","0","1","1","0","1","0","0","0","2","2","0","7","6","1","0","0","0","0","0","0","0","0","0","-2"
"188340","Vaughn College of Aeronautics and Technology","2019","Tenured, associate professors","5","4","1","0","0","0","1","1","0","0","0","0","0","0","0","2","2","0","2","1","1","0","0","0","0","0","0","0","0","0","-2"
"188340","Vaughn College of Aeronautics and Technology","2019","On-Tenure track total","9","5","4","0","0","0","1","0","1","0","0","0","1","1","0","0","0","0","7","4","3","0","0","0","0","0","0","0","0","0","-2"
"188340","Vaughn College of Aeronautics and Technology","2019","On-tenure track, associate professors","2","1","1","0","0","0","1","0","1","0","0","0","0","0","0","0","0","0","1","1","0","0","0","0","0","0","0","0","0","0","-2"
"188340","Vaughn College of Aeronautics and Technology","2019","On-tenure track, assistant professors","7","4","3","0","0","0","0","0","0","0","0","0","1","1","0","0","0","0","6","3","3","0","0","0","0","0","0","0","0","0","-2"
"188340","Vaughn College of Aeronautics and Technology","2019","Not on tenure track/No tenure system system total","15","13","2","0","0","0","0","0","0","2","2","0","2","1","1","3","3","0","7","6","1","1","1","0","0","0","0","0","0","0","-2"
"188340","Vaughn College of Aeronautics and Technology","2019","Not on tenure/no tenure system, associate professors","2","2","0","0","0","0","0","0","0","1","1","0","0","0","0","0","0","0","1","1","0","0","0","0","0","0","0","0","0","0","-2"
"188340","Vaughn College of Aeronautics and Technology","2019","Not on tenure/no tenure system, assistant professors","8","6","2","0","0","0","0","0","0","0","0","0","2","1","1","1","1","0","5","4","1","0","0","0","0","0","0","0","0","0","-2"
"188340","Vaughn College of Aeronautics and Technology","2019","Not on tenure/no tenure system, instructors","5","5","0","0","0","0","0","0","0","1","1","0","0","0","0","2","2","0","1","1","0","1","1","0","0","0","0","0","0","0","-2"
"189413","Boricua College","2019","Not on tenure track/No tenure system system total","39","14","25","0","0","0","0","0","0","3","1","2","31","13","18","0","0","0","5","0","5","0","0","0","0","0","0","0","0","0","-2"
"189413","Boricua College","2019","Not on tenure/no tenure system, professors","3","2","1","0","0","0","0","0","0","1","1","0","2","1","1","0","0","0","0","0","0","0","0","0","0","0","0","0","0","0","-2"
"189413","Boricua College","2019","Not on tenure/no tenure system, associate professors","7","3","4","0","0","0","0","0","0","0","0","0","5","3","2","0","0","0","2","0","2","0","0","0","0","0","0","0","0","0","-2"
"189413","Boricua College","2019","Not on tenure/no tenure system, assistant professors","16","6","10","0","0","0","0","0","0","1","0","1","14","6","8","0","0","0","1","0","1","0","0","0","0","0","0","0","0","0","-2"
"189413","Boricua College","2019","Not on tenure/no tenure system, instructors","13","3","10","0","0","0","0","0","0","1","0","1","10","3","7","0","0","0","2","0","2","0","0","0","0","0","0","0","0","0","-2"
"190114","Metropolitan College of New York","2019","Not on tenure track/No tenure system system total","20","11","9","1","0","1","1","0","1","3","2","1","1","0","1","0","0","0","14","9","5","0","0","0","0","0","0","0","0","0","-2"
"190114","Metropolitan College of New York","2019","Not on tenure/no tenure system, professors","11","6","5","0","0","0","1","0","1","1","1","0","1","0","1","0","0","0","8","5","3","0","0","0","0","0","0","0","0","0","-2"
"190114","Metropolitan College of New York","2019","Not on tenure/no tenure system, associate professors","8","5","3","1","0","1","0","0","0","2","1","1","0","0","0","0","0","0","5","4","1","0","0","0","0","0","0","0","0","0","-2"
"190114","Metropolitan College of New York","2019","Not on tenure/no tenure system, assistant professors","1","0","1","0","0","0","0","0","0","0","0","0","0","0","0","0","0","0","1","0","1","0","0","0","0","0","0","0","0","0","-2"
"190558","College of Staten Island CUNY","2019","Tenured total","261","145","116","0","0","0","40","22","18","8","4","4","17","10","7","0","0","0","194","108","86","1","1","0","0","0","0","1","0","1","-2"
"190558","College of Staten Island CUNY","2019","Tenured, professors","128","79","49","0","0","0","21","14","7","3","2","1","9","6","3","0","0","0","95","57","38","0","0","0","0","0","0","0","0","0","-2"
"190558","College of Staten Island CUNY","2019","Tenured, associate professors","103","53","50","0","0","0","17","8","9","4","1","3","6","4","2","0","0","0","74","39","35","1","1","0","0","0","0","1","0","1","-2"
"190558","College of Staten Island CUNY","2019","Tenured, assistant professors","10","6","4","0","0","0","0","0","0","1","1","0","0","0","0","0","0","0","9","5","4","0","0","0","0","0","0","0","0","0","-2"
"190558","College of Staten Island CUNY","2019","Tenured, lecturers","20","7","13","0","0","0","2","0","2","0","0","0","2","0","2","0","0","0","16","7","9","0","0","0","0","0","0","0","0","0","-2"
"190558","College of Staten Island CUNY","2019","On-Tenure track total","76","39","37","0","0","0","15","5","10","3","1","2","4","4","0","0","0","0","40","20","20","1","0","1","0","0","0","13","9","4","-2"
"190558","College of Staten Island CUNY","2019","On-tenure track, professors","2","2","0","0","0","0","1","1","0","0","0","0","0","0","0","0","0","0","1","1","0","0","0","0","0","0","0","0","0","0","-2"
"190558","College of Staten Island CUNY","2019","On-tenure track, associate professors","5","2","3","0","0","0","2","1","1","1","0","1","0","0","0","0","0","0","1","0","1","0","0","0","0","0","0","1","1","0","-2"
"190558","College of Staten Island CUNY","2019","On-tenure track, assistant professors","62","32","30","0","0","0","12","3","9","2","1","1","4","4","0","0","0","0","32","16","16","1","0","1","0","0","0","11","8","3","-2"
"190558","College of Staten Island CUNY","2019","On-tenure track, lecturers","7","3","4","0","0","0","0","0","0","0","0","0","0","0","0","0","0","0","6","3","3","0","0","0","0","0","0","1","0","1","-2"
"190558","College of Staten Island CUNY","2019","Not on tenure track/No tenure system system total","22","10","12","0","0","0","3","3","0","1","0","1","4","2","2","0","0","0","12","4","8","0","0","0","0","0","0","2","1","1","-2"
"190558","College of Staten Island CUNY","2019","Not on tenure/no tenure system, professors","4","1","3","0","0","0","0","0","0","0","0","0","1","0","1","0","0","0","3","1","2","0","0","0","0","0","0","0","0","0","-2"
"190558","College of Staten Island CUNY","2019","Not on tenure/no tenure system, lecturers","18","9","9","0","0","0","3","3","0","1","0","1","3","2","1","0","0","0","9","3","6","0","0","0","0","0","0","2","1","1","-2"
"190594","CUNY Hunter College","2019","Tenured total","466","236","230","0","0","0","54","25","29","47","25","22","55","20","35","0","0","0","302","162","140","4","3","1","0","0","0","4","1","3","-2"
"190594","CUNY Hunter College","2019","Tenured, professors","230","125","105","0","0","0","21","13","8","18","11","7","23","10","13","0","0","0","166","89","77","2","2","0","0","0","0","0","0","0","-2"
"190594","CUNY Hunter College","2019","Tenured, associate professors","191","94","97","0","0","0","29","11","18","23","13","10","27","9","18","0","0","0","109","60","49","1","0","1","0","0","0","2","1","1","-2"
"190594","CUNY Hunter College","2019","Tenured, assistant professors","11","4","7","0","0","0","1","0","1","2","1","1","0","0","0","0","0","0","8","3","5","0","0","0","0","0","0","0","0","0","-2"
"190594","CUNY Hunter College","2019","Tenured, lecturers","34","13","21","0","0","0","3","1","2","4","0","4","5","1","4","0","0","0","19","10","9","1","1","0","0","0","0","2","0","2","-2"
"190594","CUNY Hunter College","2019","On-Tenure track total","119","40","79","2","0","2","11","2","9","13","4","9","9","2","7","0","0","0","66","23","43","4","2","2","0","0","0","14","7","7","-2"
"190594","CUNY Hunter College","2019","On-tenure track, professors","2","0","2","0","0","0","0","0","0","0","0","0","0","0","0","0","0","0","2","0","2","0","0","0","0","0","0","0","0","0","-2"
"190594","CUNY Hunter College","2019","On-tenure track, associate professors","13","7","6","0","0","0","2","0","2","3","3","0","1","0","1","0","0","0","7","4","3","0","0","0","0","0","0","0","0","0","-2"
"190594","CUNY Hunter College","2019","On-tenure track, assistant professors","74","23","51","2","0","2","7","1","6","6","1","5","5","2","3","0","0","0","41","11","30","2","2","0","0","0","0","11","6","5","-2"
"190594","CUNY Hunter College","2019","On-tenure track, lecturers","30","10","20","0","0","0","2","1","1","4","0","4","3","0","3","0","0","0","16","8","8","2","0","2","0","0","0","3","1","2","-2"
"190594","CUNY Hunter College","2019","Not on tenure track/No tenure system system total","47","16","31","0","0","0","1","0","1","2","0","2","4","3","1","0","0","0","37","11","26","2","1","1","0","0","0","1","1","0","-2"
"190594","CUNY Hunter College","2019","Not on tenure/no tenure system, professors","43","14","29","0","0","0","1","0","1","2","0","2","3","3","0","0","0","0","36","11","25","1","0","1","0","0","0","0","0","0","-2"
"190594","CUNY Hunter College","2019","Not on tenure/no tenure system, lecturers","4","2","2","0","0","0","0","0","0","0","0","0","1","0","1","0","0","0","1","0","1","1","1","0","0","0","0","1","1","0","-2"
"190600","CUNY John Jay College of Criminal Justice","2019","Tenured total","298","163","135","0","0","0","25","9","16","34","18","16","34","14","20","3","0","3","187","116","71","2","2","0","0","0","0","13","4","9","-2"
"190600","CUNY John Jay College of Criminal Justice","2019","Tenured, professors","99","63","36","0","0","0","9","4","5","6","1","5","7","3","4","0","0","0","73","54","19","1","1","0","0","0","0","3","0","3","-2"
"190600","CUNY John Jay College of Criminal Justice","2019","Tenured, associate professors","147","76","71","0","0","0","12","4","8","19","12","7","19","7","12","1","0","1","86","49","37","1","1","0","0","0","0","9","3","6","-2"
"190600","CUNY John Jay College of Criminal Justice","2019","Tenured, assistant professors","21","9","12","0","0","0","3","1","2","3","1","2","4","2","2","0","0","0","11","5","6","0","0","0","0","0","0","0","0","0","-2"
"190600","CUNY John Jay College of Criminal Justice","2019","Tenured, lecturers","31","15","16","0","0","0","1","0","1","6","4","2","4","2","2","2","0","2","17","8","9","0","0","0","0","0","0","1","1","0","-2"
"190600","CUNY John Jay College of Criminal Justice","2019","On-Tenure track total","75","30","45","0","0","0","9","4","5","6","2","4","7","4","3","0","0","0","42","16","26","1","0","1","0","0","0","10","4","6","-2"
"190600","CUNY John Jay College of Criminal Justice","2019","On-tenure track, associate professors","10","7","3","0","0","0","1","0","1","0","0","0","1","1","0","0","0","0","7","5","2","0","0","0","0","0","0","1","1","0","-2"
"190600","CUNY John Jay College of Criminal Justice","2019","On-tenure track, assistant professors","51","17","34","0","0","0","3","2","1","5","1","4","4","2","2","0","0","0","29","9","20","1","0","1","0","0","0","9","3","6","-2"
"190600","CUNY John Jay College of Criminal Justice","2019","On-tenure track, lecturers","14","6","8","0","0","0","5","2","3","1","1","0","2","1","1","0","0","0","6","2","4","0","0","0","0","0","0","0","0","0","-2"
"190600","CUNY John Jay College of Criminal Justice","2019","Not on tenure track/No tenure system system total","27","15","12","0","0","0","2","1","1","1","1","0","5","3","2","0","0","0","16","9","7","1","0","1","0","0","0","2","1","1","-2"
"190600","CUNY John Jay College of Criminal Justice","2019","Not on tenure/no tenure system, professors","3","2","1","0","0","0","0","0","0","0","0","0","0","0","0","0","0","0","3","2","1","0","0","0","0","0","0","0","0","0","-2"
"190600","CUNY John Jay College of Criminal Justice","2019","Not on tenure/no tenure system, associate professors","1","1","0","0","0","0","0","0","0","0","0","0","0","0","0","0","0","0","1","1","0","0","0","0","0","0","0","0","0","0","-2"
"190600","CUNY John Jay College of Criminal Justice","2019","Not on tenure/no tenure system, assistant professors","3","1","2","0","0","0","1","0","1","0","0","0","1","1","0","0","0","0","1","0","1","0","0","0","0","0","0","0","0","0","-2"
"190600","CUNY John Jay College of Criminal Justice","2019","Not on tenure/no tenure system, lecturers","20","11","9","0","0","0","1","1","0","1","1","0","4","2","2","0","0","0","11","6","5","1","0","1","0","0","0","2","1","1","-2"
"190637","CUNY Lehman College","2019","Tenured total","240","112","128","2","0","2","17","10","7","28","8","20","27","17","10","0","0","0","161","75","86","0","0","0","0","0","0","5","2","3","-2"
"190637","CUNY Lehman College","2019","Tenured, professors","82","50","32","1","0","1","6","3","3","3","2","1","6","4","2","0","0","0","65","40","25","0","0","0","0","0","0","1","1","0","-2"
"190637","CUNY Lehman College","2019","Tenured, associate professors","109","44","65","1","0","1","7","4","3","13","5","8","15","8","7","0","0","0","71","26","45","0","0","0","0","0","0","2","1","1","-2"
"190637","CUNY Lehman College","2019","Tenured, assistant professors","9","5","4","0","0","0","2","2","0","3","0","3","1","1","0","0","0","0","3","2","1","0","0","0","0","0","0","0","0","0","-2"
"190637","CUNY Lehman College","2019","Tenured, lecturers","40","13","27","0","0","0","2","1","1","9","1","8","5","4","1","0","0","0","22","7","15","0","0","0","0","0","0","2","0","2","-2"
"190637","CUNY Lehman College","2019","On-Tenure track total","101","40","61","0","0","0","9","3","6","13","2","11","17","6","11","0","0","0","49","21","28","2","1","1","0","0","0","11","7","4","-2"
"190637","CUNY Lehman College","2019","On-tenure track, associate professors","5","3","2","0","0","0","1","1","0","0","0","0","1","0","1","0","0","0","3","2","1","0","0","0","0","0","0","0","0","0","-2"
"190637","CUNY Lehman College","2019","On-tenure track, assistant professors","80","33","47","0","0","0","7","2","5","9","2","7","15","6","9","0","0","0","39","18","21","1","0","1","0","0","0","9","5","4","-2"
"190637","CUNY Lehman College","2019","On-tenure track, lecturers","16","4","12","0","0","0","1","0","1","4","0","4","1","0","1","0","0","0","7","1","6","1","1","0","0","0","0","2","2","0","-2"
"190637","CUNY Lehman College","2019","Not on tenure track/No tenure system system total","39","14","25","0","0","0","1","0","1","4","2","2","8","1","7","0","0","0","26","11","15","0","0","0","0","0","0","0","0","0","-2"
"190637","CUNY Lehman College","2019","Not on tenure/no tenure system, professors","5","1","4","0","0","0","0","0","0","1","1","0","1","0","1","0","0","0","3","0","3","0","0","0","0","0","0","0","0","0","-2"
"190637","CUNY Lehman College","2019","Not on tenure/no tenure system, assistant professors","11","6","5","0","0","0","0","0","0","1","0","1","2","0","2","0","0","0","8","6","2","0","0","0","0","0","0","0","0","0","-2"
"190637","CUNY Lehman College","2019","Not on tenure/no tenure system, instructors","2","1","1","0","0","0","0","0","0","0","0","0","0","0","0","0","0","0","2","1","1","0","0","0","0","0","0","0","0","0","-2"
"190637","CUNY Lehman College","2019","Not on tenure/no tenure system, lecturers","21","6","15","0","0","0","1","0","1","2","1","1","5","1","4","0","0","0","13","4","9","0","0","0","0","0","0","0","0","0","-2"
"190655","CUNY New York City College of Technology","2019","Tenured total","289","157","132","2","1","1","44","23","21","36","20","16","24","14","10","0","0","0","165","86","79","0","0","0","0","0","0","18","13","5","-2"
"190655","CUNY New York City College of Technology","2019","Tenured, professors","88","44","44","0","0","0","12","3","9","15","9","6","6","3","3","0","0","0","51","25","26","0","0","0","0","0","0","4","4","0","-2"
"190655","CUNY New York City College of Technology","2019","Tenured, associate professors","122","64","58","1","0","1","19","11","8","10","5","5","12","7","5","0","0","0","70","36","34","0","0","0","0","0","0","10","5","5","-2"
"190655","CUNY New York City College of Technology","2019","Tenured, assistant professors","60","39","21","1","1","0","13","9","4","4","2","2","5","4","1","0","0","0","33","19","14","0","0","0","0","0","0","4","4","0","-2"
"190655","CUNY New York City College of Technology","2019","Tenured, lecturers","19","10","9","0","0","0","0","0","0","7","4","3","1","0","1","0","0","0","11","6","5","0","0","0","0","0","0","0","0","0","-2"
"190655","CUNY New York City College of Technology","2019","On-Tenure track total","95","41","54","0","0","0","22","14","8","13","3","10","6","3","3","0","0","0","52","21","31","0","0","0","0","0","0","2","0","2","-2"
"190655","CUNY New York City College of Technology","2019","On-tenure track, associate professors","17","9","8","0","0","0","4","3","1","0","0","0","1","1","0","0","0","0","12","5","7","0","0","0","0","0","0","0","0","0","-2"
"190655","CUNY New York City College of Technology","2019","On-tenure track, assistant professors","76","30","46","0","0","0","17","10","7","12","2","10","5","2","3","0","0","0","40","16","24","0","0","0","0","0","0","2","0","2","-2"
"190655","CUNY New York City College of Technology","2019","On-tenure track, lecturers","2","2","0","0","0","0","1","1","0","1","1","0","0","0","0","0","0","0","0","0","0","0","0","0","0","0","0","0","0","0","-2"
"190655","CUNY New York City College of Technology","2019","Not on tenure track/No tenure system system total","5","3","2","0","0","0","2","2","0","1","0","1","0","0","0","0","0","0","1","1","0","0","0","0","0","0","0","1","0","1","-2"
"190655","CUNY New York City College of Technology","2019","Not on tenure/no tenure system, professors","1","1","0","0","0","0","0","0","0","0","0","0","0","0","0","0","0","0","1","1","0","0","0","0","0","0","0","0","0","0","-2"
"190655","CUNY New York City College of Technology","2019","Not on tenure/no tenure system, assistant professors","3","2","1","0","0","0","2","2","0","0","0","0","0","0","0","0","0","0","0","0","0","0","0","0","0","0","0","1","0","1","-2"
"190655","CUNY New York City College of Technology","2019","Not on tenure/no tenure system, instructors","1","0","1","0","0","0","0","0","0","1","0","1","0","0","0","0","0","0","0","0","0","0","0","0","0","0","0","0","0","0","-2"
"190664","CUNY Queens College","2019","Tenured total","429","227","202","0","0","0","48","20","28","19","13","6","28","10","18","0","0","0","308","176","132","4","2","2","0","0","0","22","6","16","-2"
"190664","CUNY Queens College","2019","Tenured, professors","194","129","65","0","0","0","23","13","10","10","8","2","13","5","8","0","0","0","141","98","43","3","2","1","0","0","0","4","3","1","-2"
"190664","CUNY Queens College","2019","Tenured, associate professors","162","69","93","0","0","0","20","6","14","6","3","3","14","5","9","0","0","0","106","52","54","0","0","0","0","0","0","16","3","13","-2"
"190664","CUNY Queens College","2019","Tenured, assistant professors","12","6","6","0","0","0","1","1","0","2","1","1","0","0","0","0","0","0","7","4","3","1","0","1","0","0","0","1","0","1","-2"
"190664","CUNY Queens College","2019","Tenured, lecturers","61","23","38","0","0","0","4","0","4","1","1","0","1","0","1","0","0","0","54","22","32","0","0","0","0","0","0","1","0","1","-2"
"190664","CUNY Queens College","2019","On-Tenure track total","117","64","53","0","0","0","16","10","6","14","6","8","12","7","5","0","0","0","53","29","24","4","2","2","0","0","0","18","10","8","-2"
"190664","CUNY Queens College","2019","On-tenure track, professors","1","0","1","0","0","0","0","0","0","0","0","0","0","0","0","0","0","0","1","0","1","0","0","0","0","0","0","0","0","0","-2"
"190664","CUNY Queens College","2019","On-tenure track, associate professors","6","4","2","0","0","0","1","1","0","1","0","1","1","1","0","0","0","0","3","2","1","0","0","0","0","0","0","0","0","0","-2"
"190664","CUNY Queens College","2019","On-tenure track, assistant professors","83","46","37","0","0","0","11","7","4","9","4","5","10","5","5","0","0","0","32","18","14","4","2","2","0","0","0","17","10","7","-2"
"190664","CUNY Queens College","2019","On-tenure track, lecturers","27","14","13","0","0","0","4","2","2","4","2","2","1","1","0","0","0","0","17","9","8","0","0","0","0","0","0","1","0","1","-2"
"190664","CUNY Queens College","2019","Not on tenure track/No tenure system system total","37","21","16","0","0","0","6","2","4","4","2","2","2","0","2","0","0","0","24","16","8","0","0","0","0","0","0","1","1","0","-2"
"190664","CUNY Queens College","2019","Not on tenure/no tenure system, professors","7","4","3","0","0","0","0","0","0","2","0","2","0","0","0","0","0","0","5","4","1","0","0","0","0","0","0","0","0","0","-2"
"190664","CUNY Queens College","2019","Not on tenure/no tenure system, assistant professors","2","1","1","0","0","0","1","0","1","0","0","0","0","0","0","0","0","0","1","1","0","0","0","0","0","0","0","0","0","0","-2"
"190664","CUNY Queens College","2019","Not on tenure/no tenure system, lecturers","28","16","12","0","0","0","5","2","3","2","2","0","2","0","2","0","0","0","18","11","7","0","0","0","0","0","0","1","1","0","-2"
"190691","CUNY York College","2019","Tenured total","130","70","60","0","0","0","19","12","7","23","10","13","10","5","5","0","0","0","75","42","33","0","0","0","0","0","0","3","1","2","-2"
"190691","CUNY York College","2019","Tenured, professors","44","26","18","0","0","0","6","6","0","4","3","1","3","1","2","0","0","0","30","15","15","0","0","0","0","0","0","1","1","0","-2"
"190691","CUNY York College","2019","Tenured, associate professors","62","31","31","0","0","0","11","6","5","13","4","9","7","4","3","0","0","0","29","17","12","0","0","0","0","0","0","2","0","2","-2"
"190691","CUNY York College","2019","Tenured, assistant professors","10","6","4","0","0","0","1","0","1","3","1","2","0","0","0","0","0","0","6","5","1","0","0","0","0","0","0","0","0","0","-2"
"190691","CUNY York College","2019","Tenured, lecturers","14","7","7","0","0","0","1","0","1","3","2","1","0","0","0","0","0","0","10","5","5","0","0","0","0","0","0","0","0","0","-2"
"190691","CUNY York College","2019","On-Tenure track total","47","21","26","0","0","0","8","4","4","11","3","8","8","3","5","0","0","0","18","10","8","0","0","0","0","0","0","2","1","1","-2"
"190691","CUNY York College","2019","On-tenure track, professors","1","0","1","0","0","0","0","0","0","0","0","0","0","0","0","0","0","0","1","0","1","0","0","0","0","0","0","0","0","0","-2"
"190691","CUNY York College","2019","On-tenure track, associate professors","5","2","3","0","0","0","2","1","1","0","0","0","2","1","1","0","0","0","1","0","1","0","0","0","0","0","0","0","0","0","-2"
"190691","CUNY York College","2019","On-tenure track, assistant professors","37","17","20","0","0","0","6","3","3","9","2","7","5","2","3","0","0","0","15","9","6","0","0","0","0","0","0","2","1","1","-2"
"190691","CUNY York College","2019","On-tenure track, lecturers","4","2","2","0","0","0","0","0","0","2","1","1","1","0","1","0","0","0","1","1","0","0","0","0","0","0","0","0","0","0","-2"
"190691","CUNY York College","2019","Not on tenure track/No tenure system system total","11","4","7","0","0","0","1","0","1","6","2","4","1","0","1","0","0","0","3","2","1","0","0","0","0","0","0","0","0","0","-2"
"190691","CUNY York College","2019","Not on tenure/no tenure system, professors","6","1","5","0","0","0","1","0","1","3","0","3","0","0","0","0","0","0","2","1","1","0","0","0","0","0","0","0","0","0","-2"
"190691","CUNY York College","2019","Not on tenure/no tenure system, lecturers","5","3","2","0","0","0","0","0","0","3","2","1","1","0","1","0","0","0","1","1","0","0","0","0","0","0","0","0","0","0","-2"
"190761","Dominican College of Blauvelt","2019","Tenured total","32","10","22","0","0","0","1","1","0","0","0","0","2","1","1","0","0","0","29","8","21","0","0","0","0","0","0","0","0","0","-2"
"190761","Dominican College of Blauvelt","2019","Tenured, professors","5","1","4","0","0","0","0","0","0","0","0","0","0","0","0","0","0","0","5","1","4","0","0","0","0","0","0","0","0","0","-2"
"190761","Dominican College of Blauvelt","2019","Tenured, associate professors","15","6","9","0","0","0","1","1","0","0","0","0","1","1","0","0","0","0","13","4","9","0","0","0","0","0","0","0","0","0","-2"
"190761","Dominican College of Blauvelt","2019","Tenured, assistant professors","12","3","9","0","0","0","0","0","0","0","0","0","1","0","1","0","0","0","11","3","8","0","0","0","0","0","0","0","0","0","-2"
"190761","Dominican College of Blauvelt","2019","On-Tenure track total","26","11","15","0","0","0","3","2","1","2","0","2","2","1","1","0","0","0","18","7","11","0","0","0","1","1","0","0","0","0","-2"
"190761","Dominican College of Blauvelt","2019","On-tenure track, associate professors","2","2","0","0","0","0","1","1","0","0","0","0","0","0","0","0","0","0","1","1","0","0","0","0","0","0","0","0","0","0","-2"
"190761","Dominican College of Blauvelt","2019","On-tenure track, assistant professors","20","8","12","0","0","0","2","1","1","1","0","1","2","1","1","0","0","0","14","5","9","0","0","0","1","1","0","0","0","0","-2"
"190761","Dominican College of Blauvelt","2019","On-tenure track, instructors","4","1","3","0","0","0","0","0","0","1","0","1","0","0","0","0","0","0","3","1","2","0","0","0","0","0","0","0","0","0","-2"
"190761","Dominican College of Blauvelt","2019","Not on tenure track/No tenure system system total","18","6","12","0","0","0","0","0","0","0","0","0","0","0","0","0","0","0","18","6","12","0","0","0","0","0","0","0","0","0","-2"
"190761","Dominican College of Blauvelt","2019","Not on tenure/no tenure system, assistant professors","13","6","7","0","0","0","0","0","0","0","0","0","0","0","0","0","0","0","13","6","7","0","0","0","0","0","0","0","0","0","-2"
"190761","Dominican College of Blauvelt","2019","Not on tenure/no tenure system, instructors","5","0","5","0","0","0","0","0","0","0","0","0","0","0","0","0","0","0","5","0","5","0","0","0","0","0","0","0","0","0","-2"
"192749","Manhattanville College","2019","Tenured total","73","36","37","1","1","0","6","1","5","3","2","1","1","0","1","0","0","0","59","31","28","0","0","0","3","1","2","0","0","0","-2"
"192749","Manhattanville College","2019","Tenured, professors","44","27","17","1","1","0","4","1","3","2","2","0","1","0","1","0","0","0","36","23","13","0","0","0","0","0","0","0","0","0","-2"
"192749","Manhattanville College","2019","Tenured, associate professors","27","9","18","0","0","0","1","0","1","0","0","0","0","0","0","0","0","0","23","8","15","0","0","0","3","1","2","0","0","0","-2"
"192749","Manhattanville College","2019","Tenured, assistant professors","2","0","2","0","0","0","1","0","1","1","0","1","0","0","0","0","0","0","0","0","0","0","0","0","0","0","0","0","0","0","-2"
"192749","Manhattanville College","2019","On-Tenure track total","15","7","8","0","0","0","0","0","0","1","1","0","0","0","0","0","0","0","13","5","8","0","0","0","1","1","0","0","0","0","-2"
"192749","Manhattanville College","2019","On-tenure track, professors","1","0","1","0","0","0","0","0","0","0","0","0","0","0","0","0","0","0","1","0","1","0","0","0","0","0","0","0","0","0","-2"
"192749","Manhattanville College","2019","On-tenure track, associate professors","5","4","1","0","0","0","0","0","0","1","1","0","0","0","0","0","0","0","3","2","1","0","0","0","1","1","0","0","0","0","-2"
"192749","Manhattanville College","2019","On-tenure track, assistant professors","9","3","6","0","0","0","0","0","0","0","0","0","0","0","0","0","0","0","9","3","6","0","0","0","0","0","0","0","0","0","-2"
"192749","Manhattanville College","2019","Not on tenure track/No tenure system system total","24","13","11","0","0","0","1","0","1","0","0","0","2","1","1","0","0","0","18","12","6","2","0","2","1","0","1","0","0","0","-2"
"192749","Manhattanville College","2019","Not on tenure/no tenure system, professors","1","0","1","0","0","0","0","0","0","0","0","0","0","0","0","0","0","0","0","0","0","1","0","1","0","0","0","0","0","0","-2"
"192749","Manhattanville College","2019","Not on tenure/no tenure system, associate professors","2","1","1","0","0","0","0","0","0","0","0","0","0","0","0","0","0","0","1","1","0","0","0","0","1","0","1","0","0","0","-2"
"192749","Manhattanville College","2019","Not on tenure/no tenure system, assistant professors","3","3","0","0","0","0","0","0","0","0","0","0","0","0","0","0","0","0","3","3","0","0","0","0","0","0","0","0","0","0","-2"
"192749","Manhattanville College","2019","Not on tenure/no tenure system, instructors","1","1","0","0","0","0","0","0","0","0","0","0","0","0","0","0","0","0","1","1","0","0","0","0","0","0","0","0","0","0","-2"
"192749","Manhattanville College","2019","Not on tenure/no tenure system, lecturers","17","8","9","0","0","0","1","0","1","0","0","0","2","1","1","0","0","0","13","7","6","1","0","1","0","0","0","0","0","0","-2"
"193016","Mercy College","2019","Tenured total","63","26","37","0","0","0","13","5","8","4","1","3","3","2","1","0","0","0","42","17","25","1","1","0","0","0","0","0","0","0","-2"
"193016","Mercy College","2019","Tenured, professors","22","13","9","0","0","0","3","2","1","1","1","0","1","1","0","0","0","0","16","8","8","1","1","0","0","0","0","0","0","0","-2"
"193016","Mercy College","2019","Tenured, associate professors","34","11","23","0","0","0","8","3","5","3","0","3","1","0","1","0","0","0","22","8","14","0","0","0","0","0","0","0","0","0","-2"
"193016","Mercy College","2019","Tenured, assistant professors","7","2","5","0","0","0","2","0","2","0","0","0","1","1","0","0","0","0","4","1","3","0","0","0","0","0","0","0","0","0","-2"
"193016","Mercy College","2019","On-Tenure track total","27","12","15","0","0","0","6","4","2","3","1","2","1","0","1","0","0","0","17","7","10","0","0","0","0","0","0","0","0","0","-2"
"193016","Mercy College","2019","On-tenure track, professors","1","0","1","0","0","0","0","0","0","0","0","0","0","0","0","0","0","0","1","0","1","0","0","0","0","0","0","0","0","0","-2"
"193016","Mercy College","2019","On-tenure track, associate professors","4","3","1","0","0","0","0","0","0","0","0","0","1","0","1","0","0","0","3","3","0","0","0","0","0","0","0","0","0","0","-2"
"193016","Mercy College","2019","On-tenure track, assistant professors","22","9","13","0","0","0","6","4","2","3","1","2","0","0","0","0","0","0","13","4","9","0","0","0","0","0","0","0","0","0","-2"
"193016","Mercy College","2019","Not on tenure track/No tenure system system total","157","56","101","0","0","0","7","3","4","17","7","10","13","4","9","0","0","0","118","41","77","0","0","0","2","1","1","0","0","0","-2"
"193016","Mercy College","2019","Not on tenure/no tenure system, professors","8","2","6","0","0","0","0","0","0","0","0","0","1","0","1","0","0","0","7","2","5","0","0","0","0","0","0","0","0","0","-2"
"193016","Mercy College","2019","Not on tenure/no tenure system, associate professors","40","15","25","0","0","0","3","2","1","1","0","1","2","0","2","0","0","0","34","13","21","0","0","0","0","0","0","0","0","0","-2"
"193016","Mercy College","2019","Not on tenure/no tenure system, assistant professors","92","32","60","0","0","0","3","0","3","13","6","7","10","4","6","0","0","0","64","21","43","0","0","0","2","1","1","0","0","0","-2"
"193016","Mercy College","2019","Not on tenure/no tenure system, instructors","17","7","10","0","0","0","1","1","0","3","1","2","0","0","0","0","0","0","13","5","8","0","0","0","0","0","0","0","0","0","-2"
"193399","College of Mount Saint Vincent","2019","Tenured total","26","17","9","0","0","0","1","0","1","0","0","0","0","0","0","0","0","0","25","17","8","0","0","0","0","0","0","0","0","0","-2"
"193399","College of Mount Saint Vincent","2019","Tenured, professors","9","7","2","0","0","0","0","0","0","0","0","0","0","0","0","0","0","0","9","7","2","0","0","0","0","0","0","0","0","0","-2"
"193399","College of Mount Saint Vincent","2019","Tenured, associate professors","16","9","7","0","0","0","1","0","1","0","0","0","0","0","0","0","0","0","15","9","6","0","0","0","0","0","0","0","0","0","-2"
"193399","College of Mount Saint Vincent","2019","Tenured, assistant professors","1","1","0","0","0","0","0","0","0","0","0","0","0","0","0","0","0","0","1","1","0","0","0","0","0","0","0","0","0","0","-2"
"193399","College of Mount Saint Vincent","2019","On-Tenure track total","41","16","25","0","0","0","6","2","4","1","0","1","3","0","3","0","0","0","29","13","16","2","1","1","0","0","0","0","0","0","-2"
"193399","College of Mount Saint Vincent","2019","On-tenure track, professors","4","2","2","0","0","0","1","1","0","0","0","0","0","0","0","0","0","0","3","1","2","0","0","0","0","0","0","0","0","0","-2"
"193399","College of Mount Saint Vincent","2019","On-tenure track, associate professors","20","6","14","0","0","0","4","1","3","0","0","0","2","0","2","0","0","0","14","5","9","0","0","0","0","0","0","0","0","0","-2"
"193399","College of Mount Saint Vincent","2019","On-tenure track, assistant professors","16","8","8","0","0","0","1","0","1","1","0","1","1","0","1","0","0","0","11","7","4","2","1","1","0","0","0","0","0","0","-2"
"193399","College of Mount Saint Vincent","2019","On-tenure track, instructors","1","0","1","0","0","0","0","0","0","0","0","0","0","0","0","0","0","0","1","0","1","0","0","0","0","0","0","0","0","0","-2"
"193399","College of Mount Saint Vincent","2019","Not on tenure track/No tenure system system total","15","3","12","0","0","0","0","0","0","3","0","3","1","0","1","0","0","0","11","3","8","0","0","0","0","0","0","0","0","0","-2"
"193399","College of Mount Saint Vincent","2019","Not on tenure/no tenure system, professors","1","0","1","0","0","0","0","0","0","0","0","0","0","0","0","0","0","0","1","0","1","0","0","0","0","0","0","0","0","0","-2"
"193399","College of Mount Saint Vincent","2019","Not on tenure/no tenure system, assistant professors","5","2","3","0","0","0","0","0","0","0","0","0","1","0","1","0","0","0","4","2","2","0","0","0","0","0","0","0","0","0","-2"
"193399","College of Mount Saint Vincent","2019","Not on tenure/no tenure system, instructors","9","1","8","0","0","0","0","0","0","3","0","3","0","0","0","0","0","0","6","1","5","0","0","0","0","0","0","0","0","0","-2"
"194161","Nyack College","2019","Tenured total","20","10","10","0","0","0","4","2","2","2","1","1","0","0","0","0","0","0","14","7","7","0","0","0","0","0","0","0","0","0","-2"
"194161","Nyack College","2019","Tenured, professors","19","9","10","0","0","0","4","2","2","2","1","1","0","0","0","0","0","0","13","6","7","0","0","0","0","0","0","0","0","0","-2"
"194161","Nyack College","2019","Tenured, associate professors","1","1","0","0","0","0","0","0","0","0","0","0","0","0","0","0","0","0","1","1","0","0","0","0","0","0","0","0","0","0","-2"
"194161","Nyack College","2019","On-Tenure track total","36","20","16","0","0","0","6","3","3","6","2","4","9","5","4","0","0","0","15","10","5","0","0","0","0","0","0","0","0","0","-2"
"194161","Nyack College","2019","On-tenure track, professors","10","5","5","0","0","0","1","0","1","1","0","1","0","0","0","0","0","0","8","5","3","0","0","0","0","0","0","0","0","0","-2"
"194161","Nyack College","2019","On-tenure track, associate professors","11","7","4","0","0","0","3","2","1","2","1","1","1","0","1","0","0","0","5","4","1","0","0","0","0","0","0","0","0","0","-2"
"194161","Nyack College","2019","On-tenure track, assistant professors","15","8","7","0","0","0","2","1","1","3","1","2","8","5","3","0","0","0","2","1","1","0","0","0","0","0","0","0","0","0","-2"
"194161","Nyack College","2019","Not on tenure track/No tenure system system total","5","3","2","0","0","0","1","0","1","2","1","1","1","1","0","0","0","0","1","1","0","0","0","0","0","0","0","0","0","0","-2"
"194161","Nyack College","2019","Not on tenure/no tenure system, lecturers","5","3","2","0","0","0","1","0","1","2","1","1","1","1","0","0","0","0","1","1","0","0","0","0","0","0","0","0","0","0","-2"
"195173","St Francis College","2019","Tenured total","48","24","24","0","0","0","3","2","1","3","0","3","2","1","1","0","0","0","40","21","19","0","0","0","0","0","0","0","0","0","-2"
"195173","St Francis College","2019","Tenured, professors","27","15","12","0","0","0","1","1","0","1","0","1","0","0","0","0","0","0","25","14","11","0","0","0","0","0","0","0","0","0","-2"
"195173","St Francis College","2019","Tenured, associate professors","21","9","12","0","0","0","2","1","1","2","0","2","2","1","1","0","0","0","15","7","8","0","0","0","0","0","0","0","0","0","-2"
"195173","St Francis College","2019","On-Tenure track total","29","10","19","0","0","0","1","0","1","2","1","1","1","0","1","0","0","0","22","9","13","3","0","3","0","0","0","0","0","0","-2"
"195173","St Francis College","2019","On-tenure track, associate professors","2","0","2","0","0","0","0","0","0","0","0","0","0","0","0","0","0","0","1","0","1","1","0","1","0","0","0","0","0","0","-2"
"195173","St Francis College","2019","On-tenure track, assistant professors","27","10","17","0","0","0","1","0","1","2","1","1","1","0","1","0","0","0","21","9","12","2","0","2","0","0","0","0","0","0","-2"
"195173","St Francis College","2019","Not on tenure track/No tenure system system total","16","11","5","0","0","0","1","1","0","1","0","1","0","0","0","0","0","0","12","8","4","1","1","0","0","0","0","1","1","0","-2"
"195173","St Francis College","2019","Not on tenure/no tenure system, lecturers","16","11","5","0","0","0","1","1","0","1","0","1","0","0","0","0","0","0","12","8","4","1","1","0","0","0","0","1","1","0","-2"
"196219","SUNY at Purchase College","2019","Tenured total","90","45","45","0","0","0","5","2","3","3","2","1","3","2","1","0","0","0","76","38","38","3","1","2","0","0","0","0","0","0","-2"
"196219","SUNY at Purchase College","2019","Tenured, professors","31","16","15","0","0","0","2","2","0","1","1","0","0","0","0","0","0","0","27","12","15","1","1","0","0","0","0","0","0","0","-2"
"196219","SUNY at Purchase College","2019","Tenured, associate professors","59","29","30","0","0","0","3","0","3","2","1","1","3","2","1","0","0","0","49","26","23","2","0","2","0","0","0","0","0","0","-2"
"196219","SUNY at Purchase College","2019","On-Tenure track total","53","27","26","0","0","0","3","2","1","2","0","2","7","4","3","0","0","0","39","19","20","0","0","0","0","0","0","2","2","0","-2"
"196219","SUNY at Purchase College","2019","On-tenure track, associate professors","6","3","3","0","0","0","1","1","0","0","0","0","1","0","1","0","0","0","4","2","2","0","0","0","0","0","0","0","0","0","-2"
"196219","SUNY at Purchase College","2019","On-tenure track, assistant professors","47","24","23","0","0","0","2","1","1","2","0","2","6","4","2","0","0","0","35","17","18","0","0","0","0","0","0","2","2","0","-2"
"196219","SUNY at Purchase College","2019","Not on tenure track/No tenure system system total","42","15","27","0","0","0","5","0","5","3","2","1","5","2","3","0","0","0","28","10","18","0","0","0","0","0","0","1","1","0","-2"
"196219","SUNY at Purchase College","2019","Not on tenure/no tenure system, associate professors","3","1","2","0","0","0","0","0","0","0","0","0","0","0","0","0","0","0","3","1","2","0","0","0","0","0","0","0","0","0","-2"
"196219","SUNY at Purchase College","2019","Not on tenure/no tenure system, assistant professors","35","12","23","0","0","0","4","0","4","3","2","1","5","2","3","0","0","0","22","7","15","0","0","0","0","0","0","1","1","0","-2"
"196219","SUNY at Purchase College","2019","Not on tenure/no tenure system, lecturers","4","2","2","0","0","0","1","0","1","0","0","0","0","0","0","0","0","0","3","2","1","0","0","0","0","0","0","0","0","0","-2"
"196237","SUNY College at Old Westbury","2019","Tenured total","91","43","48","0","0","0","19","7","12","11","6","5","8","7","1","0","0","0","52","23","29","1","0","1","0","0","0","0","0","0","-2"
"196237","SUNY College at Old Westbury","2019","Tenured, professors","24","11","13","0","0","0","6","3","3","1","1","0","4","4","0","0","0","0","13","3","10","0","0","0","0","0","0","0","0","0","-2"
"196237","SUNY College at Old Westbury","2019","Tenured, associate professors","66","31","35","0","0","0","13","4","9","10","5","5","4","3","1","0","0","0","38","19","19","1","0","1","0","0","0","0","0","0","-2"
"196237","SUNY College at Old Westbury","2019","Tenured, instructors","1","1","0","0","0","0","0","0","0","0","0","0","0","0","0","0","0","0","1","1","0","0","0","0","0","0","0","0","0","0","-2"
"196237","SUNY College at Old Westbury","2019","On-Tenure track total","53","25","28","1","1","0","5","2","3","6","4","2","7","1","6","0","0","0","32","15","17","0","0","0","0","0","0","2","2","0","-2"
"196237","SUNY College at Old Westbury","2019","On-tenure track, assistant professors","53","25","28","1","1","0","5","2","3","6","4","2","7","1","6","0","0","0","32","15","17","0","0","0","0","0","0","2","2","0","-2"
"196237","SUNY College at Old Westbury","2019","Not on tenure track/No tenure system system total","30","13","17","0","0","0","4","0","4","6","2","4","0","0","0","0","0","0","20","11","9","0","0","0","0","0","0","0","0","0","-2"
"196237","SUNY College at Old Westbury","2019","Not on tenure/no tenure system, associate professors","2","1","1","0","0","0","0","0","0","2","1","1","0","0","0","0","0","0","0","0","0","0","0","0","0","0","0","0","0","0","-2"
"196237","SUNY College at Old Westbury","2019","Not on tenure/no tenure system, assistant professors","11","4","7","0","0","0","0","0","0","3","0","3","0","0","0","0","0","0","8","4","4","0","0","0","0","0","0","0","0","0","-2"
"196237","SUNY College at Old Westbury","2019","Not on tenure/no tenure system, instructors","2","2","0","0","0","0","0","0","0","0","0","0","0","0","0","0","0","0","2","2","0","0","0","0","0","0","0","0","0","0","-2"
"196237","SUNY College at Old Westbury","2019","Not on tenure/no tenure system, lecturers","15","6","9","0","0","0","4","0","4","1","1","0","0","0","0","0","0","0","10","5","5","0","0","0","0","0","0","0","0","0","-2"
"206279","Union Institute & University","2019","Not on tenure track/No tenure system system total","31","14","17","0","0","0","1","0","1","7","3","4","1","1","0","0","0","0","18","9","9","2","1","1","2","0","2","0","0","0","-2"
"206279","Union Institute & University","2019","Not on tenure/no tenure system, no academic rank","31","14","17","0","0","0","1","0","1","7","3","4","1","1","0","0","0","0","18","9","9","2","1","1","2","0","2","0","0","0","-2"
"207351","Oklahoma Panhandle State University","2019","Tenured total","11","7","4","0","0","0","1","0","1","0","0","0","0","0","0","0","0","0","9","7","2","1","0","1","0","0","0","0","0","0","-2"
"207351","Oklahoma Panhandle State University","2019","Tenured, professors","8","6","2","0","0","0","0","0","0","0","0","0","0","0","0","0","0","0","8","6","2","0","0","0","0","0","0","0","0","0","-2"
"207351","Oklahoma Panhandle State University","2019","Tenured, associate professors","3","1","2","0","0","0","1","0","1","0","0","0","0","0","0","0","0","0","1","1","0","1","0","1","0","0","0","0","0","0","-2"
"207351","Oklahoma Panhandle State University","2019","On-Tenure track total","17","9","8","1","1","0","0","0","0","0","0","0","0","0","0","0","0","0","15","7","8","1","1","0","0","0","0","0","0","0","-2"
"207351","Oklahoma Panhandle State University","2019","On-tenure track, associate professors","2","2","0","1","1","0","0","0","0","0","0","0","0","0","0","0","0","0","1","1","0","0","0","0","0","0","0","0","0","0","-2"
"207351","Oklahoma Panhandle State University","2019","On-tenure track, assistant professors","15","7","8","0","0","0","0","0","0","0","0","0","0","0","0","0","0","0","14","6","8","1","1","0","0","0","0","0","0","0","-2"
"207351","Oklahoma Panhandle State University","2019","Not on tenure track/No tenure system system total","17","9","8","0","0","0","0","0","0","1","0","1","2","2","0","0","0","0","13","6","7","0","0","0","0","0","0","1","1","0","-2"
"207351","Oklahoma Panhandle State University","2019","Not on tenure/no tenure system, instructors","17","9","8","0","0","0","0","0","0","1","0","1","2","2","0","0","0","0","13","6","7","0","0","0","0","0","0","1","1","0","-2"
"209241","Mount Angel Seminary","2019","Not on tenure track/No tenure system system total","13","9","4","0","0","0","1","0","1","0","0","0","0","0","0","0","0","0","12","9","3","0","0","0","0","0","0","0","0","0","-2"
"209241","Mount Angel Seminary","2019","Not on tenure/no tenure system, professors","6","5","1","0","0","0","0","0","0","0","0","0","0","0","0","0","0","0","6","5","1","0","0","0","0","0","0","0","0","0","-2"
"209241","Mount Angel Seminary","2019","Not on tenure/no tenure system, associate professors","7","4","3","0","0","0","1","0","1","0","0","0","0","0","0","0","0","0","6","4","2","0","0","0","0","0","0","0","0","0","-2"
"210304","Warner Pacific University","2019","Not on tenure track/No tenure system system total","27","13","14","0","0","0","1","1","0","2","1","1","3","2","1","0","0","0","18","7","11","0","0","0","3","2","1","0","0","0","-2"
"210304","Warner Pacific University","2019","Not on tenure/no tenure system, professors","5","4","1","0","0","0","0","0","0","0","0","0","1","1","0","0","0","0","4","3","1","0","0","0","0","0","0","0","0","0","-2"
"210304","Warner Pacific University","2019","Not on tenure/no tenure system, associate professors","10","3","7","0","0","0","1","1","0","0","0","0","0","0","0","0","0","0","7","1","6","0","0","0","2","1","1","0","0","0","-2"
"210304","Warner Pacific University","2019","Not on tenure/no tenure system, assistant professors","9","5","4","0","0","0","0","0","0","1","1","0","2","1","1","0","0","0","5","2","3","0","0","0","1","1","0","0","0","0","-2"
"210304","Warner Pacific University","2019","Not on tenure/no tenure system, instructors","3","1","2","0","0","0","0","0","0","1","0","1","0","0","0","0","0","0","2","1","1","0","0","0","0","0","0","0","0","0","-2"
"222831","Angelo State University","2019","Tenured total","135","81","54","2","0","2","6","3","3","9","5","4","8","2","6","0","0","0","109","70","39","0","0","0","1","1","0","0","0","0","-2"
"222831","Angelo State University","2019","Tenured, professors","74","46","28","2","0","2","3","2","1","2","1","1","4","2","2","0","0","0","63","41","22","0","0","0","0","0","0","0","0","0","-2"
"222831","Angelo State University","2019","Tenured, associate professors","59","34","25","0","0","0","3","1","2","7","4","3","3","0","3","0","0","0","45","28","17","0","0","0","1","1","0","0","0","0","-2"
"222831","Angelo State University","2019","Tenured, assistant professors","2","1","1","0","0","0","0","0","0","0","0","0","1","0","1","0","0","0","1","1","0","0","0","0","0","0","0","0","0","0","-2"
"222831","Angelo State University","2019","On-Tenure track total","68","39","29","1","1","0","9","9","0","2","2","0","4","2","2","0","0","0","51","24","27","0","0","0","1","1","0","0","0","0","-2"
"222831","Angelo State University","2019","On-tenure track, assistant professors","68","39","29","1","1","0","9","9","0","2","2","0","4","2","2","0","0","0","51","24","27","0","0","0","1","1","0","0","0","0","-2"
"222831","Angelo State University","2019","Not on tenure track/No tenure system system total","106","44","62","3","0","3","0","0","0","1","0","1","15","9","6","0","0","0","87","35","52","0","0","0","0","0","0","0","0","0","-2"
"222831","Angelo State University","2019","Not on tenure/no tenure system, assistant professors","1","1","0","0","0","0","0","0","0","0","0","0","0","0","0","0","0","0","1","1","0","0","0","0","0","0","0","0","0","0","-2"
"222831","Angelo State University","2019","Not on tenure/no tenure system, instructors","76","37","39","1","0","1","0","0","0","0","0","0","10","8","2","0","0","0","65","29","36","0","0","0","0","0","0","0","0","0","-2"
"222831","Angelo State University","2019","Not on tenure/no tenure system, lecturers","1","0","1","0","0","0","0","0","0","0","0","0","0","0","0","0","0","0","1","0","1","0","0","0","0","0","0","0","0","0","-2"
"222831","Angelo State University","2019","Not on tenure/no tenure system, no academic rank","28","6","22","2","0","2","0","0","0","1","0","1","5","1","4","0","0","0","20","5","15","0","0","0","0","0","0","0","0","0","-2"
"222992","Austin Community College District","2019","Not on tenure track/No tenure system system total","598","259","339","2","0","2","29","11","18","48","23","25","93","46","47","2","2","0","415","173","242","9","4","5","0","0","0","0","0","0","-2"
"222992","Austin Community College District","2019","Not on tenure/no tenure system, professors","325","158","167","2","0","2","17","7","10","28","18","10","47","24","23","1","1","0","225","106","119","5","2","3","0","0","0","0","0","0","-2"
"222992","Austin Community College District","2019","Not on tenure/no tenure system, associate professors","152","49","103","0","0","0","9","3","6","10","2","8","27","11","16","0","0","0","105","32","73","1","1","0","0","0","0","0","0","0","-2"
"222992","Austin Community College District","2019","Not on tenure/no tenure system, assistant professors","50","24","26","0","0","0","2","1","1","3","2","1","8","4","4","1","1","0","33","15","18","3","1","2","0","0","0","0","0","0","-2"
"222992","Austin Community College District","2019","Not on tenure/no tenure system, instructors","5","3","2","0","0","0","0","0","0","0","0","0","2","2","0","0","0","0","3","1","2","0","0","0","0","0","0","0","0","0","-2"
"222992","Austin Community College District","2019","Not on tenure/no tenure system, no academic rank","66","25","41","0","0","0","1","0","1","7","1","6","9","5","4","0","0","0","49","19","30","0","0","0","0","0","0","0","0","0","-2"
"223506","Brazosport College","2019","Tenured total","39","22","17","1","1","0","2","0","2","2","2","0","2","0","2","0","0","0","32","19","13","0","0","0","0","0","0","0","0","0","-2"
"223506","Brazosport College","2019","Tenured, professors","15","9","6","1","1","0","1","0","1","0","0","0","0","0","0","0","0","0","13","8","5","0","0","0","0","0","0","0","0","0","-2"
"223506","Brazosport College","2019","Tenured, associate professors","12","7","5","0","0","0","1","0","1","2","2","0","0","0","0","0","0","0","9","5","4","0","0","0","0","0","0","0","0","0","-2"
"223506","Brazosport College","2019","Tenured, assistant professors","12","6","6","0","0","0","0","0","0","0","0","0","2","0","2","0","0","0","10","6","4","0","0","0","0","0","0","0","0","0","-2"
"223506","Brazosport College","2019","Not on tenure track/No tenure system system total","61","38","23","1","1","0","3","3","0","7","2","5","6","4","2","0","0","0","44","28","16","0","0","0","0","0","0","0","0","0","-2"
"223506","Brazosport College","2019","Not on tenure/no tenure system, professors","1","1","0","0","0","0","0","0","0","0","0","0","0","0","0","0","0","0","1","1","0","0","0","0","0","0","0","0","0","0","-2"
"223506","Brazosport College","2019","Not on tenure/no tenure system, associate professors","5","3","2","0","0","0","0","0","0","1","0","1","1","1","0","0","0","0","3","2","1","0","0","0","0","0","0","0","0","0","-2"
"223506","Brazosport College","2019","Not on tenure/no tenure system, assistant professors","24","13","11","0","0","0","2","2","0","4","1","3","1","0","1","0","0","0","17","10","7","0","0","0","0","0","0","0","0","0","-2"
"223506","Brazosport College","2019","Not on tenure/no tenure system, instructors","31","21","10","1","1","0","1","1","0","2","1","1","4","3","1","0","0","0","23","15","8","0","0","0","0","0","0","0","0","0","-2"
"224004","Concordia University Texas","2019","Tenured total","8","6","2","0","0","0","0","0","0","0","0","0","0","0","0","0","0","0","8","6","2","0","0","0","0","0","0","0","0","0","-2"
"224004","Concordia University Texas","2019","Tenured, professors","7","5","2","0","0","0","0","0","0","0","0","0","0","0","0","0","0","0","7","5","2","0","0","0","0","0","0","0","0","0","-2"
"224004","Concordia University Texas","2019","Tenured, associate professors","1","1","0","0","0","0","0","0","0","0","0","0","0","0","0","0","0","0","1","1","0","0","0","0","0","0","0","0","0","0","-2"
"224004","Concordia University Texas","2019","On-Tenure track total","44","19","25","2","0","2","0","0","0","3","1","2","2","0","2","0","0","0","33","16","17","1","1","0","0","0","0","3","1","2","-2"
"224004","Concordia University Texas","2019","On-tenure track, professors","2","1","1","0","0","0","0","0","0","0","0","0","0","0","0","0","0","0","2","1","1","0","0","0","0","0","0","0","0","0","-2"
"224004","Concordia University Texas","2019","On-tenure track, associate professors","21","11","10","1","0","1","0","0","0","1","0","1","1","0","1","0","0","0","18","11","7","0","0","0","0","0","0","0","0","0","-2"
"224004","Concordia University Texas","2019","On-tenure track, assistant professors","18","7","11","1","0","1","0","0","0","2","1","1","1","0","1","0","0","0","10","4","6","1","1","0","0","0","0","3","1","2","-2"
"224004","Concordia University Texas","2019","On-tenure track, instructors","3","0","3","0","0","0","0","0","0","0","0","0","0","0","0","0","0","0","3","0","3","0","0","0","0","0","0","0","0","0","-2"
"224004","Concordia University Texas","2019","Not on tenure track/No tenure system system total","1","0","1","0","0","0","0","0","0","0","0","0","0","0","0","0","0","0","1","0","1","0","0","0","0","0","0","0","0","0","-2"
"224004","Concordia University Texas","2019","Not on tenure/no tenure system, instructors","1","0","1","0","0","0","0","0","0","0","0","0","0","0","0","0","0","0","1","0","1","0","0","0","0","0","0","0","0","0","-2"
"224961","Galveston College","2019","Tenured total","17","11","6","1","1","0","1","1","0","2","1","1","3","1","2","0","0","0","10","7","3","0","0","0","0","0","0","0","0","0","-2"
"224961","Galveston College","2019","Tenured, professors","2","2","0","0","0","0","0","0","0","1","1","0","0","0","0","0","0","0","1","1","0","0","0","0","0","0","0","0","0","0","-2"
"224961","Galveston College","2019","Tenured, associate professors","6","4","2","0","0","0","0","0","0","0","0","0","2","1","1","0","0","0","4","3","1","0","0","0","0","0","0","0","0","0","-2"
"224961","Galveston College","2019","Tenured, assistant professors","4","2","2","0","0","0","1","1","0","1","0","1","0","0","0","0","0","0","2","1","1","0","0","0","0","0","0","0","0","0","-2"
"224961","Galveston College","2019","Tenured, instructors","5","3","2","1","1","0","0","0","0","0","0","0","1","0","1","0","0","0","3","2","1","0","0","0","0","0","0","0","0","0","-2"
"224961","Galveston College","2019","On-Tenure track total","43","18","25","1","0","1","2","0","2","5","2","3","5","3","2","0","0","0","30","13","17","0","0","0","0","0","0","0","0","0","-2"
"224961","Galveston College","2019","On-tenure track, associate professors","2","1","1","0","0","0","0","0","0","1","0","1","0","0","0","0","0","0","1","1","0","0","0","0","0","0","0","0","0","0","-2"
"224961","Galveston College","2019","On-tenure track, assistant professors","2","1","1","0","0","0","0","0","0","0","0","0","0","0","0","0","0","0","2","1","1","0","0","0","0","0","0","0","0","0","-2"
"224961","Galveston College","2019","On-tenure track, instructors","39","16","23","1","0","1","2","0","2","4","2","2","5","3","2","0","0","0","27","11","16","0","0","0","0","0","0","0","0","0","-2"
"225201","Hallmark University","2019","Not on tenure track/No tenure system system total","25","14","11","0","0","0","1","1","0","2","2","0","5","4","1","0","0","0","16","7","9","1","0","1","0","0","0","0","0","0","-2"
"225201","Hallmark University","2019","Not on tenure/no tenure system, instructors","25","14","11","0","0","0","1","1","0","2","2","0","5","4","1","0","0","0","16","7","9","1","0","1","0","0","0","0","0","0","-2"
"225399","Houston Baptist University","2019","Not on tenure track/No tenure system system total","138","80","58","1","1","0","3","2","1","13","3","10","8","7","1","0","0","0","101","61","40","3","2","1","5","1","4","4","3","1","-2"
"225399","Houston Baptist University","2019","Not on tenure/no tenure system, professors","36","23","13","0","0","0","0","0","0","3","0","3","0","0","0","0","0","0","31","22","9","1","1","0","1","0","1","0","0","0","-2"
"225399","Houston Baptist University","2019","Not on tenure/no tenure system, associate professors","40","24","16","0","0","0","2","2","0","3","2","1","6","5","1","0","0","0","26","14","12","1","0","1","1","0","1","1","1","0","-2"
"225399","Houston Baptist University","2019","Not on tenure/no tenure system, assistant professors","60","32","28","1","1","0","0","0","0","7","1","6","2","2","0","0","0","0","43","24","19","1","1","0","3","1","2","3","2","1","-2"
"225399","Houston Baptist University","2019","Not on tenure/no tenure system, instructors","2","1","1","0","0","0","1","0","1","0","0","0","0","0","0","0","0","0","1","1","0","0","0","0","0","0","0","0","0","0","-2"
"225414","University of Houston-Clear Lake","2019","Tenured total","153","90","63","0","0","0","24","15","9","5","2","3","6","1","5","0","0","0","115","69","46","2","2","0","0","0","0","1","1","0","-2"
"225414","University of Houston-Clear Lake","2019","Tenured, professors","60","36","24","0","0","0","14","8","6","2","1","1","2","0","2","0","0","0","42","27","15","0","0","0","0","0","0","0","0","0","-2"
"225414","University of Houston-Clear Lake","2019","Tenured, associate professors","93","54","39","0","0","0","10","7","3","3","1","2","4","1","3","0","0","0","73","42","31","2","2","0","0","0","0","1","1","0","-2"
"225414","University of Houston-Clear Lake","2019","On-Tenure track total","82","42","40","0","0","0","18","12","6","5","2","3","9","2","7","1","0","1","38","20","18","2","0","2","0","0","0","9","6","3","-2"
"225414","University of Houston-Clear Lake","2019","On-tenure track, associate professors","2","1","1","0","0","0","0","0","0","0","0","0","0","0","0","0","0","0","2","1","1","0","0","0","0","0","0","0","0","0","-2"
"225414","University of Houston-Clear Lake","2019","On-tenure track, assistant professors","80","41","39","0","0","0","18","12","6","5","2","3","9","2","7","1","0","1","36","19","17","2","0","2","0","0","0","9","6","3","-2"
"225414","University of Houston-Clear Lake","2019","Not on tenure track/No tenure system system total","43","13","30","0","0","0","5","2","3","4","0","4","4","0","4","0","0","0","28","11","17","1","0","1","0","0","0","1","0","1","-2"
"225414","University of Houston-Clear Lake","2019","Not on tenure/no tenure system, lecturers","31","10","21","0","0","0","2","0","2","3","0","3","3","0","3","0","0","0","22","10","12","1","0","1","0","0","0","0","0","0","-2"
"225414","University of Houston-Clear Lake","2019","Not on tenure/no tenure system, no academic rank","12","3","9","0","0","0","3","2","1","1","0","1","1","0","1","0","0","0","6","1","5","0","0","0","0","0","0","1","0","1","-2"
"225432","University of Houston-Downtown","2019","Tenured total","169","94","75","1","0","1","32","21","11","14","5","9","13","8","5","0","0","0","106","57","49","2","2","0","0","0","0","1","1","0","-2"
"225432","University of Houston-Downtown","2019","Tenured, professors","60","39","21","0","0","0","14","11","3","5","2","3","4","4","0","0","0","0","36","21","15","1","1","0","0","0","0","0","0","0","-2"
"225432","University of Houston-Downtown","2019","Tenured, associate professors","109","55","54","1","0","1","18","10","8","9","3","6","9","4","5","0","0","0","70","36","34","1","1","0","0","0","0","1","1","0","-2"
"225432","University of Houston-Downtown","2019","On-Tenure track total","82","44","38","0","0","0","13","10","3","11","5","6","15","7","8","0","0","0","33","17","16","1","0","1","1","1","0","8","4","4","-2"
"225432","University of Houston-Downtown","2019","On-tenure track, professors","1","1","0","0","0","0","0","0","0","0","0","0","0","0","0","0","0","0","1","1","0","0","0","0","0","0","0","0","0","0","-2"
"225432","University of Houston-Downtown","2019","On-tenure track, associate professors","6","5","1","0","0","0","4","4","0","0","0","0","1","0","1","0","0","0","1","1","0","0","0","0","0","0","0","0","0","0","-2"
"225432","University of Houston-Downtown","2019","On-tenure track, assistant professors","75","38","37","0","0","0","9","6","3","11","5","6","14","7","7","0","0","0","31","15","16","1","0","1","1","1","0","8","4","4","-2"
"225432","University of Houston-Downtown","2019","Not on tenure track/No tenure system system total","106","52","54","0","0","0","25","13","12","6","3","3","12","7","5","0","0","0","54","24","30","4","3","1","2","0","2","3","2","1","-2"
"225432","University of Houston-Downtown","2019","Not on tenure/no tenure system, lecturers","95","44","51","0","0","0","23","12","11","6","3","3","9","4","5","0","0","0","49","21","28","4","3","1","2","0","2","2","1","1","-2"
"225432","University of Houston-Downtown","2019","Not on tenure/no tenure system, no academic rank","11","8","3","0","0","0","2","1","1","0","0","0","3","3","0","0","0","0","5","3","2","0","0","0","0","0","0","1","1","0","-2"
"225502","University of Houston-Victoria","2019","Tenured total","66","39","27","0","0","0","19","13","6","1","1","0","10","5","5","0","0","0","34","20","14","2","0","2","0","0","0","0","0","0","-2"
"225502","University of Houston-Victoria","2019","Tenured, professors","29","19","10","0","0","0","9","6","3","0","0","0","4","3","1","0","0","0","16","10","6","0","0","0","0","0","0","0","0","0","-2"
"225502","University of Houston-Victoria","2019","Tenured, associate professors","37","20","17","0","0","0","10","7","3","1","1","0","6","2","4","0","0","0","18","10","8","2","0","2","0","0","0","0","0","0","-2"
"225502","University of Houston-Victoria","2019","On-Tenure track total","46","23","23","0","0","0","9","5","4","5","2","3","4","3","1","0","0","0","19","9","10","0","0","0","1","0","1","8","4","4","-2"
"225502","University of Houston-Victoria","2019","On-tenure track, associate professors","3","1","2","0","0","0","1","0","1","0","0","0","0","0","0","0","0","0","2","1","1","0","0","0","0","0","0","0","0","0","-2"
"225502","University of Houston-Victoria","2019","On-tenure track, assistant professors","43","22","21","0","0","0","8","5","3","5","2","3","4","3","1","0","0","0","17","8","9","0","0","0","1","0","1","8","4","4","-2"
"225502","University of Houston-Victoria","2019","Not on tenure track/No tenure system system total","17","8","9","0","0","0","0","0","0","1","1","0","2","1","1","0","0","0","11","6","5","0","0","0","0","0","0","3","0","3","-2"
"225502","University of Houston-Victoria","2019","Not on tenure/no tenure system, lecturers","12","6","6","0","0","0","0","0","0","0","0","0","2","1","1","0","0","0","8","5","3","0","0","0","0","0","0","2","0","2","-2"
"225502","University of Houston-Victoria","2019","Not on tenure/no tenure system, no academic rank","5","2","3","0","0","0","0","0","0","1","1","0","0","0","0","0","0","0","3","1","2","0","0","0","0","0","0","1","0","1","-2"
"225548","Howard Payne University","2019","Tenured total","2","1","1","0","0","0","0","0","0","0","0","0","0","0","0","0","0","0","2","1","1","0","0","0","0","0","0","0","0","0","-2"
"225548","Howard Payne University","2019","Tenured, professors","2","1","1","0","0","0","0","0","0","0","0","0","0","0","0","0","0","0","2","1","1","0","0","0","0","0","0","0","0","0","-2"
"225548","Howard Payne University","2019","Not on tenure track/No tenure system system total","62","39","23","0","0","0","0","0","0","2","1","1","3","3","0","0","0","0","57","35","22","0","0","0","0","0","0","0","0","0","-2"
"225548","Howard Payne University","2019","Not on tenure/no tenure system, professors","17","13","4","0","0","0","0","0","0","0","0","0","1","1","0","0","0","0","16","12","4","0","0","0","0","0","0","0","0","0","-2"
"225548","Howard Payne University","2019","Not on tenure/no tenure system, associate professors","20","14","6","0","0","0","0","0","0","2","1","1","2","2","0","0","0","0","16","11","5","0","0","0","0","0","0","0","0","0","-2"
"225548","Howard Payne University","2019","Not on tenure/no tenure system, assistant professors","15","7","8","0","0","0","0","0","0","0","0","0","0","0","0","0","0","0","15","7","8","0","0","0","0","0","0","0","0","0","-2"
"225548","Howard Payne University","2019","Not on tenure/no tenure system, instructors","10","5","5","0","0","0","0","0","0","0","0","0","0","0","0","0","0","0","10","5","5","0","0","0","0","0","0","0","0","0","-2"
"225575","Huston-Tillotson University","2019","Tenured total","15","7","8","0","0","0","0","0","0","7","2","5","2","1","1","0","0","0","6","4","2","0","0","0","0","0","0","0","0","0","-2"
"225575","Huston-Tillotson University","2019","Tenured, professors","9","3","6","0","0","0","0","0","0","5","1","4","0","0","0","0","0","0","4","2","2","0","0","0","0","0","0","0","0","0","-2"
"225575","Huston-Tillotson University","2019","Tenured, associate professors","6","4","2","0","0","0","0","0","0","2","1","1","2","1","1","0","0","0","2","2","0","0","0","0","0","0","0","0","0","0","-2"
"225575","Huston-Tillotson University","2019","On-Tenure track total","20","12","8","0","0","0","2","0","2","7","2","5","2","2","0","0","0","0","2","2","0","0","0","0","6","5","1","1","1","0","-2"
"225575","Huston-Tillotson University","2019","On-tenure track, professors","1","1","0","0","0","0","0","0","0","0","0","0","0","0","0","0","0","0","1","1","0","0","0","0","0","0","0","0","0","0","-2"
"225575","Huston-Tillotson University","2019","On-tenure track, associate professors","4","0","4","0","0","0","1","0","1","3","0","3","0","0","0","0","0","0","0","0","0","0","0","0","0","0","0","0","0","0","-2"
"225575","Huston-Tillotson University","2019","On-tenure track, assistant professors","15","11","4","0","0","0","1","0","1","4","2","2","2","2","0","0","0","0","1","1","0","0","0","0","6","5","1","1","1","0","-2"
"225575","Huston-Tillotson University","2019","Not on tenure track/No tenure system system total","8","5","3","0","0","0","0","0","0","1","1","0","1","1","0","0","0","0","3","2","1","0","0","0","3","1","2","0","0","0","-2"
"225575","Huston-Tillotson University","2019","Not on tenure/no tenure system, professors","1","1","0","0","0","0","0","0","0","0","0","0","0","0","0","0","0","0","1","1","0","0","0","0","0","0","0","0","0","0","-2"
"225575","Huston-Tillotson University","2019","Not on tenure/no tenure system, assistant professors","1","0","1","0","0","0","0","0","0","0","0","0","0","0","0","0","0","0","1","0","1","0","0","0","0","0","0","0","0","0","-2"
"225575","Huston-Tillotson University","2019","Not on tenure/no tenure system, instructors","5","3","2","0","0","0","0","0","0","0","0","0","1","1","0","0","0","0","1","1","0","0","0","0","3","1","2","0","0","0","-2"
"225575","Huston-Tillotson University","2019","Not on tenure/no tenure system, lecturers","1","1","0","0","0","0","0","0","0","1","1","0","0","0","0","0","0","0","0","0","0","0","0","0","0","0","0","0","0","0","-2"
"226134","Laredo College","2019","Tenured total","131","75","56","1","0","1","6","4","2","0","0","0","103","57","46","0","0","0","20","13","7","0","0","0","1","1","0","0","0","0","-2"
"226134","Laredo College","2019","Tenured, professors","120","68","52","1","0","1","4","2","2","0","0","0","94","52","42","0","0","0","20","13","7","0","0","0","1","1","0","0","0","0","-2"
"226134","Laredo College","2019","Tenured, associate professors","11","7","4","0","0","0","2","2","0","0","0","0","9","5","4","0","0","0","0","0","0","0","0","0","0","0","0","0","0","0","-2"
"226134","Laredo College","2019","On-Tenure track total","37","18","19","0","0","0","1","0","1","1","1","0","33","15","18","0","0","0","2","2","0","0","0","0","0","0","0","0","0","0","-2"
"226134","Laredo College","2019","On-tenure track, assistant professors","34","17","17","0","0","0","1","0","1","1","1","0","30","14","16","0","0","0","2","2","0","0","0","0","0","0","0","0","0","0","-2"
"226134","Laredo College","2019","On-tenure track, instructors","3","1","2","0","0","0","0","0","0","0","0","0","3","1","2","0","0","0","0","0","0","0","0","0","0","0","0","0","0","0","-2"
"226134","Laredo College","2019","Not on tenure track/No tenure system system total","19","11","8","0","0","0","0","0","0","0","0","0","18","11","7","0","0","0","1","0","1","0","0","0","0","0","0","0","0","0","-2"
"226134","Laredo College","2019","Not on tenure/no tenure system, instructors","19","11","8","0","0","0","0","0","0","0","0","0","18","11","7","0","0","0","1","0","1","0","0","0","0","0","0","0","0","0","-2"
"226152","Texas A & M International University","2019","Tenured total","66","45","21","0","0","0","15","10","5","1","1","0","20","14","6","0","0","0","30","20","10","0","0","0","0","0","0","0","0","0","-2"
"226152","Texas A & M International University","2019","Tenured, professors","25","20","5","0","0","0","7","6","1","1","1","0","9","9","0","0","0","0","8","4","4","0","0","0","0","0","0","0","0","0","-2"
"226152","Texas A & M International University","2019","Tenured, associate professors","40","24","16","0","0","0","8","4","4","0","0","0","11","5","6","0","0","0","21","15","6","0","0","0","0","0","0","0","0","0","-2"
"226152","Texas A & M International University","2019","Tenured, assistant professors","1","1","0","0","0","0","0","0","0","0","0","0","0","0","0","0","0","0","1","1","0","0","0","0","0","0","0","0","0","0","-2"
"226152","Texas A & M International University","2019","On-Tenure track total","69","39","30","0","0","0","14","6","8","2","2","0","14","7","7","0","0","0","28","18","10","0","0","0","1","1","0","10","5","5","-2"
"226152","Texas A & M International University","2019","On-tenure track, associate professors","8","5","3","0","0","0","2","0","2","1","1","0","0","0","0","0","0","0","4","3","1","0","0","0","0","0","0","1","1","0","-2"
"226152","Texas A & M International University","2019","On-tenure track, assistant professors","61","34","27","0","0","0","12","6","6","1","1","0","14","7","7","0","0","0","24","15","9","0","0","0","1","1","0","9","4","5","-2"
"226152","Texas A & M International University","2019","Not on tenure track/No tenure system system total","91","32","59","0","0","0","4","0","4","2","1","1","49","16","33","0","0","0","27","9","18","0","0","0","3","1","2","6","5","1","-2"
"226152","Texas A & M International University","2019","Not on tenure/no tenure system, professors","1","1","0","0","0","0","0","0","0","0","0","0","0","0","0","0","0","0","0","0","0","0","0","0","0","0","0","1","1","0","-2"
"226152","Texas A & M International University","2019","Not on tenure/no tenure system, associate professors","6","3","3","0","0","0","1","0","1","1","1","0","1","1","0","0","0","0","3","1","2","0","0","0","0","0","0","0","0","0","-2"
"226152","Texas A & M International University","2019","Not on tenure/no tenure system, assistant professors","51","15","36","0","0","0","2","0","2","0","0","0","27","6","21","0","0","0","16","5","11","0","0","0","2","1","1","4","3","1","-2"
"226152","Texas A & M International University","2019","Not on tenure/no tenure system, instructors","23","9","14","0","0","0","1","0","1","0","0","0","16","7","9","0","0","0","5","1","4","0","0","0","0","0","0","1","1","0","-2"
"226152","Texas A & M International University","2019","Not on tenure/no tenure system, lecturers","10","4","6","0","0","0","0","0","0","1","0","1","5","2","3","0","0","0","3","2","1","0","0","0","1","0","1","0","0","0","-2"
"226587","McMurry University","2019","Tenured total","45","30","15","0","0","0","1","0","1","0","0","0","3","1","2","0","0","0","41","29","12","0","0","0","0","0","0","0","0","0","-2"
"226587","McMurry University","2019","Tenured, professors","28","19","9","0","0","0","1","0","1","0","0","0","0","0","0","0","0","0","27","19","8","0","0","0","0","0","0","0","0","0","-2"
"226587","McMurry University","2019","Tenured, associate professors","17","11","6","0","0","0","0","0","0","0","0","0","3","1","2","0","0","0","14","10","4","0","0","0","0","0","0","0","0","0","-2"
"226587","McMurry University","2019","On-Tenure track total","11","8","3","0","0","0","0","0","0","1","1","0","1","1","0","0","0","0","9","6","3","0","0","0","0","0","0","0","0","0","-2"
"226587","McMurry University","2019","On-tenure track, associate professors","1","1","0","0","0","0","0","0","0","0","0","0","0","0","0","0","0","0","1","1","0","0","0","0","0","0","0","0","0","0","-2"
"226587","McMurry University","2019","On-tenure track, assistant professors","9","7","2","0","0","0","0","0","0","1","1","0","1","1","0","0","0","0","7","5","2","0","0","0","0","0","0","0","0","0","-2"
"226587","McMurry University","2019","On-tenure track, instructors","1","0","1","0","0","0","0","0","0","0","0","0","0","0","0","0","0","0","1","0","1","0","0","0","0","0","0","0","0","0","-2"
"226587","McMurry University","2019","Not on tenure track/No tenure system system total","25","8","17","0","0","0","1","0","1","0","0","0","0","0","0","0","0","0","23","8","15","0","0","0","0","0","0","1","0","1","-2"
"226587","McMurry University","2019","Not on tenure/no tenure system, assistant professors","6","3","3","0","0","0","0","0","0","0","0","0","0","0","0","0","0","0","5","3","2","0","0","0","0","0","0","1","0","1","-2"
"226587","McMurry University","2019","Not on tenure/no tenure system, instructors","19","5","14","0","0","0","1","0","1","0","0","0","0","0","0","0","0","0","18","5","13","0","0","0","0","0","0","0","0","0","-2"
"226806","Midland College","2019","Not on tenure track/No tenure system system total","135","61","74","0","0","0","2","1","1","4","1","3","16","7","9","0","0","0","111","50","61","0","0","0","2","2","0","0","0","0","-2"
"226806","Midland College","2019","Not on tenure/no tenure system, professors","42","20","22","0","0","0","2","1","1","0","0","0","7","3","4","0","0","0","33","16","17","0","0","0","0","0","0","0","0","0","-2"
"226806","Midland College","2019","Not on tenure/no tenure system, associate professors","46","25","21","0","0","0","0","0","0","1","0","1","5","3","2","0","0","0","39","21","18","0","0","0","1","1","0","0","0","0","-2"
"226806","Midland College","2019","Not on tenure/no tenure system, assistant professors","16","6","10","0","0","0","0","0","0","2","1","1","1","1","0","0","0","0","12","3","9","0","0","0","1","1","0","0","0","0","-2"
"226806","Midland College","2019","Not on tenure/no tenure system, instructors","31","10","21","0","0","0","0","0","0","1","0","1","3","0","3","0","0","0","27","10","17","0","0","0","0","0","0","0","0","0","-2"
"227216","University of North Texas","2019","Tenured total","583","377","206","1","1","0","108","75","33","23","9","14","38","20","18","0","0","0","380","250","130","4","3","1","17","13","4","12","6","6","-2"
"227216","University of North Texas","2019","Tenured, professors","324","226","98","1","1","0","50","40","10","10","5","5","18","10","8","0","0","0","228","157","71","2","1","1","9","8","1","6","4","2","-2"
"227216","University of North Texas","2019","Tenured, associate professors","258","150","108","0","0","0","58","35","23","13","4","9","20","10","10","0","0","0","151","92","59","2","2","0","8","5","3","6","2","4","-2"
"227216","University of North Texas","2019","Tenured, assistant professors","1","1","0","0","0","0","0","0","0","0","0","0","0","0","0","0","0","0","1","1","0","0","0","0","0","0","0","0","0","0","-2"
"227216","University of North Texas","2019","On-Tenure track total","202","101","101","0","0","0","46","23","23","16","3","13","12","7","5","0","0","0","113","63","50","4","1","3","8","3","5","3","1","2","-2"
"227216","University of North Texas","2019","On-tenure track, associate professors","7","3","4","0","0","0","1","1","0","0","0","0","0","0","0","0","0","0","5","2","3","0","0","0","0","0","0","1","0","1","-2"
"227216","University of North Texas","2019","On-tenure track, assistant professors","195","98","97","0","0","0","45","22","23","16","3","13","12","7","5","0","0","0","108","61","47","4","1","3","8","3","5","2","1","1","-2"
"227216","University of North Texas","2019","Not on tenure track/No tenure system system total","372","138","234","1","0","1","33","11","22","20","6","14","31","8","23","0","0","0","261","103","158","8","1","7","9","3","6","9","6","3","-2"
"227216","University of North Texas","2019","Not on tenure/no tenure system, instructors","73","23","50","0","0","0","2","0","2","1","0","1","11","3","8","0","0","0","52","18","34","2","0","2","2","0","2","3","2","1","-2"
"227216","University of North Texas","2019","Not on tenure/no tenure system, lecturers","296","113","183","1","0","1","31","11","20","19","6","13","20","5","15","0","0","0","207","84","123","6","1","5","6","2","4","6","4","2","-2"
"227216","University of North Texas","2019","Not on tenure/no tenure system, no academic rank","3","2","1","0","0","0","0","0","0","0","0","0","0","0","0","0","0","0","2","1","1","0","0","0","1","1","0","0","0","0","-2"
"227331","Our Lady of the Lake University","2019","Tenured total","37","9","28","0","0","0","2","1","1","1","0","1","11","3","8","0","0","0","23","5","18","0","0","0","0","0","0","0","0","0","-2"
"227331","Our Lady of the Lake University","2019","Tenured, professors","23","7","16","0","0","0","1","1","0","1","0","1","5","2","3","0","0","0","16","4","12","0","0","0","0","0","0","0","0","0","-2"
"227331","Our Lady of the Lake University","2019","Tenured, associate professors","14","2","12","0","0","0","1","0","1","0","0","0","6","1","5","0","0","0","7","1","6","0","0","0","0","0","0","0","0","0","-2"
"227331","Our Lady of the Lake University","2019","On-Tenure track total","34","13","21","0","0","0","1","0","1","3","2","1","10","4","6","0","0","0","17","4","13","0","0","0","0","0","0","3","3","0","-2"
"227331","Our Lady of the Lake University","2019","On-tenure track, associate professors","1","0","1","0","0","0","0","0","0","0","0","0","0","0","0","0","0","0","1","0","1","0","0","0","0","0","0","0","0","0","-2"
"227331","Our Lady of the Lake University","2019","On-tenure track, assistant professors","32","13","19","0","0","0","1","0","1","3","2","1","10","4","6","0","0","0","15","4","11","0","0","0","0","0","0","3","3","0","-2"
"227331","Our Lady of the Lake University","2019","On-tenure track, instructors","1","0","1","0","0","0","0","0","0","0","0","0","0","0","0","0","0","0","1","0","1","0","0","0","0","0","0","0","0","0","-2"
"227331","Our Lady of the Lake University","2019","Not on tenure track/No tenure system system total","37","20","17","0","0","0","1","1","0","1","1","0","9","3","6","0","0","0","25","14","11","0","0","0","0","0","0","1","1","0","-2"
"227331","Our Lady of the Lake University","2019","Not on tenure/no tenure system, professors","2","0","2","0","0","0","0","0","0","0","0","0","1","0","1","0","0","0","1","0","1","0","0","0","0","0","0","0","0","0","-2"
"227331","Our Lady of the Lake University","2019","Not on tenure/no tenure system, associate professors","13","6","7","0","0","0","0","0","0","0","0","0","4","1","3","0","0","0","9","5","4","0","0","0","0","0","0","0","0","0","-2"
"227331","Our Lady of the Lake University","2019","Not on tenure/no tenure system, assistant professors","20","12","8","0","0","0","1","1","0","1","1","0","4","2","2","0","0","0","13","7","6","0","0","0","0","0","0","1","1","0","-2"
"227331","Our Lady of the Lake University","2019","Not on tenure/no tenure system, instructors","1","1","0","0","0","0","0","0","0","0","0","0","0","0","0","0","0","0","1","1","0","0","0","0","0","0","0","0","0","0","-2"
"227331","Our Lady of the Lake University","2019","Not on tenure/no tenure system, lecturers","1","1","0","0","0","0","0","0","0","0","0","0","0","0","0","0","0","0","1","1","0","0","0","0","0","0","0","0","0","0","-2"
"227368","The University of Texas Rio Grande Valley","2019","Tenured total","470","323","147","1","0","1","89","63","26","15","12","3","114","60","54","0","0","0","219","164","55","1","1","0","27","20","7","4","3","1","-2"
"227368","The University of Texas Rio Grande Valley","2019","Tenured, professors","246","181","65","1","0","1","48","37","11","6","5","1","52","30","22","0","0","0","119","94","25","0","0","0","19","14","5","1","1","0","-2"
"227368","The University of Texas Rio Grande Valley","2019","Tenured, associate professors","224","142","82","0","0","0","41","26","15","9","7","2","62","30","32","0","0","0","100","70","30","1","1","0","8","6","2","3","2","1","-2"
"227368","The University of Texas Rio Grande Valley","2019","On-Tenure track total","235","135","100","1","1","0","39","28","11","7","5","2","61","31","30","0","0","0","77","38","39","1","1","0","4","3","1","45","28","17","-2"
"227368","The University of Texas Rio Grande Valley","2019","On-tenure track, associate professors","20","12","8","0","0","0","5","4","1","0","0","0","6","3","3","0","0","0","8","4","4","0","0","0","1","1","0","0","0","0","-2"
"227368","The University of Texas Rio Grande Valley","2019","On-tenure track, assistant professors","215","123","92","1","1","0","34","24","10","7","5","2","55","28","27","0","0","0","69","34","35","1","1","0","3","2","1","45","28","17","-2"
"227368","The University of Texas Rio Grande Valley","2019","Not on tenure track/No tenure system system total","568","270","298","1","0","1","54","22","32","8","4","4","295","135","160","0","0","0","153","72","81","3","1","2","20","10","10","34","26","8","-2"
"227368","The University of Texas Rio Grande Valley","2019","Not on tenure/no tenure system, professors","6","4","2","0","0","0","1","1","0","0","0","0","0","0","0","0","0","0","5","3","2","0","0","0","0","0","0","0","0","0","-2"
"227368","The University of Texas Rio Grande Valley","2019","Not on tenure/no tenure system, associate professors","17","11","6","0","0","0","3","2","1","0","0","0","2","2","0","0","0","0","7","4","3","0","0","0","4","2","2","1","1","0","-2"
"227368","The University of Texas Rio Grande Valley","2019","Not on tenure/no tenure system, assistant professors","73","43","30","0","0","0","7","6","1","2","1","1","28","15","13","0","0","0","19","9","10","1","0","1","6","4","2","10","8","2","-2"
"227368","The University of Texas Rio Grande Valley","2019","Not on tenure/no tenure system, lecturers","472","212","260","1","0","1","43","13","30","6","3","3","265","118","147","0","0","0","122","56","66","2","1","1","10","4","6","23","17","6","-2"
"227845","Saint Edward's University","2019","Tenured total","83","36","47","0","0","0","3","1","2","2","0","2","10","3","7","0","0","0","67","32","35","1","0","1","0","0","0","0","0","0","-2"
"227845","Saint Edward's University","2019","Tenured, professors","39","19","20","0","0","0","1","1","0","1","0","1","4","1","3","0","0","0","33","17","16","0","0","0","0","0","0","0","0","0","-2"
"227845","Saint Edward's University","2019","Tenured, associate professors","44","17","27","0","0","0","2","0","2","1","0","1","6","2","4","0","0","0","34","15","19","1","0","1","0","0","0","0","0","0","-2"
"227845","Saint Edward's University","2019","On-Tenure track total","68","34","34","0","0","0","7","5","2","3","1","2","3","0","3","0","0","0","54","27","27","0","0","0","0","0","0","1","1","0","-2"
"227845","Saint Edward's University","2019","On-tenure track, professors","1","0","1","0","0","0","0","0","0","0","0","0","0","0","0","0","0","0","1","0","1","0","0","0","0","0","0","0","0","0","-2"
"227845","Saint Edward's University","2019","On-tenure track, associate professors","24","12","12","0","0","0","3","2","1","1","0","1","0","0","0","0","0","0","20","10","10","0","0","0","0","0","0","0","0","0","-2"
"227845","Saint Edward's University","2019","On-tenure track, assistant professors","43","22","21","0","0","0","4","3","1","2","1","1","3","0","3","0","0","0","33","17","16","0","0","0","0","0","0","1","1","0","-2"
"227845","Saint Edward's University","2019","Not on tenure track/No tenure system system total","25","13","12","0","0","0","2","1","1","1","0","1","2","2","0","0","0","0","20","10","10","0","0","0","0","0","0","0","0","0","-2"
"227845","Saint Edward's University","2019","Not on tenure/no tenure system, assistant professors","15","9","6","0","0","0","1","1","0","1","0","1","1","1","0","0","0","0","12","7","5","0","0","0","0","0","0","0","0","0","-2"
"227845","Saint Edward's University","2019","Not on tenure/no tenure system, instructors","8","4","4","0","0","0","1","0","1","0","0","0","1","1","0","0","0","0","6","3","3","0","0","0","0","0","0","0","0","0","-2"
"227845","Saint Edward's University","2019","Not on tenure/no tenure system, lecturers","2","0","2","0","0","0","0","0","0","0","0","0","0","0","0","0","0","0","2","0","2","0","0","0","0","0","0","0","0","0","-2"
"227863","University of St Thomas","2019","Tenured total","75","44","31","0","0","0","4","2","2","2","2","0","11","5","6","0","0","0","51","32","19","3","3","0","1","0","1","3","0","3","-2"
"227863","University of St Thomas","2019","Tenured, professors","29","17","12","0","0","0","2","0","2","0","0","0","2","1","1","0","0","0","25","16","9","0","0","0","0","0","0","0","0","0","-2"
"227863","University of St Thomas","2019","Tenured, associate professors","43","26","17","0","0","0","2","2","0","2","2","0","7","3","4","0","0","0","25","16","9","3","3","0","1","0","1","3","0","3","-2"
"227863","University of St Thomas","2019","Tenured, assistant professors","3","1","2","0","0","0","0","0","0","0","0","0","2","1","1","0","0","0","1","0","1","0","0","0","0","0","0","0","0","0","-2"
"227863","University of St Thomas","2019","On-Tenure track total","22","13","9","0","0","0","3","1","2","1","1","0","2","2","0","0","0","0","9","6","3","0","0","0","2","1","1","5","2","3","-2"
"227863","University of St Thomas","2019","On-tenure track, associate professors","6","4","2","0","0","0","0","0","0","0","0","0","1","1","0","0","0","0","5","3","2","0","0","0","0","0","0","0","0","0","-2"
"227863","University of St Thomas","2019","On-tenure track, assistant professors","16","9","7","0","0","0","3","1","2","1","1","0","1","1","0","0","0","0","4","3","1","0","0","0","2","1","1","5","2","3","-2"
"227863","University of St Thomas","2019","Not on tenure track/No tenure system system total","54","26","28","0","0","0","5","2","3","8","1","7","5","3","2","0","0","0","33","18","15","0","0","0","1","1","0","2","1","1","-2"
"227863","University of St Thomas","2019","Not on tenure/no tenure system, professors","6","2","4","0","0","0","0","0","0","2","0","2","1","1","0","0","0","0","3","1","2","0","0","0","0","0","0","0","0","0","-2"
"227863","University of St Thomas","2019","Not on tenure/no tenure system, associate professors","1","1","0","0","0","0","0","0","0","0","0","0","0","0","0","0","0","0","1","1","0","0","0","0","0","0","0","0","0","0","-2"
"227863","University of St Thomas","2019","Not on tenure/no tenure system, assistant professors","26","14","12","0","0","0","4","2","2","2","0","2","1","0","1","0","0","0","17","11","6","0","0","0","1","1","0","1","0","1","-2"
"227863","University of St Thomas","2019","Not on tenure/no tenure system, instructors","18","8","10","0","0","0","1","0","1","4","1","3","3","2","1","0","0","0","9","4","5","0","0","0","0","0","0","1","1","0","-2"
"227863","University of St Thomas","2019","Not on tenure/no tenure system, no academic rank","3","1","2","0","0","0","0","0","0","0","0","0","0","0","0","0","0","0","3","1","2","0","0","0","0","0","0","0","0","0","-2"
"228042","Schreiner University","2019","Tenured total","15","8","7","0","0","0","0","0","0","0","0","0","0","0","0","0","0","0","15","8","7","0","0","0","0","0","0","0","0","0","-2"
"228042","Schreiner University","2019","Tenured, professors","9","5","4","0","0","0","0","0","0","0","0","0","0","0","0","0","0","0","9","5","4","0","0","0","0","0","0","0","0","0","-2"
"228042","Schreiner University","2019","Tenured, associate professors","6","3","3","0","0","0","0","0","0","0","0","0","0","0","0","0","0","0","6","3","3","0","0","0","0","0","0","0","0","0","-2"
"228042","Schreiner University","2019","On-Tenure track total","25","17","8","0","0","0","0","0","0","0","0","0","4","4","0","0","0","0","20","12","8","0","0","0","1","1","0","0","0","0","-2"
"228042","Schreiner University","2019","On-tenure track, professors","1","0","1","0","0","0","0","0","0","0","0","0","0","0","0","0","0","0","1","0","1","0","0","0","0","0","0","0","0","0","-2"
"228042","Schreiner University","2019","On-tenure track, associate professors","9","4","5","0","0","0","0","0","0","0","0","0","1","1","0","0","0","0","8","3","5","0","0","0","0","0","0","0","0","0","-2"
"228042","Schreiner University","2019","On-tenure track, assistant professors","15","13","2","0","0","0","0","0","0","0","0","0","3","3","0","0","0","0","11","9","2","0","0","0","1","1","0","0","0","0","-2"
"228042","Schreiner University","2019","Not on tenure track/No tenure system system total","21","10","11","0","0","0","0","0","0","1","0","1","4","3","1","0","0","0","13","6","7","0","0","0","2","0","2","1","1","0","-2"
"228042","Schreiner University","2019","Not on tenure/no tenure system, assistant professors","9","7","2","0","0","0","0","0","0","1","0","1","2","2","0","0","0","0","5","4","1","0","0","0","0","0","0","1","1","0","-2"
"228042","Schreiner University","2019","Not on tenure/no tenure system, instructors","12","3","9","0","0","0","0","0","0","0","0","0","2","1","1","0","0","0","8","2","6","0","0","0","2","0","2","0","0","0","-2"
"228149","St. Mary's University","2019","Tenured total","137","93","44","1","1","0","10","9","1","4","3","1","19","13","6","1","1","0","95","59","36","0","0","0","1","1","0","6","6","0","-2"
"228149","St. Mary's University","2019","Tenured, professors","77","53","24","0","0","0","8","8","0","3","3","0","7","3","4","1","1","0","55","35","20","0","0","0","1","1","0","2","2","0","-2"
"228149","St. Mary's University","2019","Tenured, associate professors","58","38","20","1","1","0","2","1","1","1","0","1","12","10","2","0","0","0","38","22","16","0","0","0","0","0","0","4","4","0","-2"
"228149","St. Mary's University","2019","Tenured, assistant professors","2","2","0","0","0","0","0","0","0","0","0","0","0","0","0","0","0","0","2","2","0","0","0","0","0","0","0","0","0","0","-2"
"228149","St. Mary's University","2019","On-Tenure track total","36","17","19","1","1","0","1","0","1","1","0","1","4","3","1","0","0","0","17","6","11","0","0","0","0","0","0","12","7","5","-2"
"228149","St. Mary's University","2019","On-tenure track, associate professors","1","1","0","0","0","0","0","0","0","0","0","0","0","0","0","0","0","0","1","1","0","0","0","0","0","0","0","0","0","0","-2"
"228149","St. Mary's University","2019","On-tenure track, assistant professors","35","16","19","1","1","0","1","0","1","1","0","1","4","3","1","0","0","0","16","5","11","0","0","0","0","0","0","12","7","5","-2"
"228149","St. Mary's University","2019","Not on tenure track/No tenure system system total","48","21","27","0","0","0","0","0","0","2","2","0","9","4","5","0","0","0","34","13","21","0","0","0","1","0","1","2","2","0","-2"
"228149","St. Mary's University","2019","Not on tenure/no tenure system, professors","10","3","7","0","0","0","0","0","0","0","0","0","3","2","1","0","0","0","7","1","6","0","0","0","0","0","0","0","0","0","-2"
"228149","St. Mary's University","2019","Not on tenure/no tenure system, associate professors","1","1","0","0","0","0","0","0","0","0","0","0","0","0","0","0","0","0","1","1","0","0","0","0","0","0","0","0","0","0","-2"
"228149","St. Mary's University","2019","Not on tenure/no tenure system, assistant professors","9","6","3","0","0","0","0","0","0","0","0","0","1","1","0","0","0","0","7","5","2","0","0","0","1","0","1","0","0","0","-2"
"228149","St. Mary's University","2019","Not on tenure/no tenure system, instructors","24","11","13","0","0","0","0","0","0","2","2","0","3","1","2","0","0","0","17","6","11","0","0","0","0","0","0","2","2","0","-2"
"228149","St. Mary's University","2019","Not on tenure/no tenure system, lecturers","4","0","4","0","0","0","0","0","0","0","0","0","2","0","2","0","0","0","2","0","2","0","0","0","0","0","0","0","0","0","-2"
"228468","Southwestern Adventist University","2019","Not on tenure track/No tenure system system total","47","29","18","0","0","0","3","2","1","5","4","1","7","4","3","0","0","0","32","19","13","0","0","0","0","0","0","0","0","0","-2"
"228468","Southwestern Adventist University","2019","Not on tenure/no tenure system, professors","12","12","0","0","0","0","1","1","0","2","2","0","1","1","0","0","0","0","8","8","0","0","0","0","0","0","0","0","0","0","-2"
"228468","Southwestern Adventist University","2019","Not on tenure/no tenure system, associate professors","13","8","5","0","0","0","2","1","1","1","1","0","2","2","0","0","0","0","8","4","4","0","0","0","0","0","0","0","0","0","-2"
"228468","Southwestern Adventist University","2019","Not on tenure/no tenure system, assistant professors","22","9","13","0","0","0","0","0","0","2","1","1","4","1","3","0","0","0","16","7","9","0","0","0","0","0","0","0","0","0","-2"
"228501","Sul Ross State University","2019","Tenured total","40","24","16","0","0","0","1","1","0","0","0","0","9","6","3","0","0","0","28","16","12","0","0","0","0","0","0","2","1","1","-2"
"228501","Sul Ross State University","2019","Tenured, professors","29","18","11","0","0","0","1","1","0","0","0","0","6","3","3","0","0","0","21","14","7","0","0","0","0","0","0","1","0","1","-2"
"228501","Sul Ross State University","2019","Tenured, associate professors","11","6","5","0","0","0","0","0","0","0","0","0","3","3","0","0","0","0","7","2","5","0","0","0","0","0","0","1","1","0","-2"
"228501","Sul Ross State University","2019","On-Tenure track total","44","27","17","0","0","0","1","1","0","3","3","0","12","5","7","0","0","0","21","11","10","0","0","0","1","1","0","6","6","0","-2"
"228501","Sul Ross State University","2019","On-tenure track, associate professors","4","3","1","0","0","0","0","0","0","0","0","0","1","1","0","0","0","0","2","1","1","0","0","0","0","0","0","1","1","0","-2"
"228501","Sul Ross State University","2019","On-tenure track, assistant professors","31","19","12","0","0","0","1","1","0","2","2","0","10","4","6","0","0","0","15","9","6","0","0","0","0","0","0","3","3","0","-2"
"228501","Sul Ross State University","2019","On-tenure track, instructors","4","1","3","0","0","0","0","0","0","0","0","0","1","0","1","0","0","0","3","1","2","0","0","0","0","0","0","0","0","0","-2"
"228501","Sul Ross State University","2019","On-tenure track, no academic rank","5","4","1","0","0","0","0","0","0","1","1","0","0","0","0","0","0","0","1","0","1","0","0","0","1","1","0","2","2","0","-2"
"228501","Sul Ross State University","2019","Not on tenure track/No tenure system system total","25","8","17","0","0","0","0","0","0","1","0","1","8","2","6","0","0","0","16","6","10","0","0","0","0","0","0","0","0","0","-2"
"228501","Sul Ross State University","2019","Not on tenure/no tenure system, assistant professors","3","0","3","0","0","0","0","0","0","1","0","1","1","0","1","0","0","0","1","0","1","0","0","0","0","0","0","0","0","0","-2"
"228501","Sul Ross State University","2019","Not on tenure/no tenure system, lecturers","18","6","12","0","0","0","0","0","0","0","0","0","6","2","4","0","0","0","12","4","8","0","0","0","0","0","0","0","0","0","-2"
"228501","Sul Ross State University","2019","Not on tenure/no tenure system, no academic rank","4","2","2","0","0","0","0","0","0","0","0","0","1","0","1","0","0","0","3","2","1","0","0","0","0","0","0","0","0","0","-2"
"228644","The University of Texas Health Science Center at San Antonio","2019","Tenured total","224","153","71","0","0","0","46","30","16","6","6","0","25","13","12","0","0","0","143","101","42","0","0","0","4","3","1","0","0","0","-2"
"228644","The University of Texas Health Science Center at San Antonio","2019","Tenured, professors","158","122","36","0","0","0","31","26","5","3","3","0","17","13","4","0","0","0","104","77","27","0","0","0","3","3","0","0","0","0","-2"
"228644","The University of Texas Health Science Center at San Antonio","2019","Tenured, associate professors","65","31","34","0","0","0","15","4","11","3","3","0","8","0","8","0","0","0","38","24","14","0","0","0","1","0","1","0","0","0","-2"
"228644","The University of Texas Health Science Center at San Antonio","2019","Tenured, assistant professors","1","0","1","0","0","0","0","0","0","0","0","0","0","0","0","0","0","0","1","0","1","0","0","0","0","0","0","0","0","0","-2"
"228644","The University of Texas Health Science Center at San Antonio","2019","On-Tenure track total","69","38","31","0","0","0","23","16","7","2","0","2","11","5","6","0","0","0","29","16","13","0","0","0","4","1","3","0","0","0","-2"
"228644","The University of Texas Health Science Center at San Antonio","2019","On-tenure track, professors","1","1","0","0","0","0","0","0","0","0","0","0","0","0","0","0","0","0","1","1","0","0","0","0","0","0","0","0","0","0","-2"
"228644","The University of Texas Health Science Center at San Antonio","2019","On-tenure track, associate professors","12","8","4","0","0","0","3","3","0","0","0","0","0","0","0","0","0","0","8","5","3","0","0","0","1","0","1","0","0","0","-2"
"228644","The University of Texas Health Science Center at San Antonio","2019","On-tenure track, assistant professors","56","29","27","0","0","0","20","13","7","2","0","2","11","5","6","0","0","0","20","10","10","0","0","0","3","1","2","0","0","0","-2"
"228644","The University of Texas Health Science Center at San Antonio","2019","Not on tenure track/No tenure system system total","543","269","274","0","0","0","89","42","47","16","4","12","112","49","63","2","0","2","305","163","142","0","0","0","19","11","8","0","0","0","-2"
"228644","The University of Texas Health Science Center at San Antonio","2019","Not on tenure/no tenure system, professors","65","48","17","0","0","0","8","8","0","2","1","1","7","4","3","0","0","0","48","35","13","0","0","0","0","0","0","0","0","0","-2"
"228644","The University of Texas Health Science Center at San Antonio","2019","Not on tenure/no tenure system, associate professors","133","76","57","0","0","0","26","13","13","4","0","4","21","10","11","1","0","1","81","53","28","0","0","0","0","0","0","0","0","0","-2"
"228644","The University of Texas Health Science Center at San Antonio","2019","Not on tenure/no tenure system, assistant professors","281","121","160","0","0","0","49","20","29","7","2","5","69","29","40","1","0","1","138","60","78","0","0","0","17","10","7","0","0","0","-2"
"228644","The University of Texas Health Science Center at San Antonio","2019","Not on tenure/no tenure system, instructors","20","9","11","0","0","0","2","1","1","0","0","0","5","3","2","0","0","0","13","5","8","0","0","0","0","0","0","0","0","0","-2"
"228644","The University of Texas Health Science Center at San Antonio","2019","Not on tenure/no tenure system, lecturers","1","0","1","0","0","0","0","0","0","0","0","0","0","0","0","0","0","0","1","0","1","0","0","0","0","0","0","0","0","0","-2"
"228644","The University of Texas Health Science Center at San Antonio","2019","Not on tenure/no tenure system, no academic rank","43","15","28","0","0","0","4","0","4","3","1","2","10","3","7","0","0","0","24","10","14","0","0","0","2","1","1","0","0","0","-2"
"228705","Texas A & M University-Kingsville","2019","Tenured total","189","135","54","2","2","0","33","26","7","6","6","0","29","19","10","0","0","0","111","79","32","1","1","0","1","0","1","6","2","4","-2"
"228705","Texas A & M University-Kingsville","2019","Tenured, professors","99","76","23","1","1","0","18","15","3","4","4","0","15","10","5","0","0","0","60","46","14","0","0","0","0","0","0","1","0","1","-2"
"228705","Texas A & M University-Kingsville","2019","Tenured, associate professors","79","50","29","1","1","0","10","6","4","2","2","0","13","8","5","0","0","0","48","31","17","1","1","0","1","0","1","3","1","2","-2"
"228705","Texas A & M University-Kingsville","2019","Tenured, assistant professors","9","7","2","0","0","0","5","5","0","0","0","0","0","0","0","0","0","0","2","1","1","0","0","0","0","0","0","2","1","1","-2"
"228705","Texas A & M University-Kingsville","2019","Tenured, no academic rank","2","2","0","0","0","0","0","0","0","0","0","0","1","1","0","0","0","0","1","1","0","0","0","0","0","0","0","0","0","0","-2"
"228705","Texas A & M University-Kingsville","2019","On-Tenure track total","56","34","22","1","1","0","8","5","3","1","0","1","7","3","4","0","0","0","28","18","10","1","1","0","3","2","1","7","4","3","-2"
"228705","Texas A & M University-Kingsville","2019","On-tenure track, associate professors","5","4","1","0","0","0","0","0","0","0","0","0","1","1","0","0","0","0","3","2","1","0","0","0","1","1","0","0","0","0","-2"
"228705","Texas A & M University-Kingsville","2019","On-tenure track, assistant professors","50","30","20","1","1","0","8","5","3","1","0","1","6","2","4","0","0","0","25","16","9","1","1","0","1","1","0","7","4","3","-2"
"228705","Texas A & M University-Kingsville","2019","On-tenure track, no academic rank","1","0","1","0","0","0","0","0","0","0","0","0","0","0","0","0","0","0","0","0","0","0","0","0","1","0","1","0","0","0","-2"
"228705","Texas A & M University-Kingsville","2019","Not on tenure track/No tenure system system total","75","39","36","1","1","0","8","4","4","2","2","0","23","10","13","0","0","0","28","12","16","1","1","0","2","1","1","10","8","2","-2"
"228705","Texas A & M University-Kingsville","2019","Not on tenure/no tenure system, professors","4","4","0","0","0","0","1","1","0","0","0","0","2","2","0","0","0","0","0","0","0","0","0","0","0","0","0","1","1","0","-2"
"228705","Texas A & M University-Kingsville","2019","Not on tenure/no tenure system, assistant professors","12","7","5","0","0","0","3","2","1","0","0","0","2","1","1","0","0","0","3","1","2","0","0","0","0","0","0","4","3","1","-2"
"228705","Texas A & M University-Kingsville","2019","Not on tenure/no tenure system, lecturers","32","14","18","1","1","0","2","1","1","0","0","0","9","2","7","0","0","0","15","5","10","1","1","0","0","0","0","4","4","0","-2"
"228705","Texas A & M University-Kingsville","2019","Not on tenure/no tenure system, no academic rank","27","14","13","0","0","0","2","0","2","2","2","0","10","5","5","0","0","0","10","6","4","0","0","0","2","1","1","1","0","1","-2"
"228981","Texas Lutheran University","2019","Tenured total","45","24","21","0","0","0","1","0","1","0","0","0","3","1","2","0","0","0","41","23","18","0","0","0","0","0","0","0","0","0","-2"
"228981","Texas Lutheran University","2019","Tenured, professors","25","14","11","0","0","0","1","0","1","0","0","0","1","0","1","0","0","0","23","14","9","0","0","0","0","0","0","0","0","0","-2"
"228981","Texas Lutheran University","2019","Tenured, associate professors","19","9","10","0","0","0","0","0","0","0","0","0","2","1","1","0","0","0","17","8","9","0","0","0","0","0","0","0","0","0","-2"
"228981","Texas Lutheran University","2019","Tenured, assistant professors","1","1","0","0","0","0","0","0","0","0","0","0","0","0","0","0","0","0","1","1","0","0","0","0","0","0","0","0","0","0","-2"
"228981","Texas Lutheran University","2019","On-Tenure track total","27","9","18","0","0","0","0","0","0","0","0","0","2","0","2","0","0","0","24","9","15","0","0","0","1","0","1","0","0","0","-2"
"228981","Texas Lutheran University","2019","On-tenure track, associate professors","7","2","5","0","0","0","0","0","0","0","0","0","1","0","1","0","0","0","6","2","4","0","0","0","0","0","0","0","0","0","-2"
"228981","Texas Lutheran University","2019","On-tenure track, assistant professors","17","7","10","0","0","0","0","0","0","0","0","0","0","0","0","0","0","0","16","7","9","0","0","0","1","0","1","0","0","0","-2"
"228981","Texas Lutheran University","2019","On-tenure track, instructors","3","0","3","0","0","0","0","0","0","0","0","0","1","0","1","0","0","0","2","0","2","0","0","0","0","0","0","0","0","0","-2"
"228981","Texas Lutheran University","2019","Not on tenure track/No tenure system system total","13","5","8","0","0","0","1","0","1","0","0","0","2","1","1","0","0","0","8","2","6","0","0","0","0","0","0","2","2","0","-2"
"228981","Texas Lutheran University","2019","Not on tenure/no tenure system, assistant professors","7","4","3","0","0","0","1","0","1","0","0","0","1","1","0","0","0","0","3","1","2","0","0","0","0","0","0","2","2","0","-2"
"228981","Texas Lutheran University","2019","Not on tenure/no tenure system, lecturers","6","1","5","0","0","0","0","0","0","0","0","0","1","0","1","0","0","0","5","1","4","0","0","0","0","0","0","0","0","0","-2"
"229018","The University of Texas Permian Basin","2019","Tenured total","69","49","20","0","0","0","10","8","2","2","1","1","2","0","2","0","0","0","55","40","15","0","0","0","0","0","0","0","0","0","-2"
"229018","The University of Texas Permian Basin","2019","Tenured, professors","34","25","9","0","0","0","6","4","2","2","1","1","0","0","0","0","0","0","26","20","6","0","0","0","0","0","0","0","0","0","-2"
"229018","The University of Texas Permian Basin","2019","Tenured, associate professors","35","24","11","0","0","0","4","4","0","0","0","0","2","0","2","0","0","0","29","20","9","0","0","0","0","0","0","0","0","0","-2"
"229018","The University of Texas Permian Basin","2019","On-Tenure track total","43","26","17","0","0","0","13","10","3","2","0","2","4","1","3","0","0","0","23","15","8","0","0","0","1","0","1","0","0","0","-2"
"229018","The University of Texas Permian Basin","2019","On-tenure track, professors","1","1","0","0","0","0","1","1","0","0","0","0","0","0","0","0","0","0","0","0","0","0","0","0","0","0","0","0","0","0","-2"
"229018","The University of Texas Permian Basin","2019","On-tenure track, associate professors","4","3","1","0","0","0","1","1","0","1","0","1","0","0","0","0","0","0","2","2","0","0","0","0","0","0","0","0","0","0","-2"
"229018","The University of Texas Permian Basin","2019","On-tenure track, assistant professors","38","22","16","0","0","0","11","8","3","1","0","1","4","1","3","0","0","0","21","13","8","0","0","0","1","0","1","0","0","0","-2"
"229018","The University of Texas Permian Basin","2019","Not on tenure track/No tenure system system total","61","28","33","0","0","0","5","3","2","6","4","2","3","1","2","0","0","0","47","20","27","0","0","0","0","0","0","0","0","0","-2"
"229018","The University of Texas Permian Basin","2019","Not on tenure/no tenure system, lecturers","61","28","33","0","0","0","5","3","2","6","4","2","3","1","2","0","0","0","47","20","27","0","0","0","0","0","0","0","0","0","-2"
"229027","The University of Texas at San Antonio","2019","Tenured total","435","306","129","3","2","1","97","76","21","15","10","5","70","42","28","0","0","0","240","170","70","1","1","0","7","3","4","2","2","0","-2"
"229027","The University of Texas at San Antonio","2019","Tenured, professors","242","186","56","1","1","0","65","55","10","8","5","3","37","24","13","0","0","0","128","99","29","0","0","0","3","2","1","0","0","0","-2"
"229027","The University of Texas at San Antonio","2019","Tenured, associate professors","193","120","73","2","1","1","32","21","11","7","5","2","33","18","15","0","0","0","112","71","41","1","1","0","4","1","3","2","2","0","-2"
"229027","The University of Texas at San Antonio","2019","On-Tenure track total","176","95","81","0","0","0","26","16","10","2","2","0","28","12","16","0","0","0","68","36","32","3","1","2","22","11","11","27","17","10","-2"
"229027","The University of Texas at San Antonio","2019","On-tenure track, associate professors","11","10","1","0","0","0","1","1","0","0","0","0","0","0","0","0","0","0","7","7","0","0","0","0","2","2","0","1","0","1","-2"
"229027","The University of Texas at San Antonio","2019","On-tenure track, assistant professors","165","85","80","0","0","0","25","15","10","2","2","0","28","12","16","0","0","0","61","29","32","3","1","2","20","9","11","26","17","9","-2"
"229027","The University of Texas at San Antonio","2019","Not on tenure track/No tenure system system total","348","173","175","0","0","0","28","12","16","16","7","9","73","40","33","0","0","0","192","98","94","6","0","6","19","6","13","14","10","4","-2"
"229027","The University of Texas at San Antonio","2019","Not on tenure/no tenure system, professors","7","5","2","0","0","0","0","0","0","0","0","0","1","1","0","0","0","0","6","4","2","0","0","0","0","0","0","0","0","0","-2"
"229027","The University of Texas at San Antonio","2019","Not on tenure/no tenure system, associate professors","19","13","6","0","0","0","3","1","2","1","1","0","3","2","1","0","0","0","10","9","1","0","0","0","0","0","0","2","0","2","-2"
"229027","The University of Texas at San Antonio","2019","Not on tenure/no tenure system, assistant professors","44","28","16","0","0","0","4","2","2","1","0","1","12","5","7","0","0","0","18","14","4","0","0","0","2","1","1","7","6","1","-2"
"229027","The University of Texas at San Antonio","2019","Not on tenure/no tenure system, instructors","1","1","0","0","0","0","1","1","0","0","0","0","0","0","0","0","0","0","0","0","0","0","0","0","0","0","0","0","0","0","-2"
"229027","The University of Texas at San Antonio","2019","Not on tenure/no tenure system, lecturers","272","124","148","0","0","0","19","8","11","13","6","7","56","31","25","0","0","0","156","70","86","6","0","6","17","5","12","5","4","1","-2"
"229027","The University of Texas at San Antonio","2019","Not on tenure/no tenure system, no academic rank","5","2","3","0","0","0","1","0","1","1","0","1","1","1","0","0","0","0","2","1","1","0","0","0","0","0","0","0","0","0","-2"
"229160","Texas Wesleyan University","2019","Tenured total","74","38","36","0","0","0","5","3","2","1","1","0","5","3","2","0","0","0","62","30","32","0","0","0","1","1","0","0","0","0","-2"
"229160","Texas Wesleyan University","2019","Tenured, professors","29","18","11","0","0","0","2","2","0","1","1","0","3","2","1","0","0","0","23","13","10","0","0","0","0","0","0","0","0","0","-2"
"229160","Texas Wesleyan University","2019","Tenured, associate professors","43","19","24","0","0","0","3","1","2","0","0","0","2","1","1","0","0","0","37","16","21","0","0","0","1","1","0","0","0","0","-2"
"229160","Texas Wesleyan University","2019","Tenured, assistant professors","2","1","1","0","0","0","0","0","0","0","0","0","0","0","0","0","0","0","2","1","1","0","0","0","0","0","0","0","0","0","-2"
"229160","Texas Wesleyan University","2019","On-Tenure track total","26","11","15","0","0","0","4","2","2","1","0","1","2","2","0","0","0","0","18","7","11","1","0","1","0","0","0","0","0","0","-2"
"229160","Texas Wesleyan University","2019","On-tenure track, associate professors","3","0","3","0","0","0","0","0","0","0","0","0","0","0","0","0","0","0","3","0","3","0","0","0","0","0","0","0","0","0","-2"
"229160","Texas Wesleyan University","2019","On-tenure track, assistant professors","21","10","11","0","0","0","4","2","2","1","0","1","2","2","0","0","0","0","13","6","7","1","0","1","0","0","0","0","0","0","-2"
"229160","Texas Wesleyan University","2019","On-tenure track, instructors","2","1","1","0","0","0","0","0","0","0","0","0","0","0","0","0","0","0","2","1","1","0","0","0","0","0","0","0","0","0","-2"
"229160","Texas Wesleyan University","2019","Not on tenure track/No tenure system system total","19","10","9","0","0","0","1","1","0","2","0","2","1","1","0","0","0","0","15","8","7","0","0","0","0","0","0","0","0","0","-2"
"229160","Texas Wesleyan University","2019","Not on tenure/no tenure system, professors","1","1","0","0","0","0","0","0","0","0","0","0","0","0","0","0","0","0","1","1","0","0","0","0","0","0","0","0","0","0","-2"
"229160","Texas Wesleyan University","2019","Not on tenure/no tenure system, associate professors","2","0","2","0","0","0","0","0","0","1","0","1","0","0","0","0","0","0","1","0","1","0","0","0","0","0","0","0","0","0","-2"
"229160","Texas Wesleyan University","2019","Not on tenure/no tenure system, assistant professors","10","6","4","0","0","0","1","1","0","1","0","1","1","1","0","0","0","0","7","4","3","0","0","0","0","0","0","0","0","0","-2"
"229160","Texas Wesleyan University","2019","Not on tenure/no tenure system, instructors","6","3","3","0","0","0","0","0","0","0","0","0","0","0","0","0","0","0","6","3","3","0","0","0","0","0","0","0","0","0","-2"
"229179","Texas Woman's University","2019","Tenured total","216","64","152","3","0","3","27","10","17","11","2","9","9","2","7","2","1","1","160","47","113","3","1","2","1","1","0","0","0","0","-2"
"229179","Texas Woman's University","2019","Tenured, professors","117","36","81","2","0","2","14","7","7","4","0","4","5","2","3","1","1","0","89","25","64","1","0","1","1","1","0","0","0","0","-2"
"229179","Texas Woman's University","2019","Tenured, associate professors","96","28","68","1","0","1","13","3","10","6","2","4","4","0","4","1","0","1","69","22","47","2","1","1","0","0","0","0","0","0","-2"
"229179","Texas Woman's University","2019","Tenured, assistant professors","3","0","3","0","0","0","0","0","0","1","0","1","0","0","0","0","0","0","2","0","2","0","0","0","0","0","0","0","0","0","-2"
"229179","Texas Woman's University","2019","On-Tenure track total","112","32","80","1","0","1","12","2","10","10","3","7","11","3","8","0","0","0","73","24","49","4","0","4","1","0","1","0","0","0","-2"
"229179","Texas Woman's University","2019","On-tenure track, professors","2","0","2","0","0","0","0","0","0","0","0","0","0","0","0","0","0","0","2","0","2","0","0","0","0","0","0","0","0","0","-2"
"229179","Texas Woman's University","2019","On-tenure track, associate professors","12","1","11","0","0","0","1","0","1","1","0","1","2","1","1","0","0","0","8","0","8","0","0","0","0","0","0","0","0","0","-2"
"229179","Texas Woman's University","2019","On-tenure track, assistant professors","98","31","67","1","0","1","11","2","9","9","3","6","9","2","7","0","0","0","63","24","39","4","0","4","1","0","1","0","0","0","-2"
"229179","Texas Woman's University","2019","Not on tenure track/No tenure system system total","129","17","112","1","0","1","8","1","7","10","0","10","7","2","5","0","0","0","99","13","86","1","0","1","3","1","2","0","0","0","-2"
"229179","Texas Woman's University","2019","Not on tenure/no tenure system, professors","12","2","10","1","0","1","1","0","1","1","0","1","0","0","0","0","0","0","9","2","7","0","0","0","0","0","0","0","0","0","-2"
"229179","Texas Woman's University","2019","Not on tenure/no tenure system, associate professors","39","3","36","0","0","0","2","1","1","2","0","2","1","0","1","0","0","0","34","2","32","0","0","0","0","0","0","0","0","0","-2"
"229179","Texas Woman's University","2019","Not on tenure/no tenure system, assistant professors","55","6","49","0","0","0","3","0","3","6","0","6","5","1","4","0","0","0","37","4","33","1","0","1","3","1","2","0","0","0","-2"
"229179","Texas Woman's University","2019","Not on tenure/no tenure system, instructors","4","0","4","0","0","0","0","0","0","0","0","0","0","0","0","0","0","0","4","0","4","0","0","0","0","0","0","0","0","0","-2"
"229179","Texas Woman's University","2019","Not on tenure/no tenure system, lecturers","19","6","13","0","0","0","2","0","2","1","0","1","1","1","0","0","0","0","15","5","10","0","0","0","0","0","0","0","0","0","-2"
"229300","The University of Texas Health Science Center at Houston","2019","Tenured total","253","164","89","1","1","0","71","51","20","5","5","0","15","9","6","0","0","0","158","96","62","1","1","0","1","1","0","1","0","1","-2"
"229300","The University of Texas Health Science Center at Houston","2019","Tenured, professors","175","119","56","0","0","0","40","32","8","2","2","0","11","8","3","0","0","0","120","75","45","1","1","0","1","1","0","0","0","0","-2"
"229300","The University of Texas Health Science Center at Houston","2019","Tenured, associate professors","78","45","33","1","1","0","31","19","12","3","3","0","4","1","3","0","0","0","38","21","17","0","0","0","0","0","0","1","0","1","-2"
"229300","The University of Texas Health Science Center at Houston","2019","On-Tenure track total","142","85","57","0","0","0","52","31","21","5","1","4","15","8","7","0","0","0","58","37","21","1","1","0","5","3","2","6","4","2","-2"
"229300","The University of Texas Health Science Center at Houston","2019","On-tenure track, professors","14","12","2","0","0","0","3","3","0","0","0","0","1","1","0","0","0","0","8","6","2","0","0","0","2","2","0","0","0","0","-2"
"229300","The University of Texas Health Science Center at Houston","2019","On-tenure track, associate professors","36","17","19","0","0","0","18","9","9","1","0","1","5","2","3","0","0","0","12","6","6","0","0","0","0","0","0","0","0","0","-2"
"229300","The University of Texas Health Science Center at Houston","2019","On-tenure track, assistant professors","92","56","36","0","0","0","31","19","12","4","1","3","9","5","4","0","0","0","38","25","13","1","1","0","3","1","2","6","4","2","-2"
"229300","The University of Texas Health Science Center at Houston","2019","Not on tenure track/No tenure system system total","1355","683","672","3","3","0","414","218","196","101","26","75","129","60","69","1","1","0","595","296","299","16","7","9","47","25","22","49","47","2","-2"
"229300","The University of Texas Health Science Center at Houston","2019","Not on tenure/no tenure system, professors","127","80","47","1","1","0","27","15","12","1","0","1","13","8","5","0","0","0","78","50","28","0","0","0","6","5","1","1","1","0","-2"
"229300","The University of Texas Health Science Center at Houston","2019","Not on tenure/no tenure system, associate professors","287","152","135","1","1","0","86","52","34","21","4","17","29","15","14","0","0","0","137","73","64","3","2","1","10","5","5","0","0","0","-2"
"229300","The University of Texas Health Science Center at Houston","2019","Not on tenure/no tenure system, assistant professors","862","426","436","1","1","0","278","138","140","72","22","50","85","37","48","1","1","0","340","167","173","12","5","7","31","15","16","42","40","2","-2"
"229300","The University of Texas Health Science Center at Houston","2019","Not on tenure/no tenure system, instructors","68","24","44","0","0","0","22","13","9","7","0","7","1","0","1","0","0","0","31","5","26","1","0","1","0","0","0","6","6","0","-2"
"229300","The University of Texas Health Science Center at Houston","2019","Not on tenure/no tenure system, no academic rank","11","1","10","0","0","0","1","0","1","0","0","0","1","0","1","0","0","0","9","1","8","0","0","0","0","0","0","0","0","0","-2"
"229337","Texas Tech University Health Sciences Center","2019","Tenured total","142","91","51","0","0","0","28","18","10","1","1","0","10","8","2","0","0","0","103","64","39","0","0","0","0","0","0","0","0","0","-2"
"229337","Texas Tech University Health Sciences Center","2019","Tenured, professors","99","71","28","0","0","0","23","16","7","0","0","0","5","5","0","0","0","0","71","50","21","0","0","0","0","0","0","0","0","0","-2"
"229337","Texas Tech University Health Sciences Center","2019","Tenured, associate professors","43","20","23","0","0","0","5","2","3","1","1","0","5","3","2","0","0","0","32","14","18","0","0","0","0","0","0","0","0","0","-2"
"229337","Texas Tech University Health Sciences Center","2019","On-Tenure track total","58","38","20","1","0","1","14","10","4","5","4","1","2","0","2","0","0","0","36","24","12","0","0","0","0","0","0","0","0","0","-2"
"229337","Texas Tech University Health Sciences Center","2019","On-tenure track, professors","3","3","0","0","0","0","2","2","0","0","0","0","0","0","0","0","0","0","1","1","0","0","0","0","0","0","0","0","0","0","-2"
"229337","Texas Tech University Health Sciences Center","2019","On-tenure track, associate professors","15","10","5","1","0","1","3","2","1","0","0","0","0","0","0","0","0","0","11","8","3","0","0","0","0","0","0","0","0","0","-2"
"229337","Texas Tech University Health Sciences Center","2019","On-tenure track, assistant professors","40","25","15","0","0","0","9","6","3","5","4","1","2","0","2","0","0","0","24","15","9","0","0","0","0","0","0","0","0","0","-2"
"229337","Texas Tech University Health Sciences Center","2019","Not on tenure track/No tenure system system total","546","223","323","2","2","0","101","57","44","37","16","21","40","11","29","0","0","0","365","136","229","0","0","0","1","1","0","0","0","0","-2"
"229337","Texas Tech University Health Sciences Center","2019","Not on tenure/no tenure system, professors","60","33","27","0","0","0","4","3","1","1","1","0","2","2","0","0","0","0","53","27","26","0","0","0","0","0","0","0","0","0","-2"
"229337","Texas Tech University Health Sciences Center","2019","Not on tenure/no tenure system, associate professors","158","78","80","2","2","0","28","16","12","14","7","7","9","4","5","0","0","0","105","49","56","0","0","0","0","0","0","0","0","0","-2"
"229337","Texas Tech University Health Sciences Center","2019","Not on tenure/no tenure system, assistant professors","253","92","161","0","0","0","57","32","25","17","7","10","24","5","19","0","0","0","154","47","107","0","0","0","1","1","0","0","0","0","-2"
"229337","Texas Tech University Health Sciences Center","2019","Not on tenure/no tenure system, instructors","41","7","34","0","0","0","6","4","2","3","1","2","4","0","4","0","0","0","28","2","26","0","0","0","0","0","0","0","0","0","-2"
"229337","Texas Tech University Health Sciences Center","2019","Not on tenure/no tenure system, no academic rank","34","13","21","0","0","0","6","2","4","2","0","2","1","0","1","0","0","0","25","11","14","0","0","0","0","0","0","0","0","0","-2"
"229355","Tyler Junior College","2019","Not on tenure track/No tenure system system total","321","142","179","3","0","3","0","0","0","16","5","11","7","3","4","0","0","0","291","132","159","0","0","0","3","1","2","1","1","0","-2"
"229355","Tyler Junior College","2019","Not on tenure/no tenure system, professors","321","142","179","3","0","3","0","0","0","16","5","11","7","3","4","0","0","0","291","132","159","0","0","0","3","1","2","1","1","0","-2"
"229780","Wayland Baptist University","2019","Not on tenure track/No tenure system system total","140","92","48","3","1","2","4","2","2","11","6","5","8","4","4","0","0","0","107","74","33","4","2","2","3","3","0","0","0","0","-2"
"229780","Wayland Baptist University","2019","Not on tenure/no tenure system, professors","38","32","6","1","1","0","1","1","0","0","0","0","1","1","0","0","0","0","35","29","6","0","0","0","0","0","0","0","0","0","-2"
"229780","Wayland Baptist University","2019","Not on tenure/no tenure system, associate professors","44","30","14","1","0","1","1","0","1","5","2","3","3","2","1","0","0","0","30","22","8","2","2","0","2","2","0","0","0","0","-2"
"229780","Wayland Baptist University","2019","Not on tenure/no tenure system, assistant professors","58","30","28","1","0","1","2","1","1","6","4","2","4","1","3","0","0","0","42","23","19","2","0","2","1","1","0","0","0","0","-2"
"229814","West Texas A & M University","2019","Tenured total","135","86","49","0","0","0","11","7","4","1","1","0","6","2","4","0","0","0","115","75","40","0","0","0","1","0","1","1","1","0","-2"
"229814","West Texas A & M University","2019","Tenured, professors","62","40","22","0","0","0","8","5","3","0","0","0","1","1","0","0","0","0","53","34","19","0","0","0","0","0","0","0","0","0","-2"
"229814","West Texas A & M University","2019","Tenured, associate professors","72","45","27","0","0","0","3","2","1","1","1","0","5","1","4","0","0","0","61","40","21","0","0","0","1","0","1","1","1","0","-2"
"229814","West Texas A & M University","2019","Tenured, assistant professors","1","1","0","0","0","0","0","0","0","0","0","0","0","0","0","0","0","0","1","1","0","0","0","0","0","0","0","0","0","0","-2"
"229814","West Texas A & M University","2019","On-Tenure track total","93","54","39","0","0","0","4","1","3","0","0","0","7","4","3","0","0","0","58","36","22","0","0","0","3","2","1","21","11","10","-2"
"229814","West Texas A & M University","2019","On-tenure track, professors","1","1","0","0","0","0","0","0","0","0","0","0","0","0","0","0","0","0","1","1","0","0","0","0","0","0","0","0","0","0","-2"
"229814","West Texas A & M University","2019","On-tenure track, associate professors","1","1","0","0","0","0","0","0","0","0","0","0","1","1","0","0","0","0","0","0","0","0","0","0","0","0","0","0","0","0","-2"
"229814","West Texas A & M University","2019","On-tenure track, assistant professors","91","52","39","0","0","0","4","1","3","0","0","0","6","3","3","0","0","0","57","35","22","0","0","0","3","2","1","21","11","10","-2"
"229814","West Texas A & M University","2019","Not on tenure track/No tenure system system total","109","41","68","0","0","0","2","2","0","1","1","0","5","2","3","0","0","0","94","32","62","1","0","1","0","0","0","6","4","2","-2"
"229814","West Texas A & M University","2019","Not on tenure/no tenure system, professors","1","0","1","0","0","0","0","0","0","0","0","0","0","0","0","0","0","0","1","0","1","0","0","0","0","0","0","0","0","0","-2"
"229814","West Texas A & M University","2019","Not on tenure/no tenure system, associate professors","1","0","1","0","0","0","0","0","0","0","0","0","0","0","0","0","0","0","1","0","1","0","0","0","0","0","0","0","0","0","-2"
"229814","West Texas A & M University","2019","Not on tenure/no tenure system, assistant professors","9","4","5","0","0","0","0","0","0","0","0","0","1","1","0","0","0","0","6","3","3","0","0","0","0","0","0","2","0","2","-2"
"229814","West Texas A & M University","2019","Not on tenure/no tenure system, instructors","93","35","58","0","0","0","2","2","0","1","1","0","4","1","3","0","0","0","81","27","54","1","0","1","0","0","0","4","4","0","-2"
"229814","West Texas A & M University","2019","Not on tenure/no tenure system, lecturers","5","2","3","0","0","0","0","0","0","0","0","0","0","0","0","0","0","0","5","2","3","0","0","0","0","0","0","0","0","0","-2"
"234979","Columbia Basin College","2019","Tenured total","79","40","39","1","1","0","7","3","4","2","2","0","5","2","3","0","0","0","64","32","32","0","0","0","0","0","0","0","0","0","-2"
"234979","Columbia Basin College","2019","Tenured, no academic rank","79","40","39","1","1","0","7","3","4","2","2","0","5","2","3","0","0","0","64","32","32","0","0","0","0","0","0","0","0","0","-2"
"234979","Columbia Basin College","2019","On-Tenure track total","43","17","26","0","0","0","3","2","1","0","0","0","2","1","1","1","0","1","34","12","22","2","2","0","1","0","1","0","0","0","-2"
"234979","Columbia Basin College","2019","On-tenure track, no academic rank","43","17","26","0","0","0","3","2","1","0","0","0","2","1","1","1","0","1","34","12","22","2","2","0","1","0","1","0","0","0","-2"
"234979","Columbia Basin College","2019","Not on tenure track/No tenure system system total","14","4","10","0","0","0","0","0","0","0","0","0","1","1","0","1","0","1","11","2","9","1","1","0","0","0","0","0","0","0","-2"
"234979","Columbia Basin College","2019","Not on tenure/no tenure system, no academic rank","14","4","10","0","0","0","0","0","0","0","0","0","1","1","0","1","0","1","11","2","9","1","1","0","0","0","0","0","0","0","-2"
"235422","Heritage University","2019","Not on tenure track/No tenure system system total","67","31","36","4","2","2","1","1","0","3","2","1","6","1","5","1","1","0","49","23","26","2","1","1","1","0","1","0","0","0","-2"
"235422","Heritage University","2019","Not on tenure/no tenure system, professors","8","5","3","0","0","0","0","0","0","0","0","0","0","0","0","0","0","0","7","4","3","1","1","0","0","0","0","0","0","0","-2"
"235422","Heritage University","2019","Not on tenure/no tenure system, associate professors","25","15","10","2","0","2","0","0","0","2","2","0","2","0","2","1","1","0","18","12","6","0","0","0","0","0","0","0","0","0","-2"
"235422","Heritage University","2019","Not on tenure/no tenure system, assistant professors","28","10","18","2","2","0","1","1","0","1","0","1","2","1","1","0","0","0","22","6","16","0","0","0","0","0","0","0","0","0","-2"
"235422","Heritage University","2019","Not on tenure/no tenure system, instructors","6","1","5","0","0","0","0","0","0","0","0","0","2","0","2","0","0","0","2","1","1","1","0","1","1","0","1","0","0","0","-2"
"236975","Wenatchee Valley College","2019","Tenured total","59","32","27","0","0","0","2","0","2","1","0","1","4","4","0","0","0","0","48","25","23","4","3","1","0","0","0","0","0","0","-2"
"236975","Wenatchee Valley College","2019","Tenured, no academic rank","59","32","27","0","0","0","2","0","2","1","0","1","4","4","0","0","0","0","48","25","23","4","3","1","0","0","0","0","0","0","-2"
"236975","Wenatchee Valley College","2019","On-Tenure track total","20","6","14","0","0","0","1","0","1","0","0","0","0","0","0","0","0","0","18","5","13","1","1","0","0","0","0","0","0","0","-2"
"236975","Wenatchee Valley College","2019","On-tenure track, no academic rank","20","6","14","0","0","0","1","0","1","0","0","0","0","0","0","0","0","0","18","5","13","1","1","0","0","0","0","0","0","0","-2"
"236975","Wenatchee Valley College","2019","Not on tenure track/No tenure system system total","6","2","4","0","0","0","0","0","0","0","0","0","0","0","0","0","0","0","6","2","4","0","0","0","0","0","0","0","0","0","-2"
"236975","Wenatchee Valley College","2019","Not on tenure/no tenure system, no academic rank","6","2","4","0","0","0","0","0","0","0","0","0","0","0","0","0","0","0","6","2","4","0","0","0","0","0","0","0","0","0","-2"
"237109","Yakima Valley College","2019","Tenured total","70","31","39","0","0","0","2","1","1","0","0","0","6","1","5","0","0","0","62","29","33","0","0","0","0","0","0","0","0","0","-2"
"237109","Yakima Valley College","2019","Tenured, instructors","69","31","38","0","0","0","2","1","1","0","0","0","6","1","5","0","0","0","61","29","32","0","0","0","0","0","0","0","0","0","-2"
"237109","Yakima Valley College","2019","Tenured, no academic rank","1","0","1","0","0","0","0","0","0","0","0","0","0","0","0","0","0","0","1","0","1","0","0","0","0","0","0","0","0","0","-2"
"237109","Yakima Valley College","2019","On-Tenure track total","6","2","4","0","0","0","0","0","0","0","0","0","5","1","4","0","0","0","1","1","0","0","0","0","0","0","0","0","0","0","-2"
"237109","Yakima Valley College","2019","On-tenure track, instructors","6","2","4","0","0","0","0","0","0","0","0","0","5","1","4","0","0","0","1","1","0","0","0","0","0","0","0","0","0","0","-2"
"237109","Yakima Valley College","2019","Not on tenure track/No tenure system system total","61","30","31","2","2","0","1","0","1","0","0","0","9","6","3","0","0","0","49","22","27","0","0","0","0","0","0","0","0","0","-2"
"237109","Yakima Valley College","2019","Not on tenure/no tenure system, instructors","61","30","31","2","2","0","1","0","1","0","0","0","9","6","3","0","0","0","49","22","27","0","0","0","0","0","0","0","0","0","-2"
"238193","Alverno College","2019","Tenured total","42","12","30","0","0","0","1","0","1","1","0","1","0","0","0","0","0","0","39","11","28","0","0","0","1","1","0","0","0","0","-2"
"238193","Alverno College","2019","Tenured, professors","27","7","20","0","0","0","1","0","1","0","0","0","0","0","0","0","0","0","26","7","19","0","0","0","0","0","0","0","0","0","-2"
"238193","Alverno College","2019","Tenured, associate professors","13","4","9","0","0","0","0","0","0","1","0","1","0","0","0","0","0","0","11","3","8","0","0","0","1","1","0","0","0","0","-2"
"238193","Alverno College","2019","Tenured, assistant professors","2","1","1","0","0","0","0","0","0","0","0","0","0","0","0","0","0","0","2","1","1","0","0","0","0","0","0","0","0","0","-2"
"238193","Alverno College","2019","On-Tenure track total","39","7","32","0","0","0","0","0","0","2","0","2","3","1","2","0","0","0","33","6","27","1","0","1","0","0","0","0","0","0","-2"
"238193","Alverno College","2019","On-tenure track, professors","1","0","1","0","0","0","0","0","0","0","0","0","0","0","0","0","0","0","1","0","1","0","0","0","0","0","0","0","0","0","-2"
"238193","Alverno College","2019","On-tenure track, associate professors","8","1","7","0","0","0","0","0","0","0","0","0","0","0","0","0","0","0","8","1","7","0","0","0","0","0","0","0","0","0","-2"
"238193","Alverno College","2019","On-tenure track, assistant professors","30","6","24","0","0","0","0","0","0","2","0","2","3","1","2","0","0","0","24","5","19","1","0","1","0","0","0","0","0","0","-2"
"238193","Alverno College","2019","Not on tenure track/No tenure system system total","7","0","7","0","0","0","0","0","0","0","0","0","0","0","0","0","0","0","7","0","7","0","0","0","0","0","0","0","0","0","-2"
"238193","Alverno College","2019","Not on tenure/no tenure system, assistant professors","7","0","7","0","0","0","0","0","0","0","0","0","0","0","0","0","0","0","7","0","7","0","0","0","0","0","0","0","0","0","-2"
"239390","Mount Mary University","2019","Tenured total","28","3","25","0","0","0","0","0","0","0","0","0","0","0","0","0","0","0","28","3","25","0","0","0","0","0","0","0","0","0","-2"
"239390","Mount Mary University","2019","Tenured, professors","7","1","6","0","0","0","0","0","0","0","0","0","0","0","0","0","0","0","7","1","6","0","0","0","0","0","0","0","0","0","-2"
"239390","Mount Mary University","2019","Tenured, associate professors","18","2","16","0","0","0","0","0","0","0","0","0","0","0","0","0","0","0","18","2","16","0","0","0","0","0","0","0","0","0","-2"
"239390","Mount Mary University","2019","Tenured, assistant professors","3","0","3","0","0","0","0","0","0","0","0","0","0","0","0","0","0","0","3","0","3","0","0","0","0","0","0","0","0","0","-2"
"239390","Mount Mary University","2019","On-Tenure track total","19","3","16","1","1","0","0","0","0","3","0","3","0","0","0","0","0","0","15","2","13","0","0","0","0","0","0","0","0","0","-2"
"239390","Mount Mary University","2019","On-tenure track, professors","1","0","1","0","0","0","0","0","0","1","0","1","0","0","0","0","0","0","0","0","0","0","0","0","0","0","0","0","0","0","-2"
"239390","Mount Mary University","2019","On-tenure track, associate professors","2","0","2","0","0","0","0","0","0","0","0","0","0","0","0","0","0","0","2","0","2","0","0","0","0","0","0","0","0","0","-2"
"239390","Mount Mary University","2019","On-tenure track, assistant professors","16","3","13","1","1","0","0","0","0","2","0","2","0","0","0","0","0","0","13","2","11","0","0","0","0","0","0","0","0","0","-2"
"239390","Mount Mary University","2019","Not on tenure track/No tenure system system total","14","1","13","0","0","0","0","0","0","0","0","0","1","0","1","0","0","0","13","1","12","0","0","0","0","0","0","0","0","0","-2"
"239390","Mount Mary University","2019","Not on tenure/no tenure system, assistant professors","8","0","8","0","0","0","0","0","0","0","0","0","1","0","1","0","0","0","7","0","7","0","0","0","0","0","0","0","0","0","-2"
"239390","Mount Mary University","2019","Not on tenure/no tenure system, instructors","5","1","4","0","0","0","0","0","0","0","0","0","0","0","0","0","0","0","5","1","4","0","0","0","0","0","0","0","0","0","-2"
"239390","Mount Mary University","2019","Not on tenure/no tenure system, no academic rank","1","0","1","0","0","0","0","0","0","0","0","0","0","0","0","0","0","0","1","0","1","0","0","0","0","0","0","0","0","0","-2"
"241100","American University of Puerto Rico","2019","Tenured total","10","4","6","0","0","0","0","0","0","0","0","0","10","4","6","0","0","0","0","0","0","0","0","0","0","0","0","0","0","0","-2"
"241100","American University of Puerto Rico","2019","Tenured, professors","1","1","0","0","0","0","0","0","0","0","0","0","1","1","0","0","0","0","0","0","0","0","0","0","0","0","0","0","0","0","-2"
"241100","American University of Puerto Rico","2019","Tenured, associate professors","2","0","2","0","0","0","0","0","0","0","0","0","2","0","2","0","0","0","0","0","0","0","0","0","0","0","0","0","0","0","-2"
"241100","American University of Puerto Rico","2019","Tenured, assistant professors","6","3","3","0","0","0","0","0","0","0","0","0","6","3","3","0","0","0","0","0","0","0","0","0","0","0","0","0","0","0","-2"
"241100","American University of Puerto Rico","2019","Tenured, instructors","1","0","1","0","0","0","0","0","0","0","0","0","1","0","1","0","0","0","0","0","0","0","0","0","0","0","0","0","0","0","-2"
"241128","American University of Puerto Rico","2019","Tenured total","8","4","4","0","0","0","0","0","0","0","0","0","7","3","4","0","0","0","0","0","0","1","1","0","0","0","0","0","0","0","-2"
"241128","American University of Puerto Rico","2019","Tenured, associate professors","4","1","3","0","0","0","0","0","0","0","0","0","3","0","3","0","0","0","0","0","0","1","1","0","0","0","0","0","0","0","-2"
"241128","American University of Puerto Rico","2019","Tenured, assistant professors","1","0","1","0","0","0","0","0","0","0","0","0","1","0","1","0","0","0","0","0","0","0","0","0","0","0","0","0","0","0","-2"
"241128","American University of Puerto Rico","2019","Tenured, instructors","3","3","0","0","0","0","0","0","0","0","0","0","3","3","0","0","0","0","0","0","0","0","0","0","0","0","0","0","0","0","-2"
"241191","Universidad Adventista de las Antillas","2019","Tenured total","18","9","9","0","0","0","0","0","0","0","0","0","18","9","9","0","0","0","0","0","0","0","0","0","0","0","0","0","0","0","-2"
"241191","Universidad Adventista de las Antillas","2019","Tenured, professors","1","0","1","0","0","0","0","0","0","0","0","0","1","0","1","0","0","0","0","0","0","0","0","0","0","0","0","0","0","0","-2"
"241191","Universidad Adventista de las Antillas","2019","Tenured, associate professors","8","4","4","0","0","0","0","0","0","0","0","0","8","4","4","0","0","0","0","0","0","0","0","0","0","0","0","0","0","0","-2"
"241191","Universidad Adventista de las Antillas","2019","Tenured, assistant professors","9","5","4","0","0","0","0","0","0","0","0","0","9","5","4","0","0","0","0","0","0","0","0","0","0","0","0","0","0","0","-2"
"241191","Universidad Adventista de las Antillas","2019","On-Tenure track total","13","7","6","0","0","0","0","0","0","0","0","0","13","7","6","0","0","0","0","0","0","0","0","0","0","0","0","0","0","0","-2"
"241191","Universidad Adventista de las Antillas","2019","On-tenure track, assistant professors","10","5","5","0","0","0","0","0","0","0","0","0","10","5","5","0","0","0","0","0","0","0","0","0","0","0","0","0","0","0","-2"
"241191","Universidad Adventista de las Antillas","2019","On-tenure track, instructors","3","2","1","0","0","0","0","0","0","0","0","0","3","2","1","0","0","0","0","0","0","0","0","0","0","0","0","0","0","0","-2"
"241191","Universidad Adventista de las Antillas","2019","Not on tenure track/No tenure system system total","8","5","3","0","0","0","0","0","0","0","0","0","8","5","3","0","0","0","0","0","0","0","0","0","0","0","0","0","0","0","-2"
"241191","Universidad Adventista de las Antillas","2019","Not on tenure/no tenure system, no academic rank","8","5","3","0","0","0","0","0","0","0","0","0","8","5","3","0","0","0","0","0","0","0","0","0","0","0","0","0","0","0","-2"
"241216","Atlantic University College","2019","Not on tenure track/No tenure system system total","61","34","27","0","0","0","0","0","0","0","0","0","61","34","27","0","0","0","0","0","0","0","0","0","0","0","0","0","0","0","-2"
"241216","Atlantic University College","2019","Not on tenure/no tenure system, professors","61","34","27","0","0","0","0","0","0","0","0","0","61","34","27","0","0","0","0","0","0","0","0","0","0","0","0","0","0","0","-2"
"241225","Universidad Central de Bayamon","2019","Not on tenure track/No tenure system system total","24","6","18","0","0","0","0","0","0","0","0","0","23","6","17","0","0","0","0","0","0","0","0","0","0","0","0","1","0","1","-2"
"241225","Universidad Central de Bayamon","2019","Not on tenure/no tenure system, professors","1","1","0","0","0","0","0","0","0","0","0","0","1","1","0","0","0","0","0","0","0","0","0","0","0","0","0","0","0","0","-2"
"241225","Universidad Central de Bayamon","2019","Not on tenure/no tenure system, associate professors","13","3","10","0","0","0","0","0","0","0","0","0","12","3","9","0","0","0","0","0","0","0","0","0","0","0","0","1","0","1","-2"
"241225","Universidad Central de Bayamon","2019","Not on tenure/no tenure system, assistant professors","5","2","3","0","0","0","0","0","0","0","0","0","5","2","3","0","0","0","0","0","0","0","0","0","0","0","0","0","0","0","-2"
"241225","Universidad Central de Bayamon","2019","Not on tenure/no tenure system, instructors","5","0","5","0","0","0","0","0","0","0","0","0","5","0","5","0","0","0","0","0","0","0","0","0","0","0","0","0","0","0","-2"
"241377","Caribbean University-Bayamon","2019","Not on tenure track/No tenure system system total","30","16","14","0","0","0","0","0","0","0","0","0","30","16","14","0","0","0","0","0","0","0","0","0","0","0","0","0","0","0","-2"
"241377","Caribbean University-Bayamon","2019","Not on tenure/no tenure system, professors","1","1","0","0","0","0","0","0","0","0","0","0","1","1","0","0","0","0","0","0","0","0","0","0","0","0","0","0","0","0","-2"
"241377","Caribbean University-Bayamon","2019","Not on tenure/no tenure system, associate professors","1","0","1","0","0","0","0","0","0","0","0","0","1","0","1","0","0","0","0","0","0","0","0","0","0","0","0","0","0","0","-2"
"241377","Caribbean University-Bayamon","2019","Not on tenure/no tenure system, assistant professors","5","2","3","0","0","0","0","0","0","0","0","0","5","2","3","0","0","0","0","0","0","0","0","0","0","0","0","0","0","0","-2"
"241377","Caribbean University-Bayamon","2019","Not on tenure/no tenure system, instructors","23","13","10","0","0","0","0","0","0","0","0","0","23","13","10","0","0","0","0","0","0","0","0","0","0","0","0","0","0","0","-2"
"241386","Caribbean University-Carolina","2019","Not on tenure track/No tenure system system total","7","4","3","0","0","0","0","0","0","0","0","0","7","4","3","0","0","0","0","0","0","0","0","0","0","0","0","0","0","0","-2"
"241386","Caribbean University-Carolina","2019","Not on tenure/no tenure system, assistant professors","2","1","1","0","0","0","0","0","0","0","0","0","2","1","1","0","0","0","0","0","0","0","0","0","0","0","0","0","0","0","-2"
"241386","Caribbean University-Carolina","2019","Not on tenure/no tenure system, instructors","5","3","2","0","0","0","0","0","0","0","0","0","5","3","2","0","0","0","0","0","0","0","0","0","0","0","0","0","0","0","-2"
"241395","Pontifical Catholic University of Puerto Rico-Arecibo","2019","Not on tenure track/No tenure system system total","21","9","12","0","0","0","0","0","0","0","0","0","21","9","12","0","0","0","0","0","0","0","0","0","0","0","0","0","0","0","-2"
"241395","Pontifical Catholic University of Puerto Rico-Arecibo","2019","Not on tenure/no tenure system, professors","2","1","1","0","0","0","0","0","0","0","0","0","2","1","1","0","0","0","0","0","0","0","0","0","0","0","0","0","0","0","-2"
"241395","Pontifical Catholic University of Puerto Rico-Arecibo","2019","Not on tenure/no tenure system, associate professors","7","2","5","0","0","0","0","0","0","0","0","0","7","2","5","0","0","0","0","0","0","0","0","0","0","0","0","0","0","0","-2"
"241395","Pontifical Catholic University of Puerto Rico-Arecibo","2019","Not on tenure/no tenure system, assistant professors","2","2","0","0","0","0","0","0","0","0","0","0","2","2","0","0","0","0","0","0","0","0","0","0","0","0","0","0","0","0","-2"
"241395","Pontifical Catholic University of Puerto Rico-Arecibo","2019","Not on tenure/no tenure system, instructors","3","1","2","0","0","0","0","0","0","0","0","0","3","1","2","0","0","0","0","0","0","0","0","0","0","0","0","0","0","0","-2"
"241395","Pontifical Catholic University of Puerto Rico-Arecibo","2019","Not on tenure/no tenure system, no academic rank","7","3","4","0","0","0","0","0","0","0","0","0","7","3","4","0","0","0","0","0","0","0","0","0","0","0","0","0","0","0","-2"
"241410","Pontifical Catholic University of Puerto Rico-Ponce","2019","Not on tenure track/No tenure system system total","225","95","130","0","0","0","0","0","0","0","0","0","217","91","126","0","0","0","8","4","4","0","0","0","0","0","0","0","0","0","-2"
"241410","Pontifical Catholic University of Puerto Rico-Ponce","2019","Not on tenure/no tenure system, professors","42","23","19","0","0","0","0","0","0","0","0","0","40","21","19","0","0","0","2","2","0","0","0","0","0","0","0","0","0","0","-2"
"241410","Pontifical Catholic University of Puerto Rico-Ponce","2019","Not on tenure/no tenure system, associate professors","63","27","36","0","0","0","0","0","0","0","0","0","60","26","34","0","0","0","3","1","2","0","0","0","0","0","0","0","0","0","-2"
"241410","Pontifical Catholic University of Puerto Rico-Ponce","2019","Not on tenure/no tenure system, assistant professors","75","34","41","0","0","0","0","0","0","0","0","0","72","33","39","0","0","0","3","1","2","0","0","0","0","0","0","0","0","0","-2"
"241410","Pontifical Catholic University of Puerto Rico-Ponce","2019","Not on tenure/no tenure system, instructors","20","3","17","0","0","0","0","0","0","0","0","0","20","3","17","0","0","0","0","0","0","0","0","0","0","0","0","0","0","0","-2"
"241410","Pontifical Catholic University of Puerto Rico-Ponce","2019","Not on tenure/no tenure system, no academic rank","25","8","17","0","0","0","0","0","0","0","0","0","25","8","17","0","0","0","0","0","0","0","0","0","0","0","0","0","0","0","-2"
"241614","Universidad Teologica del Caribe","2019","Tenured total","2","0","2","0","0","0","0","0","0","0","0","0","2","0","2","0","0","0","0","0","0","0","0","0","0","0","0","0","0","0","-2"
"241614","Universidad Teologica del Caribe","2019","Tenured, professors","1","0","1","0","0","0","0","0","0","0","0","0","1","0","1","0","0","0","0","0","0","0","0","0","0","0","0","0","0","0","-2"
"241614","Universidad Teologica del Caribe","2019","Tenured, instructors","1","0","1","0","0","0","0","0","0","0","0","0","1","0","1","0","0","0","0","0","0","0","0","0","0","0","0","0","0","0","-2"
"241614","Universidad Teologica del Caribe","2019","Not on tenure track/No tenure system system total","16","11","5","0","0","0","0","0","0","0","0","0","16","11","5","0","0","0","0","0","0","0","0","0","0","0","0","0","0","0","-2"
"241614","Universidad Teologica del Caribe","2019","Not on tenure/no tenure system, instructors","16","11","5","0","0","0","0","0","0","0","0","0","16","11","5","0","0","0","0","0","0","0","0","0","0","0","0","0","0","0","-2"
"241720","Colegio Universitario de San Juan","2019","Tenured total","21","9","12","0","0","0","0","0","0","0","0","0","21","9","12","0","0","0","0","0","0","0","0","0","0","0","0","0","0","0","-2"
"241720","Colegio Universitario de San Juan","2019","Tenured, professors","1","1","0","0","0","0","0","0","0","0","0","0","1","1","0","0","0","0","0","0","0","0","0","0","0","0","0","0","0","0","-2"
"241720","Colegio Universitario de San Juan","2019","Tenured, associate professors","2","1","1","0","0","0","0","0","0","0","0","0","2","1","1","0","0","0","0","0","0","0","0","0","0","0","0","0","0","0","-2"
"241720","Colegio Universitario de San Juan","2019","Tenured, assistant professors","4","2","2","0","0","0","0","0","0","0","0","0","4","2","2","0","0","0","0","0","0","0","0","0","0","0","0","0","0","0","-2"
"241720","Colegio Universitario de San Juan","2019","Tenured, instructors","14","5","9","0","0","0","0","0","0","0","0","0","14","5","9","0","0","0","0","0","0","0","0","0","0","0","0","0","0","0","-2"
"241739","Universidad Ana G. Mendez-Cupey Campus","2019","Tenured total","9","1","8","0","0","0","0","0","0","0","0","0","9","1","8","0","0","0","0","0","0","0","0","0","0","0","0","0","0","0","-2"
"241739","Universidad Ana G. Mendez-Cupey Campus","2019","Tenured, professors","5","0","5","0","0","0","0","0","0","0","0","0","5","0","5","0","0","0","0","0","0","0","0","0","0","0","0","0","0","0","-2"
"241739","Universidad Ana G. Mendez-Cupey Campus","2019","Tenured, associate professors","4","1","3","0","0","0","0","0","0","0","0","0","4","1","3","0","0","0","0","0","0","0","0","0","0","0","0","0","0","0","-2"
"241739","Universidad Ana G. Mendez-Cupey Campus","2019","Not on tenure track/No tenure system system total","161","46","115","0","0","0","0","0","0","0","0","0","157","43","114","0","0","0","3","2","1","0","0","0","1","1","0","0","0","0","-2"
"241739","Universidad Ana G. Mendez-Cupey Campus","2019","Not on tenure/no tenure system, professors","13","6","7","0","0","0","0","0","0","0","0","0","12","5","7","0","0","0","1","1","0","0","0","0","0","0","0","0","0","0","-2"
"241739","Universidad Ana G. Mendez-Cupey Campus","2019","Not on tenure/no tenure system, associate professors","19","7","12","0","0","0","0","0","0","0","0","0","16","5","11","0","0","0","2","1","1","0","0","0","1","1","0","0","0","0","-2"
"241739","Universidad Ana G. Mendez-Cupey Campus","2019","Not on tenure/no tenure system, assistant professors","55","16","39","0","0","0","0","0","0","0","0","0","55","16","39","0","0","0","0","0","0","0","0","0","0","0","0","0","0","0","-2"
"241739","Universidad Ana G. Mendez-Cupey Campus","2019","Not on tenure/no tenure system, instructors","74","17","57","0","0","0","0","0","0","0","0","0","74","17","57","0","0","0","0","0","0","0","0","0","0","0","0","0","0","0","-2"
"241766","Conservatory of Music of Puerto Rico","2019","Tenured total","34","25","9","0","0","0","0","0","0","0","0","0","33","25","8","0","0","0","1","0","1","0","0","0","0","0","0","0","0","0","-2"
"241766","Conservatory of Music of Puerto Rico","2019","Tenured, professors","9","4","5","0","0","0","0","0","0","0","0","0","8","4","4","0","0","0","1","0","1","0","0","0","0","0","0","0","0","0","-2"
"241766","Conservatory of Music of Puerto Rico","2019","Tenured, associate professors","15","12","3","0","0","0","0","0","0","0","0","0","15","12","3","0","0","0","0","0","0","0","0","0","0","0","0","0","0","0","-2"
"241766","Conservatory of Music of Puerto Rico","2019","Tenured, assistant professors","7","7","0","0","0","0","0","0","0","0","0","0","7","7","0","0","0","0","0","0","0","0","0","0","0","0","0","0","0","0","-2"
"241766","Conservatory of Music of Puerto Rico","2019","Tenured, instructors","3","2","1","0","0","0","0","0","0","0","0","0","3","2","1","0","0","0","0","0","0","0","0","0","0","0","0","0","0","0","-2"
"241766","Conservatory of Music of Puerto Rico","2019","On-Tenure track total","2","2","0","0","0","0","0","0","0","0","0","0","1","1","0","0","0","0","1","1","0","0","0","0","0","0","0","0","0","0","-2"
"241766","Conservatory of Music of Puerto Rico","2019","On-tenure track, assistant professors","2","2","0","0","0","0","0","0","0","0","0","0","1","1","0","0","0","0","1","1","0","0","0","0","0","0","0","0","0","0","-2"
"241766","Conservatory of Music of Puerto Rico","2019","Not on tenure track/No tenure system system total","9","6","3","0","0","0","0","0","0","0","0","0","8","6","2","0","0","0","1","0","1","0","0","0","0","0","0","0","0","0","-2"
"241766","Conservatory of Music of Puerto Rico","2019","Not on tenure/no tenure system, no academic rank","9","6","3","0","0","0","0","0","0","0","0","0","8","6","2","0","0","0","1","0","1","0","0","0","0","0","0","0","0","0","-2"
"241836","EDP University of Puerto Rico Inc-San Sebastian","2019","Not on tenure track/No tenure system system total","30","8","22","0","0","0","0","0","0","0","0","0","30","8","22","0","0","0","0","0","0","0","0","0","0","0","0","0","0","0","-2"
"241836","EDP University of Puerto Rico Inc-San Sebastian","2019","Not on tenure/no tenure system, instructors","30","8","22","0","0","0","0","0","0","0","0","0","30","8","22","0","0","0","0","0","0","0","0","0","0","0","0","0","0","0","-2"
"241951","Escuela de Artes Plasticas y Diseno de Puerto Rico","2019","Tenured total","11","7","4","0","0","0","0","0","0","0","0","0","11","7","4","0","0","0","0","0","0","0","0","0","0","0","0","0","0","0","-2"
"241951","Escuela de Artes Plasticas y Diseno de Puerto Rico","2019","Tenured, professors","3","2","1","0","0","0","0","0","0","0","0","0","3","2","1","0","0","0","0","0","0","0","0","0","0","0","0","0","0","0","-2"
"241951","Escuela de Artes Plasticas y Diseno de Puerto Rico","2019","Tenured, associate professors","1","0","1","0","0","0","0","0","0","0","0","0","1","0","1","0","0","0","0","0","0","0","0","0","0","0","0","0","0","0","-2"
"241951","Escuela de Artes Plasticas y Diseno de Puerto Rico","2019","Tenured, instructors","7","5","2","0","0","0","0","0","0","0","0","0","7","5","2","0","0","0","0","0","0","0","0","0","0","0","0","0","0","0","-2"
"241951","Escuela de Artes Plasticas y Diseno de Puerto Rico","2019","Not on tenure track/No tenure system system total","13","7","6","0","0","0","0","0","0","0","0","0","13","7","6","0","0","0","0","0","0","0","0","0","0","0","0","0","0","0","-2"
"241951","Escuela de Artes Plasticas y Diseno de Puerto Rico","2019","Not on tenure/no tenure system, no academic rank","13","7","6","0","0","0","0","0","0","0","0","0","13","7","6","0","0","0","0","0","0","0","0","0","0","0","0","0","0","0","-2"
"242121","Humacao Community College","2019","Not on tenure track/No tenure system system total","27","10","17","0","0","0","0","0","0","0","0","0","27","10","17","0","0","0","0","0","0","0","0","0","0","0","0","0","0","0","-2"
"242121","Humacao Community College","2019","Not on tenure/no tenure system, professors","27","10","17","0","0","0","0","0","0","0","0","0","27","10","17","0","0","0","0","0","0","0","0","0","0","0","0","0","0","0","-2"
"242617","Inter American University of Puerto Rico-San German","2019","Tenured total","78","35","43","1","1","0","0","0","0","0","0","0","76","34","42","1","0","1","0","0","0","0","0","0","0","0","0","0","0","0","-2"
"242617","Inter American University of Puerto Rico-San German","2019","Tenured, professors","24","13","11","1","1","0","0","0","0","0","0","0","22","12","10","1","0","1","0","0","0","0","0","0","0","0","0","0","0","0","-2"
"242617","Inter American University of Puerto Rico-San German","2019","Tenured, associate professors","38","17","21","0","0","0","0","0","0","0","0","0","38","17","21","0","0","0","0","0","0","0","0","0","0","0","0","0","0","0","-2"
"242617","Inter American University of Puerto Rico-San German","2019","Tenured, assistant professors","16","5","11","0","0","0","0","0","0","0","0","0","16","5","11","0","0","0","0","0","0","0","0","0","0","0","0","0","0","0","-2"
"242617","Inter American University of Puerto Rico-San German","2019","On-Tenure track total","14","6","8","0","0","0","0","0","0","0","0","0","14","6","8","0","0","0","0","0","0","0","0","0","0","0","0","0","0","0","-2"
"242617","Inter American University of Puerto Rico-San German","2019","On-tenure track, associate professors","2","0","2","0","0","0","0","0","0","0","0","0","2","0","2","0","0","0","0","0","0","0","0","0","0","0","0","0","0","0","-2"
"242617","Inter American University of Puerto Rico-San German","2019","On-tenure track, assistant professors","12","6","6","0","0","0","0","0","0","0","0","0","12","6","6","0","0","0","0","0","0","0","0","0","0","0","0","0","0","0","-2"
"242617","Inter American University of Puerto Rico-San German","2019","Not on tenure track/No tenure system system total","4","1","3","0","0","0","0","0","0","0","0","0","4","1","3","0","0","0","0","0","0","0","0","0","0","0","0","0","0","0","-2"
"242617","Inter American University of Puerto Rico-San German","2019","Not on tenure/no tenure system, associate professors","1","1","0","0","0","0","0","0","0","0","0","0","1","1","0","0","0","0","0","0","0","0","0","0","0","0","0","0","0","0","-2"
"242617","Inter American University of Puerto Rico-San German","2019","Not on tenure/no tenure system, assistant professors","1","0","1","0","0","0","0","0","0","0","0","0","1","0","1","0","0","0","0","0","0","0","0","0","0","0","0","0","0","0","-2"
"242617","Inter American University of Puerto Rico-San German","2019","Not on tenure/no tenure system, instructors","2","0","2","0","0","0","0","0","0","0","0","0","2","0","2","0","0","0","0","0","0","0","0","0","0","0","0","0","0","0","-2"
"242626","Inter American University of Puerto Rico-Aguadilla","2019","Tenured total","52","22","30","0","0","0","0","0","0","1","0","1","51","22","29","0","0","0","0","0","0","0","0","0","0","0","0","0","0","0","-2"
"242626","Inter American University of Puerto Rico-Aguadilla","2019","Tenured, professors","10","1","9","0","0","0","0","0","0","1","0","1","9","1","8","0","0","0","0","0","0","0","0","0","0","0","0","0","0","0","-2"
"242626","Inter American University of Puerto Rico-Aguadilla","2019","Tenured, associate professors","20","7","13","0","0","0","0","0","0","0","0","0","20","7","13","0","0","0","0","0","0","0","0","0","0","0","0","0","0","0","-2"
"242626","Inter American University of Puerto Rico-Aguadilla","2019","Tenured, assistant professors","22","14","8","0","0","0","0","0","0","0","0","0","22","14","8","0","0","0","0","0","0","0","0","0","0","0","0","0","0","0","-2"
"242626","Inter American University of Puerto Rico-Aguadilla","2019","On-Tenure track total","15","6","9","0","0","0","0","0","0","0","0","0","15","6","9","0","0","0","0","0","0","0","0","0","0","0","0","0","0","0","-2"
"242626","Inter American University of Puerto Rico-Aguadilla","2019","On-tenure track, associate professors","2","0","2","0","0","0","0","0","0","0","0","0","2","0","2","0","0","0","0","0","0","0","0","0","0","0","0","0","0","0","-2"
"242626","Inter American University of Puerto Rico-Aguadilla","2019","On-tenure track, assistant professors","9","6","3","0","0","0","0","0","0","0","0","0","9","6","3","0","0","0","0","0","0","0","0","0","0","0","0","0","0","0","-2"
"242626","Inter American University of Puerto Rico-Aguadilla","2019","On-tenure track, instructors","4","0","4","0","0","0","0","0","0","0","0","0","4","0","4","0","0","0","0","0","0","0","0","0","0","0","0","0","0","0","-2"
"242626","Inter American University of Puerto Rico-Aguadilla","2019","Not on tenure track/No tenure system system total","12","3","9","0","0","0","0","0","0","0","0","0","12","3","9","0","0","0","0","0","0","0","0","0","0","0","0","0","0","0","-2"
"242626","Inter American University of Puerto Rico-Aguadilla","2019","Not on tenure/no tenure system, associate professors","1","0","1","0","0","0","0","0","0","0","0","0","1","0","1","0","0","0","0","0","0","0","0","0","0","0","0","0","0","0","-2"
"242626","Inter American University of Puerto Rico-Aguadilla","2019","Not on tenure/no tenure system, assistant professors","4","1","3","0","0","0","0","0","0","0","0","0","4","1","3","0","0","0","0","0","0","0","0","0","0","0","0","0","0","0","-2"
"242626","Inter American University of Puerto Rico-Aguadilla","2019","Not on tenure/no tenure system, instructors","7","2","5","0","0","0","0","0","0","0","0","0","7","2","5","0","0","0","0","0","0","0","0","0","0","0","0","0","0","0","-2"
"242635","Inter American University of Puerto Rico-Arecibo","2019","Tenured total","47","23","24","0","0","0","0","0","0","0","0","0","47","23","24","0","0","0","0","0","0","0","0","0","0","0","0","0","0","0","-2"
"242635","Inter American University of Puerto Rico-Arecibo","2019","Tenured, professors","20","10","10","0","0","0","0","0","0","0","0","0","20","10","10","0","0","0","0","0","0","0","0","0","0","0","0","0","0","0","-2"
"242635","Inter American University of Puerto Rico-Arecibo","2019","Tenured, associate professors","11","7","4","0","0","0","0","0","0","0","0","0","11","7","4","0","0","0","0","0","0","0","0","0","0","0","0","0","0","0","-2"
"242635","Inter American University of Puerto Rico-Arecibo","2019","Tenured, assistant professors","16","6","10","0","0","0","0","0","0","0","0","0","16","6","10","0","0","0","0","0","0","0","0","0","0","0","0","0","0","0","-2"
"242635","Inter American University of Puerto Rico-Arecibo","2019","On-Tenure track total","15","3","12","0","0","0","0","0","0","0","0","0","15","3","12","0","0","0","0","0","0","0","0","0","0","0","0","0","0","0","-2"
"242635","Inter American University of Puerto Rico-Arecibo","2019","On-tenure track, associate professors","2","0","2","0","0","0","0","0","0","0","0","0","2","0","2","0","0","0","0","0","0","0","0","0","0","0","0","0","0","0","-2"
"242635","Inter American University of Puerto Rico-Arecibo","2019","On-tenure track, assistant professors","7","2","5","0","0","0","0","0","0","0","0","0","7","2","5","0","0","0","0","0","0","0","0","0","0","0","0","0","0","0","-2"
"242635","Inter American University of Puerto Rico-Arecibo","2019","On-tenure track, instructors","6","1","5","0","0","0","0","0","0","0","0","0","6","1","5","0","0","0","0","0","0","0","0","0","0","0","0","0","0","0","-2"
"242635","Inter American University of Puerto Rico-Arecibo","2019","Not on tenure track/No tenure system system total","13","8","5","0","0","0","0","0","0","0","0","0","13","8","5","0","0","0","0","0","0","0","0","0","0","0","0","0","0","0","-2"
"242635","Inter American University of Puerto Rico-Arecibo","2019","Not on tenure/no tenure system, assistant professors","7","4","3","0","0","0","0","0","0","0","0","0","7","4","3","0","0","0","0","0","0","0","0","0","0","0","0","0","0","0","-2"
"242635","Inter American University of Puerto Rico-Arecibo","2019","Not on tenure/no tenure system, instructors","6","4","2","0","0","0","0","0","0","0","0","0","6","4","2","0","0","0","0","0","0","0","0","0","0","0","0","0","0","0","-2"
"242644","Inter American University of Puerto Rico-Barranquitas","2019","Tenured total","11","3","8","0","0","0","0","0","0","0","0","0","11","3","8","0","0","0","0","0","0","0","0","0","0","0","0","0","0","0","-2"
"242644","Inter American University of Puerto Rico-Barranquitas","2019","Tenured, professors","1","1","0","0","0","0","0","0","0","0","0","0","1","1","0","0","0","0","0","0","0","0","0","0","0","0","0","0","0","0","-2"
"242644","Inter American University of Puerto Rico-Barranquitas","2019","Tenured, associate professors","4","1","3","0","0","0","0","0","0","0","0","0","4","1","3","0","0","0","0","0","0","0","0","0","0","0","0","0","0","0","-2"
"242644","Inter American University of Puerto Rico-Barranquitas","2019","Tenured, assistant professors","6","1","5","0","0","0","0","0","0","0","0","0","6","1","5","0","0","0","0","0","0","0","0","0","0","0","0","0","0","0","-2"
"242644","Inter American University of Puerto Rico-Barranquitas","2019","On-Tenure track total","8","3","5","0","0","0","0","0","0","0","0","0","8","3","5","0","0","0","0","0","0","0","0","0","0","0","0","0","0","0","-2"
"242644","Inter American University of Puerto Rico-Barranquitas","2019","On-tenure track, associate professors","2","1","1","0","0","0","0","0","0","0","0","0","2","1","1","0","0","0","0","0","0","0","0","0","0","0","0","0","0","0","-2"
"242644","Inter American University of Puerto Rico-Barranquitas","2019","On-tenure track, assistant professors","3","1","2","0","0","0","0","0","0","0","0","0","3","1","2","0","0","0","0","0","0","0","0","0","0","0","0","0","0","0","-2"
"242644","Inter American University of Puerto Rico-Barranquitas","2019","On-tenure track, instructors","3","1","2","0","0","0","0","0","0","0","0","0","3","1","2","0","0","0","0","0","0","0","0","0","0","0","0","0","0","0","-2"
"242644","Inter American University of Puerto Rico-Barranquitas","2019","Not on tenure track/No tenure system system total","11","5","6","0","0","0","2","1","1","0","0","0","9","4","5","0","0","0","0","0","0","0","0","0","0","0","0","0","0","0","-2"
"242644","Inter American University of Puerto Rico-Barranquitas","2019","Not on tenure/no tenure system, assistant professors","6","3","3","0","0","0","2","1","1","0","0","0","4","2","2","0","0","0","0","0","0","0","0","0","0","0","0","0","0","0","-2"
"242644","Inter American University of Puerto Rico-Barranquitas","2019","Not on tenure/no tenure system, instructors","5","2","3","0","0","0","0","0","0","0","0","0","5","2","3","0","0","0","0","0","0","0","0","0","0","0","0","0","0","0","-2"
"242653","Inter American University of Puerto Rico-Metro","2019","Tenured total","126","63","63","0","0","0","0","0","0","0","0","0","123","61","62","0","0","0","3","2","1","0","0","0","0","0","0","0","0","0","-2"
"242653","Inter American University of Puerto Rico-Metro","2019","Tenured, professors","52","27","25","0","0","0","0","0","0","0","0","0","49","25","24","0","0","0","3","2","1","0","0","0","0","0","0","0","0","0","-2"
"242653","Inter American University of Puerto Rico-Metro","2019","Tenured, associate professors","57","27","30","0","0","0","0","0","0","0","0","0","57","27","30","0","0","0","0","0","0","0","0","0","0","0","0","0","0","0","-2"
"242653","Inter American University of Puerto Rico-Metro","2019","Tenured, assistant professors","17","9","8","0","0","0","0","0","0","0","0","0","17","9","8","0","0","0","0","0","0","0","0","0","0","0","0","0","0","0","-2"
"242653","Inter American University of Puerto Rico-Metro","2019","On-Tenure track total","22","7","15","0","0","0","0","0","0","0","0","0","20","6","14","0","0","0","2","1","1","0","0","0","0","0","0","0","0","0","-2"
"242653","Inter American University of Puerto Rico-Metro","2019","On-tenure track, professors","1","0","1","0","0","0","0","0","0","0","0","0","1","0","1","0","0","0","0","0","0","0","0","0","0","0","0","0","0","0","-2"
"242653","Inter American University of Puerto Rico-Metro","2019","On-tenure track, associate professors","5","2","3","0","0","0","0","0","0","0","0","0","5","2","3","0","0","0","0","0","0","0","0","0","0","0","0","0","0","0","-2"
"242653","Inter American University of Puerto Rico-Metro","2019","On-tenure track, assistant professors","15","5","10","0","0","0","0","0","0","0","0","0","13","4","9","0","0","0","2","1","1","0","0","0","0","0","0","0","0","0","-2"
"242653","Inter American University of Puerto Rico-Metro","2019","On-tenure track, instructors","1","0","1","0","0","0","0","0","0","0","0","0","1","0","1","0","0","0","0","0","0","0","0","0","0","0","0","0","0","0","-2"
"242653","Inter American University of Puerto Rico-Metro","2019","Not on tenure track/No tenure system system total","36","16","20","0","0","0","0","0","0","1","0","1","35","16","19","0","0","0","0","0","0","0","0","0","0","0","0","0","0","0","-2"
"242653","Inter American University of Puerto Rico-Metro","2019","Not on tenure/no tenure system, professors","1","1","0","0","0","0","0","0","0","0","0","0","1","1","0","0","0","0","0","0","0","0","0","0","0","0","0","0","0","0","-2"
"242653","Inter American University of Puerto Rico-Metro","2019","Not on tenure/no tenure system, associate professors","1","1","0","0","0","0","0","0","0","0","0","0","1","1","0","0","0","0","0","0","0","0","0","0","0","0","0","0","0","0","-2"
"242653","Inter American University of Puerto Rico-Metro","2019","Not on tenure/no tenure system, assistant professors","21","10","11","0","0","0","0","0","0","0","0","0","21","10","11","0","0","0","0","0","0","0","0","0","0","0","0","0","0","0","-2"
"242653","Inter American University of Puerto Rico-Metro","2019","Not on tenure/no tenure system, instructors","13","4","9","0","0","0","0","0","0","1","0","1","12","4","8","0","0","0","0","0","0","0","0","0","0","0","0","0","0","0","-2"
"242662","Inter American University of Puerto Rico-Ponce","2019","Tenured total","57","26","31","0","0","0","0","0","0","0","0","0","57","26","31","0","0","0","0","0","0","0","0","0","0","0","0","0","0","0","-2"
"242662","Inter American University of Puerto Rico-Ponce","2019","Tenured, professors","14","6","8","0","0","0","0","0","0","0","0","0","14","6","8","0","0","0","0","0","0","0","0","0","0","0","0","0","0","0","-2"
"242662","Inter American University of Puerto Rico-Ponce","2019","Tenured, associate professors","26","14","12","0","0","0","0","0","0","0","0","0","26","14","12","0","0","0","0","0","0","0","0","0","0","0","0","0","0","0","-2"
"242662","Inter American University of Puerto Rico-Ponce","2019","Tenured, assistant professors","17","6","11","0","0","0","0","0","0","0","0","0","17","6","11","0","0","0","0","0","0","0","0","0","0","0","0","0","0","0","-2"
"242662","Inter American University of Puerto Rico-Ponce","2019","On-Tenure track total","32","12","20","0","0","0","0","0","0","0","0","0","30","11","19","1","0","1","1","1","0","0","0","0","0","0","0","0","0","0","-2"
"242662","Inter American University of Puerto Rico-Ponce","2019","On-tenure track, professors","1","1","0","0","0","0","0","0","0","0","0","0","1","1","0","0","0","0","0","0","0","0","0","0","0","0","0","0","0","0","-2"
"242662","Inter American University of Puerto Rico-Ponce","2019","On-tenure track, associate professors","9","7","2","0","0","0","0","0","0","0","0","0","8","6","2","0","0","0","1","1","0","0","0","0","0","0","0","0","0","0","-2"
"242662","Inter American University of Puerto Rico-Ponce","2019","On-tenure track, assistant professors","15","2","13","0","0","0","0","0","0","0","0","0","14","2","12","1","0","1","0","0","0","0","0","0","0","0","0","0","0","0","-2"
"242662","Inter American University of Puerto Rico-Ponce","2019","On-tenure track, instructors","7","2","5","0","0","0","0","0","0","0","0","0","7","2","5","0","0","0","0","0","0","0","0","0","0","0","0","0","0","0","-2"
"242662","Inter American University of Puerto Rico-Ponce","2019","Not on tenure track/No tenure system system total","11","2","9","0","0","0","0","0","0","0","0","0","11","2","9","0","0","0","0","0","0","0","0","0","0","0","0","0","0","0","-2"
"242662","Inter American University of Puerto Rico-Ponce","2019","Not on tenure/no tenure system, assistant professors","5","0","5","0","0","0","0","0","0","0","0","0","5","0","5","0","0","0","0","0","0","0","0","0","0","0","0","0","0","0","-2"
"242662","Inter American University of Puerto Rico-Ponce","2019","Not on tenure/no tenure system, instructors","6","2","4","0","0","0","0","0","0","0","0","0","6","2","4","0","0","0","0","0","0","0","0","0","0","0","0","0","0","0","-2"
"242680","Inter American University of Puerto Rico-Fajardo","2019","Tenured total","32","16","16","0","0","0","0","0","0","0","0","0","32","16","16","0","0","0","0","0","0","0","0","0","0","0","0","0","0","0","-2"
"242680","Inter American University of Puerto Rico-Fajardo","2019","Tenured, professors","4","3","1","0","0","0","0","0","0","0","0","0","4","3","1","0","0","0","0","0","0","0","0","0","0","0","0","0","0","0","-2"
"242680","Inter American University of Puerto Rico-Fajardo","2019","Tenured, associate professors","11","6","5","0","0","0","0","0","0","0","0","0","11","6","5","0","0","0","0","0","0","0","0","0","0","0","0","0","0","0","-2"
"242680","Inter American University of Puerto Rico-Fajardo","2019","Tenured, assistant professors","17","7","10","0","0","0","0","0","0","0","0","0","17","7","10","0","0","0","0","0","0","0","0","0","0","0","0","0","0","0","-2"
"242680","Inter American University of Puerto Rico-Fajardo","2019","On-Tenure track total","7","0","7","0","0","0","0","0","0","0","0","0","7","0","7","0","0","0","0","0","0","0","0","0","0","0","0","0","0","0","-2"
"242680","Inter American University of Puerto Rico-Fajardo","2019","On-tenure track, associate professors","1","0","1","0","0","0","0","0","0","0","0","0","1","0","1","0","0","0","0","0","0","0","0","0","0","0","0","0","0","0","-2"
"242680","Inter American University of Puerto Rico-Fajardo","2019","On-tenure track, assistant professors","5","0","5","0","0","0","0","0","0","0","0","0","5","0","5","0","0","0","0","0","0","0","0","0","0","0","0","0","0","0","-2"
"242680","Inter American University of Puerto Rico-Fajardo","2019","On-tenure track, instructors","1","0","1","0","0","0","0","0","0","0","0","0","1","0","1","0","0","0","0","0","0","0","0","0","0","0","0","0","0","0","-2"
"242680","Inter American University of Puerto Rico-Fajardo","2019","Not on tenure track/No tenure system system total","2","1","1","0","0","0","0","0","0","0","0","0","2","1","1","0","0","0","0","0","0","0","0","0","0","0","0","0","0","0","-2"
"242680","Inter American University of Puerto Rico-Fajardo","2019","Not on tenure/no tenure system, assistant professors","2","1","1","0","0","0","0","0","0","0","0","0","2","1","1","0","0","0","0","0","0","0","0","0","0","0","0","0","0","0","-2"
"242699","Inter American University of Puerto Rico-Guayama","2019","Tenured total","19","6","13","0","0","0","0","0","0","0","0","0","19","6","13","0","0","0","0","0","0","0","0","0","0","0","0","0","0","0","-2"
"242699","Inter American University of Puerto Rico-Guayama","2019","Tenured, professors","1","1","0","0","0","0","0","0","0","0","0","0","1","1","0","0","0","0","0","0","0","0","0","0","0","0","0","0","0","0","-2"
"242699","Inter American University of Puerto Rico-Guayama","2019","Tenured, associate professors","6","1","5","0","0","0","0","0","0","0","0","0","6","1","5","0","0","0","0","0","0","0","0","0","0","0","0","0","0","0","-2"
"242699","Inter American University of Puerto Rico-Guayama","2019","Tenured, assistant professors","12","4","8","0","0","0","0","0","0","0","0","0","12","4","8","0","0","0","0","0","0","0","0","0","0","0","0","0","0","0","-2"
"242699","Inter American University of Puerto Rico-Guayama","2019","On-Tenure track total","7","4","3","0","0","0","0","0","0","0","0","0","7","4","3","0","0","0","0","0","0","0","0","0","0","0","0","0","0","0","-2"
"242699","Inter American University of Puerto Rico-Guayama","2019","On-tenure track, assistant professors","5","4","1","0","0","0","0","0","0","0","0","0","5","4","1","0","0","0","0","0","0","0","0","0","0","0","0","0","0","0","-2"
"242699","Inter American University of Puerto Rico-Guayama","2019","On-tenure track, instructors","2","0","2","0","0","0","0","0","0","0","0","0","2","0","2","0","0","0","0","0","0","0","0","0","0","0","0","0","0","0","-2"
"242699","Inter American University of Puerto Rico-Guayama","2019","Not on tenure track/No tenure system system total","4","0","4","0","0","0","0","0","0","0","0","0","4","0","4","0","0","0","0","0","0","0","0","0","0","0","0","0","0","0","-2"
"242699","Inter American University of Puerto Rico-Guayama","2019","Not on tenure/no tenure system, assistant professors","1","0","1","0","0","0","0","0","0","0","0","0","1","0","1","0","0","0","0","0","0","0","0","0","0","0","0","0","0","0","-2"
"242699","Inter American University of Puerto Rico-Guayama","2019","Not on tenure/no tenure system, instructors","3","0","3","0","0","0","0","0","0","0","0","0","3","0","3","0","0","0","0","0","0","0","0","0","0","0","0","0","0","0","-2"
"242705","Inter American University of Puerto Rico-Bayamon","2019","Tenured total","53","33","20","1","1","0","0","0","0","0","0","0","52","32","20","0","0","0","0","0","0","0","0","0","0","0","0","0","0","0","-2"
"242705","Inter American University of Puerto Rico-Bayamon","2019","Tenured, professors","13","11","2","1","1","0","0","0","0","0","0","0","12","10","2","0","0","0","0","0","0","0","0","0","0","0","0","0","0","0","-2"
"242705","Inter American University of Puerto Rico-Bayamon","2019","Tenured, associate professors","19","11","8","0","0","0","0","0","0","0","0","0","19","11","8","0","0","0","0","0","0","0","0","0","0","0","0","0","0","0","-2"
"242705","Inter American University of Puerto Rico-Bayamon","2019","Tenured, assistant professors","21","11","10","0","0","0","0","0","0","0","0","0","21","11","10","0","0","0","0","0","0","0","0","0","0","0","0","0","0","0","-2"
"242705","Inter American University of Puerto Rico-Bayamon","2019","On-Tenure track total","26","15","11","1","1","0","0","0","0","0","0","0","25","14","11","0","0","0","0","0","0","0","0","0","0","0","0","0","0","0","-2"
"242705","Inter American University of Puerto Rico-Bayamon","2019","On-tenure track, professors","1","1","0","0","0","0","0","0","0","0","0","0","1","1","0","0","0","0","0","0","0","0","0","0","0","0","0","0","0","0","-2"
"242705","Inter American University of Puerto Rico-Bayamon","2019","On-tenure track, associate professors","7","3","4","0","0","0","0","0","0","0","0","0","7","3","4","0","0","0","0","0","0","0","0","0","0","0","0","0","0","0","-2"
"242705","Inter American University of Puerto Rico-Bayamon","2019","On-tenure track, assistant professors","12","7","5","1","1","0","0","0","0","0","0","0","11","6","5","0","0","0","0","0","0","0","0","0","0","0","0","0","0","0","-2"
"242705","Inter American University of Puerto Rico-Bayamon","2019","On-tenure track, instructors","6","4","2","0","0","0","0","0","0","0","0","0","6","4","2","0","0","0","0","0","0","0","0","0","0","0","0","0","0","0","-2"
"242705","Inter American University of Puerto Rico-Bayamon","2019","Not on tenure track/No tenure system system total","11","5","6","0","0","0","0","0","0","0","0","0","11","5","6","0","0","0","0","0","0","0","0","0","0","0","0","0","0","0","-2"
"242705","Inter American University of Puerto Rico-Bayamon","2019","Not on tenure/no tenure system, assistant professors","3","2","1","0","0","0","0","0","0","0","0","0","3","2","1","0","0","0","0","0","0","0","0","0","0","0","0","0","0","0","-2"
"242705","Inter American University of Puerto Rico-Bayamon","2019","Not on tenure/no tenure system, instructors","8","3","5","0","0","0","0","0","0","0","0","0","8","3","5","0","0","0","0","0","0","0","0","0","0","0","0","0","0","0","-2"
"243106","University of Puerto Rico-Aguadilla","2019","Tenured total","74","37","37","0","0","0","0","0","0","0","0","0","72","36","36","0","0","0","2","1","1","0","0","0","0","0","0","0","0","0","-2"
"243106","University of Puerto Rico-Aguadilla","2019","Tenured, professors","43","22","21","0","0","0","0","0","0","0","0","0","42","22","20","0","0","0","1","0","1","0","0","0","0","0","0","0","0","0","-2"
"243106","University of Puerto Rico-Aguadilla","2019","Tenured, associate professors","21","11","10","0","0","0","0","0","0","0","0","0","21","11","10","0","0","0","0","0","0","0","0","0","0","0","0","0","0","0","-2"
"243106","University of Puerto Rico-Aguadilla","2019","Tenured, assistant professors","8","2","6","0","0","0","0","0","0","0","0","0","7","1","6","0","0","0","1","1","0","0","0","0","0","0","0","0","0","0","-2"
"243106","University of Puerto Rico-Aguadilla","2019","Tenured, instructors","2","2","0","0","0","0","0","0","0","0","0","0","2","2","0","0","0","0","0","0","0","0","0","0","0","0","0","0","0","0","-2"
"243106","University of Puerto Rico-Aguadilla","2019","On-Tenure track total","1","1","0","0","0","0","0","0","0","0","0","0","1","1","0","0","0","0","0","0","0","0","0","0","0","0","0","0","0","0","-2"
"243106","University of Puerto Rico-Aguadilla","2019","On-tenure track, associate professors","1","1","0","0","0","0","0","0","0","0","0","0","1","1","0","0","0","0","0","0","0","0","0","0","0","0","0","0","0","0","-2"
"243106","University of Puerto Rico-Aguadilla","2019","Not on tenure track/No tenure system system total","19","8","11","0","0","0","0","0","0","0","0","0","17","8","9","0","0","0","0","0","0","0","0","0","2","0","2","0","0","0","-2"
"243106","University of Puerto Rico-Aguadilla","2019","Not on tenure/no tenure system, assistant professors","10","4","6","0","0","0","0","0","0","0","0","0","9","4","5","0","0","0","0","0","0","0","0","0","1","0","1","0","0","0","-2"
"243106","University of Puerto Rico-Aguadilla","2019","Not on tenure/no tenure system, instructors","9","4","5","0","0","0","0","0","0","0","0","0","8","4","4","0","0","0","0","0","0","0","0","0","1","0","1","0","0","0","-2"
"243115","University of Puerto Rico-Arecibo","2019","Tenured total","127","62","65","0","0","0","0","0","0","0","0","0","127","62","65","0","0","0","0","0","0","0","0","0","0","0","0","0","0","0","-2"
"243115","University of Puerto Rico-Arecibo","2019","Tenured, professors","72","34","38","0","0","0","0","0","0","0","0","0","72","34","38","0","0","0","0","0","0","0","0","0","0","0","0","0","0","0","-2"
"243115","University of Puerto Rico-Arecibo","2019","Tenured, associate professors","34","13","21","0","0","0","0","0","0","0","0","0","34","13","21","0","0","0","0","0","0","0","0","0","0","0","0","0","0","0","-2"
"243115","University of Puerto Rico-Arecibo","2019","Tenured, assistant professors","18","12","6","0","0","0","0","0","0","0","0","0","18","12","6","0","0","0","0","0","0","0","0","0","0","0","0","0","0","0","-2"
"243115","University of Puerto Rico-Arecibo","2019","Tenured, instructors","3","3","0","0","0","0","0","0","0","0","0","0","3","3","0","0","0","0","0","0","0","0","0","0","0","0","0","0","0","0","-2"
"243115","University of Puerto Rico-Arecibo","2019","On-Tenure track total","6","3","3","0","0","0","0","0","0","0","0","0","6","3","3","0","0","0","0","0","0","0","0","0","0","0","0","0","0","0","-2"
"243115","University of Puerto Rico-Arecibo","2019","On-tenure track, associate professors","2","1","1","0","0","0","0","0","0","0","0","0","2","1","1","0","0","0","0","0","0","0","0","0","0","0","0","0","0","0","-2"
"243115","University of Puerto Rico-Arecibo","2019","On-tenure track, assistant professors","3","2","1","0","0","0","0","0","0","0","0","0","3","2","1","0","0","0","0","0","0","0","0","0","0","0","0","0","0","0","-2"
"243115","University of Puerto Rico-Arecibo","2019","On-tenure track, instructors","1","0","1","0","0","0","0","0","0","0","0","0","1","0","1","0","0","0","0","0","0","0","0","0","0","0","0","0","0","0","-2"
"243115","University of Puerto Rico-Arecibo","2019","Not on tenure track/No tenure system system total","37","15","22","0","0","0","0","0","0","0","0","0","35","15","20","0","0","0","0","0","0","0","0","0","2","0","2","0","0","0","-2"
"243115","University of Puerto Rico-Arecibo","2019","Not on tenure/no tenure system, professors","14","8","6","0","0","0","0","0","0","0","0","0","14","8","6","0","0","0","0","0","0","0","0","0","0","0","0","0","0","0","-2"
"243115","University of Puerto Rico-Arecibo","2019","Not on tenure/no tenure system, associate professors","4","2","2","0","0","0","0","0","0","0","0","0","4","2","2","0","0","0","0","0","0","0","0","0","0","0","0","0","0","0","-2"
"243115","University of Puerto Rico-Arecibo","2019","Not on tenure/no tenure system, assistant professors","2","0","2","0","0","0","0","0","0","0","0","0","2","0","2","0","0","0","0","0","0","0","0","0","0","0","0","0","0","0","-2"
"243115","University of Puerto Rico-Arecibo","2019","Not on tenure/no tenure system, instructors","17","5","12","0","0","0","0","0","0","0","0","0","15","5","10","0","0","0","0","0","0","0","0","0","2","0","2","0","0","0","-2"
"243133","University of Puerto Rico-Bayamon","2019","Tenured total","97","47","50","0","0","0","0","0","0","0","0","0","97","47","50","0","0","0","0","0","0","0","0","0","0","0","0","0","0","0","-2"
"243133","University of Puerto Rico-Bayamon","2019","Tenured, professors","41","23","18","0","0","0","0","0","0","0","0","0","41","23","18","0","0","0","0","0","0","0","0","0","0","0","0","0","0","0","-2"
"243133","University of Puerto Rico-Bayamon","2019","Tenured, associate professors","30","13","17","0","0","0","0","0","0","0","0","0","30","13","17","0","0","0","0","0","0","0","0","0","0","0","0","0","0","0","-2"
"243133","University of Puerto Rico-Bayamon","2019","Tenured, assistant professors","21","9","12","0","0","0","0","0","0","0","0","0","21","9","12","0","0","0","0","0","0","0","0","0","0","0","0","0","0","0","-2"
"243133","University of Puerto Rico-Bayamon","2019","Tenured, no academic rank","5","2","3","0","0","0","0","0","0","0","0","0","5","2","3","0","0","0","0","0","0","0","0","0","0","0","0","0","0","0","-2"
"243133","University of Puerto Rico-Bayamon","2019","On-Tenure track total","7","2","5","0","0","0","0","0","0","0","0","0","7","2","5","0","0","0","0","0","0","0","0","0","0","0","0","0","0","0","-2"
"243133","University of Puerto Rico-Bayamon","2019","On-tenure track, associate professors","2","0","2","0","0","0","0","0","0","0","0","0","2","0","2","0","0","0","0","0","0","0","0","0","0","0","0","0","0","0","-2"
"243133","University of Puerto Rico-Bayamon","2019","On-tenure track, assistant professors","4","2","2","0","0","0","0","0","0","0","0","0","4","2","2","0","0","0","0","0","0","0","0","0","0","0","0","0","0","0","-2"
"243133","University of Puerto Rico-Bayamon","2019","On-tenure track, no academic rank","1","0","1","0","0","0","0","0","0","0","0","0","1","0","1","0","0","0","0","0","0","0","0","0","0","0","0","0","0","0","-2"
"243133","University of Puerto Rico-Bayamon","2019","Not on tenure track/No tenure system system total","44","24","20","0","0","0","0","0","0","0","0","0","44","24","20","0","0","0","0","0","0","0","0","0","0","0","0","0","0","0","-2"
"243133","University of Puerto Rico-Bayamon","2019","Not on tenure/no tenure system, assistant professors","20","8","12","0","0","0","0","0","0","0","0","0","20","8","12","0","0","0","0","0","0","0","0","0","0","0","0","0","0","0","-2"
"243133","University of Puerto Rico-Bayamon","2019","Not on tenure/no tenure system, instructors","20","14","6","0","0","0","0","0","0","0","0","0","20","14","6","0","0","0","0","0","0","0","0","0","0","0","0","0","0","0","-2"
"243133","University of Puerto Rico-Bayamon","2019","Not on tenure/no tenure system, no academic rank","4","2","2","0","0","0","0","0","0","0","0","0","4","2","2","0","0","0","0","0","0","0","0","0","0","0","0","0","0","0","-2"
"243142","University of Puerto Rico-Carolina","2019","Tenured total","60","32","28","0","0","0","0","0","0","1","1","0","59","31","28","0","0","0","0","0","0","0","0","0","0","0","0","0","0","0","-2"
"243142","University of Puerto Rico-Carolina","2019","Tenured, professors","26","15","11","0","0","0","0","0","0","1","1","0","25","14","11","0","0","0","0","0","0","0","0","0","0","0","0","0","0","0","-2"
"243142","University of Puerto Rico-Carolina","2019","Tenured, associate professors","21","10","11","0","0","0","0","0","0","0","0","0","21","10","11","0","0","0","0","0","0","0","0","0","0","0","0","0","0","0","-2"
"243142","University of Puerto Rico-Carolina","2019","Tenured, assistant professors","11","5","6","0","0","0","0","0","0","0","0","0","11","5","6","0","0","0","0","0","0","0","0","0","0","0","0","0","0","0","-2"
"243142","University of Puerto Rico-Carolina","2019","Tenured, instructors","2","2","0","0","0","0","0","0","0","0","0","0","2","2","0","0","0","0","0","0","0","0","0","0","0","0","0","0","0","0","-2"
"243142","University of Puerto Rico-Carolina","2019","On-Tenure track total","9","5","4","0","0","0","0","0","0","0","0","0","9","5","4","0","0","0","0","0","0","0","0","0","0","0","0","0","0","0","-2"
"243142","University of Puerto Rico-Carolina","2019","On-tenure track, assistant professors","5","3","2","0","0","0","0","0","0","0","0","0","5","3","2","0","0","0","0","0","0","0","0","0","0","0","0","0","0","0","-2"
"243142","University of Puerto Rico-Carolina","2019","On-tenure track, instructors","4","2","2","0","0","0","0","0","0","0","0","0","4","2","2","0","0","0","0","0","0","0","0","0","0","0","0","0","0","0","-2"
"243142","University of Puerto Rico-Carolina","2019","Not on tenure track/No tenure system system total","20","9","11","0","0","0","0","0","0","0","0","0","20","9","11","0","0","0","0","0","0","0","0","0","0","0","0","0","0","0","-2"
"243142","University of Puerto Rico-Carolina","2019","Not on tenure/no tenure system, assistant professors","4","1","3","0","0","0","0","0","0","0","0","0","4","1","3","0","0","0","0","0","0","0","0","0","0","0","0","0","0","0","-2"
"243142","University of Puerto Rico-Carolina","2019","Not on tenure/no tenure system, instructors","16","8","8","0","0","0","0","0","0","0","0","0","16","8","8","0","0","0","0","0","0","0","0","0","0","0","0","0","0","0","-2"
"243151","University of Puerto Rico-Cayey","2019","Tenured total","68","39","29","0","0","0","1","0","1","0","0","0","66","38","28","0","0","0","1","1","0","0","0","0","0","0","0","0","0","0","-2"
"243151","University of Puerto Rico-Cayey","2019","Tenured, professors","34","18","16","0","0","0","1","0","1","0","0","0","32","17","15","0","0","0","1","1","0","0","0","0","0","0","0","0","0","0","-2"
"243151","University of Puerto Rico-Cayey","2019","Tenured, associate professors","8","5","3","0","0","0","0","0","0","0","0","0","8","5","3","0","0","0","0","0","0","0","0","0","0","0","0","0","0","0","-2"
"243151","University of Puerto Rico-Cayey","2019","Tenured, assistant professors","26","16","10","0","0","0","0","0","0","0","0","0","26","16","10","0","0","0","0","0","0","0","0","0","0","0","0","0","0","0","-2"
"243151","University of Puerto Rico-Cayey","2019","On-Tenure track total","14","7","7","0","0","0","0","0","0","0","0","0","13","7","6","0","0","0","1","0","1","0","0","0","0","0","0","0","0","0","-2"
"243151","University of Puerto Rico-Cayey","2019","On-tenure track, associate professors","7","3","4","0","0","0","0","0","0","0","0","0","6","3","3","0","0","0","1","0","1","0","0","0","0","0","0","0","0","0","-2"
"243151","University of Puerto Rico-Cayey","2019","On-tenure track, assistant professors","7","4","3","0","0","0","0","0","0","0","0","0","7","4","3","0","0","0","0","0","0","0","0","0","0","0","0","0","0","0","-2"
"243151","University of Puerto Rico-Cayey","2019","Not on tenure track/No tenure system system total","43","17","26","0","0","0","0","0","0","0","0","0","42","17","25","0","0","0","1","0","1","0","0","0","0","0","0","0","0","0","-2"
"243151","University of Puerto Rico-Cayey","2019","Not on tenure/no tenure system, professors","1","0","1","0","0","0","0","0","0","0","0","0","1","0","1","0","0","0","0","0","0","0","0","0","0","0","0","0","0","0","-2"
"243151","University of Puerto Rico-Cayey","2019","Not on tenure/no tenure system, associate professors","34","13","21","0","0","0","0","0","0","0","0","0","33","13","20","0","0","0","1","0","1","0","0","0","0","0","0","0","0","0","-2"
"243151","University of Puerto Rico-Cayey","2019","Not on tenure/no tenure system, instructors","8","4","4","0","0","0","0","0","0","0","0","0","8","4","4","0","0","0","0","0","0","0","0","0","0","0","0","0","0","0","-2"
"243179","University of Puerto Rico-Humacao","2019","Tenured total","121","61","60","1","1","0","0","0","0","0","0","0","114","58","56","0","0","0","6","2","4","0","0","0","0","0","0","0","0","0","-2"
"243179","University of Puerto Rico-Humacao","2019","Tenured, professors","78","40","38","1","1","0","0","0","0","0","0","0","71","37","34","0","0","0","6","2","4","0","0","0","0","0","0","0","0","0","-2"
"243179","University of Puerto Rico-Humacao","2019","Tenured, associate professors","33","14","19","0","0","0","0","0","0","0","0","0","33","14","19","0","0","0","0","0","0","0","0","0","0","0","0","0","0","0","-2"
"243179","University of Puerto Rico-Humacao","2019","Tenured, assistant professors","10","7","3","0","0","0","0","0","0","0","0","0","10","7","3","0","0","0","0","0","0","0","0","0","0","0","0","0","0","0","-2"
"243179","University of Puerto Rico-Humacao","2019","On-Tenure track total","7","2","5","0","0","0","0","0","0","0","0","0","7","2","5","0","0","0","0","0","0","0","0","0","0","0","0","0","0","0","-2"
"243179","University of Puerto Rico-Humacao","2019","On-tenure track, assistant professors","6","2","4","0","0","0","0","0","0","0","0","0","6","2","4","0","0","0","0","0","0","0","0","0","0","0","0","0","0","0","-2"
"243179","University of Puerto Rico-Humacao","2019","On-tenure track, instructors","1","0","1","0","0","0","0","0","0","0","0","0","1","0","1","0","0","0","0","0","0","0","0","0","0","0","0","0","0","0","-2"
"243179","University of Puerto Rico-Humacao","2019","Not on tenure track/No tenure system system total","24","10","14","1","1","0","0","0","0","0","0","0","20","7","13","0","0","0","0","0","0","0","0","0","2","1","1","1","1","0","-2"
"243179","University of Puerto Rico-Humacao","2019","Not on tenure/no tenure system, assistant professors","13","7","6","1","1","0","0","0","0","0","0","0","9","4","5","0","0","0","0","0","0","0","0","0","2","1","1","1","1","0","-2"
"243179","University of Puerto Rico-Humacao","2019","Not on tenure/no tenure system, instructors","11","3","8","0","0","0","0","0","0","0","0","0","11","3","8","0","0","0","0","0","0","0","0","0","0","0","0","0","0","0","-2"
"243188","University of Puerto Rico-Utuado","2019","Tenured total","28","16","12","0","0","0","0","0","0","0","0","0","28","16","12","0","0","0","0","0","0","0","0","0","0","0","0","0","0","0","-2"
"243188","University of Puerto Rico-Utuado","2019","Tenured, professors","15","9","6","0","0","0","0","0","0","0","0","0","15","9","6","0","0","0","0","0","0","0","0","0","0","0","0","0","0","0","-2"
"243188","University of Puerto Rico-Utuado","2019","Tenured, associate professors","5","2","3","0","0","0","0","0","0","0","0","0","5","2","3","0","0","0","0","0","0","0","0","0","0","0","0","0","0","0","-2"
"243188","University of Puerto Rico-Utuado","2019","Tenured, assistant professors","7","4","3","0","0","0","0","0","0","0","0","0","7","4","3","0","0","0","0","0","0","0","0","0","0","0","0","0","0","0","-2"
"243188","University of Puerto Rico-Utuado","2019","Tenured, instructors","1","1","0","0","0","0","0","0","0","0","0","0","1","1","0","0","0","0","0","0","0","0","0","0","0","0","0","0","0","0","-2"
"243188","University of Puerto Rico-Utuado","2019","On-Tenure track total","2","2","0","0","0","0","0","0","0","0","0","0","1","1","0","0","0","0","0","0","0","0","0","0","1","1","0","0","0","0","-2"
"243188","University of Puerto Rico-Utuado","2019","On-tenure track, associate professors","1","1","0","0","0","0","0","0","0","0","0","0","0","0","0","0","0","0","0","0","0","0","0","0","1","1","0","0","0","0","-2"
"243188","University of Puerto Rico-Utuado","2019","On-tenure track, assistant professors","1","1","0","0","0","0","0","0","0","0","0","0","1","1","0","0","0","0","0","0","0","0","0","0","0","0","0","0","0","0","-2"
"243188","University of Puerto Rico-Utuado","2019","Not on tenure track/No tenure system system total","13","5","8","0","0","0","0","0","0","0","0","0","12","5","7","0","0","0","0","0","0","0","0","0","1","0","1","0","0","0","-2"
"243188","University of Puerto Rico-Utuado","2019","Not on tenure/no tenure system, assistant professors","4","1","3","0","0","0","0","0","0","0","0","0","4","1","3","0","0","0","0","0","0","0","0","0","0","0","0","0","0","0","-2"
"243188","University of Puerto Rico-Utuado","2019","Not on tenure/no tenure system, instructors","9","4","5","0","0","0","0","0","0","0","0","0","8","4","4","0","0","0","0","0","0","0","0","0","1","0","1","0","0","0","-2"
"243197","University of Puerto Rico-Mayaguez","2019","Tenured total","390","255","135","0","0","0","0","0","0","0","0","0","389","254","135","0","0","0","1","1","0","0","0","0","0","0","0","0","0","0","-2"
"243197","University of Puerto Rico-Mayaguez","2019","Tenured, professors","313","210","103","0","0","0","0","0","0","0","0","0","312","209","103","0","0","0","1","1","0","0","0","0","0","0","0","0","0","0","-2"
"243197","University of Puerto Rico-Mayaguez","2019","Tenured, associate professors","71","41","30","0","0","0","0","0","0","0","0","0","71","41","30","0","0","0","0","0","0","0","0","0","0","0","0","0","0","0","-2"
"243197","University of Puerto Rico-Mayaguez","2019","Tenured, assistant professors","6","4","2","0","0","0","0","0","0","0","0","0","6","4","2","0","0","0","0","0","0","0","0","0","0","0","0","0","0","0","-2"
"243197","University of Puerto Rico-Mayaguez","2019","On-Tenure track total","31","18","13","0","0","0","0","0","0","0","0","0","29","16","13","0","0","0","0","0","0","0","0","0","2","2","0","0","0","0","-2"
"243197","University of Puerto Rico-Mayaguez","2019","On-tenure track, professors","1","0","1","0","0","0","0","0","0","0","0","0","1","0","1","0","0","0","0","0","0","0","0","0","0","0","0","0","0","0","-2"
"243197","University of Puerto Rico-Mayaguez","2019","On-tenure track, associate professors","19","12","7","0","0","0","0","0","0","0","0","0","19","12","7","0","0","0","0","0","0","0","0","0","0","0","0","0","0","0","-2"
"243197","University of Puerto Rico-Mayaguez","2019","On-tenure track, assistant professors","11","6","5","0","0","0","0","0","0","0","0","0","9","4","5","0","0","0","0","0","0","0","0","0","2","2","0","0","0","0","-2"
"243197","University of Puerto Rico-Mayaguez","2019","Not on tenure track/No tenure system system total","62","31","31","0","0","0","0","0","0","0","0","0","36","17","19","0","0","0","0","0","0","0","0","0","26","14","12","0","0","0","-2"
"243197","University of Puerto Rico-Mayaguez","2019","Not on tenure/no tenure system, professors","4","3","1","0","0","0","0","0","0","0","0","0","4","3","1","0","0","0","0","0","0","0","0","0","0","0","0","0","0","0","-2"
"243197","University of Puerto Rico-Mayaguez","2019","Not on tenure/no tenure system, assistant professors","58","28","30","0","0","0","0","0","0","0","0","0","32","14","18","0","0","0","0","0","0","0","0","0","26","14","12","0","0","0","-2"
"243203","University of Puerto Rico-Medical Sciences","2019","Tenured total","375","156","219","0","0","0","2","1","1","0","0","0","357","147","210","0","0","0","16","8","8","0","0","0","0","0","0","0","0","0","-2"
"243203","University of Puerto Rico-Medical Sciences","2019","Tenured, professors","241","105","136","0","0","0","2","1","1","0","0","0","227","97","130","0","0","0","12","7","5","0","0","0","0","0","0","0","0","0","-2"
"243203","University of Puerto Rico-Medical Sciences","2019","Tenured, associate professors","84","33","51","0","0","0","0","0","0","0","0","0","82","33","49","0","0","0","2","0","2","0","0","0","0","0","0","0","0","0","-2"
"243203","University of Puerto Rico-Medical Sciences","2019","Tenured, assistant professors","30","13","17","0","0","0","0","0","0","0","0","0","30","13","17","0","0","0","0","0","0","0","0","0","0","0","0","0","0","0","-2"
"243203","University of Puerto Rico-Medical Sciences","2019","Tenured, instructors","5","1","4","0","0","0","0","0","0","0","0","0","4","1","3","0","0","0","1","0","1","0","0","0","0","0","0","0","0","0","-2"
"243203","University of Puerto Rico-Medical Sciences","2019","Tenured, no academic rank","15","4","11","0","0","0","0","0","0","0","0","0","14","3","11","0","0","0","1","1","0","0","0","0","0","0","0","0","0","0","-2"
"243203","University of Puerto Rico-Medical Sciences","2019","On-Tenure track total","69","28","41","1","1","0","2","0","2","0","0","0","62","23","39","0","0","0","4","4","0","0","0","0","0","0","0","0","0","0","-2"
"243203","University of Puerto Rico-Medical Sciences","2019","On-tenure track, professors","15","6","9","0","0","0","1","0","1","0","0","0","14","6","8","0","0","0","0","0","0","0","0","0","0","0","0","0","0","0","-2"
"243203","University of Puerto Rico-Medical Sciences","2019","On-tenure track, associate professors","16","6","10","0","0","0","0","0","0","0","0","0","16","6","10","0","0","0","0","0","0","0","0","0","0","0","0","0","0","0","-2"
"243203","University of Puerto Rico-Medical Sciences","2019","On-tenure track, assistant professors","27","12","15","1","1","0","0","0","0","0","0","0","23","8","15","0","0","0","3","3","0","0","0","0","0","0","0","0","0","0","-2"
"243203","University of Puerto Rico-Medical Sciences","2019","On-tenure track, instructors","4","1","3","0","0","0","0","0","0","0","0","0","4","1","3","0","0","0","0","0","0","0","0","0","0","0","0","0","0","0","-2"
"243203","University of Puerto Rico-Medical Sciences","2019","On-tenure track, no academic rank","7","3","4","0","0","0","1","0","1","0","0","0","5","2","3","0","0","0","1","1","0","0","0","0","0","0","0","0","0","0","-2"
"243203","University of Puerto Rico-Medical Sciences","2019","Not on tenure track/No tenure system system total","196","63","133","0","0","0","1","1","0","0","0","0","185","62","123","1","0","1","9","0","9","0","0","0","0","0","0","0","0","0","-2"
"243203","University of Puerto Rico-Medical Sciences","2019","Not on tenure/no tenure system, professors","16","9","7","0","0","0","0","0","0","0","0","0","16","9","7","0","0","0","0","0","0","0","0","0","0","0","0","0","0","0","-2"
"243203","University of Puerto Rico-Medical Sciences","2019","Not on tenure/no tenure system, associate professors","32","12","20","0","0","0","0","0","0","0","0","0","29","12","17","1","0","1","2","0","2","0","0","0","0","0","0","0","0","0","-2"
"243203","University of Puerto Rico-Medical Sciences","2019","Not on tenure/no tenure system, assistant professors","71","29","42","0","0","0","0","0","0","0","0","0","71","29","42","0","0","0","0","0","0","0","0","0","0","0","0","0","0","0","-2"
"243203","University of Puerto Rico-Medical Sciences","2019","Not on tenure/no tenure system, instructors","13","4","9","0","0","0","0","0","0","0","0","0","13","4","9","0","0","0","0","0","0","0","0","0","0","0","0","0","0","0","-2"
"243203","University of Puerto Rico-Medical Sciences","2019","Not on tenure/no tenure system, no academic rank","64","9","55","0","0","0","1","1","0","0","0","0","56","8","48","0","0","0","7","0","7","0","0","0","0","0","0","0","0","0","-2"
"243212","University of Puerto Rico-Ponce","2019","Tenured total","58","25","33","0","0","0","0","0","0","0","0","0","58","25","33","0","0","0","0","0","0","0","0","0","0","0","0","0","0","0","-2"
"243212","University of Puerto Rico-Ponce","2019","Tenured, professors","25","10","15","0","0","0","0","0","0","0","0","0","25","10","15","0","0","0","0","0","0","0","0","0","0","0","0","0","0","0","-2"
"243212","University of Puerto Rico-Ponce","2019","Tenured, associate professors","18","6","12","0","0","0","0","0","0","0","0","0","18","6","12","0","0","0","0","0","0","0","0","0","0","0","0","0","0","0","-2"
"243212","University of Puerto Rico-Ponce","2019","Tenured, assistant professors","10","4","6","0","0","0","0","0","0","0","0","0","10","4","6","0","0","0","0","0","0","0","0","0","0","0","0","0","0","0","-2"
"243212","University of Puerto Rico-Ponce","2019","Tenured, instructors","5","5","0","0","0","0","0","0","0","0","0","0","5","5","0","0","0","0","0","0","0","0","0","0","0","0","0","0","0","0","-2"
"243212","University of Puerto Rico-Ponce","2019","On-Tenure track total","5","2","3","0","0","0","0","0","0","0","0","0","5","2","3","0","0","0","0","0","0","0","0","0","0","0","0","0","0","0","-2"
"243212","University of Puerto Rico-Ponce","2019","On-tenure track, associate professors","3","2","1","0","0","0","0","0","0","0","0","0","3","2","1","0","0","0","0","0","0","0","0","0","0","0","0","0","0","0","-2"
"243212","University of Puerto Rico-Ponce","2019","On-tenure track, assistant professors","2","0","2","0","0","0","0","0","0","0","0","0","2","0","2","0","0","0","0","0","0","0","0","0","0","0","0","0","0","0","-2"
"243212","University of Puerto Rico-Ponce","2019","Not on tenure track/No tenure system system total","9","2","7","0","0","0","0","0","0","0","0","0","9","2","7","0","0","0","0","0","0","0","0","0","0","0","0","0","0","0","-2"
"243212","University of Puerto Rico-Ponce","2019","Not on tenure/no tenure system, assistant professors","5","0","5","0","0","0","0","0","0","0","0","0","5","0","5","0","0","0","0","0","0","0","0","0","0","0","0","0","0","0","-2"
"243212","University of Puerto Rico-Ponce","2019","Not on tenure/no tenure system, instructors","4","2","2","0","0","0","0","0","0","0","0","0","4","2","2","0","0","0","0","0","0","0","0","0","0","0","0","0","0","0","-2"
"243221","University of Puerto Rico-Rio Piedras","2019","Tenured total","551","299","252","0","0","0","5","5","0","0","0","0","532","285","247","0","0","0","11","7","4","0","0","0","3","2","1","0","0","0","-2"
"243221","University of Puerto Rico-Rio Piedras","2019","Tenured, professors","413","236","177","0","0","0","4","4","0","0","0","0","401","227","174","0","0","0","8","5","3","0","0","0","0","0","0","0","0","0","-2"
"243221","University of Puerto Rico-Rio Piedras","2019","Tenured, associate professors","96","45","51","0","0","0","1","1","0","0","0","0","92","42","50","0","0","0","1","0","1","0","0","0","2","2","0","0","0","0","-2"
"243221","University of Puerto Rico-Rio Piedras","2019","Tenured, assistant professors","35","14","21","0","0","0","0","0","0","0","0","0","33","12","21","0","0","0","2","2","0","0","0","0","0","0","0","0","0","0","-2"
"243221","University of Puerto Rico-Rio Piedras","2019","Tenured, instructors","6","3","3","0","0","0","0","0","0","0","0","0","5","3","2","0","0","0","0","0","0","0","0","0","1","0","1","0","0","0","-2"
"243221","University of Puerto Rico-Rio Piedras","2019","Tenured, no academic rank","1","1","0","0","0","0","0","0","0","0","0","0","1","1","0","0","0","0","0","0","0","0","0","0","0","0","0","0","0","0","-2"
"243221","University of Puerto Rico-Rio Piedras","2019","On-Tenure track total","24","13","11","0","0","0","0","0","0","0","0","0","19","9","10","0","0","0","2","2","0","0","0","0","3","2","1","0","0","0","-2"
"243221","University of Puerto Rico-Rio Piedras","2019","On-tenure track, associate professors","2","0","2","0","0","0","0","0","0","0","0","0","2","0","2","0","0","0","0","0","0","0","0","0","0","0","0","0","0","0","-2"
"243221","University of Puerto Rico-Rio Piedras","2019","On-tenure track, assistant professors","22","13","9","0","0","0","0","0","0","0","0","0","17","9","8","0","0","0","2","2","0","0","0","0","3","2","1","0","0","0","-2"
"243221","University of Puerto Rico-Rio Piedras","2019","Not on tenure track/No tenure system system total","148","78","70","0","0","0","1","0","1","1","1","0","132","70","62","0","0","0","1","1","0","0","0","0","13","6","7","0","0","0","-2"
"243221","University of Puerto Rico-Rio Piedras","2019","Not on tenure/no tenure system, professors","3","0","3","0","0","0","0","0","0","0","0","0","2","0","2","0","0","0","0","0","0","0","0","0","1","0","1","0","0","0","-2"
"243221","University of Puerto Rico-Rio Piedras","2019","Not on tenure/no tenure system, assistant professors","79","45","34","0","0","0","0","0","0","1","1","0","70","39","31","0","0","0","1","1","0","0","0","0","7","4","3","0","0","0","-2"
"243221","University of Puerto Rico-Rio Piedras","2019","Not on tenure/no tenure system, instructors","65","33","32","0","0","0","1","0","1","0","0","0","59","31","28","0","0","0","0","0","0","0","0","0","5","2","3","0","0","0","-2"
"243221","University of Puerto Rico-Rio Piedras","2019","Not on tenure/no tenure system, no academic rank","1","0","1","0","0","0","0","0","0","0","0","0","1","0","1","0","0","0","0","0","0","0","0","0","0","0","0","0","0","0","-2"
"243346","Universidad Ana G. Mendez-Carolina Campus","2019","Tenured total","9","5","4","0","0","0","0","0","0","0","0","0","9","5","4","0","0","0","0","0","0","0","0","0","0","0","0","0","0","0","-2"
"243346","Universidad Ana G. Mendez-Carolina Campus","2019","Tenured, professors","3","1","2","0","0","0","0","0","0","0","0","0","3","1","2","0","0","0","0","0","0","0","0","0","0","0","0","0","0","0","-2"
"243346","Universidad Ana G. Mendez-Carolina Campus","2019","Tenured, associate professors","3","2","1","0","0","0","0","0","0","0","0","0","3","2","1","0","0","0","0","0","0","0","0","0","0","0","0","0","0","0","-2"
"243346","Universidad Ana G. Mendez-Carolina Campus","2019","Tenured, assistant professors","3","2","1","0","0","0","0","0","0","0","0","0","3","2","1","0","0","0","0","0","0","0","0","0","0","0","0","0","0","0","-2"
"243346","Universidad Ana G. Mendez-Carolina Campus","2019","Not on tenure track/No tenure system system total","123","52","71","0","0","0","0","0","0","1","1","0","118","48","70","0","0","0","3","2","1","0","0","0","1","1","0","0","0","0","-2"
"243346","Universidad Ana G. Mendez-Carolina Campus","2019","Not on tenure/no tenure system, professors","12","5","7","0","0","0","0","0","0","0","0","0","12","5","7","0","0","0","0","0","0","0","0","0","0","0","0","0","0","0","-2"
"243346","Universidad Ana G. Mendez-Carolina Campus","2019","Not on tenure/no tenure system, associate professors","18","5","13","0","0","0","0","0","0","0","0","0","16","4","12","0","0","0","1","0","1","0","0","0","1","1","0","0","0","0","-2"
"243346","Universidad Ana G. Mendez-Carolina Campus","2019","Not on tenure/no tenure system, assistant professors","39","17","22","0","0","0","0","0","0","1","1","0","38","16","22","0","0","0","0","0","0","0","0","0","0","0","0","0","0","0","-2"
"243346","Universidad Ana G. Mendez-Carolina Campus","2019","Not on tenure/no tenure system, instructors","54","25","29","0","0","0","0","0","0","0","0","0","52","23","29","0","0","0","2","2","0","0","0","0","0","0","0","0","0","0","-2"
"243443","Universidad del Sagrado Corazon","2019","Tenured total","57","18","39","0","0","0","1","1","0","0","0","0","56","17","39","0","0","0","0","0","0","0","0","0","0","0","0","0","0","0","-2"
"243443","Universidad del Sagrado Corazon","2019","Tenured, professors","30","10","20","0","0","0","1","1","0","0","0","0","29","9","20","0","0","0","0","0","0","0","0","0","0","0","0","0","0","0","-2"
"243443","Universidad del Sagrado Corazon","2019","Tenured, associate professors","6","0","6","0","0","0","0","0","0","0","0","0","6","0","6","0","0","0","0","0","0","0","0","0","0","0","0","0","0","0","-2"
"243443","Universidad del Sagrado Corazon","2019","Tenured, assistant professors","14","6","8","0","0","0","0","0","0","0","0","0","14","6","8","0","0","0","0","0","0","0","0","0","0","0","0","0","0","0","-2"
"243443","Universidad del Sagrado Corazon","2019","Tenured, instructors","7","2","5","0","0","0","0","0","0","0","0","0","7","2","5","0","0","0","0","0","0","0","0","0","0","0","0","0","0","0","-2"
"243443","Universidad del Sagrado Corazon","2019","Not on tenure track/No tenure system system total","4","1","3","0","0","0","0","0","0","0","0","0","4","1","3","0","0","0","0","0","0","0","0","0","0","0","0","0","0","0","-2"
"243443","Universidad del Sagrado Corazon","2019","Not on tenure/no tenure system, assistant professors","1","1","0","0","0","0","0","0","0","0","0","0","1","1","0","0","0","0","0","0","0","0","0","0","0","0","0","0","0","0","-2"
"243443","Universidad del Sagrado Corazon","2019","Not on tenure/no tenure system, instructors","3","0","3","0","0","0","0","0","0","0","0","0","3","0","3","0","0","0","0","0","0","0","0","0","0","0","0","0","0","0","-2"
"243568","Universidad Central Del Caribe","2019","Not on tenure track/No tenure system system total","44","18","26","0","0","0","0","0","0","0","0","0","32","12","20","0","0","0","12","6","6","0","0","0","0","0","0","0","0","0","-2"
"243568","Universidad Central Del Caribe","2019","Not on tenure/no tenure system, professors","15","8","7","0","0","0","0","0","0","0","0","0","9","5","4","0","0","0","6","3","3","0","0","0","0","0","0","0","0","0","-2"
"243568","Universidad Central Del Caribe","2019","Not on tenure/no tenure system, associate professors","13","5","8","0","0","0","0","0","0","0","0","0","9","3","6","0","0","0","4","2","2","0","0","0","0","0","0","0","0","0","-2"
"243568","Universidad Central Del Caribe","2019","Not on tenure/no tenure system, assistant professors","14","4","10","0","0","0","0","0","0","0","0","0","12","3","9","0","0","0","2","1","1","0","0","0","0","0","0","0","0","0","-2"
"243568","Universidad Central Del Caribe","2019","Not on tenure/no tenure system, instructors","2","1","1","0","0","0","0","0","0","0","0","0","2","1","1","0","0","0","0","0","0","0","0","0","0","0","0","0","0","0","-2"
"243577","Universidad Politecnica de Puerto Rico","2019","Not on tenure track/No tenure system system total","133","88","45","0","0","0","1","1","0","0","0","0","122","77","45","0","0","0","2","2","0","0","0","0","8","8","0","0","0","0","-2"
"243577","Universidad Politecnica de Puerto Rico","2019","Not on tenure/no tenure system, professors","36","27","9","0","0","0","1","1","0","0","0","0","34","25","9","0","0","0","1","1","0","0","0","0","0","0","0","0","0","0","-2"
"243577","Universidad Politecnica de Puerto Rico","2019","Not on tenure/no tenure system, associate professors","77","49","28","0","0","0","0","0","0","0","0","0","69","41","28","0","0","0","1","1","0","0","0","0","7","7","0","0","0","0","-2"
"243577","Universidad Politecnica de Puerto Rico","2019","Not on tenure/no tenure system, assistant professors","16","10","6","0","0","0","0","0","0","0","0","0","15","9","6","0","0","0","0","0","0","0","0","0","1","1","0","0","0","0","-2"
"243577","Universidad Politecnica de Puerto Rico","2019","Not on tenure/no tenure system, instructors","4","2","2","0","0","0","0","0","0","0","0","0","4","2","2","0","0","0","0","0","0","0","0","0","0","0","0","0","0","0","-2"
"243586","Pontifical Catholic University of Puerto Rico-Mayaguez","2019","Not on tenure track/No tenure system system total","38","19","19","0","0","0","0","0","0","0","0","0","37","18","19","0","0","0","0","0","0","0","0","0","1","1","0","0","0","0","-2"
"243586","Pontifical Catholic University of Puerto Rico-Mayaguez","2019","Not on tenure/no tenure system, professors","4","3","1","0","0","0","0","0","0","0","0","0","4","3","1","0","0","0","0","0","0","0","0","0","0","0","0","0","0","0","-2"
"243586","Pontifical Catholic University of Puerto Rico-Mayaguez","2019","Not on tenure/no tenure system, associate professors","5","4","1","0","0","0","0","0","0","0","0","0","5","4","1","0","0","0","0","0","0","0","0","0","0","0","0","0","0","0","-2"
"243586","Pontifical Catholic University of Puerto Rico-Mayaguez","2019","Not on tenure/no tenure system, assistant professors","22","10","12","0","0","0","0","0","0","0","0","0","21","9","12","0","0","0","0","0","0","0","0","0","1","1","0","0","0","0","-2"
"243586","Pontifical Catholic University of Puerto Rico-Mayaguez","2019","Not on tenure/no tenure system, instructors","3","1","2","0","0","0","0","0","0","0","0","0","3","1","2","0","0","0","0","0","0","0","0","0","0","0","0","0","0","0","-2"
"243586","Pontifical Catholic University of Puerto Rico-Mayaguez","2019","Not on tenure/no tenure system, no academic rank","4","1","3","0","0","0","0","0","0","0","0","0","4","1","3","0","0","0","0","0","0","0","0","0","0","0","0","0","0","0","-2"
"243601","Universidad Ana G. Mendez-Gurabo Campus","2019","Tenured total","21","8","13","0","0","0","0","0","0","0","0","0","21","8","13","0","0","0","0","0","0","0","0","0","0","0","0","0","0","0","-2"
"243601","Universidad Ana G. Mendez-Gurabo Campus","2019","Tenured, professors","12","4","8","0","0","0","0","0","0","0","0","0","12","4","8","0","0","0","0","0","0","0","0","0","0","0","0","0","0","0","-2"
"243601","Universidad Ana G. Mendez-Gurabo Campus","2019","Tenured, associate professors","8","3","5","0","0","0","0","0","0","0","0","0","8","3","5","0","0","0","0","0","0","0","0","0","0","0","0","0","0","0","-2"
"243601","Universidad Ana G. Mendez-Gurabo Campus","2019","Tenured, assistant professors","1","1","0","0","0","0","0","0","0","0","0","0","1","1","0","0","0","0","0","0","0","0","0","0","0","0","0","0","0","0","-2"
"243601","Universidad Ana G. Mendez-Gurabo Campus","2019","Not on tenure track/No tenure system system total","180","77","103","0","0","0","1","1","0","0","0","0","171","72","99","0","0","0","2","1","1","0","0","0","6","3","3","0","0","0","-2"
"243601","Universidad Ana G. Mendez-Gurabo Campus","2019","Not on tenure/no tenure system, professors","20","13","7","0","0","0","1","1","0","0","0","0","16","9","7","0","0","0","1","1","0","0","0","0","2","2","0","0","0","0","-2"
"243601","Universidad Ana G. Mendez-Gurabo Campus","2019","Not on tenure/no tenure system, associate professors","24","7","17","0","0","0","0","0","0","0","0","0","22","7","15","0","0","0","0","0","0","0","0","0","2","0","2","0","0","0","-2"
"243601","Universidad Ana G. Mendez-Gurabo Campus","2019","Not on tenure/no tenure system, assistant professors","76","36","40","0","0","0","0","0","0","0","0","0","75","35","40","0","0","0","0","0","0","0","0","0","1","1","0","0","0","0","-2"
"243601","Universidad Ana G. Mendez-Gurabo Campus","2019","Not on tenure/no tenure system, instructors","56","20","36","0","0","0","0","0","0","0","0","0","54","20","34","0","0","0","1","0","1","0","0","0","1","0","1","0","0","0","-2"
"243601","Universidad Ana G. Mendez-Gurabo Campus","2019","Not on tenure/no tenure system, no academic rank","4","1","3","0","0","0","0","0","0","0","0","0","4","1","3","0","0","0","0","0","0","0","0","0","0","0","0","0","0","0","-2"
"243832","EDP University of Puerto Rico Inc-San Juan","2019","Not on tenure track/No tenure system system total","40","15","25","0","0","0","0","0","0","0","0","0","40","15","25","0","0","0","0","0","0","0","0","0","0","0","0","0","0","0","-2"
"243832","EDP University of Puerto Rico Inc-San Juan","2019","Not on tenure/no tenure system, instructors","40","15","25","0","0","0","0","0","0","0","0","0","40","15","25","0","0","0","0","0","0","0","0","0","0","0","0","0","0","0","-2"
"245953","Mid-America Christian University","2019","Not on tenure track/No tenure system system total","32","17","15","3","3","0","0","0","0","1","0","1","0","0","0","0","0","0","24","13","11","0","0","0","2","0","2","2","1","1","-2"
"245953","Mid-America Christian University","2019","Not on tenure/no tenure system, professors","8","4","4","2","2","0","0","0","0","1","0","1","0","0","0","0","0","0","5","2","3","0","0","0","0","0","0","0","0","0","-2"
"245953","Mid-America Christian University","2019","Not on tenure/no tenure system, associate professors","12","8","4","1","1","0","0","0","0","0","0","0","0","0","0","0","0","0","9","7","2","0","0","0","1","0","1","1","0","1","-2"
"245953","Mid-America Christian University","2019","Not on tenure/no tenure system, assistant professors","11","4","7","0","0","0","0","0","0","0","0","0","0","0","0","0","0","0","9","3","6","0","0","0","1","0","1","1","1","0","-2"
"245953","Mid-America Christian University","2019","Not on tenure/no tenure system, instructors","1","1","0","0","0","0","0","0","0","0","0","0","0","0","0","0","0","0","1","1","0","0","0","0","0","0","0","0","0","0","-2"
"363907","Caribbean University-Ponce","2019","Not on tenure track/No tenure system system total","20","7","13","0","0","0","0","0","0","0","0","0","20","7","13","0","0","0","0","0","0","0","0","0","0","0","0","0","0","0","-2"
"363907","Caribbean University-Ponce","2019","Not on tenure/no tenure system, professors","1","1","0","0","0","0","0","0","0","0","0","0","1","1","0","0","0","0","0","0","0","0","0","0","0","0","0","0","0","0","-2"
"363907","Caribbean University-Ponce","2019","Not on tenure/no tenure system, assistant professors","6","3","3","0","0","0","0","0","0","0","0","0","6","3","3","0","0","0","0","0","0","0","0","0","0","0","0","0","0","0","-2"
"363907","Caribbean University-Ponce","2019","Not on tenure/no tenure system, instructors","13","3","10","0","0","0","0","0","0","0","0","0","13","3","10","0","0","0","0","0","0","0","0","0","0","0","0","0","0","0","-2"
"363916","Caribbean University-Vega Baja","2019","Not on tenure track/No tenure system system total","5","2","3","0","0","0","0","0","0","0","0","0","5","2","3","0","0","0","0","0","0","0","0","0","0","0","0","0","0","0","-2"
"363916","Caribbean University-Vega Baja","2019","Not on tenure/no tenure system, instructors","5","2","3","0","0","0","0","0","0","0","0","0","5","2","3","0","0","0","0","0","0","0","0","0","0","0","0","0","0","0","-2"
"366711","California State University-San Marcos","2019","Tenured total","188","96","92","3","1","2","28","17","11","5","4","1","27","11","16","1","1","0","112","56","56","5","1","4","6","4","2","1","1","0","-2"
"366711","California State University-San Marcos","2019","Tenured, professors","111","55","56","1","0","1","14","9","5","2","1","1","14","8","6","0","0","0","73","34","39","3","0","3","3","2","1","1","1","0","-2"
"366711","California State University-San Marcos","2019","Tenured, associate professors","76","40","36","2","1","1","14","8","6","3","3","0","13","3","10","1","1","0","39","22","17","2","1","1","2","1","1","0","0","0","-2"
"366711","California State University-San Marcos","2019","Tenured, no academic rank","1","1","0","0","0","0","0","0","0","0","0","0","0","0","0","0","0","0","0","0","0","0","0","0","1","1","0","0","0","0","-2"
"366711","California State University-San Marcos","2019","On-Tenure track total","95","46","49","0","0","0","17","9","8","7","3","4","13","8","5","0","0","0","36","16","20","4","1","3","5","3","2","13","6","7","-2"
"366711","California State University-San Marcos","2019","On-tenure track, associate professors","5","5","0","0","0","0","3","3","0","0","0","0","0","0","0","0","0","0","1","1","0","0","0","0","1","1","0","0","0","0","-2"
"366711","California State University-San Marcos","2019","On-tenure track, assistant professors","90","41","49","0","0","0","14","6","8","7","3","4","13","8","5","0","0","0","35","15","20","4","1","3","4","2","2","13","6","7","-2"
"366711","California State University-San Marcos","2019","Not on tenure track/No tenure system system total","109","32","77","1","0","1","8","3","5","2","1","1","10","2","8","0","0","0","80","24","56","6","1","5","1","1","0","1","0","1","-2"
"366711","California State University-San Marcos","2019","Not on tenure/no tenure system, lecturers","109","32","77","1","0","1","8","3","5","2","1","1","10","2","8","0","0","0","80","24","56","6","1","5","1","1","0","1","0","1","-2"
"367884","Hodges University","2019","Not on tenure track/No tenure system system total","26","13","13","0","0","0","0","0","0","0","0","0","6","3","3","0","0","0","19","10","9","1","0","1","0","0","0","0","0","0","-2"
"367884","Hodges University","2019","Not on tenure/no tenure system, professors","10","4","6","0","0","0","0","0","0","0","0","0","0","0","0","0","0","0","10","4","6","0","0","0","0","0","0","0","0","0","-2"
"367884","Hodges University","2019","Not on tenure/no tenure system, associate professors","6","3","3","0","0","0","0","0","0","0","0","0","2","1","1","0","0","0","3","2","1","1","0","1","0","0","0","0","0","0","-2"
"367884","Hodges University","2019","Not on tenure/no tenure system, assistant professors","10","6","4","0","0","0","0","0","0","0","0","0","4","2","2","0","0","0","6","4","2","0","0","0","0","0","0","0","0","0","-2"
"376385","Universal Technology College of Puerto Rico","2019","Not on tenure track/No tenure system system total","17","10","7","0","0","0","0","0","0","0","0","0","17","10","7","0","0","0","0","0","0","0","0","0","0","0","0","0","0","0","-2"
"376385","Universal Technology College of Puerto Rico","2019","Not on tenure/no tenure system, professors","17","10","7","0","0","0","0","0","0","0","0","0","17","10","7","0","0","0","0","0","0","0","0","0","0","0","0","0","0","0","-2"
"401223","World Mission University","2019","Not on tenure track/No tenure system system total","5","3","2","0","0","0","5","3","2","0","0","0","0","0","0","0","0","0","0","0","0","0","0","0","0","0","0","0","0","0","-2"
"401223","World Mission University","2019","Not on tenure/no tenure system, associate professors","4","2","2","0","0","0","4","2","2","0","0","0","0","0","0","0","0","0","0","0","0","0","0","0","0","0","0","0","0","0","-2"
"401223","World Mission University","2019","Not on tenure/no tenure system, assistant professors","1","1","0","0","0","0","1","1","0","0","0","0","0","0","0","0","0","0","0","0","0","0","0","0","0","0","0","0","0","0","-2"
"407009","Arizona State University-West","2019","Tenured total","113","60","53","0","0","0","9","3","6","2","1","1","13","8","5","0","0","0","84","46","38","1","0","1","4","2","2","0","0","0","-2"
"407009","Arizona State University-West","2019","Tenured, professors","48","28","20","0","0","0","5","1","4","0","0","0","4","4","0","0","0","0","37","22","15","0","0","0","2","1","1","0","0","0","-2"
"407009","Arizona State University-West","2019","Tenured, associate professors","65","32","33","0","0","0","4","2","2","2","1","1","9","4","5","0","0","0","47","24","23","1","0","1","2","1","1","0","0","0","-2"
"407009","Arizona State University-West","2019","On-Tenure track total","40","12","28","2","1","1","6","1","5","1","0","1","3","1","2","0","0","0","18","6","12","1","1","0","4","0","4","5","2","3","-2"
"407009","Arizona State University-West","2019","On-tenure track, associate professors","2","0","2","0","0","0","1","0","1","0","0","0","0","0","0","0","0","0","1","0","1","0","0","0","0","0","0","0","0","0","-2"
"407009","Arizona State University-West","2019","On-tenure track, assistant professors","38","12","26","2","1","1","5","1","4","1","0","1","3","1","2","0","0","0","17","6","11","1","1","0","4","0","4","5","2","3","-2"
"407009","Arizona State University-West","2019","Not on tenure track/No tenure system system total","138","38","100","2","0","2","6","2","4","4","2","2","13","5","8","1","0","1","105","27","78","1","1","0","5","0","5","1","1","0","-2"
"407009","Arizona State University-West","2019","Not on tenure/no tenure system, professors","2","2","0","0","0","0","0","0","0","0","0","0","1","1","0","0","0","0","1","1","0","0","0","0","0","0","0","0","0","0","-2"
"407009","Arizona State University-West","2019","Not on tenure/no tenure system, associate professors","9","4","5","0","0","0","0","0","0","1","1","0","0","0","0","1","0","1","7","3","4","0","0","0","0","0","0","0","0","0","-2"
"407009","Arizona State University-West","2019","Not on tenure/no tenure system, assistant professors","37","5","32","0","0","0","0","0","0","0","0","0","4","1","3","0","0","0","33","4","29","0","0","0","0","0","0","0","0","0","-2"
"407009","Arizona State University-West","2019","Not on tenure/no tenure system, instructors","47","14","33","0","0","0","3","2","1","0","0","0","5","2","3","0","0","0","33","8","25","1","1","0","4","0","4","1","1","0","-2"
"407009","Arizona State University-West","2019","Not on tenure/no tenure system, lecturers","43","13","30","2","0","2","3","0","3","3","1","2","3","1","2","0","0","0","31","11","20","0","0","0","1","0","1","0","0","0","-2"
"409315","South Texas College","2019","Not on tenure track/No tenure system system total","639","380","259","2","2","0","57","28","29","13","11","2","383","225","158","0","0","0","174","106","68","0","0","0","10","8","2","0","0","0","-2"
"409315","South Texas College","2019","Not on tenure/no tenure system, professors","9","5","4","0","0","0","1","1","0","1","1","0","2","1","1","0","0","0","5","2","3","0","0","0","0","0","0","0","0","0","-2"
"409315","South Texas College","2019","Not on tenure/no tenure system, associate professors","32","19","13","0","0","0","1","1","0","0","0","0","19","11","8","0","0","0","12","7","5","0","0","0","0","0","0","0","0","0","-2"
"409315","South Texas College","2019","Not on tenure/no tenure system, assistant professors","43","26","17","0","0","0","4","2","2","2","1","1","19","11","8","0","0","0","18","12","6","0","0","0","0","0","0","0","0","0","-2"
"409315","South Texas College","2019","Not on tenure/no tenure system, instructors","442","249","193","1","1","0","48","22","26","9","8","1","268","151","117","0","0","0","113","66","47","0","0","0","3","1","2","0","0","0","-2"
"409315","South Texas College","2019","Not on tenure/no tenure system, lecturers","113","81","32","1","1","0","3","2","1","1","1","0","75","51","24","0","0","0","26","19","7","0","0","0","7","7","0","0","0","0","-2"
"409698","California State University-Monterey Bay","2019","Tenured total","93","47","46","1","1","0","18","8","10","3","1","2","20","12","8","1","0","1","45","23","22","1","0","1","4","2","2","0","0","0","-2"
"409698","California State University-Monterey Bay","2019","Tenured, professors","62","34","28","1","1","0","15","7","8","1","0","1","12","8","4","1","0","1","29","17","12","1","0","1","2","1","1","0","0","0","-2"
"409698","California State University-Monterey Bay","2019","Tenured, associate professors","31","13","18","0","0","0","3","1","2","2","1","1","8","4","4","0","0","0","16","6","10","0","0","0","2","1","1","0","0","0","-2"
"409698","California State University-Monterey Bay","2019","On-Tenure track total","83","35","48","0","0","0","10","3","7","2","2","0","13","5","8","0","0","0","49","21","28","1","1","0","3","1","2","5","2","3","-2"
"409698","California State University-Monterey Bay","2019","On-tenure track, associate professors","4","2","2","0","0","0","1","0","1","0","0","0","0","0","0","0","0","0","3","2","1","0","0","0","0","0","0","0","0","0","-2"
"409698","California State University-Monterey Bay","2019","On-tenure track, assistant professors","79","33","46","0","0","0","9","3","6","2","2","0","13","5","8","0","0","0","46","19","27","1","1","0","3","1","2","5","2","3","-2"
"409698","California State University-Monterey Bay","2019","Not on tenure track/No tenure system system total","51","23","28","0","0","0","5","3","2","2","0","2","12","6","6","0","0","0","25","11","14","1","1","0","6","2","4","0","0","0","-2"
"409698","California State University-Monterey Bay","2019","Not on tenure/no tenure system, lecturers","51","23","28","0","0","0","5","3","2","2","0","2","12","6","6","0","0","0","25","11","14","1","1","0","6","2","4","0","0","0","-2"
"414823","Johnson & Wales University-North Miami","2019","Not on tenure track/No tenure system system total","46","31","15","0","0","0","3","1","2","10","7","3","5","3","2","0","0","0","26","19","7","2","1","1","0","0","0","0","0","0","-2"
"414823","Johnson & Wales University-North Miami","2019","Not on tenure/no tenure system, professors","11","6","5","0","0","0","1","0","1","2","1","1","1","0","1","0","0","0","7","5","2","0","0","0","0","0","0","0","0","0","-2"
"414823","Johnson & Wales University-North Miami","2019","Not on tenure/no tenure system, associate professors","13","8","5","0","0","0","1","1","0","3","2","1","1","0","1","0","0","0","7","5","2","1","0","1","0","0","0","0","0","0","-2"
"414823","Johnson & Wales University-North Miami","2019","Not on tenure/no tenure system, assistant professors","11","8","3","0","0","0","0","0","0","3","2","1","1","1","0","0","0","0","6","4","2","1","1","0","0","0","0","0","0","0","-2"
"414823","Johnson & Wales University-North Miami","2019","Not on tenure/no tenure system, instructors","11","9","2","0","0","0","1","0","1","2","2","0","2","2","0","0","0","0","6","5","1","0","0","0","0","0","0","0","0","0","-2"
"416801","The University of Texas MD Anderson Cancer Center","2019","Tenured total","1","1","0","0","0","0","1","1","0","0","0","0","0","0","0","0","0","0","0","0","0","0","0","0","0","0","0","0","0","0","-2"
"416801","The University of Texas MD Anderson Cancer Center","2019","Tenured, professors","1","1","0","0","0","0","1","1","0","0","0","0","0","0","0","0","0","0","0","0","0","0","0","0","0","0","0","0","0","0","-2"
"416801","The University of Texas MD Anderson Cancer Center","2019","Not on tenure track/No tenure system system total","22","10","12","0","0","0","4","4","0","3","1","2","0","0","0","0","0","0","15","5","10","0","0","0","0","0","0","0","0","0","-2"
"416801","The University of Texas MD Anderson Cancer Center","2019","Not on tenure/no tenure system, lecturers","22","10","12","0","0","0","4","4","0","3","1","2","0","0","0","0","0","0","15","5","10","0","0","0","0","0","0","0","0","0","-2"
"430670","San Juan Bautista School of Medicine","2019","Tenured total","11","6","5","0","0","0","0","0","0","0","0","0","11","6","5","0","0","0","0","0","0","0","0","0","0","0","0","0","0","0","-2"
"430670","San Juan Bautista School of Medicine","2019","Tenured, associate professors","5","5","0","0","0","0","0","0","0","0","0","0","5","5","0","0","0","0","0","0","0","0","0","0","0","0","0","0","0","0","-2"
"430670","San Juan Bautista School of Medicine","2019","Tenured, assistant professors","5","1","4","0","0","0","0","0","0","0","0","0","5","1","4","0","0","0","0","0","0","0","0","0","0","0","0","0","0","0","-2"
"430670","San Juan Bautista School of Medicine","2019","Tenured, instructors","1","0","1","0","0","0","0","0","0","0","0","0","1","0","1","0","0","0","0","0","0","0","0","0","0","0","0","0","0","0","-2"
"430670","San Juan Bautista School of Medicine","2019","On-Tenure track total","10","3","7","0","0","0","0","0","0","0","0","0","10","3","7","0","0","0","0","0","0","0","0","0","0","0","0","0","0","0","-2"
"430670","San Juan Bautista School of Medicine","2019","On-tenure track, associate professors","1","0","1","0","0","0","0","0","0","0","0","0","1","0","1","0","0","0","0","0","0","0","0","0","0","0","0","0","0","0","-2"
"430670","San Juan Bautista School of Medicine","2019","On-tenure track, assistant professors","3","0","3","0","0","0","0","0","0","0","0","0","3","0","3","0","0","0","0","0","0","0","0","0","0","0","0","0","0","0","-2"
"430670","San Juan Bautista School of Medicine","2019","On-tenure track, instructors","6","3","3","0","0","0","0","0","0","0","0","0","6","3","3","0","0","0","0","0","0","0","0","0","0","0","0","0","0","0","-2"
"430670","San Juan Bautista School of Medicine","2019","Not on tenure track/No tenure system system total","20","16","4","0","0","0","0","0","0","0","0","0","20","16","4","0","0","0","0","0","0","0","0","0","0","0","0","0","0","0","-2"
"430670","San Juan Bautista School of Medicine","2019","Not on tenure/no tenure system, professors","1","1","0","0","0","0","0","0","0","0","0","0","1","1","0","0","0","0","0","0","0","0","0","0","0","0","0","0","0","0","-2"
"430670","San Juan Bautista School of Medicine","2019","Not on tenure/no tenure system, associate professors","2","2","0","0","0","0","0","0","0","0","0","0","2","2","0","0","0","0","0","0","0","0","0","0","0","0","0","0","0","0","-2"
"430670","San Juan Bautista School of Medicine","2019","Not on tenure/no tenure system, assistant professors","15","12","3","0","0","0","0","0","0","0","0","0","15","12","3","0","0","0","0","0","0","0","0","0","0","0","0","0","0","0","-2"
"430670","San Juan Bautista School of Medicine","2019","Not on tenure/no tenure system, instructors","2","1","1","0","0","0","0","0","0","0","0","0","2","1","1","0","0","0","0","0","0","0","0","0","0","0","0","0","0","0","-2"
"434900","Dewey University-Carolina","2019","Not on tenure track/No tenure system system total","27","12","15","0","0","0","0","0","0","0","0","0","27","12","15","0","0","0","0","0","0","0","0","0","0","0","0","0","0","0","-2"
"434900","Dewey University-Carolina","2019","Not on tenure/no tenure system, professors","27","12","15","0","0","0","0","0","0","0","0","0","27","12","15","0","0","0","0","0","0","0","0","0","0","0","0","0","0","0","-2"
"439446","Atlantic Institute of Oriental Medicine","2019","Not on tenure track/No tenure system system total","6","2","4","0","0","0","5","2","3","0","0","0","0","0","0","0","0","0","1","0","1","0","0","0","0","0","0","0","0","0","-2"
"439446","Atlantic Institute of Oriental Medicine","2019","Not on tenure/no tenure system, instructors","6","2","4","0","0","0","5","2","3","0","0","0","0","0","0","0","0","0","1","0","1","0","0","0","0","0","0","0","0","0","-2"
"440651","Atenas College","2019","Tenured total","13","2","11","0","0","0","0","0","0","0","0","0","13","2","11","0","0","0","0","0","0","0","0","0","0","0","0","0","0","0","-2"
"440651","Atenas College","2019","Tenured, professors","13","2","11","0","0","0","0","0","0","0","0","0","13","2","11","0","0","0","0","0","0","0","0","0","0","0","0","0","0","0","-2"
"440651","Atenas College","2019","Not on tenure track/No tenure system system total","7","1","6","0","0","0","0","0","0","0","0","0","7","1","6","0","0","0","0","0","0","0","0","0","0","0","0","0","0","0","-2"
"440651","Atenas College","2019","Not on tenure/no tenure system, professors","7","1","6","0","0","0","0","0","0","0","0","0","7","1","6","0","0","0","0","0","0","0","0","0","0","0","0","0","0","0","-2"
"440794","Pillar College","2019","Not on tenure track/No tenure system system total","12","6","6","0","0","0","1","1","0","5","1","4","0","0","0","0","0","0","4","4","0","2","0","2","0","0","0","0","0","0","-2"
"440794","Pillar College","2019","Not on tenure/no tenure system, professors","3","2","1","0","0","0","0","0","0","0","0","0","0","0","0","0","0","0","2","2","0","1","0","1","0","0","0","0","0","0","-2"
"440794","Pillar College","2019","Not on tenure/no tenure system, associate professors","4","2","2","0","0","0","1","1","0","1","0","1","0","0","0","0","0","0","1","1","0","1","0","1","0","0","0","0","0","0","-2"
"440794","Pillar College","2019","Not on tenure/no tenure system, assistant professors","5","2","3","0","0","0","0","0","0","4","1","3","0","0","0","0","0","0","1","1","0","0","0","0","0","0","0","0","0","0","-2"
"441900","Nevada State College","2019","Tenured total","26","15","11","0","0","0","3","2","1","2","2","0","2","0","2","0","0","0","19","11","8","0","0","0","0","0","0","0","0","0","-2"
"441900","Nevada State College","2019","Tenured, professors","7","4","3","0","0","0","0","0","0","0","0","0","0","0","0","0","0","0","7","4","3","0","0","0","0","0","0","0","0","0","-2"
"441900","Nevada State College","2019","Tenured, associate professors","19","11","8","0","0","0","3","2","1","2","2","0","2","0","2","0","0","0","12","7","5","0","0","0","0","0","0","0","0","0","-2"
"441900","Nevada State College","2019","On-Tenure track total","40","7","33","0","0","0","2","0","2","1","0","1","5","1","4","0","0","0","29","6","23","2","0","2","1","0","1","0","0","0","-2"
"441900","Nevada State College","2019","On-tenure track, assistant professors","40","7","33","0","0","0","2","0","2","1","0","1","5","1","4","0","0","0","29","6","23","2","0","2","1","0","1","0","0","0","-2"
"441900","Nevada State College","2019","Not on tenure track/No tenure system system total","38","13","25","0","0","0","3","1","2","4","1","3","4","1","3","1","0","1","21","7","14","3","2","1","2","1","1","0","0","0","-2"
"441900","Nevada State College","2019","Not on tenure/no tenure system, lecturers","38","13","25","0","0","0","3","1","2","4","1","3","4","1","3","1","0","1","21","7","14","3","2","1","2","1","1","0","0","0","-2"
"441937","California State University-Channel Islands","2019","Tenured total","80","41","39","0","0","0","5","1","4","2","1","1","16","8","8","0","0","0","52","27","25","0","0","0","4","4","0","1","0","1","-2"
"441937","California State University-Channel Islands","2019","Tenured, professors","54","30","24","0","0","0","4","1","3","1","1","0","11","6","5","0","0","0","35","19","16","0","0","0","3","3","0","0","0","0","-2"
"441937","California State University-Channel Islands","2019","Tenured, associate professors","26","11","15","0","0","0","1","0","1","1","0","1","5","2","3","0","0","0","17","8","9","0","0","0","1","1","0","1","0","1","-2"
"441937","California State University-Channel Islands","2019","On-Tenure track total","70","25","45","0","0","0","7","2","5","2","0","2","15","7","8","0","0","0","40","14","26","2","0","2","1","1","0","3","1","2","-2"
"441937","California State University-Channel Islands","2019","On-tenure track, assistant professors","70","25","45","0","0","0","7","2","5","2","0","2","15","7","8","0","0","0","40","14","26","2","0","2","1","1","0","3","1","2","-2"
"441937","California State University-Channel Islands","2019","Not on tenure track/No tenure system system total","86","41","45","1","0","1","10","4","6","0","0","0","9","4","5","0","0","0","61","28","33","4","4","0","1","1","0","0","0","0","-2"
"441937","California State University-Channel Islands","2019","Not on tenure/no tenure system, lecturers","86","41","45","1","0","1","10","4","6","0","0","0","9","4","5","0","0","0","61","28","33","4","4","0","1","1","0","0","0","0","-2"
"443562","Dewey University-Hato Rey","2019","Not on tenure track/No tenure system system total","50","21","29","0","0","0","0","0","0","0","0","0","29","0","29","0","0","0","0","0","0","0","0","0","0","0","0","21","21","0","-2"
"443562","Dewey University-Hato Rey","2019","Not on tenure/no tenure system, professors","50","21","29","0","0","0","0","0","0","0","0","0","29","0","29","0","0","0","0","0","0","0","0","0","0","0","0","21","21","0","-2"
"444398","Baptist University of the Americas","2019","Not on tenure track/No tenure system system total","6","3","3","0","0","0","0","0","0","0","0","0","4","1","3","0","0","0","2","2","0","0","0","0","0","0","0","0","0","0","-2"
"444398","Baptist University of the Americas","2019","Not on tenure/no tenure system, professors","2","1","1","0","0","0","0","0","0","0","0","0","2","1","1","0","0","0","0","0","0","0","0","0","0","0","0","0","0","0","-2"
"444398","Baptist University of the Americas","2019","Not on tenure/no tenure system, assistant professors","4","2","2","0","0","0","0","0","0","0","0","0","2","0","2","0","0","0","2","2","0","0","0","0","0","0","0","0","0","0","-2"
"448886","Arizona State University-Downtown Phoenix","2019","Tenured total","167","85","82","0","0","0","16","5","11","6","2","4","12","6","6","0","0","0","127","68","59","3","2","1","2","1","1","1","1","0","-2"
"448886","Arizona State University-Downtown Phoenix","2019","Tenured, professors","88","55","33","0","0","0","4","3","1","3","1","2","7","5","2","0","0","0","69","42","27","2","2","0","2","1","1","1","1","0","-2"
"448886","Arizona State University-Downtown Phoenix","2019","Tenured, associate professors","79","30","49","0","0","0","12","2","10","3","1","2","5","1","4","0","0","0","58","26","32","1","0","1","0","0","0","0","0","0","-2"
"448886","Arizona State University-Downtown Phoenix","2019","On-Tenure track total","67","27","40","0","0","0","11","6","5","1","1","0","7","1","6","0","0","0","28","13","15","4","1","3","10","2","8","6","3","3","-2"
"448886","Arizona State University-Downtown Phoenix","2019","On-tenure track, associate professors","6","3","3","0","0","0","0","0","0","0","0","0","0","0","0","0","0","0","3","1","2","1","1","0","2","1","1","0","0","0","-2"
"448886","Arizona State University-Downtown Phoenix","2019","On-tenure track, assistant professors","61","24","37","0","0","0","11","6","5","1","1","0","7","1","6","0","0","0","25","12","13","3","0","3","8","1","7","6","3","3","-2"
"448886","Arizona State University-Downtown Phoenix","2019","Not on tenure track/No tenure system system total","372","112","260","2","1","1","13","5","8","21","4","17","25","9","16","0","0","0","278","80","198","4","1","3","23","9","14","6","3","3","-2"
"448886","Arizona State University-Downtown Phoenix","2019","Not on tenure/no tenure system, professors","66","22","44","0","0","0","1","1","0","6","1","5","7","2","5","0","0","0","42","14","28","0","0","0","9","3","6","1","1","0","-2"
"448886","Arizona State University-Downtown Phoenix","2019","Not on tenure/no tenure system, associate professors","31","4","27","0","0","0","2","0","2","2","0","2","1","0","1","0","0","0","23","3","20","1","0","1","2","1","1","0","0","0","-2"
"448886","Arizona State University-Downtown Phoenix","2019","Not on tenure/no tenure system, assistant professors","59","14","45","1","1","0","4","2","2","1","0","1","5","2","3","0","0","0","44","7","37","0","0","0","2","1","1","2","1","1","-2"
"448886","Arizona State University-Downtown Phoenix","2019","Not on tenure/no tenure system, instructors","87","32","55","0","0","0","1","1","0","9","3","6","7","2","5","0","0","0","63","23","40","2","1","1","5","2","3","0","0","0","-2"
"448886","Arizona State University-Downtown Phoenix","2019","Not on tenure/no tenure system, lecturers","128","39","89","1","0","1","5","1","4","3","0","3","5","3","2","0","0","0","106","33","73","1","0","1","4","1","3","3","1","2","-2"
"448886","Arizona State University-Downtown Phoenix","2019","Not on tenure/no tenure system, no academic rank","1","1","0","0","0","0","0","0","0","0","0","0","0","0","0","0","0","0","0","0","0","0","0","0","1","1","0","0","0","0","-2"
"449135","Dewey University-Juana Díaz","2019","Not on tenure track/No tenure system system total","12","5","7","0","0","0","0","0","0","0","0","0","12","5","7","0","0","0","0","0","0","0","0","0","0","0","0","0","0","0","-2"
"449135","Dewey University-Juana Díaz","2019","Not on tenure/no tenure system, professors","12","5","7","0","0","0","0","0","0","0","0","0","12","5","7","0","0","0","0","0","0","0","0","0","0","0","0","0","0","0","-2"
"449870","University of the West","2019","Tenured total","7","5","2","0","0","0","6","5","1","1","0","1","0","0","0","0","0","0","0","0","0","0","0","0","0","0","0","0","0","0","-2"
"449870","University of the West","2019","Tenured, professors","5","4","1","0","0","0","5","4","1","0","0","0","0","0","0","0","0","0","0","0","0","0","0","0","0","0","0","0","0","0","-2"
"449870","University of the West","2019","Tenured, associate professors","2","1","1","0","0","0","1","1","0","1","0","1","0","0","0","0","0","0","0","0","0","0","0","0","0","0","0","0","0","0","-2"
"449870","University of the West","2019","On-Tenure track total","4","2","2","0","0","0","0","0","0","2","1","1","0","0","0","0","0","0","1","0","1","1","1","0","0","0","0","0","0","0","-2"
"449870","University of the West","2019","On-tenure track, assistant professors","4","2","2","0","0","0","0","0","0","2","1","1","0","0","0","0","0","0","1","0","1","1","1","0","0","0","0","0","0","0","-2"
"449870","University of the West","2019","Not on tenure track/No tenure system system total","5","2","3","0","0","0","2","1","1","1","0","1","0","0","0","0","0","0","2","1","1","0","0","0","0","0","0","0","0","0","-2"
"449870","University of the West","2019","Not on tenure/no tenure system, assistant professors","3","1","2","0","0","0","2","1","1","1","0","1","0","0","0","0","0","0","0","0","0","0","0","0","0","0","0","0","0","0","-2"
"449870","University of the West","2019","Not on tenure/no tenure system, instructors","2","1","1","0","0","0","0","0","0","0","0","0","0","0","0","0","0","0","2","1","1","0","0","0","0","0","0","0","0","0","-2"
"455770","Providence Christian College","2019","Not on tenure track/No tenure system system total","3","3","0","0","0","0","0","0","0","0","0","0","0","0","0","0","0","0","3","3","0","0","0","0","0","0","0","0","0","0","-2"
"455770","Providence Christian College","2019","Not on tenure/no tenure system, professors","1","1","0","0","0","0","0","0","0","0","0","0","0","0","0","0","0","0","1","1","0","0","0","0","0","0","0","0","0","0","-2"
"455770","Providence Christian College","2019","Not on tenure/no tenure system, associate professors","1","1","0","0","0","0","0","0","0","0","0","0","0","0","0","0","0","0","1","1","0","0","0","0","0","0","0","0","0","0","-2"
"455770","Providence Christian College","2019","Not on tenure/no tenure system, instructors","1","1","0","0","0","0","0","0","0","0","0","0","0","0","0","0","0","0","1","1","0","0","0","0","0","0","0","0","0","0","-2"
"456490","Polytechnic University of Puerto Rico-Orlando","2019","Not on tenure track/No tenure system system total","8","7","1","0","0","0","0","0","0","0","0","0","8","7","1","0","0","0","0","0","0","0","0","0","0","0","0","0","0","0","-2"
"456490","Polytechnic University of Puerto Rico-Orlando","2019","Not on tenure/no tenure system, professors","1","0","1","0","0","0","0","0","0","0","0","0","1","0","1","0","0","0","0","0","0","0","0","0","0","0","0","0","0","0","-2"
"456490","Polytechnic University of Puerto Rico-Orlando","2019","Not on tenure/no tenure system, associate professors","7","7","0","0","0","0","0","0","0","0","0","0","7","7","0","0","0","0","0","0","0","0","0","0","0","0","0","0","0","0","-2"
"459949","Texas A&M University-San Antonio","2019","Tenured total","49","28","21","0","0","0","5","5","0","1","0","1","7","5","2","0","0","0","34","17","17","0","0","0","0","0","0","2","1","1","-2"
"459949","Texas A&M University-San Antonio","2019","Tenured, professors","17","11","6","0","0","0","3","3","0","0","0","0","3","2","1","0","0","0","11","6","5","0","0","0","0","0","0","0","0","0","-2"
"459949","Texas A&M University-San Antonio","2019","Tenured, associate professors","32","17","15","0","0","0","2","2","0","1","0","1","4","3","1","0","0","0","23","11","12","0","0","0","0","0","0","2","1","1","-2"
"459949","Texas A&M University-San Antonio","2019","On-Tenure track total","74","37","37","1","0","1","9","6","3","2","1","1","16","4","12","0","0","0","32","16","16","0","0","0","1","1","0","13","9","4","-2"
"459949","Texas A&M University-San Antonio","2019","On-tenure track, associate professors","12","2","10","0","0","0","2","1","1","0","0","0","2","0","2","0","0","0","7","1","6","0","0","0","0","0","0","1","0","1","-2"
"459949","Texas A&M University-San Antonio","2019","On-tenure track, assistant professors","62","35","27","1","0","1","7","5","2","2","1","1","14","4","10","0","0","0","25","15","10","0","0","0","1","1","0","12","9","3","-2"
"459949","Texas A&M University-San Antonio","2019","Not on tenure track/No tenure system system total","59","28","31","0","0","0","1","1","0","5","2","3","9","5","4","0","0","0","37","16","21","0","0","0","2","1","1","5","3","2","-2"
"459949","Texas A&M University-San Antonio","2019","Not on tenure/no tenure system, instructors","19","12","7","0","0","0","0","0","0","0","0","0","4","3","1","0","0","0","13","7","6","0","0","0","1","1","0","1","1","0","-2"
"459949","Texas A&M University-San Antonio","2019","Not on tenure/no tenure system, lecturers","40","16","24","0","0","0","1","1","0","5","2","3","5","2","3","0","0","0","24","9","15","0","0","0","1","0","1","4","2","2","-2"
"462354","John Paul the Great Catholic University","2019","Not on tenure track/No tenure system system total","11","9","2","0","0","0","1","0","1","0","0","0","0","0","0","0","0","0","10","9","1","0","0","0","0","0","0","0","0","0","-2"
"462354","John Paul the Great Catholic University","2019","Not on tenure/no tenure system, professors","11","9","2","0","0","0","1","0","1","0","0","0","0","0","0","0","0","0","10","9","1","0","0","0","0","0","0","0","0","0","-2"
"464226","Ottawa University-Surprise","2019","Tenured total","2","1","1","0","0","0","1","0","1","0","0","0","0","0","0","0","0","0","1","1","0","0","0","0","0","0","0","0","0","0","-2"
"464226","Ottawa University-Surprise","2019","Tenured, professors","1","0","1","0","0","0","1","0","1","0","0","0","0","0","0","0","0","0","0","0","0","0","0","0","0","0","0","0","0","0","-2"
"464226","Ottawa University-Surprise","2019","Tenured, associate professors","1","1","0","0","0","0","0","0","0","0","0","0","0","0","0","0","0","0","1","1","0","0","0","0","0","0","0","0","0","0","-2"
"464226","Ottawa University-Surprise","2019","Not on tenure track/No tenure system system total","8","2","6","0","0","0","1","0","1","0","0","0","0","0","0","0","0","0","6","2","4","1","0","1","0","0","0","0","0","0","-2"
"464226","Ottawa University-Surprise","2019","Not on tenure/no tenure system, professors","1","0","1","0","0","0","0","0","0","0","0","0","0","0","0","0","0","0","1","0","1","0","0","0","0","0","0","0","0","0","-2"
"464226","Ottawa University-Surprise","2019","Not on tenure/no tenure system, associate professors","1","1","0","0","0","0","0","0","0","0","0","0","0","0","0","0","0","0","1","1","0","0","0","0","0","0","0","0","0","0","-2"
"464226","Ottawa University-Surprise","2019","Not on tenure/no tenure system, assistant professors","5","1","4","0","0","0","1","0","1","0","0","0","0","0","0","0","0","0","3","1","2","1","0","1","0","0","0","0","0","0","-2"
"464226","Ottawa University-Surprise","2019","Not on tenure/no tenure system, instructors","1","0","1","0","0","0","0","0","0","0","0","0","0","0","0","0","0","0","1","0","1","0","0","0","0","0","0","0","0","0","-2"
"469416","Dewey University-Manati","2019","Not on tenure track/No tenure system system total","27","12","15","0","0","0","0","0","0","0","0","0","27","12","15","0","0","0","0","0","0","0","0","0","0","0","0","0","0","0","-2"
"469416","Dewey University-Manati","2019","Not on tenure/no tenure system, professors","27","12","15","0","0","0","0","0","0","0","0","0","27","12","15","0","0","0","0","0","0","0","0","0","0","0","0","0","0","0","-2"
"474863","Los Angeles Pacific University","2019","Not on tenure track/No tenure system system total","11","6","5","0","0","0","2","0","2","2","1","1","1","1","0","0","0","0","6","4","2","0","0","0","0","0","0","0","0","0","-2"
"474863","Los Angeles Pacific University","2019","Not on tenure/no tenure system, lecturers","11","6","5","0","0","0","2","0","2","2","1","1","1","1","0","0","0","0","6","4","2","0","0","0","0","0","0","0","0","0","-2"
"475273","Springfield College-Regional, Online, and Continuing Education","2019","Tenured total","4","2","2","0","0","0","0","0","0","2","1","1","0","0","0","0","0","0","2","1","1","0","0","0","0","0","0","0","0","0","-2"
"475273","Springfield College-Regional, Online, and Continuing Education","2019","Tenured, professors","4","2","2","0","0","0","0","0","0","2","1","1","0","0","0","0","0","0","2","1","1","0","0","0","0","0","0","0","0","0","-2"
"475273","Springfield College-Regional, Online, and Continuing Education","2019","On-Tenure track total","2","0","2","0","0","0","0","0","0","1","0","1","0","0","0","0","0","0","1","0","1","0","0","0","0","0","0","0","0","0","-2"
"475273","Springfield College-Regional, Online, and Continuing Education","2019","On-tenure track, associate professors","1","0","1","0","0","0","0","0","0","1","0","1","0","0","0","0","0","0","0","0","0","0","0","0","0","0","0","0","0","0","-2"
"475273","Springfield College-Regional, Online, and Continuing Education","2019","On-tenure track, assistant professors","1","0","1","0","0","0","0","0","0","0","0","0","0","0","0","0","0","0","1","0","1","0","0","0","0","0","0","0","0","0","-2"
"475273","Springfield College-Regional, Online, and Continuing Education","2019","Not on tenure track/No tenure system system total","8","4","4","0","0","0","0","0","0","3","2","1","0","0","0","0","0","0","4","2","2","0","0","0","1","0","1","0","0","0","-2"
"475273","Springfield College-Regional, Online, and Continuing Education","2019","Not on tenure/no tenure system, professors","3","2","1","0","0","0","0","0","0","1","1","0","0","0","0","0","0","0","2","1","1","0","0","0","0","0","0","0","0","0","-2"
"475273","Springfield College-Regional, Online, and Continuing Education","2019","Not on tenure/no tenure system, assistant professors","5","2","3","0","0","0","0","0","0","2","1","1","0","0","0","0","0","0","2","1","1","0","0","0","1","0","1","0","0","0","-2"
"478634","California College San Diego","2019","Not on tenure track/No tenure system system total","3","2","1","0","0","0","0","0","0","0","0","0","2","1","1","0","0","0","1","1","0","0","0","0","0","0","0","0","0","0","-2"
"478634","California College San Diego","2019","Not on tenure/no tenure system, no academic rank","3","2","1","0","0","0","0","0","0","0","0","0","2","1","1","0","0","0","1","1","0","0","0","0","0","0","0","0","0","0","-2"
"483036","Texas A&M University-Central Texas","2019","Tenured total","22","12","10","0","0","0","1","0","1","1","0","1","0","0","0","0","0","0","20","12","8","0","0","0","0","0","0","0","0","0","-2"
"483036","Texas A&M University-Central Texas","2019","Tenured, professors","5","5","0","0","0","0","0","0","0","0","0","0","0","0","0","0","0","0","5","5","0","0","0","0","0","0","0","0","0","0","-2"
"483036","Texas A&M University-Central Texas","2019","Tenured, associate professors","17","7","10","0","0","0","1","0","1","1","0","1","0","0","0","0","0","0","15","7","8","0","0","0","0","0","0","0","0","0","-2"
"483036","Texas A&M University-Central Texas","2019","On-Tenure track total","41","22","19","0","0","0","1","0","1","4","2","2","4","0","4","0","0","0","23","15","8","1","0","1","2","0","2","6","5","1","-2"
"483036","Texas A&M University-Central Texas","2019","On-tenure track, associate professors","4","1","3","0","0","0","0","0","0","0","0","0","0","0","0","0","0","0","3","1","2","1","0","1","0","0","0","0","0","0","-2"
"483036","Texas A&M University-Central Texas","2019","On-tenure track, assistant professors","35","20","15","0","0","0","1","0","1","4","2","2","3","0","3","0","0","0","19","13","6","0","0","0","2","0","2","6","5","1","-2"
"483036","Texas A&M University-Central Texas","2019","On-tenure track, lecturers","2","1","1","0","0","0","0","0","0","0","0","0","1","0","1","0","0","0","1","1","0","0","0","0","0","0","0","0","0","0","-2"
"483036","Texas A&M University-Central Texas","2019","Not on tenure track/No tenure system system total","24","8","16","0","0","0","1","0","1","2","1","1","3","0","3","0","0","0","15","5","10","0","0","0","1","0","1","2","2","0","-2"
"483036","Texas A&M University-Central Texas","2019","Not on tenure/no tenure system, associate professors","2","0","2","0","0","0","1","0","1","0","0","0","0","0","0","0","0","0","1","0","1","0","0","0","0","0","0","0","0","0","-2"
"483036","Texas A&M University-Central Texas","2019","Not on tenure/no tenure system, assistant professors","6","3","3","0","0","0","0","0","0","0","0","0","0","0","0","0","0","0","3","1","2","0","0","0","1","0","1","2","2","0","-2"
"483036","Texas A&M University-Central Texas","2019","Not on tenure/no tenure system, instructors","1","0","1","0","0","0","0","0","0","0","0","0","0","0","0","0","0","0","1","0","1","0","0","0","0","0","0","0","0","0","-2"
"483036","Texas A&M University-Central Texas","2019","Not on tenure/no tenure system, lecturers","15","5","10","0","0","0","0","0","0","2","1","1","3","0","3","0","0","0","10","4","6","0","0","0","0","0","0","0","0","0","-2"
"483595","Universidad Ana G. Mendez-Online Campus","2019","Not on tenure track/No tenure system system total","1","1","0","0","0","0","0","0","0","0","0","0","1","1","0","0","0","0","0","0","0","0","0","0","0","0","0","0","0","0","-2"
"483595","Universidad Ana G. Mendez-Online Campus","2019","Not on tenure/no tenure system, assistant professors","1","1","0","0","0","0","0","0","0","0","0","0","1","1","0","0","0","0","0","0","0","0","0","0","0","0","0","0","0","0","-2"
"484905","University of North Texas at Dallas","2019","Tenured total","25","13","12","0","0","0","7","5","2","1","0","1","4","3","1","0","0","0","12","5","7","0","0","0","0","0","0","1","0","1","-2"
"484905","University of North Texas at Dallas","2019","Tenured, professors","9","4","5","0","0","0","2","2","0","1","0","1","2","1","1","0","0","0","4","1","3","0","0","0","0","0","0","0","0","0","-2"
"484905","University of North Texas at Dallas","2019","Tenured, associate professors","16","9","7","0","0","0","5","3","2","0","0","0","2","2","0","0","0","0","8","4","4","0","0","0","0","0","0","1","0","1","-2"
"484905","University of North Texas at Dallas","2019","On-Tenure track total","33","17","16","0","0","0","2","0","2","6","5","1","2","1","1","0","0","0","22","11","11","0","0","0","1","0","1","0","0","0","-2"
"484905","University of North Texas at Dallas","2019","On-tenure track, associate professors","3","2","1","0","0","0","0","0","0","1","1","0","0","0","0","0","0","0","2","1","1","0","0","0","0","0","0","0","0","0","-2"
"484905","University of North Texas at Dallas","2019","On-tenure track, assistant professors","30","15","15","0","0","0","2","0","2","5","4","1","2","1","1","0","0","0","20","10","10","0","0","0","1","0","1","0","0","0","-2"
"484905","University of North Texas at Dallas","2019","Not on tenure track/No tenure system system total","57","24","33","1","1","0","2","2","0","12","4","8","6","0","6","0","0","0","35","17","18","0","0","0","1","0","1","0","0","0","-2"
"484905","University of North Texas at Dallas","2019","Not on tenure/no tenure system, professors","1","1","0","0","0","0","0","0","0","0","0","0","0","0","0","0","0","0","1","1","0","0","0","0","0","0","0","0","0","0","-2"
"484905","University of North Texas at Dallas","2019","Not on tenure/no tenure system, assistant professors","3","1","2","0","0","0","0","0","0","2","1","1","0","0","0","0","0","0","1","0","1","0","0","0","0","0","0","0","0","0","-2"
"484905","University of North Texas at Dallas","2019","Not on tenure/no tenure system, instructors","10","3","7","0","0","0","0","0","0","2","0","2","2","0","2","0","0","0","6","3","3","0","0","0","0","0","0","0","0","0","-2"
"484905","University of North Texas at Dallas","2019","Not on tenure/no tenure system, lecturers","43","19","24","1","1","0","2","2","0","8","3","5","4","0","4","0","0","0","27","13","14","0","0","0","1","0","1","0","0","0","-2"
"485263","California College San Diego","2019","Not on tenure track/No tenure system system total","14","7","7","1","1","0","2","1","1","0","0","0","3","2","1","1","1","0","7","2","5","0","0","0","0","0","0","0","0","0","-2"
"485263","California College San Diego","2019","Not on tenure/no tenure system, no academic rank","14","7","7","1","1","0","2","1","1","0","0","0","3","2","1","1","1","0","7","2","5","0","0","0","0","0","0","0","0","0","-2"
"487296","University of Arizona-Sierra Vista","2019","Tenured total","3","1","2","0","0","0","1","0","1","0","0","0","0","0","0","0","0","0","2","1","1","0","0","0","0","0","0","0","0","0","-2"
"487296","University of Arizona-Sierra Vista","2019","Tenured, professors","2","0","2","0","0","0","1","0","1","0","0","0","0","0","0","0","0","0","1","0","1","0","0","0","0","0","0","0","0","0","-2"
"487296","University of Arizona-Sierra Vista","2019","Tenured, associate professors","1","1","0","0","0","0","0","0","0","0","0","0","0","0","0","0","0","0","1","1","0","0","0","0","0","0","0","0","0","0","-2"
"487296","University of Arizona-Sierra Vista","2019","On-Tenure track total","1","0","1","1","0","1","0","0","0","0","0","0","0","0","0","0","0","0","0","0","0","0","0","0","0","0","0","0","0","0","-2"
"487296","University of Arizona-Sierra Vista","2019","On-tenure track, assistant professors","1","0","1","1","0","1","0","0","0","0","0","0","0","0","0","0","0","0","0","0","0","0","0","0","0","0","0","0","0","0","-2"
"487296","University of Arizona-Sierra Vista","2019","Not on tenure track/No tenure system system total","15","7","8","0","0","0","0","0","0","0","0","0","3","1","2","0","0","0","11","5","6","0","0","0","1","1","0","0","0","0","-2"
"487296","University of Arizona-Sierra Vista","2019","Not on tenure/no tenure system, professors","1","1","0","0","0","0","0","0","0","0","0","0","0","0","0","0","0","0","1","1","0","0","0","0","0","0","0","0","0","0","-2"
"487296","University of Arizona-Sierra Vista","2019","Not on tenure/no tenure system, assistant professors","13","6","7","0","0","0","0","0","0","0","0","0","3","1","2","0","0","0","9","4","5","0","0","0","1","1","0","0","0","0","-2"
"487296","University of Arizona-Sierra Vista","2019","Not on tenure/no tenure system, lecturers","1","0","1","0","0","0","0","0","0","0","0","0","0","0","0","0","0","0","1","0","1","0","0","0","0","0","0","0","0","0","-2"
"488785","University of Saint Katherine","2019","Not on tenure track/No tenure system system total","5","3","2","0","0","0","0","0","0","0","0","0","0","0","0","0","0","0","5","3","2","0","0","0","0","0","0","0","0","0","-2"
"488785","University of Saint Katherine","2019","Not on tenure/no tenure system, assistant professors","5","3","2","0","0","0","0","0","0","0","0","0","0","0","0","0","0","0","5","3","2","0","0","0","0","0","0","0","0","0","-2"
"492689","Texas Tech University Health Sciences Center-El Paso","2019","Tenured total","30","24","6","0","0","0","9","7","2","0","0","0","2","1","1","0","0","0","19","16","3","0","0","0","0","0","0","0","0","0","-2"
"492689","Texas Tech University Health Sciences Center-El Paso","2019","Tenured, professors","21","18","3","0","0","0","5","4","1","0","0","0","1","1","0","0","0","0","15","13","2","0","0","0","0","0","0","0","0","0","-2"
"492689","Texas Tech University Health Sciences Center-El Paso","2019","Tenured, associate professors","8","6","2","0","0","0","4","3","1","0","0","0","0","0","0","0","0","0","4","3","1","0","0","0","0","0","0","0","0","0","-2"
"492689","Texas Tech University Health Sciences Center-El Paso","2019","Tenured, no academic rank","1","0","1","0","0","0","0","0","0","0","0","0","1","0","1","0","0","0","0","0","0","0","0","0","0","0","0","0","0","0","-2"
"492689","Texas Tech University Health Sciences Center-El Paso","2019","On-Tenure track total","17","9","8","0","0","0","6","3","3","0","0","0","6","5","1","0","0","0","5","1","4","0","0","0","0","0","0","0","0","0","-2"
"492689","Texas Tech University Health Sciences Center-El Paso","2019","On-tenure track, professors","2","2","0","0","0","0","1","1","0","0","0","0","0","0","0","0","0","0","1","1","0","0","0","0","0","0","0","0","0","0","-2"
"492689","Texas Tech University Health Sciences Center-El Paso","2019","On-tenure track, associate professors","8","5","3","0","0","0","4","2","2","0","0","0","3","3","0","0","0","0","1","0","1","0","0","0","0","0","0","0","0","0","-2"
"492689","Texas Tech University Health Sciences Center-El Paso","2019","On-tenure track, assistant professors","7","2","5","0","0","0","1","0","1","0","0","0","3","2","1","0","0","0","3","0","3","0","0","0","0","0","0","0","0","0","-2"
"492689","Texas Tech University Health Sciences Center-El Paso","2019","Not on tenure track/No tenure system system total","237","120","117","0","0","0","29","12","17","13","4","9","80","38","42","0","0","0","79","41","38","2","2","0","0","0","0","34","23","11","-2"
"492689","Texas Tech University Health Sciences Center-El Paso","2019","Not on tenure/no tenure system, professors","11","5","6","0","0","0","1","0","1","1","0","1","1","1","0","0","0","0","8","4","4","0","0","0","0","0","0","0","0","0","-2"
"492689","Texas Tech University Health Sciences Center-El Paso","2019","Not on tenure/no tenure system, associate professors","31","22","9","0","0","0","5","2","3","4","1","3","8","6","2","0","0","0","13","12","1","0","0","0","0","0","0","1","1","0","-2"
"492689","Texas Tech University Health Sciences Center-El Paso","2019","Not on tenure/no tenure system, assistant professors","162","83","79","0","0","0","21","9","12","7","3","4","47","23","24","0","0","0","52","24","28","2","2","0","0","0","0","33","22","11","-2"
"492689","Texas Tech University Health Sciences Center-El Paso","2019","Not on tenure/no tenure system, instructors","13","3","10","0","0","0","2","1","1","1","0","1","10","2","8","0","0","0","0","0","0","0","0","0","0","0","0","0","0","0","-2"
"492689","Texas Tech University Health Sciences Center-El Paso","2019","Not on tenure/no tenure system, lecturers","20","7","13","0","0","0","0","0","0","0","0","0","14","6","8","0","0","0","6","1","5","0","0","0","0","0","0","0","0","0","-2"
"494278","EDP University of Puerto Rico-Humacao","2019","Not on tenure track/No tenure system system total","4","1","3","0","0","0","0","0","0","0","0","0","4","1","3","0","0","0","0","0","0","0","0","0","0","0","0","0","0","0","-2"
"494278","EDP University of Puerto Rico-Humacao","2019","Not on tenure/no tenure system, instructors","4","1","3","0","0","0","0","0","0","0","0","0","4","1","3","0","0","0","0","0","0","0","0","0","0","0","0","0","0","0","-2"
"494287","EDP University of Puerto Rico-Manati","2019","Not on tenure track/No tenure system system total","7","0","7","0","0","0","0","0","0","0","0","0","7","0","7","0","0","0","0","0","0","0","0","0","0","0","0","0","0","0","-2"
"494287","EDP University of Puerto Rico-Manati","2019","Not on tenure/no tenure system, instructors","7","0","7","0","0","0","0","0","0","0","0","0","7","0","7","0","0","0","0","0","0","0","0","0","0","0","0","0","0","0","-2"
