"unitid","institution name","year","S2015_IS.Instructional staff category","S2015_IS_RV.Grand total","S2015_IS_RV.Grand total men","S2015_IS_RV.Grand total women","S2015_IS_RV.American Indian or Alaska Native total","S2015_IS_RV.American Indian or Alaska Native men","S2015_IS_RV.American Indian or Alaska Native women","S2015_IS_RV.Asian total","S2015_IS_RV.Asian men","S2015_IS_RV.Asian women","S2015_IS_RV.Black or African American total","S2015_IS_RV.Black or African American men","S2015_IS_RV.Black or African American women","S2015_IS_RV.Hispanic or Latino total","S2015_IS_RV.Hispanic or Latino men","S2015_IS_RV.Hispanic or Latino women","S2015_IS_RV.Native Hawaiian or Other Pacific Islander total","S2015_IS_RV.Native Hawaiian or Other Pacific Islander men","S2015_IS_RV.Native Hawaiian or Other Pacific Islander women","S2015_IS_RV.White total","S2015_IS_RV.White men","S2015_IS_RV.White women","S2015_IS_RV.Two or more races total","S2015_IS_RV.Two or more races men","S2015_IS_RV.Two or more races women","S2015_IS_RV.Race/ethnicity unknown total","S2015_IS_RV.Race/ethnicity unknown men","S2015_IS_RV.Race/ethnicity unknown women","S2015_IS_RV.Nonresident alien total","S2015_IS_RV.Nonresident alien men","S2015_IS_RV.Nonresident alien women","IDX_HR"
"104188","Southwest University of Visual Arts-Tucson","2015","Not on tenure track/No tenure system system total","11","7","4","0","0","0","0","0","0","0","0","0","2","2","0","0","0","0","9","5","4","0","0","0","0","0","0","0","0","0","-2"
"104188","Southwest University of Visual Arts-Tucson","2015","Not on tenure/no tenure system, professors","9","5","4","0","0","0","0","0","0","0","0","0","1","1","0","0","0","0","8","4","4","0","0","0","0","0","0","0","0","0","-2"
"104188","Southwest University of Visual Arts-Tucson","2015","Not on tenure/no tenure system, no academic rank","2","2","0","0","0","0","0","0","0","0","0","0","1","1","0","0","0","0","1","1","0","0","0","0","0","0","0","0","0","0","-2"
"105367","Ottawa University-Phoenix","2015","Tenured total","3","0","3","0","0","0","1","0","1","0","0","0","0","0","0","0","0","0","2","0","2","0","0","0","0","0","0","0","0","0","-2"
"105367","Ottawa University-Phoenix","2015","Tenured, professors","2","0","2","0","0","0","1","0","1","0","0","0","0","0","0","0","0","0","1","0","1","0","0","0","0","0","0","0","0","0","-2"
"105367","Ottawa University-Phoenix","2015","Tenured, associate professors","1","0","1","0","0","0","0","0","0","0","0","0","0","0","0","0","0","0","1","0","1","0","0","0","0","0","0","0","0","0","-2"
"105367","Ottawa University-Phoenix","2015","Not on tenure track/No tenure system system total","4","1","3","0","0","0","0","0","0","0","0","0","2","0","2","0","0","0","2","1","1","0","0","0","0","0","0","0","0","0","-2"
"105367","Ottawa University-Phoenix","2015","Not on tenure/no tenure system, associate professors","1","0","1","0","0","0","0","0","0","0","0","0","1","0","1","0","0","0","0","0","0","0","0","0","0","0","0","0","0","0","-2"
"105367","Ottawa University-Phoenix","2015","Not on tenure/no tenure system, assistant professors","2","1","1","0","0","0","0","0","0","0","0","0","1","0","1","0","0","0","1","1","0","0","0","0","0","0","0","0","0","0","-2"
"105367","Ottawa University-Phoenix","2015","Not on tenure/no tenure system, instructors","1","0","1","0","0","0","0","0","0","0","0","0","0","0","0","0","0","0","1","0","1","0","0","0","0","0","0","0","0","0","-2"
"109350","Antelope Valley College","2015","Tenured total","145","75","70","1","1","0","8","6","2","11","4","7","14","8","6","0","0","0","107","53","54","0","0","0","4","3","1","0","0","0","-2"
"109350","Antelope Valley College","2015","Tenured, professors","73","29","44","1","1","0","2","1","1","5","1","4","8","3","5","0","0","0","56","22","34","0","0","0","1","1","0","0","0","0","-2"
"109350","Antelope Valley College","2015","Tenured, associate professors","16","11","5","0","0","0","2","1","1","0","0","0","2","2","0","0","0","0","11","7","4","0","0","0","1","1","0","0","0","0","-2"
"109350","Antelope Valley College","2015","Tenured, assistant professors","5","2","3","0","0","0","1","1","0","0","0","0","0","0","0","0","0","0","4","1","3","0","0","0","0","0","0","0","0","0","-2"
"109350","Antelope Valley College","2015","Tenured, instructors","51","33","18","0","0","0","3","3","0","6","3","3","4","3","1","0","0","0","36","23","13","0","0","0","2","1","1","0","0","0","-2"
"109350","Antelope Valley College","2015","On-Tenure track total","25","16","9","1","1","0","3","2","1","1","1","0","3","1","2","0","0","0","17","11","6","0","0","0","0","0","0","0","0","0","-2"
"109350","Antelope Valley College","2015","On-tenure track, instructors","25","16","9","1","1","0","3","2","1","1","1","0","3","1","2","0","0","0","17","11","6","0","0","0","0","0","0","0","0","0","-2"
"109785","Azusa Pacific University","2015","Not on tenure track/No tenure system system total","442","208","234","4","2","2","56","21","35","28","11","17","30","14","16","5","2","3","289","143","146","0","0","0","28","15","13","2","0","2","-2"
"109785","Azusa Pacific University","2015","Not on tenure/no tenure system, professors","138","87","51","0","0","0","15","9","6","8","6","2","4","2","2","0","0","0","101","63","38","0","0","0","10","7","3","0","0","0","-2"
"109785","Azusa Pacific University","2015","Not on tenure/no tenure system, associate professors","114","56","58","2","1","1","16","8","8","11","2","9","8","4","4","1","0","1","70","38","32","0","0","0","5","3","2","1","0","1","-2"
"109785","Azusa Pacific University","2015","Not on tenure/no tenure system, assistant professors","172","63","109","2","1","1","25","4","21","9","3","6","16","7","9","2","2","0","105","41","64","0","0","0","12","5","7","1","0","1","-2"
"109785","Azusa Pacific University","2015","Not on tenure/no tenure system, instructors","18","2","16","0","0","0","0","0","0","0","0","0","2","1","1","2","0","2","13","1","12","0","0","0","1","0","1","0","0","0","-2"
"109819","Bakersfield College","2015","Tenured total","190","100","90","2","1","1","6","2","4","9","5","4","19","8","11","1","1","0","140","78","62","0","0","0","13","5","8","0","0","0","-2"
"109819","Bakersfield College","2015","Tenured, instructors","190","100","90","2","1","1","6","2","4","9","5","4","19","8","11","1","1","0","140","78","62","0","0","0","13","5","8","0","0","0","-2"
"109819","Bakersfield College","2015","On-Tenure track total","73","37","36","1","1","0","7","5","2","1","1","0","13","5","8","0","0","0","51","25","26","0","0","0","0","0","0","0","0","0","-2"
"109819","Bakersfield College","2015","On-tenure track, instructors","73","37","36","1","1","0","7","5","2","1","1","0","13","5","8","0","0","0","51","25","26","0","0","0","0","0","0","0","0","0","-2"
"109819","Bakersfield College","2015","Not on tenure track/No tenure system system total","21","8","13","1","1","0","0","0","0","1","0","1","7","3","4","0","0","0","12","4","8","0","0","0","0","0","0","0","0","0","-2"
"109819","Bakersfield College","2015","Not on tenure/no tenure system, instructors","21","8","13","1","1","0","0","0","0","1","0","1","7","3","4","0","0","0","12","4","8","0","0","0","0","0","0","0","0","0","-2"
"110361","California Baptist University","2015","Tenured total","77","47","30","0","0","0","8","6","2","1","0","1","3","1","2","0","0","0","61","38","23","4","2","2","0","0","0","0","0","0","-2"
"110361","California Baptist University","2015","Tenured, professors","55","39","16","0","0","0","7","6","1","0","0","0","1","0","1","0","0","0","44","31","13","3","2","1","0","0","0","0","0","0","-2"
"110361","California Baptist University","2015","Tenured, associate professors","22","8","14","0","0","0","1","0","1","1","0","1","2","1","1","0","0","0","17","7","10","1","0","1","0","0","0","0","0","0","-2"
"110361","California Baptist University","2015","On-Tenure track total","175","94","81","1","0","1","26","15","11","6","4","2","12","6","6","1","0","1","119","66","53","4","1","3","6","2","4","0","0","0","-2"
"110361","California Baptist University","2015","On-tenure track, professors","10","8","2","0","0","0","3","3","0","0","0","0","0","0","0","0","0","0","7","5","2","0","0","0","0","0","0","0","0","0","-2"
"110361","California Baptist University","2015","On-tenure track, associate professors","44","29","15","0","0","0","9","6","3","2","1","1","4","2","2","0","0","0","26","20","6","2","0","2","1","0","1","0","0","0","-2"
"110361","California Baptist University","2015","On-tenure track, assistant professors","121","57","64","1","0","1","14","6","8","4","3","1","8","4","4","1","0","1","86","41","45","2","1","1","5","2","3","0","0","0","-2"
"110361","California Baptist University","2015","Not on tenure track/No tenure system system total","27","8","19","0","0","0","1","0","1","2","0","2","3","0","3","0","0","0","21","8","13","0","0","0","0","0","0","0","0","0","-2"
"110361","California Baptist University","2015","Not on tenure/no tenure system, professors","9","3","6","0","0","0","0","0","0","0","0","0","2","0","2","0","0","0","7","3","4","0","0","0","0","0","0","0","0","0","-2"
"110361","California Baptist University","2015","Not on tenure/no tenure system, lecturers","18","5","13","0","0","0","1","0","1","2","0","2","1","0","1","0","0","0","14","5","9","0","0","0","0","0","0","0","0","0","-2"
"110413","California Lutheran University","2015","Tenured total","84","48","36","0","0","0","8","3","5","4","2","2","4","2","2","0","0","0","67","41","26","0","0","0","0","0","0","1","0","1","-2"
"110413","California Lutheran University","2015","Tenured, professors","47","29","18","0","0","0","4","2","2","3","2","1","1","1","0","0","0","0","39","24","15","0","0","0","0","0","0","0","0","0","-2"
"110413","California Lutheran University","2015","Tenured, associate professors","33","17","16","0","0","0","4","1","3","1","0","1","1","0","1","0","0","0","26","16","10","0","0","0","0","0","0","1","0","1","-2"
"110413","California Lutheran University","2015","Tenured, assistant professors","4","2","2","0","0","0","0","0","0","0","0","0","2","1","1","0","0","0","2","1","1","0","0","0","0","0","0","0","0","0","-2"
"110413","California Lutheran University","2015","On-Tenure track total","50","24","26","0","0","0","2","1","1","1","0","1","7","2","5","0","0","0","37","19","18","1","1","0","1","0","1","1","1","0","-2"
"110413","California Lutheran University","2015","On-tenure track, professors","3","3","0","0","0","0","0","0","0","0","0","0","0","0","0","0","0","0","3","3","0","0","0","0","0","0","0","0","0","0","-2"
"110413","California Lutheran University","2015","On-tenure track, associate professors","7","4","3","0","0","0","0","0","0","0","0","0","1","1","0","0","0","0","6","3","3","0","0","0","0","0","0","0","0","0","-2"
"110413","California Lutheran University","2015","On-tenure track, assistant professors","40","17","23","0","0","0","2","1","1","1","0","1","6","1","5","0","0","0","28","13","15","1","1","0","1","0","1","1","1","0","-2"
"110413","California Lutheran University","2015","Not on tenure track/No tenure system system total","48","25","23","0","0","0","1","0","1","1","0","1","0","0","0","0","0","0","46","25","21","0","0","0","0","0","0","0","0","0","-2"
"110413","California Lutheran University","2015","Not on tenure/no tenure system, professors","5","3","2","0","0","0","0","0","0","0","0","0","0","0","0","0","0","0","5","3","2","0","0","0","0","0","0","0","0","0","-2"
"110413","California Lutheran University","2015","Not on tenure/no tenure system, associate professors","1","0","1","0","0","0","0","0","0","0","0","0","0","0","0","0","0","0","1","0","1","0","0","0","0","0","0","0","0","0","-2"
"110413","California Lutheran University","2015","Not on tenure/no tenure system, assistant professors","6","3","3","0","0","0","0","0","0","0","0","0","0","0","0","0","0","0","6","3","3","0","0","0","0","0","0","0","0","0","-2"
"110413","California Lutheran University","2015","Not on tenure/no tenure system, instructors","3","3","0","0","0","0","0","0","0","0","0","0","0","0","0","0","0","0","3","3","0","0","0","0","0","0","0","0","0","0","-2"
"110413","California Lutheran University","2015","Not on tenure/no tenure system, lecturers","33","16","17","0","0","0","1","0","1","1","0","1","0","0","0","0","0","0","31","16","15","0","0","0","0","0","0","0","0","0","-2"
"110486","California State University-Bakersfield","2015","Tenured total","130","75","55","0","0","0","19","14","5","8","4","4","16","11","5","1","1","0","77","38","39","2","0","2","3","3","0","4","4","0","-2"
"110486","California State University-Bakersfield","2015","Tenured, professors","75","52","23","0","0","0","13","11","2","5","3","2","6","5","1","1","1","0","45","28","17","1","0","1","1","1","0","3","3","0","-2"
"110486","California State University-Bakersfield","2015","Tenured, associate professors","53","22","31","0","0","0","5","2","3","3","1","2","10","6","4","0","0","0","31","10","21","1","0","1","2","2","0","1","1","0","-2"
"110486","California State University-Bakersfield","2015","Tenured, assistant professors","2","1","1","0","0","0","1","1","0","0","0","0","0","0","0","0","0","0","1","0","1","0","0","0","0","0","0","0","0","0","-2"
"110486","California State University-Bakersfield","2015","On-Tenure track total","48","27","21","0","0","0","4","3","1","0","0","0","8","4","4","0","0","0","24","12","12","0","0","0","2","2","0","10","6","4","-2"
"110486","California State University-Bakersfield","2015","On-tenure track, associate professors","1","0","1","0","0","0","1","0","1","0","0","0","0","0","0","0","0","0","0","0","0","0","0","0","0","0","0","0","0","0","-2"
"110486","California State University-Bakersfield","2015","On-tenure track, assistant professors","47","27","20","0","0","0","3","3","0","0","0","0","8","4","4","0","0","0","24","12","12","0","0","0","2","2","0","10","6","4","-2"
"110486","California State University-Bakersfield","2015","Not on tenure track/No tenure system system total","90","37","53","1","0","1","6","3","3","1","0","1","13","6","7","1","0","1","60","23","37","1","1","0","2","0","2","5","4","1","-2"
"110486","California State University-Bakersfield","2015","Not on tenure/no tenure system, lecturers","90","37","53","1","0","1","6","3","3","1","0","1","13","6","7","1","0","1","60","23","37","1","1","0","2","0","2","5","4","1","-2"
"110495","California State University-Stanislaus","2015","Tenured total","164","89","75","1","0","1","25","7","18","6","4","2","15","9","6","0","0","0","110","65","45","0","0","0","7","4","3","0","0","0","-2"
"110495","California State University-Stanislaus","2015","Tenured, professors","119","68","51","1","0","1","16","5","11","2","2","0","12","7","5","0","0","0","82","50","32","0","0","0","6","4","2","0","0","0","-2"
"110495","California State University-Stanislaus","2015","Tenured, associate professors","44","20","24","0","0","0","9","2","7","4","2","2","3","2","1","0","0","0","27","14","13","0","0","0","1","0","1","0","0","0","-2"
"110495","California State University-Stanislaus","2015","Tenured, assistant professors","1","1","0","0","0","0","0","0","0","0","0","0","0","0","0","0","0","0","1","1","0","0","0","0","0","0","0","0","0","0","-2"
"110495","California State University-Stanislaus","2015","On-Tenure track total","67","35","32","0","0","0","12","9","3","3","1","2","6","1","5","0","0","0","34","20","14","1","1","0","2","0","2","9","3","6","-2"
"110495","California State University-Stanislaus","2015","On-tenure track, associate professors","3","2","1","0","0","0","1","1","0","0","0","0","0","0","0","0","0","0","2","1","1","0","0","0","0","0","0","0","0","0","-2"
"110495","California State University-Stanislaus","2015","On-tenure track, assistant professors","64","33","31","0","0","0","11","8","3","3","1","2","6","1","5","0","0","0","32","19","13","1","1","0","2","0","2","9","3","6","-2"
"110495","California State University-Stanislaus","2015","Not on tenure track/No tenure system system total","63","31","32","0","0","0","7","3","4","0","0","0","5","2","3","0","0","0","48","25","23","1","0","1","2","1","1","0","0","0","-2"
"110495","California State University-Stanislaus","2015","Not on tenure/no tenure system, lecturers","63","31","32","0","0","0","7","3","4","0","0","0","5","2","3","0","0","0","48","25","23","1","0","1","2","1","1","0","0","0","-2"
"110510","California State University-San Bernardino","2015","Tenured total","265","151","114","1","1","0","45","25","20","10","3","7","26","14","12","0","0","0","173","103","70","1","1","0","9","4","5","0","0","0","-2"
"110510","California State University-San Bernardino","2015","Tenured, professors","197","126","71","1","1","0","32","21","11","6","2","4","17","9","8","0","0","0","134","88","46","1","1","0","6","4","2","0","0","0","-2"
"110510","California State University-San Bernardino","2015","Tenured, associate professors","61","22","39","0","0","0","12","3","9","4","1","3","8","4","4","0","0","0","34","14","20","0","0","0","3","0","3","0","0","0","-2"
"110510","California State University-San Bernardino","2015","Tenured, assistant professors","7","3","4","0","0","0","1","1","0","0","0","0","1","1","0","0","0","0","5","1","4","0","0","0","0","0","0","0","0","0","-2"
"110510","California State University-San Bernardino","2015","On-Tenure track total","98","47","51","0","0","0","15","7","8","8","3","5","13","5","8","0","0","0","46","26","20","0","0","0","10","5","5","6","1","5","-2"
"110510","California State University-San Bernardino","2015","On-tenure track, professors","3","2","1","0","0","0","0","0","0","0","0","0","0","0","0","0","0","0","2","2","0","0","0","0","1","0","1","0","0","0","-2"
"110510","California State University-San Bernardino","2015","On-tenure track, associate professors","7","2","5","0","0","0","0","0","0","2","0","2","0","0","0","0","0","0","3","1","2","0","0","0","2","1","1","0","0","0","-2"
"110510","California State University-San Bernardino","2015","On-tenure track, assistant professors","88","43","45","0","0","0","15","7","8","6","3","3","13","5","8","0","0","0","41","23","18","0","0","0","7","4","3","6","1","5","-2"
"110510","California State University-San Bernardino","2015","Not on tenure track/No tenure system system total","92","35","57","0","0","0","9","2","7","3","2","1","8","4","4","0","0","0","65","23","42","0","0","0","5","3","2","2","1","1","-2"
"110510","California State University-San Bernardino","2015","Not on tenure/no tenure system, lecturers","92","35","57","0","0","0","9","2","7","3","2","1","8","4","4","0","0","0","65","23","42","0","0","0","5","3","2","2","1","1","-2"
"110529","California State Polytechnic University-Pomona","2015","Tenured total","328","190","138","1","0","1","83","51","32","10","6","4","30","20","10","1","1","0","182","102","80","0","0","0","17","10","7","4","0","4","-2"
"110529","California State Polytechnic University-Pomona","2015","Tenured, professors","239","147","92","0","0","0","55","39","16","6","3","3","26","17","9","1","1","0","141","81","60","0","0","0","10","6","4","0","0","0","-2"
"110529","California State Polytechnic University-Pomona","2015","Tenured, associate professors","88","43","45","1","0","1","28","12","16","4","3","1","4","3","1","0","0","0","41","21","20","0","0","0","7","4","3","3","0","3","-2"
"110529","California State Polytechnic University-Pomona","2015","Tenured, assistant professors","1","0","1","0","0","0","0","0","0","0","0","0","0","0","0","0","0","0","0","0","0","0","0","0","0","0","0","1","0","1","-2"
"110529","California State Polytechnic University-Pomona","2015","On-Tenure track total","153","81","72","1","1","0","32","16","16","2","1","1","15","7","8","0","0","0","70","39","31","3","2","1","7","5","2","23","10","13","-2"
"110529","California State Polytechnic University-Pomona","2015","On-tenure track, professors","1","0","1","0","0","0","0","0","0","0","0","0","0","0","0","0","0","0","1","0","1","0","0","0","0","0","0","0","0","0","-2"
"110529","California State Polytechnic University-Pomona","2015","On-tenure track, associate professors","8","5","3","0","0","0","3","2","1","0","0","0","0","0","0","0","0","0","3","2","1","0","0","0","2","1","1","0","0","0","-2"
"110529","California State Polytechnic University-Pomona","2015","On-tenure track, assistant professors","144","76","68","1","1","0","29","14","15","2","1","1","15","7","8","0","0","0","66","37","29","3","2","1","5","4","1","23","10","13","-2"
"110529","California State Polytechnic University-Pomona","2015","Not on tenure track/No tenure system system total","92","51","41","1","1","0","13","5","8","2","0","2","11","6","5","1","1","0","57","33","24","0","0","0","5","4","1","2","1","1","-2"
"110529","California State Polytechnic University-Pomona","2015","Not on tenure/no tenure system, lecturers","92","51","41","1","1","0","13","5","8","2","0","2","11","6","5","1","1","0","57","33","24","0","0","0","5","4","1","2","1","1","-2"
"110547","California State University-Dominguez Hills","2015","Tenured total","145","74","71","1","0","1","23","13","10","9","5","4","14","9","5","0","0","0","85","43","42","3","2","1","10","2","8","0","0","0","-2"
"110547","California State University-Dominguez Hills","2015","Tenured, professors","86","48","38","0","0","0","9","6","3","5","2","3","8","6","2","0","0","0","56","31","25","2","2","0","6","1","5","0","0","0","-2"
"110547","California State University-Dominguez Hills","2015","Tenured, associate professors","55","25","30","1","0","1","13","7","6","3","2","1","5","3","2","0","0","0","29","12","17","1","0","1","3","1","2","0","0","0","-2"
"110547","California State University-Dominguez Hills","2015","Tenured, assistant professors","4","1","3","0","0","0","1","0","1","1","1","0","1","0","1","0","0","0","0","0","0","0","0","0","1","0","1","0","0","0","-2"
"110547","California State University-Dominguez Hills","2015","On-Tenure track total","78","31","47","2","1","1","14","3","11","7","4","3","10","3","7","0","0","0","30","10","20","2","2","0","5","3","2","8","5","3","-2"
"110547","California State University-Dominguez Hills","2015","On-tenure track, professors","7","3","4","0","0","0","2","1","1","1","1","0","0","0","0","0","0","0","3","0","3","0","0","0","1","1","0","0","0","0","-2"
"110547","California State University-Dominguez Hills","2015","On-tenure track, associate professors","10","5","5","0","0","0","2","0","2","1","1","0","0","0","0","0","0","0","5","3","2","1","1","0","0","0","0","1","0","1","-2"
"110547","California State University-Dominguez Hills","2015","On-tenure track, assistant professors","61","23","38","2","1","1","10","2","8","5","2","3","10","3","7","0","0","0","22","7","15","1","1","0","4","2","2","7","5","2","-2"
"110547","California State University-Dominguez Hills","2015","Not on tenure track/No tenure system system total","92","48","44","1","0","1","9","6","3","6","3","3","15","6","9","0","0","0","50","27","23","0","0","0","11","6","5","0","0","0","-2"
"110547","California State University-Dominguez Hills","2015","Not on tenure/no tenure system, lecturers","92","48","44","1","0","1","9","6","3","6","3","3","15","6","9","0","0","0","50","27","23","0","0","0","11","6","5","0","0","0","-2"
"110556","California State University-Fresno","2015","Tenured total","365","228","137","0","0","0","62","45","17","14","7","7","35","23","12","0","0","0","240","145","95","3","3","0","6","2","4","5","3","2","-2"
"110556","California State University-Fresno","2015","Tenured, professors","216","149","67","0","0","0","28","25","3","6","3","3","18","14","4","0","0","0","156","102","54","2","2","0","5","2","3","1","1","0","-2"
"110556","California State University-Fresno","2015","Tenured, associate professors","146","77","69","0","0","0","34","20","14","8","4","4","17","9","8","0","0","0","81","41","40","1","1","0","1","0","1","4","2","2","-2"
"110556","California State University-Fresno","2015","Tenured, assistant professors","2","1","1","0","0","0","0","0","0","0","0","0","0","0","0","0","0","0","2","1","1","0","0","0","0","0","0","0","0","0","-2"
"110556","California State University-Fresno","2015","Tenured, no academic rank","1","1","0","0","0","0","0","0","0","0","0","0","0","0","0","0","0","0","1","1","0","0","0","0","0","0","0","0","0","0","-2"
"110556","California State University-Fresno","2015","On-Tenure track total","153","69","84","1","0","1","19","12","7","6","2","4","18","7","11","0","0","0","80","30","50","3","3","0","5","1","4","21","14","7","-2"
"110556","California State University-Fresno","2015","On-tenure track, associate professors","4","2","2","0","0","0","2","1","1","0","0","0","1","1","0","0","0","0","1","0","1","0","0","0","0","0","0","0","0","0","-2"
"110556","California State University-Fresno","2015","On-tenure track, assistant professors","148","67","81","1","0","1","17","11","6","6","2","4","16","6","10","0","0","0","79","30","49","3","3","0","5","1","4","21","14","7","-2"
"110556","California State University-Fresno","2015","On-tenure track, no academic rank","1","0","1","0","0","0","0","0","0","0","0","0","1","0","1","0","0","0","0","0","0","0","0","0","0","0","0","0","0","0","-2"
"110556","California State University-Fresno","2015","Not on tenure track/No tenure system system total","168","83","85","2","0","2","12","7","5","5","2","3","22","11","11","1","1","0","116","57","59","3","1","2","6","3","3","1","1","0","-2"
"110556","California State University-Fresno","2015","Not on tenure/no tenure system, lecturers","168","83","85","2","0","2","12","7","5","5","2","3","22","11","11","1","1","0","116","57","59","3","1","2","6","3","3","1","1","0","-2"
"110565","California State University-Fullerton","2015","Tenured total","522","285","237","0","0","0","110","64","46","13","5","8","33","18","15","1","1","0","360","195","165","0","0","0","0","0","0","5","2","3","-2"
"110565","California State University-Fullerton","2015","Tenured, professors","304","177","127","0","0","0","67","40","27","6","1","5","17","8","9","1","1","0","213","127","86","0","0","0","0","0","0","0","0","0","-2"
"110565","California State University-Fullerton","2015","Tenured, associate professors","218","108","110","0","0","0","43","24","19","7","4","3","16","10","6","0","0","0","147","68","79","0","0","0","0","0","0","5","2","3","-2"
"110565","California State University-Fullerton","2015","On-Tenure track total","238","119","119","1","0","1","40","12","28","9","4","5","31","15","16","0","0","0","111","59","52","0","0","0","5","2","3","41","27","14","-2"
"110565","California State University-Fullerton","2015","On-tenure track, professors","1","1","0","0","0","0","1","1","0","0","0","0","0","0","0","0","0","0","0","0","0","0","0","0","0","0","0","0","0","0","-2"
"110565","California State University-Fullerton","2015","On-tenure track, associate professors","21","12","9","0","0","0","4","2","2","0","0","0","2","1","1","0","0","0","11","7","4","0","0","0","1","1","0","3","1","2","-2"
"110565","California State University-Fullerton","2015","On-tenure track, assistant professors","216","106","110","1","0","1","35","9","26","9","4","5","29","14","15","0","0","0","100","52","48","0","0","0","4","1","3","38","26","12","-2"
"110565","California State University-Fullerton","2015","Not on tenure track/No tenure system system total","221","89","132","0","0","0","31","12","19","6","4","2","15","3","12","0","0","0","158","63","95","0","0","0","6","4","2","5","3","2","-2"
"110565","California State University-Fullerton","2015","Not on tenure/no tenure system, lecturers","221","89","132","0","0","0","31","12","19","6","4","2","15","3","12","0","0","0","158","63","95","0","0","0","6","4","2","5","3","2","-2"
"110574","California State University-East Bay","2015","Tenured total","211","107","104","2","2","0","40","19","21","11","6","5","20","7","13","2","1","1","122","62","60","0","0","0","8","5","3","6","5","1","-2"
"110574","California State University-East Bay","2015","Tenured, professors","122","63","59","0","0","0","17","8","9","8","5","3","14","5","9","2","1","1","77","41","36","0","0","0","2","1","1","2","2","0","-2"
"110574","California State University-East Bay","2015","Tenured, associate professors","85","41","44","2","2","0","23","11","12","3","1","2","5","2","3","0","0","0","42","18","24","0","0","0","6","4","2","4","3","1","-2"
"110574","California State University-East Bay","2015","Tenured, assistant professors","4","3","1","0","0","0","0","0","0","0","0","0","1","0","1","0","0","0","3","3","0","0","0","0","0","0","0","0","0","0","-2"
"110574","California State University-East Bay","2015","On-Tenure track total","93","49","44","0","0","0","18","10","8","6","3","3","7","5","2","0","0","0","39","19","20","1","1","0","9","4","5","13","7","6","-2"
"110574","California State University-East Bay","2015","On-tenure track, professors","1","1","0","0","0","0","0","0","0","0","0","0","0","0","0","0","0","0","1","1","0","0","0","0","0","0","0","0","0","0","-2"
"110574","California State University-East Bay","2015","On-tenure track, associate professors","8","5","3","0","0","0","1","1","0","0","0","0","2","1","1","0","0","0","3","1","2","0","0","0","2","2","0","0","0","0","-2"
"110574","California State University-East Bay","2015","On-tenure track, assistant professors","84","43","41","0","0","0","17","9","8","6","3","3","5","4","1","0","0","0","35","17","18","1","1","0","7","2","5","13","7","6","-2"
"110574","California State University-East Bay","2015","Not on tenure track/No tenure system system total","50","20","30","1","1","0","2","0","2","6","0","6","3","2","1","1","0","1","35","17","18","0","0","0","2","0","2","0","0","0","-2"
"110574","California State University-East Bay","2015","Not on tenure/no tenure system, lecturers","50","20","30","1","1","0","2","0","2","6","0","6","3","2","1","1","0","1","35","17","18","0","0","0","2","0","2","0","0","0","-2"
"110583","California State University-Long Beach","2015","Tenured total","570","321","249","2","2","0","119","57","62","18","13","5","54","33","21","0","0","0","356","201","155","4","2","2","16","13","3","1","0","1","-2"
"110583","California State University-Long Beach","2015","Tenured, professors","364","217","147","2","2","0","75","41","34","9","8","1","29","20","9","0","0","0","239","139","100","0","0","0","10","7","3","0","0","0","-2"
"110583","California State University-Long Beach","2015","Tenured, associate professors","201","101","100","0","0","0","43","15","28","9","5","4","25","13","12","0","0","0","113","60","53","4","2","2","6","6","0","1","0","1","-2"
"110583","California State University-Long Beach","2015","Tenured, assistant professors","3","1","2","0","0","0","1","1","0","0","0","0","0","0","0","0","0","0","2","0","2","0","0","0","0","0","0","0","0","0","-2"
"110583","California State University-Long Beach","2015","Tenured, no academic rank","2","2","0","0","0","0","0","0","0","0","0","0","0","0","0","0","0","0","2","2","0","0","0","0","0","0","0","0","0","0","-2"
"110583","California State University-Long Beach","2015","On-Tenure track total","186","77","109","3","1","2","38","9","29","7","2","5","12","4","8","1","1","0","80","40","40","2","0","2","11","6","5","32","14","18","-2"
"110583","California State University-Long Beach","2015","On-tenure track, professors","1","1","0","0","0","0","0","0","0","0","0","0","0","0","0","0","0","0","1","1","0","0","0","0","0","0","0","0","0","0","-2"
"110583","California State University-Long Beach","2015","On-tenure track, associate professors","9","2","7","0","0","0","5","0","5","0","0","0","0","0","0","0","0","0","2","1","1","0","0","0","0","0","0","2","1","1","-2"
"110583","California State University-Long Beach","2015","On-tenure track, assistant professors","176","74","102","3","1","2","33","9","24","7","2","5","12","4","8","1","1","0","77","38","39","2","0","2","11","6","5","30","13","17","-2"
"110583","California State University-Long Beach","2015","Not on tenure track/No tenure system system total","270","123","147","1","0","1","32","16","16","7","2","5","25","11","14","0","0","0","192","87","105","9","4","5","3","3","0","1","0","1","-2"
"110583","California State University-Long Beach","2015","Not on tenure/no tenure system, lecturers","270","123","147","1","0","1","32","16","16","7","2","5","25","11","14","0","0","0","192","87","105","9","4","5","3","3","0","1","0","1","-2"
"110592","California State University-Los Angeles","2015","Tenured total","369","198","171","2","0","2","96","53","43","17","9","8","51","31","20","1","1","0","186","93","93","1","0","1","14","10","4","1","1","0","-2"
"110592","California State University-Los Angeles","2015","Tenured, professors","261","146","115","2","0","2","65","37","28","13","7","6","35","22","13","0","0","0","137","74","63","1","0","1","8","6","2","0","0","0","-2"
"110592","California State University-Los Angeles","2015","Tenured, associate professors","106","50","56","0","0","0","30","15","15","4","2","2","16","9","7","1","1","0","48","18","30","0","0","0","6","4","2","1","1","0","-2"
"110592","California State University-Los Angeles","2015","Tenured, assistant professors","2","2","0","0","0","0","1","1","0","0","0","0","0","0","0","0","0","0","1","1","0","0","0","0","0","0","0","0","0","0","-2"
"110592","California State University-Los Angeles","2015","On-Tenure track total","109","43","66","1","0","1","13","2","11","8","2","6","20","8","12","0","0","0","40","20","20","3","0","3","6","2","4","18","9","9","-2"
"110592","California State University-Los Angeles","2015","On-tenure track, professors","14","5","9","0","0","0","2","1","1","1","0","1","3","2","1","0","0","0","8","2","6","0","0","0","0","0","0","0","0","0","-2"
"110592","California State University-Los Angeles","2015","On-tenure track, associate professors","1","1","0","0","0","0","0","0","0","0","0","0","0","0","0","0","0","0","1","1","0","0","0","0","0","0","0","0","0","0","-2"
"110592","California State University-Los Angeles","2015","On-tenure track, assistant professors","94","37","57","1","0","1","11","1","10","7","2","5","17","6","11","0","0","0","31","17","14","3","0","3","6","2","4","18","9","9","-2"
"110592","California State University-Los Angeles","2015","Not on tenure track/No tenure system system total","144","71","73","1","1","0","23","10","13","9","5","4","33","19","14","0","0","0","65","29","36","2","0","2","8","5","3","3","2","1","-2"
"110592","California State University-Los Angeles","2015","Not on tenure/no tenure system, lecturers","144","71","73","1","1","0","23","10","13","9","5","4","33","19","14","0","0","0","65","29","36","2","0","2","8","5","3","3","2","1","-2"
"110608","California State University-Northridge","2015","Tenured total","530","290","240","4","2","2","83","46","37","21","6","15","68","32","36","0","0","0","343","197","146","5","3","2","5","4","1","1","0","1","-2"
"110608","California State University-Northridge","2015","Tenured, professors","375","203","172","3","1","2","56","32","24","12","3","9","50","22","28","0","0","0","247","141","106","5","3","2","2","1","1","0","0","0","-2"
"110608","California State University-Northridge","2015","Tenured, associate professors","145","81","64","1","1","0","26","13","13","9","3","6","15","9","6","0","0","0","90","52","38","0","0","0","3","3","0","1","0","1","-2"
"110608","California State University-Northridge","2015","Tenured, assistant professors","1","1","0","0","0","0","0","0","0","0","0","0","1","1","0","0","0","0","0","0","0","0","0","0","0","0","0","0","0","0","-2"
"110608","California State University-Northridge","2015","Tenured, no academic rank","9","5","4","0","0","0","1","1","0","0","0","0","2","0","2","0","0","0","6","4","2","0","0","0","0","0","0","0","0","0","-2"
"110608","California State University-Northridge","2015","On-Tenure track total","242","103","139","3","1","2","44","17","27","16","4","12","19","13","6","0","0","0","122","47","75","2","0","2","17","9","8","19","12","7","-2"
"110608","California State University-Northridge","2015","On-tenure track, professors","1","0","1","0","0","0","0","0","0","1","0","1","0","0","0","0","0","0","0","0","0","0","0","0","0","0","0","0","0","0","-2"
"110608","California State University-Northridge","2015","On-tenure track, associate professors","30","14","16","1","1","0","8","4","4","2","2","0","1","1","0","0","0","0","14","3","11","0","0","0","2","1","1","2","2","0","-2"
"110608","California State University-Northridge","2015","On-tenure track, assistant professors","211","89","122","2","0","2","36","13","23","13","2","11","18","12","6","0","0","0","108","44","64","2","0","2","15","8","7","17","10","7","-2"
"110608","California State University-Northridge","2015","Not on tenure track/No tenure system system total","165","75","90","1","0","1","13","6","7","6","4","2","25","15","10","0","0","0","111","45","66","2","0","2","6","4","2","1","1","0","-2"
"110608","California State University-Northridge","2015","Not on tenure/no tenure system, lecturers","165","75","90","1","0","1","13","6","7","6","4","2","25","15","10","0","0","0","111","45","66","2","0","2","6","4","2","1","1","0","-2"
"110617","California State University-Sacramento","2015","Tenured total","476","266","210","3","1","2","77","43","34","23","10","13","43","25","18","0","0","0","302","171","131","2","1","1","13","8","5","13","7","6","-2"
"110617","California State University-Sacramento","2015","Tenured, professors","339","196","143","3","1","2","48","26","22","16","6","10","32","20","12","0","0","0","228","138","90","2","1","1","7","4","3","3","0","3","-2"
"110617","California State University-Sacramento","2015","Tenured, associate professors","131","66","65","0","0","0","28","16","12","7","4","3","11","5","6","0","0","0","70","31","39","0","0","0","5","3","2","10","7","3","-2"
"110617","California State University-Sacramento","2015","Tenured, assistant professors","4","2","2","0","0","0","1","1","0","0","0","0","0","0","0","0","0","0","2","0","2","0","0","0","1","1","0","0","0","0","-2"
"110617","California State University-Sacramento","2015","Tenured, no academic rank","2","2","0","0","0","0","0","0","0","0","0","0","0","0","0","0","0","0","2","2","0","0","0","0","0","0","0","0","0","0","-2"
"110617","California State University-Sacramento","2015","On-Tenure track total","119","62","57","1","1","0","13","9","4","3","1","2","2","2","0","0","0","0","85","41","44","1","1","0","12","6","6","2","1","1","-2"
"110617","California State University-Sacramento","2015","On-tenure track, professors","2","0","2","0","0","0","0","0","0","0","0","0","0","0","0","0","0","0","2","0","2","0","0","0","0","0","0","0","0","0","-2"
"110617","California State University-Sacramento","2015","On-tenure track, associate professors","6","3","3","0","0","0","2","1","1","0","0","0","0","0","0","0","0","0","4","2","2","0","0","0","0","0","0","0","0","0","-2"
"110617","California State University-Sacramento","2015","On-tenure track, assistant professors","110","59","51","1","1","0","11","8","3","3","1","2","2","2","0","0","0","0","78","39","39","1","1","0","12","6","6","2","1","1","-2"
"110617","California State University-Sacramento","2015","On-tenure track, no academic rank","1","0","1","0","0","0","0","0","0","0","0","0","0","0","0","0","0","0","1","0","1","0","0","0","0","0","0","0","0","0","-2"
"110617","California State University-Sacramento","2015","Not on tenure track/No tenure system system total","122","55","67","1","0","1","8","6","2","3","2","1","2","0","2","0","0","0","97","41","56","2","0","2","7","4","3","2","2","0","-2"
"110617","California State University-Sacramento","2015","Not on tenure/no tenure system, lecturers","122","55","67","1","0","1","8","6","2","3","2","1","2","0","2","0","0","0","97","41","56","2","0","2","7","4","3","2","2","0","-2"
"110671","University of California-Riverside","2015","Tenured total","494","339","155","4","2","2","99","69","30","17","10","7","29","17","12","0","0","0","336","236","100","0","0","0","5","2","3","4","3","1","-2"
"110671","University of California-Riverside","2015","Tenured, professors","320","246","74","1","1","0","59","49","10","9","5","4","17","11","6","0","0","0","229","177","52","0","0","0","4","2","2","1","1","0","-2"
"110671","University of California-Riverside","2015","Tenured, associate professors","173","92","81","3","1","2","40","20","20","8","5","3","12","6","6","0","0","0","106","58","48","0","0","0","1","0","1","3","2","1","-2"
"110671","University of California-Riverside","2015","Tenured, lecturers","1","1","0","0","0","0","0","0","0","0","0","0","0","0","0","0","0","0","1","1","0","0","0","0","0","0","0","0","0","0","-2"
"110671","University of California-Riverside","2015","On-Tenure track total","188","116","72","1","1","0","47","28","19","6","2","4","12","6","6","0","0","0","80","48","32","2","0","2","11","9","2","29","22","7","-2"
"110671","University of California-Riverside","2015","On-tenure track, assistant professors","186","115","71","1","1","0","47","28","19","6","2","4","12","6","6","0","0","0","78","47","31","2","0","2","11","9","2","29","22","7","-2"
"110671","University of California-Riverside","2015","On-tenure track, lecturers","2","1","1","0","0","0","0","0","0","0","0","0","0","0","0","0","0","0","2","1","1","0","0","0","0","0","0","0","0","0","-2"
"110671","University of California-Riverside","2015","Not on tenure track/No tenure system system total","162","97","65","1","1","0","26","14","12","10","6","4","17","8","9","0","0","0","90","54","36","1","1","0","6","4","2","11","9","2","-2"
"110671","University of California-Riverside","2015","Not on tenure/no tenure system, professors","9","7","2","0","0","0","2","2","0","1","0","1","0","0","0","0","0","0","6","5","1","0","0","0","0","0","0","0","0","0","-2"
"110671","University of California-Riverside","2015","Not on tenure/no tenure system, associate professors","5","5","0","0","0","0","0","0","0","1","1","0","0","0","0","0","0","0","4","4","0","0","0","0","0","0","0","0","0","0","-2"
"110671","University of California-Riverside","2015","Not on tenure/no tenure system, assistant professors","60","38","22","0","0","0","14","6","8","5","4","1","7","5","2","0","0","0","19","11","8","1","1","0","3","2","1","11","9","2","-2"
"110671","University of California-Riverside","2015","Not on tenure/no tenure system, lecturers","86","47","39","1","1","0","10","6","4","2","1","1","10","3","7","0","0","0","60","34","26","0","0","0","3","2","1","0","0","0","-2"
"110671","University of California-Riverside","2015","Not on tenure/no tenure system, no academic rank","2","0","2","0","0","0","0","0","0","1","0","1","0","0","0","0","0","0","1","0","1","0","0","0","0","0","0","0","0","0","-2"
"110705","University of California-Santa Barbara","2015","Tenured total","698","466","232","6","1","5","72","46","26","15","10","5","47","28","19","0","0","0","529","361","168","0","0","0","6","5","1","23","15","8","-2"
"110705","University of California-Santa Barbara","2015","Tenured, professors","509","363","146","3","1","2","55","36","19","6","4","2","26","18","8","0","0","0","396","287","109","0","0","0","6","5","1","17","12","5","-2"
"110705","University of California-Santa Barbara","2015","Tenured, associate professors","163","92","71","3","0","3","17","10","7","8","5","3","18","9","9","0","0","0","112","65","47","0","0","0","0","0","0","5","3","2","-2"
"110705","University of California-Santa Barbara","2015","Tenured, lecturers","26","11","15","0","0","0","0","0","0","1","1","0","3","1","2","0","0","0","21","9","12","0","0","0","0","0","0","1","0","1","-2"
"110705","University of California-Santa Barbara","2015","On-Tenure track total","105","55","50","2","1","1","8","3","5","4","1","3","9","4","5","0","0","0","43","22","21","4","1","3","15","9","6","20","14","6","-2"
"110705","University of California-Santa Barbara","2015","On-tenure track, professors","2","2","0","0","0","0","0","0","0","0","0","0","0","0","0","0","0","0","0","0","0","0","0","0","0","0","0","2","2","0","-2"
"110705","University of California-Santa Barbara","2015","On-tenure track, assistant professors","97","49","48","2","1","1","8","3","5","4","1","3","9","4","5","0","0","0","39","19","20","4","1","3","13","8","5","18","12","6","-2"
"110705","University of California-Santa Barbara","2015","On-tenure track, lecturers","6","4","2","0","0","0","0","0","0","0","0","0","0","0","0","0","0","0","4","3","1","0","0","0","2","1","1","0","0","0","-2"
"110705","University of California-Santa Barbara","2015","Not on tenure track/No tenure system system total","120","56","64","1","1","0","10","3","7","1","0","1","5","1","4","0","0","0","87","38","49","0","0","0","5","4","1","11","9","2","-2"
"110705","University of California-Santa Barbara","2015","Not on tenure/no tenure system, assistant professors","14","10","4","0","0","0","2","1","1","1","0","1","1","1","0","0","0","0","3","2","1","0","0","0","1","1","0","6","5","1","-2"
"110705","University of California-Santa Barbara","2015","Not on tenure/no tenure system, lecturers","106","46","60","1","1","0","8","2","6","0","0","0","4","0","4","0","0","0","84","36","48","0","0","0","4","3","1","5","4","1","-2"
"110714","University of California-Santa Cruz","2015","Tenured total","433","272","161","7","1","6","67","39","28","7","6","1","40","19","21","0","0","0","304","202","102","1","1","0","7","4","3","0","0","0","-2"
"110714","University of California-Santa Cruz","2015","Tenured, professors","288","195","93","3","1","2","40","27","13","4","4","0","21","10","11","0","0","0","215","150","65","0","0","0","5","3","2","0","0","0","-2"
"110714","University of California-Santa Cruz","2015","Tenured, associate professors","134","71","63","4","0","4","26","11","15","3","2","1","17","9","8","0","0","0","82","48","34","1","1","0","1","0","1","0","0","0","-2"
"110714","University of California-Santa Cruz","2015","Tenured, lecturers","11","6","5","0","0","0","1","1","0","0","0","0","2","0","2","0","0","0","7","4","3","0","0","0","1","1","0","0","0","0","-2"
"110714","University of California-Santa Cruz","2015","On-Tenure track total","92","53","39","2","1","1","12","8","4","4","2","2","10","7","3","0","0","0","46","23","23","1","0","1","2","1","1","15","11","4","-2"
"110714","University of California-Santa Cruz","2015","On-tenure track, associate professors","2","2","0","0","0","0","0","0","0","0","0","0","0","0","0","0","0","0","1","1","0","0","0","0","0","0","0","1","1","0","-2"
"110714","University of California-Santa Cruz","2015","On-tenure track, assistant professors","90","51","39","2","1","1","12","8","4","4","2","2","10","7","3","0","0","0","45","22","23","1","0","1","2","1","1","14","10","4","-2"
"110714","University of California-Santa Cruz","2015","Not on tenure track/No tenure system system total","42","21","21","0","0","0","2","0","2","1","0","1","8","4","4","0","0","0","29","16","13","0","0","0","0","0","0","2","1","1","-2"
"110714","University of California-Santa Cruz","2015","Not on tenure/no tenure system, professors","2","2","0","0","0","0","0","0","0","0","0","0","0","0","0","0","0","0","2","2","0","0","0","0","0","0","0","0","0","0","-2"
"110714","University of California-Santa Cruz","2015","Not on tenure/no tenure system, associate professors","1","1","0","0","0","0","0","0","0","0","0","0","0","0","0","0","0","0","0","0","0","0","0","0","0","0","0","1","1","0","-2"
"110714","University of California-Santa Cruz","2015","Not on tenure/no tenure system, assistant professors","8","3","5","0","0","0","0","0","0","0","0","0","2","0","2","0","0","0","5","3","2","0","0","0","0","0","0","1","0","1","-2"
"110714","University of California-Santa Cruz","2015","Not on tenure/no tenure system, lecturers","28","13","15","0","0","0","2","0","2","1","0","1","5","3","2","0","0","0","20","10","10","0","0","0","0","0","0","0","0","0","-2"
"110714","University of California-Santa Cruz","2015","Not on tenure/no tenure system, no academic rank","3","2","1","0","0","0","0","0","0","0","0","0","1","1","0","0","0","0","2","1","1","0","0","0","0","0","0","0","0","0","-2"
"111966","Charles R Drew University of Medicine and Science","2015","Not on tenure track/No tenure system system total","45","18","27","0","0","0","11","6","5","14","5","9","5","2","3","0","0","0","12","5","7","1","0","1","2","0","2","0","0","0","-2"
"111966","Charles R Drew University of Medicine and Science","2015","Not on tenure/no tenure system, professors","1","1","0","0","0","0","0","0","0","0","0","0","0","0","0","0","0","0","1","1","0","0","0","0","0","0","0","0","0","0","-2"
"111966","Charles R Drew University of Medicine and Science","2015","Not on tenure/no tenure system, associate professors","10","4","6","0","0","0","1","1","0","2","1","1","2","1","1","0","0","0","5","1","4","0","0","0","0","0","0","0","0","0","-2"
"111966","Charles R Drew University of Medicine and Science","2015","Not on tenure/no tenure system, assistant professors","21","9","12","0","0","0","8","3","5","5","2","3","2","1","1","0","0","0","6","3","3","0","0","0","0","0","0","0","0","0","-2"
"111966","Charles R Drew University of Medicine and Science","2015","Not on tenure/no tenure system, instructors","13","4","9","0","0","0","2","2","0","7","2","5","1","0","1","0","0","0","0","0","0","1","0","1","2","0","2","0","0","0","-2"
"112075","Concordia University-Irvine","2015","Not on tenure track/No tenure system system total","105","55","50","0","0","0","3","1","2","2","0","2","7","4","3","0","0","0","92","50","42","0","0","0","0","0","0","1","0","1","-2"
"112075","Concordia University-Irvine","2015","Not on tenure/no tenure system, professors","35","26","9","0","0","0","1","1","0","1","0","1","3","3","0","0","0","0","30","22","8","0","0","0","0","0","0","0","0","0","-2"
"112075","Concordia University-Irvine","2015","Not on tenure/no tenure system, associate professors","14","7","7","0","0","0","1","0","1","0","0","0","0","0","0","0","0","0","13","7","6","0","0","0","0","0","0","0","0","0","-2"
"112075","Concordia University-Irvine","2015","Not on tenure/no tenure system, assistant professors","56","22","34","0","0","0","1","0","1","1","0","1","4","1","3","0","0","0","49","21","28","0","0","0","0","0","0","1","0","1","-2"
"112084","San Diego Christian College","2015","Not on tenure track/No tenure system system total","19","10","9","0","0","0","0","0","0","1","0","1","0","0","0","1","1","0","17","9","8","0","0","0","0","0","0","0","0","0","-2"
"112084","San Diego Christian College","2015","Not on tenure/no tenure system, professors","3","3","0","0","0","0","0","0","0","0","0","0","0","0","0","0","0","0","3","3","0","0","0","0","0","0","0","0","0","0","-2"
"112084","San Diego Christian College","2015","Not on tenure/no tenure system, associate professors","8","5","3","0","0","0","0","0","0","0","0","0","0","0","0","1","1","0","7","4","3","0","0","0","0","0","0","0","0","0","-2"
"112084","San Diego Christian College","2015","Not on tenure/no tenure system, assistant professors","7","2","5","0","0","0","0","0","0","1","0","1","0","0","0","0","0","0","6","2","4","0","0","0","0","0","0","0","0","0","-2"
"112084","San Diego Christian College","2015","Not on tenure/no tenure system, instructors","1","0","1","0","0","0","0","0","0","0","0","0","0","0","0","0","0","0","1","0","1","0","0","0","0","0","0","0","0","0","-2"
"113236","Cypress College","2015","Tenured total","171","73","98","0","0","0","17","4","13","5","0","5","26","15","11","1","0","1","96","44","52","6","2","4","18","8","10","2","0","2","-2"
"113236","Cypress College","2015","Tenured, instructors","171","73","98","0","0","0","17","4","13","5","0","5","26","15","11","1","0","1","96","44","52","6","2","4","18","8","10","2","0","2","-2"
"113236","Cypress College","2015","On-Tenure track total","34","15","19","0","0","0","4","0","4","1","0","1","9","4","5","0","0","0","15","9","6","1","0","1","3","2","1","1","0","1","-2"
"113236","Cypress College","2015","On-tenure track, instructors","34","15","19","0","0","0","4","0","4","1","0","1","9","4","5","0","0","0","15","9","6","1","0","1","3","2","1","1","0","1","-2"
"113236","Cypress College","2015","Not on tenure track/No tenure system system total","4","2","2","0","0","0","1","1","0","0","0","0","1","0","1","0","0","0","2","1","1","0","0","0","0","0","0","0","0","0","-2"
"113236","Cypress College","2015","Not on tenure/no tenure system, instructors","4","2","2","0","0","0","1","1","0","0","0","0","1","0","1","0","0","0","2","1","1","0","0","0","0","0","0","0","0","0","-2"
"113698","Dominican University of California","2015","Tenured total","44","20","24","0","0","0","4","1","3","3","2","1","1","0","1","0","0","0","34","16","18","0","0","0","2","1","1","0","0","0","-2"
"113698","Dominican University of California","2015","Tenured, professors","30","13","17","0","0","0","2","0","2","1","1","0","1","0","1","0","0","0","24","11","13","0","0","0","2","1","1","0","0","0","-2"
"113698","Dominican University of California","2015","Tenured, associate professors","13","6","7","0","0","0","2","1","1","2","1","1","0","0","0","0","0","0","9","4","5","0","0","0","0","0","0","0","0","0","-2"
"113698","Dominican University of California","2015","Tenured, assistant professors","1","1","0","0","0","0","0","0","0","0","0","0","0","0","0","0","0","0","1","1","0","0","0","0","0","0","0","0","0","0","-2"
"113698","Dominican University of California","2015","On-Tenure track total","31","8","23","0","0","0","5","2","3","0","0","0","1","0","1","0","0","0","25","6","19","0","0","0","0","0","0","0","0","0","-2"
"113698","Dominican University of California","2015","On-tenure track, associate professors","2","0","2","0","0","0","0","0","0","0","0","0","0","0","0","0","0","0","2","0","2","0","0","0","0","0","0","0","0","0","-2"
"113698","Dominican University of California","2015","On-tenure track, assistant professors","29","8","21","0","0","0","5","2","3","0","0","0","1","0","1","0","0","0","23","6","17","0","0","0","0","0","0","0","0","0","-2"
"113698","Dominican University of California","2015","Not on tenure track/No tenure system system total","28","13","15","1","1","0","2","0","2","1","1","0","1","1","0","0","0","0","22","9","13","0","0","0","1","1","0","0","0","0","-2"
"113698","Dominican University of California","2015","Not on tenure/no tenure system, assistant professors","28","13","15","1","1","0","2","0","2","1","1","0","1","1","0","0","0","0","22","9","13","0","0","0","1","1","0","0","0","0","-2"
"114433","Feather River Community College District","2015","Tenured total","19","11","8","0","0","0","0","0","0","0","0","0","0","0","0","0","0","0","19","11","8","0","0","0","0","0","0","0","0","0","-2"
"114433","Feather River Community College District","2015","Tenured, professors","19","11","8","0","0","0","0","0","0","0","0","0","0","0","0","0","0","0","19","11","8","0","0","0","0","0","0","0","0","0","-2"
"114433","Feather River Community College District","2015","On-Tenure track total","5","4","1","0","0","0","0","0","0","0","0","0","0","0","0","0","0","0","5","4","1","0","0","0","0","0","0","0","0","0","-2"
"114433","Feather River Community College District","2015","On-tenure track, instructors","5","4","1","0","0","0","0","0","0","0","0","0","0","0","0","0","0","0","5","4","1","0","0","0","0","0","0","0","0","0","-2"
"114716","Foothill College","2015","Tenured total","146","56","90","0","0","0","23","6","17","5","3","2","24","9","15","0","0","0","90","36","54","1","1","0","3","1","2","0","0","0","-2"
"114716","Foothill College","2015","Tenured, instructors","146","56","90","0","0","0","23","6","17","5","3","2","24","9","15","0","0","0","90","36","54","1","1","0","3","1","2","0","0","0","-2"
"114716","Foothill College","2015","On-Tenure track total","41","18","23","0","0","0","2","1","1","3","1","2","3","1","2","0","0","0","29","12","17","3","3","0","1","0","1","0","0","0","-2"
"114716","Foothill College","2015","On-tenure track, instructors","41","18","23","0","0","0","2","1","1","3","1","2","3","1","2","0","0","0","29","12","17","3","3","0","1","0","1","0","0","0","-2"
"114716","Foothill College","2015","Not on tenure track/No tenure system system total","1","1","0","0","0","0","0","0","0","1","1","0","0","0","0","0","0","0","0","0","0","0","0","0","0","0","0","0","0","0","-2"
"114716","Foothill College","2015","Not on tenure/no tenure system, instructors","1","1","0","0","0","0","0","0","0","1","1","0","0","0","0","0","0","0","0","0","0","0","0","0","0","0","0","0","0","0","-2"
"114813","Fresno Pacific University","2015","Tenured total","42","28","14","0","0","0","2","2","0","0","0","0","1","0","1","0","0","0","36","24","12","2","1","1","1","1","0","0","0","0","-2"
"114813","Fresno Pacific University","2015","Tenured, professors","15","12","3","0","0","0","1","1","0","0","0","0","0","0","0","0","0","0","14","11","3","0","0","0","0","0","0","0","0","0","-2"
"114813","Fresno Pacific University","2015","Tenured, associate professors","26","15","11","0","0","0","0","0","0","0","0","0","1","0","1","0","0","0","22","13","9","2","1","1","1","1","0","0","0","0","-2"
"114813","Fresno Pacific University","2015","Tenured, assistant professors","1","1","0","0","0","0","1","1","0","0","0","0","0","0","0","0","0","0","0","0","0","0","0","0","0","0","0","0","0","0","-2"
"114813","Fresno Pacific University","2015","On-Tenure track total","28","16","12","0","0","0","3","2","1","1","1","0","0","0","0","0","0","0","21","12","9","1","0","1","2","1","1","0","0","0","-2"
"114813","Fresno Pacific University","2015","On-tenure track, associate professors","2","2","0","0","0","0","1","1","0","0","0","0","0","0","0","0","0","0","1","1","0","0","0","0","0","0","0","0","0","0","-2"
"114813","Fresno Pacific University","2015","On-tenure track, assistant professors","25","13","12","0","0","0","1","0","1","1","1","0","0","0","0","0","0","0","20","11","9","1","0","1","2","1","1","0","0","0","-2"
"114813","Fresno Pacific University","2015","On-tenure track, instructors","1","1","0","0","0","0","1","1","0","0","0","0","0","0","0","0","0","0","0","0","0","0","0","0","0","0","0","0","0","0","-2"
"114813","Fresno Pacific University","2015","Not on tenure track/No tenure system system total","31","11","20","0","0","0","0","0","0","0","0","0","3","0","3","0","0","0","26","10","16","0","0","0","2","1","1","0","0","0","-2"
"114813","Fresno Pacific University","2015","Not on tenure/no tenure system, professors","1","1","0","0","0","0","0","0","0","0","0","0","0","0","0","0","0","0","1","1","0","0","0","0","0","0","0","0","0","0","-2"
"114813","Fresno Pacific University","2015","Not on tenure/no tenure system, associate professors","5","3","2","0","0","0","0","0","0","0","0","0","0","0","0","0","0","0","4","3","1","0","0","0","1","0","1","0","0","0","-2"
"114813","Fresno Pacific University","2015","Not on tenure/no tenure system, assistant professors","17","5","12","0","0","0","0","0","0","0","0","0","0","0","0","0","0","0","17","5","12","0","0","0","0","0","0","0","0","0","-2"
"114813","Fresno Pacific University","2015","Not on tenure/no tenure system, instructors","8","2","6","0","0","0","0","0","0","0","0","0","3","0","3","0","0","0","4","1","3","0","0","0","1","1","0","0","0","0","-2"
"115728","Holy Names University","2015","Tenured total","12","5","7","0","0","0","1","0","1","1","0","1","1","0","1","1","0","1","8","5","3","0","0","0","0","0","0","0","0","0","-2"
"115728","Holy Names University","2015","Tenured, professors","6","3","3","0","0","0","0","0","0","0","0","0","1","0","1","0","0","0","5","3","2","0","0","0","0","0","0","0","0","0","-2"
"115728","Holy Names University","2015","Tenured, associate professors","6","2","4","0","0","0","1","0","1","1","0","1","0","0","0","1","0","1","3","2","1","0","0","0","0","0","0","0","0","0","-2"
"115728","Holy Names University","2015","On-Tenure track total","15","6","9","0","0","0","4","3","1","1","1","0","0","0","0","0","0","0","9","2","7","0","0","0","0","0","0","1","0","1","-2"
"115728","Holy Names University","2015","On-tenure track, associate professors","2","2","0","0","0","0","1","1","0","0","0","0","0","0","0","0","0","0","1","1","0","0","0","0","0","0","0","0","0","0","-2"
"115728","Holy Names University","2015","On-tenure track, assistant professors","13","4","9","0","0","0","3","2","1","1","1","0","0","0","0","0","0","0","8","1","7","0","0","0","0","0","0","1","0","1","-2"
"115728","Holy Names University","2015","Not on tenure track/No tenure system system total","15","4","11","0","0","0","0","0","0","1","0","1","1","0","1","0","0","0","12","4","8","0","0","0","0","0","0","1","0","1","-2"
"115728","Holy Names University","2015","Not on tenure/no tenure system, professors","2","2","0","0","0","0","0","0","0","0","0","0","0","0","0","0","0","0","2","2","0","0","0","0","0","0","0","0","0","0","-2"
"115728","Holy Names University","2015","Not on tenure/no tenure system, associate professors","4","0","4","0","0","0","0","0","0","1","0","1","0","0","0","0","0","0","3","0","3","0","0","0","0","0","0","0","0","0","-2"
"115728","Holy Names University","2015","Not on tenure/no tenure system, assistant professors","4","1","3","0","0","0","0","0","0","0","0","0","1","0","1","0","0","0","2","1","1","0","0","0","0","0","0","1","0","1","-2"
"115728","Holy Names University","2015","Not on tenure/no tenure system, instructors","5","1","4","0","0","0","0","0","0","0","0","0","0","0","0","0","0","0","5","1","4","0","0","0","0","0","0","0","0","0","-2"
"115773","Humphreys University-Stockton and Modesto Campuses","2015","Not on tenure track/No tenure system system total","18","5","13","0","0","0","0","0","0","0","0","0","4","1","3","0","0","0","14","4","10","0","0","0","0","0","0","0","0","0","-2"
"115773","Humphreys University-Stockton and Modesto Campuses","2015","Not on tenure/no tenure system, professors","2","2","0","0","0","0","0","0","0","0","0","0","0","0","0","0","0","0","2","2","0","0","0","0","0","0","0","0","0","0","-2"
"115773","Humphreys University-Stockton and Modesto Campuses","2015","Not on tenure/no tenure system, associate professors","3","2","1","0","0","0","0","0","0","0","0","0","1","1","0","0","0","0","2","1","1","0","0","0","0","0","0","0","0","0","-2"
"115773","Humphreys University-Stockton and Modesto Campuses","2015","Not on tenure/no tenure system, assistant professors","9","1","8","0","0","0","0","0","0","0","0","0","3","0","3","0","0","0","6","1","5","0","0","0","0","0","0","0","0","0","-2"
"115773","Humphreys University-Stockton and Modesto Campuses","2015","Not on tenure/no tenure system, instructors","3","0","3","0","0","0","0","0","0","0","0","0","0","0","0","0","0","0","3","0","3","0","0","0","0","0","0","0","0","0","-2"
"115773","Humphreys University-Stockton and Modesto Campuses","2015","Not on tenure/no tenure system, no academic rank","1","0","1","0","0","0","0","0","0","0","0","0","0","0","0","0","0","0","1","0","1","0","0","0","0","0","0","0","0","0","-2"
"117104","Life Pacific University","2015","Not on tenure track/No tenure system system total","12","8","4","0","0","0","0","0","0","1","1","0","1","0","1","0","0","0","10","7","3","0","0","0","0","0","0","0","0","0","-2"
"117104","Life Pacific University","2015","Not on tenure/no tenure system, professors","4","3","1","0","0","0","0","0","0","0","0","0","0","0","0","0","0","0","4","3","1","0","0","0","0","0","0","0","0","0","-2"
"117104","Life Pacific University","2015","Not on tenure/no tenure system, associate professors","4","3","1","0","0","0","0","0","0","0","0","0","0","0","0","0","0","0","4","3","1","0","0","0","0","0","0","0","0","0","-2"
"117104","Life Pacific University","2015","Not on tenure/no tenure system, assistant professors","4","2","2","0","0","0","0","0","0","1","1","0","1","0","1","0","0","0","2","1","1","0","0","0","0","0","0","0","0","0","-2"
"117140","University of La Verne","2015","Tenured total","122","72","50","0","0","0","10","5","5","4","3","1","10","6","4","0","0","0","96","57","39","0","0","0","2","1","1","0","0","0","-2"
"117140","University of La Verne","2015","Tenured, professors","83","53","30","0","0","0","6","3","3","2","2","0","4","3","1","0","0","0","71","45","26","0","0","0","0","0","0","0","0","0","-2"
"117140","University of La Verne","2015","Tenured, associate professors","37","18","19","0","0","0","3","1","2","2","1","1","6","3","3","0","0","0","24","12","12","0","0","0","2","1","1","0","0","0","-2"
"117140","University of La Verne","2015","Tenured, assistant professors","2","1","1","0","0","0","1","1","0","0","0","0","0","0","0","0","0","0","1","0","1","0","0","0","0","0","0","0","0","0","-2"
"117140","University of La Verne","2015","On-Tenure track total","62","21","41","0","0","0","16","3","13","3","0","3","5","4","1","0","0","0","23","9","14","0","0","0","15","5","10","0","0","0","-2"
"117140","University of La Verne","2015","On-tenure track, associate professors","9","3","6","0","0","0","1","0","1","1","0","1","2","2","0","0","0","0","5","1","4","0","0","0","0","0","0","0","0","0","-2"
"117140","University of La Verne","2015","On-tenure track, assistant professors","53","18","35","0","0","0","15","3","12","2","0","2","3","2","1","0","0","0","18","8","10","0","0","0","15","5","10","0","0","0","-2"
"117140","University of La Verne","2015","Not on tenure track/No tenure system system total","78","29","49","0","0","0","2","1","1","4","2","2","12","5","7","0","0","0","44","13","31","0","0","0","16","8","8","0","0","0","-2"
"117140","University of La Verne","2015","Not on tenure/no tenure system, professors","8","4","4","0","0","0","0","0","0","1","1","0","0","0","0","0","0","0","7","3","4","0","0","0","0","0","0","0","0","0","-2"
"117140","University of La Verne","2015","Not on tenure/no tenure system, associate professors","11","0","11","0","0","0","0","0","0","1","0","1","0","0","0","0","0","0","7","0","7","0","0","0","3","0","3","0","0","0","-2"
"117140","University of La Verne","2015","Not on tenure/no tenure system, assistant professors","58","24","34","0","0","0","2","1","1","2","1","1","11","4","7","0","0","0","30","10","20","0","0","0","13","8","5","0","0","0","-2"
"117140","University of La Verne","2015","Not on tenure/no tenure system, instructors","1","1","0","0","0","0","0","0","0","0","0","0","1","1","0","0","0","0","0","0","0","0","0","0","0","0","0","0","0","0","-2"
"117627","La Sierra University","2015","Tenured total","39","25","14","0","0","0","8","6","2","2","2","0","2","1","1","0","0","0","25","15","10","2","1","1","0","0","0","0","0","0","-2"
"117627","La Sierra University","2015","Tenured, professors","19","15","4","0","0","0","4","3","1","0","0","0","2","1","1","0","0","0","13","11","2","0","0","0","0","0","0","0","0","0","-2"
"117627","La Sierra University","2015","Tenured, associate professors","20","10","10","0","0","0","4","3","1","2","2","0","0","0","0","0","0","0","12","4","8","2","1","1","0","0","0","0","0","0","-2"
"117627","La Sierra University","2015","On-Tenure track total","29","19","10","0","0","0","4","1","3","2","2","0","5","5","0","0","0","0","18","11","7","0","0","0","0","0","0","0","0","0","-2"
"117627","La Sierra University","2015","On-tenure track, professors","5","4","1","0","0","0","1","0","1","0","0","0","1","1","0","0","0","0","3","3","0","0","0","0","0","0","0","0","0","0","-2"
"117627","La Sierra University","2015","On-tenure track, associate professors","17","10","7","0","0","0","2","1","1","2","2","0","1","1","0","0","0","0","12","6","6","0","0","0","0","0","0","0","0","0","-2"
"117627","La Sierra University","2015","On-tenure track, assistant professors","7","5","2","0","0","0","1","0","1","0","0","0","3","3","0","0","0","0","3","2","1","0","0","0","0","0","0","0","0","0","-2"
"117627","La Sierra University","2015","Not on tenure track/No tenure system system total","34","15","19","0","0","0","5","3","2","1","0","1","4","4","0","0","0","0","23","8","15","1","0","1","0","0","0","0","0","0","-2"
"117627","La Sierra University","2015","Not on tenure/no tenure system, professors","4","2","2","0","0","0","1","0","1","0","0","0","0","0","0","0","0","0","3","2","1","0","0","0","0","0","0","0","0","0","-2"
"117627","La Sierra University","2015","Not on tenure/no tenure system, associate professors","5","1","4","0","0","0","0","0","0","0","0","0","0","0","0","0","0","0","5","1","4","0","0","0","0","0","0","0","0","0","-2"
"117627","La Sierra University","2015","Not on tenure/no tenure system, assistant professors","17","9","8","0","0","0","4","3","1","0","0","0","3","3","0","0","0","0","10","3","7","0","0","0","0","0","0","0","0","0","-2"
"117627","La Sierra University","2015","Not on tenure/no tenure system, lecturers","8","3","5","0","0","0","0","0","0","1","0","1","1","1","0","0","0","0","5","2","3","1","0","1","0","0","0","0","0","0","-2"
"117636","Loma Linda University","2015","Tenured total","20","14","6","0","0","0","3","2","1","1","1","0","1","1","0","0","0","0","15","10","5","0","0","0","0","0","0","0","0","0","-2"
"117636","Loma Linda University","2015","Tenured, professors","19","13","6","0","0","0","3","2","1","1","1","0","1","1","0","0","0","0","14","9","5","0","0","0","0","0","0","0","0","0","-2"
"117636","Loma Linda University","2015","Tenured, associate professors","1","1","0","0","0","0","0","0","0","0","0","0","0","0","0","0","0","0","1","1","0","0","0","0","0","0","0","0","0","0","-2"
"117636","Loma Linda University","2015","On-Tenure track total","56","31","25","0","0","0","9","3","6","7","3","4","6","4","2","0","0","0","34","21","13","0","0","0","0","0","0","0","0","0","-2"
"117636","Loma Linda University","2015","On-tenure track, professors","14","12","2","0","0","0","3","2","1","1","1","0","2","2","0","0","0","0","8","7","1","0","0","0","0","0","0","0","0","0","-2"
"117636","Loma Linda University","2015","On-tenure track, associate professors","14","8","6","0","0","0","5","1","4","1","1","0","0","0","0","0","0","0","8","6","2","0","0","0","0","0","0","0","0","0","-2"
"117636","Loma Linda University","2015","On-tenure track, assistant professors","25","10","15","0","0","0","1","0","1","4","1","3","4","2","2","0","0","0","16","7","9","0","0","0","0","0","0","0","0","0","-2"
"117636","Loma Linda University","2015","On-tenure track, instructors","3","1","2","0","0","0","0","0","0","1","0","1","0","0","0","0","0","0","2","1","1","0","0","0","0","0","0","0","0","0","-2"
"117636","Loma Linda University","2015","Not on tenure track/No tenure system system total","333","144","189","1","1","0","57","26","31","22","10","12","22","9","13","0","0","0","221","90","131","3","1","2","0","0","0","7","7","0","-2"
"117636","Loma Linda University","2015","Not on tenure/no tenure system, professors","36","22","14","0","0","0","6","5","1","4","2","2","2","1","1","0","0","0","23","13","10","0","0","0","0","0","0","1","1","0","-2"
"117636","Loma Linda University","2015","Not on tenure/no tenure system, associate professors","66","32","34","0","0","0","6","3","3","7","5","2","2","1","1","0","0","0","49","21","28","0","0","0","0","0","0","2","2","0","-2"
"117636","Loma Linda University","2015","Not on tenure/no tenure system, assistant professors","179","71","108","0","0","0","32","12","20","10","2","8","17","7","10","0","0","0","116","47","69","1","0","1","0","0","0","3","3","0","-2"
"117636","Loma Linda University","2015","Not on tenure/no tenure system, instructors","52","19","33","1","1","0","13","6","7","1","1","0","1","0","1","0","0","0","33","9","24","2","1","1","0","0","0","1","1","0","-2"
"118541","Marymount California University","2015","Not on tenure track/No tenure system system total","32","16","16","0","0","0","2","1","1","3","2","1","3","2","1","0","0","0","24","11","13","0","0","0","0","0","0","0","0","0","-2"
"118541","Marymount California University","2015","Not on tenure/no tenure system, professors","17","10","7","0","0","0","0","0","0","1","0","1","1","1","0","0","0","0","15","9","6","0","0","0","0","0","0","0","0","0","-2"
"118541","Marymount California University","2015","Not on tenure/no tenure system, associate professors","9","4","5","0","0","0","1","0","1","2","2","0","0","0","0","0","0","0","6","2","4","0","0","0","0","0","0","0","0","0","-2"
"118541","Marymount California University","2015","Not on tenure/no tenure system, assistant professors","5","2","3","0","0","0","1","1","0","0","0","0","2","1","1","0","0","0","2","0","2","0","0","0","0","0","0","0","0","0","-2"
"118541","Marymount California University","2015","Not on tenure/no tenure system, instructors","1","0","1","0","0","0","0","0","0","0","0","0","0","0","0","0","0","0","1","0","1","0","0","0","0","0","0","0","0","0","-2"
"118693","Menlo College","2015","Not on tenure track/No tenure system system total","31","16","15","0","0","0","7","4","3","3","0","3","0","0","0","0","0","0","21","12","9","0","0","0","0","0","0","0","0","0","-2"
"118693","Menlo College","2015","Not on tenure/no tenure system, professors","13","7","6","0","0","0","4","3","1","1","0","1","0","0","0","0","0","0","8","4","4","0","0","0","0","0","0","0","0","0","-2"
"118693","Menlo College","2015","Not on tenure/no tenure system, associate professors","8","2","6","0","0","0","1","0","1","1","0","1","0","0","0","0","0","0","6","2","4","0","0","0","0","0","0","0","0","0","-2"
"118693","Menlo College","2015","Not on tenure/no tenure system, assistant professors","4","2","2","0","0","0","1","1","0","1","0","1","0","0","0","0","0","0","2","1","1","0","0","0","0","0","0","0","0","0","-2"
"118693","Menlo College","2015","Not on tenure/no tenure system, instructors","1","1","0","0","0","0","0","0","0","0","0","0","0","0","0","0","0","0","1","1","0","0","0","0","0","0","0","0","0","0","-2"
"118693","Menlo College","2015","Not on tenure/no tenure system, lecturers","5","4","1","0","0","0","1","0","1","0","0","0","0","0","0","0","0","0","4","4","0","0","0","0","0","0","0","0","0","0","-2"
"118888","Mills College","2015","Tenured total","66","24","42","0","0","0","6","3","3","6","2","4","6","2","4","0","0","0","44","17","27","4","0","4","0","0","0","0","0","0","-2"
"118888","Mills College","2015","Tenured, professors","48","19","29","0","0","0","2","1","1","4","1","3","5","2","3","0","0","0","36","15","21","1","0","1","0","0","0","0","0","0","-2"
"118888","Mills College","2015","Tenured, associate professors","17","4","13","0","0","0","4","2","2","1","0","1","1","0","1","0","0","0","8","2","6","3","0","3","0","0","0","0","0","0","-2"
"118888","Mills College","2015","Tenured, no academic rank","1","1","0","0","0","0","0","0","0","1","1","0","0","0","0","0","0","0","0","0","0","0","0","0","0","0","0","0","0","0","-2"
"118888","Mills College","2015","On-Tenure track total","14","2","12","0","0","0","3","1","2","1","0","1","0","0","0","0","0","0","10","1","9","0","0","0","0","0","0","0","0","0","-2"
"118888","Mills College","2015","On-tenure track, associate professors","1","0","1","0","0","0","0","0","0","1","0","1","0","0","0","0","0","0","0","0","0","0","0","0","0","0","0","0","0","0","-2"
"118888","Mills College","2015","On-tenure track, assistant professors","13","2","11","0","0","0","3","1","2","0","0","0","0","0","0","0","0","0","10","1","9","0","0","0","0","0","0","0","0","0","-2"
"118888","Mills College","2015","Not on tenure track/No tenure system system total","33","9","24","0","0","0","5","0","5","1","0","1","1","0","1","0","0","0","25","9","16","0","0","0","1","0","1","0","0","0","-2"
"118888","Mills College","2015","Not on tenure/no tenure system, professors","2","0","2","0","0","0","0","0","0","0","0","0","0","0","0","0","0","0","2","0","2","0","0","0","0","0","0","0","0","0","-2"
"118888","Mills College","2015","Not on tenure/no tenure system, associate professors","3","1","2","0","0","0","0","0","0","0","0","0","1","0","1","0","0","0","2","1","1","0","0","0","0","0","0","0","0","0","-2"
"118888","Mills College","2015","Not on tenure/no tenure system, assistant professors","24","7","17","0","0","0","2","0","2","1","0","1","0","0","0","0","0","0","20","7","13","0","0","0","1","0","1","0","0","0","-2"
"118888","Mills College","2015","Not on tenure/no tenure system, lecturers","3","1","2","0","0","0","2","0","2","0","0","0","0","0","0","0","0","0","1","1","0","0","0","0","0","0","0","0","0","0","-2"
"118888","Mills College","2015","Not on tenure/no tenure system, no academic rank","1","0","1","0","0","0","1","0","1","0","0","0","0","0","0","0","0","0","0","0","0","0","0","0","0","0","0","0","0","0","-2"
"118912","MiraCosta College","2015","Tenured total","154","77","77","0","0","0","9","5","4","7","5","2","31","17","14","0","0","0","101","49","52","5","1","4","1","0","1","0","0","0","-2"
"118912","MiraCosta College","2015","Tenured, instructors","154","77","77","0","0","0","9","5","4","7","5","2","31","17","14","0","0","0","101","49","52","5","1","4","1","0","1","0","0","0","-2"
"118912","MiraCosta College","2015","On-Tenure track total","28","11","17","1","0","1","2","0","2","0","0","0","4","1","3","1","1","0","18","9","9","1","0","1","1","0","1","0","0","0","-2"
"118912","MiraCosta College","2015","On-tenure track, instructors","28","11","17","1","0","1","2","0","2","0","0","0","4","1","3","1","1","0","18","9","9","1","0","1","1","0","1","0","0","0","-2"
"118912","MiraCosta College","2015","Not on tenure track/No tenure system system total","5","2","3","0","0","0","1","1","0","1","1","0","1","0","1","0","0","0","1","0","1","0","0","0","0","0","0","1","0","1","-2"
"118912","MiraCosta College","2015","Not on tenure/no tenure system, instructors","5","2","3","0","0","0","1","1","0","1","1","0","1","0","1","0","0","0","1","0","1","0","0","0","0","0","0","1","0","1","-2"
"118976","Modesto Junior College","2015","Tenured total","124","52","72","1","0","1","4","1","3","5","2","3","13","8","5","0","0","0","89","37","52","0","0","0","11","4","7","1","0","1","-2"
"118976","Modesto Junior College","2015","Tenured, instructors","124","52","72","1","0","1","4","1","3","5","2","3","13","8","5","0","0","0","89","37","52","0","0","0","11","4","7","1","0","1","-2"
"118976","Modesto Junior College","2015","On-Tenure track total","54","34","20","0","0","0","1","0","1","4","1","3","4","3","1","0","0","0","39","28","11","0","0","0","6","2","4","0","0","0","-2"
"118976","Modesto Junior College","2015","On-tenure track, instructors","54","34","20","0","0","0","1","0","1","4","1","3","4","3","1","0","0","0","39","28","11","0","0","0","6","2","4","0","0","0","-2"
"118976","Modesto Junior College","2015","Not on tenure track/No tenure system system total","59","24","35","1","1","0","3","0","3","4","1","3","5","2","3","1","0","1","40","20","20","1","0","1","3","0","3","1","0","1","-2"
"118976","Modesto Junior College","2015","Not on tenure/no tenure system, instructors","59","24","35","1","1","0","3","0","3","4","1","3","5","2","3","1","0","1","40","20","20","1","0","1","3","0","3","1","0","1","-2"
"119173","Mount Saint Mary's University","2015","Tenured total","54","14","40","1","0","1","4","1","3","4","0","4","1","1","0","0","0","0","42","11","31","2","1","1","0","0","0","0","0","0","-2"
"119173","Mount Saint Mary's University","2015","Tenured, professors","21","6","15","1","0","1","2","0","2","0","0","0","1","1","0","0","0","0","16","5","11","1","0","1","0","0","0","0","0","0","-2"
"119173","Mount Saint Mary's University","2015","Tenured, associate professors","23","5","18","0","0","0","2","1","1","2","0","2","0","0","0","0","0","0","19","4","15","0","0","0","0","0","0","0","0","0","-2"
"119173","Mount Saint Mary's University","2015","Tenured, assistant professors","10","3","7","0","0","0","0","0","0","2","0","2","0","0","0","0","0","0","7","2","5","1","1","0","0","0","0","0","0","0","-2"
"119173","Mount Saint Mary's University","2015","On-Tenure track total","23","6","17","0","0","0","5","3","2","4","1","3","1","0","1","0","0","0","10","2","8","3","0","3","0","0","0","0","0","0","-2"
"119173","Mount Saint Mary's University","2015","On-tenure track, professors","1","1","0","0","0","0","0","0","0","0","0","0","0","0","0","0","0","0","1","1","0","0","0","0","0","0","0","0","0","0","-2"
"119173","Mount Saint Mary's University","2015","On-tenure track, associate professors","8","2","6","0","0","0","2","2","0","1","0","1","1","0","1","0","0","0","3","0","3","1","0","1","0","0","0","0","0","0","-2"
"119173","Mount Saint Mary's University","2015","On-tenure track, assistant professors","13","3","10","0","0","0","3","1","2","2","1","1","0","0","0","0","0","0","6","1","5","2","0","2","0","0","0","0","0","0","-2"
"119173","Mount Saint Mary's University","2015","On-tenure track, instructors","1","0","1","0","0","0","0","0","0","1","0","1","0","0","0","0","0","0","0","0","0","0","0","0","0","0","0","0","0","0","-2"
"119173","Mount Saint Mary's University","2015","Not on tenure track/No tenure system system total","44","10","34","1","1","0","4","0","4","4","1","3","2","1","1","0","0","0","26","6","20","7","1","6","0","0","0","0","0","0","-2"
"119173","Mount Saint Mary's University","2015","Not on tenure/no tenure system, professors","1","0","1","0","0","0","0","0","0","0","0","0","0","0","0","0","0","0","1","0","1","0","0","0","0","0","0","0","0","0","-2"
"119173","Mount Saint Mary's University","2015","Not on tenure/no tenure system, associate professors","4","1","3","0","0","0","0","0","0","0","0","0","0","0","0","0","0","0","3","0","3","1","1","0","0","0","0","0","0","0","-2"
"119173","Mount Saint Mary's University","2015","Not on tenure/no tenure system, assistant professors","25","7","18","0","0","0","3","0","3","2","1","1","1","1","0","0","0","0","16","5","11","3","0","3","0","0","0","0","0","0","-2"
"119173","Mount Saint Mary's University","2015","Not on tenure/no tenure system, instructors","14","2","12","1","1","0","1","0","1","2","0","2","1","0","1","0","0","0","6","1","5","3","0","3","0","0","0","0","0","0","-2"
"119605","National University","2015","Not on tenure track/No tenure system system total","299","146","153","1","1","0","33","20","13","19","8","11","23","10","13","0","0","0","207","103","104","4","2","2","11","2","9","1","0","1","-2"
"119605","National University","2015","Not on tenure/no tenure system, professors","102","66","36","1","1","0","13","10","3","6","3","3","6","2","4","0","0","0","72","48","24","1","1","0","3","1","2","0","0","0","-2"
"119605","National University","2015","Not on tenure/no tenure system, associate professors","93","40","53","0","0","0","7","5","2","5","2","3","6","3","3","0","0","0","69","29","40","3","1","2","2","0","2","1","0","1","-2"
"119605","National University","2015","Not on tenure/no tenure system, assistant professors","80","31","49","0","0","0","11","4","7","6","2","4","8","3","5","0","0","0","50","21","29","0","0","0","5","1","4","0","0","0","-2"
"119605","National University","2015","Not on tenure/no tenure system, instructors","21","7","14","0","0","0","2","1","1","2","1","1","2","1","1","0","0","0","14","4","10","0","0","0","1","0","1","0","0","0","-2"
"119605","National University","2015","Not on tenure/no tenure system, no academic rank","3","2","1","0","0","0","0","0","0","0","0","0","1","1","0","0","0","0","2","1","1","0","0","0","0","0","0","0","0","0","-2"
"120184","Notre Dame de Namur University","2015","Tenured total","35","19","16","1","1","0","5","2","3","1","1","0","1","0","1","0","0","0","27","15","12","0","0","0","0","0","0","0","0","0","-2"
"120184","Notre Dame de Namur University","2015","Tenured, professors","32","19","13","1","1","0","3","2","1","1","1","0","1","0","1","0","0","0","26","15","11","0","0","0","0","0","0","0","0","0","-2"
"120184","Notre Dame de Namur University","2015","Tenured, associate professors","3","0","3","0","0","0","2","0","2","0","0","0","0","0","0","0","0","0","1","0","1","0","0","0","0","0","0","0","0","0","-2"
"120184","Notre Dame de Namur University","2015","On-Tenure track total","12","2","10","0","0","0","2","0","2","1","0","1","1","1","0","0","0","0","6","1","5","2","0","2","0","0","0","0","0","0","-2"
"120184","Notre Dame de Namur University","2015","On-tenure track, associate professors","2","0","2","0","0","0","0","0","0","0","0","0","0","0","0","0","0","0","2","0","2","0","0","0","0","0","0","0","0","0","-2"
"120184","Notre Dame de Namur University","2015","On-tenure track, assistant professors","10","2","8","0","0","0","2","0","2","1","0","1","1","1","0","0","0","0","4","1","3","2","0","2","0","0","0","0","0","0","-2"
"120184","Notre Dame de Namur University","2015","Not on tenure track/No tenure system system total","11","3","8","0","0","0","3","1","2","1","0","1","0","0","0","0","0","0","7","2","5","0","0","0","0","0","0","0","0","0","-2"
"120184","Notre Dame de Namur University","2015","Not on tenure/no tenure system, associate professors","2","1","1","0","0","0","2","1","1","0","0","0","0","0","0","0","0","0","0","0","0","0","0","0","0","0","0","0","0","0","-2"
"120184","Notre Dame de Namur University","2015","Not on tenure/no tenure system, assistant professors","6","1","5","0","0","0","1","0","1","1","0","1","0","0","0","0","0","0","4","1","3","0","0","0","0","0","0","0","0","0","-2"
"120184","Notre Dame de Namur University","2015","Not on tenure/no tenure system, instructors","2","1","1","0","0","0","0","0","0","0","0","0","0","0","0","0","0","0","2","1","1","0","0","0","0","0","0","0","0","0","-2"
"120184","Notre Dame de Namur University","2015","Not on tenure/no tenure system, no academic rank","1","0","1","0","0","0","0","0","0","0","0","0","0","0","0","0","0","0","1","0","1","0","0","0","0","0","0","0","0","0","-2"
"120537","Hope International University","2015","Not on tenure track/No tenure system system total","39","23","16","0","0","0","2","1","1","1","0","1","2","2","0","0","0","0","34","20","14","0","0","0","0","0","0","0","0","0","-2"
"120537","Hope International University","2015","Not on tenure/no tenure system, professors","9","7","2","0","0","0","1","1","0","0","0","0","0","0","0","0","0","0","8","6","2","0","0","0","0","0","0","0","0","0","-2"
"120537","Hope International University","2015","Not on tenure/no tenure system, associate professors","22","12","10","0","0","0","1","0","1","1","0","1","2","2","0","0","0","0","18","10","8","0","0","0","0","0","0","0","0","0","-2"
"120537","Hope International University","2015","Not on tenure/no tenure system, assistant professors","8","4","4","0","0","0","0","0","0","0","0","0","0","0","0","0","0","0","8","4","4","0","0","0","0","0","0","0","0","0","-2"
"120768","Pacific Oaks College","2015","Not on tenure track/No tenure system system total","15","3","12","0","0","0","0","0","0","5","1","4","4","1","3","0","0","0","6","1","5","0","0","0","0","0","0","0","0","0","-2"
"120768","Pacific Oaks College","2015","Not on tenure/no tenure system, professors","15","3","12","0","0","0","0","0","0","5","1","4","4","1","3","0","0","0","6","1","5","0","0","0","0","0","0","0","0","0","-2"
"120865","Pacific Union College","2015","Tenured total","36","22","14","0","0","0","2","1","1","1","1","0","1","0","1","0","0","0","25","16","9","3","1","2","4","3","1","0","0","0","-2"
"120865","Pacific Union College","2015","Tenured, professors","27","18","9","0","0","0","2","1","1","1","1","0","0","0","0","0","0","0","17","12","5","3","1","2","4","3","1","0","0","0","-2"
"120865","Pacific Union College","2015","Tenured, associate professors","9","4","5","0","0","0","0","0","0","0","0","0","1","0","1","0","0","0","8","4","4","0","0","0","0","0","0","0","0","0","-2"
"120865","Pacific Union College","2015","On-Tenure track total","39","13","26","0","0","0","6","4","2","1","0","1","1","0","1","0","0","0","27","8","19","3","1","2","1","0","1","0","0","0","-2"
"120865","Pacific Union College","2015","On-tenure track, professors","8","4","4","0","0","0","2","2","0","0","0","0","0","0","0","0","0","0","5","1","4","1","1","0","0","0","0","0","0","0","-2"
"120865","Pacific Union College","2015","On-tenure track, associate professors","8","2","6","0","0","0","0","0","0","1","0","1","0","0","0","0","0","0","5","2","3","2","0","2","0","0","0","0","0","0","-2"
"120865","Pacific Union College","2015","On-tenure track, assistant professors","22","7","15","0","0","0","4","2","2","0","0","0","1","0","1","0","0","0","16","5","11","0","0","0","1","0","1","0","0","0","-2"
"120865","Pacific Union College","2015","On-tenure track, instructors","1","0","1","0","0","0","0","0","0","0","0","0","0","0","0","0","0","0","1","0","1","0","0","0","0","0","0","0","0","0","-2"
"120865","Pacific Union College","2015","Not on tenure track/No tenure system system total","17","13","4","0","0","0","0","0","0","2","1","1","2","0","2","0","0","0","8","8","0","1","1","0","1","1","0","3","2","1","-2"
"120865","Pacific Union College","2015","Not on tenure/no tenure system, associate professors","5","5","0","0","0","0","0","0","0","0","0","0","0","0","0","0","0","0","4","4","0","0","0","0","0","0","0","1","1","0","-2"
"120865","Pacific Union College","2015","Not on tenure/no tenure system, assistant professors","8","5","3","0","0","0","0","0","0","1","0","1","1","0","1","0","0","0","3","3","0","0","0","0","1","1","0","2","1","1","-2"
"120865","Pacific Union College","2015","Not on tenure/no tenure system, instructors","4","3","1","0","0","0","0","0","0","1","1","0","1","0","1","0","0","0","1","1","0","1","1","0","0","0","0","0","0","0","-2"
"121619","Santa Ana College","2015","Tenured total","129","57","72","2","1","1","12","6","6","2","0","2","30","11","19","0","0","0","81","38","43","0","0","0","1","0","1","1","1","0","-2"
"121619","Santa Ana College","2015","Tenured, instructors","129","57","72","2","1","1","12","6","6","2","0","2","30","11","19","0","0","0","81","38","43","0","0","0","1","0","1","1","1","0","-2"
"121619","Santa Ana College","2015","On-Tenure track total","103","50","53","0","0","0","18","7","11","2","1","1","28","12","16","0","0","0","51","27","24","0","0","0","4","3","1","0","0","0","-2"
"121619","Santa Ana College","2015","On-tenure track, instructors","103","50","53","0","0","0","18","7","11","2","1","1","28","12","16","0","0","0","51","27","24","0","0","0","4","3","1","0","0","0","-2"
"121619","Santa Ana College","2015","Not on tenure track/No tenure system system total","8","3","5","0","0","0","0","0","0","0","0","0","5","2","3","0","0","0","1","0","1","0","0","0","0","0","0","2","1","1","-2"
"121619","Santa Ana College","2015","Not on tenure/no tenure system, instructors","8","3","5","0","0","0","0","0","0","0","0","0","5","2","3","0","0","0","1","0","1","0","0","0","0","0","0","2","1","1","-2"
"121691","University of Redlands","2015","Tenured total","158","80","78","1","1","0","20","11","9","4","2","2","5","3","2","0","0","0","126","62","64","0","0","0","2","1","1","0","0","0","-2"
"121691","University of Redlands","2015","Tenured, professors","106","59","47","0","0","0","10","7","3","2","2","0","3","2","1","0","0","0","90","48","42","0","0","0","1","0","1","0","0","0","-2"
"121691","University of Redlands","2015","Tenured, associate professors","52","21","31","1","1","0","10","4","6","2","0","2","2","1","1","0","0","0","36","14","22","0","0","0","1","1","0","0","0","0","-2"
"121691","University of Redlands","2015","On-Tenure track total","10","6","4","0","0","0","0","0","0","0","0","0","0","0","0","0","0","0","10","6","4","0","0","0","0","0","0","0","0","0","-2"
"121691","University of Redlands","2015","On-tenure track, associate professors","1","1","0","0","0","0","0","0","0","0","0","0","0","0","0","0","0","0","1","1","0","0","0","0","0","0","0","0","0","0","-2"
"121691","University of Redlands","2015","On-tenure track, assistant professors","9","5","4","0","0","0","0","0","0","0","0","0","0","0","0","0","0","0","9","5","4","0","0","0","0","0","0","0","0","0","-2"
"121691","University of Redlands","2015","Not on tenure track/No tenure system system total","38","21","17","0","0","0","4","3","1","1","1","0","1","1","0","0","0","0","30","14","16","0","0","0","2","2","0","0","0","0","-2"
"121691","University of Redlands","2015","Not on tenure/no tenure system, professors","2","2","0","0","0","0","1","1","0","0","0","0","0","0","0","0","0","0","1","1","0","0","0","0","0","0","0","0","0","0","-2"
"121691","University of Redlands","2015","Not on tenure/no tenure system, lecturers","11","5","6","0","0","0","0","0","0","0","0","0","1","1","0","0","0","0","10","4","6","0","0","0","0","0","0","0","0","0","-2"
"121691","University of Redlands","2015","Not on tenure/no tenure system, no academic rank","25","14","11","0","0","0","3","2","1","1","1","0","0","0","0","0","0","0","19","9","10","0","0","0","2","2","0","0","0","0","-2"
"121886","Rio Hondo College","2015","Tenured total","158","80","78","3","3","0","15","7","8","5","3","2","49","21","28","0","0","0","82","43","39","3","2","1","0","0","0","1","1","0","-2"
"121886","Rio Hondo College","2015","Tenured, instructors","158","80","78","3","3","0","15","7","8","5","3","2","49","21","28","0","0","0","82","43","39","3","2","1","0","0","0","1","1","0","-2"
"121886","Rio Hondo College","2015","On-Tenure track total","32","10","22","0","0","0","6","1","5","2","0","2","19","6","13","0","0","0","4","3","1","0","0","0","1","0","1","0","0","0","-2"
"121886","Rio Hondo College","2015","On-tenure track, instructors","32","10","22","0","0","0","6","1","5","2","0","2","19","6","13","0","0","0","4","3","1","0","0","0","1","0","1","0","0","0","-2"
"122375","San Diego Mesa College","2015","Tenured total","185","94","91","2","1","1","19","6","13","15","9","6","25","12","13","0","0","0","106","57","49","0","0","0","18","9","9","0","0","0","-2"
"122375","San Diego Mesa College","2015","Tenured, instructors","185","94","91","2","1","1","19","6","13","15","9","6","25","12","13","0","0","0","106","57","49","0","0","0","18","9","9","0","0","0","-2"
"122375","San Diego Mesa College","2015","On-Tenure track total","50","17","33","0","0","0","3","0","3","2","1","1","8","5","3","0","0","0","29","7","22","0","0","0","7","4","3","1","0","1","-2"
"122375","San Diego Mesa College","2015","On-tenure track, instructors","50","17","33","0","0","0","3","0","3","2","1","1","8","5","3","0","0","0","29","7","22","0","0","0","7","4","3","1","0","1","-2"
"122375","San Diego Mesa College","2015","Not on tenure track/No tenure system system total","1","1","0","0","0","0","0","0","0","1","1","0","0","0","0","0","0","0","0","0","0","0","0","0","0","0","0","0","0","0","-2"
"122375","San Diego Mesa College","2015","Not on tenure/no tenure system, instructors","1","1","0","0","0","0","0","0","0","1","1","0","0","0","0","0","0","0","0","0","0","0","0","0","0","0","0","0","0","0","-2"
"122977","Santa Monica College","2015","Tenured total","259","116","143","0","0","0","29","12","17","29","13","16","32","12","20","0","0","0","152","74","78","1","0","1","0","0","0","16","5","11","-2"
"122977","Santa Monica College","2015","Tenured, instructors","259","116","143","0","0","0","29","12","17","29","13","16","32","12","20","0","0","0","152","74","78","1","0","1","0","0","0","16","5","11","-2"
"122977","Santa Monica College","2015","On-Tenure track total","65","26","39","0","0","0","6","1","5","6","1","5","7","4","3","0","0","0","23","11","12","0","0","0","1","1","0","22","8","14","-2"
"122977","Santa Monica College","2015","On-tenure track, instructors","65","26","39","0","0","0","6","1","5","6","1","5","7","4","3","0","0","0","23","11","12","0","0","0","1","1","0","22","8","14","-2"
"122977","Santa Monica College","2015","Not on tenure track/No tenure system system total","14","4","10","0","0","0","1","0","1","1","1","0","2","0","2","0","0","0","6","1","5","0","0","0","0","0","0","4","2","2","-2"
"122977","Santa Monica College","2015","Not on tenure/no tenure system, instructors","14","4","10","0","0","0","1","0","1","1","1","0","2","0","2","0","0","0","6","1","5","0","0","0","0","0","0","4","2","2","-2"
"123509","Skyline College","2015","Tenured total","82","44","38","0","0","0","19","10","9","5","5","0","10","5","5","0","0","0","45","23","22","0","0","0","2","1","1","1","0","1","-2"
"123509","Skyline College","2015","Tenured, instructors","82","44","38","0","0","0","19","10","9","5","5","0","10","5","5","0","0","0","45","23","22","0","0","0","2","1","1","1","0","1","-2"
"123509","Skyline College","2015","On-Tenure track total","43","19","24","0","0","0","9","3","6","5","3","2","7","3","4","0","0","0","13","7","6","0","0","0","9","3","6","0","0","0","-2"
"123509","Skyline College","2015","On-tenure track, instructors","43","19","24","0","0","0","9","3","6","5","3","2","7","3","4","0","0","0","13","7","6","0","0","0","9","3","6","0","0","0","-2"
"123509","Skyline College","2015","Not on tenure track/No tenure system system total","5","5","0","0","0","0","2","2","0","1","1","0","0","0","0","0","0","0","2","2","0","0","0","0","0","0","0","0","0","0","-2"
"123509","Skyline College","2015","Not on tenure/no tenure system, instructors","5","5","0","0","0","0","2","2","0","1","1","0","0","0","0","0","0","0","2","2","0","0","0","0","0","0","0","0","0","0","-2"
"123554","Saint Mary's College of California","2015","Tenured total","135","69","66","1","0","1","16","8","8","3","1","2","7","4","3","0","0","0","99","53","46","0","0","0","5","2","3","4","1","3","-2"
"123554","Saint Mary's College of California","2015","Tenured, professors","77","45","32","1","0","1","9","5","4","0","0","0","5","3","2","0","0","0","61","37","24","0","0","0","1","0","1","0","0","0","-2"
"123554","Saint Mary's College of California","2015","Tenured, associate professors","58","24","34","0","0","0","7","3","4","3","1","2","2","1","1","0","0","0","38","16","22","0","0","0","4","2","2","4","1","3","-2"
"123554","Saint Mary's College of California","2015","On-Tenure track total","48","16","32","0","0","0","7","1","6","2","1","1","7","1","6","0","0","0","14","5","9","0","0","0","13","7","6","5","1","4","-2"
"123554","Saint Mary's College of California","2015","On-tenure track, associate professors","10","4","6","0","0","0","1","0","1","1","1","0","1","0","1","0","0","0","1","0","1","0","0","0","6","3","3","0","0","0","-2"
"123554","Saint Mary's College of California","2015","On-tenure track, assistant professors","38","12","26","0","0","0","6","1","5","1","0","1","6","1","5","0","0","0","13","5","8","0","0","0","7","4","3","5","1","4","-2"
"123554","Saint Mary's College of California","2015","Not on tenure track/No tenure system system total","39","17","22","0","0","0","3","1","2","0","0","0","1","1","0","0","0","0","23","11","12","0","0","0","9","3","6","3","1","2","-2"
"123554","Saint Mary's College of California","2015","Not on tenure/no tenure system, professors","1","1","0","0","0","0","0","0","0","0","0","0","0","0","0","0","0","0","0","0","0","0","0","0","1","1","0","0","0","0","-2"
"123554","Saint Mary's College of California","2015","Not on tenure/no tenure system, associate professors","21","8","13","0","0","0","1","0","1","0","0","0","0","0","0","0","0","0","13","5","8","0","0","0","5","2","3","2","1","1","-2"
"123554","Saint Mary's College of California","2015","Not on tenure/no tenure system, assistant professors","17","8","9","0","0","0","2","1","1","0","0","0","1","1","0","0","0","0","10","6","4","0","0","0","3","0","3","1","0","1","-2"
"123563","Solano Community College","2015","Tenured total","114","56","58","0","0","0","6","3","3","8","3","5","13","6","7","0","0","0","87","44","43","0","0","0","0","0","0","0","0","0","-2"
"123563","Solano Community College","2015","Tenured, instructors","114","56","58","0","0","0","6","3","3","8","3","5","13","6","7","0","0","0","87","44","43","0","0","0","0","0","0","0","0","0","-2"
"123563","Solano Community College","2015","On-Tenure track total","28","10","18","0","0","0","1","0","1","5","3","2","2","1","1","0","0","0","20","6","14","0","0","0","0","0","0","0","0","0","-2"
"123563","Solano Community College","2015","On-tenure track, instructors","28","10","18","0","0","0","1","0","1","5","3","2","2","1","1","0","0","0","20","6","14","0","0","0","0","0","0","0","0","0","-2"
"123563","Solano Community College","2015","Not on tenure track/No tenure system system total","20","10","10","0","0","0","1","0","1","1","1","0","0","0","0","0","0","0","16","8","8","0","0","0","1","0","1","1","1","0","-2"
"123563","Solano Community College","2015","Not on tenure/no tenure system, instructors","20","10","10","0","0","0","1","0","1","1","1","0","0","0","0","0","0","0","16","8","8","0","0","0","1","0","1","1","1","0","-2"
"123572","Sonoma State University","2015","Tenured total","175","91","84","0","0","0","14","11","3","2","0","2","11","6","5","0","0","0","140","69","71","2","2","0","6","3","3","0","0","0","-2"
"123572","Sonoma State University","2015","Tenured, professors","121","61","60","0","0","0","9","8","1","2","0","2","6","2","4","0","0","0","99","48","51","1","1","0","4","2","2","0","0","0","-2"
"123572","Sonoma State University","2015","Tenured, associate professors","54","30","24","0","0","0","5","3","2","0","0","0","5","4","1","0","0","0","41","21","20","1","1","0","2","1","1","0","0","0","-2"
"123572","Sonoma State University","2015","On-Tenure track total","36","17","19","1","0","1","4","2","2","0","0","0","3","1","2","0","0","0","19","9","10","0","0","0","6","2","4","3","3","0","-2"
"123572","Sonoma State University","2015","On-tenure track, assistant professors","36","17","19","1","0","1","4","2","2","0","0","0","3","1","2","0","0","0","19","9","10","0","0","0","6","2","4","3","3","0","-2"
"123572","Sonoma State University","2015","Not on tenure track/No tenure system system total","35","13","22","0","0","0","0","0","0","1","0","1","2","0","2","0","0","0","27","9","18","0","0","0","5","4","1","0","0","0","-2"
"123572","Sonoma State University","2015","Not on tenure/no tenure system, lecturers","35","13","22","0","0","0","0","0","0","1","0","1","2","0","2","0","0","0","27","9","18","0","0","0","5","4","1","0","0","0","-2"
"123651","Vanguard University of Southern California","2015","Tenured total","39","24","15","0","0","0","3","1","2","1","1","0","2","1","1","0","0","0","32","20","12","1","1","0","0","0","0","0","0","0","-2"
"123651","Vanguard University of Southern California","2015","Tenured, professors","29","20","9","0","0","0","1","0","1","0","0","0","2","1","1","0","0","0","25","18","7","1","1","0","0","0","0","0","0","0","-2"
"123651","Vanguard University of Southern California","2015","Tenured, associate professors","9","4","5","0","0","0","2","1","1","1","1","0","0","0","0","0","0","0","6","2","4","0","0","0","0","0","0","0","0","0","-2"
"123651","Vanguard University of Southern California","2015","Tenured, assistant professors","1","0","1","0","0","0","0","0","0","0","0","0","0","0","0","0","0","0","1","0","1","0","0","0","0","0","0","0","0","0","-2"
"123651","Vanguard University of Southern California","2015","On-Tenure track total","16","6","10","0","0","0","3","0","3","0","0","0","3","1","2","0","0","0","8","4","4","1","1","0","1","0","1","0","0","0","-2"
"123651","Vanguard University of Southern California","2015","On-tenure track, professors","1","1","0","0","0","0","0","0","0","0","0","0","0","0","0","0","0","0","0","0","0","1","1","0","0","0","0","0","0","0","-2"
"123651","Vanguard University of Southern California","2015","On-tenure track, associate professors","3","1","2","0","0","0","0","0","0","0","0","0","2","1","1","0","0","0","1","0","1","0","0","0","0","0","0","0","0","0","-2"
"123651","Vanguard University of Southern California","2015","On-tenure track, assistant professors","12","4","8","0","0","0","3","0","3","0","0","0","1","0","1","0","0","0","7","4","3","0","0","0","1","0","1","0","0","0","-2"
"123651","Vanguard University of Southern California","2015","Not on tenure track/No tenure system system total","5","0","5","0","0","0","0","0","0","0","0","0","0","0","0","0","0","0","5","0","5","0","0","0","0","0","0","0","0","0","-2"
"123651","Vanguard University of Southern California","2015","Not on tenure/no tenure system, associate professors","1","0","1","0","0","0","0","0","0","0","0","0","0","0","0","0","0","0","1","0","1","0","0","0","0","0","0","0","0","0","-2"
"123651","Vanguard University of Southern California","2015","Not on tenure/no tenure system, assistant professors","4","0","4","0","0","0","0","0","0","0","0","0","0","0","0","0","0","0","4","0","4","0","0","0","0","0","0","0","0","0","-2"
"125471","West Los Angeles College","2015","Tenured total","85","34","51","0","0","0","13","6","7","18","6","12","9","2","7","0","0","0","38","17","21","0","0","0","7","3","4","0","0","0","-2"
"125471","West Los Angeles College","2015","Tenured, instructors","85","34","51","0","0","0","13","6","7","18","6","12","9","2","7","0","0","0","38","17","21","0","0","0","7","3","4","0","0","0","-2"
"125471","West Los Angeles College","2015","On-Tenure track total","35","17","18","0","0","0","1","1","0","1","1","0","6","5","1","1","0","1","5","1","4","0","0","0","20","9","11","1","0","1","-2"
"125471","West Los Angeles College","2015","On-tenure track, instructors","35","17","18","0","0","0","1","1","0","1","1","0","6","5","1","1","0","1","5","1","4","0","0","0","20","9","11","1","0","1","-2"
"125471","West Los Angeles College","2015","Not on tenure track/No tenure system system total","12","4","8","0","0","0","0","0","0","2","0","2","1","0","1","0","0","0","2","0","2","1","1","0","6","3","3","0","0","0","-2"
"125471","West Los Angeles College","2015","Not on tenure/no tenure system, instructors","12","4","8","0","0","0","0","0","0","2","0","2","1","0","1","0","0","0","2","0","2","1","1","0","6","3","3","0","0","0","-2"
"125763","Whittier College","2015","Tenured total","90","50","40","0","0","0","4","1","3","4","2","2","12","8","4","0","0","0","65","36","29","1","0","1","0","0","0","4","3","1","-2"
"125763","Whittier College","2015","Tenured, professors","46","29","17","0","0","0","1","1","0","1","1","0","1","1","0","0","0","0","40","25","15","1","0","1","0","0","0","2","1","1","-2"
"125763","Whittier College","2015","Tenured, associate professors","44","21","23","0","0","0","3","0","3","3","1","2","11","7","4","0","0","0","25","11","14","0","0","0","0","0","0","2","2","0","-2"
"125763","Whittier College","2015","On-Tenure track total","28","13","15","0","0","0","5","2","3","1","1","0","1","0","1","0","0","0","16","7","9","1","1","0","0","0","0","4","2","2","-2"
"125763","Whittier College","2015","On-tenure track, assistant professors","28","13","15","0","0","0","5","2","3","1","1","0","1","0","1","0","0","0","16","7","9","1","1","0","0","0","0","4","2","2","-2"
"125763","Whittier College","2015","Not on tenure track/No tenure system system total","40","13","27","0","0","0","2","0","2","0","0","0","7","0","7","0","0","0","29","12","17","1","1","0","0","0","0","1","0","1","-2"
"125763","Whittier College","2015","Not on tenure/no tenure system, professors","9","1","8","0","0","0","0","0","0","0","0","0","1","0","1","0","0","0","7","1","6","0","0","0","0","0","0","1","0","1","-2"
"125763","Whittier College","2015","Not on tenure/no tenure system, associate professors","1","0","1","0","0","0","0","0","0","0","0","0","0","0","0","0","0","0","1","0","1","0","0","0","0","0","0","0","0","0","-2"
"125763","Whittier College","2015","Not on tenure/no tenure system, assistant professors","20","10","10","0","0","0","2","0","2","0","0","0","2","0","2","0","0","0","15","9","6","1","1","0","0","0","0","0","0","0","-2"
"125763","Whittier College","2015","Not on tenure/no tenure system, instructors","8","2","6","0","0","0","0","0","0","0","0","0","3","0","3","0","0","0","5","2","3","0","0","0","0","0","0","0","0","0","-2"
"125763","Whittier College","2015","Not on tenure/no tenure system, lecturers","2","0","2","0","0","0","0","0","0","0","0","0","1","0","1","0","0","0","1","0","1","0","0","0","0","0","0","0","0","0","-2"
"125897","Woodbury University","2015","Not on tenure track/No tenure system system total","92","53","39","0","0","0","12","7","5","3","2","1","3","3","0","0","0","0","69","38","31","0","0","0","5","3","2","0","0","0","-2"
"125897","Woodbury University","2015","Not on tenure/no tenure system, professors","25","13","12","0","0","0","3","2","1","1","0","1","0","0","0","0","0","0","20","10","10","0","0","0","1","1","0","0","0","0","-2"
"125897","Woodbury University","2015","Not on tenure/no tenure system, associate professors","23","14","9","0","0","0","1","1","0","0","0","0","2","2","0","0","0","0","18","11","7","0","0","0","2","0","2","0","0","0","-2"
"125897","Woodbury University","2015","Not on tenure/no tenure system, assistant professors","41","24","17","0","0","0","8","4","4","2","2","0","1","1","0","0","0","0","28","15","13","0","0","0","2","2","0","0","0","0","-2"
"125897","Woodbury University","2015","Not on tenure/no tenure system, lecturers","3","2","1","0","0","0","0","0","0","0","0","0","0","0","0","0","0","0","3","2","1","0","0","0","0","0","0","0","0","0","-2"
"126182","Adams State University","2015","Tenured total","58","34","24","0","0","0","0","0","0","0","0","0","10","6","4","1","0","1","46","27","19","0","0","0","1","1","0","0","0","0","-2"
"126182","Adams State University","2015","Tenured, professors","38","25","13","0","0","0","0","0","0","0","0","0","5","4","1","0","0","0","32","20","12","0","0","0","1","1","0","0","0","0","-2"
"126182","Adams State University","2015","Tenured, associate professors","13","5","8","0","0","0","0","0","0","0","0","0","3","1","2","0","0","0","10","4","6","0","0","0","0","0","0","0","0","0","-2"
"126182","Adams State University","2015","Tenured, assistant professors","7","4","3","0","0","0","0","0","0","0","0","0","2","1","1","1","0","1","4","3","1","0","0","0","0","0","0","0","0","0","-2"
"126182","Adams State University","2015","On-Tenure track total","26","16","10","0","0","0","0","0","0","0","0","0","5","3","2","1","1","0","19","11","8","0","0","0","1","1","0","0","0","0","-2"
"126182","Adams State University","2015","On-tenure track, assistant professors","24","15","9","0","0","0","0","0","0","0","0","0","5","3","2","0","0","0","18","11","7","0","0","0","1","1","0","0","0","0","-2"
"126182","Adams State University","2015","On-tenure track, no academic rank","2","1","1","0","0","0","0","0","0","0","0","0","0","0","0","1","1","0","1","0","1","0","0","0","0","0","0","0","0","0","-2"
"126182","Adams State University","2015","Not on tenure track/No tenure system system total","28","15","13","0","0","0","0","0","0","1","0","1","6","4","2","0","0","0","18","8","10","1","1","0","2","2","0","0","0","0","-2"
"126182","Adams State University","2015","Not on tenure/no tenure system, no academic rank","28","15","13","0","0","0","0","0","0","1","0","1","6","4","2","0","0","0","18","8","10","1","1","0","2","2","0","0","0","0","-2"
"126562","University of Colorado Denver/Anschutz Medical Campus","2015","Tenured total","576","408","168","4","2","2","46","32","14","6","4","2","32","24","8","0","0","0","473","338","135","1","0","1","14","8","6","0","0","0","-2"
"126562","University of Colorado Denver/Anschutz Medical Campus","2015","Tenured, professors","370","282","88","1","0","1","23","17","6","3","3","0","17","12","5","0","0","0","321","248","73","0","0","0","5","2","3","0","0","0","-2"
"126562","University of Colorado Denver/Anschutz Medical Campus","2015","Tenured, associate professors","206","126","80","3","2","1","23","15","8","3","1","2","15","12","3","0","0","0","152","90","62","1","0","1","9","6","3","0","0","0","-2"
"126562","University of Colorado Denver/Anschutz Medical Campus","2015","On-Tenure track total","1621","788","833","5","2","3","152","77","75","21","6","15","75","34","41","4","1","3","1176","576","600","9","4","5","164","78","86","15","10","5","-2"
"126562","University of Colorado Denver/Anschutz Medical Campus","2015","On-tenure track, professors","185","120","65","0","0","0","18","12","6","0","0","0","5","4","1","0","0","0","143","91","52","3","0","3","14","11","3","2","2","0","-2"
"126562","University of Colorado Denver/Anschutz Medical Campus","2015","On-tenure track, associate professors","525","272","253","5","2","3","47","30","17","4","2","2","20","10","10","1","0","1","398","197","201","3","2","1","46","28","18","1","1","0","-2"
"126562","University of Colorado Denver/Anschutz Medical Campus","2015","On-tenure track, assistant professors","911","396","515","0","0","0","87","35","52","17","4","13","50","20","30","3","1","2","635","288","347","3","2","1","104","39","65","12","7","5","-2"
"126562","University of Colorado Denver/Anschutz Medical Campus","2015","Not on tenure track/No tenure system system total","1323","404","919","8","2","6","68","28","40","13","5","8","58","22","36","2","1","1","977","289","688","5","2","3","180","47","133","12","8","4","-2"
"126562","University of Colorado Denver/Anschutz Medical Campus","2015","Not on tenure/no tenure system, professors","11","4","7","0","0","0","0","0","0","0","0","0","0","0","0","0","0","0","11","4","7","0","0","0","0","0","0","0","0","0","-2"
"126562","University of Colorado Denver/Anschutz Medical Campus","2015","Not on tenure/no tenure system, associate professors","38","22","16","1","1","0","1","0","1","0","0","0","2","1","1","0","0","0","31","17","14","0","0","0","3","3","0","0","0","0","-2"
"126562","University of Colorado Denver/Anschutz Medical Campus","2015","Not on tenure/no tenure system, assistant professors","65","35","30","0","0","0","6","0","6","1","1","0","7","5","2","1","1","0","41","21","20","1","1","0","4","2","2","4","4","0","-2"
"126562","University of Colorado Denver/Anschutz Medical Campus","2015","Not on tenure/no tenure system, instructors","1209","343","866","7","1","6","61","28","33","12","4","8","49","16","33","1","0","1","894","247","647","4","1","3","173","42","131","8","4","4","-2"
"126711","Colorado Mountain College","2015","Not on tenure track/No tenure system system total","118","60","58","1","1","0","2","1","1","0","0","0","7","4","3","0","0","0","102","51","51","1","1","0","5","2","3","0","0","0","-2"
"126711","Colorado Mountain College","2015","Not on tenure/no tenure system, professors","35","17","18","0","0","0","0","0","0","0","0","0","1","1","0","0","0","0","34","16","18","0","0","0","0","0","0","0","0","0","-2"
"126711","Colorado Mountain College","2015","Not on tenure/no tenure system, associate professors","54","26","28","0","0","0","1","1","0","0","0","0","3","2","1","0","0","0","46","21","25","0","0","0","4","2","2","0","0","0","-2"
"126711","Colorado Mountain College","2015","Not on tenure/no tenure system, assistant professors","24","14","10","1","1","0","1","0","1","0","0","0","3","1","2","0","0","0","17","11","6","1","1","0","1","0","1","0","0","0","-2"
"126711","Colorado Mountain College","2015","Not on tenure/no tenure system, instructors","5","3","2","0","0","0","0","0","0","0","0","0","0","0","0","0","0","0","5","3","2","0","0","0","0","0","0","0","0","0","-2"
"126942","Community College of Denver","2015","Not on tenure track/No tenure system system total","102","49","53","0","0","0","5","2","3","4","3","1","3","1","2","0","0","0","88","43","45","1","0","1","1","0","1","0","0","0","-2"
"126942","Community College of Denver","2015","Not on tenure/no tenure system, professors","29","13","16","0","0","0","2","1","1","2","1","1","1","0","1","0","0","0","24","11","13","0","0","0","0","0","0","0","0","0","-2"
"126942","Community College of Denver","2015","Not on tenure/no tenure system, associate professors","29","16","13","0","0","0","2","1","1","0","0","0","0","0","0","0","0","0","27","15","12","0","0","0","0","0","0","0","0","0","-2"
"126942","Community College of Denver","2015","Not on tenure/no tenure system, assistant professors","17","6","11","0","0","0","1","0","1","1","1","0","0","0","0","0","0","0","14","5","9","1","0","1","0","0","0","0","0","0","-2"
"126942","Community College of Denver","2015","Not on tenure/no tenure system, instructors","27","14","13","0","0","0","0","0","0","1","1","0","2","1","1","0","0","0","23","12","11","0","0","0","1","0","1","0","0","0","-2"
"127617","Morgan Community College","2015","Not on tenure track/No tenure system system total","30","10","20","0","0","0","0","0","0","0","0","0","0","0","0","0","0","0","29","10","19","1","0","1","0","0","0","0","0","0","-2"
"127617","Morgan Community College","2015","Not on tenure/no tenure system, no academic rank","30","10","20","0","0","0","0","0","0","0","0","0","0","0","0","0","0","0","29","10","19","1","0","1","0","0","0","0","0","0","-2"
"127884","Pueblo Community College","2015","Not on tenure track/No tenure system system total","97","46","51","0","0","0","0","0","0","0","0","0","16","9","7","0","0","0","78","36","42","0","0","0","3","1","2","0","0","0","-2"
"127884","Pueblo Community College","2015","Not on tenure/no tenure system, no academic rank","97","46","51","0","0","0","0","0","0","0","0","0","16","9","7","0","0","0","78","36","42","0","0","0","3","1","2","0","0","0","-2"
"128106","Colorado State University Pueblo","2015","Tenured total","101","59","42","0","0","0","7","4","3","4","3","1","14","6","8","0","0","0","70","43","27","0","0","0","6","3","3","0","0","0","-2"
"128106","Colorado State University Pueblo","2015","Tenured, professors","43","29","14","0","0","0","3","2","1","3","3","0","7","4","3","0","0","0","28","18","10","0","0","0","2","2","0","0","0","0","-2"
"128106","Colorado State University Pueblo","2015","Tenured, associate professors","53","27","26","0","0","0","4","2","2","0","0","0","7","2","5","0","0","0","38","22","16","0","0","0","4","1","3","0","0","0","-2"
"128106","Colorado State University Pueblo","2015","Tenured, assistant professors","5","3","2","0","0","0","0","0","0","1","0","1","0","0","0","0","0","0","4","3","1","0","0","0","0","0","0","0","0","0","-2"
"128106","Colorado State University Pueblo","2015","On-Tenure track total","22","13","9","0","0","0","0","0","0","0","0","0","4","3","1","0","0","0","13","7","6","0","0","0","4","2","2","1","1","0","-2"
"128106","Colorado State University Pueblo","2015","On-tenure track, assistant professors","22","13","9","0","0","0","0","0","0","0","0","0","4","3","1","0","0","0","13","7","6","0","0","0","4","2","2","1","1","0","-2"
"128106","Colorado State University Pueblo","2015","Not on tenure track/No tenure system system total","51","22","29","0","0","0","1","0","1","1","0","1","6","2","4","0","0","0","37","16","21","1","0","1","3","3","0","2","1","1","-2"
"128106","Colorado State University Pueblo","2015","Not on tenure/no tenure system, assistant professors","12","4","8","0","0","0","0","0","0","0","0","0","3","1","2","0","0","0","7","2","5","0","0","0","0","0","0","2","1","1","-2"
"128106","Colorado State University Pueblo","2015","Not on tenure/no tenure system, instructors","1","0","1","0","0","0","0","0","0","0","0","0","0","0","0","0","0","0","1","0","1","0","0","0","0","0","0","0","0","0","-2"
"128106","Colorado State University Pueblo","2015","Not on tenure/no tenure system, lecturers","33","14","19","0","0","0","1","0","1","1","0","1","3","1","2","0","0","0","25","11","14","1","0","1","2","2","0","0","0","0","-2"
"128106","Colorado State University Pueblo","2015","Not on tenure/no tenure system, no academic rank","5","4","1","0","0","0","0","0","0","0","0","0","0","0","0","0","0","0","4","3","1","0","0","0","1","1","0","0","0","0","-2"
"128744","University of Bridgeport","2015","Tenured total","57","37","20","0","0","0","13","10","3","2","2","0","1","0","1","0","0","0","41","25","16","0","0","0","0","0","0","0","0","0","-2"
"128744","University of Bridgeport","2015","Tenured, professors","16","13","3","0","0","0","4","3","1","0","0","0","0","0","0","0","0","0","12","10","2","0","0","0","0","0","0","0","0","0","-2"
"128744","University of Bridgeport","2015","Tenured, associate professors","39","24","15","0","0","0","9","7","2","2","2","0","1","0","1","0","0","0","27","15","12","0","0","0","0","0","0","0","0","0","-2"
"128744","University of Bridgeport","2015","Tenured, assistant professors","2","0","2","0","0","0","0","0","0","0","0","0","0","0","0","0","0","0","2","0","2","0","0","0","0","0","0","0","0","0","-2"
"128744","University of Bridgeport","2015","On-Tenure track total","30","13","17","0","0","0","3","1","2","1","0","1","0","0","0","0","0","0","26","12","14","0","0","0","0","0","0","0","0","0","-2"
"128744","University of Bridgeport","2015","On-tenure track, associate professors","9","6","3","0","0","0","0","0","0","0","0","0","0","0","0","0","0","0","9","6","3","0","0","0","0","0","0","0","0","0","-2"
"128744","University of Bridgeport","2015","On-tenure track, assistant professors","21","7","14","0","0","0","3","1","2","1","0","1","0","0","0","0","0","0","17","6","11","0","0","0","0","0","0","0","0","0","-2"
"128744","University of Bridgeport","2015","Not on tenure track/No tenure system system total","41","23","18","0","0","0","5","4","1","1","1","0","1","1","0","0","0","0","34","17","17","0","0","0","0","0","0","0","0","0","-2"
"128744","University of Bridgeport","2015","Not on tenure/no tenure system, professors","1","0","1","0","0","0","0","0","0","0","0","0","0","0","0","0","0","0","1","0","1","0","0","0","0","0","0","0","0","0","-2"
"128744","University of Bridgeport","2015","Not on tenure/no tenure system, associate professors","4","3","1","0","0","0","0","0","0","0","0","0","0","0","0","0","0","0","4","3","1","0","0","0","0","0","0","0","0","0","-2"
"128744","University of Bridgeport","2015","Not on tenure/no tenure system, assistant professors","17","9","8","0","0","0","3","3","0","1","1","0","1","1","0","0","0","0","12","4","8","0","0","0","0","0","0","0","0","0","-2"
"128744","University of Bridgeport","2015","Not on tenure/no tenure system, lecturers","19","11","8","0","0","0","2","1","1","0","0","0","0","0","0","0","0","0","17","10","7","0","0","0","0","0","0","0","0","0","-2"
"131876","Trinity Washington University","2015","Tenured total","23","6","17","0","0","0","3","2","1","4","2","2","2","1","1","0","0","0","14","1","13","0","0","0","0","0","0","0","0","0","-2"
"131876","Trinity Washington University","2015","Tenured, professors","4","0","4","0","0","0","1","0","1","0","0","0","0","0","0","0","0","0","3","0","3","0","0","0","0","0","0","0","0","0","-2"
"131876","Trinity Washington University","2015","Tenured, associate professors","19","6","13","0","0","0","2","2","0","4","2","2","2","1","1","0","0","0","11","1","10","0","0","0","0","0","0","0","0","0","-2"
"131876","Trinity Washington University","2015","On-Tenure track total","12","2","10","0","0","0","1","0","1","7","1","6","0","0","0","0","0","0","4","1","3","0","0","0","0","0","0","0","0","0","-2"
"131876","Trinity Washington University","2015","On-tenure track, associate professors","1","0","1","0","0","0","0","0","0","0","0","0","0","0","0","0","0","0","1","0","1","0","0","0","0","0","0","0","0","0","-2"
"131876","Trinity Washington University","2015","On-tenure track, assistant professors","11","2","9","0","0","0","1","0","1","7","1","6","0","0","0","0","0","0","3","1","2","0","0","0","0","0","0","0","0","0","-2"
"131876","Trinity Washington University","2015","Not on tenure track/No tenure system system total","20","8","12","0","0","0","1","0","1","7","3","4","0","0","0","0","0","0","12","5","7","0","0","0","0","0","0","0","0","0","-2"
"131876","Trinity Washington University","2015","Not on tenure/no tenure system, associate professors","2","0","2","0","0","0","1","0","1","0","0","0","0","0","0","0","0","0","1","0","1","0","0","0","0","0","0","0","0","0","-2"
"131876","Trinity Washington University","2015","Not on tenure/no tenure system, assistant professors","18","8","10","0","0","0","0","0","0","7","3","4","0","0","0","0","0","0","11","5","6","0","0","0","0","0","0","0","0","0","-2"
"132471","Barry University","2015","Tenured total","18","10","8","1","0","1","1","0","1","2","2","0","0","0","0","0","0","0","14","8","6","0","0","0","0","0","0","0","0","0","-2"
"132471","Barry University","2015","Tenured, professors","10","5","5","0","0","0","0","0","0","2","2","0","0","0","0","0","0","0","8","3","5","0","0","0","0","0","0","0","0","0","-2"
"132471","Barry University","2015","Tenured, associate professors","8","5","3","1","0","1","1","0","1","0","0","0","0","0","0","0","0","0","6","5","1","0","0","0","0","0","0","0","0","0","-2"
"132471","Barry University","2015","On-Tenure track total","14","5","9","1","0","1","2","0","2","1","1","0","1","1","0","0","0","0","6","2","4","0","0","0","3","1","2","0","0","0","-2"
"132471","Barry University","2015","On-tenure track, associate professors","5","1","4","1","0","1","1","0","1","0","0","0","1","1","0","0","0","0","2","0","2","0","0","0","0","0","0","0","0","0","-2"
"132471","Barry University","2015","On-tenure track, assistant professors","9","4","5","0","0","0","1","0","1","1","1","0","0","0","0","0","0","0","4","2","2","0","0","0","3","1","2","0","0","0","-2"
"132471","Barry University","2015","Not on tenure track/No tenure system system total","330","144","186","1","0","1","20","10","10","31","3","28","57","30","27","0","0","0","191","88","103","0","0","0","21","11","10","9","2","7","-2"
"132471","Barry University","2015","Not on tenure/no tenure system, professors","69","39","30","0","0","0","6","5","1","4","0","4","10","6","4","0","0","0","48","27","21","0","0","0","1","1","0","0","0","0","-2"
"132471","Barry University","2015","Not on tenure/no tenure system, associate professors","110","48","62","1","0","1","5","2","3","7","1","6","18","5","13","0","0","0","70","34","36","0","0","0","7","4","3","2","2","0","-2"
"132471","Barry University","2015","Not on tenure/no tenure system, assistant professors","114","42","72","0","0","0","7","3","4","18","2","16","16","12","4","0","0","0","59","20","39","0","0","0","7","5","2","7","0","7","-2"
"132471","Barry University","2015","Not on tenure/no tenure system, instructors","37","15","22","0","0","0","2","0","2","2","0","2","13","7","6","0","0","0","14","7","7","0","0","0","6","1","5","0","0","0","-2"
"132709","Broward College","2015","Tenured total","332","156","176","5","0","5","17","13","4","60","22","38","64","34","30","0","0","0","178","82","96","0","0","0","8","5","3","0","0","0","-2"
"132709","Broward College","2015","Tenured, professors","60","33","27","2","0","2","5","3","2","5","2","3","10","6","4","0","0","0","37","21","16","0","0","0","1","1","0","0","0","0","-2"
"132709","Broward College","2015","Tenured, associate professors","23","9","14","1","0","1","1","1","0","5","1","4","2","1","1","0","0","0","13","5","8","0","0","0","1","1","0","0","0","0","-2"
"132709","Broward College","2015","Tenured, assistant professors","225","103","122","2","0","2","11","9","2","47","18","29","49","25","24","0","0","0","110","48","62","0","0","0","6","3","3","0","0","0","-2"
"132709","Broward College","2015","Tenured, instructors","24","11","13","0","0","0","0","0","0","3","1","2","3","2","1","0","0","0","18","8","10","0","0","0","0","0","0","0","0","0","-2"
"132709","Broward College","2015","On-Tenure track total","64","31","33","1","0","1","2","0","2","8","3","5","11","2","9","0","0","0","30","17","13","0","0","0","12","9","3","0","0","0","-2"
"132709","Broward College","2015","On-tenure track, associate professors","1","1","0","0","0","0","0","0","0","0","0","0","0","0","0","0","0","0","1","1","0","0","0","0","0","0","0","0","0","0","-2"
"132709","Broward College","2015","On-tenure track, assistant professors","58","27","31","1","0","1","2","0","2","8","3","5","8","1","7","0","0","0","27","14","13","0","0","0","12","9","3","0","0","0","-2"
"132709","Broward College","2015","On-tenure track, instructors","5","3","2","0","0","0","0","0","0","0","0","0","3","1","2","0","0","0","2","2","0","0","0","0","0","0","0","0","0","0","-2"
"132709","Broward College","2015","Not on tenure track/No tenure system system total","5","2","3","0","0","0","1","0","1","0","0","0","0","0","0","0","0","0","3","2","1","0","0","0","1","0","1","0","0","0","-2"
"132709","Broward College","2015","Not on tenure/no tenure system, associate professors","1","0","1","0","0","0","0","0","0","0","0","0","0","0","0","0","0","0","1","0","1","0","0","0","0","0","0","0","0","0","-2"
"132709","Broward College","2015","Not on tenure/no tenure system, assistant professors","4","2","2","0","0","0","1","0","1","0","0","0","0","0","0","0","0","0","2","2","0","0","0","0","1","0","1","0","0","0","-2"
"132903","University of Central Florida","2015","Tenured total","585","418","167","3","3","0","100","84","16","28","17","11","37","25","12","0","0","0","412","285","127","1","0","1","0","0","0","4","4","0","-2"
"132903","University of Central Florida","2015","Tenured, professors","252","195","57","1","1","0","52","45","7","5","3","2","12","10","2","0","0","0","178","133","45","1","0","1","0","0","0","3","3","0","-2"
"132903","University of Central Florida","2015","Tenured, associate professors","329","219","110","2","2","0","48","39","9","23","14","9","25","15","10","0","0","0","230","148","82","0","0","0","0","0","0","1","1","0","-2"
"132903","University of Central Florida","2015","Tenured, assistant professors","4","4","0","0","0","0","0","0","0","0","0","0","0","0","0","0","0","0","4","4","0","0","0","0","0","0","0","0","0","0","-2"
"132903","University of Central Florida","2015","On-Tenure track total","241","133","108","0","0","0","34","21","13","9","2","7","18","10","8","0","0","0","139","70","69","3","1","2","0","0","0","38","29","9","-2"
"132903","University of Central Florida","2015","On-tenure track, associate professors","7","5","2","0","0","0","1","1","0","0","0","0","1","1","0","0","0","0","4","2","2","0","0","0","0","0","0","1","1","0","-2"
"132903","University of Central Florida","2015","On-tenure track, assistant professors","234","128","106","0","0","0","33","20","13","9","2","7","17","9","8","0","0","0","135","68","67","3","1","2","0","0","0","37","28","9","-2"
"132903","University of Central Florida","2015","Not on tenure track/No tenure system system total","502","220","282","1","1","0","19","10","9","17","4","13","34","15","19","0","0","0","413","184","229","4","1","3","0","0","0","14","5","9","-2"
"132903","University of Central Florida","2015","Not on tenure/no tenure system, professors","4","2","2","0","0","0","1","1","0","0","0","0","1","0","1","0","0","0","2","1","1","0","0","0","0","0","0","0","0","0","-2"
"132903","University of Central Florida","2015","Not on tenure/no tenure system, associate professors","11","7","4","0","0","0","1","1","0","0","0","0","1","0","1","0","0","0","9","6","3","0","0","0","0","0","0","0","0","0","-2"
"132903","University of Central Florida","2015","Not on tenure/no tenure system, assistant professors","48","21","27","0","0","0","6","2","4","0","0","0","5","3","2","0","0","0","35","16","19","0","0","0","0","0","0","2","0","2","-2"
"132903","University of Central Florida","2015","Not on tenure/no tenure system, instructors","212","86","126","0","0","0","3","2","1","7","2","5","12","4","8","0","0","0","185","76","109","2","0","2","0","0","0","3","2","1","-2"
"132903","University of Central Florida","2015","Not on tenure/no tenure system, lecturers","226","104","122","1","1","0","8","4","4","10","2","8","15","8","7","0","0","0","181","85","96","2","1","1","0","0","0","9","3","6","-2"
"132903","University of Central Florida","2015","Not on tenure/no tenure system, no academic rank","1","0","1","0","0","0","0","0","0","0","0","0","0","0","0","0","0","0","1","0","1","0","0","0","0","0","0","0","0","0","-2"
"133508","Florida SouthWestern State College","2015","Tenured total","77","33","44","1","0","1","1","1","0","3","0","3","1","1","0","0","0","0","70","30","40","0","0","0","1","1","0","0","0","0","-2"
"133508","Florida SouthWestern State College","2015","Tenured, no academic rank","77","33","44","1","0","1","1","1","0","3","0","3","1","1","0","0","0","0","70","30","40","0","0","0","1","1","0","0","0","0","-2"
"133508","Florida SouthWestern State College","2015","On-Tenure track total","94","50","44","1","1","0","2","1","1","8","6","2","5","3","2","0","0","0","70","34","36","0","0","0","1","1","0","7","4","3","-2"
"133508","Florida SouthWestern State College","2015","On-tenure track, no academic rank","94","50","44","1","1","0","2","1","1","8","6","2","5","3","2","0","0","0","70","34","36","0","0","0","1","1","0","7","4","3","-2"
"133508","Florida SouthWestern State College","2015","Not on tenure track/No tenure system system total","5","1","4","0","0","0","1","0","1","0","0","0","0","0","0","0","0","0","4","1","3","0","0","0","0","0","0","0","0","0","-2"
"133508","Florida SouthWestern State College","2015","Not on tenure/no tenure system, no academic rank","5","1","4","0","0","0","1","0","1","0","0","0","0","0","0","0","0","0","4","1","3","0","0","0","0","0","0","0","0","0","-2"
"133669","Florida Atlantic University","2015","Tenured total","439","285","154","1","1","0","78","63","15","26","9","17","27","14","13","1","1","0","301","194","107","1","0","1","0","0","0","4","3","1","-2"
"133669","Florida Atlantic University","2015","Tenured, professors","211","158","53","1","1","0","42","39","3","10","5","5","9","6","3","1","1","0","147","105","42","0","0","0","0","0","0","1","1","0","-2"
"133669","Florida Atlantic University","2015","Tenured, associate professors","227","126","101","0","0","0","36","24","12","16","4","12","18","8","10","0","0","0","153","88","65","1","0","1","0","0","0","3","2","1","-2"
"133669","Florida Atlantic University","2015","Tenured, assistant professors","1","1","0","0","0","0","0","0","0","0","0","0","0","0","0","0","0","0","1","1","0","0","0","0","0","0","0","0","0","0","-2"
"133669","Florida Atlantic University","2015","On-Tenure track total","127","57","70","0","0","0","12","8","4","4","0","4","6","4","2","0","0","0","83","30","53","1","0","1","0","0","0","21","15","6","-2"
"133669","Florida Atlantic University","2015","On-tenure track, associate professors","10","3","7","0","0","0","1","0","1","1","0","1","0","0","0","0","0","0","7","3","4","1","0","1","0","0","0","0","0","0","-2"
"133669","Florida Atlantic University","2015","On-tenure track, assistant professors","117","54","63","0","0","0","11","8","3","3","0","3","6","4","2","0","0","0","76","27","49","0","0","0","0","0","0","21","15","6","-2"
"133669","Florida Atlantic University","2015","Not on tenure track/No tenure system system total","228","98","130","0","0","0","12","3","9","20","9","11","28","11","17","0","0","0","151","64","87","1","1","0","0","0","0","16","10","6","-2"
"133669","Florida Atlantic University","2015","Not on tenure/no tenure system, professors","2","2","0","0","0","0","1","1","0","0","0","0","0","0","0","0","0","0","1","1","0","0","0","0","0","0","0","0","0","0","-2"
"133669","Florida Atlantic University","2015","Not on tenure/no tenure system, associate professors","6","6","0","0","0","0","0","0","0","0","0","0","1","1","0","0","0","0","5","5","0","0","0","0","0","0","0","0","0","0","-2"
"133669","Florida Atlantic University","2015","Not on tenure/no tenure system, assistant professors","29","13","16","0","0","0","3","1","2","1","0","1","1","1","0","0","0","0","14","5","9","1","1","0","0","0","0","9","5","4","-2"
"133669","Florida Atlantic University","2015","Not on tenure/no tenure system, instructors","186","76","110","0","0","0","8","1","7","19","9","10","25","9","16","0","0","0","127","52","75","0","0","0","0","0","0","7","5","2","-2"
"133669","Florida Atlantic University","2015","Not on tenure/no tenure system, lecturers","3","0","3","0","0","0","0","0","0","0","0","0","0","0","0","0","0","0","3","0","3","0","0","0","0","0","0","0","0","0","-2"
"133669","Florida Atlantic University","2015","Not on tenure/no tenure system, no academic rank","2","1","1","0","0","0","0","0","0","0","0","0","1","0","1","0","0","0","1","1","0","0","0","0","0","0","0","0","0","0","-2"
"133872","AdventHealth University","2015","Not on tenure track/No tenure system system total","85","26","59","0","0","0","5","0","5","16","6","10","8","3","5","0","0","0","56","17","39","0","0","0","0","0","0","0","0","0","-2"
"133872","AdventHealth University","2015","Not on tenure/no tenure system, professors","14","6","8","0","0","0","0","0","0","3","0","3","2","2","0","0","0","0","9","4","5","0","0","0","0","0","0","0","0","0","-2"
"133872","AdventHealth University","2015","Not on tenure/no tenure system, associate professors","19","5","14","0","0","0","0","0","0","4","2","2","1","0","1","0","0","0","14","3","11","0","0","0","0","0","0","0","0","0","-2"
"133872","AdventHealth University","2015","Not on tenure/no tenure system, assistant professors","35","10","25","0","0","0","4","0","4","7","2","5","3","1","2","0","0","0","21","7","14","0","0","0","0","0","0","0","0","0","-2"
"133872","AdventHealth University","2015","Not on tenure/no tenure system, instructors","17","5","12","0","0","0","1","0","1","2","2","0","2","0","2","0","0","0","12","3","9","0","0","0","0","0","0","0","0","0","-2"
"133960","The College of the Florida Keys","2015","Tenured total","3","0","3","0","0","0","0","0","0","0","0","0","1","0","1","0","0","0","1","0","1","0","0","0","1","0","1","0","0","0","-2"
"133960","The College of the Florida Keys","2015","Tenured, professors","1","0","1","0","0","0","0","0","0","0","0","0","0","0","0","0","0","0","0","0","0","0","0","0","1","0","1","0","0","0","-2"
"133960","The College of the Florida Keys","2015","Tenured, associate professors","1","0","1","0","0","0","0","0","0","0","0","0","0","0","0","0","0","0","1","0","1","0","0","0","0","0","0","0","0","0","-2"
"133960","The College of the Florida Keys","2015","Tenured, assistant professors","1","0","1","0","0","0","0","0","0","0","0","0","1","0","1","0","0","0","0","0","0","0","0","0","0","0","0","0","0","0","-2"
"133960","The College of the Florida Keys","2015","On-Tenure track total","5","2","3","0","0","0","0","0","0","0","0","0","0","0","0","0","0","0","4","2","2","1","0","1","0","0","0","0","0","0","-2"
"133960","The College of the Florida Keys","2015","On-tenure track, professors","1","0","1","0","0","0","0","0","0","0","0","0","0","0","0","0","0","0","1","0","1","0","0","0","0","0","0","0","0","0","-2"
"133960","The College of the Florida Keys","2015","On-tenure track, associate professors","2","1","1","0","0","0","0","0","0","0","0","0","0","0","0","0","0","0","1","1","0","1","0","1","0","0","0","0","0","0","-2"
"133960","The College of the Florida Keys","2015","On-tenure track, assistant professors","2","1","1","0","0","0","0","0","0","0","0","0","0","0","0","0","0","0","2","1","1","0","0","0","0","0","0","0","0","0","-2"
"133960","The College of the Florida Keys","2015","Not on tenure track/No tenure system system total","17","6","11","0","0","0","0","0","0","0","0","0","1","0","1","0","0","0","13","5","8","0","0","0","3","1","2","0","0","0","-2"
"133960","The College of the Florida Keys","2015","Not on tenure/no tenure system, professors","2","0","2","0","0","0","0","0","0","0","0","0","0","0","0","0","0","0","1","0","1","0","0","0","1","0","1","0","0","0","-2"
"133960","The College of the Florida Keys","2015","Not on tenure/no tenure system, associate professors","2","1","1","0","0","0","0","0","0","0","0","0","1","0","1","0","0","0","1","1","0","0","0","0","0","0","0","0","0","0","-2"
"133960","The College of the Florida Keys","2015","Not on tenure/no tenure system, assistant professors","6","1","5","0","0","0","0","0","0","0","0","0","0","0","0","0","0","0","5","1","4","0","0","0","1","0","1","0","0","0","-2"
"133960","The College of the Florida Keys","2015","Not on tenure/no tenure system, instructors","7","4","3","0","0","0","0","0","0","0","0","0","0","0","0","0","0","0","6","3","3","0","0","0","1","1","0","0","0","0","-2"
"134608","Indian River State College","2015","Tenured total","167","78","89","2","0","2","7","3","4","17","8","9","8","3","5","1","0","1","131","63","68","0","0","0","1","1","0","0","0","0","-2"
"134608","Indian River State College","2015","Tenured, professors","31","14","17","1","0","1","2","1","1","4","2","2","1","1","0","0","0","0","23","10","13","0","0","0","0","0","0","0","0","0","-2"
"134608","Indian River State College","2015","Tenured, associate professors","40","18","22","0","0","0","2","1","1","4","2","2","2","1","1","0","0","0","32","14","18","0","0","0","0","0","0","0","0","0","-2"
"134608","Indian River State College","2015","Tenured, assistant professors","80","41","39","1","0","1","3","1","2","8","4","4","5","1","4","1","0","1","61","34","27","0","0","0","1","1","0","0","0","0","-2"
"134608","Indian River State College","2015","Tenured, instructors","16","5","11","0","0","0","0","0","0","1","0","1","0","0","0","0","0","0","15","5","10","0","0","0","0","0","0","0","0","0","-2"
"134608","Indian River State College","2015","On-Tenure track total","29","13","16","1","1","0","2","1","1","4","1","3","2","1","1","0","0","0","19","9","10","0","0","0","1","0","1","0","0","0","-2"
"134608","Indian River State College","2015","On-tenure track, associate professors","1","0","1","0","0","0","0","0","0","0","0","0","0","0","0","0","0","0","1","0","1","0","0","0","0","0","0","0","0","0","-2"
"134608","Indian River State College","2015","On-tenure track, assistant professors","26","12","14","1","1","0","2","1","1","4","1","3","2","1","1","0","0","0","16","8","8","0","0","0","1","0","1","0","0","0","-2"
"134608","Indian River State College","2015","On-tenure track, instructors","2","1","1","0","0","0","0","0","0","0","0","0","0","0","0","0","0","0","2","1","1","0","0","0","0","0","0","0","0","0","-2"
"134608","Indian River State College","2015","Not on tenure track/No tenure system system total","14","7","7","0","0","0","1","0","1","1","0","1","0","0","0","0","0","0","11","6","5","0","0","0","1","1","0","0","0","0","-2"
"134608","Indian River State College","2015","Not on tenure/no tenure system, assistant professors","7","3","4","0","0","0","0","0","0","1","0","1","0","0","0","0","0","0","5","2","3","0","0","0","1","1","0","0","0","0","-2"
"134608","Indian River State College","2015","Not on tenure/no tenure system, instructors","7","4","3","0","0","0","1","0","1","0","0","0","0","0","0","0","0","0","6","4","2","0","0","0","0","0","0","0","0","0","-2"
"135081","Keiser University-Ft Lauderdale","2015","Not on tenure track/No tenure system system total","1109","430","679","6","3","3","50","19","31","126","50","76","148","62","86","1","0","1","759","290","469","19","6","13","0","0","0","0","0","0","-2"
"135081","Keiser University-Ft Lauderdale","2015","Not on tenure/no tenure system, instructors","1109","430","679","6","3","3","50","19","31","126","50","76","148","62","86","1","0","1","759","290","469","19","6","13","0","0","0","0","0","0","-2"
"135610","Trinity International University-Florida","2015","Tenured total","2","0","2","0","0","0","0","0","0","0","0","0","1","0","1","0","0","0","1","0","1","0","0","0","0","0","0","0","0","0","-2"
"135610","Trinity International University-Florida","2015","Tenured, associate professors","2","0","2","0","0","0","0","0","0","0","0","0","1","0","1","0","0","0","1","0","1","0","0","0","0","0","0","0","0","0","-2"
"135717","Miami Dade College","2015","Tenured total","566","277","289","3","1","2","30","12","18","77","31","46","247","122","125","0","0","0","202","108","94","6","2","4","1","1","0","0","0","0","-2"
"135717","Miami Dade College","2015","Tenured, professors","164","84","80","1","1","0","11","5","6","20","9","11","61","28","33","0","0","0","68","39","29","3","2","1","0","0","0","0","0","0","-2"
"135717","Miami Dade College","2015","Tenured, associate professors","275","129","146","0","0","0","13","6","7","39","16","23","132","60","72","0","0","0","89","46","43","1","0","1","1","1","0","0","0","0","-2"
"135717","Miami Dade College","2015","Tenured, assistant professors","114","53","61","1","0","1","6","1","5","18","6","12","45","26","19","0","0","0","42","20","22","2","0","2","0","0","0","0","0","0","-2"
"135717","Miami Dade College","2015","Tenured, instructors","13","11","2","1","0","1","0","0","0","0","0","0","9","8","1","0","0","0","3","3","0","0","0","0","0","0","0","0","0","0","-2"
"135717","Miami Dade College","2015","On-Tenure track total","158","69","89","0","0","0","3","2","1","45","12","33","66","37","29","0","0","0","42","18","24","2","0","2","0","0","0","0","0","0","-2"
"135717","Miami Dade College","2015","On-tenure track, associate professors","1","0","1","0","0","0","0","0","0","0","0","0","1","0","1","0","0","0","0","0","0","0","0","0","0","0","0","0","0","0","-2"
"135717","Miami Dade College","2015","On-tenure track, assistant professors","55","28","27","0","0","0","1","0","1","10","5","5","24","14","10","0","0","0","18","9","9","2","0","2","0","0","0","0","0","0","-2"
"135717","Miami Dade College","2015","On-tenure track, instructors","102","41","61","0","0","0","2","2","0","35","7","28","41","23","18","0","0","0","24","9","15","0","0","0","0","0","0","0","0","0","-2"
"136215","Nova Southeastern University","2015","Tenured total","24","17","7","0","0","0","1","1","0","2","1","1","0","0","0","0","0","0","21","15","6","0","0","0","0","0","0","0","0","0","-2"
"136215","Nova Southeastern University","2015","Tenured, professors","24","17","7","0","0","0","1","1","0","2","1","1","0","0","0","0","0","0","21","15","6","0","0","0","0","0","0","0","0","0","-2"
"136215","Nova Southeastern University","2015","On-Tenure track total","1","0","1","0","0","0","0","0","0","0","0","0","0","0","0","0","0","0","1","0","1","0","0","0","0","0","0","0","0","0","-2"
"136215","Nova Southeastern University","2015","On-tenure track, associate professors","1","0","1","0","0","0","0","0","0","0","0","0","0","0","0","0","0","0","1","0","1","0","0","0","0","0","0","0","0","0","-2"
"136215","Nova Southeastern University","2015","Not on tenure track/No tenure system system total","793","371","422","1","0","1","63","37","26","65","20","45","88","31","57","4","3","1","534","267","267","1","0","1","23","5","18","14","8","6","-2"
"136215","Nova Southeastern University","2015","Not on tenure/no tenure system, professors","144","93","51","0","0","0","17","14","3","3","2","1","11","5","6","2","2","0","109","69","40","0","0","0","1","0","1","1","1","0","-2"
"136215","Nova Southeastern University","2015","Not on tenure/no tenure system, associate professors","279","129","150","0","0","0","20","11","9","27","9","18","30","12","18","1","0","1","186","92","94","0","0","0","12","2","10","3","3","0","-2"
"136215","Nova Southeastern University","2015","Not on tenure/no tenure system, assistant professors","328","136","192","1","0","1","24","11","13","30","8","22","40","10","30","1","1","0","213","99","114","1","0","1","9","3","6","9","4","5","-2"
"136215","Nova Southeastern University","2015","Not on tenure/no tenure system, instructors","21","6","15","0","0","0","1","0","1","2","0","2","4","3","1","0","0","0","13","3","10","0","0","0","1","0","1","0","0","0","-2"
"136215","Nova Southeastern University","2015","Not on tenure/no tenure system, lecturers","4","2","2","0","0","0","0","0","0","0","0","0","1","0","1","0","0","0","3","2","1","0","0","0","0","0","0","0","0","0","-2"
"136215","Nova Southeastern University","2015","Not on tenure/no tenure system, no academic rank","17","5","12","0","0","0","1","1","0","3","1","2","2","1","1","0","0","0","10","2","8","0","0","0","0","0","0","1","0","1","-2"
"136358","Palm Beach State College","2015","Tenured total","196","78","118","0","0","0","7","6","1","27","13","14","20","5","15","0","0","0","133","50","83","1","1","0","8","3","5","0","0","0","-2"
"136358","Palm Beach State College","2015","Tenured, professors","45","22","23","0","0","0","4","3","1","7","5","2","6","2","4","0","0","0","28","12","16","0","0","0","0","0","0","0","0","0","-2"
"136358","Palm Beach State College","2015","Tenured, associate professors","26","8","18","0","0","0","0","0","0","4","2","2","4","0","4","0","0","0","17","6","11","0","0","0","1","0","1","0","0","0","-2"
"136358","Palm Beach State College","2015","Tenured, assistant professors","29","7","22","0","0","0","1","1","0","4","1","3","2","0","2","0","0","0","19","4","15","0","0","0","3","1","2","0","0","0","-2"
"136358","Palm Beach State College","2015","Tenured, instructors","96","41","55","0","0","0","2","2","0","12","5","7","8","3","5","0","0","0","69","28","41","1","1","0","4","2","2","0","0","0","-2"
"136358","Palm Beach State College","2015","On-Tenure track total","101","50","51","1","0","1","3","2","1","12","5","7","9","3","6","0","0","0","69","35","34","0","0","0","6","5","1","1","0","1","-2"
"136358","Palm Beach State College","2015","On-tenure track, professors","3","0","3","0","0","0","0","0","0","0","0","0","0","0","0","0","0","0","3","0","3","0","0","0","0","0","0","0","0","0","-2"
"136358","Palm Beach State College","2015","On-tenure track, associate professors","16","9","7","0","0","0","2","1","1","3","1","2","0","0","0","0","0","0","10","6","4","0","0","0","1","1","0","0","0","0","-2"
"136358","Palm Beach State College","2015","On-tenure track, assistant professors","29","14","15","1","0","1","1","1","0","5","1","4","4","1","3","0","0","0","17","10","7","0","0","0","1","1","0","0","0","0","-2"
"136358","Palm Beach State College","2015","On-tenure track, instructors","53","27","26","0","0","0","0","0","0","4","3","1","5","2","3","0","0","0","39","19","20","0","0","0","4","3","1","1","0","1","-2"
"136358","Palm Beach State College","2015","Not on tenure track/No tenure system system total","9","2","7","1","0","1","1","0","1","2","0","2","1","0","1","0","0","0","3","2","1","1","0","1","0","0","0","0","0","0","-2"
"136358","Palm Beach State College","2015","Not on tenure/no tenure system, professors","1","0","1","0","0","0","0","0","0","0","0","0","0","0","0","0","0","0","1","0","1","0","0","0","0","0","0","0","0","0","-2"
"136358","Palm Beach State College","2015","Not on tenure/no tenure system, instructors","7","2","5","1","0","1","1","0","1","1","0","1","1","0","1","0","0","0","2","2","0","1","0","1","0","0","0","0","0","0","-2"
"136358","Palm Beach State College","2015","Not on tenure/no tenure system, no academic rank","1","0","1","0","0","0","0","0","0","1","0","1","0","0","0","0","0","0","0","0","0","0","0","0","0","0","0","0","0","0","-2"
"136516","Polk State College","2015","Tenured total","118","52","66","1","0","1","1","1","0","9","4","5","5","2","3","0","0","0","100","44","56","1","0","1","0","0","0","1","1","0","-2"
"136516","Polk State College","2015","Tenured, no academic rank","118","52","66","1","0","1","1","1","0","9","4","5","5","2","3","0","0","0","100","44","56","1","0","1","0","0","0","1","1","0","-2"
"136516","Polk State College","2015","On-Tenure track total","32","18","14","0","0","0","0","0","0","3","2","1","1","1","0","0","0","0","28","15","13","0","0","0","0","0","0","0","0","0","-2"
"136516","Polk State College","2015","On-tenure track, no academic rank","32","18","14","0","0","0","0","0","0","3","2","1","1","1","0","0","0","0","28","15","13","0","0","0","0","0","0","0","0","0","-2"
"136516","Polk State College","2015","Not on tenure track/No tenure system system total","6","3","3","0","0","0","1","0","1","0","0","0","1","0","1","0","0","0","3","3","0","0","0","0","0","0","0","1","0","1","-2"
"136516","Polk State College","2015","Not on tenure/no tenure system, no academic rank","6","3","3","0","0","0","1","0","1","0","0","0","1","0","1","0","0","0","3","3","0","0","0","0","0","0","0","1","0","1","-2"
"137209","Seminole State College of Florida","2015","Tenured total","155","58","97","0","0","0","6","4","2","9","3","6","13","5","8","1","1","0","124","44","80","2","1","1","0","0","0","0","0","0","-2"
"137209","Seminole State College of Florida","2015","Tenured, no academic rank","155","58","97","0","0","0","6","4","2","9","3","6","13","5","8","1","1","0","124","44","80","2","1","1","0","0","0","0","0","0","-2"
"137209","Seminole State College of Florida","2015","On-Tenure track total","40","18","22","0","0","0","2","1","1","1","0","1","3","2","1","0","0","0","34","15","19","0","0","0","0","0","0","0","0","0","-2"
"137209","Seminole State College of Florida","2015","On-tenure track, no academic rank","40","18","22","0","0","0","2","1","1","1","0","1","3","2","1","0","0","0","34","15","19","0","0","0","0","0","0","0","0","0","-2"
"137315","South Florida State College","2015","Tenured total","51","21","30","0","0","0","1","0","1","2","0","2","0","0","0","0","0","0","48","21","27","0","0","0","0","0","0","0","0","0","-2"
"137315","South Florida State College","2015","Tenured, instructors","51","21","30","0","0","0","1","0","1","2","0","2","0","0","0","0","0","0","48","21","27","0","0","0","0","0","0","0","0","0","-2"
"137315","South Florida State College","2015","On-Tenure track total","11","4","7","0","0","0","0","0","0","1","0","1","1","0","1","0","0","0","9","4","5","0","0","0","0","0","0","0","0","0","-2"
"137315","South Florida State College","2015","On-tenure track, instructors","11","4","7","0","0","0","0","0","0","1","0","1","1","0","1","0","0","0","9","4","5","0","0","0","0","0","0","0","0","0","-2"
"137476","St. Thomas University","2015","Tenured total","21","14","7","0","0","0","0","0","0","2","1","1","0","0","0","0","0","0","19","13","6","0","0","0","0","0","0","0","0","0","-2"
"137476","St. Thomas University","2015","Tenured, professors","21","14","7","0","0","0","0","0","0","2","1","1","0","0","0","0","0","0","19","13","6","0","0","0","0","0","0","0","0","0","-2"
"137476","St. Thomas University","2015","On-Tenure track total","3","2","1","0","0","0","1","1","0","0","0","0","0","0","0","0","0","0","2","1","1","0","0","0","0","0","0","0","0","0","-2"
"137476","St. Thomas University","2015","On-tenure track, professors","2","1","1","0","0","0","1","1","0","0","0","0","0","0","0","0","0","0","1","0","1","0","0","0","0","0","0","0","0","0","-2"
"137476","St. Thomas University","2015","On-tenure track, associate professors","1","1","0","0","0","0","0","0","0","0","0","0","0","0","0","0","0","0","1","1","0","0","0","0","0","0","0","0","0","0","-2"
"137476","St. Thomas University","2015","Not on tenure track/No tenure system system total","75","41","34","0","0","0","6","4","2","8","3","5","16","11","5","0","0","0","45","23","22","0","0","0","0","0","0","0","0","0","-2"
"137476","St. Thomas University","2015","Not on tenure/no tenure system, professors","27","17","10","0","0","0","1","1","0","0","0","0","4","2","2","0","0","0","22","14","8","0","0","0","0","0","0","0","0","0","-2"
"137476","St. Thomas University","2015","Not on tenure/no tenure system, associate professors","26","10","16","0","0","0","2","1","1","5","1","4","5","3","2","0","0","0","14","5","9","0","0","0","0","0","0","0","0","0","-2"
"137476","St. Thomas University","2015","Not on tenure/no tenure system, assistant professors","19","12","7","0","0","0","3","2","1","2","1","1","6","5","1","0","0","0","8","4","4","0","0","0","0","0","0","0","0","0","-2"
"137476","St. Thomas University","2015","Not on tenure/no tenure system, instructors","2","1","1","0","0","0","0","0","0","1","1","0","0","0","0","0","0","0","1","0","1","0","0","0","0","0","0","0","0","0","-2"
"137476","St. Thomas University","2015","Not on tenure/no tenure system, lecturers","1","1","0","0","0","0","0","0","0","0","0","0","1","1","0","0","0","0","0","0","0","0","0","0","0","0","0","0","0","0","-2"
"138187","Valencia College","2015","Tenured total","317","136","181","3","1","2","16","7","9","25","13","12","30","11","19","0","0","0","237","101","136","0","0","0","6","3","3","0","0","0","-2"
"138187","Valencia College","2015","Tenured, no academic rank","317","136","181","3","1","2","16","7","9","25","13","12","30","11","19","0","0","0","237","101","136","0","0","0","6","3","3","0","0","0","-2"
"138187","Valencia College","2015","On-Tenure track total","103","43","60","1","1","0","3","2","1","12","4","8","11","5","6","0","0","0","72","30","42","0","0","0","4","1","3","0","0","0","-2"
"138187","Valencia College","2015","On-tenure track, no academic rank","103","43","60","1","1","0","3","2","1","12","4","8","11","5","6","0","0","0","72","30","42","0","0","0","4","1","3","0","0","0","-2"
"138187","Valencia College","2015","Not on tenure track/No tenure system system total","115","43","72","0","0","0","8","1","7","13","1","12","9","5","4","0","0","0","81","34","47","0","0","0","4","2","2","0","0","0","-2"
"138187","Valencia College","2015","Not on tenure/no tenure system, no academic rank","115","43","72","0","0","0","8","1","7","13","1","12","9","5","4","0","0","0","81","34","47","0","0","0","4","2","2","0","0","0","-2"
"139463","Dalton State College","2015","Tenured total","82","41","41","0","0","0","2","2","0","2","1","1","0","0","0","0","0","0","76","36","40","1","1","0","1","1","0","0","0","0","-2"
"139463","Dalton State College","2015","Tenured, professors","23","14","9","0","0","0","1","1","0","0","0","0","0","0","0","0","0","0","22","13","9","0","0","0","0","0","0","0","0","0","-2"
"139463","Dalton State College","2015","Tenured, associate professors","55","24","31","0","0","0","1","1","0","2","1","1","0","0","0","0","0","0","50","20","30","1","1","0","1","1","0","0","0","0","-2"
"139463","Dalton State College","2015","Tenured, assistant professors","4","3","1","0","0","0","0","0","0","0","0","0","0","0","0","0","0","0","4","3","1","0","0","0","0","0","0","0","0","0","-2"
"139463","Dalton State College","2015","On-Tenure track total","58","24","34","0","0","0","1","0","1","2","1","1","2","2","0","0","0","0","51","20","31","0","0","0","1","1","0","1","0","1","-2"
"139463","Dalton State College","2015","On-tenure track, professors","1","0","1","0","0","0","0","0","0","0","0","0","0","0","0","0","0","0","1","0","1","0","0","0","0","0","0","0","0","0","-2"
"139463","Dalton State College","2015","On-tenure track, associate professors","12","9","3","0","0","0","0","0","0","1","1","0","0","0","0","0","0","0","10","8","2","0","0","0","0","0","0","1","0","1","-2"
"139463","Dalton State College","2015","On-tenure track, assistant professors","44","15","29","0","0","0","1","0","1","1","0","1","2","2","0","0","0","0","39","12","27","0","0","0","1","1","0","0","0","0","-2"
"139463","Dalton State College","2015","On-tenure track, instructors","1","0","1","0","0","0","0","0","0","0","0","0","0","0","0","0","0","0","1","0","1","0","0","0","0","0","0","0","0","0","-2"
"139463","Dalton State College","2015","Not on tenure track/No tenure system system total","21","9","12","0","0","0","1","0","1","0","0","0","0","0","0","0","0","0","20","9","11","0","0","0","0","0","0","0","0","0","-2"
"139463","Dalton State College","2015","Not on tenure/no tenure system, assistant professors","3","2","1","0","0","0","0","0","0","0","0","0","0","0","0","0","0","0","3","2","1","0","0","0","0","0","0","0","0","0","-2"
"139463","Dalton State College","2015","Not on tenure/no tenure system, instructors","4","2","2","0","0","0","0","0","0","0","0","0","0","0","0","0","0","0","4","2","2","0","0","0","0","0","0","0","0","0","-2"
"139463","Dalton State College","2015","Not on tenure/no tenure system, lecturers","14","5","9","0","0","0","1","0","1","0","0","0","0","0","0","0","0","0","13","5","8","0","0","0","0","0","0","0","0","0","-2"
"142887","American Academy of Art","2015","Not on tenure track/No tenure system system total","26","14","12","0","0","0","1","1","0","1","0","1","0","0","0","0","0","0","24","13","11","0","0","0","0","0","0","0","0","0","-2"
"142887","American Academy of Art","2015","Not on tenure/no tenure system, instructors","26","14","12","0","0","0","1","1","0","1","0","1","0","0","0","0","0","0","24","13","11","0","0","0","0","0","0","0","0","0","-2"
"143118","Aurora University","2015","Tenured total","58","28","30","0","0","0","1","0","1","1","1","0","2","1","1","0","0","0","54","26","28","0","0","0","0","0","0","0","0","0","-2"
"143118","Aurora University","2015","Tenured, professors","20","10","10","0","0","0","1","0","1","1","1","0","0","0","0","0","0","0","18","9","9","0","0","0","0","0","0","0","0","0","-2"
"143118","Aurora University","2015","Tenured, associate professors","38","18","20","0","0","0","0","0","0","0","0","0","2","1","1","0","0","0","36","17","19","0","0","0","0","0","0","0","0","0","-2"
"143118","Aurora University","2015","On-Tenure track total","27","9","18","0","0","0","1","1","0","0","0","0","1","0","1","0","0","0","23","6","17","0","0","0","2","2","0","0","0","0","-2"
"143118","Aurora University","2015","On-tenure track, associate professors","2","0","2","0","0","0","0","0","0","0","0","0","0","0","0","0","0","0","2","0","2","0","0","0","0","0","0","0","0","0","-2"
"143118","Aurora University","2015","On-tenure track, assistant professors","25","9","16","0","0","0","1","1","0","0","0","0","1","0","1","0","0","0","21","6","15","0","0","0","2","2","0","0","0","0","-2"
"143118","Aurora University","2015","Not on tenure track/No tenure system system total","72","32","40","0","0","0","4","1","3","2","2","0","3","2","1","0","0","0","61","27","34","0","0","0","2","0","2","0","0","0","-2"
"143118","Aurora University","2015","Not on tenure/no tenure system, associate professors","16","9","7","0","0","0","0","0","0","0","0","0","1","1","0","0","0","0","15","8","7","0","0","0","0","0","0","0","0","0","-2"
"143118","Aurora University","2015","Not on tenure/no tenure system, assistant professors","22","10","12","0","0","0","2","1","1","0","0","0","1","1","0","0","0","0","18","8","10","0","0","0","1","0","1","0","0","0","-2"
"143118","Aurora University","2015","Not on tenure/no tenure system, lecturers","28","10","18","0","0","0","2","0","2","2","2","0","1","0","1","0","0","0","22","8","14","0","0","0","1","0","1","0","0","0","-2"
"143118","Aurora University","2015","Not on tenure/no tenure system, no academic rank","6","3","3","0","0","0","0","0","0","0","0","0","0","0","0","0","0","0","6","3","3","0","0","0","0","0","0","0","0","0","-2"
"143978","The Chicago School of Professional Psychology at Chicago","2015","Not on tenure track/No tenure system system total","94","40","54","2","0","2","4","3","1","10","3","7","7","3","4","0","0","0","66","29","37","1","0","1","4","2","2","0","0","0","-2"
"143978","The Chicago School of Professional Psychology at Chicago","2015","Not on tenure/no tenure system, professors","14","9","5","1","0","1","0","0","0","0","0","0","1","1","0","0","0","0","11","7","4","0","0","0","1","1","0","0","0","0","-2"
"143978","The Chicago School of Professional Psychology at Chicago","2015","Not on tenure/no tenure system, associate professors","48","20","28","1","0","1","2","1","1","7","2","5","3","1","2","0","0","0","32","15","17","1","0","1","2","1","1","0","0","0","-2"
"143978","The Chicago School of Professional Psychology at Chicago","2015","Not on tenure/no tenure system, assistant professors","32","11","21","0","0","0","2","2","0","3","1","2","3","1","2","0","0","0","23","7","16","0","0","0","1","0","1","0","0","0","-2"
"144351","Concordia University-Chicago","2015","Tenured total","48","18","30","0","0","0","2","1","1","2","0","2","0","0","0","0","0","0","44","17","27","0","0","0","0","0","0","0","0","0","-2"
"144351","Concordia University-Chicago","2015","Tenured, professors","33","14","19","0","0","0","0","0","0","1","0","1","0","0","0","0","0","0","32","14","18","0","0","0","0","0","0","0","0","0","-2"
"144351","Concordia University-Chicago","2015","Tenured, associate professors","15","4","11","0","0","0","2","1","1","1","0","1","0","0","0","0","0","0","12","3","9","0","0","0","0","0","0","0","0","0","-2"
"144351","Concordia University-Chicago","2015","On-Tenure track total","88","45","43","0","0","0","3","2","1","3","1","2","3","2","1","0","0","0","74","35","39","1","1","0","1","1","0","3","3","0","-2"
"144351","Concordia University-Chicago","2015","On-tenure track, professors","6","4","2","0","0","0","0","0","0","0","0","0","0","0","0","0","0","0","6","4","2","0","0","0","0","0","0","0","0","0","-2"
"144351","Concordia University-Chicago","2015","On-tenure track, associate professors","43","22","21","0","0","0","1","1","0","0","0","0","2","1","1","0","0","0","37","17","20","0","0","0","1","1","0","2","2","0","-2"
"144351","Concordia University-Chicago","2015","On-tenure track, assistant professors","39","19","20","0","0","0","2","1","1","3","1","2","1","1","0","0","0","0","31","14","17","1","1","0","0","0","0","1","1","0","-2"
"144351","Concordia University-Chicago","2015","Not on tenure track/No tenure system system total","124","50","74","1","0","1","1","1","0","17","4","13","1","0","1","0","0","0","92","43","49","0","0","0","9","1","8","3","1","2","-2"
"144351","Concordia University-Chicago","2015","Not on tenure/no tenure system, associate professors","3","2","1","0","0","0","0","0","0","1","1","0","1","0","1","0","0","0","1","1","0","0","0","0","0","0","0","0","0","0","-2"
"144351","Concordia University-Chicago","2015","Not on tenure/no tenure system, assistant professors","7","3","4","0","0","0","0","0","0","0","0","0","0","0","0","0","0","0","6","2","4","0","0","0","0","0","0","1","1","0","-2"
"144351","Concordia University-Chicago","2015","Not on tenure/no tenure system, no academic rank","114","45","69","1","0","1","1","1","0","16","3","13","0","0","0","0","0","0","85","40","45","0","0","0","9","1","8","2","0","2","-2"
"145600","University of Illinois Chicago","2015","Tenured total","839","522","317","2","0","2","151","104","47","32","14","18","58","30","28","0","0","0","570","358","212","4","1","3","17","11","6","5","4","1","-2"
"145600","University of Illinois Chicago","2015","Tenured, professors","442","307","135","0","0","0","75","57","18","12","6","6","22","12","10","0","0","0","327","227","100","0","0","0","4","3","1","2","2","0","-2"
"145600","University of Illinois Chicago","2015","Tenured, associate professors","377","202","175","2","0","2","71","43","28","19","8","11","34","17","17","0","0","0","233","125","108","4","1","3","11","6","5","3","2","1","-2"
"145600","University of Illinois Chicago","2015","Tenured, assistant professors","19","12","7","0","0","0","4","3","1","1","0","1","2","1","1","0","0","0","10","6","4","0","0","0","2","2","0","0","0","0","-2"
"145600","University of Illinois Chicago","2015","Tenured, no academic rank","1","1","0","0","0","0","1","1","0","0","0","0","0","0","0","0","0","0","0","0","0","0","0","0","0","0","0","0","0","0","-2"
"145600","University of Illinois Chicago","2015","On-Tenure track total","383","207","176","0","0","0","92","56","36","32","17","15","31","12","19","1","0","1","181","94","87","6","2","4","9","5","4","31","21","10","-2"
"145600","University of Illinois Chicago","2015","On-tenure track, professors","13","8","5","0","0","0","4","3","1","0","0","0","0","0","0","0","0","0","9","5","4","0","0","0","0","0","0","0","0","0","-2"
"145600","University of Illinois Chicago","2015","On-tenure track, associate professors","38","26","12","0","0","0","8","6","2","3","2","1","2","1","1","0","0","0","21","14","7","1","1","0","2","1","1","1","1","0","-2"
"145600","University of Illinois Chicago","2015","On-tenure track, assistant professors","332","173","159","0","0","0","80","47","33","29","15","14","29","11","18","1","0","1","151","75","76","5","1","4","7","4","3","30","20","10","-2"
"145600","University of Illinois Chicago","2015","Not on tenure track/No tenure system system total","719","288","431","1","0","1","118","37","81","44","17","27","36","16","20","0","0","0","471","194","277","6","2","4","15","6","9","28","16","12","-2"
"145600","University of Illinois Chicago","2015","Not on tenure/no tenure system, professors","33","21","12","0","0","0","5","4","1","0","0","0","0","0","0","0","0","0","27","17","10","0","0","0","1","0","1","0","0","0","-2"
"145600","University of Illinois Chicago","2015","Not on tenure/no tenure system, associate professors","83","30","53","0","0","0","9","2","7","6","1","5","3","1","2","0","0","0","60","25","35","1","0","1","2","0","2","2","1","1","-2"
"145600","University of Illinois Chicago","2015","Not on tenure/no tenure system, assistant professors","313","119","194","0","0","0","55","11","44","20","10","10","20","8","12","0","0","0","196","78","118","2","0","2","6","3","3","14","9","5","-2"
"145600","University of Illinois Chicago","2015","Not on tenure/no tenure system, instructors","141","44","97","1","0","1","40","17","23","9","1","8","2","1","1","0","0","0","79","20","59","0","0","0","3","1","2","7","4","3","-2"
"145600","University of Illinois Chicago","2015","Not on tenure/no tenure system, lecturers","137","70","67","0","0","0","8","3","5","7","4","3","10","6","4","0","0","0","102","52","50","2","1","1","3","2","1","5","2","3","-2"
"145600","University of Illinois Chicago","2015","Not on tenure/no tenure system, no academic rank","12","4","8","0","0","0","1","0","1","2","1","1","1","0","1","0","0","0","7","2","5","1","1","0","0","0","0","0","0","0","-2"
"147536","National Louis University","2015","Tenured total","68","25","43","0","0","0","5","1","4","3","3","0","1","1","0","0","0","0","58","19","39","1","1","0","0","0","0","0","0","0","-2"
"147536","National Louis University","2015","Tenured, professors","17","6","11","0","0","0","0","0","0","0","0","0","0","0","0","0","0","0","17","6","11","0","0","0","0","0","0","0","0","0","-2"
"147536","National Louis University","2015","Tenured, associate professors","43","13","30","0","0","0","5","1","4","2","2","0","1","1","0","0","0","0","35","9","26","0","0","0","0","0","0","0","0","0","-2"
"147536","National Louis University","2015","Tenured, assistant professors","8","6","2","0","0","0","0","0","0","1","1","0","0","0","0","0","0","0","6","4","2","1","1","0","0","0","0","0","0","0","-2"
"147536","National Louis University","2015","On-Tenure track total","6","1","5","0","0","0","0","0","0","1","1","0","1","0","1","0","0","0","4","0","4","0","0","0","0","0","0","0","0","0","-2"
"147536","National Louis University","2015","On-tenure track, assistant professors","6","1","5","0","0","0","0","0","0","1","1","0","1","0","1","0","0","0","4","0","4","0","0","0","0","0","0","0","0","0","-2"
"147536","National Louis University","2015","Not on tenure track/No tenure system system total","55","20","35","1","0","1","1","0","1","5","1","4","3","2","1","0","0","0","44","17","27","0","0","0","0","0","0","1","0","1","-2"
"147536","National Louis University","2015","Not on tenure/no tenure system, professors","2","1","1","0","0","0","0","0","0","0","0","0","0","0","0","0","0","0","2","1","1","0","0","0","0","0","0","0","0","0","-2"
"147536","National Louis University","2015","Not on tenure/no tenure system, associate professors","5","1","4","0","0","0","0","0","0","1","0","1","0","0","0","0","0","0","4","1","3","0","0","0","0","0","0","0","0","0","-2"
"147536","National Louis University","2015","Not on tenure/no tenure system, assistant professors","39","16","23","1","0","1","1","0","1","4","1","3","1","1","0","0","0","0","31","14","17","0","0","0","0","0","0","1","0","1","-2"
"147536","National Louis University","2015","Not on tenure/no tenure system, instructors","9","2","7","0","0","0","0","0","0","0","0","0","2","1","1","0","0","0","7","1","6","0","0","0","0","0","0","0","0","0","-2"
"147679","North Park University","2015","Tenured total","70","34","36","0","0","0","6","4","2","4","1","3","2","0","2","0","0","0","58","29","29","0","0","0","0","0","0","0","0","0","-2"
"147679","North Park University","2015","Tenured, professors","55","30","25","0","0","0","4","3","1","4","1","3","2","0","2","0","0","0","45","26","19","0","0","0","0","0","0","0","0","0","-2"
"147679","North Park University","2015","Tenured, associate professors","12","2","10","0","0","0","1","0","1","0","0","0","0","0","0","0","0","0","11","2","9","0","0","0","0","0","0","0","0","0","-2"
"147679","North Park University","2015","Tenured, assistant professors","3","2","1","0","0","0","1","1","0","0","0","0","0","0","0","0","0","0","2","1","1","0","0","0","0","0","0","0","0","0","-2"
"147679","North Park University","2015","On-Tenure track total","20","12","8","0","0","0","2","0","2","2","2","0","0","0","0","0","0","0","13","8","5","3","2","1","0","0","0","0","0","0","-2"
"147679","North Park University","2015","On-tenure track, professors","1","0","1","0","0","0","0","0","0","0","0","0","0","0","0","0","0","0","1","0","1","0","0","0","0","0","0","0","0","0","-2"
"147679","North Park University","2015","On-tenure track, associate professors","9","5","4","0","0","0","2","0","2","1","1","0","0","0","0","0","0","0","6","4","2","0","0","0","0","0","0","0","0","0","-2"
"147679","North Park University","2015","On-tenure track, assistant professors","10","7","3","0","0","0","0","0","0","1","1","0","0","0","0","0","0","0","6","4","2","3","2","1","0","0","0","0","0","0","-2"
"147679","North Park University","2015","Not on tenure track/No tenure system system total","30","7","23","1","0","1","0","0","0","2","0","2","0","0","0","0","0","0","27","7","20","0","0","0","0","0","0","0","0","0","-2"
"147679","North Park University","2015","Not on tenure/no tenure system, professors","5","2","3","0","0","0","0","0","0","0","0","0","0","0","0","0","0","0","5","2","3","0","0","0","0","0","0","0","0","0","-2"
"147679","North Park University","2015","Not on tenure/no tenure system, associate professors","9","2","7","1","0","1","0","0","0","1","0","1","0","0","0","0","0","0","7","2","5","0","0","0","0","0","0","0","0","0","-2"
"147679","North Park University","2015","Not on tenure/no tenure system, assistant professors","13","3","10","0","0","0","0","0","0","0","0","0","0","0","0","0","0","0","13","3","10","0","0","0","0","0","0","0","0","0","-2"
"147679","North Park University","2015","Not on tenure/no tenure system, instructors","3","0","3","0","0","0","0","0","0","1","0","1","0","0","0","0","0","0","2","0","2","0","0","0","0","0","0","0","0","0","-2"
"147776","Northeastern Illinois University","2015","Tenured total","135","63","72","0","0","0","19","10","9","13","8","5","16","4","12","0","0","0","81","36","45","0","0","0","5","5","0","1","0","1","-2"
"147776","Northeastern Illinois University","2015","Tenured, professors","57","25","32","0","0","0","13","7","6","3","2","1","5","1","4","0","0","0","36","15","21","0","0","0","0","0","0","0","0","0","-2"
"147776","Northeastern Illinois University","2015","Tenured, associate professors","75","36","39","0","0","0","6","3","3","9","5","4","11","3","8","0","0","0","43","20","23","0","0","0","5","5","0","1","0","1","-2"
"147776","Northeastern Illinois University","2015","Tenured, assistant professors","3","2","1","0","0","0","0","0","0","1","1","0","0","0","0","0","0","0","2","1","1","0","0","0","0","0","0","0","0","0","-2"
"147776","Northeastern Illinois University","2015","On-Tenure track total","95","40","55","1","1","0","19","7","12","7","3","4","12","6","6","0","0","0","46","18","28","0","0","0","10","5","5","0","0","0","-2"
"147776","Northeastern Illinois University","2015","On-tenure track, associate professors","17","8","9","0","0","0","2","0","2","1","0","1","4","2","2","0","0","0","8","4","4","0","0","0","2","2","0","0","0","0","-2"
"147776","Northeastern Illinois University","2015","On-tenure track, assistant professors","78","32","46","1","1","0","17","7","10","6","3","3","8","4","4","0","0","0","38","14","24","0","0","0","8","3","5","0","0","0","-2"
"147776","Northeastern Illinois University","2015","Not on tenure track/No tenure system system total","101","47","54","0","0","0","5","3","2","5","3","2","9","5","4","0","0","0","73","31","42","0","0","0","9","5","4","0","0","0","-2"
"147776","Northeastern Illinois University","2015","Not on tenure/no tenure system, instructors","101","47","54","0","0","0","5","3","2","5","3","2","9","5","4","0","0","0","73","31","42","0","0","0","9","5","4","0","0","0","-2"
"148335","Robert Morris University Illinois","2015","Not on tenure track/No tenure system system total","76","43","33","0","0","0","12","9","3","7","3","4","2","2","0","0","0","0","55","29","26","0","0","0","0","0","0","0","0","0","-2"
"148335","Robert Morris University Illinois","2015","Not on tenure/no tenure system, professors","76","43","33","0","0","0","12","9","3","7","3","4","2","2","0","0","0","0","55","29","26","0","0","0","0","0","0","0","0","0","-2"
"148487","Roosevelt University","2015","Tenured total","145","84","61","1","1","0","6","3","3","9","4","5","4","3","1","0","0","0","104","57","47","2","0","2","9","8","1","10","8","2","-2"
"148487","Roosevelt University","2015","Tenured, professors","46","33","13","0","0","0","3","2","1","5","3","2","2","2","0","0","0","0","31","22","9","0","0","0","3","2","1","2","2","0","-2"
"148487","Roosevelt University","2015","Tenured, associate professors","94","49","45","1","1","0","3","1","2","3","1","2","2","1","1","0","0","0","69","33","36","2","0","2","6","6","0","8","6","2","-2"
"148487","Roosevelt University","2015","Tenured, assistant professors","5","2","3","0","0","0","0","0","0","1","0","1","0","0","0","0","0","0","4","2","2","0","0","0","0","0","0","0","0","0","-2"
"148487","Roosevelt University","2015","On-Tenure track total","51","31","20","0","0","0","2","1","1","3","1","2","2","1","1","0","0","0","29","18","11","3","2","1","2","1","1","10","7","3","-2"
"148487","Roosevelt University","2015","On-tenure track, professors","1","1","0","0","0","0","0","0","0","0","0","0","0","0","0","0","0","0","0","0","0","1","1","0","0","0","0","0","0","0","-2"
"148487","Roosevelt University","2015","On-tenure track, associate professors","5","4","1","0","0","0","0","0","0","0","0","0","0","0","0","0","0","0","4","3","1","0","0","0","0","0","0","1","1","0","-2"
"148487","Roosevelt University","2015","On-tenure track, assistant professors","45","26","19","0","0","0","2","1","1","3","1","2","2","1","1","0","0","0","25","15","10","2","1","1","2","1","1","9","6","3","-2"
"148487","Roosevelt University","2015","Not on tenure track/No tenure system system total","42","22","20","0","0","0","2","0","2","1","1","0","2","1","1","0","0","0","32","18","14","1","0","1","1","0","1","3","2","1","-2"
"148487","Roosevelt University","2015","Not on tenure/no tenure system, associate professors","1","0","1","0","0","0","0","0","0","0","0","0","0","0","0","0","0","0","1","0","1","0","0","0","0","0","0","0","0","0","-2"
"148487","Roosevelt University","2015","Not on tenure/no tenure system, assistant professors","14","8","6","0","0","0","1","0","1","0","0","0","0","0","0","0","0","0","12","7","5","0","0","0","0","0","0","1","1","0","-2"
"148487","Roosevelt University","2015","Not on tenure/no tenure system, instructors","2","0","2","0","0","0","0","0","0","0","0","0","1","0","1","0","0","0","1","0","1","0","0","0","0","0","0","0","0","0","-2"
"148487","Roosevelt University","2015","Not on tenure/no tenure system, lecturers","22","12","10","0","0","0","1","0","1","1","1","0","1","1","0","0","0","0","16","9","7","1","0","1","1","0","1","1","1","0","-2"
"148487","Roosevelt University","2015","Not on tenure/no tenure system, no academic rank","3","2","1","0","0","0","0","0","0","0","0","0","0","0","0","0","0","0","2","2","0","0","0","0","0","0","0","1","0","1","-2"
"148496","Dominican University","2015","Tenured total","93","37","56","0","0","0","6","3","3","4","2","2","6","2","4","0","0","0","76","29","47","1","1","0","0","0","0","0","0","0","-2"
"148496","Dominican University","2015","Tenured, professors","44","26","18","0","0","0","3","2","1","1","1","0","1","1","0","0","0","0","38","21","17","1","1","0","0","0","0","0","0","0","-2"
"148496","Dominican University","2015","Tenured, associate professors","38","9","29","0","0","0","2","1","1","2","1","1","4","1","3","0","0","0","30","6","24","0","0","0","0","0","0","0","0","0","-2"
"148496","Dominican University","2015","Tenured, assistant professors","11","2","9","0","0","0","1","0","1","1","0","1","1","0","1","0","0","0","8","2","6","0","0","0","0","0","0","0","0","0","-2"
"148496","Dominican University","2015","On-Tenure track total","49","27","22","0","0","0","6","2","4","4","2","2","3","2","1","0","0","0","35","20","15","0","0","0","1","1","0","0","0","0","-2"
"148496","Dominican University","2015","On-tenure track, associate professors","11","3","8","0","0","0","1","0","1","0","0","0","2","1","1","0","0","0","8","2","6","0","0","0","0","0","0","0","0","0","-2"
"148496","Dominican University","2015","On-tenure track, assistant professors","35","23","12","0","0","0","4","2","2","3","2","1","0","0","0","0","0","0","27","18","9","0","0","0","1","1","0","0","0","0","-2"
"148496","Dominican University","2015","On-tenure track, instructors","3","1","2","0","0","0","1","0","1","1","0","1","1","1","0","0","0","0","0","0","0","0","0","0","0","0","0","0","0","0","-2"
"148496","Dominican University","2015","Not on tenure track/No tenure system system total","24","9","15","0","0","0","2","1","1","1","1","0","2","1","1","0","0","0","19","6","13","0","0","0","0","0","0","0","0","0","-2"
"148496","Dominican University","2015","Not on tenure/no tenure system, assistant professors","1","1","0","0","0","0","0","0","0","0","0","0","0","0","0","0","0","0","1","1","0","0","0","0","0","0","0","0","0","0","-2"
"148496","Dominican University","2015","Not on tenure/no tenure system, lecturers","23","8","15","0","0","0","2","1","1","1","1","0","2","1","1","0","0","0","18","5","13","0","0","0","0","0","0","0","0","0","-2"
"148511","Rush University","2015","Tenured total","211","134","77","0","0","0","44","26","18","5","3","2","5","3","2","0","0","0","156","101","55","1","1","0","0","0","0","0","0","0","-2"
"148511","Rush University","2015","Tenured, professors","92","62","30","0","0","0","15","11","4","2","1","1","1","1","0","0","0","0","74","49","25","0","0","0","0","0","0","0","0","0","-2"
"148511","Rush University","2015","Tenured, associate professors","119","72","47","0","0","0","29","15","14","3","2","1","4","2","2","0","0","0","82","52","30","1","1","0","0","0","0","0","0","0","-2"
"148511","Rush University","2015","On-Tenure track total","621","277","344","0","0","0","178","82","96","25","8","17","20","9","11","0","0","0","392","175","217","6","3","3","0","0","0","0","0","0","-2"
"148511","Rush University","2015","On-tenure track, assistant professors","483","228","255","0","0","0","143","63","80","20","6","14","16","7","9","0","0","0","300","150","150","4","2","2","0","0","0","0","0","0","-2"
"148511","Rush University","2015","On-tenure track, instructors","138","49","89","0","0","0","35","19","16","5","2","3","4","2","2","0","0","0","92","25","67","2","1","1","0","0","0","0","0","0","-2"
"148511","Rush University","2015","Not on tenure track/No tenure system system total","113","13","100","0","0","0","2","0","2","8","1","7","1","0","1","0","0","0","102","12","90","0","0","0","0","0","0","0","0","0","-2"
"148511","Rush University","2015","Not on tenure/no tenure system, professors","10","0","10","0","0","0","0","0","0","0","0","0","0","0","0","0","0","0","10","0","10","0","0","0","0","0","0","0","0","0","-2"
"148511","Rush University","2015","Not on tenure/no tenure system, associate professors","14","2","12","0","0","0","0","0","0","0","0","0","0","0","0","0","0","0","14","2","12","0","0","0","0","0","0","0","0","0","-2"
"148511","Rush University","2015","Not on tenure/no tenure system, assistant professors","39","5","34","0","0","0","1","0","1","4","1","3","0","0","0","0","0","0","34","4","30","0","0","0","0","0","0","0","0","0","-2"
"148511","Rush University","2015","Not on tenure/no tenure system, instructors","50","6","44","0","0","0","1","0","1","4","0","4","1","0","1","0","0","0","44","6","38","0","0","0","0","0","0","0","0","0","-2"
"148627","Saint Xavier University","2015","Tenured total","106","49","57","0","0","0","9","5","4","5","3","2","2","0","2","0","0","0","85","37","48","0","0","0","5","4","1","0","0","0","-2"
"148627","Saint Xavier University","2015","Tenured, professors","27","14","13","0","0","0","1","1","0","1","1","0","1","0","1","0","0","0","24","12","12","0","0","0","0","0","0","0","0","0","-2"
"148627","Saint Xavier University","2015","Tenured, associate professors","77","34","43","0","0","0","8","4","4","3","2","1","1","0","1","0","0","0","61","25","36","0","0","0","4","3","1","0","0","0","-2"
"148627","Saint Xavier University","2015","Tenured, assistant professors","2","1","1","0","0","0","0","0","0","1","0","1","0","0","0","0","0","0","0","0","0","0","0","0","1","1","0","0","0","0","-2"
"148627","Saint Xavier University","2015","On-Tenure track total","35","12","23","1","0","1","1","1","0","2","1","1","1","1","0","0","0","0","17","4","13","0","0","0","13","5","8","0","0","0","-2"
"148627","Saint Xavier University","2015","On-tenure track, professors","2","1","1","0","0","0","0","0","0","0","0","0","0","0","0","0","0","0","0","0","0","0","0","0","2","1","1","0","0","0","-2"
"148627","Saint Xavier University","2015","On-tenure track, associate professors","3","2","1","0","0","0","0","0","0","0","0","0","0","0","0","0","0","0","2","1","1","0","0","0","1","1","0","0","0","0","-2"
"148627","Saint Xavier University","2015","On-tenure track, assistant professors","30","9","21","1","0","1","1","1","0","2","1","1","1","1","0","0","0","0","15","3","12","0","0","0","10","3","7","0","0","0","-2"
"148627","Saint Xavier University","2015","Not on tenure track/No tenure system system total","28","8","20","0","0","0","0","0","0","1","0","1","2","1","1","0","0","0","20","5","15","0","0","0","5","2","3","0","0","0","-2"
"148627","Saint Xavier University","2015","Not on tenure/no tenure system, associate professors","1","0","1","0","0","0","0","0","0","0","0","0","0","0","0","0","0","0","1","0","1","0","0","0","0","0","0","0","0","0","-2"
"148627","Saint Xavier University","2015","Not on tenure/no tenure system, assistant professors","12","3","9","0","0","0","0","0","0","1","0","1","0","0","0","0","0","0","7","2","5","0","0","0","4","1","3","0","0","0","-2"
"148627","Saint Xavier University","2015","Not on tenure/no tenure system, instructors","3","0","3","0","0","0","0","0","0","0","0","0","0","0","0","0","0","0","3","0","3","0","0","0","0","0","0","0","0","0","-2"
"148627","Saint Xavier University","2015","Not on tenure/no tenure system, lecturers","9","5","4","0","0","0","0","0","0","0","0","0","2","1","1","0","0","0","6","3","3","0","0","0","1","1","0","0","0","0","-2"
"148627","Saint Xavier University","2015","Not on tenure/no tenure system, no academic rank","3","0","3","0","0","0","0","0","0","0","0","0","0","0","0","0","0","0","3","0","3","0","0","0","0","0","0","0","0","0","-2"
"148876","Saint Augustine College","2015","Not on tenure track/No tenure system system total","28","12","16","0","0","0","2","1","1","2","1","1","14","9","5","0","0","0","8","0","8","0","0","0","2","1","1","0","0","0","-2"
"148876","Saint Augustine College","2015","Not on tenure/no tenure system, associate professors","4","2","2","0","0","0","0","0","0","0","0","0","2","2","0","0","0","0","2","0","2","0","0","0","0","0","0","0","0","0","-2"
"148876","Saint Augustine College","2015","Not on tenure/no tenure system, assistant professors","21","7","14","0","0","0","1","0","1","2","1","1","10","5","5","0","0","0","6","0","6","0","0","0","2","1","1","0","0","0","-2"
"148876","Saint Augustine College","2015","Not on tenure/no tenure system, instructors","3","3","0","0","0","0","1","1","0","0","0","0","2","2","0","0","0","0","0","0","0","0","0","0","0","0","0","0","0","0","-2"
"149639","VanderCook College of Music","2015","Not on tenure track/No tenure system system total","10","3","7","0","0","0","2","0","2","1","1","0","0","0","0","0","0","0","7","2","5","0","0","0","0","0","0","0","0","0","-2"
"149639","VanderCook College of Music","2015","Not on tenure/no tenure system, professors","3","1","2","0","0","0","0","0","0","0","0","0","0","0","0","0","0","0","3","1","2","0","0","0","0","0","0","0","0","0","-2"
"149639","VanderCook College of Music","2015","Not on tenure/no tenure system, associate professors","6","1","5","0","0","0","2","0","2","1","1","0","0","0","0","0","0","0","3","0","3","0","0","0","0","0","0","0","0","0","-2"
"149639","VanderCook College of Music","2015","Not on tenure/no tenure system, assistant professors","1","1","0","0","0","0","0","0","0","0","0","0","0","0","0","0","0","0","1","1","0","0","0","0","0","0","0","0","0","0","-2"
"150172","Calumet College of Saint Joseph","2015","Tenured total","16","12","4","0","0","0","0","0","0","0","0","0","0","0","0","0","0","0","16","12","4","0","0","0","0","0","0","0","0","0","-2"
"150172","Calumet College of Saint Joseph","2015","Tenured, professors","2","2","0","0","0","0","0","0","0","0","0","0","0","0","0","0","0","0","2","2","0","0","0","0","0","0","0","0","0","0","-2"
"150172","Calumet College of Saint Joseph","2015","Tenured, associate professors","13","9","4","0","0","0","0","0","0","0","0","0","0","0","0","0","0","0","13","9","4","0","0","0","0","0","0","0","0","0","-2"
"150172","Calumet College of Saint Joseph","2015","Tenured, assistant professors","1","1","0","0","0","0","0","0","0","0","0","0","0","0","0","0","0","0","1","1","0","0","0","0","0","0","0","0","0","0","-2"
"150172","Calumet College of Saint Joseph","2015","On-Tenure track total","8","2","6","0","0","0","1","1","0","1","0","1","2","0","2","0","0","0","4","1","3","0","0","0","0","0","0","0","0","0","-2"
"150172","Calumet College of Saint Joseph","2015","On-tenure track, assistant professors","8","2","6","0","0","0","1","1","0","1","0","1","2","0","2","0","0","0","4","1","3","0","0","0","0","0","0","0","0","0","-2"
"150172","Calumet College of Saint Joseph","2015","Not on tenure track/No tenure system system total","6","5","1","0","0","0","0","0","0","0","0","0","2","2","0","0","0","0","4","3","1","0","0","0","0","0","0","0","0","0","-2"
"150172","Calumet College of Saint Joseph","2015","Not on tenure/no tenure system, instructors","6","5","1","0","0","0","0","0","0","0","0","0","2","2","0","0","0","0","4","3","1","0","0","0","0","0","0","0","0","0","-2"
"151360","Indiana University-Northwest","2015","Tenured total","60","38","22","0","0","0","8","5","3","3","3","0","6","4","2","0","0","0","42","25","17","1","1","0","0","0","0","0","0","0","-2"
"151360","Indiana University-Northwest","2015","Tenured, professors","28","17","11","0","0","0","2","2","0","1","1","0","2","0","2","0","0","0","22","13","9","1","1","0","0","0","0","0","0","0","-2"
"151360","Indiana University-Northwest","2015","Tenured, associate professors","32","21","11","0","0","0","6","3","3","2","2","0","4","4","0","0","0","0","20","12","8","0","0","0","0","0","0","0","0","0","-2"
"151360","Indiana University-Northwest","2015","On-Tenure track total","42","18","24","1","0","1","10","5","5","6","0","6","0","0","0","0","0","0","25","13","12","0","0","0","0","0","0","0","0","0","-2"
"151360","Indiana University-Northwest","2015","On-tenure track, associate professors","8","3","5","0","0","0","1","0","1","0","0","0","0","0","0","0","0","0","7","3","4","0","0","0","0","0","0","0","0","0","-2"
"151360","Indiana University-Northwest","2015","On-tenure track, assistant professors","34","15","19","1","0","1","9","5","4","6","0","6","0","0","0","0","0","0","18","10","8","0","0","0","0","0","0","0","0","0","-2"
"151360","Indiana University-Northwest","2015","Not on tenure track/No tenure system system total","51","13","38","0","0","0","2","0","2","2","0","2","3","2","1","0","0","0","43","11","32","1","0","1","0","0","0","0","0","0","-2"
"151360","Indiana University-Northwest","2015","Not on tenure/no tenure system, associate professors","6","0","6","0","0","0","1","0","1","0","0","0","0","0","0","0","0","0","5","0","5","0","0","0","0","0","0","0","0","0","-2"
"151360","Indiana University-Northwest","2015","Not on tenure/no tenure system, assistant professors","26","5","21","0","0","0","0","0","0","2","0","2","2","1","1","0","0","0","22","4","18","0","0","0","0","0","0","0","0","0","-2"
"151360","Indiana University-Northwest","2015","Not on tenure/no tenure system, lecturers","19","8","11","0","0","0","1","0","1","0","0","0","1","1","0","0","0","0","16","7","9","1","0","1","0","0","0","0","0","0","-2"
"155007","Donnelly College","2015","Not on tenure track/No tenure system system total","22","8","14","0","0","0","1","1","0","1","0","1","2","1","1","0","0","0","18","6","12","0","0","0","0","0","0","0","0","0","-2"
"155007","Donnelly College","2015","Not on tenure/no tenure system, associate professors","1","0","1","0","0","0","0","0","0","0","0","0","0","0","0","0","0","0","1","0","1","0","0","0","0","0","0","0","0","0","-2"
"155007","Donnelly College","2015","Not on tenure/no tenure system, assistant professors","13","5","8","0","0","0","1","1","0","1","0","1","0","0","0","0","0","0","11","4","7","0","0","0","0","0","0","0","0","0","-2"
"155007","Donnelly College","2015","Not on tenure/no tenure system, instructors","8","3","5","0","0","0","0","0","0","0","0","0","2","1","1","0","0","0","6","2","4","0","0","0","0","0","0","0","0","0","-2"
"160409","Saint Joseph Seminary College","2015","Not on tenure track/No tenure system system total","26","19","7","0","0","0","1","1","0","0","0","0","1","1","0","0","0","0","24","17","7","0","0","0","0","0","0","0","0","0","-2"
"160409","Saint Joseph Seminary College","2015","Not on tenure/no tenure system, professors","26","19","7","0","0","0","1","1","0","0","0","0","1","1","0","0","0","0","24","17","7","0","0","0","0","0","0","0","0","0","-2"
"165167","Cambridge College","2015","Not on tenure track/No tenure system system total","22","11","11","0","0","0","0","0","0","6","3","3","0","0","0","0","0","0","15","8","7","0","0","0","1","0","1","0","0","0","-2"
"165167","Cambridge College","2015","Not on tenure/no tenure system, professors","15","9","6","0","0","0","0","0","0","5","2","3","0","0","0","0","0","0","10","7","3","0","0","0","0","0","0","0","0","0","-2"
"165167","Cambridge College","2015","Not on tenure/no tenure system, associate professors","4","0","4","0","0","0","0","0","0","0","0","0","0","0","0","0","0","0","3","0","3","0","0","0","1","0","1","0","0","0","-2"
"165167","Cambridge College","2015","Not on tenure/no tenure system, assistant professors","2","1","1","0","0","0","0","0","0","0","0","0","0","0","0","0","0","0","2","1","1","0","0","0","0","0","0","0","0","0","-2"
"165167","Cambridge College","2015","Not on tenure/no tenure system, lecturers","1","1","0","0","0","0","0","0","0","1","1","0","0","0","0","0","0","0","0","0","0","0","0","0","0","0","0","0","0","0","-2"
"165884","Benjamin Franklin Institute of Technology","2015","Not on tenure track/No tenure system system total","37","28","9","0","0","0","0","0","0","1","1","0","2","2","0","0","0","0","34","25","9","0","0","0","0","0","0","0","0","0","-2"
"165884","Benjamin Franklin Institute of Technology","2015","Not on tenure/no tenure system, professors","4","1","3","0","0","0","0","0","0","0","0","0","0","0","0","0","0","0","4","1","3","0","0","0","0","0","0","0","0","0","-2"
"165884","Benjamin Franklin Institute of Technology","2015","Not on tenure/no tenure system, associate professors","10","7","3","0","0","0","0","0","0","0","0","0","0","0","0","0","0","0","10","7","3","0","0","0","0","0","0","0","0","0","-2"
"165884","Benjamin Franklin Institute of Technology","2015","Not on tenure/no tenure system, assistant professors","10","9","1","0","0","0","0","0","0","1","1","0","1","1","0","0","0","0","8","7","1","0","0","0","0","0","0","0","0","0","-2"
"165884","Benjamin Franklin Institute of Technology","2015","Not on tenure/no tenure system, instructors","13","11","2","0","0","0","0","0","0","0","0","0","1","1","0","0","0","0","12","10","2","0","0","0","0","0","0","0","0","0","-2"
"182005","College of Southern Nevada","2015","Tenured total","347","193","154","3","2","1","28","13","15","14","6","8","13","6","7","0","0","0","275","157","118","12","7","5","0","0","0","2","2","0","-2"
"182005","College of Southern Nevada","2015","Tenured, professors","347","193","154","3","2","1","28","13","15","14","6","8","13","6","7","0","0","0","275","157","118","12","7","5","0","0","0","2","2","0","-2"
"182005","College of Southern Nevada","2015","On-Tenure track total","100","43","57","1","0","1","7","5","2","7","2","5","2","1","1","0","0","0","77","33","44","6","2","4","0","0","0","0","0","0","-2"
"182005","College of Southern Nevada","2015","On-tenure track, instructors","100","43","57","1","0","1","7","5","2","7","2","5","2","1","1","0","0","0","77","33","44","6","2","4","0","0","0","0","0","0","-2"
"182005","College of Southern Nevada","2015","Not on tenure track/No tenure system system total","56","27","29","0","0","0","2","1","1","5","1","4","3","3","0","0","0","0","42","20","22","4","2","2","0","0","0","0","0","0","-2"
"182005","College of Southern Nevada","2015","Not on tenure/no tenure system, instructors","56","27","29","0","0","0","2","1","1","5","1","4","3","3","0","0","0","0","42","20","22","4","2","2","0","0","0","0","0","0","-2"
"182500","Truckee Meadows Community College","2015","Tenured total","105","54","51","1","1","0","4","0","4","0","0","0","4","3","1","0","0","0","95","50","45","1","0","1","0","0","0","0","0","0","-2"
"182500","Truckee Meadows Community College","2015","Tenured, professors","105","54","51","1","1","0","4","0","4","0","0","0","4","3","1","0","0","0","95","50","45","1","0","1","0","0","0","0","0","0","-2"
"182500","Truckee Meadows Community College","2015","On-Tenure track total","27","12","15","1","1","0","1","1","0","1","0","1","3","1","2","0","0","0","21","9","12","0","0","0","0","0","0","0","0","0","-2"
"182500","Truckee Meadows Community College","2015","On-tenure track, professors","27","12","15","1","1","0","1","1","0","1","0","1","3","1","2","0","0","0","21","9","12","0","0","0","0","0","0","0","0","0","-2"
"182500","Truckee Meadows Community College","2015","Not on tenure track/No tenure system system total","27","18","9","0","0","0","0","0","0","0","0","0","1","1","0","0","0","0","26","17","9","0","0","0","0","0","0","0","0","0","-2"
"182500","Truckee Meadows Community College","2015","Not on tenure/no tenure system, instructors","27","18","9","0","0","0","0","0","0","0","0","0","1","1","0","0","0","0","26","17","9","0","0","0","0","0","0","0","0","0","-2"
"183822","Bloomfield College","2015","Tenured total","45","16","29","0","0","0","1","0","1","7","2","5","2","0","2","0","0","0","35","14","21","0","0","0","0","0","0","0","0","0","-2"
"183822","Bloomfield College","2015","Tenured, professors","30","11","19","0","0","0","0","0","0","5","0","5","1","0","1","0","0","0","24","11","13","0","0","0","0","0","0","0","0","0","-2"
"183822","Bloomfield College","2015","Tenured, associate professors","15","5","10","0","0","0","1","0","1","2","2","0","1","0","1","0","0","0","11","3","8","0","0","0","0","0","0","0","0","0","-2"
"183822","Bloomfield College","2015","On-Tenure track total","23","9","14","0","0","0","1","1","0","4","0","4","3","1","2","0","0","0","15","7","8","0","0","0","0","0","0","0","0","0","-2"
"183822","Bloomfield College","2015","On-tenure track, associate professors","2","1","1","0","0","0","0","0","0","0","0","0","1","0","1","0","0","0","1","1","0","0","0","0","0","0","0","0","0","0","-2"
"183822","Bloomfield College","2015","On-tenure track, assistant professors","20","8","12","0","0","0","1","1","0","4","0","4","2","1","1","0","0","0","13","6","7","0","0","0","0","0","0","0","0","0","-2"
"183822","Bloomfield College","2015","On-tenure track, instructors","1","0","1","0","0","0","0","0","0","0","0","0","0","0","0","0","0","0","1","0","1","0","0","0","0","0","0","0","0","0","-2"
"183822","Bloomfield College","2015","Not on tenure track/No tenure system system total","5","3","2","0","0","0","1","1","0","0","0","0","0","0","0","0","0","0","4","2","2","0","0","0","0","0","0","0","0","0","-2"
"183822","Bloomfield College","2015","Not on tenure/no tenure system, associate professors","1","1","0","0","0","0","0","0","0","0","0","0","0","0","0","0","0","0","1","1","0","0","0","0","0","0","0","0","0","0","-2"
"183822","Bloomfield College","2015","Not on tenure/no tenure system, assistant professors","2","1","1","0","0","0","0","0","0","0","0","0","0","0","0","0","0","0","2","1","1","0","0","0","0","0","0","0","0","0","-2"
"183822","Bloomfield College","2015","Not on tenure/no tenure system, instructors","2","1","1","0","0","0","1","1","0","0","0","0","0","0","0","0","0","0","1","0","1","0","0","0","0","0","0","0","0","0","-2"
"183910","Caldwell University","2015","Tenured total","49","23","26","0","0","0","2","1","1","1","0","1","1","1","0","0","0","0","44","21","23","0","0","0","1","0","1","0","0","0","-2"
"183910","Caldwell University","2015","Tenured, professors","38","19","19","0","0","0","1","0","1","1","0","1","1","1","0","0","0","0","35","18","17","0","0","0","0","0","0","0","0","0","-2"
"183910","Caldwell University","2015","Tenured, associate professors","10","4","6","0","0","0","1","1","0","0","0","0","0","0","0","0","0","0","8","3","5","0","0","0","1","0","1","0","0","0","-2"
"183910","Caldwell University","2015","Tenured, assistant professors","1","0","1","0","0","0","0","0","0","0","0","0","0","0","0","0","0","0","1","0","1","0","0","0","0","0","0","0","0","0","-2"
"183910","Caldwell University","2015","On-Tenure track total","27","8","19","0","0","0","1","1","0","1","0","1","2","0","2","0","0","0","23","7","16","0","0","0","0","0","0","0","0","0","-2"
"183910","Caldwell University","2015","On-tenure track, associate professors","5","3","2","0","0","0","1","1","0","0","0","0","0","0","0","0","0","0","4","2","2","0","0","0","0","0","0","0","0","0","-2"
"183910","Caldwell University","2015","On-tenure track, assistant professors","22","5","17","0","0","0","0","0","0","1","0","1","2","0","2","0","0","0","19","5","14","0","0","0","0","0","0","0","0","0","-2"
"183910","Caldwell University","2015","Not on tenure track/No tenure system system total","3","0","3","0","0","0","0","0","0","1","0","1","0","0","0","0","0","0","2","0","2","0","0","0","0","0","0","0","0","0","-2"
"183910","Caldwell University","2015","Not on tenure/no tenure system, instructors","1","0","1","0","0","0","0","0","0","1","0","1","0","0","0","0","0","0","0","0","0","0","0","0","0","0","0","0","0","0","-2"
"183910","Caldwell University","2015","Not on tenure/no tenure system, no academic rank","2","0","2","0","0","0","0","0","0","0","0","0","0","0","0","0","0","0","2","0","2","0","0","0","0","0","0","0","0","0","-2"
"184603","Fairleigh Dickinson University-Metropolitan Campus","2015","Tenured total","92","60","32","0","0","0","14","9","5","5","5","0","1","1","0","0","0","0","72","45","27","0","0","0","0","0","0","0","0","0","-2"
"184603","Fairleigh Dickinson University-Metropolitan Campus","2015","Tenured, professors","61","38","23","0","0","0","6","3","3","2","2","0","1","1","0","0","0","0","52","32","20","0","0","0","0","0","0","0","0","0","-2"
"184603","Fairleigh Dickinson University-Metropolitan Campus","2015","Tenured, associate professors","30","22","8","0","0","0","8","6","2","3","3","0","0","0","0","0","0","0","19","13","6","0","0","0","0","0","0","0","0","0","-2"
"184603","Fairleigh Dickinson University-Metropolitan Campus","2015","Tenured, assistant professors","1","0","1","0","0","0","0","0","0","0","0","0","0","0","0","0","0","0","1","0","1","0","0","0","0","0","0","0","0","0","-2"
"184603","Fairleigh Dickinson University-Metropolitan Campus","2015","On-Tenure track total","32","13","19","0","0","0","4","2","2","1","1","0","4","2","2","0","0","0","23","8","15","0","0","0","0","0","0","0","0","0","-2"
"184603","Fairleigh Dickinson University-Metropolitan Campus","2015","On-tenure track, professors","1","0","1","0","0","0","0","0","0","0","0","0","0","0","0","0","0","0","1","0","1","0","0","0","0","0","0","0","0","0","-2"
"184603","Fairleigh Dickinson University-Metropolitan Campus","2015","On-tenure track, associate professors","4","1","3","0","0","0","0","0","0","0","0","0","0","0","0","0","0","0","4","1","3","0","0","0","0","0","0","0","0","0","-2"
"184603","Fairleigh Dickinson University-Metropolitan Campus","2015","On-tenure track, assistant professors","27","12","15","0","0","0","4","2","2","1","1","0","4","2","2","0","0","0","18","7","11","0","0","0","0","0","0","0","0","0","-2"
"184603","Fairleigh Dickinson University-Metropolitan Campus","2015","Not on tenure track/No tenure system system total","45","20","25","0","0","0","3","1","2","3","0","3","10","5","5","0","0","0","29","14","15","0","0","0","0","0","0","0","0","0","-2"
"184603","Fairleigh Dickinson University-Metropolitan Campus","2015","Not on tenure/no tenure system, assistant professors","7","1","6","0","0","0","0","0","0","2","0","2","1","0","1","0","0","0","4","1","3","0","0","0","0","0","0","0","0","0","-2"
"184603","Fairleigh Dickinson University-Metropolitan Campus","2015","Not on tenure/no tenure system, instructors","4","1","3","0","0","0","1","1","0","0","0","0","0","0","0","0","0","0","3","0","3","0","0","0","0","0","0","0","0","0","-2"
"184603","Fairleigh Dickinson University-Metropolitan Campus","2015","Not on tenure/no tenure system, lecturers","34","18","16","0","0","0","2","0","2","1","0","1","9","5","4","0","0","0","22","13","9","0","0","0","0","0","0","0","0","0","-2"
"184612","Felician University","2015","Not on tenure track/No tenure system system total","85","32","53","0","0","0","3","2","1","3","0","3","3","1","2","0","0","0","76","29","47","0","0","0","0","0","0","0","0","0","-2"
"184612","Felician University","2015","Not on tenure/no tenure system, professors","14","5","9","0","0","0","0","0","0","0","0","0","0","0","0","0","0","0","14","5","9","0","0","0","0","0","0","0","0","0","-2"
"184612","Felician University","2015","Not on tenure/no tenure system, associate professors","33","15","18","0","0","0","1","0","1","0","0","0","2","1","1","0","0","0","30","14","16","0","0","0","0","0","0","0","0","0","-2"
"184612","Felician University","2015","Not on tenure/no tenure system, assistant professors","22","10","12","0","0","0","1","1","0","2","0","2","0","0","0","0","0","0","19","9","10","0","0","0","0","0","0","0","0","0","-2"
"184612","Felician University","2015","Not on tenure/no tenure system, instructors","16","2","14","0","0","0","1","1","0","1","0","1","1","0","1","0","0","0","13","1","12","0","0","0","0","0","0","0","0","0","-2"
"185129","New Jersey City University","2015","Tenured total","186","92","94","0","0","0","20","9","11","30","11","19","19","8","11","0","0","0","117","64","53","0","0","0","0","0","0","0","0","0","-2"
"185129","New Jersey City University","2015","Tenured, professors","90","45","45","0","0","0","12","5","7","14","4","10","10","5","5","0","0","0","54","31","23","0","0","0","0","0","0","0","0","0","-2"
"185129","New Jersey City University","2015","Tenured, associate professors","69","37","32","0","0","0","6","4","2","8","4","4","7","3","4","0","0","0","48","26","22","0","0","0","0","0","0","0","0","0","-2"
"185129","New Jersey City University","2015","Tenured, assistant professors","26","9","17","0","0","0","2","0","2","7","2","5","2","0","2","0","0","0","15","7","8","0","0","0","0","0","0","0","0","0","-2"
"185129","New Jersey City University","2015","Tenured, instructors","1","1","0","0","0","0","0","0","0","1","1","0","0","0","0","0","0","0","0","0","0","0","0","0","0","0","0","0","0","0","-2"
"185129","New Jersey City University","2015","On-Tenure track total","62","27","35","0","0","0","17","10","7","5","1","4","3","0","3","0","0","0","37","16","21","0","0","0","0","0","0","0","0","0","-2"
"185129","New Jersey City University","2015","On-tenure track, professors","1","1","0","0","0","0","0","0","0","0","0","0","0","0","0","0","0","0","1","1","0","0","0","0","0","0","0","0","0","0","-2"
"185129","New Jersey City University","2015","On-tenure track, associate professors","9","2","7","0","0","0","2","0","2","0","0","0","0","0","0","0","0","0","7","2","5","0","0","0","0","0","0","0","0","0","-2"
"185129","New Jersey City University","2015","On-tenure track, assistant professors","52","24","28","0","0","0","15","10","5","5","1","4","3","0","3","0","0","0","29","13","16","0","0","0","0","0","0","0","0","0","-2"
"185129","New Jersey City University","2015","Not on tenure track/No tenure system system total","3","2","1","0","0","0","0","0","0","0","0","0","1","0","1","0","0","0","2","2","0","0","0","0","0","0","0","0","0","0","-2"
"185129","New Jersey City University","2015","Not on tenure/no tenure system, assistant professors","3","2","1","0","0","0","0","0","0","0","0","0","1","0","1","0","0","0","2","2","0","0","0","0","0","0","0","0","0","0","-2"
"185590","Montclair State University","2015","Tenured total","422","221","201","0","0","0","63","33","30","33","15","18","31","15","16","0","0","0","283","150","133","7","6","1","2","1","1","3","1","2","-2"
"185590","Montclair State University","2015","Tenured, professors","166","95","71","0","0","0","24","15","9","13","6","7","11","7","4","0","0","0","116","65","51","2","2","0","0","0","0","0","0","0","-2"
"185590","Montclair State University","2015","Tenured, associate professors","229","114","115","0","0","0","37","17","20","16","9","7","18","7","11","0","0","0","149","76","73","5","4","1","2","1","1","2","0","2","-2"
"185590","Montclair State University","2015","Tenured, assistant professors","27","12","15","0","0","0","2","1","1","4","0","4","2","1","1","0","0","0","18","9","9","0","0","0","0","0","0","1","1","0","-2"
"185590","Montclair State University","2015","On-Tenure track total","108","63","45","0","0","0","9","6","3","6","5","1","4","4","0","0","0","0","72","37","35","0","0","0","4","3","1","13","8","5","-2"
"185590","Montclair State University","2015","On-tenure track, professors","3","1","2","0","0","0","1","0","1","0","0","0","0","0","0","0","0","0","2","1","1","0","0","0","0","0","0","0","0","0","-2"
"185590","Montclair State University","2015","On-tenure track, associate professors","15","11","4","0","0","0","2","1","1","2","2","0","2","2","0","0","0","0","8","5","3","0","0","0","1","1","0","0","0","0","-2"
"185590","Montclair State University","2015","On-tenure track, assistant professors","90","51","39","0","0","0","6","5","1","4","3","1","2","2","0","0","0","0","62","31","31","0","0","0","3","2","1","13","8","5","-2"
"185590","Montclair State University","2015","Not on tenure track/No tenure system system total","74","28","46","0","0","0","2","2","0","1","0","1","7","2","5","0","0","0","57","22","35","2","0","2","3","0","3","2","2","0","-2"
"185590","Montclair State University","2015","Not on tenure/no tenure system, associate professors","2","1","1","0","0","0","0","0","0","0","0","0","0","0","0","0","0","0","2","1","1","0","0","0","0","0","0","0","0","0","-2"
"185590","Montclair State University","2015","Not on tenure/no tenure system, assistant professors","11","4","7","0","0","0","0","0","0","0","0","0","0","0","0","0","0","0","9","3","6","1","0","1","0","0","0","1","1","0","-2"
"185590","Montclair State University","2015","Not on tenure/no tenure system, instructors","9","1","8","0","0","0","0","0","0","0","0","0","0","0","0","0","0","0","9","1","8","0","0","0","0","0","0","0","0","0","-2"
"185590","Montclair State University","2015","Not on tenure/no tenure system, no academic rank","52","22","30","0","0","0","2","2","0","1","0","1","7","2","5","0","0","0","37","17","20","1","0","1","3","0","3","1","1","0","-2"
"186399","Rutgers University-Newark","2015","Tenured total","274","192","82","1","0","1","34","25","9","17","12","5","9","7","2","0","0","0","183","128","55","1","1","0","12","8","4","17","11","6","-2"
"186399","Rutgers University-Newark","2015","Tenured, professors","170","128","42","0","0","0","23","19","4","6","5","1","4","4","0","0","0","0","127","93","34","0","0","0","4","3","1","6","4","2","-2"
"186399","Rutgers University-Newark","2015","Tenured, associate professors","104","64","40","1","0","1","11","6","5","11","7","4","5","3","2","0","0","0","56","35","21","1","1","0","8","5","3","11","7","4","-2"
"186399","Rutgers University-Newark","2015","On-Tenure track total","111","67","44","0","0","0","11","8","3","6","0","6","5","4","1","0","0","0","35","21","14","3","1","2","24","14","10","27","19","8","-2"
"186399","Rutgers University-Newark","2015","On-tenure track, professors","1","0","1","0","0","0","0","0","0","0","0","0","0","0","0","0","0","0","1","0","1","0","0","0","0","0","0","0","0","0","-2"
"186399","Rutgers University-Newark","2015","On-tenure track, associate professors","15","7","8","0","0","0","0","0","0","2","0","2","0","0","0","0","0","0","3","2","1","0","0","0","6","3","3","4","2","2","-2"
"186399","Rutgers University-Newark","2015","On-tenure track, assistant professors","95","60","35","0","0","0","11","8","3","4","0","4","5","4","1","0","0","0","31","19","12","3","1","2","18","11","7","23","17","6","-2"
"186399","Rutgers University-Newark","2015","Not on tenure track/No tenure system system total","130","87","43","0","0","0","10","6","4","13","9","4","4","3","1","0","0","0","71","49","22","0","0","0","25","15","10","7","5","2","-2"
"186399","Rutgers University-Newark","2015","Not on tenure/no tenure system, professors","10","5","5","0","0","0","0","0","0","2","1","1","1","1","0","0","0","0","6","2","4","0","0","0","1","1","0","0","0","0","-2"
"186399","Rutgers University-Newark","2015","Not on tenure/no tenure system, associate professors","8","7","1","0","0","0","0","0","0","1","1","0","0","0","0","0","0","0","5","4","1","0","0","0","1","1","0","1","1","0","-2"
"186399","Rutgers University-Newark","2015","Not on tenure/no tenure system, assistant professors","47","37","10","0","0","0","3","2","1","3","3","0","0","0","0","0","0","0","30","24","6","0","0","0","10","7","3","1","1","0","-2"
"186399","Rutgers University-Newark","2015","Not on tenure/no tenure system, instructors","50","28","22","0","0","0","7","4","3","4","2","2","2","1","1","0","0","0","28","18","10","0","0","0","9","3","6","0","0","0","-2"
"186399","Rutgers University-Newark","2015","Not on tenure/no tenure system, lecturers","14","9","5","0","0","0","0","0","0","3","2","1","1","1","0","0","0","0","1","0","1","0","0","0","4","3","1","5","3","2","-2"
"186399","Rutgers University-Newark","2015","Not on tenure/no tenure system, no academic rank","1","1","0","0","0","0","0","0","0","0","0","0","0","0","0","0","0","0","1","1","0","0","0","0","0","0","0","0","0","0","-2"
"186432","Saint Peter's University","2015","Tenured total","72","40","32","0","0","0","3","2","1","3","1","2","3","1","2","0","0","0","63","36","27","0","0","0","0","0","0","0","0","0","-2"
"186432","Saint Peter's University","2015","Tenured, professors","31","19","12","0","0","0","0","0","0","0","0","0","1","0","1","0","0","0","30","19","11","0","0","0","0","0","0","0","0","0","-2"
"186432","Saint Peter's University","2015","Tenured, associate professors","32","15","17","0","0","0","2","2","0","1","0","1","2","1","1","0","0","0","27","12","15","0","0","0","0","0","0","0","0","0","-2"
"186432","Saint Peter's University","2015","Tenured, assistant professors","6","4","2","0","0","0","0","0","0","2","1","1","0","0","0","0","0","0","4","3","1","0","0","0","0","0","0","0","0","0","-2"
"186432","Saint Peter's University","2015","Tenured, instructors","2","2","0","0","0","0","0","0","0","0","0","0","0","0","0","0","0","0","2","2","0","0","0","0","0","0","0","0","0","0","-2"
"186432","Saint Peter's University","2015","Tenured, lecturers","1","0","1","0","0","0","1","0","1","0","0","0","0","0","0","0","0","0","0","0","0","0","0","0","0","0","0","0","0","0","-2"
"186432","Saint Peter's University","2015","On-Tenure track total","25","15","10","0","0","0","1","1","0","2","1","1","3","1","2","0","0","0","19","12","7","0","0","0","0","0","0","0","0","0","-2"
"186432","Saint Peter's University","2015","On-tenure track, associate professors","2","2","0","0","0","0","0","0","0","0","0","0","0","0","0","0","0","0","2","2","0","0","0","0","0","0","0","0","0","0","-2"
"186432","Saint Peter's University","2015","On-tenure track, assistant professors","23","13","10","0","0","0","1","1","0","2","1","1","3","1","2","0","0","0","17","10","7","0","0","0","0","0","0","0","0","0","-2"
"186432","Saint Peter's University","2015","Not on tenure track/No tenure system system total","16","5","11","0","0","0","1","0","1","0","0","0","1","1","0","0","0","0","14","4","10","0","0","0","0","0","0","0","0","0","-2"
"186432","Saint Peter's University","2015","Not on tenure/no tenure system, assistant professors","5","3","2","0","0","0","1","0","1","0","0","0","1","1","0","0","0","0","3","2","1","0","0","0","0","0","0","0","0","0","-2"
"186432","Saint Peter's University","2015","Not on tenure/no tenure system, lecturers","6","2","4","0","0","0","0","0","0","0","0","0","0","0","0","0","0","0","6","2","4","0","0","0","0","0","0","0","0","0","-2"
"186432","Saint Peter's University","2015","Not on tenure/no tenure system, no academic rank","5","0","5","0","0","0","0","0","0","0","0","0","0","0","0","0","0","0","5","0","5","0","0","0","0","0","0","0","0","0","-2"
"187444","William Paterson University of New Jersey","2015","Tenured total","301","165","136","1","0","1","57","34","23","26","19","7","26","12","14","0","0","0","185","98","87","4","1","3","0","0","0","2","1","1","-2"
"187444","William Paterson University of New Jersey","2015","Tenured, professors","167","101","66","1","0","1","37","28","9","12","8","4","12","7","5","0","0","0","102","56","46","2","1","1","0","0","0","1","1","0","-2"
"187444","William Paterson University of New Jersey","2015","Tenured, associate professors","122","60","62","0","0","0","18","6","12","13","11","2","12","5","7","0","0","0","76","38","38","2","0","2","0","0","0","1","0","1","-2"
"187444","William Paterson University of New Jersey","2015","Tenured, assistant professors","12","4","8","0","0","0","2","0","2","1","0","1","2","0","2","0","0","0","7","4","3","0","0","0","0","0","0","0","0","0","-2"
"187444","William Paterson University of New Jersey","2015","On-Tenure track total","84","31","53","0","0","0","15","7","8","7","3","4","3","2","1","0","0","0","48","14","34","0","0","0","3","1","2","8","4","4","-2"
"187444","William Paterson University of New Jersey","2015","On-tenure track, professors","2","2","0","0","0","0","1","1","0","0","0","0","0","0","0","0","0","0","1","1","0","0","0","0","0","0","0","0","0","0","-2"
"187444","William Paterson University of New Jersey","2015","On-tenure track, associate professors","7","2","5","0","0","0","2","2","0","0","0","0","0","0","0","0","0","0","4","0","4","0","0","0","1","0","1","0","0","0","-2"
"187444","William Paterson University of New Jersey","2015","On-tenure track, assistant professors","73","26","47","0","0","0","12","4","8","7","3","4","3","2","1","0","0","0","42","13","29","0","0","0","2","1","1","7","3","4","-2"
"187444","William Paterson University of New Jersey","2015","On-tenure track, instructors","2","1","1","0","0","0","0","0","0","0","0","0","0","0","0","0","0","0","1","0","1","0","0","0","0","0","0","1","1","0","-2"
"187444","William Paterson University of New Jersey","2015","Not on tenure track/No tenure system system total","26","10","16","0","0","0","2","1","1","3","1","2","1","0","1","0","0","0","18","7","11","0","0","0","2","1","1","0","0","0","-2"
"187444","William Paterson University of New Jersey","2015","Not on tenure/no tenure system, associate professors","1","1","0","0","0","0","0","0","0","0","0","0","0","0","0","0","0","0","1","1","0","0","0","0","0","0","0","0","0","0","-2"
"187444","William Paterson University of New Jersey","2015","Not on tenure/no tenure system, assistant professors","15","6","9","0","0","0","1","0","1","2","1","1","1","0","1","0","0","0","9","4","5","0","0","0","2","1","1","0","0","0","-2"
"187444","William Paterson University of New Jersey","2015","Not on tenure/no tenure system, instructors","10","3","7","0","0","0","1","1","0","1","0","1","0","0","0","0","0","0","8","2","6","0","0","0","0","0","0","0","0","0","-2"
"187648","Eastern New Mexico University-Main Campus","2015","Tenured total","71","38","33","0","0","0","3","3","0","0","0","0","5","3","2","0","0","0","54","28","26","1","0","1","0","0","0","8","4","4","-2"
"187648","Eastern New Mexico University-Main Campus","2015","Tenured, professors","38","25","13","0","0","0","3","3","0","0","0","0","3","2","1","0","0","0","29","18","11","1","0","1","0","0","0","2","2","0","-2"
"187648","Eastern New Mexico University-Main Campus","2015","Tenured, associate professors","27","11","16","0","0","0","0","0","0","0","0","0","2","1","1","0","0","0","19","8","11","0","0","0","0","0","0","6","2","4","-2"
"187648","Eastern New Mexico University-Main Campus","2015","Tenured, assistant professors","1","0","1","0","0","0","0","0","0","0","0","0","0","0","0","0","0","0","1","0","1","0","0","0","0","0","0","0","0","0","-2"
"187648","Eastern New Mexico University-Main Campus","2015","Tenured, instructors","5","2","3","0","0","0","0","0","0","0","0","0","0","0","0","0","0","0","5","2","3","0","0","0","0","0","0","0","0","0","-2"
"187648","Eastern New Mexico University-Main Campus","2015","On-Tenure track total","42","26","16","0","0","0","1","0","1","1","1","0","1","0","1","0","0","0","33","22","11","0","0","0","2","1","1","4","2","2","-2"
"187648","Eastern New Mexico University-Main Campus","2015","On-tenure track, associate professors","2","2","0","0","0","0","0","0","0","0","0","0","0","0","0","0","0","0","2","2","0","0","0","0","0","0","0","0","0","0","-2"
"187648","Eastern New Mexico University-Main Campus","2015","On-tenure track, assistant professors","38","22","16","0","0","0","1","0","1","1","1","0","1","0","1","0","0","0","29","18","11","0","0","0","2","1","1","4","2","2","-2"
"187648","Eastern New Mexico University-Main Campus","2015","On-tenure track, no academic rank","2","2","0","0","0","0","0","0","0","0","0","0","0","0","0","0","0","0","2","2","0","0","0","0","0","0","0","0","0","0","-2"
"187648","Eastern New Mexico University-Main Campus","2015","Not on tenure track/No tenure system system total","37","12","25","0","0","0","0","0","0","0","0","0","3","1","2","0","0","0","32","11","21","1","0","1","1","0","1","0","0","0","-2"
"187648","Eastern New Mexico University-Main Campus","2015","Not on tenure/no tenure system, assistant professors","4","2","2","0","0","0","0","0","0","0","0","0","0","0","0","0","0","0","4","2","2","0","0","0","0","0","0","0","0","0","-2"
"187648","Eastern New Mexico University-Main Campus","2015","Not on tenure/no tenure system, instructors","33","10","23","0","0","0","0","0","0","0","0","0","3","1","2","0","0","0","28","9","19","1","0","1","1","0","1","0","0","0","-2"
"187897","New Mexico Highlands University","2015","Tenured total","60","40","20","0","0","0","2","1","1","2","1","1","14","10","4","0","0","0","37","26","11","2","1","1","1","0","1","2","1","1","-2"
"187897","New Mexico Highlands University","2015","Tenured, professors","29","17","12","0","0","0","0","0","0","0","0","0","7","6","1","0","0","0","20","11","9","0","0","0","1","0","1","1","0","1","-2"
"187897","New Mexico Highlands University","2015","Tenured, associate professors","30","22","8","0","0","0","2","1","1","2","1","1","6","3","3","0","0","0","17","15","2","2","1","1","0","0","0","1","1","0","-2"
"187897","New Mexico Highlands University","2015","Tenured, assistant professors","1","1","0","0","0","0","0","0","0","0","0","0","1","1","0","0","0","0","0","0","0","0","0","0","0","0","0","0","0","0","-2"
"187897","New Mexico Highlands University","2015","On-Tenure track total","32","18","14","1","1","0","2","2","0","1","0","1","10","6","4","0","0","0","16","8","8","0","0","0","0","0","0","2","1","1","-2"
"187897","New Mexico Highlands University","2015","On-tenure track, associate professors","4","2","2","1","1","0","1","1","0","0","0","0","2","0","2","0","0","0","0","0","0","0","0","0","0","0","0","0","0","0","-2"
"187897","New Mexico Highlands University","2015","On-tenure track, assistant professors","28","16","12","0","0","0","1","1","0","1","0","1","8","6","2","0","0","0","16","8","8","0","0","0","0","0","0","2","1","1","-2"
"187897","New Mexico Highlands University","2015","Not on tenure track/No tenure system system total","44","21","23","0","0","0","2","1","1","0","0","0","12","4","8","0","0","0","28","15","13","0","0","0","0","0","0","2","1","1","-2"
"187897","New Mexico Highlands University","2015","Not on tenure/no tenure system, professors","1","0","1","0","0","0","0","0","0","0","0","0","1","0","1","0","0","0","0","0","0","0","0","0","0","0","0","0","0","0","-2"
"187897","New Mexico Highlands University","2015","Not on tenure/no tenure system, associate professors","1","1","0","0","0","0","0","0","0","0","0","0","0","0","0","0","0","0","1","1","0","0","0","0","0","0","0","0","0","0","-2"
"187897","New Mexico Highlands University","2015","Not on tenure/no tenure system, assistant professors","13","8","5","0","0","0","0","0","0","0","0","0","2","2","0","0","0","0","9","5","4","0","0","0","0","0","0","2","1","1","-2"
"187897","New Mexico Highlands University","2015","Not on tenure/no tenure system, instructors","12","5","7","0","0","0","2","1","1","0","0","0","4","2","2","0","0","0","6","2","4","0","0","0","0","0","0","0","0","0","-2"
"187897","New Mexico Highlands University","2015","Not on tenure/no tenure system, no academic rank","17","7","10","0","0","0","0","0","0","0","0","0","5","0","5","0","0","0","12","7","5","0","0","0","0","0","0","0","0","0","-2"
"187985","University of New Mexico-Main Campus","2015","Tenured total","612","352","260","18","6","12","63","43","20","9","4","5","74","31","43","0","0","0","419","253","166","3","1","2","22","10","12","4","4","0","-2"
"187985","University of New Mexico-Main Campus","2015","Tenured, professors","332","213","119","10","4","6","35","26","9","2","1","1","30","15","15","0","0","0","246","162","84","1","1","0","7","3","4","1","1","0","-2"
"187985","University of New Mexico-Main Campus","2015","Tenured, associate professors","278","137","141","8","2","6","28","17","11","7","3","4","43","15","28","0","0","0","172","90","82","2","0","2","15","7","8","3","3","0","-2"
"187985","University of New Mexico-Main Campus","2015","Tenured, assistant professors","2","2","0","0","0","0","0","0","0","0","0","0","1","1","0","0","0","0","1","1","0","0","0","0","0","0","0","0","0","0","-2"
"187985","University of New Mexico-Main Campus","2015","On-Tenure track total","295","157","138","9","2","7","24","17","7","8","5","3","35","18","17","0","0","0","141","67","74","3","2","1","43","26","17","32","20","12","-2"
"187985","University of New Mexico-Main Campus","2015","On-tenure track, professors","6","2","4","0","0","0","1","0","1","0","0","0","3","1","2","0","0","0","2","1","1","0","0","0","0","0","0","0","0","0","-2"
"187985","University of New Mexico-Main Campus","2015","On-tenure track, associate professors","16","11","5","0","0","0","3","3","0","3","3","0","1","0","1","0","0","0","7","4","3","1","1","0","1","0","1","0","0","0","-2"
"187985","University of New Mexico-Main Campus","2015","On-tenure track, assistant professors","273","144","129","9","2","7","20","14","6","5","2","3","31","17","14","0","0","0","132","62","70","2","1","1","42","26","16","32","20","12","-2"
"187985","University of New Mexico-Main Campus","2015","Not on tenure track/No tenure system system total","793","352","441","5","2","3","64","33","31","17","5","12","108","39","69","1","0","1","527","241","286","11","3","8","28","14","14","32","15","17","-2"
"187985","University of New Mexico-Main Campus","2015","Not on tenure/no tenure system, professors","102","60","42","2","1","1","7","4","3","0","0","0","4","2","2","0","0","0","83","49","34","0","0","0","6","4","2","0","0","0","-2"
"187985","University of New Mexico-Main Campus","2015","Not on tenure/no tenure system, associate professors","131","68","63","0","0","0","13","7","6","4","0","4","11","3","8","1","0","1","98","54","44","2","2","0","1","1","0","1","1","0","-2"
"187985","University of New Mexico-Main Campus","2015","Not on tenure/no tenure system, assistant professors","307","137","170","1","0","1","33","20","13","7","3","4","53","23","30","0","0","0","172","76","96","6","1","5","10","3","7","25","11","14","-2"
"187985","University of New Mexico-Main Campus","2015","Not on tenure/no tenure system, instructors","64","18","46","0","0","0","8","1","7","1","0","1","7","0","7","0","0","0","45","15","30","1","0","1","1","1","0","1","1","0","-2"
"187985","University of New Mexico-Main Campus","2015","Not on tenure/no tenure system, lecturers","189","69","120","2","1","1","3","1","2","5","2","3","33","11","22","0","0","0","129","47","82","2","0","2","10","5","5","5","2","3","-2"
"188030","New Mexico State University-Main Campus","2015","Tenured total","392","249","143","4","3","1","41","31","10","5","5","0","51","27","24","0","0","0","281","176","105","2","1","1","0","0","0","8","6","2","-2"
"188030","New Mexico State University-Main Campus","2015","Tenured, professors","199","144","55","2","2","0","19","15","4","3","3","0","16","11","5","0","0","0","157","111","46","0","0","0","0","0","0","2","2","0","-2"
"188030","New Mexico State University-Main Campus","2015","Tenured, associate professors","186","102","84","1","0","1","22","16","6","2","2","0","34","16","18","0","0","0","119","63","56","2","1","1","0","0","0","6","4","2","-2"
"188030","New Mexico State University-Main Campus","2015","Tenured, assistant professors","7","3","4","1","1","0","0","0","0","0","0","0","1","0","1","0","0","0","5","2","3","0","0","0","0","0","0","0","0","0","-2"
"188030","New Mexico State University-Main Campus","2015","On-Tenure track total","163","86","77","2","2","0","16","9","7","6","1","5","31","13","18","0","0","0","86","47","39","2","1","1","0","0","0","20","13","7","-2"
"188030","New Mexico State University-Main Campus","2015","On-tenure track, associate professors","7","4","3","1","1","0","0","0","0","0","0","0","0","0","0","0","0","0","6","3","3","0","0","0","0","0","0","0","0","0","-2"
"188030","New Mexico State University-Main Campus","2015","On-tenure track, assistant professors","156","82","74","1","1","0","16","9","7","6","1","5","31","13","18","0","0","0","80","44","36","2","1","1","0","0","0","20","13","7","-2"
"188030","New Mexico State University-Main Campus","2015","Not on tenure track/No tenure system system total","129","45","84","1","1","0","4","1","3","1","0","1","28","6","22","0","0","0","82","31","51","3","1","2","7","3","4","3","2","1","-2"
"188030","New Mexico State University-Main Campus","2015","Not on tenure/no tenure system, professors","13","6","7","0","0","0","0","0","0","0","0","0","0","0","0","0","0","0","13","6","7","0","0","0","0","0","0","0","0","0","-2"
"188030","New Mexico State University-Main Campus","2015","Not on tenure/no tenure system, associate professors","27","8","19","0","0","0","0","0","0","1","0","1","6","0","6","0","0","0","19","7","12","1","1","0","0","0","0","0","0","0","-2"
"188030","New Mexico State University-Main Campus","2015","Not on tenure/no tenure system, assistant professors","59","16","43","1","1","0","2","0","2","0","0","0","15","3","12","0","0","0","38","11","27","2","0","2","0","0","0","1","1","0","-2"
"188030","New Mexico State University-Main Campus","2015","Not on tenure/no tenure system, instructors","9","4","5","0","0","0","1","1","0","0","0","0","3","0","3","0","0","0","5","3","2","0","0","0","0","0","0","0","0","0","-2"
"188030","New Mexico State University-Main Campus","2015","Not on tenure/no tenure system, no academic rank","21","11","10","0","0","0","1","0","1","0","0","0","4","3","1","0","0","0","7","4","3","0","0","0","7","3","4","2","1","1","-2"
"188058","Northern New Mexico College","2015","Tenured total","17","7","10","1","1","0","1","1","0","0","0","0","9","3","6","0","0","0","5","2","3","0","0","0","1","0","1","0","0","0","-2"
"188058","Northern New Mexico College","2015","Tenured, associate professors","17","7","10","1","1","0","1","1","0","0","0","0","9","3","6","0","0","0","5","2","3","0","0","0","1","0","1","0","0","0","-2"
"188058","Northern New Mexico College","2015","On-Tenure track total","13","8","5","0","0","0","2","2","0","0","0","0","5","3","2","0","0","0","5","2","3","0","0","0","1","1","0","0","0","0","-2"
"188058","Northern New Mexico College","2015","On-tenure track, assistant professors","12","7","5","0","0","0","2","2","0","0","0","0","5","3","2","0","0","0","4","1","3","0","0","0","1","1","0","0","0","0","-2"
"188058","Northern New Mexico College","2015","On-tenure track, instructors","1","1","0","0","0","0","0","0","0","0","0","0","0","0","0","0","0","0","1","1","0","0","0","0","0","0","0","0","0","0","-2"
"188058","Northern New Mexico College","2015","Not on tenure track/No tenure system system total","7","3","4","0","0","0","0","0","0","0","0","0","1","0","1","0","0","0","4","2","2","0","0","0","2","1","1","0","0","0","-2"
"188058","Northern New Mexico College","2015","Not on tenure/no tenure system, assistant professors","4","1","3","0","0","0","0","0","0","0","0","0","1","0","1","0","0","0","2","1","1","0","0","0","1","0","1","0","0","0","-2"
"188058","Northern New Mexico College","2015","Not on tenure/no tenure system, lecturers","3","2","1","0","0","0","0","0","0","0","0","0","0","0","0","0","0","0","2","1","1","0","0","0","1","1","0","0","0","0","-2"
"188182","University of the Southwest","2015","Not on tenure track/No tenure system system total","30","14","16","0","0","0","1","1","0","1","0","1","3","1","2","0","0","0","25","12","13","0","0","0","0","0","0","0","0","0","-2"
"188182","University of the Southwest","2015","Not on tenure/no tenure system, professors","4","1","3","0","0","0","0","0","0","0","0","0","0","0","0","0","0","0","4","1","3","0","0","0","0","0","0","0","0","0","-2"
"188182","University of the Southwest","2015","Not on tenure/no tenure system, associate professors","7","2","5","0","0","0","0","0","0","0","0","0","1","0","1","0","0","0","6","2","4","0","0","0","0","0","0","0","0","0","-2"
"188182","University of the Southwest","2015","Not on tenure/no tenure system, assistant professors","15","8","7","0","0","0","1","1","0","1","0","1","2","1","1","0","0","0","11","6","5","0","0","0","0","0","0","0","0","0","-2"
"188182","University of the Southwest","2015","Not on tenure/no tenure system, instructors","4","3","1","0","0","0","0","0","0","0","0","0","0","0","0","0","0","0","4","3","1","0","0","0","0","0","0","0","0","0","-2"
"188304","Western New Mexico University","2015","Tenured total","42","22","20","0","0","0","0","0","0","0","0","0","6","5","1","0","0","0","28","12","16","0","0","0","8","5","3","0","0","0","-2"
"188304","Western New Mexico University","2015","Tenured, professors","26","13","13","0","0","0","0","0","0","0","0","0","0","0","0","0","0","0","20","9","11","0","0","0","6","4","2","0","0","0","-2"
"188304","Western New Mexico University","2015","Tenured, associate professors","16","9","7","0","0","0","0","0","0","0","0","0","6","5","1","0","0","0","8","3","5","0","0","0","2","1","1","0","0","0","-2"
"188304","Western New Mexico University","2015","On-Tenure track total","51","16","35","0","0","0","3","2","1","2","1","1","8","3","5","1","1","0","32","8","24","0","0","0","5","1","4","0","0","0","-2"
"188304","Western New Mexico University","2015","On-tenure track, associate professors","2","1","1","0","0","0","0","0","0","0","0","0","2","1","1","0","0","0","0","0","0","0","0","0","0","0","0","0","0","0","-2"
"188304","Western New Mexico University","2015","On-tenure track, assistant professors","49","15","34","0","0","0","3","2","1","2","1","1","6","2","4","1","1","0","32","8","24","0","0","0","5","1","4","0","0","0","-2"
"188304","Western New Mexico University","2015","Not on tenure track/No tenure system system total","17","7","10","0","0","0","1","0","1","0","0","0","3","0","3","0","0","0","4","4","0","0","0","0","9","3","6","0","0","0","-2"
"188304","Western New Mexico University","2015","Not on tenure/no tenure system, professors","1","1","0","0","0","0","0","0","0","0","0","0","0","0","0","0","0","0","1","1","0","0","0","0","0","0","0","0","0","0","-2"
"188304","Western New Mexico University","2015","Not on tenure/no tenure system, associate professors","2","2","0","0","0","0","0","0","0","0","0","0","0","0","0","0","0","0","2","2","0","0","0","0","0","0","0","0","0","0","-2"
"188304","Western New Mexico University","2015","Not on tenure/no tenure system, assistant professors","8","0","8","0","0","0","1","0","1","0","0","0","2","0","2","0","0","0","0","0","0","0","0","0","5","0","5","0","0","0","-2"
"188304","Western New Mexico University","2015","Not on tenure/no tenure system, instructors","1","0","1","0","0","0","0","0","0","0","0","0","0","0","0","0","0","0","0","0","0","0","0","0","1","0","1","0","0","0","-2"
"188304","Western New Mexico University","2015","Not on tenure/no tenure system, lecturers","5","4","1","0","0","0","0","0","0","0","0","0","1","0","1","0","0","0","1","1","0","0","0","0","3","3","0","0","0","0","-2"
"188340","Vaughn College of Aeronautics and Technology","2015","Tenured total","21","17","4","0","0","0","0","0","0","1","0","1","0","0","0","3","3","0","17","14","3","0","0","0","0","0","0","0","0","0","-2"
"188340","Vaughn College of Aeronautics and Technology","2015","Tenured, professors","12","10","2","0","0","0","0","0","0","0","0","0","0","0","0","2","2","0","10","8","2","0","0","0","0","0","0","0","0","0","-2"
"188340","Vaughn College of Aeronautics and Technology","2015","Tenured, associate professors","9","7","2","0","0","0","0","0","0","1","0","1","0","0","0","1","1","0","7","6","1","0","0","0","0","0","0","0","0","0","-2"
"188340","Vaughn College of Aeronautics and Technology","2015","On-Tenure track total","11","7","4","0","0","0","3","1","2","0","0","0","1","1","0","2","2","0","5","3","2","0","0","0","0","0","0","0","0","0","-2"
"188340","Vaughn College of Aeronautics and Technology","2015","On-tenure track, associate professors","1","0","1","0","0","0","1","0","1","0","0","0","0","0","0","0","0","0","0","0","0","0","0","0","0","0","0","0","0","0","-2"
"188340","Vaughn College of Aeronautics and Technology","2015","On-tenure track, assistant professors","10","7","3","0","0","0","2","1","1","0","0","0","1","1","0","2","2","0","5","3","2","0","0","0","0","0","0","0","0","0","-2"
"188340","Vaughn College of Aeronautics and Technology","2015","Not on tenure track/No tenure system system total","11","9","2","0","0","0","0","0","0","2","2","0","1","1","0","2","2","0","6","4","2","0","0","0","0","0","0","0","0","0","-2"
"188340","Vaughn College of Aeronautics and Technology","2015","Not on tenure/no tenure system, associate professors","2","2","0","0","0","0","0","0","0","1","1","0","0","0","0","0","0","0","1","1","0","0","0","0","0","0","0","0","0","0","-2"
"188340","Vaughn College of Aeronautics and Technology","2015","Not on tenure/no tenure system, assistant professors","5","3","2","0","0","0","0","0","0","0","0","0","0","0","0","1","1","0","4","2","2","0","0","0","0","0","0","0","0","0","-2"
"188340","Vaughn College of Aeronautics and Technology","2015","Not on tenure/no tenure system, instructors","4","4","0","0","0","0","0","0","0","1","1","0","1","1","0","1","1","0","1","1","0","0","0","0","0","0","0","0","0","0","-2"
"189413","Boricua College","2015","Not on tenure track/No tenure system system total","46","21","25","0","0","0","1","0","1","1","1","0","42","20","22","0","0","0","2","0","2","0","0","0","0","0","0","0","0","0","-2"
"189413","Boricua College","2015","Not on tenure/no tenure system, professors","6","3","3","0","0","0","0","0","0","1","1","0","5","2","3","0","0","0","0","0","0","0","0","0","0","0","0","0","0","0","-2"
"189413","Boricua College","2015","Not on tenure/no tenure system, associate professors","8","4","4","0","0","0","0","0","0","0","0","0","7","4","3","0","0","0","1","0","1","0","0","0","0","0","0","0","0","0","-2"
"189413","Boricua College","2015","Not on tenure/no tenure system, assistant professors","15","9","6","0","0","0","0","0","0","0","0","0","15","9","6","0","0","0","0","0","0","0","0","0","0","0","0","0","0","0","-2"
"189413","Boricua College","2015","Not on tenure/no tenure system, instructors","17","5","12","0","0","0","1","0","1","0","0","0","15","5","10","0","0","0","1","0","1","0","0","0","0","0","0","0","0","0","-2"
"190114","Metropolitan College of New York","2015","Not on tenure track/No tenure system system total","25","14","11","0","0","0","2","1","1","4","2","2","1","0","1","0","0","0","17","11","6","0","0","0","1","0","1","0","0","0","-2"
"190114","Metropolitan College of New York","2015","Not on tenure/no tenure system, professors","7","6","1","0","0","0","0","0","0","0","0","0","1","0","1","0","0","0","6","6","0","0","0","0","0","0","0","0","0","0","-2"
"190114","Metropolitan College of New York","2015","Not on tenure/no tenure system, associate professors","14","7","7","0","0","0","2","1","1","3","2","1","0","0","0","0","0","0","9","4","5","0","0","0","0","0","0","0","0","0","-2"
"190114","Metropolitan College of New York","2015","Not on tenure/no tenure system, assistant professors","4","1","3","0","0","0","0","0","0","1","0","1","0","0","0","0","0","0","2","1","1","0","0","0","1","0","1","0","0","0","-2"
"190558","College of Staten Island CUNY","2015","Tenured total","261","151","110","1","1","0","39","23","16","9","6","3","15","9","6","0","0","0","196","111","85","1","1","0","0","0","0","0","0","0","-2"
"190558","College of Staten Island CUNY","2015","Tenured, professors","108","70","38","0","0","0","15","10","5","1","1","0","8","6","2","0","0","0","84","53","31","0","0","0","0","0","0","0","0","0","-2"
"190558","College of Staten Island CUNY","2015","Tenured, associate professors","118","64","54","1","1","0","22","13","9","7","4","3","5","3","2","0","0","0","82","42","40","1","1","0","0","0","0","0","0","0","-2"
"190558","College of Staten Island CUNY","2015","Tenured, assistant professors","17","10","7","0","0","0","1","0","1","1","1","0","0","0","0","0","0","0","15","9","6","0","0","0","0","0","0","0","0","0","-2"
"190558","College of Staten Island CUNY","2015","Tenured, lecturers","18","7","11","0","0","0","1","0","1","0","0","0","2","0","2","0","0","0","15","7","8","0","0","0","0","0","0","0","0","0","-2"
"190558","College of Staten Island CUNY","2015","On-Tenure track total","114","52","62","0","0","0","12","2","10","5","0","5","8","5","3","0","0","0","69","33","36","0","0","0","0","0","0","20","12","8","-2"
"190558","College of Staten Island CUNY","2015","On-tenure track, professors","1","1","0","0","0","0","1","1","0","0","0","0","0","0","0","0","0","0","0","0","0","0","0","0","0","0","0","0","0","0","-2"
"190558","College of Staten Island CUNY","2015","On-tenure track, associate professors","12","8","4","0","0","0","2","0","2","1","0","1","1","1","0","0","0","0","8","7","1","0","0","0","0","0","0","0","0","0","-2"
"190558","College of Staten Island CUNY","2015","On-tenure track, assistant professors","94","42","52","0","0","0","7","1","6","4","0","4","6","4","2","0","0","0","57","25","32","0","0","0","0","0","0","20","12","8","-2"
"190558","College of Staten Island CUNY","2015","On-tenure track, lecturers","7","1","6","0","0","0","2","0","2","0","0","0","1","0","1","0","0","0","4","1","3","0","0","0","0","0","0","0","0","0","-2"
"190558","College of Staten Island CUNY","2015","Not on tenure track/No tenure system system total","16","5","11","0","0","0","1","0","1","0","0","0","1","1","0","0","0","0","14","4","10","0","0","0","0","0","0","0","0","0","-2"
"190558","College of Staten Island CUNY","2015","Not on tenure/no tenure system, professors","2","0","2","0","0","0","0","0","0","0","0","0","0","0","0","0","0","0","2","0","2","0","0","0","0","0","0","0","0","0","-2"
"190558","College of Staten Island CUNY","2015","Not on tenure/no tenure system, associate professors","1","0","1","0","0","0","0","0","0","0","0","0","0","0","0","0","0","0","1","0","1","0","0","0","0","0","0","0","0","0","-2"
"190558","College of Staten Island CUNY","2015","Not on tenure/no tenure system, assistant professors","3","1","2","0","0","0","0","0","0","0","0","0","0","0","0","0","0","0","3","1","2","0","0","0","0","0","0","0","0","0","-2"
"190558","College of Staten Island CUNY","2015","Not on tenure/no tenure system, lecturers","10","4","6","0","0","0","1","0","1","0","0","0","1","1","0","0","0","0","8","3","5","0","0","0","0","0","0","0","0","0","-2"
"190594","CUNY Hunter College","2015","Tenured total","497","254","243","0","0","0","46","20","26","48","23","25","52","19","33","0","0","0","342","188","154","2","1","1","0","0","0","7","3","4","-2"
"190594","CUNY Hunter College","2015","Tenured, professors","247","131","116","0","0","0","16","9","7","18","10","8","18","8","10","0","0","0","192","103","89","1","1","0","0","0","0","2","0","2","-2"
"190594","CUNY Hunter College","2015","Tenured, associate professors","200","100","100","0","0","0","25","11","14","21","10","11","27","8","19","0","0","0","123","68","55","1","0","1","0","0","0","3","3","0","-2"
"190594","CUNY Hunter College","2015","Tenured, assistant professors","19","9","10","0","0","0","3","0","3","4","2","2","2","2","0","0","0","0","10","5","5","0","0","0","0","0","0","0","0","0","-2"
"190594","CUNY Hunter College","2015","Tenured, lecturers","31","14","17","0","0","0","2","0","2","5","1","4","5","1","4","0","0","0","17","12","5","0","0","0","0","0","0","2","0","2","-2"
"190594","CUNY Hunter College","2015","On-Tenure track total","125","50","75","1","0","1","14","5","9","8","4","4","8","3","5","0","0","0","82","32","50","1","0","1","0","0","0","11","6","5","-2"
"190594","CUNY Hunter College","2015","On-tenure track, professors","2","0","2","0","0","0","0","0","0","0","0","0","0","0","0","0","0","0","2","0","2","0","0","0","0","0","0","0","0","0","-2"
"190594","CUNY Hunter College","2015","On-tenure track, associate professors","20","11","9","0","0","0","3","2","1","2","1","1","3","1","2","0","0","0","10","6","4","0","0","0","0","0","0","2","1","1","-2"
"190594","CUNY Hunter College","2015","On-tenure track, assistant professors","86","32","54","1","0","1","9","2","7","6","3","3","4","1","3","0","0","0","57","21","36","1","0","1","0","0","0","8","5","3","-2"
"190594","CUNY Hunter College","2015","On-tenure track, lecturers","17","7","10","0","0","0","2","1","1","0","0","0","1","1","0","0","0","0","13","5","8","0","0","0","0","0","0","1","0","1","-2"
"190594","CUNY Hunter College","2015","Not on tenure track/No tenure system system total","86","40","46","0","0","0","5","2","3","2","1","1","4","4","0","0","0","0","68","27","41","2","1","1","0","0","0","5","5","0","-2"
"190594","CUNY Hunter College","2015","Not on tenure/no tenure system, professors","50","19","31","0","0","0","2","0","2","1","0","1","2","2","0","0","0","0","40","13","27","2","1","1","0","0","0","3","3","0","-2"
"190594","CUNY Hunter College","2015","Not on tenure/no tenure system, associate professors","3","2","1","0","0","0","0","0","0","0","0","0","1","1","0","0","0","0","2","1","1","0","0","0","0","0","0","0","0","0","-2"
"190594","CUNY Hunter College","2015","Not on tenure/no tenure system, assistant professors","15","9","6","0","0","0","2","1","1","0","0","0","0","0","0","0","0","0","13","8","5","0","0","0","0","0","0","0","0","0","-2"
"190594","CUNY Hunter College","2015","Not on tenure/no tenure system, instructors","2","0","2","0","0","0","0","0","0","0","0","0","0","0","0","0","0","0","2","0","2","0","0","0","0","0","0","0","0","0","-2"
"190594","CUNY Hunter College","2015","Not on tenure/no tenure system, lecturers","16","10","6","0","0","0","1","1","0","1","1","0","1","1","0","0","0","0","11","5","6","0","0","0","0","0","0","2","2","0","-2"
"190600","CUNY John Jay College of Criminal Justice","2015","Tenured total","293","155","138","0","0","0","24","9","15","34","17","17","25","10","15","1","0","1","195","114","81","0","0","0","0","0","0","14","5","9","-2"
"190600","CUNY John Jay College of Criminal Justice","2015","Tenured, professors","99","60","39","0","0","0","5","2","3","6","1","5","6","3","3","0","0","0","81","54","27","0","0","0","0","0","0","1","0","1","-2"
"190600","CUNY John Jay College of Criminal Justice","2015","Tenured, associate professors","144","76","68","0","0","0","14","6","8","21","13","8","13","5","8","0","0","0","84","48","36","0","0","0","0","0","0","12","4","8","-2"
"190600","CUNY John Jay College of Criminal Justice","2015","Tenured, assistant professors","27","7","20","0","0","0","4","1","3","3","0","3","3","2","1","0","0","0","17","4","13","0","0","0","0","0","0","0","0","0","-2"
"190600","CUNY John Jay College of Criminal Justice","2015","Tenured, lecturers","23","12","11","0","0","0","1","0","1","4","3","1","3","0","3","1","0","1","13","8","5","0","0","0","0","0","0","1","1","0","-2"
"190600","CUNY John Jay College of Criminal Justice","2015","On-Tenure track total","94","44","50","0","0","0","3","2","1","8","3","5","13","8","5","3","1","2","59","27","32","1","1","0","0","0","0","7","2","5","-2"
"190600","CUNY John Jay College of Criminal Justice","2015","On-tenure track, associate professors","8","2","6","0","0","0","0","0","0","0","0","0","1","1","0","0","0","0","7","1","6","0","0","0","0","0","0","0","0","0","-2"
"190600","CUNY John Jay College of Criminal Justice","2015","On-tenure track, assistant professors","76","37","39","0","0","0","3","2","1","6","2","4","10","5","5","2","1","1","47","24","23","1","1","0","0","0","0","7","2","5","-2"
"190600","CUNY John Jay College of Criminal Justice","2015","On-tenure track, lecturers","10","5","5","0","0","0","0","0","0","2","1","1","2","2","0","1","0","1","5","2","3","0","0","0","0","0","0","0","0","0","-2"
"190600","CUNY John Jay College of Criminal Justice","2015","Not on tenure track/No tenure system system total","26","16","10","0","0","0","0","0","0","1","0","1","3","2","1","0","0","0","20","13","7","0","0","0","0","0","0","2","1","1","-2"
"190600","CUNY John Jay College of Criminal Justice","2015","Not on tenure/no tenure system, professors","8","4","4","0","0","0","0","0","0","1","0","1","1","0","1","0","0","0","6","4","2","0","0","0","0","0","0","0","0","0","-2"
"190600","CUNY John Jay College of Criminal Justice","2015","Not on tenure/no tenure system, associate professors","1","1","0","0","0","0","0","0","0","0","0","0","0","0","0","0","0","0","1","1","0","0","0","0","0","0","0","0","0","0","-2"
"190600","CUNY John Jay College of Criminal Justice","2015","Not on tenure/no tenure system, assistant professors","8","4","4","0","0","0","0","0","0","0","0","0","1","1","0","0","0","0","6","3","3","0","0","0","0","0","0","1","0","1","-2"
"190600","CUNY John Jay College of Criminal Justice","2015","Not on tenure/no tenure system, instructors","1","0","1","0","0","0","0","0","0","0","0","0","0","0","0","0","0","0","1","0","1","0","0","0","0","0","0","0","0","0","-2"
"190600","CUNY John Jay College of Criminal Justice","2015","Not on tenure/no tenure system, lecturers","8","7","1","0","0","0","0","0","0","0","0","0","1","1","0","0","0","0","6","5","1","0","0","0","0","0","0","1","1","0","-2"
"190637","CUNY Lehman College","2015","Tenured total","251","130","121","1","0","1","12","9","3","24","11","13","36","21","15","0","0","0","177","89","88","0","0","0","0","0","0","1","0","1","-2"
"190637","CUNY Lehman College","2015","Tenured, professors","92","56","36","1","0","1","2","1","1","2","1","1","13","9","4","0","0","0","74","45","29","0","0","0","0","0","0","0","0","0","-2"
"190637","CUNY Lehman College","2015","Tenured, associate professors","108","50","58","0","0","0","7","5","2","11","7","4","15","6","9","0","0","0","75","32","43","0","0","0","0","0","0","0","0","0","-2"
"190637","CUNY Lehman College","2015","Tenured, assistant professors","21","9","12","0","0","0","3","3","0","5","1","4","1","1","0","0","0","0","12","4","8","0","0","0","0","0","0","0","0","0","-2"
"190637","CUNY Lehman College","2015","Tenured, lecturers","30","15","15","0","0","0","0","0","0","6","2","4","7","5","2","0","0","0","16","8","8","0","0","0","0","0","0","1","0","1","-2"
"190637","CUNY Lehman College","2015","On-Tenure track total","101","31","70","1","0","1","13","4","9","12","1","11","9","4","5","0","0","0","59","19","40","1","0","1","0","0","0","6","3","3","-2"
"190637","CUNY Lehman College","2015","On-tenure track, associate professors","6","4","2","0","0","0","2","2","0","0","0","0","1","1","0","0","0","0","3","1","2","0","0","0","0","0","0","0","0","0","-2"
"190637","CUNY Lehman College","2015","On-tenure track, assistant professors","75","21","54","1","0","1","9","1","8","8","0","8","7","3","4","0","0","0","43","14","29","1","0","1","0","0","0","6","3","3","-2"
"190637","CUNY Lehman College","2015","On-tenure track, lecturers","20","6","14","0","0","0","2","1","1","4","1","3","1","0","1","0","0","0","13","4","9","0","0","0","0","0","0","0","0","0","-2"
"190637","CUNY Lehman College","2015","Not on tenure track/No tenure system system total","22","12","10","1","1","0","1","0","1","2","1","1","3","1","2","0","0","0","13","7","6","0","0","0","0","0","0","2","2","0","-2"
"190637","CUNY Lehman College","2015","Not on tenure/no tenure system, professors","3","3","0","0","0","0","0","0","0","0","0","0","1","1","0","0","0","0","2","2","0","0","0","0","0","0","0","0","0","0","-2"
"190637","CUNY Lehman College","2015","Not on tenure/no tenure system, associate professors","1","1","0","0","0","0","0","0","0","0","0","0","0","0","0","0","0","0","1","1","0","0","0","0","0","0","0","0","0","0","-2"
"190637","CUNY Lehman College","2015","Not on tenure/no tenure system, assistant professors","3","2","1","0","0","0","0","0","0","1","1","0","1","0","1","0","0","0","1","1","0","0","0","0","0","0","0","0","0","0","-2"
"190637","CUNY Lehman College","2015","Not on tenure/no tenure system, instructors","3","1","2","0","0","0","0","0","0","0","0","0","0","0","0","0","0","0","3","1","2","0","0","0","0","0","0","0","0","0","-2"
"190637","CUNY Lehman College","2015","Not on tenure/no tenure system, lecturers","12","5","7","1","1","0","1","0","1","1","0","1","1","0","1","0","0","0","6","2","4","0","0","0","0","0","0","2","2","0","-2"
"190655","CUNY New York City College of Technology","2015","Tenured total","262","142","120","1","1","0","29","14","15","40","21","19","17","10","7","0","0","0","165","89","76","0","0","0","1","1","0","9","6","3","-2"
"190655","CUNY New York City College of Technology","2015","Tenured, professors","63","37","26","0","0","0","5","1","4","7","4","3","6","3","3","0","0","0","44","28","16","0","0","0","0","0","0","1","1","0","-2"
"190655","CUNY New York City College of Technology","2015","Tenured, associate professors","112","56","56","0","0","0","16","7","9","16","8","8","6","4","2","0","0","0","68","32","36","0","0","0","1","1","0","5","4","1","-2"
"190655","CUNY New York City College of Technology","2015","Tenured, assistant professors","63","37","26","1","1","0","8","6","2","7","4","3","4","3","1","0","0","0","40","22","18","0","0","0","0","0","0","3","1","2","-2"
"190655","CUNY New York City College of Technology","2015","Tenured, lecturers","24","12","12","0","0","0","0","0","0","10","5","5","1","0","1","0","0","0","13","7","6","0","0","0","0","0","0","0","0","0","-2"
"190655","CUNY New York City College of Technology","2015","On-Tenure track total","155","76","79","1","0","1","30","17","13","13","2","11","14","6","8","0","0","0","88","44","44","0","0","0","0","0","0","9","7","2","-2"
"190655","CUNY New York City College of Technology","2015","On-tenure track, associate professors","11","5","6","0","0","0","2","0","2","2","1","1","1","1","0","0","0","0","5","3","2","0","0","0","0","0","0","1","0","1","-2"
"190655","CUNY New York City College of Technology","2015","On-tenure track, assistant professors","144","71","73","1","0","1","28","17","11","11","1","10","13","5","8","0","0","0","83","41","42","0","0","0","0","0","0","8","7","1","-2"
"190655","CUNY New York City College of Technology","2015","Not on tenure track/No tenure system system total","20","10","10","0","0","0","3","2","1","2","0","2","1","1","0","0","0","0","10","6","4","1","0","1","0","0","0","3","1","2","-2"
"190655","CUNY New York City College of Technology","2015","Not on tenure/no tenure system, assistant professors","11","6","5","0","0","0","1","0","1","2","0","2","1","1","0","0","0","0","4","4","0","0","0","0","0","0","0","3","1","2","-2"
"190655","CUNY New York City College of Technology","2015","Not on tenure/no tenure system, instructors","1","0","1","0","0","0","0","0","0","0","0","0","0","0","0","0","0","0","1","0","1","0","0","0","0","0","0","0","0","0","-2"
"190655","CUNY New York City College of Technology","2015","Not on tenure/no tenure system, lecturers","8","4","4","0","0","0","2","2","0","0","0","0","0","0","0","0","0","0","5","2","3","1","0","1","0","0","0","0","0","0","-2"
"190664","CUNY Queens College","2015","Tenured total","455","259","196","0","0","0","50","23","27","18","12","6","23","10","13","0","0","0","346","208","138","2","2","0","0","0","0","16","4","12","-2"
"190664","CUNY Queens College","2015","Tenured, professors","201","135","66","0","0","0","21","11","10","9","6","3","9","5","4","0","0","0","159","111","48","1","1","0","0","0","0","2","1","1","-2"
"190664","CUNY Queens College","2015","Tenured, associate professors","175","90","85","0","0","0","23","11","12","7","4","3","11","3","8","0","0","0","121","68","53","1","1","0","0","0","0","12","3","9","-2"
"190664","CUNY Queens College","2015","Tenured, assistant professors","18","7","11","0","0","0","3","1","2","1","1","0","0","0","0","0","0","0","13","5","8","0","0","0","0","0","0","1","0","1","-2"
"190664","CUNY Queens College","2015","Tenured, lecturers","61","27","34","0","0","0","3","0","3","1","1","0","3","2","1","0","0","0","53","24","29","0","0","0","0","0","0","1","0","1","-2"
"190664","CUNY Queens College","2015","On-Tenure track total","126","54","72","0","0","0","9","1","8","10","3","7","12","7","5","0","0","0","67","30","37","2","2","0","0","0","0","26","11","15","-2"
"190664","CUNY Queens College","2015","On-tenure track, professors","2","1","1","0","0","0","0","0","0","0","0","0","0","0","0","0","0","0","1","0","1","1","1","0","0","0","0","0","0","0","-2"
"190664","CUNY Queens College","2015","On-tenure track, associate professors","8","5","3","0","0","0","0","0","0","0","0","0","2","1","1","0","0","0","4","3","1","0","0","0","0","0","0","2","1","1","-2"
"190664","CUNY Queens College","2015","On-tenure track, assistant professors","102","43","59","0","0","0","8","1","7","10","3","7","10","6","4","0","0","0","50","22","28","1","1","0","0","0","0","23","10","13","-2"
"190664","CUNY Queens College","2015","On-tenure track, lecturers","14","5","9","0","0","0","1","0","1","0","0","0","0","0","0","0","0","0","12","5","7","0","0","0","0","0","0","1","0","1","-2"
"190664","CUNY Queens College","2015","Not on tenure track/No tenure system system total","31","16","15","0","0","0","2","0","2","5","1","4","1","0","1","0","0","0","23","15","8","0","0","0","0","0","0","0","0","0","-2"
"190664","CUNY Queens College","2015","Not on tenure/no tenure system, professors","9","4","5","0","0","0","0","0","0","4","1","3","0","0","0","0","0","0","5","3","2","0","0","0","0","0","0","0","0","0","-2"
"190664","CUNY Queens College","2015","Not on tenure/no tenure system, associate professors","3","3","0","0","0","0","0","0","0","0","0","0","0","0","0","0","0","0","3","3","0","0","0","0","0","0","0","0","0","0","-2"
"190664","CUNY Queens College","2015","Not on tenure/no tenure system, assistant professors","7","4","3","0","0","0","1","0","1","1","0","1","0","0","0","0","0","0","5","4","1","0","0","0","0","0","0","0","0","0","-2"
"190664","CUNY Queens College","2015","Not on tenure/no tenure system, instructors","4","3","1","0","0","0","0","0","0","0","0","0","1","0","1","0","0","0","3","3","0","0","0","0","0","0","0","0","0","0","-2"
"190664","CUNY Queens College","2015","Not on tenure/no tenure system, lecturers","8","2","6","0","0","0","1","0","1","0","0","0","0","0","0","0","0","0","7","2","5","0","0","0","0","0","0","0","0","0","-2"
"190691","CUNY York College","2015","Tenured total","135","75","60","0","0","0","19","14","5","25","14","11","13","5","8","0","0","0","76","42","34","0","0","0","0","0","0","2","0","2","-2"
"190691","CUNY York College","2015","Tenured, professors","38","23","15","0","0","0","5","5","0","1","1","0","3","1","2","0","0","0","29","16","13","0","0","0","0","0","0","0","0","0","-2"
"190691","CUNY York College","2015","Tenured, associate professors","68","36","32","0","0","0","12","8","4","15","8","7","8","4","4","0","0","0","31","16","15","0","0","0","0","0","0","2","0","2","-2"
"190691","CUNY York College","2015","Tenured, assistant professors","10","7","3","0","0","0","0","0","0","3","2","1","1","0","1","0","0","0","6","5","1","0","0","0","0","0","0","0","0","0","-2"
"190691","CUNY York College","2015","Tenured, lecturers","19","9","10","0","0","0","2","1","1","6","3","3","1","0","1","0","0","0","10","5","5","0","0","0","0","0","0","0","0","0","-2"
"190691","CUNY York College","2015","On-Tenure track total","55","23","32","0","0","0","10","5","5","13","2","11","3","2","1","0","0","0","28","13","15","0","0","0","0","0","0","1","1","0","-2"
"190691","CUNY York College","2015","On-tenure track, professors","1","1","0","0","0","0","1","1","0","0","0","0","0","0","0","0","0","0","0","0","0","0","0","0","0","0","0","0","0","0","-2"
"190691","CUNY York College","2015","On-tenure track, associate professors","11","3","8","0","0","0","1","0","1","2","0","2","0","0","0","0","0","0","7","2","5","0","0","0","0","0","0","1","1","0","-2"
"190691","CUNY York College","2015","On-tenure track, assistant professors","39","18","21","0","0","0","8","4","4","9","2","7","3","2","1","0","0","0","19","10","9","0","0","0","0","0","0","0","0","0","-2"
"190691","CUNY York College","2015","On-tenure track, lecturers","4","1","3","0","0","0","0","0","0","2","0","2","0","0","0","0","0","0","2","1","1","0","0","0","0","0","0","0","0","0","-2"
"190691","CUNY York College","2015","Not on tenure track/No tenure system system total","12","4","8","0","0","0","1","0","1","4","1","3","0","0","0","0","0","0","5","2","3","0","0","0","0","0","0","2","1","1","-2"
"190691","CUNY York College","2015","Not on tenure/no tenure system, professors","5","1","4","0","0","0","0","0","0","2","1","1","0","0","0","0","0","0","2","0","2","0","0","0","0","0","0","1","0","1","-2"
"190691","CUNY York College","2015","Not on tenure/no tenure system, assistant professors","5","2","3","0","0","0","1","0","1","1","0","1","0","0","0","0","0","0","2","1","1","0","0","0","0","0","0","1","1","0","-2"
"190691","CUNY York College","2015","Not on tenure/no tenure system, lecturers","2","1","1","0","0","0","0","0","0","1","0","1","0","0","0","0","0","0","1","1","0","0","0","0","0","0","0","0","0","0","-2"
"190761","Dominican College of Blauvelt","2015","Tenured total","32","11","21","0","0","0","2","1","1","0","0","0","1","0","1","0","0","0","29","10","19","0","0","0","0","0","0","0","0","0","-2"
"190761","Dominican College of Blauvelt","2015","Tenured, professors","4","0","4","0","0","0","1","0","1","0","0","0","0","0","0","0","0","0","3","0","3","0","0","0","0","0","0","0","0","0","-2"
"190761","Dominican College of Blauvelt","2015","Tenured, associate professors","13","5","8","0","0","0","1","1","0","0","0","0","1","0","1","0","0","0","11","4","7","0","0","0","0","0","0","0","0","0","-2"
"190761","Dominican College of Blauvelt","2015","Tenured, assistant professors","15","6","9","0","0","0","0","0","0","0","0","0","0","0","0","0","0","0","15","6","9","0","0","0","0","0","0","0","0","0","-2"
"190761","Dominican College of Blauvelt","2015","On-Tenure track total","22","6","16","0","0","0","2","1","1","1","0","1","5","1","4","0","0","0","14","4","10","0","0","0","0","0","0","0","0","0","-2"
"190761","Dominican College of Blauvelt","2015","On-tenure track, associate professors","2","1","1","0","0","0","0","0","0","0","0","0","1","0","1","0","0","0","1","1","0","0","0","0","0","0","0","0","0","0","-2"
"190761","Dominican College of Blauvelt","2015","On-tenure track, assistant professors","18","5","13","0","0","0","2","1","1","1","0","1","3","1","2","0","0","0","12","3","9","0","0","0","0","0","0","0","0","0","-2"
"190761","Dominican College of Blauvelt","2015","On-tenure track, instructors","2","0","2","0","0","0","0","0","0","0","0","0","1","0","1","0","0","0","1","0","1","0","0","0","0","0","0","0","0","0","-2"
"190761","Dominican College of Blauvelt","2015","Not on tenure track/No tenure system system total","19","5","14","0","0","0","0","0","0","0","0","0","0","0","0","0","0","0","19","5","14","0","0","0","0","0","0","0","0","0","-2"
"190761","Dominican College of Blauvelt","2015","Not on tenure/no tenure system, assistant professors","17","5","12","0","0","0","0","0","0","0","0","0","0","0","0","0","0","0","17","5","12","0","0","0","0","0","0","0","0","0","-2"
"190761","Dominican College of Blauvelt","2015","Not on tenure/no tenure system, instructors","2","0","2","0","0","0","0","0","0","0","0","0","0","0","0","0","0","0","2","0","2","0","0","0","0","0","0","0","0","0","-2"
"192749","Manhattanville College","2015","Tenured total","58","30","28","0","0","0","4","1","3","3","3","0","0","0","0","0","0","0","50","26","24","0","0","0","1","0","1","0","0","0","-2"
"192749","Manhattanville College","2015","Tenured, professors","36","22","14","0","0","0","3","1","2","2","2","0","0","0","0","0","0","0","31","19","12","0","0","0","0","0","0","0","0","0","-2"
"192749","Manhattanville College","2015","Tenured, associate professors","19","7","12","0","0","0","1","0","1","1","1","0","0","0","0","0","0","0","16","6","10","0","0","0","1","0","1","0","0","0","-2"
"192749","Manhattanville College","2015","Tenured, assistant professors","3","1","2","0","0","0","0","0","0","0","0","0","0","0","0","0","0","0","3","1","2","0","0","0","0","0","0","0","0","0","-2"
"192749","Manhattanville College","2015","On-Tenure track total","35","13","22","1","1","0","3","1","2","1","0","1","0","0","0","0","0","0","26","8","18","0","0","0","4","3","1","0","0","0","-2"
"192749","Manhattanville College","2015","On-tenure track, professors","3","2","1","1","1","0","0","0","0","0","0","0","0","0","0","0","0","0","2","1","1","0","0","0","0","0","0","0","0","0","-2"
"192749","Manhattanville College","2015","On-tenure track, associate professors","6","3","3","0","0","0","1","0","1","0","0","0","0","0","0","0","0","0","5","3","2","0","0","0","0","0","0","0","0","0","-2"
"192749","Manhattanville College","2015","On-tenure track, assistant professors","26","8","18","0","0","0","2","1","1","1","0","1","0","0","0","0","0","0","19","4","15","0","0","0","4","3","1","0","0","0","-2"
"192749","Manhattanville College","2015","Not on tenure track/No tenure system system total","16","9","7","0","0","0","1","0","1","1","0","1","1","0","1","0","0","0","13","9","4","0","0","0","0","0","0","0","0","0","-2"
"192749","Manhattanville College","2015","Not on tenure/no tenure system, professors","1","1","0","0","0","0","0","0","0","0","0","0","0","0","0","0","0","0","1","1","0","0","0","0","0","0","0","0","0","0","-2"
"192749","Manhattanville College","2015","Not on tenure/no tenure system, assistant professors","2","2","0","0","0","0","0","0","0","0","0","0","0","0","0","0","0","0","2","2","0","0","0","0","0","0","0","0","0","0","-2"
"192749","Manhattanville College","2015","Not on tenure/no tenure system, instructors","2","0","2","0","0","0","0","0","0","0","0","0","0","0","0","0","0","0","2","0","2","0","0","0","0","0","0","0","0","0","-2"
"192749","Manhattanville College","2015","Not on tenure/no tenure system, lecturers","11","6","5","0","0","0","1","0","1","1","0","1","1","0","1","0","0","0","8","6","2","0","0","0","0","0","0","0","0","0","-2"
"193016","Mercy College","2015","Tenured total","53","23","30","0","0","0","11","5","6","4","2","2","0","0","0","0","0","0","38","16","22","0","0","0","0","0","0","0","0","0","-2"
"193016","Mercy College","2015","Tenured, professors","18","11","7","0","0","0","3","3","0","1","1","0","0","0","0","0","0","0","14","7","7","0","0","0","0","0","0","0","0","0","-2"
"193016","Mercy College","2015","Tenured, associate professors","26","8","18","0","0","0","5","1","4","3","1","2","0","0","0","0","0","0","18","6","12","0","0","0","0","0","0","0","0","0","-2"
"193016","Mercy College","2015","Tenured, assistant professors","9","4","5","0","0","0","3","1","2","0","0","0","0","0","0","0","0","0","6","3","3","0","0","0","0","0","0","0","0","0","-2"
"193016","Mercy College","2015","On-Tenure track total","33","9","24","0","0","0","2","1","1","2","0","2","4","2","2","0","0","0","23","6","17","0","0","0","0","0","0","2","0","2","-2"
"193016","Mercy College","2015","On-tenure track, professors","2","1","1","0","0","0","0","0","0","0","0","0","1","1","0","0","0","0","1","0","1","0","0","0","0","0","0","0","0","0","-2"
"193016","Mercy College","2015","On-tenure track, associate professors","12","4","8","0","0","0","1","0","1","1","0","1","2","0","2","0","0","0","8","4","4","0","0","0","0","0","0","0","0","0","-2"
"193016","Mercy College","2015","On-tenure track, assistant professors","19","4","15","0","0","0","1","1","0","1","0","1","1","1","0","0","0","0","14","2","12","0","0","0","0","0","0","2","0","2","-2"
"193016","Mercy College","2015","Not on tenure track/No tenure system system total","112","43","69","0","0","0","6","4","2","7","1","6","7","2","5","0","0","0","89","35","54","0","0","0","0","0","0","3","1","2","-2"
"193016","Mercy College","2015","Not on tenure/no tenure system, professors","5","2","3","0","0","0","0","0","0","0","0","0","0","0","0","0","0","0","5","2","3","0","0","0","0","0","0","0","0","0","-2"
"193016","Mercy College","2015","Not on tenure/no tenure system, associate professors","33","13","20","0","0","0","3","2","1","0","0","0","1","0","1","0","0","0","28","11","17","0","0","0","0","0","0","1","0","1","-2"
"193016","Mercy College","2015","Not on tenure/no tenure system, assistant professors","59","21","38","0","0","0","1","0","1","6","0","6","6","2","4","0","0","0","44","18","26","0","0","0","0","0","0","2","1","1","-2"
"193016","Mercy College","2015","Not on tenure/no tenure system, instructors","15","7","8","0","0","0","2","2","0","1","1","0","0","0","0","0","0","0","12","4","8","0","0","0","0","0","0","0","0","0","-2"
"193399","College of Mount Saint Vincent","2015","Tenured total","38","19","19","0","0","0","1","0","1","0","0","0","0","0","0","0","0","0","36","18","18","1","1","0","0","0","0","0","0","0","-2"
"193399","College of Mount Saint Vincent","2015","Tenured, professors","12","6","6","0","0","0","0","0","0","0","0","0","0","0","0","0","0","0","11","5","6","1","1","0","0","0","0","0","0","0","-2"
"193399","College of Mount Saint Vincent","2015","Tenured, associate professors","22","11","11","0","0","0","1","0","1","0","0","0","0","0","0","0","0","0","21","11","10","0","0","0","0","0","0","0","0","0","-2"
"193399","College of Mount Saint Vincent","2015","Tenured, assistant professors","4","2","2","0","0","0","0","0","0","0","0","0","0","0","0","0","0","0","4","2","2","0","0","0","0","0","0","0","0","0","-2"
"193399","College of Mount Saint Vincent","2015","On-Tenure track total","32","11","21","0","0","0","4","1","3","0","0","0","5","1","4","0","0","0","21","8","13","2","1","1","0","0","0","0","0","0","-2"
"193399","College of Mount Saint Vincent","2015","On-tenure track, associate professors","11","3","8","0","0","0","1","0","1","0","0","0","1","0","1","0","0","0","8","2","6","1","1","0","0","0","0","0","0","0","-2"
"193399","College of Mount Saint Vincent","2015","On-tenure track, assistant professors","20","8","12","0","0","0","3","1","2","0","0","0","4","1","3","0","0","0","12","6","6","1","0","1","0","0","0","0","0","0","-2"
"193399","College of Mount Saint Vincent","2015","On-tenure track, instructors","1","0","1","0","0","0","0","0","0","0","0","0","0","0","0","0","0","0","1","0","1","0","0","0","0","0","0","0","0","0","-2"
"193399","College of Mount Saint Vincent","2015","Not on tenure track/No tenure system system total","10","3","7","0","0","0","0","0","0","0","0","0","1","0","1","0","0","0","8","3","5","0","0","0","1","0","1","0","0","0","-2"
"193399","College of Mount Saint Vincent","2015","Not on tenure/no tenure system, professors","1","1","0","0","0","0","0","0","0","0","0","0","0","0","0","0","0","0","1","1","0","0","0","0","0","0","0","0","0","0","-2"
"193399","College of Mount Saint Vincent","2015","Not on tenure/no tenure system, associate professors","1","0","1","0","0","0","0","0","0","0","0","0","0","0","0","0","0","0","1","0","1","0","0","0","0","0","0","0","0","0","-2"
"193399","College of Mount Saint Vincent","2015","Not on tenure/no tenure system, instructors","8","2","6","0","0","0","0","0","0","0","0","0","1","0","1","0","0","0","6","2","4","0","0","0","1","0","1","0","0","0","-2"
"194161","Nyack College","2015","Tenured total","38","25","13","0","0","0","6","4","2","5","3","2","1","0","1","0","0","0","26","18","8","0","0","0","0","0","0","0","0","0","-2"
"194161","Nyack College","2015","Tenured, professors","30","22","8","0","0","0","6","4","2","4","2","2","0","0","0","0","0","0","20","16","4","0","0","0","0","0","0","0","0","0","-2"
"194161","Nyack College","2015","Tenured, associate professors","8","3","5","0","0","0","0","0","0","1","1","0","1","0","1","0","0","0","6","2","4","0","0","0","0","0","0","0","0","0","-2"
"194161","Nyack College","2015","On-Tenure track total","53","34","19","0","0","0","11","6","5","5","1","4","6","4","2","0","0","0","28","20","8","0","0","0","0","0","0","3","3","0","-2"
"194161","Nyack College","2015","On-tenure track, professors","7","5","2","0","0","0","0","0","0","2","0","2","0","0","0","0","0","0","5","5","0","0","0","0","0","0","0","0","0","0","-2"
"194161","Nyack College","2015","On-tenure track, associate professors","11","8","3","0","0","0","2","0","2","0","0","0","1","1","0","0","0","0","8","7","1","0","0","0","0","0","0","0","0","0","-2"
"194161","Nyack College","2015","On-tenure track, assistant professors","35","21","14","0","0","0","9","6","3","3","1","2","5","3","2","0","0","0","15","8","7","0","0","0","0","0","0","3","3","0","-2"
"194161","Nyack College","2015","Not on tenure track/No tenure system system total","9","4","5","0","0","0","0","0","0","5","1","4","2","2","0","0","0","0","2","1","1","0","0","0","0","0","0","0","0","0","-2"
"194161","Nyack College","2015","Not on tenure/no tenure system, lecturers","9","4","5","0","0","0","0","0","0","5","1","4","2","2","0","0","0","0","2","1","1","0","0","0","0","0","0","0","0","0","-2"
"195173","St Francis College","2015","Tenured total","51","26","25","0","0","0","2","1","1","3","0","3","3","1","2","0","0","0","43","24","19","0","0","0","0","0","0","0","0","0","-2"
"195173","St Francis College","2015","Tenured, professors","26","16","10","0","0","0","1","1","0","1","0","1","1","0","1","0","0","0","23","15","8","0","0","0","0","0","0","0","0","0","-2"
"195173","St Francis College","2015","Tenured, associate professors","25","10","15","0","0","0","1","0","1","2","0","2","2","1","1","0","0","0","20","9","11","0","0","0","0","0","0","0","0","0","-2"
"195173","St Francis College","2015","On-Tenure track total","17","6","11","0","0","0","3","2","1","2","0","2","0","0","0","0","0","0","11","3","8","0","0","0","0","0","0","1","1","0","-2"
"195173","St Francis College","2015","On-tenure track, associate professors","1","0","1","0","0","0","0","0","0","0","0","0","0","0","0","0","0","0","1","0","1","0","0","0","0","0","0","0","0","0","-2"
"195173","St Francis College","2015","On-tenure track, assistant professors","16","6","10","0","0","0","3","2","1","2","0","2","0","0","0","0","0","0","10","3","7","0","0","0","0","0","0","1","1","0","-2"
"195173","St Francis College","2015","Not on tenure track/No tenure system system total","13","9","4","0","0","0","0","0","0","1","0","1","0","0","0","0","0","0","12","9","3","0","0","0","0","0","0","0","0","0","-2"
"195173","St Francis College","2015","Not on tenure/no tenure system, assistant professors","1","1","0","0","0","0","0","0","0","0","0","0","0","0","0","0","0","0","1","1","0","0","0","0","0","0","0","0","0","0","-2"
"195173","St Francis College","2015","Not on tenure/no tenure system, lecturers","12","8","4","0","0","0","0","0","0","1","0","1","0","0","0","0","0","0","11","8","3","0","0","0","0","0","0","0","0","0","-2"
"196219","SUNY at Purchase College","2015","Tenured total","89","43","46","0","0","0","5","3","2","3","2","1","2","2","0","0","0","0","77","35","42","2","1","1","0","0","0","0","0","0","-2"
"196219","SUNY at Purchase College","2015","Tenured, professors","33","19","14","0","0","0","2","2","0","1","1","0","0","0","0","0","0","0","30","16","14","0","0","0","0","0","0","0","0","0","-2"
"196219","SUNY at Purchase College","2015","Tenured, associate professors","56","24","32","0","0","0","3","1","2","2","1","1","2","2","0","0","0","0","47","19","28","2","1","1","0","0","0","0","0","0","-2"
"196219","SUNY at Purchase College","2015","On-Tenure track total","58","30","28","0","0","0","5","2","3","3","0","3","2","2","0","0","0","0","41","22","19","2","1","1","0","0","0","5","3","2","-2"
"196219","SUNY at Purchase College","2015","On-tenure track, associate professors","6","5","1","0","0","0","0","0","0","0","0","0","0","0","0","0","0","0","5","5","0","1","0","1","0","0","0","0","0","0","-2"
"196219","SUNY at Purchase College","2015","On-tenure track, assistant professors","52","25","27","0","0","0","5","2","3","3","0","3","2","2","0","0","0","0","36","17","19","1","1","0","0","0","0","5","3","2","-2"
"196219","SUNY at Purchase College","2015","Not on tenure track/No tenure system system total","30","8","22","0","0","0","2","0","2","3","1","2","1","0","1","0","0","0","22","6","16","0","0","0","0","0","0","2","1","1","-2"
"196219","SUNY at Purchase College","2015","Not on tenure/no tenure system, associate professors","1","0","1","0","0","0","0","0","0","0","0","0","0","0","0","0","0","0","1","0","1","0","0","0","0","0","0","0","0","0","-2"
"196219","SUNY at Purchase College","2015","Not on tenure/no tenure system, assistant professors","26","8","18","0","0","0","1","0","1","3","1","2","1","0","1","0","0","0","19","6","13","0","0","0","0","0","0","2","1","1","-2"
"196219","SUNY at Purchase College","2015","Not on tenure/no tenure system, lecturers","3","0","3","0","0","0","1","0","1","0","0","0","0","0","0","0","0","0","2","0","2","0","0","0","0","0","0","0","0","0","-2"
"196237","SUNY College at Old Westbury","2015","Tenured total","89","44","45","0","0","0","15","6","9","11","7","4","9","7","2","0","0","0","54","24","30","0","0","0","0","0","0","0","0","0","-2"
"196237","SUNY College at Old Westbury","2015","Tenured, professors","28","16","12","0","0","0","7","4","3","2","2","0","5","4","1","0","0","0","14","6","8","0","0","0","0","0","0","0","0","0","-2"
"196237","SUNY College at Old Westbury","2015","Tenured, associate professors","60","27","33","0","0","0","8","2","6","9","5","4","4","3","1","0","0","0","39","17","22","0","0","0","0","0","0","0","0","0","-2"
"196237","SUNY College at Old Westbury","2015","Tenured, instructors","1","1","0","0","0","0","0","0","0","0","0","0","0","0","0","0","0","0","1","1","0","0","0","0","0","0","0","0","0","0","-2"
"196237","SUNY College at Old Westbury","2015","On-Tenure track total","51","21","30","0","0","0","9","3","6","7","4","3","4","2","2","0","0","0","28","10","18","1","0","1","0","0","0","2","2","0","-2"
"196237","SUNY College at Old Westbury","2015","On-tenure track, associate professors","2","0","2","0","0","0","2","0","2","0","0","0","0","0","0","0","0","0","0","0","0","0","0","0","0","0","0","0","0","0","-2"
"196237","SUNY College at Old Westbury","2015","On-tenure track, assistant professors","49","21","28","0","0","0","7","3","4","7","4","3","4","2","2","0","0","0","28","10","18","1","0","1","0","0","0","2","2","0","-2"
"196237","SUNY College at Old Westbury","2015","Not on tenure track/No tenure system system total","20","8","12","0","0","0","2","0","2","3","1","2","2","0","2","0","0","0","12","7","5","0","0","0","0","0","0","1","0","1","-2"
"196237","SUNY College at Old Westbury","2015","Not on tenure/no tenure system, associate professors","1","1","0","0","0","0","0","0","0","1","1","0","0","0","0","0","0","0","0","0","0","0","0","0","0","0","0","0","0","0","-2"
"196237","SUNY College at Old Westbury","2015","Not on tenure/no tenure system, assistant professors","6","1","5","0","0","0","1","0","1","1","0","1","0","0","0","0","0","0","4","1","3","0","0","0","0","0","0","0","0","0","-2"
"196237","SUNY College at Old Westbury","2015","Not on tenure/no tenure system, instructors","4","1","3","0","0","0","0","0","0","1","0","1","0","0","0","0","0","0","3","1","2","0","0","0","0","0","0","0","0","0","-2"
"196237","SUNY College at Old Westbury","2015","Not on tenure/no tenure system, lecturers","9","5","4","0","0","0","1","0","1","0","0","0","2","0","2","0","0","0","5","5","0","0","0","0","0","0","0","1","0","1","-2"
"206279","Union Institute & University","2015","Not on tenure track/No tenure system system total","31","15","16","0","0","0","1","0","1","5","2","3","1","1","0","0","0","0","20","11","9","1","0","1","3","1","2","0","0","0","-2"
"206279","Union Institute & University","2015","Not on tenure/no tenure system, no academic rank","31","15","16","0","0","0","1","0","1","5","2","3","1","1","0","0","0","0","20","11","9","1","0","1","3","1","2","0","0","0","-2"
"207351","Oklahoma Panhandle State University","2015","Tenured total","7","5","2","0","0","0","0","0","0","0","0","0","0","0","0","0","0","0","7","5","2","0","0","0","0","0","0","0","0","0","-2"
"207351","Oklahoma Panhandle State University","2015","Tenured, professors","4","3","1","0","0","0","0","0","0","0","0","0","0","0","0","0","0","0","4","3","1","0","0","0","0","0","0","0","0","0","-2"
"207351","Oklahoma Panhandle State University","2015","Tenured, associate professors","3","2","1","0","0","0","0","0","0","0","0","0","0","0","0","0","0","0","3","2","1","0","0","0","0","0","0","0","0","0","-2"
"207351","Oklahoma Panhandle State University","2015","On-Tenure track total","32","19","13","2","1","1","0","0","0","0","0","0","0","0","0","0","0","0","30","18","12","0","0","0","0","0","0","0","0","0","-2"
"207351","Oklahoma Panhandle State University","2015","On-tenure track, associate professors","7","7","0","1","1","0","0","0","0","0","0","0","0","0","0","0","0","0","6","6","0","0","0","0","0","0","0","0","0","0","-2"
"207351","Oklahoma Panhandle State University","2015","On-tenure track, assistant professors","17","7","10","1","0","1","0","0","0","0","0","0","0","0","0","0","0","0","16","7","9","0","0","0","0","0","0","0","0","0","-2"
"207351","Oklahoma Panhandle State University","2015","On-tenure track, instructors","8","5","3","0","0","0","0","0","0","0","0","0","0","0","0","0","0","0","8","5","3","0","0","0","0","0","0","0","0","0","-2"
"207351","Oklahoma Panhandle State University","2015","Not on tenure track/No tenure system system total","5","4","1","0","0","0","0","0","0","0","0","0","1","1","0","0","0","0","4","3","1","0","0","0","0","0","0","0","0","0","-2"
"207351","Oklahoma Panhandle State University","2015","Not on tenure/no tenure system, instructors","5","4","1","0","0","0","0","0","0","0","0","0","1","1","0","0","0","0","4","3","1","0","0","0","0","0","0","0","0","0","-2"
"209241","Mount Angel Seminary","2015","Not on tenure track/No tenure system system total","20","15","5","0","0","0","1","0","1","0","0","0","0","0","0","0","0","0","19","15","4","0","0","0","0","0","0","0","0","0","-2"
"209241","Mount Angel Seminary","2015","Not on tenure/no tenure system, professors","5","5","0","0","0","0","0","0","0","0","0","0","0","0","0","0","0","0","5","5","0","0","0","0","0","0","0","0","0","0","-2"
"209241","Mount Angel Seminary","2015","Not on tenure/no tenure system, associate professors","8","5","3","0","0","0","1","0","1","0","0","0","0","0","0","0","0","0","7","5","2","0","0","0","0","0","0","0","0","0","-2"
"209241","Mount Angel Seminary","2015","Not on tenure/no tenure system, assistant professors","5","4","1","0","0","0","0","0","0","0","0","0","0","0","0","0","0","0","5","4","1","0","0","0","0","0","0","0","0","0","-2"
"209241","Mount Angel Seminary","2015","Not on tenure/no tenure system, instructors","1","0","1","0","0","0","0","0","0","0","0","0","0","0","0","0","0","0","1","0","1","0","0","0","0","0","0","0","0","0","-2"
"209241","Mount Angel Seminary","2015","Not on tenure/no tenure system, no academic rank","1","1","0","0","0","0","0","0","0","0","0","0","0","0","0","0","0","0","1","1","0","0","0","0","0","0","0","0","0","0","-2"
"210304","Warner Pacific University","2015","Not on tenure track/No tenure system system total","27","16","11","0","0","0","0","0","0","0","0","0","3","2","1","0","0","0","24","14","10","0","0","0","0","0","0","0","0","0","-2"
"210304","Warner Pacific University","2015","Not on tenure/no tenure system, professors","7","5","2","0","0","0","0","0","0","0","0","0","1","1","0","0","0","0","6","4","2","0","0","0","0","0","0","0","0","0","-2"
"210304","Warner Pacific University","2015","Not on tenure/no tenure system, associate professors","11","8","3","0","0","0","0","0","0","0","0","0","1","1","0","0","0","0","10","7","3","0","0","0","0","0","0","0","0","0","-2"
"210304","Warner Pacific University","2015","Not on tenure/no tenure system, assistant professors","9","3","6","0","0","0","0","0","0","0","0","0","1","0","1","0","0","0","8","3","5","0","0","0","0","0","0","0","0","0","-2"
"222831","Angelo State University","2015","Tenured total","122","80","42","3","2","1","6","4","2","3","1","2","8","3","5","0","0","0","102","70","32","0","0","0","0","0","0","0","0","0","-2"
"222831","Angelo State University","2015","Tenured, professors","75","53","22","2","2","0","2","1","1","0","0","0","3","2","1","0","0","0","68","48","20","0","0","0","0","0","0","0","0","0","-2"
"222831","Angelo State University","2015","Tenured, associate professors","46","27","19","1","0","1","4","3","1","3","1","2","4","1","3","0","0","0","34","22","12","0","0","0","0","0","0","0","0","0","-2"
"222831","Angelo State University","2015","Tenured, assistant professors","1","0","1","0","0","0","0","0","0","0","0","0","1","0","1","0","0","0","0","0","0","0","0","0","0","0","0","0","0","0","-2"
"222831","Angelo State University","2015","On-Tenure track total","63","39","24","0","0","0","5","4","1","2","1","1","6","3","3","0","0","0","48","29","19","0","0","0","2","2","0","0","0","0","-2"
"222831","Angelo State University","2015","On-tenure track, assistant professors","63","39","24","0","0","0","5","4","1","2","1","1","6","3","3","0","0","0","48","29","19","0","0","0","2","2","0","0","0","0","-2"
"222831","Angelo State University","2015","Not on tenure track/No tenure system system total","79","30","49","0","0","0","1","0","1","1","0","1","9","5","4","0","0","0","68","25","43","0","0","0","0","0","0","0","0","0","-2"
"222831","Angelo State University","2015","Not on tenure/no tenure system, instructors","51","24","27","0","0","0","0","0","0","0","0","0","6","5","1","0","0","0","45","19","26","0","0","0","0","0","0","0","0","0","-2"
"222831","Angelo State University","2015","Not on tenure/no tenure system, no academic rank","28","6","22","0","0","0","1","0","1","1","0","1","3","0","3","0","0","0","23","6","17","0","0","0","0","0","0","0","0","0","-2"
"222992","Austin Community College District","2015","Not on tenure track/No tenure system system total","534","238","296","2","0","2","25","9","16","33","14","19","71","38","33","2","2","0","394","172","222","7","3","4","0","0","0","0","0","0","-2"
"222992","Austin Community College District","2015","Not on tenure/no tenure system, professors","324","160","164","2","0","2","9","4","5","18","8","10","42","25","17","1","1","0","249","122","127","3","0","3","0","0","0","0","0","0","-2"
"222992","Austin Community College District","2015","Not on tenure/no tenure system, associate professors","147","48","99","0","0","0","11","3","8","12","5","7","22","9","13","0","0","0","101","30","71","1","1","0","0","0","0","0","0","0","-2"
"222992","Austin Community College District","2015","Not on tenure/no tenure system, assistant professors","51","23","28","0","0","0","3","1","2","2","1","1","7","4","3","1","1","0","36","15","21","2","1","1","0","0","0","0","0","0","-2"
"222992","Austin Community College District","2015","Not on tenure/no tenure system, instructors","2","1","1","0","0","0","0","0","0","0","0","0","0","0","0","0","0","0","2","1","1","0","0","0","0","0","0","0","0","0","-2"
"222992","Austin Community College District","2015","Not on tenure/no tenure system, no academic rank","10","6","4","0","0","0","2","1","1","1","0","1","0","0","0","0","0","0","6","4","2","1","1","0","0","0","0","0","0","0","-2"
"223506","Brazosport College","2015","Tenured total","60","34","26","1","1","0","2","0","2","2","2","0","3","1","2","0","0","0","52","30","22","0","0","0","0","0","0","0","0","0","-2"
"223506","Brazosport College","2015","Tenured, professors","18","12","6","0","0","0","1","0","1","0","0","0","0","0","0","0","0","0","17","12","5","0","0","0","0","0","0","0","0","0","-2"
"223506","Brazosport College","2015","Tenured, associate professors","24","14","10","1","1","0","0","0","0","2","2","0","0","0","0","0","0","0","21","11","10","0","0","0","0","0","0","0","0","0","-2"
"223506","Brazosport College","2015","Tenured, assistant professors","17","8","9","0","0","0","1","0","1","0","0","0","3","1","2","0","0","0","13","7","6","0","0","0","0","0","0","0","0","0","-2"
"223506","Brazosport College","2015","Tenured, instructors","1","0","1","0","0","0","0","0","0","0","0","0","0","0","0","0","0","0","1","0","1","0","0","0","0","0","0","0","0","0","-2"
"223506","Brazosport College","2015","On-Tenure track total","1","0","1","0","0","0","0","0","0","1","0","1","0","0","0","0","0","0","0","0","0","0","0","0","0","0","0","0","0","0","-2"
"223506","Brazosport College","2015","On-tenure track, assistant professors","1","0","1","0","0","0","0","0","0","1","0","1","0","0","0","0","0","0","0","0","0","0","0","0","0","0","0","0","0","0","-2"
"223506","Brazosport College","2015","Not on tenure track/No tenure system system total","34","20","14","1","1","0","1","1","0","2","0","2","4","3","1","0","0","0","26","15","11","0","0","0","0","0","0","0","0","0","-2"
"223506","Brazosport College","2015","Not on tenure/no tenure system, assistant professors","5","3","2","0","0","0","0","0","0","0","0","0","1","1","0","0","0","0","4","2","2","0","0","0","0","0","0","0","0","0","-2"
"223506","Brazosport College","2015","Not on tenure/no tenure system, instructors","29","17","12","1","1","0","1","1","0","2","0","2","3","2","1","0","0","0","22","13","9","0","0","0","0","0","0","0","0","0","-2"
"224004","Concordia University Texas","2015","Tenured total","14","9","5","0","0","0","0","0","0","0","0","0","0","0","0","0","0","0","14","9","5","0","0","0","0","0","0","0","0","0","-2"
"224004","Concordia University Texas","2015","Tenured, professors","9","6","3","0","0","0","0","0","0","0","0","0","0","0","0","0","0","0","9","6","3","0","0","0","0","0","0","0","0","0","-2"
"224004","Concordia University Texas","2015","Tenured, associate professors","5","3","2","0","0","0","0","0","0","0","0","0","0","0","0","0","0","0","5","3","2","0","0","0","0","0","0","0","0","0","-2"
"224004","Concordia University Texas","2015","On-Tenure track total","50","28","22","1","0","1","0","0","0","2","1","1","0","0","0","0","0","0","44","26","18","0","0","0","1","1","0","2","0","2","-2"
"224004","Concordia University Texas","2015","On-tenure track, professors","1","0","1","0","0","0","0","0","0","0","0","0","0","0","0","0","0","0","1","0","1","0","0","0","0","0","0","0","0","0","-2"
"224004","Concordia University Texas","2015","On-tenure track, associate professors","9","5","4","0","0","0","0","0","0","0","0","0","0","0","0","0","0","0","9","5","4","0","0","0","0","0","0","0","0","0","-2"
"224004","Concordia University Texas","2015","On-tenure track, assistant professors","40","23","17","1","0","1","0","0","0","2","1","1","0","0","0","0","0","0","34","21","13","0","0","0","1","1","0","2","0","2","-2"
"224004","Concordia University Texas","2015","Not on tenure track/No tenure system system total","3","3","0","0","0","0","0","0","0","0","0","0","1","1","0","0","0","0","2","2","0","0","0","0","0","0","0","0","0","0","-2"
"224004","Concordia University Texas","2015","Not on tenure/no tenure system, assistant professors","1","1","0","0","0","0","0","0","0","0","0","0","1","1","0","0","0","0","0","0","0","0","0","0","0","0","0","0","0","0","-2"
"224004","Concordia University Texas","2015","Not on tenure/no tenure system, no academic rank","2","2","0","0","0","0","0","0","0","0","0","0","0","0","0","0","0","0","2","2","0","0","0","0","0","0","0","0","0","0","-2"
"224961","Galveston College","2015","Tenured total","24","14","10","1","1","0","1","1","0","3","1","2","3","1","2","0","0","0","16","10","6","0","0","0","0","0","0","0","0","0","-2"
"224961","Galveston College","2015","Tenured, professors","4","3","1","0","0","0","0","0","0","1","1","0","0","0","0","0","0","0","3","2","1","0","0","0","0","0","0","0","0","0","-2"
"224961","Galveston College","2015","Tenured, associate professors","7","4","3","0","0","0","0","0","0","0","0","0","2","1","1","0","0","0","5","3","2","0","0","0","0","0","0","0","0","0","-2"
"224961","Galveston College","2015","Tenured, assistant professors","6","3","3","0","0","0","1","1","0","2","0","2","0","0","0","0","0","0","3","2","1","0","0","0","0","0","0","0","0","0","-2"
"224961","Galveston College","2015","Tenured, instructors","7","4","3","1","1","0","0","0","0","0","0","0","1","0","1","0","0","0","5","3","2","0","0","0","0","0","0","0","0","0","-2"
"224961","Galveston College","2015","On-Tenure track total","26","13","13","0","0","0","1","0","1","3","2","1","2","1","1","0","0","0","20","10","10","0","0","0","0","0","0","0","0","0","-2"
"224961","Galveston College","2015","On-tenure track, associate professors","3","2","1","0","0","0","0","0","0","1","0","1","0","0","0","0","0","0","2","2","0","0","0","0","0","0","0","0","0","0","-2"
"224961","Galveston College","2015","On-tenure track, assistant professors","4","3","1","0","0","0","0","0","0","0","0","0","0","0","0","0","0","0","4","3","1","0","0","0","0","0","0","0","0","0","-2"
"224961","Galveston College","2015","On-tenure track, instructors","19","8","11","0","0","0","1","0","1","2","2","0","2","1","1","0","0","0","14","5","9","0","0","0","0","0","0","0","0","0","-2"
"224961","Galveston College","2015","Not on tenure track/No tenure system system total","6","2","4","0","0","0","0","0","0","1","0","1","1","0","1","0","0","0","4","2","2","0","0","0","0","0","0","0","0","0","-2"
"224961","Galveston College","2015","Not on tenure/no tenure system, instructors","6","2","4","0","0","0","0","0","0","1","0","1","1","0","1","0","0","0","4","2","2","0","0","0","0","0","0","0","0","0","-2"
"225201","Hallmark University","2015","Not on tenure track/No tenure system system total","25","17","8","0","0","0","1","1","0","3","2","1","9","7","2","0","0","0","12","7","5","0","0","0","0","0","0","0","0","0","-2"
"225201","Hallmark University","2015","Not on tenure/no tenure system, instructors","25","17","8","0","0","0","1","1","0","3","2","1","9","7","2","0","0","0","12","7","5","0","0","0","0","0","0","0","0","0","-2"
"225399","Houston Baptist University","2015","Not on tenure track/No tenure system system total","132","71","61","1","1","0","3","3","0","9","2","7","10","7","3","0","0","0","102","53","49","3","3","0","4","2","2","0","0","0","-2"
"225399","Houston Baptist University","2015","Not on tenure/no tenure system, professors","28","17","11","0","0","0","0","0","0","4","1","3","0","0","0","0","0","0","23","15","8","1","1","0","0","0","0","0","0","0","-2"
"225399","Houston Baptist University","2015","Not on tenure/no tenure system, associate professors","29","22","7","0","0","0","1","1","0","1","1","0","6","5","1","0","0","0","20","14","6","0","0","0","1","1","0","0","0","0","-2"
"225399","Houston Baptist University","2015","Not on tenure/no tenure system, assistant professors","71","28","43","1","1","0","2","2","0","4","0","4","4","2","2","0","0","0","56","21","35","1","1","0","3","1","2","0","0","0","-2"
"225399","Houston Baptist University","2015","Not on tenure/no tenure system, instructors","4","4","0","0","0","0","0","0","0","0","0","0","0","0","0","0","0","0","3","3","0","1","1","0","0","0","0","0","0","0","-2"
"225414","University of Houston-Clear Lake","2015","Tenured total","149","92","57","0","0","0","24","17","7","8","4","4","5","1","4","0","0","0","110","68","42","2","2","0","0","0","0","0","0","0","-2"
"225414","University of Houston-Clear Lake","2015","Tenured, professors","51","34","17","0","0","0","11","8","3","1","1","0","2","0","2","0","0","0","37","25","12","0","0","0","0","0","0","0","0","0","-2"
"225414","University of Houston-Clear Lake","2015","Tenured, associate professors","98","58","40","0","0","0","13","9","4","7","3","4","3","1","2","0","0","0","73","43","30","2","2","0","0","0","0","0","0","0","-2"
"225414","University of Houston-Clear Lake","2015","On-Tenure track total","90","40","50","0","0","0","16","8","8","7","2","5","7","1","6","1","0","1","47","24","23","2","0","2","1","0","1","9","5","4","-2"
"225414","University of Houston-Clear Lake","2015","On-tenure track, associate professors","2","2","0","0","0","0","0","0","0","0","0","0","0","0","0","0","0","0","2","2","0","0","0","0","0","0","0","0","0","0","-2"
"225414","University of Houston-Clear Lake","2015","On-tenure track, assistant professors","88","38","50","0","0","0","16","8","8","7","2","5","7","1","6","1","0","1","45","22","23","2","0","2","1","0","1","9","5","4","-2"
"225414","University of Houston-Clear Lake","2015","Not on tenure track/No tenure system system total","49","19","30","0","0","0","5","3","2","2","0","2","4","0","4","0","0","0","34","14","20","1","0","1","0","0","0","3","2","1","-2"
"225414","University of Houston-Clear Lake","2015","Not on tenure/no tenure system, lecturers","32","10","22","0","0","0","1","0","1","1","0","1","3","0","3","0","0","0","25","9","16","1","0","1","0","0","0","1","1","0","-2"
"225414","University of Houston-Clear Lake","2015","Not on tenure/no tenure system, no academic rank","17","9","8","0","0","0","4","3","1","1","0","1","1","0","1","0","0","0","9","5","4","0","0","0","0","0","0","2","1","1","-2"
"225432","University of Houston-Downtown","2015","Tenured total","159","86","73","1","0","1","29","20","9","11","3","8","9","5","4","0","0","0","108","57","51","1","1","0","0","0","0","0","0","0","-2"
"225432","University of Houston-Downtown","2015","Tenured, professors","50","28","22","0","0","0","10","7","3","5","2","3","2","2","0","0","0","0","33","17","16","0","0","0","0","0","0","0","0","0","-2"
"225432","University of Houston-Downtown","2015","Tenured, associate professors","109","58","51","1","0","1","19","13","6","6","1","5","7","3","4","0","0","0","75","40","35","1","1","0","0","0","0","0","0","0","-2"
"225432","University of Houston-Downtown","2015","On-Tenure track total","73","39","34","0","0","0","11","7","4","12","3","9","8","5","3","0","0","0","38","21","17","0","0","0","0","0","0","4","3","1","-2"
"225432","University of Houston-Downtown","2015","On-tenure track, associate professors","4","2","2","0","0","0","1","1","0","0","0","0","1","0","1","0","0","0","2","1","1","0","0","0","0","0","0","0","0","0","-2"
"225432","University of Houston-Downtown","2015","On-tenure track, assistant professors","64","33","31","0","0","0","9","5","4","12","3","9","6","5","1","0","0","0","33","17","16","0","0","0","0","0","0","4","3","1","-2"
"225432","University of Houston-Downtown","2015","On-tenure track, instructors","5","4","1","0","0","0","1","1","0","0","0","0","1","0","1","0","0","0","3","3","0","0","0","0","0","0","0","0","0","0","-2"
"225432","University of Houston-Downtown","2015","Not on tenure track/No tenure system system total","109","50","59","0","0","0","17","9","8","9","5","4","7","4","3","1","0","1","69","27","42","4","3","1","0","0","0","2","2","0","-2"
"225432","University of Houston-Downtown","2015","Not on tenure/no tenure system, instructors","2","0","2","0","0","0","0","0","0","1","0","1","0","0","0","0","0","0","1","0","1","0","0","0","0","0","0","0","0","0","-2"
"225432","University of Houston-Downtown","2015","Not on tenure/no tenure system, lecturers","99","44","55","0","0","0","16","9","7","7","4","3","7","4","3","1","0","1","62","22","40","4","3","1","0","0","0","2","2","0","-2"
"225432","University of Houston-Downtown","2015","Not on tenure/no tenure system, no academic rank","8","6","2","0","0","0","1","0","1","1","1","0","0","0","0","0","0","0","6","5","1","0","0","0","0","0","0","0","0","0","-2"
"225502","University of Houston-Victoria","2015","Tenured total","47","29","18","0","0","0","15","12","3","0","0","0","6","3","3","1","1","0","23","12","11","0","0","0","0","0","0","2","1","1","-2"
"225502","University of Houston-Victoria","2015","Tenured, professors","20","14","6","0","0","0","6","4","2","0","0","0","2","1","1","1","1","0","11","8","3","0","0","0","0","0","0","0","0","0","-2"
"225502","University of Houston-Victoria","2015","Tenured, associate professors","27","15","12","0","0","0","9","8","1","0","0","0","4","2","2","0","0","0","12","4","8","0","0","0","0","0","0","2","1","1","-2"
"225502","University of Houston-Victoria","2015","On-Tenure track total","34","19","15","0","0","0","3","2","1","1","1","0","3","1","2","0","0","0","15","9","6","0","0","0","0","0","0","12","6","6","-2"
"225502","University of Houston-Victoria","2015","On-tenure track, assistant professors","34","19","15","0","0","0","3","2","1","1","1","0","3","1","2","0","0","0","15","9","6","0","0","0","0","0","0","12","6","6","-2"
"225502","University of Houston-Victoria","2015","Not on tenure track/No tenure system system total","25","11","14","0","0","0","2","2","0","0","0","0","5","2","3","0","0","0","13","5","8","1","0","1","0","0","0","4","2","2","-2"
"225502","University of Houston-Victoria","2015","Not on tenure/no tenure system, instructors","6","3","3","0","0","0","1","1","0","0","0","0","2","1","1","0","0","0","2","1","1","0","0","0","0","0","0","1","0","1","-2"
"225502","University of Houston-Victoria","2015","Not on tenure/no tenure system, lecturers","10","7","3","0","0","0","1","1","0","0","0","0","2","1","1","0","0","0","4","3","1","0","0","0","0","0","0","3","2","1","-2"
"225502","University of Houston-Victoria","2015","Not on tenure/no tenure system, no academic rank","9","1","8","0","0","0","0","0","0","0","0","0","1","0","1","0","0","0","7","1","6","1","0","1","0","0","0","0","0","0","-2"
"225548","Howard Payne University","2015","Tenured total","3","2","1","0","0","0","0","0","0","0","0","0","0","0","0","0","0","0","3","2","1","0","0","0","0","0","0","0","0","0","-2"
"225548","Howard Payne University","2015","Tenured, professors","3","2","1","0","0","0","0","0","0","0","0","0","0","0","0","0","0","0","3","2","1","0","0","0","0","0","0","0","0","0","-2"
"225548","Howard Payne University","2015","Not on tenure track/No tenure system system total","78","49","29","0","0","0","0","0","0","1","1","0","5","4","1","0","0","0","72","44","28","0","0","0","0","0","0","0","0","0","-2"
"225548","Howard Payne University","2015","Not on tenure/no tenure system, professors","23","16","7","0","0","0","0","0","0","0","0","0","1","0","1","0","0","0","22","16","6","0","0","0","0","0","0","0","0","0","-2"
"225548","Howard Payne University","2015","Not on tenure/no tenure system, associate professors","23","15","8","0","0","0","0","0","0","0","0","0","3","3","0","0","0","0","20","12","8","0","0","0","0","0","0","0","0","0","-2"
"225548","Howard Payne University","2015","Not on tenure/no tenure system, assistant professors","21","13","8","0","0","0","0","0","0","1","1","0","0","0","0","0","0","0","20","12","8","0","0","0","0","0","0","0","0","0","-2"
"225548","Howard Payne University","2015","Not on tenure/no tenure system, instructors","11","5","6","0","0","0","0","0","0","0","0","0","1","1","0","0","0","0","10","4","6","0","0","0","0","0","0","0","0","0","-2"
"225575","Huston-Tillotson University","2015","Tenured total","8","3","5","0","0","0","0","0","0","4","1","3","0","0","0","0","0","0","4","2","2","0","0","0","0","0","0","0","0","0","-2"
"225575","Huston-Tillotson University","2015","Tenured, professors","7","2","5","0","0","0","0","0","0","4","1","3","0","0","0","0","0","0","3","1","2","0","0","0","0","0","0","0","0","0","-2"
"225575","Huston-Tillotson University","2015","Tenured, associate professors","1","1","0","0","0","0","0","0","0","0","0","0","0","0","0","0","0","0","1","1","0","0","0","0","0","0","0","0","0","0","-2"
"225575","Huston-Tillotson University","2015","On-Tenure track total","32","15","17","0","0","0","3","1","2","13","3","10","5","4","1","0","0","0","9","6","3","0","0","0","0","0","0","2","1","1","-2"
"225575","Huston-Tillotson University","2015","On-tenure track, professors","3","3","0","0","0","0","0","0","0","0","0","0","1","1","0","0","0","0","2","2","0","0","0","0","0","0","0","0","0","0","-2"
"225575","Huston-Tillotson University","2015","On-tenure track, associate professors","8","1","7","0","0","0","0","0","0","5","1","4","1","0","1","0","0","0","2","0","2","0","0","0","0","0","0","0","0","0","-2"
"225575","Huston-Tillotson University","2015","On-tenure track, assistant professors","20","11","9","0","0","0","3","1","2","7","2","5","3","3","0","0","0","0","5","4","1","0","0","0","0","0","0","2","1","1","-2"
"225575","Huston-Tillotson University","2015","On-tenure track, instructors","1","0","1","0","0","0","0","0","0","1","0","1","0","0","0","0","0","0","0","0","0","0","0","0","0","0","0","0","0","0","-2"
"225575","Huston-Tillotson University","2015","Not on tenure track/No tenure system system total","10","5","5","0","0","0","0","0","0","5","2","3","1","1","0","0","0","0","4","2","2","0","0","0","0","0","0","0","0","0","-2"
"225575","Huston-Tillotson University","2015","Not on tenure/no tenure system, professors","1","1","0","0","0","0","0","0","0","0","0","0","0","0","0","0","0","0","1","1","0","0","0","0","0","0","0","0","0","0","-2"
"225575","Huston-Tillotson University","2015","Not on tenure/no tenure system, associate professors","1","0","1","0","0","0","0","0","0","0","0","0","0","0","0","0","0","0","1","0","1","0","0","0","0","0","0","0","0","0","-2"
"225575","Huston-Tillotson University","2015","Not on tenure/no tenure system, instructors","5","3","2","0","0","0","0","0","0","4","2","2","0","0","0","0","0","0","1","1","0","0","0","0","0","0","0","0","0","0","-2"
"225575","Huston-Tillotson University","2015","Not on tenure/no tenure system, lecturers","3","1","2","0","0","0","0","0","0","1","0","1","1","1","0","0","0","0","1","0","1","0","0","0","0","0","0","0","0","0","-2"
"226134","Laredo College","2015","Tenured total","123","68","55","1","0","1","3","1","2","2","1","1","95","52","43","0","0","0","21","13","8","0","0","0","1","1","0","0","0","0","-2"
"226134","Laredo College","2015","Tenured, instructors","123","68","55","1","0","1","3","1","2","2","1","1","95","52","43","0","0","0","21","13","8","0","0","0","1","1","0","0","0","0","-2"
"226134","Laredo College","2015","On-Tenure track total","43","26","17","0","0","0","5","4","1","0","0","0","31","18","13","0","0","0","7","4","3","0","0","0","0","0","0","0","0","0","-2"
"226134","Laredo College","2015","On-tenure track, instructors","43","26","17","0","0","0","5","4","1","0","0","0","31","18","13","0","0","0","7","4","3","0","0","0","0","0","0","0","0","0","-2"
"226134","Laredo College","2015","Not on tenure track/No tenure system system total","11","6","5","0","0","0","0","0","0","0","0","0","11","6","5","0","0","0","0","0","0","0","0","0","0","0","0","0","0","0","-2"
"226134","Laredo College","2015","Not on tenure/no tenure system, instructors","11","6","5","0","0","0","0","0","0","0","0","0","11","6","5","0","0","0","0","0","0","0","0","0","0","0","0","0","0","0","-2"
"226152","Texas A & M International University","2015","Tenured total","73","51","22","0","0","0","15","11","4","1","1","0","23","18","5","0","0","0","31","19","12","0","0","0","0","0","0","3","2","1","-2"
"226152","Texas A & M International University","2015","Tenured, professors","22","20","2","0","0","0","4","4","0","1","1","0","9","9","0","0","0","0","7","5","2","0","0","0","0","0","0","1","1","0","-2"
"226152","Texas A & M International University","2015","Tenured, associate professors","48","30","18","0","0","0","11","7","4","0","0","0","14","9","5","0","0","0","22","13","9","0","0","0","0","0","0","1","1","0","-2"
"226152","Texas A & M International University","2015","Tenured, assistant professors","3","1","2","0","0","0","0","0","0","0","0","0","0","0","0","0","0","0","2","1","1","0","0","0","0","0","0","1","0","1","-2"
"226152","Texas A & M International University","2015","On-Tenure track total","59","31","28","0","0","0","12","6","6","2","1","1","11","4","7","0","0","0","26","14","12","0","0","0","1","1","0","7","5","2","-2"
"226152","Texas A & M International University","2015","On-tenure track, associate professors","5","2","3","0","0","0","3","2","1","0","0","0","1","0","1","0","0","0","1","0","1","0","0","0","0","0","0","0","0","0","-2"
"226152","Texas A & M International University","2015","On-tenure track, assistant professors","54","29","25","0","0","0","9","4","5","2","1","1","10","4","6","0","0","0","25","14","11","0","0","0","1","1","0","7","5","2","-2"
"226152","Texas A & M International University","2015","Not on tenure track/No tenure system system total","77","30","47","0","0","0","5","1","4","4","1","3","43","15","28","0","0","0","21","9","12","0","0","0","0","0","0","4","4","0","-2"
"226152","Texas A & M International University","2015","Not on tenure/no tenure system, professors","1","1","0","0","0","0","0","0","0","0","0","0","0","0","0","0","0","0","0","0","0","0","0","0","0","0","0","1","1","0","-2"
"226152","Texas A & M International University","2015","Not on tenure/no tenure system, associate professors","5","2","3","0","0","0","1","0","1","0","0","0","2","1","1","0","0","0","2","1","1","0","0","0","0","0","0","0","0","0","-2"
"226152","Texas A & M International University","2015","Not on tenure/no tenure system, assistant professors","33","10","23","0","0","0","3","0","3","1","1","0","17","3","14","0","0","0","11","5","6","0","0","0","0","0","0","1","1","0","-2"
"226152","Texas A & M International University","2015","Not on tenure/no tenure system, instructors","32","14","18","0","0","0","0","0","0","2","0","2","21","10","11","0","0","0","7","2","5","0","0","0","0","0","0","2","2","0","-2"
"226152","Texas A & M International University","2015","Not on tenure/no tenure system, lecturers","6","3","3","0","0","0","1","1","0","1","0","1","3","1","2","0","0","0","1","1","0","0","0","0","0","0","0","0","0","0","-2"
"226587","McMurry University","2015","Tenured total","47","32","15","1","1","0","1","0","1","0","0","0","3","1","2","0","0","0","42","30","12","0","0","0","0","0","0","0","0","0","-2"
"226587","McMurry University","2015","Tenured, professors","27","18","9","1","1","0","0","0","0","0","0","0","0","0","0","0","0","0","26","17","9","0","0","0","0","0","0","0","0","0","-2"
"226587","McMurry University","2015","Tenured, associate professors","19","14","5","0","0","0","1","0","1","0","0","0","3","1","2","0","0","0","15","13","2","0","0","0","0","0","0","0","0","0","-2"
"226587","McMurry University","2015","Tenured, assistant professors","1","0","1","0","0","0","0","0","0","0","0","0","0","0","0","0","0","0","1","0","1","0","0","0","0","0","0","0","0","0","-2"
"226587","McMurry University","2015","On-Tenure track total","11","3","8","0","0","0","0","0","0","1","1","0","1","0","1","0","0","0","9","2","7","0","0","0","0","0","0","0","0","0","-2"
"226587","McMurry University","2015","On-tenure track, associate professors","1","0","1","0","0","0","0","0","0","0","0","0","0","0","0","0","0","0","1","0","1","0","0","0","0","0","0","0","0","0","-2"
"226587","McMurry University","2015","On-tenure track, assistant professors","10","3","7","0","0","0","0","0","0","1","1","0","1","0","1","0","0","0","8","2","6","0","0","0","0","0","0","0","0","0","-2"
"226587","McMurry University","2015","Not on tenure track/No tenure system system total","20","9","11","0","0","0","0","0","0","0","0","0","0","0","0","0","0","0","20","9","11","0","0","0","0","0","0","0","0","0","-2"
"226587","McMurry University","2015","Not on tenure/no tenure system, assistant professors","4","4","0","0","0","0","0","0","0","0","0","0","0","0","0","0","0","0","4","4","0","0","0","0","0","0","0","0","0","0","-2"
"226587","McMurry University","2015","Not on tenure/no tenure system, instructors","16","5","11","0","0","0","0","0","0","0","0","0","0","0","0","0","0","0","16","5","11","0","0","0","0","0","0","0","0","0","-2"
"226806","Midland College","2015","Not on tenure track/No tenure system system total","126","57","69","0","0","0","1","1","0","4","1","3","17","9","8","0","0","0","103","46","57","0","0","0","1","0","1","0","0","0","-2"
"226806","Midland College","2015","Not on tenure/no tenure system, professors","43","20","23","0","0","0","0","0","0","1","1","0","4","2","2","0","0","0","38","17","21","0","0","0","0","0","0","0","0","0","-2"
"226806","Midland College","2015","Not on tenure/no tenure system, associate professors","44","15","29","0","0","0","1","1","0","1","0","1","10","5","5","0","0","0","31","9","22","0","0","0","1","0","1","0","0","0","-2"
"226806","Midland College","2015","Not on tenure/no tenure system, assistant professors","11","9","2","0","0","0","0","0","0","0","0","0","1","1","0","0","0","0","10","8","2","0","0","0","0","0","0","0","0","0","-2"
"226806","Midland College","2015","Not on tenure/no tenure system, instructors","28","13","15","0","0","0","0","0","0","2","0","2","2","1","1","0","0","0","24","12","12","0","0","0","0","0","0","0","0","0","-2"
"227216","University of North Texas","2015","Tenured total","606","411","195","1","1","0","91","65","26","21","10","11","34","22","12","0","0","0","425","291","134","4","3","1","16","12","4","14","7","7","-2"
"227216","University of North Texas","2015","Tenured, professors","299","224","75","1","1","0","32","29","3","9","5","4","16","9","7","0","0","0","227","168","59","2","2","0","10","8","2","2","2","0","-2"
"227216","University of North Texas","2015","Tenured, associate professors","306","186","120","0","0","0","59","36","23","12","5","7","18","13","5","0","0","0","197","122","75","2","1","1","6","4","2","12","5","7","-2"
"227216","University of North Texas","2015","Tenured, assistant professors","1","1","0","0","0","0","0","0","0","0","0","0","0","0","0","0","0","0","1","1","0","0","0","0","0","0","0","0","0","0","-2"
"227216","University of North Texas","2015","On-Tenure track total","119","56","63","1","0","1","19","11","8","13","4","9","11","4","7","0","0","0","69","35","34","2","1","1","1","0","1","3","1","2","-2"
"227216","University of North Texas","2015","On-tenure track, associate professors","3","3","0","0","0","0","1","1","0","0","0","0","0","0","0","0","0","0","2","2","0","0","0","0","0","0","0","0","0","0","-2"
"227216","University of North Texas","2015","On-tenure track, assistant professors","116","53","63","1","0","1","18","10","8","13","4","9","11","4","7","0","0","0","67","33","34","2","1","1","1","0","1","3","1","2","-2"
"227216","University of North Texas","2015","Not on tenure track/No tenure system system total","340","129","211","3","0","3","18","4","14","16","6","10","25","9","16","0","0","0","259","103","156","6","0","6","9","5","4","4","2","2","-2"
"227216","University of North Texas","2015","Not on tenure/no tenure system, professors","1","0","1","0","0","0","0","0","0","0","0","0","0","0","0","0","0","0","1","0","1","0","0","0","0","0","0","0","0","0","-2"
"227216","University of North Texas","2015","Not on tenure/no tenure system, associate professors","1","0","1","0","0","0","0","0","0","0","0","0","0","0","0","0","0","0","1","0","1","0","0","0","0","0","0","0","0","0","-2"
"227216","University of North Texas","2015","Not on tenure/no tenure system, assistant professors","1","1","0","0","0","0","0","0","0","0","0","0","0","0","0","0","0","0","1","1","0","0","0","0","0","0","0","0","0","0","-2"
"227216","University of North Texas","2015","Not on tenure/no tenure system, instructors","93","36","57","2","0","2","1","1","0","2","0","2","10","4","6","0","0","0","69","27","42","1","0","1","5","3","2","3","1","2","-2"
"227216","University of North Texas","2015","Not on tenure/no tenure system, lecturers","233","90","143","1","0","1","17","3","14","14","6","8","15","5","10","0","0","0","176","73","103","5","0","5","4","2","2","1","1","0","-2"
"227216","University of North Texas","2015","Not on tenure/no tenure system, no academic rank","11","2","9","0","0","0","0","0","0","0","0","0","0","0","0","0","0","0","11","2","9","0","0","0","0","0","0","0","0","0","-2"
"227331","Our Lady of the Lake University","2015","Tenured total","37","14","23","0","0","0","1","1","0","2","1","1","10","4","6","0","0","0","24","8","16","0","0","0","0","0","0","0","0","0","-2"
"227331","Our Lady of the Lake University","2015","Tenured, professors","19","7","12","0","0","0","1","1","0","1","0","1","5","1","4","0","0","0","12","5","7","0","0","0","0","0","0","0","0","0","-2"
"227331","Our Lady of the Lake University","2015","Tenured, associate professors","18","7","11","0","0","0","0","0","0","1","1","0","5","3","2","0","0","0","12","3","9","0","0","0","0","0","0","0","0","0","-2"
"227331","Our Lady of the Lake University","2015","On-Tenure track total","35","11","24","0","0","0","4","1","3","1","0","1","11","4","7","0","0","0","19","6","13","0","0","0","0","0","0","0","0","0","-2"
"227331","Our Lady of the Lake University","2015","On-tenure track, associate professors","3","2","1","0","0","0","0","0","0","0","0","0","1","0","1","0","0","0","2","2","0","0","0","0","0","0","0","0","0","0","-2"
"227331","Our Lady of the Lake University","2015","On-tenure track, assistant professors","32","9","23","0","0","0","4","1","3","1","0","1","10","4","6","0","0","0","17","4","13","0","0","0","0","0","0","0","0","0","-2"
"227331","Our Lady of the Lake University","2015","Not on tenure track/No tenure system system total","28","10","18","0","0","0","1","0","1","0","0","0","14","4","10","0","0","0","13","6","7","0","0","0","0","0","0","0","0","0","-2"
"227331","Our Lady of the Lake University","2015","Not on tenure/no tenure system, professors","2","0","2","0","0","0","0","0","0","0","0","0","1","0","1","0","0","0","1","0","1","0","0","0","0","0","0","0","0","0","-2"
"227331","Our Lady of the Lake University","2015","Not on tenure/no tenure system, associate professors","3","1","2","0","0","0","0","0","0","0","0","0","1","0","1","0","0","0","2","1","1","0","0","0","0","0","0","0","0","0","-2"
"227331","Our Lady of the Lake University","2015","Not on tenure/no tenure system, assistant professors","22","8","14","0","0","0","1","0","1","0","0","0","12","4","8","0","0","0","9","4","5","0","0","0","0","0","0","0","0","0","-2"
"227331","Our Lady of the Lake University","2015","Not on tenure/no tenure system, instructors","1","1","0","0","0","0","0","0","0","0","0","0","0","0","0","0","0","0","1","1","0","0","0","0","0","0","0","0","0","0","-2"
"227368","The University of Texas Rio Grande Valley","2015","Tenured total","445","305","140","1","1","0","79","58","21","12","11","1","104","55","49","0","0","0","214","155","59","15","13","2","18","11","7","2","1","1","-2"
"227368","The University of Texas Rio Grande Valley","2015","Tenured, professors","145","108","37","1","1","0","24","21","3","3","3","0","27","14","13","0","0","0","75","56","19","9","7","2","6","6","0","0","0","0","-2"
"227368","The University of Texas Rio Grande Valley","2015","Tenured, associate professors","300","197","103","0","0","0","55","37","18","9","8","1","77","41","36","0","0","0","139","99","40","6","6","0","12","5","7","2","1","1","-2"
"227368","The University of Texas Rio Grande Valley","2015","On-Tenure track total","191","117","74","1","1","0","34","24","10","11","8","3","51","26","25","0","0","0","86","52","34","2","1","1","4","3","1","2","2","0","-2"
"227368","The University of Texas Rio Grande Valley","2015","On-tenure track, assistant professors","191","117","74","1","1","0","34","24","10","11","8","3","51","26","25","0","0","0","86","52","34","2","1","1","4","3","1","2","2","0","-2"
"227368","The University of Texas Rio Grande Valley","2015","Not on tenure track/No tenure system system total","454","221","233","1","0","1","42","18","24","3","0","3","191","98","93","0","0","0","129","62","67","8","2","6","63","32","31","17","9","8","-2"
"227368","The University of Texas Rio Grande Valley","2015","Not on tenure/no tenure system, professors","9","7","2","0","0","0","0","0","0","0","0","0","1","1","0","0","0","0","2","2","0","0","0","0","6","4","2","0","0","0","-2"
"227368","The University of Texas Rio Grande Valley","2015","Not on tenure/no tenure system, associate professors","1","1","0","0","0","0","0","0","0","0","0","0","0","0","0","0","0","0","0","0","0","0","0","0","1","1","0","0","0","0","-2"
"227368","The University of Texas Rio Grande Valley","2015","Not on tenure/no tenure system, assistant professors","4","2","2","0","0","0","0","0","0","0","0","0","2","1","1","0","0","0","0","0","0","0","0","0","1","1","0","1","0","1","-2"
"227368","The University of Texas Rio Grande Valley","2015","Not on tenure/no tenure system, lecturers","440","211","229","1","0","1","42","18","24","3","0","3","188","96","92","0","0","0","127","60","67","8","2","6","55","26","29","16","9","7","-2"
"227845","Saint Edward's University","2015","Tenured total","71","35","36","0","0","0","1","1","0","1","0","1","4","1","3","0","0","0","65","33","32","0","0","0","0","0","0","0","0","0","-2"
"227845","Saint Edward's University","2015","Tenured, professors","30","16","14","0","0","0","0","0","0","1","0","1","1","0","1","0","0","0","28","16","12","0","0","0","0","0","0","0","0","0","-2"
"227845","Saint Edward's University","2015","Tenured, associate professors","41","19","22","0","0","0","1","1","0","0","0","0","3","1","2","0","0","0","37","17","20","0","0","0","0","0","0","0","0","0","-2"
"227845","Saint Edward's University","2015","On-Tenure track total","88","41","47","0","0","0","3","3","0","2","0","2","8","2","6","0","0","0","68","33","35","2","1","1","3","2","1","2","0","2","-2"
"227845","Saint Edward's University","2015","On-tenure track, professors","1","0","1","0","0","0","0","0","0","0","0","0","0","0","0","0","0","0","1","0","1","0","0","0","0","0","0","0","0","0","-2"
"227845","Saint Edward's University","2015","On-tenure track, associate professors","37","21","16","0","0","0","1","1","0","1","0","1","3","1","2","0","0","0","31","19","12","0","0","0","1","0","1","0","0","0","-2"
"227845","Saint Edward's University","2015","On-tenure track, assistant professors","50","20","30","0","0","0","2","2","0","1","0","1","5","1","4","0","0","0","36","14","22","2","1","1","2","2","0","2","0","2","-2"
"227845","Saint Edward's University","2015","Not on tenure track/No tenure system system total","32","13","19","0","0","0","1","1","0","0","0","0","4","3","1","0","0","0","27","9","18","0","0","0","0","0","0","0","0","0","-2"
"227845","Saint Edward's University","2015","Not on tenure/no tenure system, assistant professors","28","11","17","0","0","0","1","1","0","0","0","0","3","2","1","0","0","0","24","8","16","0","0","0","0","0","0","0","0","0","-2"
"227845","Saint Edward's University","2015","Not on tenure/no tenure system, instructors","4","2","2","0","0","0","0","0","0","0","0","0","1","1","0","0","0","0","3","1","2","0","0","0","0","0","0","0","0","0","-2"
"227863","University of St Thomas","2015","Tenured total","79","49","30","0","0","0","4","2","2","2","2","0","7","3","4","0","0","0","63","39","24","3","3","0","0","0","0","0","0","0","-2"
"227863","University of St Thomas","2015","Tenured, professors","36","22","14","0","0","0","2","1","1","0","0","0","2","1","1","0","0","0","32","20","12","0","0","0","0","0","0","0","0","0","-2"
"227863","University of St Thomas","2015","Tenured, associate professors","42","26","16","0","0","0","2","1","1","2","2","0","4","1","3","0","0","0","31","19","12","3","3","0","0","0","0","0","0","0","-2"
"227863","University of St Thomas","2015","Tenured, assistant professors","1","1","0","0","0","0","0","0","0","0","0","0","1","1","0","0","0","0","0","0","0","0","0","0","0","0","0","0","0","0","-2"
"227863","University of St Thomas","2015","On-Tenure track total","42","21","21","0","0","0","6","4","2","2","1","1","9","6","3","0","0","0","18","9","9","0","0","0","0","0","0","7","1","6","-2"
"227863","University of St Thomas","2015","On-tenure track, professors","1","1","0","0","0","0","0","0","0","0","0","0","0","0","0","0","0","0","0","0","0","0","0","0","0","0","0","1","1","0","-2"
"227863","University of St Thomas","2015","On-tenure track, associate professors","4","3","1","0","0","0","0","0","0","0","0","0","2","2","0","0","0","0","2","1","1","0","0","0","0","0","0","0","0","0","-2"
"227863","University of St Thomas","2015","On-tenure track, assistant professors","37","17","20","0","0","0","6","4","2","2","1","1","7","4","3","0","0","0","16","8","8","0","0","0","0","0","0","6","0","6","-2"
"227863","University of St Thomas","2015","Not on tenure track/No tenure system system total","70","31","39","0","0","0","7","3","4","16","4","12","6","3","3","0","0","0","39","21","18","1","0","1","0","0","0","1","0","1","-2"
"227863","University of St Thomas","2015","Not on tenure/no tenure system, professors","9","4","5","0","0","0","0","0","0","2","0","2","1","1","0","0","0","0","6","3","3","0","0","0","0","0","0","0","0","0","-2"
"227863","University of St Thomas","2015","Not on tenure/no tenure system, associate professors","3","2","1","0","0","0","1","1","0","0","0","0","0","0","0","0","0","0","2","1","1","0","0","0","0","0","0","0","0","0","-2"
"227863","University of St Thomas","2015","Not on tenure/no tenure system, assistant professors","46","18","28","0","0","0","5","2","3","12","3","9","5","2","3","0","0","0","22","11","11","1","0","1","0","0","0","1","0","1","-2"
"227863","University of St Thomas","2015","Not on tenure/no tenure system, instructors","12","7","5","0","0","0","1","0","1","2","1","1","0","0","0","0","0","0","9","6","3","0","0","0","0","0","0","0","0","0","-2"
"228042","Schreiner University","2015","Tenured total","21","13","8","0","0","0","0","0","0","0","0","0","0","0","0","0","0","0","21","13","8","0","0","0","0","0","0","0","0","0","-2"
"228042","Schreiner University","2015","Tenured, professors","14","8","6","0","0","0","0","0","0","0","0","0","0","0","0","0","0","0","14","8","6","0","0","0","0","0","0","0","0","0","-2"
"228042","Schreiner University","2015","Tenured, associate professors","7","5","2","0","0","0","0","0","0","0","0","0","0","0","0","0","0","0","7","5","2","0","0","0","0","0","0","0","0","0","-2"
"228042","Schreiner University","2015","On-Tenure track total","21","10","11","0","0","0","1","0","1","0","0","0","2","2","0","0","0","0","18","8","10","0","0","0","0","0","0","0","0","0","-2"
"228042","Schreiner University","2015","On-tenure track, assistant professors","21","10","11","0","0","0","1","0","1","0","0","0","2","2","0","0","0","0","18","8","10","0","0","0","0","0","0","0","0","0","-2"
"228042","Schreiner University","2015","Not on tenure track/No tenure system system total","17","7","10","0","0","0","1","0","1","1","1","0","2","1","1","0","0","0","13","5","8","0","0","0","0","0","0","0","0","0","-2"
"228042","Schreiner University","2015","Not on tenure/no tenure system, assistant professors","6","5","1","0","0","0","0","0","0","0","0","0","1","1","0","0","0","0","5","4","1","0","0","0","0","0","0","0","0","0","-2"
"228042","Schreiner University","2015","Not on tenure/no tenure system, instructors","11","2","9","0","0","0","1","0","1","1","1","0","1","0","1","0","0","0","8","1","7","0","0","0","0","0","0","0","0","0","-2"
"228149","St. Mary's University","2015","Tenured total","134","90","44","1","1","0","10","9","1","3","2","1","17","12","5","2","2","0","100","63","37","0","0","0","0","0","0","1","1","0","-2"
"228149","St. Mary's University","2015","Tenured, professors","81","58","23","0","0","0","7","7","0","2","2","0","9","5","4","1","1","0","62","43","19","0","0","0","0","0","0","0","0","0","-2"
"228149","St. Mary's University","2015","Tenured, associate professors","50","29","21","1","1","0","3","2","1","1","0","1","8","7","1","1","1","0","35","17","18","0","0","0","0","0","0","1","1","0","-2"
"228149","St. Mary's University","2015","Tenured, assistant professors","3","3","0","0","0","0","0","0","0","0","0","0","0","0","0","0","0","0","3","3","0","0","0","0","0","0","0","0","0","0","-2"
"228149","St. Mary's University","2015","On-Tenure track total","27","17","10","0","0","0","2","2","0","1","1","0","3","3","0","0","0","0","18","8","10","0","0","0","0","0","0","3","3","0","-2"
"228149","St. Mary's University","2015","On-tenure track, associate professors","2","0","2","0","0","0","0","0","0","0","0","0","0","0","0","0","0","0","2","0","2","0","0","0","0","0","0","0","0","0","-2"
"228149","St. Mary's University","2015","On-tenure track, assistant professors","25","17","8","0","0","0","2","2","0","1","1","0","3","3","0","0","0","0","16","8","8","0","0","0","0","0","0","3","3","0","-2"
"228149","St. Mary's University","2015","Not on tenure track/No tenure system system total","42","23","19","0","0","0","1","0","1","0","0","0","10","4","6","0","0","0","31","19","12","0","0","0","0","0","0","0","0","0","-2"
"228149","St. Mary's University","2015","Not on tenure/no tenure system, professors","8","1","7","0","0","0","0","0","0","0","0","0","1","0","1","0","0","0","7","1","6","0","0","0","0","0","0","0","0","0","-2"
"228149","St. Mary's University","2015","Not on tenure/no tenure system, associate professors","2","2","0","0","0","0","0","0","0","0","0","0","0","0","0","0","0","0","2","2","0","0","0","0","0","0","0","0","0","0","-2"
"228149","St. Mary's University","2015","Not on tenure/no tenure system, assistant professors","15","11","4","0","0","0","0","0","0","0","0","0","2","1","1","0","0","0","13","10","3","0","0","0","0","0","0","0","0","0","-2"
"228149","St. Mary's University","2015","Not on tenure/no tenure system, instructors","10","6","4","0","0","0","1","0","1","0","0","0","4","2","2","0","0","0","5","4","1","0","0","0","0","0","0","0","0","0","-2"
"228149","St. Mary's University","2015","Not on tenure/no tenure system, lecturers","7","3","4","0","0","0","0","0","0","0","0","0","3","1","2","0","0","0","4","2","2","0","0","0","0","0","0","0","0","0","-2"
"228468","Southwestern Adventist University","2015","Not on tenure track/No tenure system system total","49","33","16","0","0","0","2","1","1","5","5","0","5","4","1","1","0","1","34","21","13","0","0","0","0","0","0","2","2","0","-2"
"228468","Southwestern Adventist University","2015","Not on tenure/no tenure system, professors","19","17","2","0","0","0","0","0","0","3","3","0","1","1","0","0","0","0","15","13","2","0","0","0","0","0","0","0","0","0","-2"
"228468","Southwestern Adventist University","2015","Not on tenure/no tenure system, associate professors","12","10","2","0","0","0","1","1","0","2","2","0","1","1","0","0","0","0","7","5","2","0","0","0","0","0","0","1","1","0","-2"
"228468","Southwestern Adventist University","2015","Not on tenure/no tenure system, assistant professors","17","6","11","0","0","0","1","0","1","0","0","0","3","2","1","1","0","1","11","3","8","0","0","0","0","0","0","1","1","0","-2"
"228468","Southwestern Adventist University","2015","Not on tenure/no tenure system, instructors","1","0","1","0","0","0","0","0","0","0","0","0","0","0","0","0","0","0","1","0","1","0","0","0","0","0","0","0","0","0","-2"
"228501","Sul Ross State University","2015","Tenured total","57","38","19","1","1","0","1","1","0","1","1","0","10","7","3","0","0","0","43","28","15","1","0","1","0","0","0","0","0","0","-2"
"228501","Sul Ross State University","2015","Tenured, professors","41","28","13","0","0","0","1","1","0","1","1","0","5","3","2","0","0","0","33","23","10","1","0","1","0","0","0","0","0","0","-2"
"228501","Sul Ross State University","2015","Tenured, associate professors","13","7","6","1","1","0","0","0","0","0","0","0","3","2","1","0","0","0","9","4","5","0","0","0","0","0","0","0","0","0","-2"
"228501","Sul Ross State University","2015","Tenured, assistant professors","3","3","0","0","0","0","0","0","0","0","0","0","2","2","0","0","0","0","1","1","0","0","0","0","0","0","0","0","0","0","-2"
"228501","Sul Ross State University","2015","On-Tenure track total","35","19","16","0","0","0","1","1","0","0","0","0","8","2","6","0","0","0","23","13","10","0","0","0","0","0","0","3","3","0","-2"
"228501","Sul Ross State University","2015","On-tenure track, associate professors","3","2","1","0","0","0","0","0","0","0","0","0","1","1","0","0","0","0","2","1","1","0","0","0","0","0","0","0","0","0","-2"
"228501","Sul Ross State University","2015","On-tenure track, assistant professors","30","16","14","0","0","0","1","1","0","0","0","0","6","1","5","0","0","0","21","12","9","0","0","0","0","0","0","2","2","0","-2"
"228501","Sul Ross State University","2015","On-tenure track, instructors","2","1","1","0","0","0","0","0","0","0","0","0","1","0","1","0","0","0","0","0","0","0","0","0","0","0","0","1","1","0","-2"
"228501","Sul Ross State University","2015","Not on tenure track/No tenure system system total","30","16","14","0","0","0","0","0","0","1","1","0","8","4","4","0","0","0","18","10","8","1","0","1","0","0","0","2","1","1","-2"
"228501","Sul Ross State University","2015","Not on tenure/no tenure system, professors","1","1","0","0","0","0","0","0","0","0","0","0","0","0","0","0","0","0","1","1","0","0","0","0","0","0","0","0","0","0","-2"
"228501","Sul Ross State University","2015","Not on tenure/no tenure system, assistant professors","1","1","0","0","0","0","0","0","0","0","0","0","0","0","0","0","0","0","0","0","0","0","0","0","0","0","0","1","1","0","-2"
"228501","Sul Ross State University","2015","Not on tenure/no tenure system, instructors","3","1","2","0","0","0","0","0","0","0","0","0","0","0","0","0","0","0","2","1","1","0","0","0","0","0","0","1","0","1","-2"
"228501","Sul Ross State University","2015","Not on tenure/no tenure system, lecturers","25","13","12","0","0","0","0","0","0","1","1","0","8","4","4","0","0","0","15","8","7","1","0","1","0","0","0","0","0","0","-2"
"228644","The University of Texas Health Science Center at San Antonio","2015","Tenured total","257","179","78","1","0","1","41","31","10","5","4","1","23","11","12","0","0","0","184","130","54","0","0","0","3","3","0","0","0","0","-2"
"228644","The University of Texas Health Science Center at San Antonio","2015","Tenured, professors","186","137","49","0","0","0","29","24","5","3","2","1","14","9","5","0","0","0","138","100","38","0","0","0","2","2","0","0","0","0","-2"
"228644","The University of Texas Health Science Center at San Antonio","2015","Tenured, associate professors","69","42","27","1","0","1","12","7","5","2","2","0","8","2","6","0","0","0","45","30","15","0","0","0","1","1","0","0","0","0","-2"
"228644","The University of Texas Health Science Center at San Antonio","2015","Tenured, assistant professors","2","0","2","0","0","0","0","0","0","0","0","0","1","0","1","0","0","0","1","0","1","0","0","0","0","0","0","0","0","0","-2"
"228644","The University of Texas Health Science Center at San Antonio","2015","On-Tenure track total","71","41","30","1","1","0","13","6","7","2","2","0","16","9","7","0","0","0","39","23","16","0","0","0","0","0","0","0","0","0","-2"
"228644","The University of Texas Health Science Center at San Antonio","2015","On-tenure track, professors","1","1","0","0","0","0","0","0","0","0","0","0","0","0","0","0","0","0","1","1","0","0","0","0","0","0","0","0","0","0","-2"
"228644","The University of Texas Health Science Center at San Antonio","2015","On-tenure track, associate professors","13","10","3","0","0","0","2","2","0","0","0","0","3","2","1","0","0","0","8","6","2","0","0","0","0","0","0","0","0","0","-2"
"228644","The University of Texas Health Science Center at San Antonio","2015","On-tenure track, assistant professors","57","30","27","1","1","0","11","4","7","2","2","0","13","7","6","0","0","0","30","16","14","0","0","0","0","0","0","0","0","0","-2"
"228644","The University of Texas Health Science Center at San Antonio","2015","Not on tenure track/No tenure system system total","451","217","234","0","0","0","68","36","32","12","2","10","76","29","47","1","0","1","278","142","136","0","0","0","16","8","8","0","0","0","-2"
"228644","The University of Texas Health Science Center at San Antonio","2015","Not on tenure/no tenure system, professors","52","36","16","0","0","0","5","4","1","1","1","0","5","4","1","0","0","0","41","27","14","0","0","0","0","0","0","0","0","0","-2"
"228644","The University of Texas Health Science Center at San Antonio","2015","Not on tenure/no tenure system, associate professors","104","62","42","0","0","0","17","11","6","1","0","1","8","4","4","1","0","1","76","46","30","0","0","0","1","1","0","0","0","0","-2"
"228644","The University of Texas Health Science Center at San Antonio","2015","Not on tenure/no tenure system, assistant professors","242","100","142","0","0","0","45","20","25","8","1","7","50","19","31","0","0","0","126","53","73","0","0","0","13","7","6","0","0","0","-2"
"228644","The University of Texas Health Science Center at San Antonio","2015","Not on tenure/no tenure system, instructors","32","9","23","0","0","0","1","1","0","0","0","0","11","1","10","0","0","0","19","7","12","0","0","0","1","0","1","0","0","0","-2"
"228644","The University of Texas Health Science Center at San Antonio","2015","Not on tenure/no tenure system, lecturers","9","4","5","0","0","0","0","0","0","1","0","1","1","0","1","0","0","0","7","4","3","0","0","0","0","0","0","0","0","0","-2"
"228644","The University of Texas Health Science Center at San Antonio","2015","Not on tenure/no tenure system, no academic rank","12","6","6","0","0","0","0","0","0","1","0","1","1","1","0","0","0","0","9","5","4","0","0","0","1","0","1","0","0","0","-2"
"228705","Texas A & M University-Kingsville","2015","Tenured total","159","117","42","2","2","0","24","20","4","5","5","0","19","15","4","0","0","0","105","72","33","0","0","0","0","0","0","4","3","1","-2"
"228705","Texas A & M University-Kingsville","2015","Tenured, professors","87","68","19","1","1","0","13","11","2","3","3","0","9","7","2","0","0","0","61","46","15","0","0","0","0","0","0","0","0","0","-2"
"228705","Texas A & M University-Kingsville","2015","Tenured, associate professors","67","48","19","1","1","0","10","9","1","2","2","0","10","8","2","0","0","0","41","26","15","0","0","0","0","0","0","3","2","1","-2"
"228705","Texas A & M University-Kingsville","2015","Tenured, assistant professors","5","1","4","0","0","0","1","0","1","0","0","0","0","0","0","0","0","0","3","0","3","0","0","0","0","0","0","1","1","0","-2"
"228705","Texas A & M University-Kingsville","2015","On-Tenure track total","106","61","45","0","0","0","11","9","2","1","0","1","10","1","9","0","0","0","56","32","24","1","1","0","2","1","1","25","17","8","-2"
"228705","Texas A & M University-Kingsville","2015","On-tenure track, professors","1","0","1","0","0","0","0","0","0","0","0","0","0","0","0","0","0","0","1","0","1","0","0","0","0","0","0","0","0","0","-2"
"228705","Texas A & M University-Kingsville","2015","On-tenure track, associate professors","9","7","2","0","0","0","0","0","0","0","0","0","1","1","0","0","0","0","7","6","1","0","0","0","0","0","0","1","0","1","-2"
"228705","Texas A & M University-Kingsville","2015","On-tenure track, assistant professors","96","54","42","0","0","0","11","9","2","1","0","1","9","0","9","0","0","0","48","26","22","1","1","0","2","1","1","24","17","7","-2"
"228705","Texas A & M University-Kingsville","2015","Not on tenure track/No tenure system system total","105","59","46","2","1","1","9","7","2","2","2","0","31","15","16","0","0","0","50","26","24","1","1","0","1","1","0","9","6","3","-2"
"228705","Texas A & M University-Kingsville","2015","Not on tenure/no tenure system, professors","4","4","0","0","0","0","0","0","0","0","0","0","1","1","0","0","0","0","2","2","0","0","0","0","0","0","0","1","1","0","-2"
"228705","Texas A & M University-Kingsville","2015","Not on tenure/no tenure system, associate professors","4","3","1","0","0","0","1","1","0","0","0","0","3","2","1","0","0","0","0","0","0","0","0","0","0","0","0","0","0","0","-2"
"228705","Texas A & M University-Kingsville","2015","Not on tenure/no tenure system, assistant professors","13","12","1","0","0","0","1","1","0","0","0","0","4","3","1","0","0","0","5","5","0","0","0","0","0","0","0","3","3","0","-2"
"228705","Texas A & M University-Kingsville","2015","Not on tenure/no tenure system, instructors","1","0","1","0","0","0","0","0","0","0","0","0","0","0","0","0","0","0","0","0","0","0","0","0","0","0","0","1","0","1","-2"
"228705","Texas A & M University-Kingsville","2015","Not on tenure/no tenure system, lecturers","71","35","36","2","1","1","5","4","1","2","2","0","19","8","11","0","0","0","38","17","21","1","1","0","0","0","0","4","2","2","-2"
"228705","Texas A & M University-Kingsville","2015","Not on tenure/no tenure system, no academic rank","12","5","7","0","0","0","2","1","1","0","0","0","4","1","3","0","0","0","5","2","3","0","0","0","1","1","0","0","0","0","-2"
"228981","Texas Lutheran University","2015","Tenured total","39","21","18","0","0","0","1","0","1","0","0","0","1","0","1","0","0","0","36","20","16","0","0","0","1","1","0","0","0","0","-2"
"228981","Texas Lutheran University","2015","Tenured, professors","26","16","10","0","0","0","0","0","0","0","0","0","0","0","0","0","0","0","26","16","10","0","0","0","0","0","0","0","0","0","-2"
"228981","Texas Lutheran University","2015","Tenured, associate professors","12","4","8","0","0","0","1","0","1","0","0","0","1","0","1","0","0","0","9","3","6","0","0","0","1","1","0","0","0","0","-2"
"228981","Texas Lutheran University","2015","Tenured, assistant professors","1","1","0","0","0","0","0","0","0","0","0","0","0","0","0","0","0","0","1","1","0","0","0","0","0","0","0","0","0","0","-2"
"228981","Texas Lutheran University","2015","On-Tenure track total","32","15","17","0","0","0","0","0","0","2","2","0","4","1","3","0","0","0","25","12","13","0","0","0","1","0","1","0","0","0","-2"
"228981","Texas Lutheran University","2015","On-tenure track, associate professors","6","3","3","0","0","0","0","0","0","0","0","0","0","0","0","0","0","0","6","3","3","0","0","0","0","0","0","0","0","0","-2"
"228981","Texas Lutheran University","2015","On-tenure track, assistant professors","22","12","10","0","0","0","0","0","0","2","2","0","3","1","2","0","0","0","16","9","7","0","0","0","1","0","1","0","0","0","-2"
"228981","Texas Lutheran University","2015","On-tenure track, instructors","3","0","3","0","0","0","0","0","0","0","0","0","1","0","1","0","0","0","2","0","2","0","0","0","0","0","0","0","0","0","-2"
"228981","Texas Lutheran University","2015","On-tenure track, lecturers","1","0","1","0","0","0","0","0","0","0","0","0","0","0","0","0","0","0","1","0","1","0","0","0","0","0","0","0","0","0","-2"
"228981","Texas Lutheran University","2015","Not on tenure track/No tenure system system total","10","3","7","0","0","0","0","0","0","0","0","0","1","1","0","0","0","0","9","2","7","0","0","0","0","0","0","0","0","0","-2"
"228981","Texas Lutheran University","2015","Not on tenure/no tenure system, assistant professors","4","2","2","0","0","0","0","0","0","0","0","0","1","1","0","0","0","0","3","1","2","0","0","0","0","0","0","0","0","0","-2"
"228981","Texas Lutheran University","2015","Not on tenure/no tenure system, lecturers","6","1","5","0","0","0","0","0","0","0","0","0","0","0","0","0","0","0","6","1","5","0","0","0","0","0","0","0","0","0","-2"
"229018","The University of Texas Permian Basin","2015","Tenured total","49","35","14","1","0","1","7","6","1","0","0","0","3","1","2","0","0","0","38","28","10","0","0","0","0","0","0","0","0","0","-2"
"229018","The University of Texas Permian Basin","2015","Tenured, professors","13","12","1","0","0","0","1","1","0","0","0","0","0","0","0","0","0","0","12","11","1","0","0","0","0","0","0","0","0","0","-2"
"229018","The University of Texas Permian Basin","2015","Tenured, associate professors","36","23","13","1","0","1","6","5","1","0","0","0","3","1","2","0","0","0","26","17","9","0","0","0","0","0","0","0","0","0","-2"
"229018","The University of Texas Permian Basin","2015","On-Tenure track total","34","17","17","0","0","0","4","3","1","1","0","1","7","4","3","0","0","0","22","10","12","0","0","0","0","0","0","0","0","0","-2"
"229018","The University of Texas Permian Basin","2015","On-tenure track, professors","3","2","1","0","0","0","0","0","0","0","0","0","0","0","0","0","0","0","3","2","1","0","0","0","0","0","0","0","0","0","-2"
"229018","The University of Texas Permian Basin","2015","On-tenure track, associate professors","3","2","1","0","0","0","0","0","0","0","0","0","0","0","0","0","0","0","3","2","1","0","0","0","0","0","0","0","0","0","-2"
"229018","The University of Texas Permian Basin","2015","On-tenure track, assistant professors","28","13","15","0","0","0","4","3","1","1","0","1","7","4","3","0","0","0","16","6","10","0","0","0","0","0","0","0","0","0","-2"
"229018","The University of Texas Permian Basin","2015","Not on tenure track/No tenure system system total","43","13","30","0","0","0","1","0","1","1","1","0","2","1","1","0","0","0","39","11","28","0","0","0","0","0","0","0","0","0","-2"
"229018","The University of Texas Permian Basin","2015","Not on tenure/no tenure system, professors","3","1","2","0","0","0","0","0","0","0","0","0","0","0","0","0","0","0","3","1","2","0","0","0","0","0","0","0","0","0","-2"
"229018","The University of Texas Permian Basin","2015","Not on tenure/no tenure system, assistant professors","1","0","1","0","0","0","0","0","0","0","0","0","0","0","0","0","0","0","1","0","1","0","0","0","0","0","0","0","0","0","-2"
"229018","The University of Texas Permian Basin","2015","Not on tenure/no tenure system, instructors","2","0","2","0","0","0","0","0","0","0","0","0","0","0","0","0","0","0","2","0","2","0","0","0","0","0","0","0","0","0","-2"
"229018","The University of Texas Permian Basin","2015","Not on tenure/no tenure system, lecturers","37","12","25","0","0","0","1","0","1","1","1","0","2","1","1","0","0","0","33","10","23","0","0","0","0","0","0","0","0","0","-2"
"229027","The University of Texas at San Antonio","2015","Tenured total","451","314","137","4","3","1","87","72","15","19","12","7","67","34","33","0","0","0","264","185","79","8","6","2","0","0","0","2","2","0","-2"
"229027","The University of Texas at San Antonio","2015","Tenured, professors","217","171","46","2","2","0","49","45","4","9","5","4","23","16","7","0","0","0","130","101","29","4","2","2","0","0","0","0","0","0","-2"
"229027","The University of Texas at San Antonio","2015","Tenured, associate professors","234","143","91","2","1","1","38","27","11","10","7","3","44","18","26","0","0","0","134","84","50","4","4","0","0","0","0","2","2","0","-2"
"229027","The University of Texas at San Antonio","2015","On-Tenure track total","170","101","69","0","0","0","18","14","4","8","4","4","20","10","10","0","0","0","72","41","31","21","11","10","0","0","0","31","21","10","-2"
"229027","The University of Texas at San Antonio","2015","On-tenure track, associate professors","7","6","1","0","0","0","1","1","0","0","0","0","2","1","1","0","0","0","3","3","0","1","1","0","0","0","0","0","0","0","-2"
"229027","The University of Texas at San Antonio","2015","On-tenure track, assistant professors","163","95","68","0","0","0","17","13","4","8","4","4","18","9","9","0","0","0","69","38","31","20","10","10","0","0","0","31","21","10","-2"
"229027","The University of Texas at San Antonio","2015","Not on tenure track/No tenure system system total","281","138","143","2","1","1","14","9","5","6","3","3","52","27","25","0","0","0","190","94","96","11","2","9","0","0","0","6","2","4","-2"
"229027","The University of Texas at San Antonio","2015","Not on tenure/no tenure system, assistant professors","5","0","5","0","0","0","0","0","0","1","0","1","0","0","0","0","0","0","2","0","2","2","0","2","0","0","0","0","0","0","-2"
"229027","The University of Texas at San Antonio","2015","Not on tenure/no tenure system, lecturers","276","138","138","2","1","1","14","9","5","5","3","2","52","27","25","0","0","0","188","94","94","9","2","7","0","0","0","6","2","4","-2"
"229160","Texas Wesleyan University","2015","Tenured total","74","39","35","0","0","0","3","2","1","1","1","0","4","3","1","0","0","0","65","32","33","1","1","0","0","0","0","0","0","0","-2"
"229160","Texas Wesleyan University","2015","Tenured, professors","34","18","16","0","0","0","1","1","0","1","1","0","4","3","1","0","0","0","27","12","15","1","1","0","0","0","0","0","0","0","-2"
"229160","Texas Wesleyan University","2015","Tenured, associate professors","39","21","18","0","0","0","2","1","1","0","0","0","0","0","0","0","0","0","37","20","17","0","0","0","0","0","0","0","0","0","-2"
"229160","Texas Wesleyan University","2015","Tenured, assistant professors","1","0","1","0","0","0","0","0","0","0","0","0","0","0","0","0","0","0","1","0","1","0","0","0","0","0","0","0","0","0","-2"
"229160","Texas Wesleyan University","2015","On-Tenure track total","36","15","21","1","0","1","3","1","2","0","0","0","4","2","2","0","0","0","26","10","16","2","2","0","0","0","0","0","0","0","-2"
"229160","Texas Wesleyan University","2015","On-tenure track, associate professors","3","1","2","0","0","0","0","0","0","0","0","0","0","0","0","0","0","0","2","0","2","1","1","0","0","0","0","0","0","0","-2"
"229160","Texas Wesleyan University","2015","On-tenure track, assistant professors","33","14","19","1","0","1","3","1","2","0","0","0","4","2","2","0","0","0","24","10","14","1","1","0","0","0","0","0","0","0","-2"
"229160","Texas Wesleyan University","2015","Not on tenure track/No tenure system system total","25","12","13","0","0","0","1","1","0","2","1","1","1","1","0","0","0","0","20","9","11","1","0","1","0","0","0","0","0","0","-2"
"229160","Texas Wesleyan University","2015","Not on tenure/no tenure system, professors","3","3","0","0","0","0","0","0","0","0","0","0","0","0","0","0","0","0","3","3","0","0","0","0","0","0","0","0","0","0","-2"
"229160","Texas Wesleyan University","2015","Not on tenure/no tenure system, assistant professors","10","4","6","0","0","0","1","1","0","1","1","0","1","1","0","0","0","0","6","1","5","1","0","1","0","0","0","0","0","0","-2"
"229160","Texas Wesleyan University","2015","Not on tenure/no tenure system, instructors","12","5","7","0","0","0","0","0","0","1","0","1","0","0","0","0","0","0","11","5","6","0","0","0","0","0","0","0","0","0","-2"
"229179","Texas Woman's University","2015","Tenured total","213","60","153","1","0","1","22","10","12","7","1","6","3","1","2","2","1","1","178","47","131","0","0","0","0","0","0","0","0","0","-2"
"229179","Texas Woman's University","2015","Tenured, professors","102","32","70","0","0","0","11","6","5","3","0","3","2","1","1","0","0","0","86","25","61","0","0","0","0","0","0","0","0","0","-2"
"229179","Texas Woman's University","2015","Tenured, associate professors","108","28","80","1","0","1","11","4","7","3","1","2","1","0","1","2","1","1","90","22","68","0","0","0","0","0","0","0","0","0","-2"
"229179","Texas Woman's University","2015","Tenured, assistant professors","3","0","3","0","0","0","0","0","0","1","0","1","0","0","0","0","0","0","2","0","2","0","0","0","0","0","0","0","0","0","-2"
"229179","Texas Woman's University","2015","On-Tenure track total","105","32","73","1","0","1","7","2","5","9","2","7","6","0","6","0","0","0","70","22","48","7","4","3","5","2","3","0","0","0","-2"
"229179","Texas Woman's University","2015","On-tenure track, associate professors","15","2","13","0","0","0","0","0","0","0","0","0","2","0","2","0","0","0","9","0","9","2","1","1","2","1","1","0","0","0","-2"
"229179","Texas Woman's University","2015","On-tenure track, assistant professors","90","30","60","1","0","1","7","2","5","9","2","7","4","0","4","0","0","0","61","22","39","5","3","2","3","1","2","0","0","0","-2"
"229179","Texas Woman's University","2015","Not on tenure track/No tenure system system total","120","13","107","1","0","1","7","1","6","6","1","5","1","0","1","0","0","0","103","10","93","0","0","0","2","1","1","0","0","0","-2"
"229179","Texas Woman's University","2015","Not on tenure/no tenure system, professors","9","1","8","0","0","0","0","0","0","1","0","1","0","0","0","0","0","0","7","0","7","0","0","0","1","1","0","0","0","0","-2"
"229179","Texas Woman's University","2015","Not on tenure/no tenure system, associate professors","37","3","34","1","0","1","2","0","2","1","0","1","0","0","0","0","0","0","33","3","30","0","0","0","0","0","0","0","0","0","-2"
"229179","Texas Woman's University","2015","Not on tenure/no tenure system, assistant professors","61","7","54","0","0","0","4","1","3","3","1","2","1","0","1","0","0","0","52","5","47","0","0","0","1","0","1","0","0","0","-2"
"229179","Texas Woman's University","2015","Not on tenure/no tenure system, instructors","3","0","3","0","0","0","1","0","1","0","0","0","0","0","0","0","0","0","2","0","2","0","0","0","0","0","0","0","0","0","-2"
"229179","Texas Woman's University","2015","Not on tenure/no tenure system, lecturers","10","2","8","0","0","0","0","0","0","1","0","1","0","0","0","0","0","0","9","2","7","0","0","0","0","0","0","0","0","0","-2"
"229300","The University of Texas Health Science Center at Houston","2015","Tenured total","243","158","85","0","0","0","50","37","13","5","5","0","15","9","6","0","0","0","169","103","66","1","1","0","3","3","0","0","0","0","-2"
"229300","The University of Texas Health Science Center at Houston","2015","Tenured, professors","177","122","55","0","0","0","33","25","8","3","3","0","8","7","1","0","0","0","129","83","46","1","1","0","3","3","0","0","0","0","-2"
"229300","The University of Texas Health Science Center at Houston","2015","Tenured, associate professors","65","36","29","0","0","0","16","12","4","2","2","0","7","2","5","0","0","0","40","20","20","0","0","0","0","0","0","0","0","0","-2"
"229300","The University of Texas Health Science Center at Houston","2015","Tenured, assistant professors","1","0","1","0","0","0","1","0","1","0","0","0","0","0","0","0","0","0","0","0","0","0","0","0","0","0","0","0","0","0","-2"
"229300","The University of Texas Health Science Center at Houston","2015","On-Tenure track total","171","100","71","0","0","0","56","37","19","9","4","5","15","8","7","0","0","0","76","42","34","0","0","0","2","1","1","13","8","5","-2"
"229300","The University of Texas Health Science Center at Houston","2015","On-tenure track, professors","21","19","2","0","0","0","6","6","0","1","1","0","2","2","0","0","0","0","12","10","2","0","0","0","0","0","0","0","0","0","-2"
"229300","The University of Texas Health Science Center at Houston","2015","On-tenure track, associate professors","34","21","13","0","0","0","12","8","4","1","1","0","4","2","2","0","0","0","15","8","7","0","0","0","1","1","0","1","1","0","-2"
"229300","The University of Texas Health Science Center at Houston","2015","On-tenure track, assistant professors","116","60","56","0","0","0","38","23","15","7","2","5","9","4","5","0","0","0","49","24","25","0","0","0","1","0","1","12","7","5","-2"
"229300","The University of Texas Health Science Center at Houston","2015","Not on tenure track/No tenure system system total","1197","645","552","5","5","0","316","181","135","90","27","63","99","46","53","0","0","0","564","303","261","5","2","3","57","36","21","61","45","16","-2"
"229300","The University of Texas Health Science Center at Houston","2015","Not on tenure/no tenure system, professors","96","65","31","0","0","0","13","8","5","2","0","2","6","3","3","0","0","0","70","50","20","0","0","0","3","3","0","2","1","1","-2"
"229300","The University of Texas Health Science Center at Houston","2015","Not on tenure/no tenure system, associate professors","225","131","94","2","2","0","58","37","21","6","2","4","21","11","10","0","0","0","128","71","57","1","1","0","7","5","2","2","2","0","-2"
"229300","The University of Texas Health Science Center at Houston","2015","Not on tenure/no tenure system, assistant professors","794","423","371","3","3","0","224","125","99","77","25","52","67","31","36","0","0","0","320","171","149","4","1","3","47","28","19","52","39","13","-2"
"229300","The University of Texas Health Science Center at Houston","2015","Not on tenure/no tenure system, instructors","64","22","42","0","0","0","20","11","9","4","0","4","3","1","2","0","0","0","33","7","26","0","0","0","0","0","0","4","3","1","-2"
"229300","The University of Texas Health Science Center at Houston","2015","Not on tenure/no tenure system, lecturers","18","4","14","0","0","0","1","0","1","1","0","1","2","0","2","0","0","0","13","4","9","0","0","0","0","0","0","1","0","1","-2"
"229337","Texas Tech University Health Sciences Center","2015","Tenured total","154","105","49","0","0","0","26","17","9","2","1","1","10","9","1","0","0","0","116","78","38","0","0","0","0","0","0","0","0","0","-2"
"229337","Texas Tech University Health Sciences Center","2015","Tenured, professors","106","77","29","0","0","0","18","13","5","1","0","1","6","6","0","0","0","0","81","58","23","0","0","0","0","0","0","0","0","0","-2"
"229337","Texas Tech University Health Sciences Center","2015","Tenured, associate professors","48","28","20","0","0","0","8","4","4","1","1","0","4","3","1","0","0","0","35","20","15","0","0","0","0","0","0","0","0","0","-2"
"229337","Texas Tech University Health Sciences Center","2015","On-Tenure track total","87","54","33","0","0","0","22","14","8","2","2","0","9","4","5","0","0","0","54","34","20","0","0","0","0","0","0","0","0","0","-2"
"229337","Texas Tech University Health Sciences Center","2015","On-tenure track, professors","12","9","3","0","0","0","4","2","2","0","0","0","1","1","0","0","0","0","7","6","1","0","0","0","0","0","0","0","0","0","-2"
"229337","Texas Tech University Health Sciences Center","2015","On-tenure track, associate professors","23","19","4","0","0","0","6","6","0","1","1","0","2","1","1","0","0","0","14","11","3","0","0","0","0","0","0","0","0","0","-2"
"229337","Texas Tech University Health Sciences Center","2015","On-tenure track, assistant professors","52","26","26","0","0","0","12","6","6","1","1","0","6","2","4","0","0","0","33","17","16","0","0","0","0","0","0","0","0","0","-2"
"229337","Texas Tech University Health Sciences Center","2015","Not on tenure track/No tenure system system total","710","336","374","2","1","1","126","75","51","42","14","28","119","61","58","0","0","0","421","185","236","0","0","0","0","0","0","0","0","0","-2"
"229337","Texas Tech University Health Sciences Center","2015","Not on tenure/no tenure system, professors","50","35","15","0","0","0","7","4","3","2","0","2","2","2","0","0","0","0","39","29","10","0","0","0","0","0","0","0","0","0","-2"
"229337","Texas Tech University Health Sciences Center","2015","Not on tenure/no tenure system, associate professors","171","94","77","1","0","1","27","20","7","10","4","6","18","14","4","0","0","0","115","56","59","0","0","0","0","0","0","0","0","0","-2"
"229337","Texas Tech University Health Sciences Center","2015","Not on tenure/no tenure system, assistant professors","357","170","187","1","1","0","73","42","31","23","8","15","62","34","28","0","0","0","198","85","113","0","0","0","0","0","0","0","0","0","-2"
"229337","Texas Tech University Health Sciences Center","2015","Not on tenure/no tenure system, instructors","62","14","48","0","0","0","8","5","3","4","1","3","13","3","10","0","0","0","37","5","32","0","0","0","0","0","0","0","0","0","-2"
"229337","Texas Tech University Health Sciences Center","2015","Not on tenure/no tenure system, no academic rank","70","23","47","0","0","0","11","4","7","3","1","2","24","8","16","0","0","0","32","10","22","0","0","0","0","0","0","0","0","0","-2"
"229355","Tyler Junior College","2015","Not on tenure track/No tenure system system total","306","127","179","0","0","0","3","1","2","16","4","12","10","3","7","0","0","0","274","118","156","0","0","0","1","0","1","2","1","1","-2"
"229355","Tyler Junior College","2015","Not on tenure/no tenure system, professors","306","127","179","0","0","0","3","1","2","16","4","12","10","3","7","0","0","0","274","118","156","0","0","0","1","0","1","2","1","1","-2"
"229780","Wayland Baptist University","2015","Not on tenure track/No tenure system system total","141","93","48","1","1","0","6","4","2","11","7","4","4","3","1","0","0","0","105","70","35","3","0","3","11","8","3","0","0","0","-2"
"229780","Wayland Baptist University","2015","Not on tenure/no tenure system, professors","56","41","15","1","1","0","0","0","0","1","1","0","1","1","0","0","0","0","52","37","15","0","0","0","1","1","0","0","0","0","-2"
"229780","Wayland Baptist University","2015","Not on tenure/no tenure system, associate professors","38","25","13","0","0","0","3","1","2","5","3","2","0","0","0","0","0","0","26","19","7","2","0","2","2","2","0","0","0","0","-2"
"229780","Wayland Baptist University","2015","Not on tenure/no tenure system, assistant professors","37","21","16","0","0","0","3","3","0","5","3","2","3","2","1","0","0","0","19","8","11","0","0","0","7","5","2","0","0","0","-2"
"229780","Wayland Baptist University","2015","Not on tenure/no tenure system, instructors","5","5","0","0","0","0","0","0","0","0","0","0","0","0","0","0","0","0","5","5","0","0","0","0","0","0","0","0","0","0","-2"
"229780","Wayland Baptist University","2015","Not on tenure/no tenure system, lecturers","5","1","4","0","0","0","0","0","0","0","0","0","0","0","0","0","0","0","3","1","2","1","0","1","1","0","1","0","0","0","-2"
"229814","West Texas A & M University","2015","Tenured total","131","90","41","3","3","0","11","7","4","1","1","0","3","2","1","0","0","0","112","77","35","0","0","0","1","0","1","0","0","0","-2"
"229814","West Texas A & M University","2015","Tenured, professors","64","46","18","2","2","0","4","4","0","0","0","0","1","1","0","0","0","0","57","39","18","0","0","0","0","0","0","0","0","0","-2"
"229814","West Texas A & M University","2015","Tenured, associate professors","65","43","22","1","1","0","7","3","4","1","1","0","2","1","1","0","0","0","53","37","16","0","0","0","1","0","1","0","0","0","-2"
"229814","West Texas A & M University","2015","Tenured, assistant professors","2","1","1","0","0","0","0","0","0","0","0","0","0","0","0","0","0","0","2","1","1","0","0","0","0","0","0","0","0","0","-2"
"229814","West Texas A & M University","2015","On-Tenure track total","64","35","29","0","0","0","0","0","0","1","1","0","4","2","2","0","0","0","54","27","27","0","0","0","0","0","0","5","5","0","-2"
"229814","West Texas A & M University","2015","On-tenure track, associate professors","2","1","1","0","0","0","0","0","0","0","0","0","1","0","1","0","0","0","1","1","0","0","0","0","0","0","0","0","0","0","-2"
"229814","West Texas A & M University","2015","On-tenure track, assistant professors","60","33","27","0","0","0","0","0","0","1","1","0","3","2","1","0","0","0","51","25","26","0","0","0","0","0","0","5","5","0","-2"
"229814","West Texas A & M University","2015","On-tenure track, instructors","2","1","1","0","0","0","0","0","0","0","0","0","0","0","0","0","0","0","2","1","1","0","0","0","0","0","0","0","0","0","-2"
"229814","West Texas A & M University","2015","Not on tenure track/No tenure system system total","123","50","73","1","0","1","0","0","0","0","0","0","11","4","7","0","0","0","104","42","62","1","0","1","0","0","0","6","4","2","-2"
"229814","West Texas A & M University","2015","Not on tenure/no tenure system, professors","2","1","1","0","0","0","0","0","0","0","0","0","0","0","0","0","0","0","2","1","1","0","0","0","0","0","0","0","0","0","-2"
"229814","West Texas A & M University","2015","Not on tenure/no tenure system, assistant professors","25","11","14","1","0","1","0","0","0","0","0","0","1","0","1","0","0","0","21","11","10","0","0","0","0","0","0","2","0","2","-2"
"229814","West Texas A & M University","2015","Not on tenure/no tenure system, instructors","95","38","57","0","0","0","0","0","0","0","0","0","10","4","6","0","0","0","80","30","50","1","0","1","0","0","0","4","4","0","-2"
"229814","West Texas A & M University","2015","Not on tenure/no tenure system, no academic rank","1","0","1","0","0","0","0","0","0","0","0","0","0","0","0","0","0","0","1","0","1","0","0","0","0","0","0","0","0","0","-2"
"234979","Columbia Basin College","2015","Tenured total","79","40","39","1","1","0","7","3","4","2","1","1","4","1","3","0","0","0","65","34","31","0","0","0","0","0","0","0","0","0","-2"
"234979","Columbia Basin College","2015","Tenured, no academic rank","79","40","39","1","1","0","7","3","4","2","1","1","4","1","3","0","0","0","65","34","31","0","0","0","0","0","0","0","0","0","-2"
"234979","Columbia Basin College","2015","On-Tenure track total","25","13","12","1","1","0","2","1","1","1","1","0","2","0","2","0","0","0","19","10","9","0","0","0","0","0","0","0","0","0","-2"
"234979","Columbia Basin College","2015","On-tenure track, no academic rank","25","13","12","1","1","0","2","1","1","1","1","0","2","0","2","0","0","0","19","10","9","0","0","0","0","0","0","0","0","0","-2"
"234979","Columbia Basin College","2015","Not on tenure track/No tenure system system total","28","12","16","0","0","0","1","0","1","0","0","0","5","3","2","1","0","1","21","9","12","0","0","0","0","0","0","0","0","0","-2"
"234979","Columbia Basin College","2015","Not on tenure/no tenure system, no academic rank","28","12","16","0","0","0","1","0","1","0","0","0","5","3","2","1","0","1","21","9","12","0","0","0","0","0","0","0","0","0","-2"
"235422","Heritage University","2015","Not on tenure track/No tenure system system total","77","32","45","9","2","7","0","0","0","3","2","1","9","1","8","1","1","0","53","25","28","2","1","1","0","0","0","0","0","0","-2"
"235422","Heritage University","2015","Not on tenure/no tenure system, professors","3","1","2","1","0","1","0","0","0","0","0","0","1","0","1","0","0","0","0","0","0","1","1","0","0","0","0","0","0","0","-2"
"235422","Heritage University","2015","Not on tenure/no tenure system, associate professors","25","8","17","2","0","2","0","0","0","1","0","1","4","0","4","0","0","0","17","8","9","1","0","1","0","0","0","0","0","0","-2"
"235422","Heritage University","2015","Not on tenure/no tenure system, assistant professors","40","20","20","4","2","2","0","0","0","2","2","0","2","1","1","1","1","0","31","14","17","0","0","0","0","0","0","0","0","0","-2"
"235422","Heritage University","2015","Not on tenure/no tenure system, instructors","9","3","6","2","0","2","0","0","0","0","0","0","2","0","2","0","0","0","5","3","2","0","0","0","0","0","0","0","0","0","-2"
"236975","Wenatchee Valley College","2015","Tenured total","48","28","20","0","0","0","1","0","1","0","0","0","3","3","0","0","0","0","42","24","18","2","1","1","0","0","0","0","0","0","-2"
"236975","Wenatchee Valley College","2015","Tenured, no academic rank","48","28","20","0","0","0","1","0","1","0","0","0","3","3","0","0","0","0","42","24","18","2","1","1","0","0","0","0","0","0","-2"
"236975","Wenatchee Valley College","2015","On-Tenure track total","19","8","11","0","0","0","1","0","1","1","0","1","1","1","0","0","0","0","15","6","9","1","1","0","0","0","0","0","0","0","-2"
"236975","Wenatchee Valley College","2015","On-tenure track, no academic rank","19","8","11","0","0","0","1","0","1","1","0","1","1","1","0","0","0","0","15","6","9","1","1","0","0","0","0","0","0","0","-2"
"236975","Wenatchee Valley College","2015","Not on tenure track/No tenure system system total","5","3","2","0","0","0","0","0","0","0","0","0","0","0","0","0","0","0","5","3","2","0","0","0","0","0","0","0","0","0","-2"
"236975","Wenatchee Valley College","2015","Not on tenure/no tenure system, no academic rank","5","3","2","0","0","0","0","0","0","0","0","0","0","0","0","0","0","0","5","3","2","0","0","0","0","0","0","0","0","0","-2"
"237109","Yakima Valley College","2015","Tenured total","62","29","33","1","1","0","2","1","1","0","0","0","2","2","0","0","0","0","57","25","32","0","0","0","0","0","0","0","0","0","-2"
"237109","Yakima Valley College","2015","Tenured, instructors","62","29","33","1","1","0","2","1","1","0","0","0","2","2","0","0","0","0","57","25","32","0","0","0","0","0","0","0","0","0","-2"
"237109","Yakima Valley College","2015","On-Tenure track total","13","3","10","0","0","0","0","0","0","0","0","0","2","0","2","0","0","0","11","3","8","0","0","0","0","0","0","0","0","0","-2"
"237109","Yakima Valley College","2015","On-tenure track, instructors","13","3","10","0","0","0","0","0","0","0","0","0","2","0","2","0","0","0","11","3","8","0","0","0","0","0","0","0","0","0","-2"
"237109","Yakima Valley College","2015","Not on tenure track/No tenure system system total","40","23","17","0","0","0","0","0","0","2","0","2","2","1","1","0","0","0","36","22","14","0","0","0","0","0","0","0","0","0","-2"
"237109","Yakima Valley College","2015","Not on tenure/no tenure system, instructors","40","23","17","0","0","0","0","0","0","2","0","2","2","1","1","0","0","0","36","22","14","0","0","0","0","0","0","0","0","0","-2"
"238193","Alverno College","2015","Tenured total","74","18","56","0","0","0","1","0","1","3","1","2","1","0","1","0","0","0","68","16","52","0","0","0","1","1","0","0","0","0","-2"
"238193","Alverno College","2015","Tenured, professors","38","11","27","0","0","0","1","0","1","1","1","0","0","0","0","0","0","0","36","10","26","0","0","0","0","0","0","0","0","0","-2"
"238193","Alverno College","2015","Tenured, associate professors","26","4","22","0","0","0","0","0","0","1","0","1","0","0","0","0","0","0","25","4","21","0","0","0","0","0","0","0","0","0","-2"
"238193","Alverno College","2015","Tenured, assistant professors","10","3","7","0","0","0","0","0","0","1","0","1","1","0","1","0","0","0","7","2","5","0","0","0","1","1","0","0","0","0","-2"
"238193","Alverno College","2015","On-Tenure track total","25","4","21","0","0","0","0","0","0","1","0","1","1","0","1","0","0","0","23","4","19","0","0","0","0","0","0","0","0","0","-2"
"238193","Alverno College","2015","On-tenure track, associate professors","2","0","2","0","0","0","0","0","0","1","0","1","0","0","0","0","0","0","1","0","1","0","0","0","0","0","0","0","0","0","-2"
"238193","Alverno College","2015","On-tenure track, assistant professors","23","4","19","0","0","0","0","0","0","0","0","0","1","0","1","0","0","0","22","4","18","0","0","0","0","0","0","0","0","0","-2"
"239390","Mount Mary University","2015","Tenured total","34","5","29","0","0","0","0","0","0","1","0","1","0","0","0","0","0","0","33","5","28","0","0","0","0","0","0","0","0","0","-2"
"239390","Mount Mary University","2015","Tenured, professors","11","3","8","0","0","0","0","0","0","0","0","0","0","0","0","0","0","0","11","3","8","0","0","0","0","0","0","0","0","0","-2"
"239390","Mount Mary University","2015","Tenured, associate professors","16","1","15","0","0","0","0","0","0","1","0","1","0","0","0","0","0","0","15","1","14","0","0","0","0","0","0","0","0","0","-2"
"239390","Mount Mary University","2015","Tenured, assistant professors","7","1","6","0","0","0","0","0","0","0","0","0","0","0","0","0","0","0","7","1","6","0","0","0","0","0","0","0","0","0","-2"
"239390","Mount Mary University","2015","On-Tenure track total","22","2","20","0","0","0","0","0","0","0","0","0","0","0","0","0","0","0","21","1","20","0","0","0","1","1","0","0","0","0","-2"
"239390","Mount Mary University","2015","On-tenure track, associate professors","1","0","1","0","0","0","0","0","0","0","0","0","0","0","0","0","0","0","1","0","1","0","0","0","0","0","0","0","0","0","-2"
"239390","Mount Mary University","2015","On-tenure track, assistant professors","21","2","19","0","0","0","0","0","0","0","0","0","0","0","0","0","0","0","20","1","19","0","0","0","1","1","0","0","0","0","-2"
"239390","Mount Mary University","2015","Not on tenure track/No tenure system system total","11","1","10","0","0","0","0","0","0","1","0","1","1","1","0","0","0","0","9","0","9","0","0","0","0","0","0","0","0","0","-2"
"239390","Mount Mary University","2015","Not on tenure/no tenure system, assistant professors","3","1","2","0","0","0","0","0","0","1","0","1","1","1","0","0","0","0","1","0","1","0","0","0","0","0","0","0","0","0","-2"
"239390","Mount Mary University","2015","Not on tenure/no tenure system, instructors","8","0","8","0","0","0","0","0","0","0","0","0","0","0","0","0","0","0","8","0","8","0","0","0","0","0","0","0","0","0","-2"
"241100","American University of Puerto Rico","2015","Tenured total","13","6","7","0","0","0","0","0","0","0","0","0","13","6","7","0","0","0","0","0","0","0","0","0","0","0","0","0","0","0","-2"
"241100","American University of Puerto Rico","2015","Tenured, associate professors","3","1","2","0","0","0","0","0","0","0","0","0","3","1","2","0","0","0","0","0","0","0","0","0","0","0","0","0","0","0","-2"
"241100","American University of Puerto Rico","2015","Tenured, assistant professors","6","3","3","0","0","0","0","0","0","0","0","0","6","3","3","0","0","0","0","0","0","0","0","0","0","0","0","0","0","0","-2"
"241100","American University of Puerto Rico","2015","Tenured, instructors","4","2","2","0","0","0","0","0","0","0","0","0","4","2","2","0","0","0","0","0","0","0","0","0","0","0","0","0","0","0","-2"
"241128","American University of Puerto Rico","2015","Tenured total","14","8","6","0","0","0","0","0","0","0","0","0","13","7","6","0","0","0","1","1","0","0","0","0","0","0","0","0","0","0","-2"
"241128","American University of Puerto Rico","2015","Tenured, assistant professors","6","2","4","0","0","0","0","0","0","0","0","0","5","1","4","0","0","0","1","1","0","0","0","0","0","0","0","0","0","0","-2"
"241128","American University of Puerto Rico","2015","Tenured, instructors","8","6","2","0","0","0","0","0","0","0","0","0","8","6","2","0","0","0","0","0","0","0","0","0","0","0","0","0","0","0","-2"
"241191","Universidad Adventista de las Antillas","2015","Tenured total","35","17","18","0","0","0","0","0","0","0","0","0","34","17","17","0","0","0","1","0","1","0","0","0","0","0","0","0","0","0","-2"
"241191","Universidad Adventista de las Antillas","2015","Tenured, professors","3","0","3","0","0","0","0","0","0","0","0","0","3","0","3","0","0","0","0","0","0","0","0","0","0","0","0","0","0","0","-2"
"241191","Universidad Adventista de las Antillas","2015","Tenured, associate professors","9","5","4","0","0","0","0","0","0","0","0","0","9","5","4","0","0","0","0","0","0","0","0","0","0","0","0","0","0","0","-2"
"241191","Universidad Adventista de las Antillas","2015","Tenured, assistant professors","17","10","7","0","0","0","0","0","0","0","0","0","17","10","7","0","0","0","0","0","0","0","0","0","0","0","0","0","0","0","-2"
"241191","Universidad Adventista de las Antillas","2015","Tenured, instructors","6","2","4","0","0","0","0","0","0","0","0","0","5","2","3","0","0","0","1","0","1","0","0","0","0","0","0","0","0","0","-2"
"241191","Universidad Adventista de las Antillas","2015","Not on tenure track/No tenure system system total","7","3","4","0","0","0","0","0","0","0","0","0","7","3","4","0","0","0","0","0","0","0","0","0","0","0","0","0","0","0","-2"
"241191","Universidad Adventista de las Antillas","2015","Not on tenure/no tenure system, no academic rank","7","3","4","0","0","0","0","0","0","0","0","0","7","3","4","0","0","0","0","0","0","0","0","0","0","0","0","0","0","0","-2"
"241216","Atlantic University College","2015","Not on tenure track/No tenure system system total","42","25","17","0","0","0","0","0","0","0","0","0","42","25","17","0","0","0","0","0","0","0","0","0","0","0","0","0","0","0","-2"
"241216","Atlantic University College","2015","Not on tenure/no tenure system, professors","42","25","17","0","0","0","0","0","0","0","0","0","42","25","17","0","0","0","0","0","0","0","0","0","0","0","0","0","0","0","-2"
"241225","Universidad Central de Bayamon","2015","Not on tenure track/No tenure system system total","34","9","25","0","0","0","0","0","0","0","0","0","34","9","25","0","0","0","0","0","0","0","0","0","0","0","0","0","0","0","-2"
"241225","Universidad Central de Bayamon","2015","Not on tenure/no tenure system, associate professors","7","5","2","0","0","0","0","0","0","0","0","0","7","5","2","0","0","0","0","0","0","0","0","0","0","0","0","0","0","0","-2"
"241225","Universidad Central de Bayamon","2015","Not on tenure/no tenure system, assistant professors","14","1","13","0","0","0","0","0","0","0","0","0","14","1","13","0","0","0","0","0","0","0","0","0","0","0","0","0","0","0","-2"
"241225","Universidad Central de Bayamon","2015","Not on tenure/no tenure system, instructors","7","2","5","0","0","0","0","0","0","0","0","0","7","2","5","0","0","0","0","0","0","0","0","0","0","0","0","0","0","0","-2"
"241225","Universidad Central de Bayamon","2015","Not on tenure/no tenure system, lecturers","6","1","5","0","0","0","0","0","0","0","0","0","6","1","5","0","0","0","0","0","0","0","0","0","0","0","0","0","0","0","-2"
"241377","Caribbean University-Bayamon","2015","Not on tenure track/No tenure system system total","37","25","12","0","0","0","0","0","0","0","0","0","37","25","12","0","0","0","0","0","0","0","0","0","0","0","0","0","0","0","-2"
"241377","Caribbean University-Bayamon","2015","Not on tenure/no tenure system, professors","1","1","0","0","0","0","0","0","0","0","0","0","1","1","0","0","0","0","0","0","0","0","0","0","0","0","0","0","0","0","-2"
"241377","Caribbean University-Bayamon","2015","Not on tenure/no tenure system, associate professors","2","1","1","0","0","0","0","0","0","0","0","0","2","1","1","0","0","0","0","0","0","0","0","0","0","0","0","0","0","0","-2"
"241377","Caribbean University-Bayamon","2015","Not on tenure/no tenure system, assistant professors","7","5","2","0","0","0","0","0","0","0","0","0","7","5","2","0","0","0","0","0","0","0","0","0","0","0","0","0","0","0","-2"
"241377","Caribbean University-Bayamon","2015","Not on tenure/no tenure system, instructors","27","18","9","0","0","0","0","0","0","0","0","0","27","18","9","0","0","0","0","0","0","0","0","0","0","0","0","0","0","0","-2"
"241386","Caribbean University-Carolina","2015","Not on tenure track/No tenure system system total","9","6","3","0","0","0","0","0","0","0","0","0","9","6","3","0","0","0","0","0","0","0","0","0","0","0","0","0","0","0","-2"
"241386","Caribbean University-Carolina","2015","Not on tenure/no tenure system, assistant professors","4","3","1","0","0","0","0","0","0","0","0","0","4","3","1","0","0","0","0","0","0","0","0","0","0","0","0","0","0","0","-2"
"241386","Caribbean University-Carolina","2015","Not on tenure/no tenure system, instructors","5","3","2","0","0","0","0","0","0","0","0","0","5","3","2","0","0","0","0","0","0","0","0","0","0","0","0","0","0","0","-2"
"241395","Pontifical Catholic University of Puerto Rico-Arecibo","2015","Not on tenure track/No tenure system system total","22","10","12","0","0","0","0","0","0","0","0","0","22","10","12","0","0","0","0","0","0","0","0","0","0","0","0","0","0","0","-2"
"241395","Pontifical Catholic University of Puerto Rico-Arecibo","2015","Not on tenure/no tenure system, professors","3","1","2","0","0","0","0","0","0","0","0","0","3","1","2","0","0","0","0","0","0","0","0","0","0","0","0","0","0","0","-2"
"241395","Pontifical Catholic University of Puerto Rico-Arecibo","2015","Not on tenure/no tenure system, associate professors","2","2","0","0","0","0","0","0","0","0","0","0","2","2","0","0","0","0","0","0","0","0","0","0","0","0","0","0","0","0","-2"
"241395","Pontifical Catholic University of Puerto Rico-Arecibo","2015","Not on tenure/no tenure system, assistant professors","6","2","4","0","0","0","0","0","0","0","0","0","6","2","4","0","0","0","0","0","0","0","0","0","0","0","0","0","0","0","-2"
"241395","Pontifical Catholic University of Puerto Rico-Arecibo","2015","Not on tenure/no tenure system, instructors","1","1","0","0","0","0","0","0","0","0","0","0","1","1","0","0","0","0","0","0","0","0","0","0","0","0","0","0","0","0","-2"
"241395","Pontifical Catholic University of Puerto Rico-Arecibo","2015","Not on tenure/no tenure system, no academic rank","10","4","6","0","0","0","0","0","0","0","0","0","10","4","6","0","0","0","0","0","0","0","0","0","0","0","0","0","0","0","-2"
"241410","Pontifical Catholic University of Puerto Rico-Ponce","2015","Not on tenure track/No tenure system system total","232","93","139","1","1","0","0","0","0","0","0","0","219","86","133","0","0","0","12","6","6","0","0","0","0","0","0","0","0","0","-2"
"241410","Pontifical Catholic University of Puerto Rico-Ponce","2015","Not on tenure/no tenure system, professors","36","17","19","0","0","0","0","0","0","0","0","0","34","15","19","0","0","0","2","2","0","0","0","0","0","0","0","0","0","0","-2"
"241410","Pontifical Catholic University of Puerto Rico-Ponce","2015","Not on tenure/no tenure system, associate professors","59","30","29","0","0","0","0","0","0","0","0","0","53","26","27","0","0","0","6","4","2","0","0","0","0","0","0","0","0","0","-2"
"241410","Pontifical Catholic University of Puerto Rico-Ponce","2015","Not on tenure/no tenure system, assistant professors","70","26","44","0","0","0","0","0","0","0","0","0","68","26","42","0","0","0","2","0","2","0","0","0","0","0","0","0","0","0","-2"
"241410","Pontifical Catholic University of Puerto Rico-Ponce","2015","Not on tenure/no tenure system, instructors","24","9","15","1","1","0","0","0","0","0","0","0","22","8","14","0","0","0","1","0","1","0","0","0","0","0","0","0","0","0","-2"
"241410","Pontifical Catholic University of Puerto Rico-Ponce","2015","Not on tenure/no tenure system, no academic rank","43","11","32","0","0","0","0","0","0","0","0","0","42","11","31","0","0","0","1","0","1","0","0","0","0","0","0","0","0","0","-2"
"241614","Universidad Teologica del Caribe","2015","Tenured total","2","0","2","0","0","0","0","0","0","0","0","0","2","0","2","0","0","0","0","0","0","0","0","0","0","0","0","0","0","0","-2"
"241614","Universidad Teologica del Caribe","2015","Tenured, professors","1","0","1","0","0","0","0","0","0","0","0","0","1","0","1","0","0","0","0","0","0","0","0","0","0","0","0","0","0","0","-2"
"241614","Universidad Teologica del Caribe","2015","Tenured, instructors","1","0","1","0","0","0","0","0","0","0","0","0","1","0","1","0","0","0","0","0","0","0","0","0","0","0","0","0","0","0","-2"
"241614","Universidad Teologica del Caribe","2015","Not on tenure track/No tenure system system total","8","5","3","0","0","0","0","0","0","0","0","0","8","5","3","0","0","0","0","0","0","0","0","0","0","0","0","0","0","0","-2"
"241614","Universidad Teologica del Caribe","2015","Not on tenure/no tenure system, instructors","8","5","3","0","0","0","0","0","0","0","0","0","8","5","3","0","0","0","0","0","0","0","0","0","0","0","0","0","0","0","-2"
"241720","Colegio Universitario de San Juan","2015","Tenured total","27","10","17","0","0","0","0","0","0","0","0","0","27","10","17","0","0","0","0","0","0","0","0","0","0","0","0","0","0","0","-2"
"241720","Colegio Universitario de San Juan","2015","Tenured, professors","1","1","0","0","0","0","0","0","0","0","0","0","1","1","0","0","0","0","0","0","0","0","0","0","0","0","0","0","0","0","-2"
"241720","Colegio Universitario de San Juan","2015","Tenured, associate professors","3","1","2","0","0","0","0","0","0","0","0","0","3","1","2","0","0","0","0","0","0","0","0","0","0","0","0","0","0","0","-2"
"241720","Colegio Universitario de San Juan","2015","Tenured, assistant professors","7","4","3","0","0","0","0","0","0","0","0","0","7","4","3","0","0","0","0","0","0","0","0","0","0","0","0","0","0","0","-2"
"241720","Colegio Universitario de San Juan","2015","Tenured, instructors","16","4","12","0","0","0","0","0","0","0","0","0","16","4","12","0","0","0","0","0","0","0","0","0","0","0","0","0","0","0","-2"
"241739","Universidad Ana G. Mendez-Cupey Campus","2015","Tenured total","24","4","20","0","0","0","0","0","0","0","0","0","24","4","20","0","0","0","0","0","0","0","0","0","0","0","0","0","0","0","-2"
"241739","Universidad Ana G. Mendez-Cupey Campus","2015","Tenured, professors","17","2","15","0","0","0","0","0","0","0","0","0","17","2","15","0","0","0","0","0","0","0","0","0","0","0","0","0","0","0","-2"
"241739","Universidad Ana G. Mendez-Cupey Campus","2015","Tenured, associate professors","6","2","4","0","0","0","0","0","0","0","0","0","6","2","4","0","0","0","0","0","0","0","0","0","0","0","0","0","0","0","-2"
"241739","Universidad Ana G. Mendez-Cupey Campus","2015","Tenured, assistant professors","1","0","1","0","0","0","0","0","0","0","0","0","1","0","1","0","0","0","0","0","0","0","0","0","0","0","0","0","0","0","-2"
"241739","Universidad Ana G. Mendez-Cupey Campus","2015","Not on tenure track/No tenure system system total","168","51","117","0","0","0","0","0","0","0","0","0","162","46","116","0","0","0","4","3","1","0","0","0","2","2","0","0","0","0","-2"
"241739","Universidad Ana G. Mendez-Cupey Campus","2015","Not on tenure/no tenure system, professors","12","7","5","0","0","0","0","0","0","0","0","0","11","6","5","0","0","0","1","1","0","0","0","0","0","0","0","0","0","0","-2"
"241739","Universidad Ana G. Mendez-Cupey Campus","2015","Not on tenure/no tenure system, associate professors","18","7","11","0","0","0","0","0","0","0","0","0","17","6","11","0","0","0","1","1","0","0","0","0","0","0","0","0","0","0","-2"
"241739","Universidad Ana G. Mendez-Cupey Campus","2015","Not on tenure/no tenure system, assistant professors","47","19","28","0","0","0","0","0","0","0","0","0","45","18","27","0","0","0","1","0","1","0","0","0","1","1","0","0","0","0","-2"
"241739","Universidad Ana G. Mendez-Cupey Campus","2015","Not on tenure/no tenure system, instructors","91","18","73","0","0","0","0","0","0","0","0","0","89","16","73","0","0","0","1","1","0","0","0","0","1","1","0","0","0","0","-2"
"241766","Conservatory of Music of Puerto Rico","2015","Tenured total","32","23","9","0","0","0","0","0","0","0","0","0","31","23","8","0","0","0","1","0","1","0","0","0","0","0","0","0","0","0","-2"
"241766","Conservatory of Music of Puerto Rico","2015","Tenured, professors","8","4","4","0","0","0","0","0","0","0","0","0","7","4","3","0","0","0","1","0","1","0","0","0","0","0","0","0","0","0","-2"
"241766","Conservatory of Music of Puerto Rico","2015","Tenured, associate professors","10","8","2","0","0","0","0","0","0","0","0","0","10","8","2","0","0","0","0","0","0","0","0","0","0","0","0","0","0","0","-2"
"241766","Conservatory of Music of Puerto Rico","2015","Tenured, assistant professors","10","8","2","0","0","0","0","0","0","0","0","0","10","8","2","0","0","0","0","0","0","0","0","0","0","0","0","0","0","0","-2"
"241766","Conservatory of Music of Puerto Rico","2015","Tenured, instructors","4","3","1","0","0","0","0","0","0","0","0","0","4","3","1","0","0","0","0","0","0","0","0","0","0","0","0","0","0","0","-2"
"241766","Conservatory of Music of Puerto Rico","2015","On-Tenure track total","7","5","2","0","0","0","0","0","0","0","0","0","7","5","2","0","0","0","0","0","0","0","0","0","0","0","0","0","0","0","-2"
"241766","Conservatory of Music of Puerto Rico","2015","On-tenure track, assistant professors","5","3","2","0","0","0","0","0","0","0","0","0","5","3","2","0","0","0","0","0","0","0","0","0","0","0","0","0","0","0","-2"
"241766","Conservatory of Music of Puerto Rico","2015","On-tenure track, instructors","2","2","0","0","0","0","0","0","0","0","0","0","2","2","0","0","0","0","0","0","0","0","0","0","0","0","0","0","0","0","-2"
"241766","Conservatory of Music of Puerto Rico","2015","Not on tenure track/No tenure system system total","14","11","3","0","0","0","0","0","0","0","0","0","12","10","2","0","0","0","2","1","1","0","0","0","0","0","0","0","0","0","-2"
"241766","Conservatory of Music of Puerto Rico","2015","Not on tenure/no tenure system, instructors","1","1","0","0","0","0","0","0","0","0","0","0","0","0","0","0","0","0","1","1","0","0","0","0","0","0","0","0","0","0","-2"
"241766","Conservatory of Music of Puerto Rico","2015","Not on tenure/no tenure system, no academic rank","13","10","3","0","0","0","0","0","0","0","0","0","12","10","2","0","0","0","1","0","1","0","0","0","0","0","0","0","0","0","-2"
"241836","EDP University of Puerto Rico Inc-San Sebastian","2015","Not on tenure track/No tenure system system total","21","7","14","0","0","0","0","0","0","0","0","0","21","7","14","0","0","0","0","0","0","0","0","0","0","0","0","0","0","0","-2"
"241836","EDP University of Puerto Rico Inc-San Sebastian","2015","Not on tenure/no tenure system, instructors","21","7","14","0","0","0","0","0","0","0","0","0","21","7","14","0","0","0","0","0","0","0","0","0","0","0","0","0","0","0","-2"
"241951","Escuela de Artes Plasticas y Diseno de Puerto Rico","2015","Tenured total","13","8","5","0","0","0","0","0","0","0","0","0","13","8","5","0","0","0","0","0","0","0","0","0","0","0","0","0","0","0","-2"
"241951","Escuela de Artes Plasticas y Diseno de Puerto Rico","2015","Tenured, professors","3","2","1","0","0","0","0","0","0","0","0","0","3","2","1","0","0","0","0","0","0","0","0","0","0","0","0","0","0","0","-2"
"241951","Escuela de Artes Plasticas y Diseno de Puerto Rico","2015","Tenured, associate professors","1","0","1","0","0","0","0","0","0","0","0","0","1","0","1","0","0","0","0","0","0","0","0","0","0","0","0","0","0","0","-2"
"241951","Escuela de Artes Plasticas y Diseno de Puerto Rico","2015","Tenured, assistant professors","1","1","0","0","0","0","0","0","0","0","0","0","1","1","0","0","0","0","0","0","0","0","0","0","0","0","0","0","0","0","-2"
"241951","Escuela de Artes Plasticas y Diseno de Puerto Rico","2015","Tenured, instructors","8","5","3","0","0","0","0","0","0","0","0","0","8","5","3","0","0","0","0","0","0","0","0","0","0","0","0","0","0","0","-2"
"241951","Escuela de Artes Plasticas y Diseno de Puerto Rico","2015","On-Tenure track total","2","2","0","0","0","0","0","0","0","0","0","0","2","2","0","0","0","0","0","0","0","0","0","0","0","0","0","0","0","0","-2"
"241951","Escuela de Artes Plasticas y Diseno de Puerto Rico","2015","On-tenure track, instructors","2","2","0","0","0","0","0","0","0","0","0","0","2","2","0","0","0","0","0","0","0","0","0","0","0","0","0","0","0","0","-2"
"242121","Humacao Community College","2015","Not on tenure track/No tenure system system total","11","4","7","0","0","0","0","0","0","0","0","0","11","4","7","0","0","0","0","0","0","0","0","0","0","0","0","0","0","0","-2"
"242121","Humacao Community College","2015","Not on tenure/no tenure system, professors","11","4","7","0","0","0","0","0","0","0","0","0","11","4","7","0","0","0","0","0","0","0","0","0","0","0","0","0","0","0","-2"
"242617","Inter American University of Puerto Rico-San German","2015","Tenured total","84","36","48","0","0","0","0","0","0","0","0","0","82","34","48","1","1","0","1","1","0","0","0","0","0","0","0","0","0","0","-2"
"242617","Inter American University of Puerto Rico-San German","2015","Tenured, professors","24","14","10","0","0","0","0","0","0","0","0","0","23","13","10","0","0","0","1","1","0","0","0","0","0","0","0","0","0","0","-2"
"242617","Inter American University of Puerto Rico-San German","2015","Tenured, associate professors","39","17","22","0","0","0","0","0","0","0","0","0","38","16","22","1","1","0","0","0","0","0","0","0","0","0","0","0","0","0","-2"
"242617","Inter American University of Puerto Rico-San German","2015","Tenured, assistant professors","21","5","16","0","0","0","0","0","0","0","0","0","21","5","16","0","0","0","0","0","0","0","0","0","0","0","0","0","0","0","-2"
"242617","Inter American University of Puerto Rico-San German","2015","On-Tenure track total","21","9","12","0","0","0","0","0","0","0","0","0","21","9","12","0","0","0","0","0","0","0","0","0","0","0","0","0","0","0","-2"
"242617","Inter American University of Puerto Rico-San German","2015","On-tenure track, associate professors","4","2","2","0","0","0","0","0","0","0","0","0","4","2","2","0","0","0","0","0","0","0","0","0","0","0","0","0","0","0","-2"
"242617","Inter American University of Puerto Rico-San German","2015","On-tenure track, assistant professors","12","4","8","0","0","0","0","0","0","0","0","0","12","4","8","0","0","0","0","0","0","0","0","0","0","0","0","0","0","0","-2"
"242617","Inter American University of Puerto Rico-San German","2015","On-tenure track, instructors","5","3","2","0","0","0","0","0","0","0","0","0","5","3","2","0","0","0","0","0","0","0","0","0","0","0","0","0","0","0","-2"
"242617","Inter American University of Puerto Rico-San German","2015","Not on tenure track/No tenure system system total","4","4","0","0","0","0","0","0","0","0","0","0","4","4","0","0","0","0","0","0","0","0","0","0","0","0","0","0","0","0","-2"
"242617","Inter American University of Puerto Rico-San German","2015","Not on tenure/no tenure system, assistant professors","4","4","0","0","0","0","0","0","0","0","0","0","4","4","0","0","0","0","0","0","0","0","0","0","0","0","0","0","0","0","-2"
"242626","Inter American University of Puerto Rico-Aguadilla","2015","Tenured total","66","27","39","0","0","0","0","0","0","0","0","0","65","27","38","1","0","1","0","0","0","0","0","0","0","0","0","0","0","0","-2"
"242626","Inter American University of Puerto Rico-Aguadilla","2015","Tenured, professors","10","3","7","0","0","0","0","0","0","0","0","0","10","3","7","0","0","0","0","0","0","0","0","0","0","0","0","0","0","0","-2"
"242626","Inter American University of Puerto Rico-Aguadilla","2015","Tenured, associate professors","25","7","18","0","0","0","0","0","0","0","0","0","24","7","17","1","0","1","0","0","0","0","0","0","0","0","0","0","0","0","-2"
"242626","Inter American University of Puerto Rico-Aguadilla","2015","Tenured, assistant professors","28","16","12","0","0","0","0","0","0","0","0","0","28","16","12","0","0","0","0","0","0","0","0","0","0","0","0","0","0","0","-2"
"242626","Inter American University of Puerto Rico-Aguadilla","2015","Tenured, instructors","3","1","2","0","0","0","0","0","0","0","0","0","3","1","2","0","0","0","0","0","0","0","0","0","0","0","0","0","0","0","-2"
"242626","Inter American University of Puerto Rico-Aguadilla","2015","On-Tenure track total","7","2","5","0","0","0","0","0","0","0","0","0","7","2","5","0","0","0","0","0","0","0","0","0","0","0","0","0","0","0","-2"
"242626","Inter American University of Puerto Rico-Aguadilla","2015","On-tenure track, associate professors","2","0","2","0","0","0","0","0","0","0","0","0","2","0","2","0","0","0","0","0","0","0","0","0","0","0","0","0","0","0","-2"
"242626","Inter American University of Puerto Rico-Aguadilla","2015","On-tenure track, assistant professors","3","1","2","0","0","0","0","0","0","0","0","0","3","1","2","0","0","0","0","0","0","0","0","0","0","0","0","0","0","0","-2"
"242626","Inter American University of Puerto Rico-Aguadilla","2015","On-tenure track, instructors","2","1","1","0","0","0","0","0","0","0","0","0","2","1","1","0","0","0","0","0","0","0","0","0","0","0","0","0","0","0","-2"
"242626","Inter American University of Puerto Rico-Aguadilla","2015","Not on tenure track/No tenure system system total","6","1","5","0","0","0","0","0","0","0","0","0","6","1","5","0","0","0","0","0","0","0","0","0","0","0","0","0","0","0","-2"
"242626","Inter American University of Puerto Rico-Aguadilla","2015","Not on tenure/no tenure system, assistant professors","2","0","2","0","0","0","0","0","0","0","0","0","2","0","2","0","0","0","0","0","0","0","0","0","0","0","0","0","0","0","-2"
"242626","Inter American University of Puerto Rico-Aguadilla","2015","Not on tenure/no tenure system, instructors","4","1","3","0","0","0","0","0","0","0","0","0","4","1","3","0","0","0","0","0","0","0","0","0","0","0","0","0","0","0","-2"
"242635","Inter American University of Puerto Rico-Arecibo","2015","Tenured total","54","30","24","0","0","0","0","0","0","0","0","0","54","30","24","0","0","0","0","0","0","0","0","0","0","0","0","0","0","0","-2"
"242635","Inter American University of Puerto Rico-Arecibo","2015","Tenured, professors","18","9","9","0","0","0","0","0","0","0","0","0","18","9","9","0","0","0","0","0","0","0","0","0","0","0","0","0","0","0","-2"
"242635","Inter American University of Puerto Rico-Arecibo","2015","Tenured, associate professors","17","11","6","0","0","0","0","0","0","0","0","0","17","11","6","0","0","0","0","0","0","0","0","0","0","0","0","0","0","0","-2"
"242635","Inter American University of Puerto Rico-Arecibo","2015","Tenured, assistant professors","19","10","9","0","0","0","0","0","0","0","0","0","19","10","9","0","0","0","0","0","0","0","0","0","0","0","0","0","0","0","-2"
"242635","Inter American University of Puerto Rico-Arecibo","2015","On-Tenure track total","18","6","12","0","0","0","0","0","0","0","0","0","18","6","12","0","0","0","0","0","0","0","0","0","0","0","0","0","0","0","-2"
"242635","Inter American University of Puerto Rico-Arecibo","2015","On-tenure track, professors","1","1","0","0","0","0","0","0","0","0","0","0","1","1","0","0","0","0","0","0","0","0","0","0","0","0","0","0","0","0","-2"
"242635","Inter American University of Puerto Rico-Arecibo","2015","On-tenure track, associate professors","1","0","1","0","0","0","0","0","0","0","0","0","1","0","1","0","0","0","0","0","0","0","0","0","0","0","0","0","0","0","-2"
"242635","Inter American University of Puerto Rico-Arecibo","2015","On-tenure track, assistant professors","10","4","6","0","0","0","0","0","0","0","0","0","10","4","6","0","0","0","0","0","0","0","0","0","0","0","0","0","0","0","-2"
"242635","Inter American University of Puerto Rico-Arecibo","2015","On-tenure track, instructors","6","1","5","0","0","0","0","0","0","0","0","0","6","1","5","0","0","0","0","0","0","0","0","0","0","0","0","0","0","0","-2"
"242635","Inter American University of Puerto Rico-Arecibo","2015","Not on tenure track/No tenure system system total","9","3","6","0","0","0","0","0","0","0","0","0","9","3","6","0","0","0","0","0","0","0","0","0","0","0","0","0","0","0","-2"
"242635","Inter American University of Puerto Rico-Arecibo","2015","Not on tenure/no tenure system, assistant professors","3","2","1","0","0","0","0","0","0","0","0","0","3","2","1","0","0","0","0","0","0","0","0","0","0","0","0","0","0","0","-2"
"242635","Inter American University of Puerto Rico-Arecibo","2015","Not on tenure/no tenure system, instructors","6","1","5","0","0","0","0","0","0","0","0","0","6","1","5","0","0","0","0","0","0","0","0","0","0","0","0","0","0","0","-2"
"242644","Inter American University of Puerto Rico-Barranquitas","2015","Tenured total","14","5","9","0","0","0","0","0","0","0","0","0","14","5","9","0","0","0","0","0","0","0","0","0","0","0","0","0","0","0","-2"
"242644","Inter American University of Puerto Rico-Barranquitas","2015","Tenured, professors","1","1","0","0","0","0","0","0","0","0","0","0","1","1","0","0","0","0","0","0","0","0","0","0","0","0","0","0","0","0","-2"
"242644","Inter American University of Puerto Rico-Barranquitas","2015","Tenured, associate professors","5","1","4","0","0","0","0","0","0","0","0","0","5","1","4","0","0","0","0","0","0","0","0","0","0","0","0","0","0","0","-2"
"242644","Inter American University of Puerto Rico-Barranquitas","2015","Tenured, assistant professors","8","3","5","0","0","0","0","0","0","0","0","0","8","3","5","0","0","0","0","0","0","0","0","0","0","0","0","0","0","0","-2"
"242644","Inter American University of Puerto Rico-Barranquitas","2015","On-Tenure track total","12","6","6","0","0","0","0","0","0","0","0","0","12","6","6","0","0","0","0","0","0","0","0","0","0","0","0","0","0","0","-2"
"242644","Inter American University of Puerto Rico-Barranquitas","2015","On-tenure track, associate professors","2","1","1","0","0","0","0","0","0","0","0","0","2","1","1","0","0","0","0","0","0","0","0","0","0","0","0","0","0","0","-2"
"242644","Inter American University of Puerto Rico-Barranquitas","2015","On-tenure track, assistant professors","6","4","2","0","0","0","0","0","0","0","0","0","6","4","2","0","0","0","0","0","0","0","0","0","0","0","0","0","0","0","-2"
"242644","Inter American University of Puerto Rico-Barranquitas","2015","On-tenure track, instructors","4","1","3","0","0","0","0","0","0","0","0","0","4","1","3","0","0","0","0","0","0","0","0","0","0","0","0","0","0","0","-2"
"242644","Inter American University of Puerto Rico-Barranquitas","2015","Not on tenure track/No tenure system system total","6","3","3","0","0","0","0","0","0","0","0","0","6","3","3","0","0","0","0","0","0","0","0","0","0","0","0","0","0","0","-2"
"242644","Inter American University of Puerto Rico-Barranquitas","2015","Not on tenure/no tenure system, assistant professors","2","2","0","0","0","0","0","0","0","0","0","0","2","2","0","0","0","0","0","0","0","0","0","0","0","0","0","0","0","0","-2"
"242644","Inter American University of Puerto Rico-Barranquitas","2015","Not on tenure/no tenure system, instructors","4","1","3","0","0","0","0","0","0","0","0","0","4","1","3","0","0","0","0","0","0","0","0","0","0","0","0","0","0","0","-2"
"242653","Inter American University of Puerto Rico-Metro","2015","Tenured total","161","75","86","0","0","0","0","0","0","0","0","0","160","74","86","0","0","0","1","1","0","0","0","0","0","0","0","0","0","0","-2"
"242653","Inter American University of Puerto Rico-Metro","2015","Tenured, professors","67","29","38","0","0","0","0","0","0","0","0","0","66","28","38","0","0","0","1","1","0","0","0","0","0","0","0","0","0","0","-2"
"242653","Inter American University of Puerto Rico-Metro","2015","Tenured, associate professors","75","37","38","0","0","0","0","0","0","0","0","0","75","37","38","0","0","0","0","0","0","0","0","0","0","0","0","0","0","0","-2"
"242653","Inter American University of Puerto Rico-Metro","2015","Tenured, assistant professors","19","9","10","0","0","0","0","0","0","0","0","0","19","9","10","0","0","0","0","0","0","0","0","0","0","0","0","0","0","0","-2"
"242653","Inter American University of Puerto Rico-Metro","2015","On-Tenure track total","14","8","6","0","0","0","0","0","0","0","0","0","14","8","6","0","0","0","0","0","0","0","0","0","0","0","0","0","0","0","-2"
"242653","Inter American University of Puerto Rico-Metro","2015","On-tenure track, professors","5","3","2","0","0","0","0","0","0","0","0","0","5","3","2","0","0","0","0","0","0","0","0","0","0","0","0","0","0","0","-2"
"242653","Inter American University of Puerto Rico-Metro","2015","On-tenure track, associate professors","1","1","0","0","0","0","0","0","0","0","0","0","1","1","0","0","0","0","0","0","0","0","0","0","0","0","0","0","0","0","-2"
"242653","Inter American University of Puerto Rico-Metro","2015","On-tenure track, assistant professors","7","4","3","0","0","0","0","0","0","0","0","0","7","4","3","0","0","0","0","0","0","0","0","0","0","0","0","0","0","0","-2"
"242653","Inter American University of Puerto Rico-Metro","2015","On-tenure track, instructors","1","0","1","0","0","0","0","0","0","0","0","0","1","0","1","0","0","0","0","0","0","0","0","0","0","0","0","0","0","0","-2"
"242653","Inter American University of Puerto Rico-Metro","2015","Not on tenure track/No tenure system system total","25","9","16","0","0","0","0","0","0","0","0","0","25","9","16","0","0","0","0","0","0","0","0","0","0","0","0","0","0","0","-2"
"242653","Inter American University of Puerto Rico-Metro","2015","Not on tenure/no tenure system, assistant professors","17","6","11","0","0","0","0","0","0","0","0","0","17","6","11","0","0","0","0","0","0","0","0","0","0","0","0","0","0","0","-2"
"242653","Inter American University of Puerto Rico-Metro","2015","Not on tenure/no tenure system, instructors","8","3","5","0","0","0","0","0","0","0","0","0","8","3","5","0","0","0","0","0","0","0","0","0","0","0","0","0","0","0","-2"
"242662","Inter American University of Puerto Rico-Ponce","2015","Tenured total","59","25","34","0","0","0","0","0","0","0","0","0","59","25","34","0","0","0","0","0","0","0","0","0","0","0","0","0","0","0","-2"
"242662","Inter American University of Puerto Rico-Ponce","2015","Tenured, professors","13","3","10","0","0","0","0","0","0","0","0","0","13","3","10","0","0","0","0","0","0","0","0","0","0","0","0","0","0","0","-2"
"242662","Inter American University of Puerto Rico-Ponce","2015","Tenured, associate professors","28","16","12","0","0","0","0","0","0","0","0","0","28","16","12","0","0","0","0","0","0","0","0","0","0","0","0","0","0","0","-2"
"242662","Inter American University of Puerto Rico-Ponce","2015","Tenured, assistant professors","18","6","12","0","0","0","0","0","0","0","0","0","18","6","12","0","0","0","0","0","0","0","0","0","0","0","0","0","0","0","-2"
"242662","Inter American University of Puerto Rico-Ponce","2015","On-Tenure track total","23","10","13","0","0","0","0","0","0","0","0","0","23","10","13","0","0","0","0","0","0","0","0","0","0","0","0","0","0","0","-2"
"242662","Inter American University of Puerto Rico-Ponce","2015","On-tenure track, associate professors","7","4","3","0","0","0","0","0","0","0","0","0","7","4","3","0","0","0","0","0","0","0","0","0","0","0","0","0","0","0","-2"
"242662","Inter American University of Puerto Rico-Ponce","2015","On-tenure track, assistant professors","12","5","7","0","0","0","0","0","0","0","0","0","12","5","7","0","0","0","0","0","0","0","0","0","0","0","0","0","0","0","-2"
"242662","Inter American University of Puerto Rico-Ponce","2015","On-tenure track, instructors","4","1","3","0","0","0","0","0","0","0","0","0","4","1","3","0","0","0","0","0","0","0","0","0","0","0","0","0","0","0","-2"
"242662","Inter American University of Puerto Rico-Ponce","2015","Not on tenure track/No tenure system system total","19","5","14","0","0","0","0","0","0","0","0","0","19","5","14","0","0","0","0","0","0","0","0","0","0","0","0","0","0","0","-2"
"242662","Inter American University of Puerto Rico-Ponce","2015","Not on tenure/no tenure system, assistant professors","11","2","9","0","0","0","0","0","0","0","0","0","11","2","9","0","0","0","0","0","0","0","0","0","0","0","0","0","0","0","-2"
"242662","Inter American University of Puerto Rico-Ponce","2015","Not on tenure/no tenure system, instructors","8","3","5","0","0","0","0","0","0","0","0","0","8","3","5","0","0","0","0","0","0","0","0","0","0","0","0","0","0","0","-2"
"242680","Inter American University of Puerto Rico-Fajardo","2015","Tenured total","25","9","16","0","0","0","0","0","0","0","0","0","25","9","16","0","0","0","0","0","0","0","0","0","0","0","0","0","0","0","-2"
"242680","Inter American University of Puerto Rico-Fajardo","2015","Tenured, professors","4","2","2","0","0","0","0","0","0","0","0","0","4","2","2","0","0","0","0","0","0","0","0","0","0","0","0","0","0","0","-2"
"242680","Inter American University of Puerto Rico-Fajardo","2015","Tenured, associate professors","10","5","5","0","0","0","0","0","0","0","0","0","10","5","5","0","0","0","0","0","0","0","0","0","0","0","0","0","0","0","-2"
"242680","Inter American University of Puerto Rico-Fajardo","2015","Tenured, assistant professors","11","2","9","0","0","0","0","0","0","0","0","0","11","2","9","0","0","0","0","0","0","0","0","0","0","0","0","0","0","0","-2"
"242680","Inter American University of Puerto Rico-Fajardo","2015","On-Tenure track total","10","5","5","0","0","0","0","0","0","0","0","0","10","5","5","0","0","0","0","0","0","0","0","0","0","0","0","0","0","0","-2"
"242680","Inter American University of Puerto Rico-Fajardo","2015","On-tenure track, assistant professors","10","5","5","0","0","0","0","0","0","0","0","0","10","5","5","0","0","0","0","0","0","0","0","0","0","0","0","0","0","0","-2"
"242680","Inter American University of Puerto Rico-Fajardo","2015","Not on tenure track/No tenure system system total","5","1","4","0","0","0","0","0","0","0","0","0","5","1","4","0","0","0","0","0","0","0","0","0","0","0","0","0","0","0","-2"
"242680","Inter American University of Puerto Rico-Fajardo","2015","Not on tenure/no tenure system, assistant professors","3","0","3","0","0","0","0","0","0","0","0","0","3","0","3","0","0","0","0","0","0","0","0","0","0","0","0","0","0","0","-2"
"242680","Inter American University of Puerto Rico-Fajardo","2015","Not on tenure/no tenure system, instructors","2","1","1","0","0","0","0","0","0","0","0","0","2","1","1","0","0","0","0","0","0","0","0","0","0","0","0","0","0","0","-2"
"242699","Inter American University of Puerto Rico-Guayama","2015","Tenured total","32","15","17","0","0","0","0","0","0","0","0","0","32","15","17","0","0","0","0","0","0","0","0","0","0","0","0","0","0","0","-2"
"242699","Inter American University of Puerto Rico-Guayama","2015","Tenured, professors","6","4","2","0","0","0","0","0","0","0","0","0","6","4","2","0","0","0","0","0","0","0","0","0","0","0","0","0","0","0","-2"
"242699","Inter American University of Puerto Rico-Guayama","2015","Tenured, associate professors","11","4","7","0","0","0","0","0","0","0","0","0","11","4","7","0","0","0","0","0","0","0","0","0","0","0","0","0","0","0","-2"
"242699","Inter American University of Puerto Rico-Guayama","2015","Tenured, assistant professors","15","7","8","0","0","0","0","0","0","0","0","0","15","7","8","0","0","0","0","0","0","0","0","0","0","0","0","0","0","0","-2"
"242699","Inter American University of Puerto Rico-Guayama","2015","On-Tenure track total","5","3","2","0","0","0","0","0","0","0","0","0","5","3","2","0","0","0","0","0","0","0","0","0","0","0","0","0","0","0","-2"
"242699","Inter American University of Puerto Rico-Guayama","2015","On-tenure track, associate professors","2","1","1","0","0","0","0","0","0","0","0","0","2","1","1","0","0","0","0","0","0","0","0","0","0","0","0","0","0","0","-2"
"242699","Inter American University of Puerto Rico-Guayama","2015","On-tenure track, assistant professors","1","0","1","0","0","0","0","0","0","0","0","0","1","0","1","0","0","0","0","0","0","0","0","0","0","0","0","0","0","0","-2"
"242699","Inter American University of Puerto Rico-Guayama","2015","On-tenure track, instructors","2","2","0","0","0","0","0","0","0","0","0","0","2","2","0","0","0","0","0","0","0","0","0","0","0","0","0","0","0","0","-2"
"242699","Inter American University of Puerto Rico-Guayama","2015","Not on tenure track/No tenure system system total","5","2","3","0","0","0","0","0","0","0","0","0","5","2","3","0","0","0","0","0","0","0","0","0","0","0","0","0","0","0","-2"
"242699","Inter American University of Puerto Rico-Guayama","2015","Not on tenure/no tenure system, assistant professors","1","1","0","0","0","0","0","0","0","0","0","0","1","1","0","0","0","0","0","0","0","0","0","0","0","0","0","0","0","0","-2"
"242699","Inter American University of Puerto Rico-Guayama","2015","Not on tenure/no tenure system, instructors","4","1","3","0","0","0","0","0","0","0","0","0","4","1","3","0","0","0","0","0","0","0","0","0","0","0","0","0","0","0","-2"
"242705","Inter American University of Puerto Rico-Bayamon","2015","Tenured total","55","32","23","0","0","0","0","0","0","0","0","0","55","32","23","0","0","0","0","0","0","0","0","0","0","0","0","0","0","0","-2"
"242705","Inter American University of Puerto Rico-Bayamon","2015","Tenured, professors","9","9","0","0","0","0","0","0","0","0","0","0","9","9","0","0","0","0","0","0","0","0","0","0","0","0","0","0","0","0","-2"
"242705","Inter American University of Puerto Rico-Bayamon","2015","Tenured, associate professors","22","10","12","0","0","0","0","0","0","0","0","0","22","10","12","0","0","0","0","0","0","0","0","0","0","0","0","0","0","0","-2"
"242705","Inter American University of Puerto Rico-Bayamon","2015","Tenured, assistant professors","24","13","11","0","0","0","0","0","0","0","0","0","24","13","11","0","0","0","0","0","0","0","0","0","0","0","0","0","0","0","-2"
"242705","Inter American University of Puerto Rico-Bayamon","2015","On-Tenure track total","31","19","12","0","0","0","0","0","0","0","0","0","31","19","12","0","0","0","0","0","0","0","0","0","0","0","0","0","0","0","-2"
"242705","Inter American University of Puerto Rico-Bayamon","2015","On-tenure track, professors","1","1","0","0","0","0","0","0","0","0","0","0","1","1","0","0","0","0","0","0","0","0","0","0","0","0","0","0","0","0","-2"
"242705","Inter American University of Puerto Rico-Bayamon","2015","On-tenure track, associate professors","6","5","1","0","0","0","0","0","0","0","0","0","6","5","1","0","0","0","0","0","0","0","0","0","0","0","0","0","0","0","-2"
"242705","Inter American University of Puerto Rico-Bayamon","2015","On-tenure track, assistant professors","14","7","7","0","0","0","0","0","0","0","0","0","14","7","7","0","0","0","0","0","0","0","0","0","0","0","0","0","0","0","-2"
"242705","Inter American University of Puerto Rico-Bayamon","2015","On-tenure track, instructors","10","6","4","0","0","0","0","0","0","0","0","0","10","6","4","0","0","0","0","0","0","0","0","0","0","0","0","0","0","0","-2"
"242705","Inter American University of Puerto Rico-Bayamon","2015","Not on tenure track/No tenure system system total","8","6","2","0","0","0","0","0","0","0","0","0","6","4","2","2","2","0","0","0","0","0","0","0","0","0","0","0","0","0","-2"
"242705","Inter American University of Puerto Rico-Bayamon","2015","Not on tenure/no tenure system, professors","1","1","0","0","0","0","0","0","0","0","0","0","1","1","0","0","0","0","0","0","0","0","0","0","0","0","0","0","0","0","-2"
"242705","Inter American University of Puerto Rico-Bayamon","2015","Not on tenure/no tenure system, assistant professors","2","2","0","0","0","0","0","0","0","0","0","0","0","0","0","2","2","0","0","0","0","0","0","0","0","0","0","0","0","0","-2"
"242705","Inter American University of Puerto Rico-Bayamon","2015","Not on tenure/no tenure system, instructors","5","3","2","0","0","0","0","0","0","0","0","0","5","3","2","0","0","0","0","0","0","0","0","0","0","0","0","0","0","0","-2"
"243106","University of Puerto Rico-Aguadilla","2015","Tenured total","89","47","42","0","0","0","0","0","0","0","0","0","89","47","42","0","0","0","0","0","0","0","0","0","0","0","0","0","0","0","-2"
"243106","University of Puerto Rico-Aguadilla","2015","Tenured, professors","42","21","21","0","0","0","0","0","0","0","0","0","42","21","21","0","0","0","0","0","0","0","0","0","0","0","0","0","0","0","-2"
"243106","University of Puerto Rico-Aguadilla","2015","Tenured, associate professors","32","19","13","0","0","0","0","0","0","0","0","0","32","19","13","0","0","0","0","0","0","0","0","0","0","0","0","0","0","0","-2"
"243106","University of Puerto Rico-Aguadilla","2015","Tenured, assistant professors","14","6","8","0","0","0","0","0","0","0","0","0","14","6","8","0","0","0","0","0","0","0","0","0","0","0","0","0","0","0","-2"
"243106","University of Puerto Rico-Aguadilla","2015","Tenured, instructors","1","1","0","0","0","0","0","0","0","0","0","0","1","1","0","0","0","0","0","0","0","0","0","0","0","0","0","0","0","0","-2"
"243106","University of Puerto Rico-Aguadilla","2015","On-Tenure track total","5","1","4","0","0","0","0","0","0","0","0","0","5","1","4","0","0","0","0","0","0","0","0","0","0","0","0","0","0","0","-2"
"243106","University of Puerto Rico-Aguadilla","2015","On-tenure track, assistant professors","3","1","2","0","0","0","0","0","0","0","0","0","3","1","2","0","0","0","0","0","0","0","0","0","0","0","0","0","0","0","-2"
"243106","University of Puerto Rico-Aguadilla","2015","On-tenure track, instructors","2","0","2","0","0","0","0","0","0","0","0","0","2","0","2","0","0","0","0","0","0","0","0","0","0","0","0","0","0","0","-2"
"243106","University of Puerto Rico-Aguadilla","2015","Not on tenure track/No tenure system system total","19","6","13","0","0","0","0","0","0","0","0","0","17","5","12","0","0","0","2","1","1","0","0","0","0","0","0","0","0","0","-2"
"243106","University of Puerto Rico-Aguadilla","2015","Not on tenure/no tenure system, assistant professors","10","4","6","0","0","0","0","0","0","0","0","0","8","3","5","0","0","0","2","1","1","0","0","0","0","0","0","0","0","0","-2"
"243106","University of Puerto Rico-Aguadilla","2015","Not on tenure/no tenure system, instructors","9","2","7","0","0","0","0","0","0","0","0","0","9","2","7","0","0","0","0","0","0","0","0","0","0","0","0","0","0","0","-2"
"243115","University of Puerto Rico-Arecibo","2015","Tenured total","145","71","74","0","0","0","0","0","0","1","0","1","144","71","73","0","0","0","0","0","0","0","0","0","0","0","0","0","0","0","-2"
"243115","University of Puerto Rico-Arecibo","2015","Tenured, professors","78","37","41","0","0","0","0","0","0","0","0","0","78","37","41","0","0","0","0","0","0","0","0","0","0","0","0","0","0","0","-2"
"243115","University of Puerto Rico-Arecibo","2015","Tenured, associate professors","37","16","21","0","0","0","0","0","0","0","0","0","37","16","21","0","0","0","0","0","0","0","0","0","0","0","0","0","0","0","-2"
"243115","University of Puerto Rico-Arecibo","2015","Tenured, assistant professors","28","16","12","0","0","0","0","0","0","1","0","1","27","16","11","0","0","0","0","0","0","0","0","0","0","0","0","0","0","0","-2"
"243115","University of Puerto Rico-Arecibo","2015","Tenured, instructors","2","2","0","0","0","0","0","0","0","0","0","0","2","2","0","0","0","0","0","0","0","0","0","0","0","0","0","0","0","0","-2"
"243115","University of Puerto Rico-Arecibo","2015","On-Tenure track total","10","5","5","0","0","0","0","0","0","0","0","0","10","5","5","0","0","0","0","0","0","0","0","0","0","0","0","0","0","0","-2"
"243115","University of Puerto Rico-Arecibo","2015","On-tenure track, assistant professors","7","3","4","0","0","0","0","0","0","0","0","0","7","3","4","0","0","0","0","0","0","0","0","0","0","0","0","0","0","0","-2"
"243115","University of Puerto Rico-Arecibo","2015","On-tenure track, instructors","3","2","1","0","0","0","0","0","0","0","0","0","3","2","1","0","0","0","0","0","0","0","0","0","0","0","0","0","0","0","-2"
"243115","University of Puerto Rico-Arecibo","2015","Not on tenure track/No tenure system system total","20","6","14","0","0","0","0","0","0","0","0","0","20","6","14","0","0","0","0","0","0","0","0","0","0","0","0","0","0","0","-2"
"243115","University of Puerto Rico-Arecibo","2015","Not on tenure/no tenure system, assistant professors","1","0","1","0","0","0","0","0","0","0","0","0","1","0","1","0","0","0","0","0","0","0","0","0","0","0","0","0","0","0","-2"
"243115","University of Puerto Rico-Arecibo","2015","Not on tenure/no tenure system, instructors","19","6","13","0","0","0","0","0","0","0","0","0","19","6","13","0","0","0","0","0","0","0","0","0","0","0","0","0","0","0","-2"
"243133","University of Puerto Rico-Bayamon","2015","Tenured total","129","62","67","0","0","0","0","0","0","0","0","0","129","62","67","0","0","0","0","0","0","0","0","0","0","0","0","0","0","0","-2"
"243133","University of Puerto Rico-Bayamon","2015","Tenured, professors","64","35","29","0","0","0","0","0","0","0","0","0","64","35","29","0","0","0","0","0","0","0","0","0","0","0","0","0","0","0","-2"
"243133","University of Puerto Rico-Bayamon","2015","Tenured, associate professors","39","15","24","0","0","0","0","0","0","0","0","0","39","15","24","0","0","0","0","0","0","0","0","0","0","0","0","0","0","0","-2"
"243133","University of Puerto Rico-Bayamon","2015","Tenured, assistant professors","26","12","14","0","0","0","0","0","0","0","0","0","26","12","14","0","0","0","0","0","0","0","0","0","0","0","0","0","0","0","-2"
"243133","University of Puerto Rico-Bayamon","2015","On-Tenure track total","18","9","9","0","0","0","0","0","0","0","0","0","18","9","9","0","0","0","0","0","0","0","0","0","0","0","0","0","0","0","-2"
"243133","University of Puerto Rico-Bayamon","2015","On-tenure track, associate professors","1","1","0","0","0","0","0","0","0","0","0","0","1","1","0","0","0","0","0","0","0","0","0","0","0","0","0","0","0","0","-2"
"243133","University of Puerto Rico-Bayamon","2015","On-tenure track, assistant professors","11","5","6","0","0","0","0","0","0","0","0","0","11","5","6","0","0","0","0","0","0","0","0","0","0","0","0","0","0","0","-2"
"243133","University of Puerto Rico-Bayamon","2015","On-tenure track, instructors","6","3","3","0","0","0","0","0","0","0","0","0","6","3","3","0","0","0","0","0","0","0","0","0","0","0","0","0","0","0","-2"
"243133","University of Puerto Rico-Bayamon","2015","Not on tenure track/No tenure system system total","58","25","33","0","0","0","0","0","0","0","0","0","58","25","33","0","0","0","0","0","0","0","0","0","0","0","0","0","0","0","-2"
"243133","University of Puerto Rico-Bayamon","2015","Not on tenure/no tenure system, assistant professors","22","7","15","0","0","0","0","0","0","0","0","0","22","7","15","0","0","0","0","0","0","0","0","0","0","0","0","0","0","0","-2"
"243133","University of Puerto Rico-Bayamon","2015","Not on tenure/no tenure system, instructors","36","18","18","0","0","0","0","0","0","0","0","0","36","18","18","0","0","0","0","0","0","0","0","0","0","0","0","0","0","0","-2"
"243142","University of Puerto Rico-Carolina","2015","Tenured total","71","42","29","0","0","0","0","0","0","0","0","0","69","40","29","0","0","0","2","2","0","0","0","0","0","0","0","0","0","0","-2"
"243142","University of Puerto Rico-Carolina","2015","Tenured, professors","23","15","8","0","0","0","0","0","0","0","0","0","23","15","8","0","0","0","0","0","0","0","0","0","0","0","0","0","0","0","-2"
"243142","University of Puerto Rico-Carolina","2015","Tenured, associate professors","30","17","13","0","0","0","0","0","0","0","0","0","28","15","13","0","0","0","2","2","0","0","0","0","0","0","0","0","0","0","-2"
"243142","University of Puerto Rico-Carolina","2015","Tenured, assistant professors","14","8","6","0","0","0","0","0","0","0","0","0","14","8","6","0","0","0","0","0","0","0","0","0","0","0","0","0","0","0","-2"
"243142","University of Puerto Rico-Carolina","2015","Tenured, instructors","4","2","2","0","0","0","0","0","0","0","0","0","4","2","2","0","0","0","0","0","0","0","0","0","0","0","0","0","0","0","-2"
"243142","University of Puerto Rico-Carolina","2015","On-Tenure track total","14","7","7","0","0","0","0","0","0","0","0","0","14","7","7","0","0","0","0","0","0","0","0","0","0","0","0","0","0","0","-2"
"243142","University of Puerto Rico-Carolina","2015","On-tenure track, assistant professors","4","3","1","0","0","0","0","0","0","0","0","0","4","3","1","0","0","0","0","0","0","0","0","0","0","0","0","0","0","0","-2"
"243142","University of Puerto Rico-Carolina","2015","On-tenure track, instructors","10","4","6","0","0","0","0","0","0","0","0","0","10","4","6","0","0","0","0","0","0","0","0","0","0","0","0","0","0","0","-2"
"243142","University of Puerto Rico-Carolina","2015","Not on tenure track/No tenure system system total","17","9","8","0","0","0","0","0","0","0","0","0","16","9","7","0","0","0","1","0","1","0","0","0","0","0","0","0","0","0","-2"
"243142","University of Puerto Rico-Carolina","2015","Not on tenure/no tenure system, assistant professors","3","1","2","0","0","0","0","0","0","0","0","0","3","1","2","0","0","0","0","0","0","0","0","0","0","0","0","0","0","0","-2"
"243142","University of Puerto Rico-Carolina","2015","Not on tenure/no tenure system, instructors","14","8","6","0","0","0","0","0","0","0","0","0","13","8","5","0","0","0","1","0","1","0","0","0","0","0","0","0","0","0","-2"
"243151","University of Puerto Rico-Cayey","2015","Tenured total","89","51","38","0","0","0","0","0","0","0","0","0","89","51","38","0","0","0","0","0","0","0","0","0","0","0","0","0","0","0","-2"
"243151","University of Puerto Rico-Cayey","2015","Tenured, professors","50","26","24","0","0","0","0","0","0","0","0","0","50","26","24","0","0","0","0","0","0","0","0","0","0","0","0","0","0","0","-2"
"243151","University of Puerto Rico-Cayey","2015","Tenured, associate professors","22","14","8","0","0","0","0","0","0","0","0","0","22","14","8","0","0","0","0","0","0","0","0","0","0","0","0","0","0","0","-2"
"243151","University of Puerto Rico-Cayey","2015","Tenured, assistant professors","14","10","4","0","0","0","0","0","0","0","0","0","14","10","4","0","0","0","0","0","0","0","0","0","0","0","0","0","0","0","-2"
"243151","University of Puerto Rico-Cayey","2015","Tenured, instructors","3","1","2","0","0","0","0","0","0","0","0","0","3","1","2","0","0","0","0","0","0","0","0","0","0","0","0","0","0","0","-2"
"243151","University of Puerto Rico-Cayey","2015","On-Tenure track total","18","10","8","0","0","0","0","0","0","0","0","0","18","10","8","0","0","0","0","0","0","0","0","0","0","0","0","0","0","0","-2"
"243151","University of Puerto Rico-Cayey","2015","On-tenure track, professors","1","1","0","0","0","0","0","0","0","0","0","0","1","1","0","0","0","0","0","0","0","0","0","0","0","0","0","0","0","0","-2"
"243151","University of Puerto Rico-Cayey","2015","On-tenure track, associate professors","1","0","1","0","0","0","0","0","0","0","0","0","1","0","1","0","0","0","0","0","0","0","0","0","0","0","0","0","0","0","-2"
"243151","University of Puerto Rico-Cayey","2015","On-tenure track, assistant professors","16","9","7","0","0","0","0","0","0","0","0","0","16","9","7","0","0","0","0","0","0","0","0","0","0","0","0","0","0","0","-2"
"243151","University of Puerto Rico-Cayey","2015","Not on tenure track/No tenure system system total","1","0","1","0","0","0","0","0","0","0","0","0","1","0","1","0","0","0","0","0","0","0","0","0","0","0","0","0","0","0","-2"
"243151","University of Puerto Rico-Cayey","2015","Not on tenure/no tenure system, assistant professors","1","0","1","0","0","0","0","0","0","0","0","0","1","0","1","0","0","0","0","0","0","0","0","0","0","0","0","0","0","0","-2"
"243179","University of Puerto Rico-Humacao","2015","Tenured total","160","79","81","0","0","0","0","0","0","0","0","0","112","53","59","0","0","0","0","0","0","7","5","2","40","20","20","1","1","0","-2"
"243179","University of Puerto Rico-Humacao","2015","Tenured, professors","96","50","46","0","0","0","0","0","0","0","0","0","65","33","32","0","0","0","0","0","0","5","4","1","26","13","13","0","0","0","-2"
"243179","University of Puerto Rico-Humacao","2015","Tenured, associate professors","50","18","32","0","0","0","0","0","0","0","0","0","37","12","25","0","0","0","0","0","0","2","1","1","10","4","6","1","1","0","-2"
"243179","University of Puerto Rico-Humacao","2015","Tenured, assistant professors","13","10","3","0","0","0","0","0","0","0","0","0","10","8","2","0","0","0","0","0","0","0","0","0","3","2","1","0","0","0","-2"
"243179","University of Puerto Rico-Humacao","2015","Tenured, instructors","1","1","0","0","0","0","0","0","0","0","0","0","0","0","0","0","0","0","0","0","0","0","0","0","1","1","0","0","0","0","-2"
"243179","University of Puerto Rico-Humacao","2015","On-Tenure track total","8","3","5","0","0","0","0","0","0","0","0","0","8","3","5","0","0","0","0","0","0","0","0","0","0","0","0","0","0","0","-2"
"243179","University of Puerto Rico-Humacao","2015","On-tenure track, assistant professors","6","2","4","0","0","0","0","0","0","0","0","0","6","2","4","0","0","0","0","0","0","0","0","0","0","0","0","0","0","0","-2"
"243179","University of Puerto Rico-Humacao","2015","On-tenure track, instructors","2","1","1","0","0","0","0","0","0","0","0","0","2","1","1","0","0","0","0","0","0","0","0","0","0","0","0","0","0","0","-2"
"243179","University of Puerto Rico-Humacao","2015","Not on tenure track/No tenure system system total","10","4","6","0","0","0","0","0","0","0","0","0","8","2","6","0","0","0","0","0","0","0","0","0","2","2","0","0","0","0","-2"
"243179","University of Puerto Rico-Humacao","2015","Not on tenure/no tenure system, assistant professors","1","1","0","0","0","0","0","0","0","0","0","0","1","1","0","0","0","0","0","0","0","0","0","0","0","0","0","0","0","0","-2"
"243179","University of Puerto Rico-Humacao","2015","Not on tenure/no tenure system, instructors","9","3","6","0","0","0","0","0","0","0","0","0","7","1","6","0","0","0","0","0","0","0","0","0","2","2","0","0","0","0","-2"
"243188","University of Puerto Rico-Utuado","2015","Tenured total","50","30","20","0","0","0","0","0","0","0","0","0","43","26","17","0","0","0","0","0","0","0","0","0","7","4","3","0","0","0","-2"
"243188","University of Puerto Rico-Utuado","2015","Tenured, professors","16","10","6","0","0","0","0","0","0","0","0","0","15","9","6","0","0","0","0","0","0","0","0","0","1","1","0","0","0","0","-2"
"243188","University of Puerto Rico-Utuado","2015","Tenured, associate professors","18","9","9","0","0","0","0","0","0","0","0","0","15","8","7","0","0","0","0","0","0","0","0","0","3","1","2","0","0","0","-2"
"243188","University of Puerto Rico-Utuado","2015","Tenured, assistant professors","14","9","5","0","0","0","0","0","0","0","0","0","11","7","4","0","0","0","0","0","0","0","0","0","3","2","1","0","0","0","-2"
"243188","University of Puerto Rico-Utuado","2015","Tenured, instructors","2","2","0","0","0","0","0","0","0","0","0","0","2","2","0","0","0","0","0","0","0","0","0","0","0","0","0","0","0","0","-2"
"243188","University of Puerto Rico-Utuado","2015","On-Tenure track total","1","0","1","0","0","0","0","0","0","0","0","0","1","0","1","0","0","0","0","0","0","0","0","0","0","0","0","0","0","0","-2"
"243188","University of Puerto Rico-Utuado","2015","On-tenure track, assistant professors","1","0","1","0","0","0","0","0","0","0","0","0","1","0","1","0","0","0","0","0","0","0","0","0","0","0","0","0","0","0","-2"
"243188","University of Puerto Rico-Utuado","2015","Not on tenure track/No tenure system system total","15","5","10","0","0","0","0","0","0","0","0","0","13","3","10","0","0","0","0","0","0","0","0","0","2","2","0","0","0","0","-2"
"243188","University of Puerto Rico-Utuado","2015","Not on tenure/no tenure system, assistant professors","6","1","5","0","0","0","0","0","0","0","0","0","6","1","5","0","0","0","0","0","0","0","0","0","0","0","0","0","0","0","-2"
"243188","University of Puerto Rico-Utuado","2015","Not on tenure/no tenure system, instructors","9","4","5","0","0","0","0","0","0","0","0","0","7","2","5","0","0","0","0","0","0","0","0","0","2","2","0","0","0","0","-2"
"243197","University of Puerto Rico-Mayaguez","2015","Tenured total","508","324","184","16","12","4","19","15","4","26","16","10","186","112","74","6","4","2","226","146","80","27","17","10","2","2","0","0","0","0","-2"
"243197","University of Puerto Rico-Mayaguez","2015","Tenured, professors","364","245","119","12","10","2","17","13","4","13","11","2","127","82","45","5","4","1","171","111","60","17","12","5","2","2","0","0","0","0","-2"
"243197","University of Puerto Rico-Mayaguez","2015","Tenured, associate professors","128","72","56","4","2","2","2","2","0","13","5","8","50","26","24","1","0","1","48","32","16","10","5","5","0","0","0","0","0","0","-2"
"243197","University of Puerto Rico-Mayaguez","2015","Tenured, assistant professors","14","5","9","0","0","0","0","0","0","0","0","0","7","2","5","0","0","0","7","3","4","0","0","0","0","0","0","0","0","0","-2"
"243197","University of Puerto Rico-Mayaguez","2015","Tenured, instructors","1","1","0","0","0","0","0","0","0","0","0","0","1","1","0","0","0","0","0","0","0","0","0","0","0","0","0","0","0","0","-2"
"243197","University of Puerto Rico-Mayaguez","2015","Tenured, no academic rank","1","1","0","0","0","0","0","0","0","0","0","0","1","1","0","0","0","0","0","0","0","0","0","0","0","0","0","0","0","0","-2"
"243197","University of Puerto Rico-Mayaguez","2015","On-Tenure track total","79","43","36","1","1","0","0","0","0","0","0","0","74","41","33","0","0","0","2","0","2","2","1","1","0","0","0","0","0","0","-2"
"243197","University of Puerto Rico-Mayaguez","2015","On-tenure track, associate professors","9","4","5","1","1","0","0","0","0","0","0","0","7","3","4","0","0","0","1","0","1","0","0","0","0","0","0","0","0","0","-2"
"243197","University of Puerto Rico-Mayaguez","2015","On-tenure track, assistant professors","70","39","31","0","0","0","0","0","0","0","0","0","67","38","29","0","0","0","1","0","1","2","1","1","0","0","0","0","0","0","-2"
"243197","University of Puerto Rico-Mayaguez","2015","Not on tenure track/No tenure system system total","38","19","19","0","0","0","0","0","0","0","0","0","34","19","15","0","0","0","3","0","3","1","0","1","0","0","0","0","0","0","-2"
"243197","University of Puerto Rico-Mayaguez","2015","Not on tenure/no tenure system, professors","1","1","0","0","0","0","0","0","0","0","0","0","1","1","0","0","0","0","0","0","0","0","0","0","0","0","0","0","0","0","-2"
"243197","University of Puerto Rico-Mayaguez","2015","Not on tenure/no tenure system, associate professors","1","0","1","0","0","0","0","0","0","0","0","0","1","0","1","0","0","0","0","0","0","0","0","0","0","0","0","0","0","0","-2"
"243197","University of Puerto Rico-Mayaguez","2015","Not on tenure/no tenure system, assistant professors","15","8","7","0","0","0","0","0","0","0","0","0","14","8","6","0","0","0","0","0","0","1","0","1","0","0","0","0","0","0","-2"
"243197","University of Puerto Rico-Mayaguez","2015","Not on tenure/no tenure system, instructors","21","10","11","0","0","0","0","0","0","0","0","0","18","10","8","0","0","0","3","0","3","0","0","0","0","0","0","0","0","0","-2"
"243203","University of Puerto Rico-Medical Sciences","2015","Tenured total","369","158","211","0","0","0","2","1","1","0","0","0","353","146","207","0","0","0","14","11","3","0","0","0","0","0","0","0","0","0","-2"
"243203","University of Puerto Rico-Medical Sciences","2015","Tenured, professors","251","117","134","0","0","0","2","1","1","0","0","0","238","107","131","0","0","0","11","9","2","0","0","0","0","0","0","0","0","0","-2"
"243203","University of Puerto Rico-Medical Sciences","2015","Tenured, associate professors","89","32","57","0","0","0","0","0","0","0","0","0","86","30","56","0","0","0","3","2","1","0","0","0","0","0","0","0","0","0","-2"
"243203","University of Puerto Rico-Medical Sciences","2015","Tenured, assistant professors","29","9","20","0","0","0","0","0","0","0","0","0","29","9","20","0","0","0","0","0","0","0","0","0","0","0","0","0","0","0","-2"
"243203","University of Puerto Rico-Medical Sciences","2015","On-Tenure track total","101","45","56","0","0","0","1","0","1","0","0","0","99","44","55","0","0","0","1","1","0","0","0","0","0","0","0","0","0","0","-2"
"243203","University of Puerto Rico-Medical Sciences","2015","On-tenure track, professors","16","11","5","0","0","0","0","0","0","0","0","0","16","11","5","0","0","0","0","0","0","0","0","0","0","0","0","0","0","0","-2"
"243203","University of Puerto Rico-Medical Sciences","2015","On-tenure track, associate professors","26","9","17","0","0","0","1","0","1","0","0","0","25","9","16","0","0","0","0","0","0","0","0","0","0","0","0","0","0","0","-2"
"243203","University of Puerto Rico-Medical Sciences","2015","On-tenure track, assistant professors","50","24","26","0","0","0","0","0","0","0","0","0","49","23","26","0","0","0","1","1","0","0","0","0","0","0","0","0","0","0","-2"
"243203","University of Puerto Rico-Medical Sciences","2015","On-tenure track, instructors","9","1","8","0","0","0","0","0","0","0","0","0","9","1","8","0","0","0","0","0","0","0","0","0","0","0","0","0","0","0","-2"
"243203","University of Puerto Rico-Medical Sciences","2015","Not on tenure track/No tenure system system total","157","51","106","0","0","0","0","0","0","1","0","1","155","51","104","0","0","0","1","0","1","0","0","0","0","0","0","0","0","0","-2"
"243203","University of Puerto Rico-Medical Sciences","2015","Not on tenure/no tenure system, professors","8","4","4","0","0","0","0","0","0","0","0","0","8","4","4","0","0","0","0","0","0","0","0","0","0","0","0","0","0","0","-2"
"243203","University of Puerto Rico-Medical Sciences","2015","Not on tenure/no tenure system, associate professors","17","7","10","0","0","0","0","0","0","1","0","1","16","7","9","0","0","0","0","0","0","0","0","0","0","0","0","0","0","0","-2"
"243203","University of Puerto Rico-Medical Sciences","2015","Not on tenure/no tenure system, assistant professors","82","31","51","0","0","0","0","0","0","0","0","0","82","31","51","0","0","0","0","0","0","0","0","0","0","0","0","0","0","0","-2"
"243203","University of Puerto Rico-Medical Sciences","2015","Not on tenure/no tenure system, instructors","13","2","11","0","0","0","0","0","0","0","0","0","13","2","11","0","0","0","0","0","0","0","0","0","0","0","0","0","0","0","-2"
"243203","University of Puerto Rico-Medical Sciences","2015","Not on tenure/no tenure system, no academic rank","37","7","30","0","0","0","0","0","0","0","0","0","36","7","29","0","0","0","1","0","1","0","0","0","0","0","0","0","0","0","-2"
"243212","University of Puerto Rico-Ponce","2015","Tenured total","84","34","50","0","0","0","0","0","0","0","0","0","84","34","50","0","0","0","0","0","0","0","0","0","0","0","0","0","0","0","-2"
"243212","University of Puerto Rico-Ponce","2015","Tenured, professors","34","13","21","0","0","0","0","0","0","0","0","0","34","13","21","0","0","0","0","0","0","0","0","0","0","0","0","0","0","0","-2"
"243212","University of Puerto Rico-Ponce","2015","Tenured, associate professors","19","8","11","0","0","0","0","0","0","0","0","0","19","8","11","0","0","0","0","0","0","0","0","0","0","0","0","0","0","0","-2"
"243212","University of Puerto Rico-Ponce","2015","Tenured, assistant professors","24","7","17","0","0","0","0","0","0","0","0","0","24","7","17","0","0","0","0","0","0","0","0","0","0","0","0","0","0","0","-2"
"243212","University of Puerto Rico-Ponce","2015","Tenured, instructors","7","6","1","0","0","0","0","0","0","0","0","0","7","6","1","0","0","0","0","0","0","0","0","0","0","0","0","0","0","0","-2"
"243212","University of Puerto Rico-Ponce","2015","On-Tenure track total","3","0","3","0","0","0","0","0","0","0","0","0","3","0","3","0","0","0","0","0","0","0","0","0","0","0","0","0","0","0","-2"
"243212","University of Puerto Rico-Ponce","2015","On-tenure track, assistant professors","2","0","2","0","0","0","0","0","0","0","0","0","2","0","2","0","0","0","0","0","0","0","0","0","0","0","0","0","0","0","-2"
"243212","University of Puerto Rico-Ponce","2015","On-tenure track, instructors","1","0","1","0","0","0","0","0","0","0","0","0","1","0","1","0","0","0","0","0","0","0","0","0","0","0","0","0","0","0","-2"
"243212","University of Puerto Rico-Ponce","2015","Not on tenure track/No tenure system system total","16","9","7","0","0","0","0","0","0","0","0","0","16","9","7","0","0","0","0","0","0","0","0","0","0","0","0","0","0","0","-2"
"243212","University of Puerto Rico-Ponce","2015","Not on tenure/no tenure system, assistant professors","6","2","4","0","0","0","0","0","0","0","0","0","6","2","4","0","0","0","0","0","0","0","0","0","0","0","0","0","0","0","-2"
"243212","University of Puerto Rico-Ponce","2015","Not on tenure/no tenure system, instructors","10","7","3","0","0","0","0","0","0","0","0","0","10","7","3","0","0","0","0","0","0","0","0","0","0","0","0","0","0","0","-2"
"243221","University of Puerto Rico-Rio Piedras","2015","Tenured total","635","331","304","1","0","1","7","4","3","4","3","1","561","278","283","0","0","0","40","32","8","4","2","2","18","12","6","0","0","0","-2"
"243221","University of Puerto Rico-Rio Piedras","2015","Tenured, professors","468","254","214","1","0","1","6","4","2","3","3","0","412","214","198","0","0","0","32","26","6","3","1","2","11","6","5","0","0","0","-2"
"243221","University of Puerto Rico-Rio Piedras","2015","Tenured, associate professors","135","61","74","0","0","0","0","0","0","1","0","1","119","49","70","0","0","0","8","6","2","1","1","0","6","5","1","0","0","0","-2"
"243221","University of Puerto Rico-Rio Piedras","2015","Tenured, assistant professors","31","15","16","0","0","0","1","0","1","0","0","0","29","14","15","0","0","0","0","0","0","0","0","0","1","1","0","0","0","0","-2"
"243221","University of Puerto Rico-Rio Piedras","2015","Tenured, instructors","1","1","0","0","0","0","0","0","0","0","0","0","1","1","0","0","0","0","0","0","0","0","0","0","0","0","0","0","0","0","-2"
"243221","University of Puerto Rico-Rio Piedras","2015","On-Tenure track total","53","29","24","0","0","0","0","0","0","0","0","0","30","14","16","0","0","0","4","2","2","0","0","0","19","13","6","0","0","0","-2"
"243221","University of Puerto Rico-Rio Piedras","2015","On-tenure track, associate professors","8","6","2","0","0","0","0","0","0","0","0","0","3","2","1","0","0","0","1","1","0","0","0","0","4","3","1","0","0","0","-2"
"243221","University of Puerto Rico-Rio Piedras","2015","On-tenure track, assistant professors","43","21","22","0","0","0","0","0","0","0","0","0","26","11","15","0","0","0","3","1","2","0","0","0","14","9","5","0","0","0","-2"
"243221","University of Puerto Rico-Rio Piedras","2015","On-tenure track, instructors","2","2","0","0","0","0","0","0","0","0","0","0","1","1","0","0","0","0","0","0","0","0","0","0","1","1","0","0","0","0","-2"
"243221","University of Puerto Rico-Rio Piedras","2015","Not on tenure track/No tenure system system total","102","50","52","0","0","0","0","0","0","0","0","0","73","38","35","0","0","0","1","1","0","0","0","0","28","11","17","0","0","0","-2"
"243221","University of Puerto Rico-Rio Piedras","2015","Not on tenure/no tenure system, professors","2","1","1","0","0","0","0","0","0","0","0","0","1","0","1","0","0","0","0","0","0","0","0","0","1","1","0","0","0","0","-2"
"243221","University of Puerto Rico-Rio Piedras","2015","Not on tenure/no tenure system, associate professors","3","2","1","0","0","0","0","0","0","0","0","0","3","2","1","0","0","0","0","0","0","0","0","0","0","0","0","0","0","0","-2"
"243221","University of Puerto Rico-Rio Piedras","2015","Not on tenure/no tenure system, assistant professors","54","29","25","0","0","0","0","0","0","0","0","0","39","22","17","0","0","0","1","1","0","0","0","0","14","6","8","0","0","0","-2"
"243221","University of Puerto Rico-Rio Piedras","2015","Not on tenure/no tenure system, instructors","41","17","24","0","0","0","0","0","0","0","0","0","29","14","15","0","0","0","0","0","0","0","0","0","12","3","9","0","0","0","-2"
"243221","University of Puerto Rico-Rio Piedras","2015","Not on tenure/no tenure system, no academic rank","2","1","1","0","0","0","0","0","0","0","0","0","1","0","1","0","0","0","0","0","0","0","0","0","1","1","0","0","0","0","-2"
"243346","Universidad Ana G. Mendez-Carolina Campus","2015","Tenured total","19","7","12","0","0","0","0","0","0","0","0","0","19","7","12","0","0","0","0","0","0","0","0","0","0","0","0","0","0","0","-2"
"243346","Universidad Ana G. Mendez-Carolina Campus","2015","Tenured, professors","8","2","6","0","0","0","0","0","0","0","0","0","8","2","6","0","0","0","0","0","0","0","0","0","0","0","0","0","0","0","-2"
"243346","Universidad Ana G. Mendez-Carolina Campus","2015","Tenured, associate professors","7","3","4","0","0","0","0","0","0","0","0","0","7","3","4","0","0","0","0","0","0","0","0","0","0","0","0","0","0","0","-2"
"243346","Universidad Ana G. Mendez-Carolina Campus","2015","Tenured, assistant professors","3","1","2","0","0","0","0","0","0","0","0","0","3","1","2","0","0","0","0","0","0","0","0","0","0","0","0","0","0","0","-2"
"243346","Universidad Ana G. Mendez-Carolina Campus","2015","Tenured, instructors","1","1","0","0","0","0","0","0","0","0","0","0","1","1","0","0","0","0","0","0","0","0","0","0","0","0","0","0","0","0","-2"
"243346","Universidad Ana G. Mendez-Carolina Campus","2015","Not on tenure track/No tenure system system total","132","50","82","0","0","0","0","0","0","1","1","0","127","46","81","0","0","0","3","2","1","0","0","0","1","1","0","0","0","0","-2"
"243346","Universidad Ana G. Mendez-Carolina Campus","2015","Not on tenure/no tenure system, professors","9","3","6","0","0","0","0","0","0","0","0","0","9","3","6","0","0","0","0","0","0","0","0","0","0","0","0","0","0","0","-2"
"243346","Universidad Ana G. Mendez-Carolina Campus","2015","Not on tenure/no tenure system, associate professors","24","6","18","0","0","0","0","0","0","0","0","0","23","5","18","0","0","0","0","0","0","0","0","0","1","1","0","0","0","0","-2"
"243346","Universidad Ana G. Mendez-Carolina Campus","2015","Not on tenure/no tenure system, assistant professors","40","17","23","0","0","0","0","0","0","1","1","0","38","16","22","0","0","0","1","0","1","0","0","0","0","0","0","0","0","0","-2"
"243346","Universidad Ana G. Mendez-Carolina Campus","2015","Not on tenure/no tenure system, instructors","58","24","34","0","0","0","0","0","0","0","0","0","56","22","34","0","0","0","2","2","0","0","0","0","0","0","0","0","0","0","-2"
"243346","Universidad Ana G. Mendez-Carolina Campus","2015","Not on tenure/no tenure system, lecturers","1","0","1","0","0","0","0","0","0","0","0","0","1","0","1","0","0","0","0","0","0","0","0","0","0","0","0","0","0","0","-2"
"243443","Universidad del Sagrado Corazon","2015","Tenured total","70","28","42","0","0","0","1","1","0","0","0","0","69","27","42","0","0","0","0","0","0","0","0","0","0","0","0","0","0","0","-2"
"243443","Universidad del Sagrado Corazon","2015","Tenured, professors","49","19","30","0","0","0","1","1","0","0","0","0","48","18","30","0","0","0","0","0","0","0","0","0","0","0","0","0","0","0","-2"
"243443","Universidad del Sagrado Corazon","2015","Tenured, associate professors","8","3","5","0","0","0","0","0","0","0","0","0","8","3","5","0","0","0","0","0","0","0","0","0","0","0","0","0","0","0","-2"
"243443","Universidad del Sagrado Corazon","2015","Tenured, assistant professors","8","4","4","0","0","0","0","0","0","0","0","0","8","4","4","0","0","0","0","0","0","0","0","0","0","0","0","0","0","0","-2"
"243443","Universidad del Sagrado Corazon","2015","Tenured, instructors","5","2","3","0","0","0","0","0","0","0","0","0","5","2","3","0","0","0","0","0","0","0","0","0","0","0","0","0","0","0","-2"
"243443","Universidad del Sagrado Corazon","2015","On-Tenure track total","14","5","9","0","0","0","0","0","0","0","0","0","14","5","9","0","0","0","0","0","0","0","0","0","0","0","0","0","0","0","-2"
"243443","Universidad del Sagrado Corazon","2015","On-tenure track, associate professors","1","1","0","0","0","0","0","0","0","0","0","0","1","1","0","0","0","0","0","0","0","0","0","0","0","0","0","0","0","0","-2"
"243443","Universidad del Sagrado Corazon","2015","On-tenure track, assistant professors","4","1","3","0","0","0","0","0","0","0","0","0","4","1","3","0","0","0","0","0","0","0","0","0","0","0","0","0","0","0","-2"
"243443","Universidad del Sagrado Corazon","2015","On-tenure track, instructors","9","3","6","0","0","0","0","0","0","0","0","0","9","3","6","0","0","0","0","0","0","0","0","0","0","0","0","0","0","0","-2"
"243568","Universidad Central Del Caribe","2015","Not on tenure track/No tenure system system total","43","22","21","0","0","0","0","0","0","0","0","0","31","15","16","0","0","0","12","7","5","0","0","0","0","0","0","0","0","0","-2"
"243568","Universidad Central Del Caribe","2015","Not on tenure/no tenure system, professors","14","9","5","0","0","0","0","0","0","0","0","0","9","6","3","0","0","0","5","3","2","0","0","0","0","0","0","0","0","0","-2"
"243568","Universidad Central Del Caribe","2015","Not on tenure/no tenure system, associate professors","15","6","9","0","0","0","0","0","0","0","0","0","12","5","7","0","0","0","3","1","2","0","0","0","0","0","0","0","0","0","-2"
"243568","Universidad Central Del Caribe","2015","Not on tenure/no tenure system, assistant professors","14","7","7","0","0","0","0","0","0","0","0","0","10","4","6","0","0","0","4","3","1","0","0","0","0","0","0","0","0","0","-2"
"243577","Universidad Politecnica de Puerto Rico","2015","Tenured total","27","17","10","0","0","0","1","1","0","0","0","0","26","16","10","0","0","0","0","0","0","0","0","0","0","0","0","0","0","0","-2"
"243577","Universidad Politecnica de Puerto Rico","2015","Tenured, professors","18","14","4","0","0","0","1","1","0","0","0","0","17","13","4","0","0","0","0","0","0","0","0","0","0","0","0","0","0","0","-2"
"243577","Universidad Politecnica de Puerto Rico","2015","Tenured, associate professors","9","3","6","0","0","0","0","0","0","0","0","0","9","3","6","0","0","0","0","0","0","0","0","0","0","0","0","0","0","0","-2"
"243577","Universidad Politecnica de Puerto Rico","2015","Not on tenure track/No tenure system system total","108","71","37","0","0","0","1","0","1","0","0","0","104","68","36","0","0","0","3","3","0","0","0","0","0","0","0","0","0","0","-2"
"243577","Universidad Politecnica de Puerto Rico","2015","Not on tenure/no tenure system, professors","20","16","4","0","0","0","0","0","0","0","0","0","19","15","4","0","0","0","1","1","0","0","0","0","0","0","0","0","0","0","-2"
"243577","Universidad Politecnica de Puerto Rico","2015","Not on tenure/no tenure system, associate professors","63","42","21","0","0","0","1","0","1","0","0","0","60","40","20","0","0","0","2","2","0","0","0","0","0","0","0","0","0","0","-2"
"243577","Universidad Politecnica de Puerto Rico","2015","Not on tenure/no tenure system, assistant professors","21","12","9","0","0","0","0","0","0","0","0","0","21","12","9","0","0","0","0","0","0","0","0","0","0","0","0","0","0","0","-2"
"243577","Universidad Politecnica de Puerto Rico","2015","Not on tenure/no tenure system, instructors","4","1","3","0","0","0","0","0","0","0","0","0","4","1","3","0","0","0","0","0","0","0","0","0","0","0","0","0","0","0","-2"
"243586","Pontifical Catholic University of Puerto Rico-Mayaguez","2015","Not on tenure track/No tenure system system total","40","22","18","0","0","0","0","0","0","0","0","0","39","21","18","0","0","0","1","1","0","0","0","0","0","0","0","0","0","0","-2"
"243586","Pontifical Catholic University of Puerto Rico-Mayaguez","2015","Not on tenure/no tenure system, professors","4","2","2","0","0","0","0","0","0","0","0","0","4","2","2","0","0","0","0","0","0","0","0","0","0","0","0","0","0","0","-2"
"243586","Pontifical Catholic University of Puerto Rico-Mayaguez","2015","Not on tenure/no tenure system, associate professors","7","6","1","0","0","0","0","0","0","0","0","0","7","6","1","0","0","0","0","0","0","0","0","0","0","0","0","0","0","0","-2"
"243586","Pontifical Catholic University of Puerto Rico-Mayaguez","2015","Not on tenure/no tenure system, assistant professors","21","9","12","0","0","0","0","0","0","0","0","0","21","9","12","0","0","0","0","0","0","0","0","0","0","0","0","0","0","0","-2"
"243586","Pontifical Catholic University of Puerto Rico-Mayaguez","2015","Not on tenure/no tenure system, instructors","3","2","1","0","0","0","0","0","0","0","0","0","2","1","1","0","0","0","1","1","0","0","0","0","0","0","0","0","0","0","-2"
"243586","Pontifical Catholic University of Puerto Rico-Mayaguez","2015","Not on tenure/no tenure system, no academic rank","5","3","2","0","0","0","0","0","0","0","0","0","5","3","2","0","0","0","0","0","0","0","0","0","0","0","0","0","0","0","-2"
"243601","Universidad Ana G. Mendez-Gurabo Campus","2015","Tenured total","36","18","18","0","0","0","0","0","0","0","0","0","36","18","18","0","0","0","0","0","0","0","0","0","0","0","0","0","0","0","-2"
"243601","Universidad Ana G. Mendez-Gurabo Campus","2015","Tenured, professors","21","11","10","0","0","0","0","0","0","0","0","0","21","11","10","0","0","0","0","0","0","0","0","0","0","0","0","0","0","0","-2"
"243601","Universidad Ana G. Mendez-Gurabo Campus","2015","Tenured, associate professors","14","6","8","0","0","0","0","0","0","0","0","0","14","6","8","0","0","0","0","0","0","0","0","0","0","0","0","0","0","0","-2"
"243601","Universidad Ana G. Mendez-Gurabo Campus","2015","Tenured, assistant professors","1","1","0","0","0","0","0","0","0","0","0","0","1","1","0","0","0","0","0","0","0","0","0","0","0","0","0","0","0","0","-2"
"243601","Universidad Ana G. Mendez-Gurabo Campus","2015","Not on tenure track/No tenure system system total","141","68","73","0","0","0","1","1","0","1","1","0","130","60","70","0","0","0","3","2","1","0","0","0","6","4","2","0","0","0","-2"
"243601","Universidad Ana G. Mendez-Gurabo Campus","2015","Not on tenure/no tenure system, professors","12","8","4","0","0","0","0","0","0","0","0","0","9","5","4","0","0","0","1","1","0","0","0","0","2","2","0","0","0","0","-2"
"243601","Universidad Ana G. Mendez-Gurabo Campus","2015","Not on tenure/no tenure system, associate professors","28","15","13","0","0","0","0","0","0","1","1","0","25","13","12","0","0","0","0","0","0","0","0","0","2","1","1","0","0","0","-2"
"243601","Universidad Ana G. Mendez-Gurabo Campus","2015","Not on tenure/no tenure system, assistant professors","58","26","32","0","0","0","1","1","0","0","0","0","55","24","31","0","0","0","0","0","0","0","0","0","2","1","1","0","0","0","-2"
"243601","Universidad Ana G. Mendez-Gurabo Campus","2015","Not on tenure/no tenure system, instructors","42","19","23","0","0","0","0","0","0","0","0","0","40","18","22","0","0","0","2","1","1","0","0","0","0","0","0","0","0","0","-2"
"243601","Universidad Ana G. Mendez-Gurabo Campus","2015","Not on tenure/no tenure system, lecturers","1","0","1","0","0","0","0","0","0","0","0","0","1","0","1","0","0","0","0","0","0","0","0","0","0","0","0","0","0","0","-2"
"243832","EDP University of Puerto Rico Inc-San Juan","2015","Not on tenure track/No tenure system system total","35","9","26","0","0","0","0","0","0","0","0","0","35","9","26","0","0","0","0","0","0","0","0","0","0","0","0","0","0","0","-2"
"243832","EDP University of Puerto Rico Inc-San Juan","2015","Not on tenure/no tenure system, instructors","35","9","26","0","0","0","0","0","0","0","0","0","35","9","26","0","0","0","0","0","0","0","0","0","0","0","0","0","0","0","-2"
"245847","Antioch University-Santa Barbara","2015","Not on tenure track/No tenure system system total","10","4","6","0","0","0","0","0","0","0","0","0","2","1","1","0","0","0","8","3","5","0","0","0","0","0","0","0","0","0","-2"
"245847","Antioch University-Santa Barbara","2015","Not on tenure/no tenure system, no academic rank","10","4","6","0","0","0","0","0","0","0","0","0","2","1","1","0","0","0","8","3","5","0","0","0","0","0","0","0","0","0","-2"
"245953","Mid-America Christian University","2015","Not on tenure track/No tenure system system total","34","22","12","2","2","0","1","1","0","1","0","1","1","1","0","0","0","0","26","16","10","1","1","0","2","1","1","0","0","0","-2"
"245953","Mid-America Christian University","2015","Not on tenure/no tenure system, professors","8","6","2","2","2","0","0","0","0","1","0","1","0","0","0","0","0","0","5","4","1","0","0","0","0","0","0","0","0","0","-2"
"245953","Mid-America Christian University","2015","Not on tenure/no tenure system, associate professors","6","3","3","0","0","0","1","1","0","0","0","0","0","0","0","0","0","0","5","2","3","0","0","0","0","0","0","0","0","0","-2"
"245953","Mid-America Christian University","2015","Not on tenure/no tenure system, assistant professors","17","12","5","0","0","0","0","0","0","0","0","0","1","1","0","0","0","0","13","9","4","1","1","0","2","1","1","0","0","0","-2"
"245953","Mid-America Christian University","2015","Not on tenure/no tenure system, instructors","3","1","2","0","0","0","0","0","0","0","0","0","0","0","0","0","0","0","3","1","2","0","0","0","0","0","0","0","0","0","-2"
"363907","Caribbean University-Ponce","2015","Not on tenure track/No tenure system system total","29","11","18","0","0","0","0","0","0","0","0","0","29","11","18","0","0","0","0","0","0","0","0","0","0","0","0","0","0","0","-2"
"363907","Caribbean University-Ponce","2015","Not on tenure/no tenure system, professors","1","1","0","0","0","0","0","0","0","0","0","0","1","1","0","0","0","0","0","0","0","0","0","0","0","0","0","0","0","0","-2"
"363907","Caribbean University-Ponce","2015","Not on tenure/no tenure system, assistant professors","7","3","4","0","0","0","0","0","0","0","0","0","7","3","4","0","0","0","0","0","0","0","0","0","0","0","0","0","0","0","-2"
"363907","Caribbean University-Ponce","2015","Not on tenure/no tenure system, instructors","21","7","14","0","0","0","0","0","0","0","0","0","21","7","14","0","0","0","0","0","0","0","0","0","0","0","0","0","0","0","-2"
"363916","Caribbean University-Vega Baja","2015","Not on tenure track/No tenure system system total","15","5","10","0","0","0","0","0","0","0","0","0","15","5","10","0","0","0","0","0","0","0","0","0","0","0","0","0","0","0","-2"
"363916","Caribbean University-Vega Baja","2015","Not on tenure/no tenure system, assistant professors","3","0","3","0","0","0","0","0","0","0","0","0","3","0","3","0","0","0","0","0","0","0","0","0","0","0","0","0","0","0","-2"
"363916","Caribbean University-Vega Baja","2015","Not on tenure/no tenure system, instructors","12","5","7","0","0","0","0","0","0","0","0","0","12","5","7","0","0","0","0","0","0","0","0","0","0","0","0","0","0","0","-2"
"366711","California State University-San Marcos","2015","Tenured total","179","92","87","3","1","2","24","17","7","5","4","1","30","16","14","1","1","0","104","45","59","2","0","2","7","5","2","3","3","0","-2"
"366711","California State University-San Marcos","2015","Tenured, professors","108","53","55","1","0","1","13","9","4","2","1","1","19","11","8","0","0","0","67","28","39","1","0","1","3","2","1","2","2","0","-2"
"366711","California State University-San Marcos","2015","Tenured, associate professors","71","39","32","2","1","1","11","8","3","3","3","0","11","5","6","1","1","0","37","17","20","1","0","1","4","3","1","1","1","0","-2"
"366711","California State University-San Marcos","2015","On-Tenure track total","67","27","40","2","1","1","11","5","6","1","0","1","13","4","9","0","0","0","34","15","19","0","0","0","1","0","1","5","2","3","-2"
"366711","California State University-San Marcos","2015","On-tenure track, assistant professors","67","27","40","2","1","1","11","5","6","1","0","1","13","4","9","0","0","0","34","15","19","0","0","0","1","0","1","5","2","3","-2"
"366711","California State University-San Marcos","2015","Not on tenure track/No tenure system system total","95","26","69","0","0","0","6","1","5","1","0","1","10","2","8","0","0","0","75","23","52","2","0","2","0","0","0","1","0","1","-2"
"366711","California State University-San Marcos","2015","Not on tenure/no tenure system, lecturers","95","26","69","0","0","0","6","1","5","1","0","1","10","2","8","0","0","0","75","23","52","2","0","2","0","0","0","1","0","1","-2"
"367884","Hodges University","2015","Not on tenure track/No tenure system system total","62","28","34","0","0","0","0","0","0","1","1","0","6","4","2","0","0","0","54","23","31","1","0","1","0","0","0","0","0","0","-2"
"367884","Hodges University","2015","Not on tenure/no tenure system, professors","8","5","3","0","0","0","0","0","0","0","0","0","0","0","0","0","0","0","8","5","3","0","0","0","0","0","0","0","0","0","-2"
"367884","Hodges University","2015","Not on tenure/no tenure system, associate professors","17","10","7","0","0","0","0","0","0","0","0","0","2","1","1","0","0","0","15","9","6","0","0","0","0","0","0","0","0","0","-2"
"367884","Hodges University","2015","Not on tenure/no tenure system, assistant professors","35","12","23","0","0","0","0","0","0","1","1","0","3","2","1","0","0","0","30","9","21","1","0","1","0","0","0","0","0","0","-2"
"367884","Hodges University","2015","Not on tenure/no tenure system, instructors","1","1","0","0","0","0","0","0","0","0","0","0","1","1","0","0","0","0","0","0","0","0","0","0","0","0","0","0","0","0","-2"
"367884","Hodges University","2015","Not on tenure/no tenure system, no academic rank","1","0","1","0","0","0","0","0","0","0","0","0","0","0","0","0","0","0","1","0","1","0","0","0","0","0","0","0","0","0","-2"
"376385","Universal Technology College of Puerto Rico","2015","Not on tenure track/No tenure system system total","34","10","24","0","0","0","0","0","0","0","0","0","34","10","24","0","0","0","0","0","0","0","0","0","0","0","0","0","0","0","-2"
"376385","Universal Technology College of Puerto Rico","2015","Not on tenure/no tenure system, professors","34","10","24","0","0","0","0","0","0","0","0","0","34","10","24","0","0","0","0","0","0","0","0","0","0","0","0","0","0","0","-2"
"407009","Arizona State University-West","2015","Tenured total","97","58","39","0","0","0","5","3","2","2","1","1","14","7","7","0","0","0","74","45","29","0","0","0","1","1","0","1","1","0","-2"
"407009","Arizona State University-West","2015","Tenured, professors","28","20","8","0","0","0","0","0","0","0","0","0","2","2","0","0","0","0","25","17","8","0","0","0","0","0","0","1","1","0","-2"
"407009","Arizona State University-West","2015","Tenured, associate professors","69","38","31","0","0","0","5","3","2","2","1","1","12","5","7","0","0","0","49","28","21","0","0","0","1","1","0","0","0","0","-2"
"407009","Arizona State University-West","2015","On-Tenure track total","29","12","17","0","0","0","4","1","3","1","0","1","3","2","1","0","0","0","18","7","11","2","1","1","0","0","0","1","1","0","-2"
"407009","Arizona State University-West","2015","On-tenure track, associate professors","1","1","0","0","0","0","0","0","0","0","0","0","0","0","0","0","0","0","1","1","0","0","0","0","0","0","0","0","0","0","-2"
"407009","Arizona State University-West","2015","On-tenure track, assistant professors","28","11","17","0","0","0","4","1","3","1","0","1","3","2","1","0","0","0","17","6","11","2","1","1","0","0","0","1","1","0","-2"
"407009","Arizona State University-West","2015","Not on tenure track/No tenure system system total","107","33","74","1","1","0","4","0","4","2","1","1","10","3","7","1","0","1","87","28","59","1","0","1","1","0","1","0","0","0","-2"
"407009","Arizona State University-West","2015","Not on tenure/no tenure system, professors","3","3","0","0","0","0","0","0","0","0","0","0","1","1","0","0","0","0","2","2","0","0","0","0","0","0","0","0","0","0","-2"
"407009","Arizona State University-West","2015","Not on tenure/no tenure system, associate professors","7","1","6","0","0","0","0","0","0","0","0","0","0","0","0","0","0","0","7","1","6","0","0","0","0","0","0","0","0","0","-2"
"407009","Arizona State University-West","2015","Not on tenure/no tenure system, assistant professors","11","1","10","0","0","0","0","0","0","0","0","0","2","1","1","0","0","0","9","0","9","0","0","0","0","0","0","0","0","0","-2"
"407009","Arizona State University-West","2015","Not on tenure/no tenure system, instructors","43","11","32","1","1","0","1","0","1","2","1","1","5","1","4","0","0","0","33","8","25","0","0","0","1","0","1","0","0","0","-2"
"407009","Arizona State University-West","2015","Not on tenure/no tenure system, lecturers","43","17","26","0","0","0","3","0","3","0","0","0","2","0","2","1","0","1","36","17","19","1","0","1","0","0","0","0","0","0","-2"
"409315","South Texas College","2015","Not on tenure track/No tenure system system total","584","352","232","3","2","1","54","26","28","12","11","1","328","197","131","0","0","0","184","115","69","0","0","0","3","1","2","0","0","0","-2"
"409315","South Texas College","2015","Not on tenure/no tenure system, professors","10","7","3","0","0","0","2","1","1","1","1","0","0","0","0","0","0","0","7","5","2","0","0","0","0","0","0","0","0","0","-2"
"409315","South Texas College","2015","Not on tenure/no tenure system, associate professors","28","19","9","0","0","0","2","2","0","0","0","0","11","8","3","0","0","0","15","9","6","0","0","0","0","0","0","0","0","0","-2"
"409315","South Texas College","2015","Not on tenure/no tenure system, assistant professors","39","22","17","0","0","0","5","2","3","0","0","0","16","9","7","0","0","0","18","11","7","0","0","0","0","0","0","0","0","0","-2"
"409315","South Texas College","2015","Not on tenure/no tenure system, instructors","507","304","203","3","2","1","45","21","24","11","10","1","301","180","121","0","0","0","144","90","54","0","0","0","3","1","2","0","0","0","-2"
"409698","California State University-Monterey Bay","2015","Tenured total","88","44","44","1","1","0","19","7","12","4","3","1","18","10","8","1","0","1","41","21","20","0","0","0","4","2","2","0","0","0","-2"
"409698","California State University-Monterey Bay","2015","Tenured, professors","50","31","19","1","1","0","13","6","7","3","2","1","8","6","2","1","0","1","24","16","8","0","0","0","0","0","0","0","0","0","-2"
"409698","California State University-Monterey Bay","2015","Tenured, associate professors","37","13","24","0","0","0","6","1","5","1","1","0","10","4","6","0","0","0","16","5","11","0","0","0","4","2","2","0","0","0","-2"
"409698","California State University-Monterey Bay","2015","Tenured, no academic rank","1","0","1","0","0","0","0","0","0","0","0","0","0","0","0","0","0","0","1","0","1","0","0","0","0","0","0","0","0","0","-2"
"409698","California State University-Monterey Bay","2015","On-Tenure track total","59","28","31","2","1","1","7","3","4","2","1","1","5","3","2","0","0","0","35","14","21","1","1","0","1","1","0","6","4","2","-2"
"409698","California State University-Monterey Bay","2015","On-tenure track, associate professors","3","3","0","0","0","0","0","0","0","0","0","0","0","0","0","0","0","0","2","2","0","0","0","0","0","0","0","1","1","0","-2"
"409698","California State University-Monterey Bay","2015","On-tenure track, assistant professors","56","25","31","2","1","1","7","3","4","2","1","1","5","3","2","0","0","0","33","12","21","1","1","0","1","1","0","5","3","2","-2"
"409698","California State University-Monterey Bay","2015","Not on tenure track/No tenure system system total","79","27","52","1","0","1","5","3","2","3","0","3","9","4","5","0","0","0","51","17","34","0","0","0","9","2","7","1","1","0","-2"
"409698","California State University-Monterey Bay","2015","Not on tenure/no tenure system, lecturers","79","27","52","1","0","1","5","3","2","3","0","3","9","4","5","0","0","0","51","17","34","0","0","0","9","2","7","1","1","0","-2"
"414823","Johnson & Wales University-North Miami","2015","Not on tenure track/No tenure system system total","57","39","18","0","0","0","4","2","2","9","6","3","4","2","2","0","0","0","37","28","9","3","1","2","0","0","0","0","0","0","-2"
"414823","Johnson & Wales University-North Miami","2015","Not on tenure/no tenure system, professors","11","6","5","0","0","0","1","0","1","1","1","0","1","0","1","0","0","0","8","5","3","0","0","0","0","0","0","0","0","0","-2"
"414823","Johnson & Wales University-North Miami","2015","Not on tenure/no tenure system, associate professors","19","11","8","0","0","0","2","2","0","3","1","2","1","0","1","0","0","0","12","8","4","1","0","1","0","0","0","0","0","0","-2"
"414823","Johnson & Wales University-North Miami","2015","Not on tenure/no tenure system, assistant professors","17","14","3","0","0","0","0","0","0","4","4","0","0","0","0","0","0","0","12","10","2","1","0","1","0","0","0","0","0","0","-2"
"414823","Johnson & Wales University-North Miami","2015","Not on tenure/no tenure system, instructors","10","8","2","0","0","0","1","0","1","1","0","1","2","2","0","0","0","0","5","5","0","1","1","0","0","0","0","0","0","0","-2"
"416801","The University of Texas MD Anderson Cancer Center","2015","Tenured total","245","179","66","0","0","0","57","39","18","5","2","3","18","13","5","0","0","0","164","124","40","0","0","0","0","0","0","1","1","0","-2"
"416801","The University of Texas MD Anderson Cancer Center","2015","Tenured, professors","180","142","38","0","0","0","37","27","10","4","2","2","12","8","4","0","0","0","126","104","22","0","0","0","0","0","0","1","1","0","-2"
"416801","The University of Texas MD Anderson Cancer Center","2015","Tenured, associate professors","65","37","28","0","0","0","20","12","8","1","0","1","6","5","1","0","0","0","38","20","18","0","0","0","0","0","0","0","0","0","-2"
"416801","The University of Texas MD Anderson Cancer Center","2015","On-Tenure track total","70","45","25","0","0","0","24","15","9","4","3","1","5","2","3","0","0","0","33","22","11","0","0","0","0","0","0","4","3","1","-2"
"416801","The University of Texas MD Anderson Cancer Center","2015","On-tenure track, professors","7","3","4","0","0","0","4","2","2","0","0","0","0","0","0","0","0","0","2","0","2","0","0","0","0","0","0","1","1","0","-2"
"416801","The University of Texas MD Anderson Cancer Center","2015","On-tenure track, associate professors","12","9","3","0","0","0","3","2","1","1","1","0","1","0","1","0","0","0","7","6","1","0","0","0","0","0","0","0","0","0","-2"
"416801","The University of Texas MD Anderson Cancer Center","2015","On-tenure track, assistant professors","51","33","18","0","0","0","17","11","6","3","2","1","4","2","2","0","0","0","24","16","8","0","0","0","0","0","0","3","2","1","-2"
"416801","The University of Texas MD Anderson Cancer Center","2015","Not on tenure track/No tenure system system total","677","371","306","3","1","2","253","141","112","33","10","23","49","31","18","2","0","2","321","180","141","0","0","0","0","0","0","16","8","8","-2"
"416801","The University of Texas MD Anderson Cancer Center","2015","Not on tenure/no tenure system, assistant professors","1","1","0","0","0","0","0","0","0","0","0","0","0","0","0","0","0","0","0","0","0","0","0","0","0","0","0","1","1","0","-2"
"416801","The University of Texas MD Anderson Cancer Center","2015","Not on tenure/no tenure system, lecturers","676","370","306","3","1","2","253","141","112","33","10","23","49","31","18","2","0","2","321","180","141","0","0","0","0","0","0","15","7","8","-2"
"430670","San Juan Bautista School of Medicine","2015","Tenured total","11","6","5","0","0","0","0","0","0","0","0","0","11","6","5","0","0","0","0","0","0","0","0","0","0","0","0","0","0","0","-2"
"430670","San Juan Bautista School of Medicine","2015","Tenured, associate professors","5","5","0","0","0","0","0","0","0","0","0","0","5","5","0","0","0","0","0","0","0","0","0","0","0","0","0","0","0","0","-2"
"430670","San Juan Bautista School of Medicine","2015","Tenured, assistant professors","5","1","4","0","0","0","0","0","0","0","0","0","5","1","4","0","0","0","0","0","0","0","0","0","0","0","0","0","0","0","-2"
"430670","San Juan Bautista School of Medicine","2015","Tenured, instructors","1","0","1","0","0","0","0","0","0","0","0","0","1","0","1","0","0","0","0","0","0","0","0","0","0","0","0","0","0","0","-2"
"430670","San Juan Bautista School of Medicine","2015","On-Tenure track total","10","3","7","0","0","0","0","0","0","0","0","0","10","3","7","0","0","0","0","0","0","0","0","0","0","0","0","0","0","0","-2"
"430670","San Juan Bautista School of Medicine","2015","On-tenure track, associate professors","1","0","1","0","0","0","0","0","0","0","0","0","1","0","1","0","0","0","0","0","0","0","0","0","0","0","0","0","0","0","-2"
"430670","San Juan Bautista School of Medicine","2015","On-tenure track, assistant professors","3","0","3","0","0","0","0","0","0","0","0","0","3","0","3","0","0","0","0","0","0","0","0","0","0","0","0","0","0","0","-2"
"430670","San Juan Bautista School of Medicine","2015","On-tenure track, instructors","6","3","3","0","0","0","0","0","0","0","0","0","6","3","3","0","0","0","0","0","0","0","0","0","0","0","0","0","0","0","-2"
"430670","San Juan Bautista School of Medicine","2015","Not on tenure track/No tenure system system total","20","16","4","0","0","0","0","0","0","0","0","0","20","16","4","0","0","0","0","0","0","0","0","0","0","0","0","0","0","0","-2"
"430670","San Juan Bautista School of Medicine","2015","Not on tenure/no tenure system, professors","1","1","0","0","0","0","0","0","0","0","0","0","1","1","0","0","0","0","0","0","0","0","0","0","0","0","0","0","0","0","-2"
"430670","San Juan Bautista School of Medicine","2015","Not on tenure/no tenure system, associate professors","2","2","0","0","0","0","0","0","0","0","0","0","2","2","0","0","0","0","0","0","0","0","0","0","0","0","0","0","0","0","-2"
"430670","San Juan Bautista School of Medicine","2015","Not on tenure/no tenure system, assistant professors","15","12","3","0","0","0","0","0","0","0","0","0","15","12","3","0","0","0","0","0","0","0","0","0","0","0","0","0","0","0","-2"
"430670","San Juan Bautista School of Medicine","2015","Not on tenure/no tenure system, instructors","2","1","1","0","0","0","0","0","0","0","0","0","2","1","1","0","0","0","0","0","0","0","0","0","0","0","0","0","0","0","-2"
"434539","City College-Miami","2015","Not on tenure track/No tenure system system total","4","1","3","0","0","0","0","0","0","0","0","0","0","0","0","0","0","0","1","1","0","0","0","0","3","0","3","0","0","0","-2"
"434539","City College-Miami","2015","Not on tenure/no tenure system, instructors","4","1","3","0","0","0","0","0","0","0","0","0","0","0","0","0","0","0","1","1","0","0","0","0","3","0","3","0","0","0","-2"
"434900","Dewey University-Carolina","2015","Not on tenure track/No tenure system system total","44","19","25","0","0","0","0","0","0","0","0","0","44","19","25","0","0","0","0","0","0","0","0","0","0","0","0","0","0","0","-2"
"434900","Dewey University-Carolina","2015","Not on tenure/no tenure system, professors","44","19","25","0","0","0","0","0","0","0","0","0","44","19","25","0","0","0","0","0","0","0","0","0","0","0","0","0","0","0","-2"
"439446","Atlantic Institute of Oriental Medicine","2015","Not on tenure track/No tenure system system total","5","5","0","0","0","0","3","3","0","1","1","0","0","0","0","0","0","0","1","1","0","0","0","0","0","0","0","0","0","0","-2"
"439446","Atlantic Institute of Oriental Medicine","2015","Not on tenure/no tenure system, instructors","5","5","0","0","0","0","3","3","0","1","1","0","0","0","0","0","0","0","1","1","0","0","0","0","0","0","0","0","0","0","-2"
"440651","Atenas College","2015","Tenured total","20","2","18","0","0","0","0","0","0","0","0","0","20","2","18","0","0","0","0","0","0","0","0","0","0","0","0","0","0","0","-2"
"440651","Atenas College","2015","Tenured, professors","20","2","18","0","0","0","0","0","0","0","0","0","20","2","18","0","0","0","0","0","0","0","0","0","0","0","0","0","0","0","-2"
"440651","Atenas College","2015","Not on tenure track/No tenure system system total","5","2","3","0","0","0","0","0","0","0","0","0","5","2","3","0","0","0","0","0","0","0","0","0","0","0","0","0","0","0","-2"
"440651","Atenas College","2015","Not on tenure/no tenure system, professors","5","2","3","0","0","0","0","0","0","0","0","0","5","2","3","0","0","0","0","0","0","0","0","0","0","0","0","0","0","0","-2"
"440794","Pillar College","2015","Tenured total","1","1","0","0","0","0","0","0","0","0","0","0","0","0","0","0","0","0","1","1","0","0","0","0","0","0","0","0","0","0","-2"
"440794","Pillar College","2015","Tenured, professors","1","1","0","0","0","0","0","0","0","0","0","0","0","0","0","0","0","0","1","1","0","0","0","0","0","0","0","0","0","0","-2"
"440794","Pillar College","2015","Not on tenure track/No tenure system system total","9","6","3","0","0","0","1","1","0","3","0","3","1","1","0","0","0","0","4","4","0","0","0","0","0","0","0","0","0","0","-2"
"440794","Pillar College","2015","Not on tenure/no tenure system, professors","1","1","0","0","0","0","0","0","0","0","0","0","0","0","0","0","0","0","1","1","0","0","0","0","0","0","0","0","0","0","-2"
"440794","Pillar College","2015","Not on tenure/no tenure system, associate professors","3","1","2","0","0","0","0","0","0","2","0","2","0","0","0","0","0","0","1","1","0","0","0","0","0","0","0","0","0","0","-2"
"440794","Pillar College","2015","Not on tenure/no tenure system, assistant professors","5","4","1","0","0","0","1","1","0","1","0","1","1","1","0","0","0","0","2","2","0","0","0","0","0","0","0","0","0","0","-2"
"441690","Universidad Pentecostal Mizpa","2015","Tenured total","3","3","0","0","0","0","0","0","0","0","0","0","3","3","0","0","0","0","0","0","0","0","0","0","0","0","0","0","0","0","-2"
"441690","Universidad Pentecostal Mizpa","2015","Tenured, professors","3","3","0","0","0","0","0","0","0","0","0","0","3","3","0","0","0","0","0","0","0","0","0","0","0","0","0","0","0","0","-2"
"441690","Universidad Pentecostal Mizpa","2015","Not on tenure track/No tenure system system total","13","9","4","0","0","0","0","0","0","0","0","0","13","9","4","0","0","0","0","0","0","0","0","0","0","0","0","0","0","0","-2"
"441690","Universidad Pentecostal Mizpa","2015","Not on tenure/no tenure system, professors","13","9","4","0","0","0","0","0","0","0","0","0","13","9","4","0","0","0","0","0","0","0","0","0","0","0","0","0","0","0","-2"
"441900","Nevada State College","2015","Tenured total","13","9","4","0","0","0","1","1","0","1","1","0","1","0","1","0","0","0","10","7","3","0","0","0","0","0","0","0","0","0","-2"
"441900","Nevada State College","2015","Tenured, professors","4","3","1","0","0","0","0","0","0","0","0","0","0","0","0","0","0","0","4","3","1","0","0","0","0","0","0","0","0","0","-2"
"441900","Nevada State College","2015","Tenured, associate professors","9","6","3","0","0","0","1","1","0","1","1","0","1","0","1","0","0","0","6","4","2","0","0","0","0","0","0","0","0","0","-2"
"441900","Nevada State College","2015","On-Tenure track total","35","14","21","0","0","0","0","0","0","3","1","2","2","1","1","0","0","0","28","12","16","2","0","2","0","0","0","0","0","0","-2"
"441900","Nevada State College","2015","On-tenure track, associate professors","1","1","0","0","0","0","0","0","0","0","0","0","0","0","0","0","0","0","1","1","0","0","0","0","0","0","0","0","0","0","-2"
"441900","Nevada State College","2015","On-tenure track, assistant professors","34","13","21","0","0","0","0","0","0","3","1","2","2","1","1","0","0","0","27","11","16","2","0","2","0","0","0","0","0","0","-2"
"441900","Nevada State College","2015","Not on tenure track/No tenure system system total","18","5","13","0","0","0","2","1","1","0","0","0","1","1","0","1","1","0","14","2","12","0","0","0","0","0","0","0","0","0","-2"
"441900","Nevada State College","2015","Not on tenure/no tenure system, lecturers","18","5","13","0","0","0","2","1","1","0","0","0","1","1","0","1","1","0","14","2","12","0","0","0","0","0","0","0","0","0","-2"
"441937","California State University-Channel Islands","2015","Tenured total","63","37","26","0","0","0","4","2","2","2","1","1","13","7","6","0","0","0","39","22","17","1","1","0","3","3","0","1","1","0","-2"
"441937","California State University-Channel Islands","2015","Tenured, professors","48","30","18","0","0","0","3","2","1","1","1","0","10","5","5","0","0","0","30","18","12","1","1","0","2","2","0","1","1","0","-2"
"441937","California State University-Channel Islands","2015","Tenured, associate professors","14","7","7","0","0","0","1","0","1","0","0","0","3","2","1","0","0","0","9","4","5","0","0","0","1","1","0","0","0","0","-2"
"441937","California State University-Channel Islands","2015","Tenured, assistant professors","1","0","1","0","0","0","0","0","0","1","0","1","0","0","0","0","0","0","0","0","0","0","0","0","0","0","0","0","0","0","-2"
"441937","California State University-Channel Islands","2015","On-Tenure track total","49","17","32","0","0","0","5","1","4","1","0","1","11","2","9","0","0","0","24","11","13","2","0","2","4","2","2","2","1","1","-2"
"441937","California State University-Channel Islands","2015","On-tenure track, professors","1","1","0","0","0","0","0","0","0","0","0","0","0","0","0","0","0","0","1","1","0","0","0","0","0","0","0","0","0","0","-2"
"441937","California State University-Channel Islands","2015","On-tenure track, associate professors","4","0","4","0","0","0","1","0","1","0","0","0","0","0","0","0","0","0","2","0","2","1","0","1","0","0","0","0","0","0","-2"
"441937","California State University-Channel Islands","2015","On-tenure track, assistant professors","44","16","28","0","0","0","4","1","3","1","0","1","11","2","9","0","0","0","21","10","11","1","0","1","4","2","2","2","1","1","-2"
"441937","California State University-Channel Islands","2015","Not on tenure track/No tenure system system total","72","34","38","0","0","0","6","4","2","1","0","1","6","4","2","0","0","0","54","23","31","2","2","0","3","1","2","0","0","0","-2"
"441937","California State University-Channel Islands","2015","Not on tenure/no tenure system, lecturers","72","34","38","0","0","0","6","4","2","1","0","1","6","4","2","0","0","0","54","23","31","2","2","0","3","1","2","0","0","0","-2"
"443562","Dewey University-Hato Rey","2015","Not on tenure track/No tenure system system total","239","108","131","0","0","0","0","0","0","0","0","0","239","108","131","0","0","0","0","0","0","0","0","0","0","0","0","0","0","0","-2"
"443562","Dewey University-Hato Rey","2015","Not on tenure/no tenure system, professors","239","108","131","0","0","0","0","0","0","0","0","0","239","108","131","0","0","0","0","0","0","0","0","0","0","0","0","0","0","0","-2"
"444398","Baptist University of the Americas","2015","Tenured total","3","2","1","0","0","0","0","0","0","0","0","0","3","2","1","0","0","0","0","0","0","0","0","0","0","0","0","0","0","0","-2"
"444398","Baptist University of the Americas","2015","Tenured, professors","3","2","1","0","0","0","0","0","0","0","0","0","3","2","1","0","0","0","0","0","0","0","0","0","0","0","0","0","0","0","-2"
"444398","Baptist University of the Americas","2015","On-Tenure track total","2","1","1","0","0","0","0","0","0","0","0","0","1","0","1","0","0","0","1","1","0","0","0","0","0","0","0","0","0","0","-2"
"444398","Baptist University of the Americas","2015","On-tenure track, assistant professors","2","1","1","0","0","0","0","0","0","0","0","0","1","0","1","0","0","0","1","1","0","0","0","0","0","0","0","0","0","0","-2"
"444398","Baptist University of the Americas","2015","Not on tenure track/No tenure system system total","5","2","3","0","0","0","0","0","0","0","0","0","3","0","3","0","0","0","2","2","0","0","0","0","0","0","0","0","0","0","-2"
"444398","Baptist University of the Americas","2015","Not on tenure/no tenure system, assistant professors","1","1","0","0","0","0","0","0","0","0","0","0","0","0","0","0","0","0","1","1","0","0","0","0","0","0","0","0","0","0","-2"
"444398","Baptist University of the Americas","2015","Not on tenure/no tenure system, instructors","4","1","3","0","0","0","0","0","0","0","0","0","3","0","3","0","0","0","1","1","0","0","0","0","0","0","0","0","0","0","-2"
"448752","CollegeAmerica-Colorado Springs","2015","Not on tenure track/No tenure system system total","8","6","2","0","0","0","0","0","0","2","1","1","0","0","0","0","0","0","6","5","1","0","0","0","0","0","0","0","0","0","-2"
"448752","CollegeAmerica-Colorado Springs","2015","Not on tenure/no tenure system, no academic rank","8","6","2","0","0","0","0","0","0","2","1","1","0","0","0","0","0","0","6","5","1","0","0","0","0","0","0","0","0","0","-2"
"448886","Arizona State University-Downtown Phoenix","2015","Tenured total","127","55","72","0","0","0","11","4","7","3","1","2","8","4","4","0","0","0","99","45","54","1","0","1","3","0","3","2","1","1","-2"
"448886","Arizona State University-Downtown Phoenix","2015","Tenured, professors","57","34","23","0","0","0","1","1","0","0","0","0","5","4","1","0","0","0","50","29","21","0","0","0","1","0","1","0","0","0","-2"
"448886","Arizona State University-Downtown Phoenix","2015","Tenured, associate professors","70","21","49","0","0","0","10","3","7","3","1","2","3","0","3","0","0","0","49","16","33","1","0","1","2","0","2","2","1","1","-2"
"448886","Arizona State University-Downtown Phoenix","2015","On-Tenure track total","51","23","28","0","0","0","9","4","5","0","0","0","5","4","1","0","0","0","32","13","19","2","0","2","1","1","0","2","1","1","-2"
"448886","Arizona State University-Downtown Phoenix","2015","On-tenure track, assistant professors","51","23","28","0","0","0","9","4","5","0","0","0","5","4","1","0","0","0","32","13","19","2","0","2","1","1","0","2","1","1","-2"
"448886","Arizona State University-Downtown Phoenix","2015","Not on tenure track/No tenure system system total","233","74","159","2","1","1","5","1","4","12","2","10","13","4","9","0","0","0","195","63","132","3","0","3","1","1","0","2","2","0","-2"
"448886","Arizona State University-Downtown Phoenix","2015","Not on tenure/no tenure system, professors","32","18","14","0","0","0","0","0","0","2","0","2","2","0","2","0","0","0","27","17","10","0","0","0","1","1","0","0","0","0","-2"
"448886","Arizona State University-Downtown Phoenix","2015","Not on tenure/no tenure system, associate professors","30","4","26","0","0","0","0","0","0","1","0","1","2","0","2","0","0","0","25","4","21","2","0","2","0","0","0","0","0","0","-2"
"448886","Arizona State University-Downtown Phoenix","2015","Not on tenure/no tenure system, assistant professors","35","6","29","0","0","0","0","0","0","0","0","0","2","0","2","0","0","0","32","5","27","0","0","0","0","0","0","1","1","0","-2"
"448886","Arizona State University-Downtown Phoenix","2015","Not on tenure/no tenure system, instructors","63","22","41","2","1","1","3","1","2","6","2","4","4","2","2","0","0","0","48","16","32","0","0","0","0","0","0","0","0","0","-2"
"448886","Arizona State University-Downtown Phoenix","2015","Not on tenure/no tenure system, lecturers","73","24","49","0","0","0","2","0","2","3","0","3","3","2","1","0","0","0","63","21","42","1","0","1","0","0","0","1","1","0","-2"
"449870","University of the West","2015","Tenured total","5","4","1","0","0","0","3","3","0","0","0","0","0","0","0","1","0","1","1","1","0","0","0","0","0","0","0","0","0","0","-2"
"449870","University of the West","2015","Tenured, professors","2","2","0","0","0","0","2","2","0","0","0","0","0","0","0","0","0","0","0","0","0","0","0","0","0","0","0","0","0","0","-2"
"449870","University of the West","2015","Tenured, associate professors","3","2","1","0","0","0","1","1","0","0","0","0","0","0","0","1","0","1","1","1","0","0","0","0","0","0","0","0","0","0","-2"
"449870","University of the West","2015","On-Tenure track total","9","6","3","0","0","0","1","1","0","1","0","1","0","0","0","1","1","0","3","1","2","1","1","0","0","0","0","2","2","0","-2"
"449870","University of the West","2015","On-tenure track, associate professors","1","1","0","0","0","0","0","0","0","0","0","0","0","0","0","0","0","0","1","1","0","0","0","0","0","0","0","0","0","0","-2"
"449870","University of the West","2015","On-tenure track, assistant professors","8","5","3","0","0","0","1","1","0","1","0","1","0","0","0","1","1","0","2","0","2","1","1","0","0","0","0","2","2","0","-2"
"449870","University of the West","2015","Not on tenure track/No tenure system system total","3","3","0","0","0","0","0","0","0","0","0","0","1","1","0","0","0","0","2","2","0","0","0","0","0","0","0","0","0","0","-2"
"449870","University of the West","2015","Not on tenure/no tenure system, assistant professors","2","2","0","0","0","0","0","0","0","0","0","0","0","0","0","0","0","0","2","2","0","0","0","0","0","0","0","0","0","0","-2"
"449870","University of the West","2015","Not on tenure/no tenure system, instructors","1","1","0","0","0","0","0","0","0","0","0","0","1","1","0","0","0","0","0","0","0","0","0","0","0","0","0","0","0","0","-2"
"455770","Providence Christian College","2015","Not on tenure track/No tenure system system total","5","4","1","0","0","0","0","0","0","0","0","0","0","0","0","0","0","0","5","4","1","0","0","0","0","0","0","0","0","0","-2"
"455770","Providence Christian College","2015","Not on tenure/no tenure system, professors","3","3","0","0","0","0","0","0","0","0","0","0","0","0","0","0","0","0","3","3","0","0","0","0","0","0","0","0","0","0","-2"
"455770","Providence Christian College","2015","Not on tenure/no tenure system, assistant professors","2","1","1","0","0","0","0","0","0","0","0","0","0","0","0","0","0","0","2","1","1","0","0","0","0","0","0","0","0","0","-2"
"456490","Polytechnic University of Puerto Rico-Orlando","2015","Not on tenure track/No tenure system system total","3","2","1","0","0","0","0","0","0","0","0","0","3","2","1","0","0","0","0","0","0","0","0","0","0","0","0","0","0","0","-2"
"456490","Polytechnic University of Puerto Rico-Orlando","2015","Not on tenure/no tenure system, professors","1","0","1","0","0","0","0","0","0","0","0","0","1","0","1","0","0","0","0","0","0","0","0","0","0","0","0","0","0","0","-2"
"456490","Polytechnic University of Puerto Rico-Orlando","2015","Not on tenure/no tenure system, associate professors","2","2","0","0","0","0","0","0","0","0","0","0","2","2","0","0","0","0","0","0","0","0","0","0","0","0","0","0","0","0","-2"
"457086","Homestead Schools","2015","Not on tenure track/No tenure system system total","1","1","0","0","0","0","1","1","0","0","0","0","0","0","0","0","0","0","0","0","0","0","0","0","0","0","0","0","0","0","-2"
"457086","Homestead Schools","2015","Not on tenure/no tenure system, instructors","1","1","0","0","0","0","1","1","0","0","0","0","0","0","0","0","0","0","0","0","0","0","0","0","0","0","0","0","0","0","-2"
"459949","Texas A&M University-San Antonio","2015","Tenured total","24","14","10","0","0","0","1","1","0","0","0","0","5","2","3","0","0","0","18","11","7","0","0","0","0","0","0","0","0","0","-2"
"459949","Texas A&M University-San Antonio","2015","Tenured, professors","6","3","3","0","0","0","0","0","0","0","0","0","3","1","2","0","0","0","3","2","1","0","0","0","0","0","0","0","0","0","-2"
"459949","Texas A&M University-San Antonio","2015","Tenured, associate professors","14","8","6","0","0","0","1","1","0","0","0","0","2","1","1","0","0","0","11","6","5","0","0","0","0","0","0","0","0","0","-2"
"459949","Texas A&M University-San Antonio","2015","Tenured, assistant professors","4","3","1","0","0","0","0","0","0","0","0","0","0","0","0","0","0","0","4","3","1","0","0","0","0","0","0","0","0","0","-2"
"459949","Texas A&M University-San Antonio","2015","On-Tenure track total","45","12","33","0","0","0","3","1","2","1","0","1","4","1","3","1","0","1","31","8","23","0","0","0","0","0","0","5","2","3","-2"
"459949","Texas A&M University-San Antonio","2015","On-tenure track, associate professors","17","4","13","0","0","0","0","0","0","1","0","1","2","0","2","0","0","0","14","4","10","0","0","0","0","0","0","0","0","0","-2"
"459949","Texas A&M University-San Antonio","2015","On-tenure track, assistant professors","28","8","20","0","0","0","3","1","2","0","0","0","2","1","1","1","0","1","17","4","13","0","0","0","0","0","0","5","2","3","-2"
"459949","Texas A&M University-San Antonio","2015","Not on tenure track/No tenure system system total","33","24","9","0","0","0","1","1","0","2","2","0","9","7","2","0","0","0","20","13","7","0","0","0","0","0","0","1","1","0","-2"
"459949","Texas A&M University-San Antonio","2015","Not on tenure/no tenure system, associate professors","5","5","0","0","0","0","1","1","0","1","1","0","1","1","0","0","0","0","2","2","0","0","0","0","0","0","0","0","0","0","-2"
"459949","Texas A&M University-San Antonio","2015","Not on tenure/no tenure system, assistant professors","28","19","9","0","0","0","0","0","0","1","1","0","8","6","2","0","0","0","18","11","7","0","0","0","0","0","0","1","1","0","-2"
"462354","John Paul the Great Catholic University","2015","Not on tenure track/No tenure system system total","5","5","0","0","0","0","0","0","0","0","0","0","0","0","0","0","0","0","3","3","0","0","0","0","2","2","0","0","0","0","-2"
"462354","John Paul the Great Catholic University","2015","Not on tenure/no tenure system, professors","5","5","0","0","0","0","0","0","0","0","0","0","0","0","0","0","0","0","3","3","0","0","0","0","2","2","0","0","0","0","-2"
"474906","Stevens-Henager College","2015","Not on tenure track/No tenure system system total","4","1","3","0","0","0","0","0","0","0","0","0","0","0","0","0","0","0","4","1","3","0","0","0","0","0","0","0","0","0","-2"
"474906","Stevens-Henager College","2015","Not on tenure/no tenure system, no academic rank","4","1","3","0","0","0","0","0","0","0","0","0","0","0","0","0","0","0","4","1","3","0","0","0","0","0","0","0","0","0","-2"
"475273","Springfield College-Regional, Online, and Continuing Education","2015","Tenured total","6","3","3","0","0","0","0","0","0","2","1","1","2","1","1","0","0","0","2","1","1","0","0","0","0","0","0","0","0","0","-2"
"475273","Springfield College-Regional, Online, and Continuing Education","2015","Tenured, professors","5","3","2","0","0","0","0","0","0","2","1","1","1","1","0","0","0","0","2","1","1","0","0","0","0","0","0","0","0","0","-2"
"475273","Springfield College-Regional, Online, and Continuing Education","2015","Tenured, associate professors","1","0","1","0","0","0","0","0","0","0","0","0","1","0","1","0","0","0","0","0","0","0","0","0","0","0","0","0","0","0","-2"
"475273","Springfield College-Regional, Online, and Continuing Education","2015","Not on tenure track/No tenure system system total","13","6","7","0","0","0","0","0","0","3","2","1","1","0","1","0","0","0","7","4","3","0","0","0","2","0","2","0","0","0","-2"
"475273","Springfield College-Regional, Online, and Continuing Education","2015","Not on tenure/no tenure system, professors","2","2","0","0","0","0","0","0","0","0","0","0","0","0","0","0","0","0","2","2","0","0","0","0","0","0","0","0","0","0","-2"
"475273","Springfield College-Regional, Online, and Continuing Education","2015","Not on tenure/no tenure system, associate professors","2","0","2","0","0","0","0","0","0","0","0","0","1","0","1","0","0","0","0","0","0","0","0","0","1","0","1","0","0","0","-2"
"475273","Springfield College-Regional, Online, and Continuing Education","2015","Not on tenure/no tenure system, assistant professors","9","4","5","0","0","0","0","0","0","3","2","1","0","0","0","0","0","0","5","2","3","0","0","0","1","0","1","0","0","0","-2"
"478634","California College San Diego","2015","Not on tenure track/No tenure system system total","6","3","3","0","0","0","1","0","1","0","0","0","1","1","0","0","0","0","4","2","2","0","0","0","0","0","0","0","0","0","-2"
"478634","California College San Diego","2015","Not on tenure/no tenure system, no academic rank","6","3","3","0","0","0","1","0","1","0","0","0","1","1","0","0","0","0","4","2","2","0","0","0","0","0","0","0","0","0","-2"
"483036","Texas A&M University-Central Texas","2015","Tenured total","11","6","5","0","0","0","0","0","0","0","0","0","1","0","1","0","0","0","10","6","4","0","0","0","0","0","0","0","0","0","-2"
"483036","Texas A&M University-Central Texas","2015","Tenured, professors","3","1","2","0","0","0","0","0","0","0","0","0","0","0","0","0","0","0","3","1","2","0","0","0","0","0","0","0","0","0","-2"
"483036","Texas A&M University-Central Texas","2015","Tenured, associate professors","5","3","2","0","0","0","0","0","0","0","0","0","0","0","0","0","0","0","5","3","2","0","0","0","0","0","0","0","0","0","-2"
"483036","Texas A&M University-Central Texas","2015","Tenured, assistant professors","3","2","1","0","0","0","0","0","0","0","0","0","1","0","1","0","0","0","2","2","0","0","0","0","0","0","0","0","0","0","-2"
"483036","Texas A&M University-Central Texas","2015","On-Tenure track total","22","14","8","0","0","0","1","0","1","0","0","0","0","0","0","0","0","0","21","14","7","0","0","0","0","0","0","0","0","0","-2"
"483036","Texas A&M University-Central Texas","2015","On-tenure track, associate professors","10","7","3","0","0","0","1","0","1","0","0","0","0","0","0","0","0","0","9","7","2","0","0","0","0","0","0","0","0","0","-2"
"483036","Texas A&M University-Central Texas","2015","On-tenure track, assistant professors","9","4","5","0","0","0","0","0","0","0","0","0","0","0","0","0","0","0","9","4","5","0","0","0","0","0","0","0","0","0","-2"
"483036","Texas A&M University-Central Texas","2015","On-tenure track, lecturers","3","3","0","0","0","0","0","0","0","0","0","0","0","0","0","0","0","0","3","3","0","0","0","0","0","0","0","0","0","0","-2"
"483036","Texas A&M University-Central Texas","2015","Not on tenure track/No tenure system system total","50","21","29","1","0","1","3","1","2","5","2","3","5","1","4","1","1","0","31","14","17","0","0","0","0","0","0","4","2","2","-2"
"483036","Texas A&M University-Central Texas","2015","Not on tenure/no tenure system, professors","1","1","0","0","0","0","0","0","0","0","0","0","0","0","0","0","0","0","1","1","0","0","0","0","0","0","0","0","0","0","-2"
"483036","Texas A&M University-Central Texas","2015","Not on tenure/no tenure system, associate professors","3","2","1","0","0","0","0","0","0","0","0","0","0","0","0","0","0","0","3","2","1","0","0","0","0","0","0","0","0","0","-2"
"483036","Texas A&M University-Central Texas","2015","Not on tenure/no tenure system, assistant professors","32","14","18","1","0","1","3","1","2","3","1","2","3","1","2","1","1","0","17","8","9","0","0","0","0","0","0","4","2","2","-2"
"483036","Texas A&M University-Central Texas","2015","Not on tenure/no tenure system, instructors","5","2","3","0","0","0","0","0","0","1","0","1","1","0","1","0","0","0","3","2","1","0","0","0","0","0","0","0","0","0","-2"
"483036","Texas A&M University-Central Texas","2015","Not on tenure/no tenure system, lecturers","9","2","7","0","0","0","0","0","0","1","1","0","1","0","1","0","0","0","7","1","6","0","0","0","0","0","0","0","0","0","-2"
"484905","University of North Texas at Dallas","2015","Tenured total","15","7","8","0","0","0","5","3","2","1","0","1","3","2","1","0","0","0","6","2","4","0","0","0","0","0","0","0","0","0","-2"
"484905","University of North Texas at Dallas","2015","Tenured, professors","9","5","4","0","0","0","2","2","0","1","0","1","2","1","1","0","0","0","4","2","2","0","0","0","0","0","0","0","0","0","-2"
"484905","University of North Texas at Dallas","2015","Tenured, associate professors","6","2","4","0","0","0","3","1","2","0","0","0","1","1","0","0","0","0","2","0","2","0","0","0","0","0","0","0","0","0","-2"
"484905","University of North Texas at Dallas","2015","On-Tenure track total","33","19","14","0","0","0","4","2","2","5","4","1","4","1","3","0","0","0","15","10","5","0","0","0","2","1","1","3","1","2","-2"
"484905","University of North Texas at Dallas","2015","On-tenure track, associate professors","2","2","0","0","0","0","0","0","0","0","0","0","1","1","0","0","0","0","1","1","0","0","0","0","0","0","0","0","0","0","-2"
"484905","University of North Texas at Dallas","2015","On-tenure track, assistant professors","31","17","14","0","0","0","4","2","2","5","4","1","3","0","3","0","0","0","14","9","5","0","0","0","2","1","1","3","1","2","-2"
"484905","University of North Texas at Dallas","2015","Not on tenure track/No tenure system system total","41","21","20","1","1","0","4","2","2","9","4","5","3","1","2","0","0","0","23","13","10","1","0","1","0","0","0","0","0","0","-2"
"484905","University of North Texas at Dallas","2015","Not on tenure/no tenure system, instructors","20","10","10","1","1","0","1","0","1","7","4","3","2","1","1","0","0","0","8","4","4","1","0","1","0","0","0","0","0","0","-2"
"484905","University of North Texas at Dallas","2015","Not on tenure/no tenure system, lecturers","21","11","10","0","0","0","3","2","1","2","0","2","1","0","1","0","0","0","15","9","6","0","0","0","0","0","0","0","0","0","-2"
"485263","California College San Diego","2015","Not on tenure track/No tenure system system total","22","13","9","0","0","0","8","7","1","1","1","0","4","2","2","0","0","0","9","3","6","0","0","0","0","0","0","0","0","0","-2"
"485263","California College San Diego","2015","Not on tenure/no tenure system, no academic rank","22","13","9","0","0","0","8","7","1","1","1","0","4","2","2","0","0","0","9","3","6","0","0","0","0","0","0","0","0","0","-2"
"487296","University of Arizona-Sierra Vista","2015","Tenured total","7","3","4","0","0","0","1","0","1","0","0","0","1","1","0","0","0","0","5","2","3","0","0","0","0","0","0","0","0","0","-2"
"487296","University of Arizona-Sierra Vista","2015","Tenured, associate professors","7","3","4","0","0","0","1","0","1","0","0","0","1","1","0","0","0","0","5","2","3","0","0","0","0","0","0","0","0","0","-2"
"487296","University of Arizona-Sierra Vista","2015","On-Tenure track total","3","1","2","1","0","1","0","0","0","0","0","0","1","1","0","0","0","0","1","0","1","0","0","0","0","0","0","0","0","0","-2"
"487296","University of Arizona-Sierra Vista","2015","On-tenure track, associate professors","3","1","2","1","0","1","0","0","0","0","0","0","1","1","0","0","0","0","1","0","1","0","0","0","0","0","0","0","0","0","-2"
"487296","University of Arizona-Sierra Vista","2015","Not on tenure track/No tenure system system total","13","7","6","1","0","1","0","0","0","1","0","1","1","0","1","0","0","0","9","6","3","0","0","0","1","1","0","0","0","0","-2"
"487296","University of Arizona-Sierra Vista","2015","Not on tenure/no tenure system, professors","2","2","0","0","0","0","0","0","0","0","0","0","0","0","0","0","0","0","2","2","0","0","0","0","0","0","0","0","0","0","-2"
"487296","University of Arizona-Sierra Vista","2015","Not on tenure/no tenure system, associate professors","1","0","1","0","0","0","0","0","0","1","0","1","0","0","0","0","0","0","0","0","0","0","0","0","0","0","0","0","0","0","-2"
"487296","University of Arizona-Sierra Vista","2015","Not on tenure/no tenure system, assistant professors","6","2","4","1","0","1","0","0","0","0","0","0","1","0","1","0","0","0","3","1","2","0","0","0","1","1","0","0","0","0","-2"
"487296","University of Arizona-Sierra Vista","2015","Not on tenure/no tenure system, lecturers","4","3","1","0","0","0","0","0","0","0","0","0","0","0","0","0","0","0","4","3","1","0","0","0","0","0","0","0","0","0","-2"
