"unitid","institution name","year","S2012_IS.Instructional staff category","S2012_IS_RV.Grand total","S2012_IS_RV.Grand total men","S2012_IS_RV.Grand total women","S2012_IS_RV.American Indian or Alaska Native total","S2012_IS_RV.American Indian or Alaska Native men","S2012_IS_RV.American Indian or Alaska Native women","S2012_IS_RV.Asian total","S2012_IS_RV.Asian men","S2012_IS_RV.Asian women","S2012_IS_RV.Black or African American total","S2012_IS_RV.Black or African American men","S2012_IS_RV.Black or African American women","S2012_IS_RV.Hispanic or Latino total","S2012_IS_RV.Hispanic or Latino men","S2012_IS_RV.Hispanic or Latino women","S2012_IS_RV.Native Hawaiian or Other Pacific Islander total","S2012_IS_RV.Native Hawaiian or Other Pacific Islander men","S2012_IS_RV.Native Hawaiian or Other Pacific Islander women","S2012_IS_RV.White total","S2012_IS_RV.White men","S2012_IS_RV.White women","S2012_IS_RV.Two or more races total","S2012_IS_RV.Two or more races men","S2012_IS_RV.Two or more races women","S2012_IS_RV.Race/ethnicity unknown total","S2012_IS_RV.Race/ethnicity unknown men","S2012_IS_RV.Race/ethnicity unknown women","S2012_IS_RV.Nonresident alien total","S2012_IS_RV.Nonresident alien men","S2012_IS_RV.Nonresident alien women","IDX_HR"
"105367","Ottawa University-Phoenix","2012","Tenured total","3","0","3","0","0","0","1","0","1","0","0","0","0","0","0","0","0","0","2","0","2","0","0","0","0","0","0","0","0","0","-2"
"105367","Ottawa University-Phoenix","2012","Tenured, professors","1","0","1","0","0","0","0","0","0","0","0","0","0","0","0","0","0","0","1","0","1","0","0","0","0","0","0","0","0","0","-2"
"105367","Ottawa University-Phoenix","2012","Tenured, associate professors","2","0","2","0","0","0","1","0","1","0","0","0","0","0","0","0","0","0","1","0","1","0","0","0","0","0","0","0","0","0","-2"
"109785","Azusa Pacific University","2012","Not on tenure track/No tenure system system total","407","196","211","3","1","2","51","22","29","26","12","14","25","9","16","3","2","1","271","133","138","1","0","1","21","15","6","6","2","4","-2"
"109785","Azusa Pacific University","2012","Not on tenure/no tenure system, professors","144","88","56","0","0","0","15","8","7","10","8","2","6","3","3","0","0","0","105","64","41","1","0","1","7","5","2","0","0","0","-2"
"109785","Azusa Pacific University","2012","Not on tenure/no tenure system, associate professors","114","62","52","1","0","1","17","10","7","12","4","8","4","3","1","1","0","1","73","39","34","0","0","0","5","5","0","1","1","0","-2"
"109785","Azusa Pacific University","2012","Not on tenure/no tenure system, assistant professors","138","45","93","2","1","1","18","4","14","4","0","4","15","3","12","2","2","0","84","29","55","0","0","0","9","5","4","4","1","3","-2"
"109785","Azusa Pacific University","2012","Not on tenure/no tenure system, instructors","11","1","10","0","0","0","1","0","1","0","0","0","0","0","0","0","0","0","9","1","8","0","0","0","0","0","0","1","0","1","-2"
"109819","Bakersfield College","2012","Tenured total","197","103","94","1","0","1","6","2","4","9","4","5","22","10","12","1","1","0","148","82","66","0","0","0","10","4","6","0","0","0","-2"
"109819","Bakersfield College","2012","Tenured, instructors","197","103","94","1","0","1","6","2","4","9","4","5","22","10","12","1","1","0","148","82","66","0","0","0","10","4","6","0","0","0","-2"
"109819","Bakersfield College","2012","On-Tenure track total","54","26","28","1","1","0","3","3","0","1","1","0","3","2","1","0","0","0","43","18","25","0","0","0","3","1","2","0","0","0","-2"
"109819","Bakersfield College","2012","On-tenure track, instructors","54","26","28","1","1","0","3","3","0","1","1","0","3","2","1","0","0","0","43","18","25","0","0","0","3","1","2","0","0","0","-2"
"109819","Bakersfield College","2012","Not on tenure track/No tenure system system total","1","0","1","0","0","0","0","0","0","0","0","0","0","0","0","0","0","0","1","0","1","0","0","0","0","0","0","0","0","0","-2"
"109819","Bakersfield College","2012","Not on tenure/no tenure system, instructors","1","0","1","0","0","0","0","0","0","0","0","0","0","0","0","0","0","0","1","0","1","0","0","0","0","0","0","0","0","0","-2"
"110413","California Lutheran University","2012","Tenured total","77","44","33","1","1","0","9","3","6","3","2","1","3","2","1","0","0","0","61","36","25","0","0","0","0","0","0","0","0","0","-2"
"110413","California Lutheran University","2012","Tenured, professors","42","27","15","1","1","0","5","3","2","1","1","0","0","0","0","0","0","0","35","22","13","0","0","0","0","0","0","0","0","0","-2"
"110413","California Lutheran University","2012","Tenured, associate professors","31","15","16","0","0","0","4","0","4","2","1","1","2","1","1","0","0","0","23","13","10","0","0","0","0","0","0","0","0","0","-2"
"110413","California Lutheran University","2012","Tenured, assistant professors","4","2","2","0","0","0","0","0","0","0","0","0","1","1","0","0","0","0","3","1","2","0","0","0","0","0","0","0","0","0","-2"
"110413","California Lutheran University","2012","On-Tenure track total","42","24","18","0","0","0","2","2","0","3","0","3","7","3","4","0","0","0","29","18","11","1","1","0","0","0","0","0","0","0","-2"
"110413","California Lutheran University","2012","On-tenure track, professors","4","4","0","0","0","0","0","0","0","0","0","0","1","1","0","0","0","0","3","3","0","0","0","0","0","0","0","0","0","0","-2"
"110413","California Lutheran University","2012","On-tenure track, associate professors","4","1","3","0","0","0","0","0","0","2","0","2","1","1","0","0","0","0","1","0","1","0","0","0","0","0","0","0","0","0","-2"
"110413","California Lutheran University","2012","On-tenure track, assistant professors","32","17","15","0","0","0","2","2","0","1","0","1","5","1","4","0","0","0","23","13","10","1","1","0","0","0","0","0","0","0","-2"
"110413","California Lutheran University","2012","On-tenure track, instructors","2","2","0","0","0","0","0","0","0","0","0","0","0","0","0","0","0","0","2","2","0","0","0","0","0","0","0","0","0","0","-2"
"110413","California Lutheran University","2012","Not on tenure track/No tenure system system total","44","19","25","0","0","0","2","0","2","0","0","0","3","0","3","0","0","0","39","19","20","0","0","0","0","0","0","0","0","0","-2"
"110413","California Lutheran University","2012","Not on tenure/no tenure system, professors","4","2","2","0","0","0","0","0","0","0","0","0","0","0","0","0","0","0","4","2","2","0","0","0","0","0","0","0","0","0","-2"
"110413","California Lutheran University","2012","Not on tenure/no tenure system, associate professors","3","2","1","0","0","0","0","0","0","0","0","0","0","0","0","0","0","0","3","2","1","0","0","0","0","0","0","0","0","0","-2"
"110413","California Lutheran University","2012","Not on tenure/no tenure system, assistant professors","8","1","7","0","0","0","1","0","1","0","0","0","2","0","2","0","0","0","5","1","4","0","0","0","0","0","0","0","0","0","-2"
"110413","California Lutheran University","2012","Not on tenure/no tenure system, instructors","5","4","1","0","0","0","0","0","0","0","0","0","1","0","1","0","0","0","4","4","0","0","0","0","0","0","0","0","0","0","-2"
"110413","California Lutheran University","2012","Not on tenure/no tenure system, lecturers","24","10","14","0","0","0","1","0","1","0","0","0","0","0","0","0","0","0","23","10","13","0","0","0","0","0","0","0","0","0","-2"
"110486","California State University-Bakersfield","2012","Tenured total","145","85","60","0","0","0","20","15","5","9","4","5","15","10","5","1","1","0","92","49","43","2","1","1","1","1","0","5","4","1","-2"
"110486","California State University-Bakersfield","2012","Tenured, professors","82","57","25","0","0","0","13","11","2","6","3","3","9","7","2","1","1","0","51","33","18","1","1","0","0","0","0","1","1","0","-2"
"110486","California State University-Bakersfield","2012","Tenured, associate professors","61","27","34","0","0","0","6","3","3","3","1","2","6","3","3","0","0","0","40","16","24","1","0","1","1","1","0","4","3","1","-2"
"110486","California State University-Bakersfield","2012","Tenured, assistant professors","2","1","1","0","0","0","1","1","0","0","0","0","0","0","0","0","0","0","1","0","1","0","0","0","0","0","0","0","0","0","-2"
"110486","California State University-Bakersfield","2012","On-Tenure track total","27","14","13","0","0","0","1","1","0","2","1","1","8","4","4","0","0","0","12","5","7","0","0","0","0","0","0","4","3","1","-2"
"110486","California State University-Bakersfield","2012","On-tenure track, associate professors","1","0","1","0","0","0","0","0","0","0","0","0","0","0","0","0","0","0","1","0","1","0","0","0","0","0","0","0","0","0","-2"
"110486","California State University-Bakersfield","2012","On-tenure track, assistant professors","26","14","12","0","0","0","1","1","0","2","1","1","8","4","4","0","0","0","11","5","6","0","0","0","0","0","0","4","3","1","-2"
"110486","California State University-Bakersfield","2012","Not on tenure track/No tenure system system total","72","21","51","0","0","0","7","2","5","1","0","1","6","3","3","2","1","1","49","12","37","1","1","0","4","1","3","2","1","1","-2"
"110486","California State University-Bakersfield","2012","Not on tenure/no tenure system, lecturers","72","21","51","0","0","0","7","2","5","1","0","1","6","3","3","2","1","1","49","12","37","1","1","0","4","1","3","2","1","1","-2"
"110495","California State University-Stanislaus","2012","Tenured total","170","95","75","1","0","1","22","6","16","3","3","0","15","8","7","0","0","0","119","70","49","0","0","0","9","7","2","1","1","0","-2"
"110495","California State University-Stanislaus","2012","Tenured, professors","116","68","48","0","0","0","15","4","11","2","2","0","8","4","4","0","0","0","85","54","31","0","0","0","6","4","2","0","0","0","-2"
"110495","California State University-Stanislaus","2012","Tenured, associate professors","54","27","27","1","0","1","7","2","5","1","1","0","7","4","3","0","0","0","34","16","18","0","0","0","3","3","0","1","1","0","-2"
"110495","California State University-Stanislaus","2012","On-Tenure track total","53","27","26","0","0","0","8","4","4","3","1","2","3","2","1","0","0","0","33","17","16","0","0","0","3","1","2","3","2","1","-2"
"110495","California State University-Stanislaus","2012","On-tenure track, assistant professors","53","27","26","0","0","0","8","4","4","3","1","2","3","2","1","0","0","0","33","17","16","0","0","0","3","1","2","3","2","1","-2"
"110495","California State University-Stanislaus","2012","Not on tenure track/No tenure system system total","51","28","23","1","1","0","6","3","3","1","0","1","4","2","2","0","0","0","35","19","16","0","0","0","4","3","1","0","0","0","-2"
"110495","California State University-Stanislaus","2012","Not on tenure/no tenure system, lecturers","51","28","23","1","1","0","6","3","3","1","0","1","4","2","2","0","0","0","35","19","16","0","0","0","4","3","1","0","0","0","-2"
"110510","California State University-San Bernardino","2012","Tenured total","300","181","119","1","1","0","46","29","17","15","4","11","26","16","10","0","0","0","201","125","76","1","1","0","8","4","4","2","1","1","-2"
"110510","California State University-San Bernardino","2012","Tenured, professors","223","145","78","1","1","0","38","26","12","10","3","7","19","12","7","0","0","0","147","99","48","1","1","0","7","3","4","0","0","0","-2"
"110510","California State University-San Bernardino","2012","Tenured, associate professors","70","33","37","0","0","0","7","2","5","4","1","3","7","4","3","0","0","0","49","24","25","0","0","0","1","1","0","2","1","1","-2"
"110510","California State University-San Bernardino","2012","Tenured, assistant professors","7","3","4","0","0","0","1","1","0","1","0","1","0","0","0","0","0","0","5","2","3","0","0","0","0","0","0","0","0","0","-2"
"110510","California State University-San Bernardino","2012","On-Tenure track total","57","28","29","0","0","0","11","5","6","3","2","1","5","3","2","0","0","0","28","13","15","0","0","0","4","1","3","6","4","2","-2"
"110510","California State University-San Bernardino","2012","On-tenure track, professors","1","1","0","0","0","0","1","1","0","0","0","0","0","0","0","0","0","0","0","0","0","0","0","0","0","0","0","0","0","0","-2"
"110510","California State University-San Bernardino","2012","On-tenure track, associate professors","3","1","2","0","0","0","0","0","0","0","0","0","0","0","0","0","0","0","3","1","2","0","0","0","0","0","0","0","0","0","-2"
"110510","California State University-San Bernardino","2012","On-tenure track, assistant professors","53","26","27","0","0","0","10","4","6","3","2","1","5","3","2","0","0","0","25","12","13","0","0","0","4","1","3","6","4","2","-2"
"110510","California State University-San Bernardino","2012","Not on tenure track/No tenure system system total","88","29","59","0","0","0","5","2","3","3","0","3","9","3","6","0","0","0","68","21","47","0","0","0","3","3","0","0","0","0","-2"
"110510","California State University-San Bernardino","2012","Not on tenure/no tenure system, lecturers","88","29","59","0","0","0","5","2","3","3","0","3","9","3","6","0","0","0","68","21","47","0","0","0","3","3","0","0","0","0","-2"
"110529","California State Polytechnic University-Pomona","2012","Tenured total","348","210","138","1","0","1","72","49","23","9","6","3","31","20","11","1","1","0","215","123","92","0","0","0","16","9","7","3","2","1","-2"
"110529","California State Polytechnic University-Pomona","2012","Tenured, professors","254","161","93","0","0","0","59","42","17","6","3","3","19","13","6","1","1","0","160","96","64","0","0","0","8","5","3","1","1","0","-2"
"110529","California State Polytechnic University-Pomona","2012","Tenured, associate professors","94","49","45","1","0","1","13","7","6","3","3","0","12","7","5","0","0","0","55","27","28","0","0","0","8","4","4","2","1","1","-2"
"110529","California State Polytechnic University-Pomona","2012","On-Tenure track total","110","60","50","0","0","0","31","16","15","5","2","3","5","3","2","0","0","0","43","26","17","1","0","1","6","5","1","19","8","11","-2"
"110529","California State Polytechnic University-Pomona","2012","On-tenure track, associate professors","12","11","1","0","0","0","6","6","0","1","1","0","0","0","0","0","0","0","5","4","1","0","0","0","0","0","0","0","0","0","-2"
"110529","California State Polytechnic University-Pomona","2012","On-tenure track, assistant professors","98","49","49","0","0","0","25","10","15","4","1","3","5","3","2","0","0","0","38","22","16","1","0","1","6","5","1","19","8","11","-2"
"110529","California State Polytechnic University-Pomona","2012","Not on tenure track/No tenure system system total","66","41","25","1","1","0","7","4","3","2","1","1","8","5","3","0","0","0","41","25","16","2","1","1","4","4","0","1","0","1","-2"
"110529","California State Polytechnic University-Pomona","2012","Not on tenure/no tenure system, lecturers","66","41","25","1","1","0","7","4","3","2","1","1","8","5","3","0","0","0","41","25","16","2","1","1","4","4","0","1","0","1","-2"
"110547","California State University-Dominguez Hills","2012","Tenured total","152","77","75","1","0","1","20","13","7","14","5","9","10","7","3","0","0","0","97","50","47","1","0","1","8","2","6","1","0","1","-2"
"110547","California State University-Dominguez Hills","2012","Tenured, professors","81","48","33","0","0","0","7","6","1","5","1","4","8","6","2","0","0","0","56","34","22","0","0","0","5","1","4","0","0","0","-2"
"110547","California State University-Dominguez Hills","2012","Tenured, associate professors","69","29","40","1","0","1","13","7","6","9","4","5","2","1","1","0","0","0","40","16","24","0","0","0","3","1","2","1","0","1","-2"
"110547","California State University-Dominguez Hills","2012","Tenured, assistant professors","2","0","2","0","0","0","0","0","0","0","0","0","0","0","0","0","0","0","1","0","1","1","0","1","0","0","0","0","0","0","-2"
"110547","California State University-Dominguez Hills","2012","On-Tenure track total","34","13","21","0","0","0","6","1","5","3","1","2","8","6","2","0","0","0","14","3","11","1","1","0","2","1","1","0","0","0","-2"
"110547","California State University-Dominguez Hills","2012","On-tenure track, professors","1","1","0","0","0","0","0","0","0","0","0","0","1","1","0","0","0","0","0","0","0","0","0","0","0","0","0","0","0","0","-2"
"110547","California State University-Dominguez Hills","2012","On-tenure track, associate professors","3","1","2","0","0","0","0","0","0","0","0","0","1","1","0","0","0","0","2","0","2","0","0","0","0","0","0","0","0","0","-2"
"110547","California State University-Dominguez Hills","2012","On-tenure track, assistant professors","30","11","19","0","0","0","6","1","5","3","1","2","6","4","2","0","0","0","12","3","9","1","1","0","2","1","1","0","0","0","-2"
"110547","California State University-Dominguez Hills","2012","Not on tenure track/No tenure system system total","81","33","48","1","0","1","6","3","3","5","1","4","10","5","5","0","0","0","54","21","33","1","1","0","4","2","2","0","0","0","-2"
"110547","California State University-Dominguez Hills","2012","Not on tenure/no tenure system, lecturers","81","33","48","1","0","1","6","3","3","5","1","4","10","5","5","0","0","0","54","21","33","1","1","0","4","2","2","0","0","0","-2"
"110556","California State University-Fresno","2012","Tenured total","376","238","138","0","0","0","49","40","9","15","9","6","39","25","14","0","0","0","265","160","105","2","2","0","5","2","3","1","0","1","-2"
"110556","California State University-Fresno","2012","Tenured, professors","227","153","74","0","0","0","29","25","4","11","7","4","22","17","5","0","0","0","161","103","58","0","0","0","4","1","3","0","0","0","-2"
"110556","California State University-Fresno","2012","Tenured, associate professors","144","83","61","0","0","0","20","15","5","4","2","2","16","8","8","0","0","0","100","55","45","2","2","0","1","1","0","1","0","1","-2"
"110556","California State University-Fresno","2012","Tenured, assistant professors","4","1","3","0","0","0","0","0","0","0","0","0","1","0","1","0","0","0","3","1","2","0","0","0","0","0","0","0","0","0","-2"
"110556","California State University-Fresno","2012","Tenured, no academic rank","1","1","0","0","0","0","0","0","0","0","0","0","0","0","0","0","0","0","1","1","0","0","0","0","0","0","0","0","0","0","-2"
"110556","California State University-Fresno","2012","On-Tenure track total","114","63","51","0","0","0","29","18","11","5","3","2","8","5","3","0","0","0","59","31","28","2","1","1","2","0","2","9","5","4","-2"
"110556","California State University-Fresno","2012","On-tenure track, associate professors","5","4","1","0","0","0","1","1","0","0","0","0","0","0","0","0","0","0","3","2","1","0","0","0","0","0","0","1","1","0","-2"
"110556","California State University-Fresno","2012","On-tenure track, assistant professors","107","58","49","0","0","0","28","17","11","5","3","2","7","5","2","0","0","0","55","28","27","2","1","1","2","0","2","8","4","4","-2"
"110556","California State University-Fresno","2012","On-tenure track, no academic rank","2","1","1","0","0","0","0","0","0","0","0","0","1","0","1","0","0","0","1","1","0","0","0","0","0","0","0","0","0","0","-2"
"110556","California State University-Fresno","2012","Not on tenure track/No tenure system system total","148","64","84","1","0","1","10","5","5","4","0","4","16","8","8","0","0","0","111","47","64","2","1","1","4","3","1","0","0","0","-2"
"110556","California State University-Fresno","2012","Not on tenure/no tenure system, lecturers","148","64","84","1","0","1","10","5","5","4","0","4","16","8","8","0","0","0","111","47","64","2","1","1","4","3","1","0","0","0","-2"
"110565","California State University-Fullerton","2012","Tenured total","471","266","205","0","0","0","88","49","39","15","8","7","33","18","15","2","2","0","330","188","142","0","0","0","0","0","0","3","1","2","-2"
"110565","California State University-Fullerton","2012","Tenured, professors","272","166","106","0","0","0","53","33","20","8","3","5","16","7","9","1","1","0","194","122","72","0","0","0","0","0","0","0","0","0","-2"
"110565","California State University-Fullerton","2012","Tenured, associate professors","191","96","95","0","0","0","34","16","18","5","4","1","16","10","6","1","1","0","132","64","68","0","0","0","0","0","0","3","1","2","-2"
"110565","California State University-Fullerton","2012","Tenured, assistant professors","8","4","4","0","0","0","1","0","1","2","1","1","1","1","0","0","0","0","4","2","2","0","0","0","0","0","0","0","0","0","-2"
"110565","California State University-Fullerton","2012","On-Tenure track total","230","125","105","0","0","0","38","24","14","8","3","5","18","11","7","0","0","0","132","69","63","0","0","0","3","1","2","31","17","14","-2"
"110565","California State University-Fullerton","2012","On-tenure track, professors","4","2","2","0","0","0","4","2","2","0","0","0","0","0","0","0","0","0","0","0","0","0","0","0","0","0","0","0","0","0","-2"
"110565","California State University-Fullerton","2012","On-tenure track, associate professors","29","19","10","0","0","0","9","6","3","0","0","0","0","0","0","0","0","0","17","11","6","0","0","0","0","0","0","3","2","1","-2"
"110565","California State University-Fullerton","2012","On-tenure track, assistant professors","197","104","93","0","0","0","25","16","9","8","3","5","18","11","7","0","0","0","115","58","57","0","0","0","3","1","2","28","15","13","-2"
"110565","California State University-Fullerton","2012","Not on tenure track/No tenure system system total","190","73","117","0","0","0","27","10","17","7","6","1","9","3","6","1","0","1","142","52","90","0","0","0","2","1","1","2","1","1","-2"
"110565","California State University-Fullerton","2012","Not on tenure/no tenure system, lecturers","190","73","117","0","0","0","27","10","17","7","6","1","9","3","6","1","0","1","142","52","90","0","0","0","2","1","1","2","1","1","-2"
"110574","California State University-East Bay","2012","Tenured total","213","116","97","2","2","0","39","19","20","14","9","5","23","11","12","2","1","1","121","66","55","0","0","0","8","5","3","4","3","1","-2"
"110574","California State University-East Bay","2012","Tenured, professors","116","68","48","0","0","0","14","6","8","8","7","1","16","8","8","1","1","0","73","44","29","0","0","0","4","2","2","0","0","0","-2"
"110574","California State University-East Bay","2012","Tenured, associate professors","92","45","47","2","2","0","24","13","11","6","2","4","6","3","3","1","0","1","45","19","26","0","0","0","4","3","1","4","3","1","-2"
"110574","California State University-East Bay","2012","Tenured, assistant professors","5","3","2","0","0","0","1","0","1","0","0","0","1","0","1","0","0","0","3","3","0","0","0","0","0","0","0","0","0","0","-2"
"110574","California State University-East Bay","2012","On-Tenure track total","63","26","37","0","0","0","11","4","7","4","0","4","4","2","2","0","0","0","31","13","18","0","0","0","5","3","2","8","4","4","-2"
"110574","California State University-East Bay","2012","On-tenure track, associate professors","6","3","3","0","0","0","0","0","0","0","0","0","0","0","0","0","0","0","5","2","3","0","0","0","0","0","0","1","1","0","-2"
"110574","California State University-East Bay","2012","On-tenure track, assistant professors","57","23","34","0","0","0","11","4","7","4","0","4","4","2","2","0","0","0","26","11","15","0","0","0","5","3","2","7","3","4","-2"
"110574","California State University-East Bay","2012","Not on tenure track/No tenure system system total","29","14","15","0","0","0","1","0","1","4","1","3","1","1","0","0","0","0","22","12","10","0","0","0","1","0","1","0","0","0","-2"
"110574","California State University-East Bay","2012","Not on tenure/no tenure system, lecturers","29","14","15","0","0","0","1","0","1","4","1","3","1","1","0","0","0","0","22","12","10","0","0","0","1","0","1","0","0","0","-2"
"110583","California State University-Long Beach","2012","Tenured total","584","341","243","2","2","0","104","57","47","19","15","4","46","28","18","0","0","0","398","229","169","2","1","1","11","8","3","2","1","1","-2"
"110583","California State University-Long Beach","2012","Tenured, professors","399","250","149","1","1","0","75","44","31","10","8","2","25","19","6","0","0","0","278","170","108","0","0","0","9","7","2","1","1","0","-2"
"110583","California State University-Long Beach","2012","Tenured, associate professors","179","86","93","1","1","0","28","12","16","8","6","2","20","8","12","0","0","0","117","57","60","2","1","1","2","1","1","1","0","1","-2"
"110583","California State University-Long Beach","2012","Tenured, assistant professors","5","4","1","0","0","0","1","1","0","1","1","0","1","1","0","0","0","0","2","1","1","0","0","0","0","0","0","0","0","0","-2"
"110583","California State University-Long Beach","2012","Tenured, no academic rank","1","1","0","0","0","0","0","0","0","0","0","0","0","0","0","0","0","0","1","1","0","0","0","0","0","0","0","0","0","0","-2"
"110583","California State University-Long Beach","2012","On-Tenure track total","169","76","93","1","0","1","38","11","27","7","3","4","17","7","10","0","0","0","74","36","38","3","2","1","15","11","4","14","6","8","-2"
"110583","California State University-Long Beach","2012","On-tenure track, associate professors","6","5","1","0","0","0","1","1","0","0","0","0","1","1","0","0","0","0","2","2","0","0","0","0","1","1","0","1","0","1","-2"
"110583","California State University-Long Beach","2012","On-tenure track, assistant professors","163","71","92","1","0","1","37","10","27","7","3","4","16","6","10","0","0","0","72","34","38","3","2","1","14","10","4","13","6","7","-2"
"110583","California State University-Long Beach","2012","Not on tenure track/No tenure system system total","192","89","103","0","0","0","20","7","13","9","2","7","14","8","6","0","0","0","143","69","74","2","1","1","4","2","2","0","0","0","-2"
"110583","California State University-Long Beach","2012","Not on tenure/no tenure system, lecturers","192","89","103","0","0","0","20","7","13","9","2","7","14","8","6","0","0","0","143","69","74","2","1","1","4","2","2","0","0","0","-2"
"110592","California State University-Los Angeles","2012","Tenured total","396","220","176","2","0","2","94","53","41","18","10","8","51","30","21","1","1","0","220","119","101","2","0","2","7","6","1","1","1","0","-2"
"110592","California State University-Los Angeles","2012","Tenured, professors","276","160","116","2","0","2","65","39","26","12","6","6","33","20","13","0","0","0","158","91","67","2","0","2","4","4","0","0","0","0","-2"
"110592","California State University-Los Angeles","2012","Tenured, associate professors","116","59","57","0","0","0","29","14","15","6","4","2","17","9","8","1","1","0","59","28","31","0","0","0","3","2","1","1","1","0","-2"
"110592","California State University-Los Angeles","2012","Tenured, assistant professors","3","0","3","0","0","0","0","0","0","0","0","0","0","0","0","0","0","0","3","0","3","0","0","0","0","0","0","0","0","0","-2"
"110592","California State University-Los Angeles","2012","Tenured, no academic rank","1","1","0","0","0","0","0","0","0","0","0","0","1","1","0","0","0","0","0","0","0","0","0","0","0","0","0","0","0","0","-2"
"110592","California State University-Los Angeles","2012","On-Tenure track total","91","38","53","1","0","1","23","10","13","3","1","2","12","7","5","0","0","0","38","15","23","0","0","0","6","2","4","8","3","5","-2"
"110592","California State University-Los Angeles","2012","On-tenure track, associate professors","2","0","2","0","0","0","1","0","1","0","0","0","0","0","0","0","0","0","1","0","1","0","0","0","0","0","0","0","0","0","-2"
"110592","California State University-Los Angeles","2012","On-tenure track, assistant professors","89","38","51","1","0","1","22","10","12","3","1","2","12","7","5","0","0","0","37","15","22","0","0","0","6","2","4","8","3","5","-2"
"110592","California State University-Los Angeles","2012","Not on tenure track/No tenure system system total","73","32","41","1","1","0","9","5","4","8","3","5","14","7","7","0","0","0","35","13","22","1","1","0","3","1","2","2","1","1","-2"
"110592","California State University-Los Angeles","2012","Not on tenure/no tenure system, lecturers","73","32","41","1","1","0","9","5","4","8","3","5","14","7","7","0","0","0","35","13","22","1","1","0","3","1","2","2","1","1","-2"
"110608","California State University-Northridge","2012","Tenured total","543","305","238","3","1","2","70","44","26","28","13","15","67","31","36","0","0","0","364","210","154","5","3","2","3","2","1","3","1","2","-2"
"110608","California State University-Northridge","2012","Tenured, professors","360","207","153","2","1","1","43","25","18","17","8","9","44","20","24","0","0","0","250","150","100","4","3","1","0","0","0","0","0","0","-2"
"110608","California State University-Northridge","2012","Tenured, associate professors","176","94","82","1","0","1","26","18","8","11","5","6","21","10","11","0","0","0","110","58","52","1","0","1","3","2","1","3","1","2","-2"
"110608","California State University-Northridge","2012","Tenured, assistant professors","3","1","2","0","0","0","0","0","0","0","0","0","1","1","0","0","0","0","2","0","2","0","0","0","0","0","0","0","0","0","-2"
"110608","California State University-Northridge","2012","Tenured, no academic rank","4","3","1","0","0","0","1","1","0","0","0","0","1","0","1","0","0","0","2","2","0","0","0","0","0","0","0","0","0","0","-2"
"110608","California State University-Northridge","2012","On-Tenure track total","217","103","114","2","2","0","41","16","25","15","6","9","15","10","5","0","0","0","117","56","61","2","0","2","12","7","5","13","6","7","-2"
"110608","California State University-Northridge","2012","On-tenure track, professors","1","1","0","0","0","0","0","0","0","0","0","0","0","0","0","0","0","0","1","1","0","0","0","0","0","0","0","0","0","0","-2"
"110608","California State University-Northridge","2012","On-tenure track, associate professors","25","7","18","0","0","0","9","2","7","1","0","1","3","1","2","0","0","0","12","4","8","0","0","0","0","0","0","0","0","0","-2"
"110608","California State University-Northridge","2012","On-tenure track, assistant professors","191","95","96","2","2","0","32","14","18","14","6","8","12","9","3","0","0","0","104","51","53","2","0","2","12","7","5","13","6","7","-2"
"110608","California State University-Northridge","2012","Not on tenure track/No tenure system system total","124","50","74","1","0","1","12","5","7","5","3","2","20","12","8","0","0","0","83","29","54","1","0","1","2","1","1","0","0","0","-2"
"110608","California State University-Northridge","2012","Not on tenure/no tenure system, lecturers","124","50","74","1","0","1","12","5","7","5","3","2","20","12","8","0","0","0","83","29","54","1","0","1","2","1","1","0","0","0","-2"
"110617","California State University-Sacramento","2012","Tenured total","485","267","218","6","3","3","71","44","27","26","9","17","42","26","16","1","1","0","323","177","146","2","1","1","8","4","4","6","2","4","-2"
"110617","California State University-Sacramento","2012","Tenured, professors","296","164","132","2","1","1","37","19","18","16","4","12","31","20","11","1","1","0","206","118","88","1","0","1","2","1","1","0","0","0","-2"
"110617","California State University-Sacramento","2012","Tenured, associate professors","183","99","84","4","2","2","33","24","9","10","5","5","11","6","5","0","0","0","113","57","56","1","1","0","5","2","3","6","2","4","-2"
"110617","California State University-Sacramento","2012","Tenured, assistant professors","4","2","2","0","0","0","1","1","0","0","0","0","0","0","0","0","0","0","2","0","2","0","0","0","1","1","0","0","0","0","-2"
"110617","California State University-Sacramento","2012","Tenured, no academic rank","2","2","0","0","0","0","0","0","0","0","0","0","0","0","0","0","0","0","2","2","0","0","0","0","0","0","0","0","0","0","-2"
"110617","California State University-Sacramento","2012","On-Tenure track total","88","41","47","1","1","0","15","6","9","1","1","0","6","2","4","0","0","0","49","22","27","0","0","0","7","3","4","9","6","3","-2"
"110617","California State University-Sacramento","2012","On-tenure track, associate professors","1","0","1","0","0","0","0","0","0","0","0","0","0","0","0","0","0","0","1","0","1","0","0","0","0","0","0","0","0","0","-2"
"110617","California State University-Sacramento","2012","On-tenure track, assistant professors","87","41","46","1","1","0","15","6","9","1","1","0","6","2","4","0","0","0","48","22","26","0","0","0","7","3","4","9","6","3","-2"
"110617","California State University-Sacramento","2012","Not on tenure track/No tenure system system total","98","36","62","0","0","0","1","1","0","2","2","0","3","0","3","0","0","0","83","29","54","2","1","1","6","2","4","1","1","0","-2"
"110617","California State University-Sacramento","2012","Not on tenure/no tenure system, lecturers","98","36","62","0","0","0","1","1","0","2","2","0","3","0","3","0","0","0","83","29","54","2","1","1","6","2","4","1","1","0","-2"
"110671","University of California-Riverside","2012","Tenured total","474","334","140","4","2","2","88","64","24","15","10","5","28","17","11","0","0","0","335","239","96","0","0","0","3","2","1","1","0","1","-2"
"110671","University of California-Riverside","2012","Tenured, professors","316","253","63","1","1","0","58","51","7","8","6","2","16","10","6","0","0","0","230","184","46","0","0","0","2","1","1","1","0","1","-2"
"110671","University of California-Riverside","2012","Tenured, associate professors","157","81","76","3","1","2","30","13","17","7","4","3","12","7","5","0","0","0","104","55","49","0","0","0","1","1","0","0","0","0","-2"
"110671","University of California-Riverside","2012","Tenured, lecturers","1","0","1","0","0","0","0","0","0","0","0","0","0","0","0","0","0","0","1","0","1","0","0","0","0","0","0","0","0","0","-2"
"110671","University of California-Riverside","2012","On-Tenure track total","142","87","55","0","0","0","40","25","15","4","2","2","11","5","6","0","0","0","64","41","23","0","0","0","3","2","1","20","12","8","-2"
"110671","University of California-Riverside","2012","On-tenure track, assistant professors","139","86","53","0","0","0","39","25","14","4","2","2","11","5","6","0","0","0","62","40","22","0","0","0","3","2","1","20","12","8","-2"
"110671","University of California-Riverside","2012","On-tenure track, lecturers","3","1","2","0","0","0","1","0","1","0","0","0","0","0","0","0","0","0","2","1","1","0","0","0","0","0","0","0","0","0","-2"
"110671","University of California-Riverside","2012","Not on tenure track/No tenure system system total","97","53","44","1","1","0","11","5","6","4","1","3","4","1","3","0","0","0","66","39","27","1","0","1","1","0","1","9","6","3","-2"
"110671","University of California-Riverside","2012","Not on tenure/no tenure system, professors","4","3","1","0","0","0","1","1","0","0","0","0","0","0","0","0","0","0","3","2","1","0","0","0","0","0","0","0","0","0","-2"
"110671","University of California-Riverside","2012","Not on tenure/no tenure system, associate professors","1","1","0","0","0","0","0","0","0","0","0","0","0","0","0","0","0","0","1","1","0","0","0","0","0","0","0","0","0","0","-2"
"110671","University of California-Riverside","2012","Not on tenure/no tenure system, assistant professors","26","19","7","0","0","0","3","2","1","3","1","2","0","0","0","0","0","0","10","10","0","1","0","1","1","0","1","8","6","2","-2"
"110671","University of California-Riverside","2012","Not on tenure/no tenure system, lecturers","65","30","35","1","1","0","7","2","5","1","0","1","4","1","3","0","0","0","51","26","25","0","0","0","0","0","0","1","0","1","-2"
"110671","University of California-Riverside","2012","Not on tenure/no tenure system, no academic rank","1","0","1","0","0","0","0","0","0","0","0","0","0","0","0","0","0","0","1","0","1","0","0","0","0","0","0","0","0","0","-2"
"110705","University of California-Santa Barbara","2012","Tenured total","683","465","218","3","1","2","72","47","25","15","8","7","45","30","15","0","0","0","526","364","162","0","0","0","0","0","0","22","15","7","-2"
"110705","University of California-Santa Barbara","2012","Tenured, professors","497","359","138","3","1","2","48","33","15","6","3","3","21","17","4","0","0","0","405","295","110","0","0","0","0","0","0","14","10","4","-2"
"110705","University of California-Santa Barbara","2012","Tenured, associate professors","166","94","72","0","0","0","23","14","9","8","4","4","22","12","10","0","0","0","105","59","46","0","0","0","0","0","0","8","5","3","-2"
"110705","University of California-Santa Barbara","2012","Tenured, lecturers","20","12","8","0","0","0","1","0","1","1","1","0","2","1","1","0","0","0","16","10","6","0","0","0","0","0","0","0","0","0","-2"
"110705","University of California-Santa Barbara","2012","On-Tenure track total","86","50","36","3","0","3","3","2","1","4","2","2","6","2","4","0","0","0","52","30","22","0","0","0","0","0","0","18","14","4","-2"
"110705","University of California-Santa Barbara","2012","On-tenure track, professors","1","1","0","0","0","0","0","0","0","0","0","0","0","0","0","0","0","0","0","0","0","0","0","0","0","0","0","1","1","0","-2"
"110705","University of California-Santa Barbara","2012","On-tenure track, associate professors","1","1","0","0","0","0","0","0","0","0","0","0","0","0","0","0","0","0","0","0","0","0","0","0","0","0","0","1","1","0","-2"
"110705","University of California-Santa Barbara","2012","On-tenure track, assistant professors","75","46","29","3","0","3","3","2","1","4","2","2","5","2","3","0","0","0","45","28","17","0","0","0","0","0","0","15","12","3","-2"
"110705","University of California-Santa Barbara","2012","On-tenure track, lecturers","9","2","7","0","0","0","0","0","0","0","0","0","1","0","1","0","0","0","7","2","5","0","0","0","0","0","0","1","0","1","-2"
"110705","University of California-Santa Barbara","2012","Not on tenure track/No tenure system system total","115","57","58","0","0","0","9","2","7","1","1","0","3","0","3","0","0","0","90","46","44","0","0","0","3","3","0","9","5","4","-2"
"110705","University of California-Santa Barbara","2012","Not on tenure/no tenure system, assistant professors","18","15","3","0","0","0","0","0","0","1","1","0","0","0","0","0","0","0","10","8","2","0","0","0","2","2","0","5","4","1","-2"
"110705","University of California-Santa Barbara","2012","Not on tenure/no tenure system, lecturers","97","42","55","0","0","0","9","2","7","0","0","0","3","0","3","0","0","0","80","38","42","0","0","0","1","1","0","4","1","3","-2"
"110714","University of California-Santa Cruz","2012","Tenured total","420","267","153","7","2","5","58","34","24","10","9","1","29","11","18","0","0","0","312","208","104","0","0","0","4","3","1","0","0","0","-2"
"110714","University of California-Santa Cruz","2012","Tenured, professors","297","200","97","3","1","2","36","26","10","5","5","0","17","6","11","0","0","0","234","160","74","0","0","0","2","2","0","0","0","0","-2"
"110714","University of California-Santa Cruz","2012","Tenured, associate professors","116","63","53","4","1","3","22","8","14","5","4","1","11","5","6","0","0","0","73","45","28","0","0","0","1","0","1","0","0","0","-2"
"110714","University of California-Santa Cruz","2012","Tenured, lecturers","7","4","3","0","0","0","0","0","0","0","0","0","1","0","1","0","0","0","5","3","2","0","0","0","1","1","0","0","0","0","-2"
"110714","University of California-Santa Cruz","2012","On-Tenure track total","80","45","35","1","0","1","10","6","4","2","1","1","12","8","4","0","0","0","50","27","23","0","0","0","1","1","0","4","2","2","-2"
"110714","University of California-Santa Cruz","2012","On-tenure track, associate professors","1","0","1","0","0","0","0","0","0","0","0","0","0","0","0","0","0","0","0","0","0","0","0","0","0","0","0","1","0","1","-2"
"110714","University of California-Santa Cruz","2012","On-tenure track, assistant professors","79","45","34","1","0","1","10","6","4","2","1","1","12","8","4","0","0","0","50","27","23","0","0","0","1","1","0","3","2","1","-2"
"110714","University of California-Santa Cruz","2012","Not on tenure track/No tenure system system total","47","27","20","0","0","0","4","1","3","1","0","1","7","3","4","0","0","0","33","22","11","1","1","0","0","0","0","1","0","1","-2"
"110714","University of California-Santa Cruz","2012","Not on tenure/no tenure system, professors","5","3","2","0","0","0","1","0","1","0","0","0","1","0","1","0","0","0","3","3","0","0","0","0","0","0","0","0","0","0","-2"
"110714","University of California-Santa Cruz","2012","Not on tenure/no tenure system, associate professors","4","3","1","0","0","0","0","0","0","0","0","0","0","0","0","0","0","0","4","3","1","0","0","0","0","0","0","0","0","0","-2"
"110714","University of California-Santa Cruz","2012","Not on tenure/no tenure system, assistant professors","6","3","3","0","0","0","0","0","0","0","0","0","0","0","0","0","0","0","4","2","2","1","1","0","0","0","0","1","0","1","-2"
"110714","University of California-Santa Cruz","2012","Not on tenure/no tenure system, lecturers","30","18","12","0","0","0","3","1","2","1","0","1","5","3","2","0","0","0","21","14","7","0","0","0","0","0","0","0","0","0","-2"
"110714","University of California-Santa Cruz","2012","Not on tenure/no tenure system, no academic rank","2","0","2","0","0","0","0","0","0","0","0","0","1","0","1","0","0","0","1","0","1","0","0","0","0","0","0","0","0","0","-2"
"111966","Charles R Drew University of Medicine and Science","2012","Not on tenure track/No tenure system system total","59","22","37","0","0","0","14","6","8","26","6","20","4","3","1","0","0","0","13","7","6","1","0","1","1","0","1","0","0","0","-2"
"111966","Charles R Drew University of Medicine and Science","2012","Not on tenure/no tenure system, professors","6","6","0","0","0","0","2","2","0","0","0","0","1","1","0","0","0","0","3","3","0","0","0","0","0","0","0","0","0","0","-2"
"111966","Charles R Drew University of Medicine and Science","2012","Not on tenure/no tenure system, associate professors","13","4","9","0","0","0","2","1","1","4","1","3","2","1","1","0","0","0","5","1","4","0","0","0","0","0","0","0","0","0","-2"
"111966","Charles R Drew University of Medicine and Science","2012","Not on tenure/no tenure system, assistant professors","20","9","11","0","0","0","9","3","6","5","2","3","1","1","0","0","0","0","4","3","1","0","0","0","1","0","1","0","0","0","-2"
"111966","Charles R Drew University of Medicine and Science","2012","Not on tenure/no tenure system, instructors","20","3","17","0","0","0","1","0","1","17","3","14","0","0","0","0","0","0","1","0","1","1","0","1","0","0","0","0","0","0","-2"
"112075","Concordia University-Irvine","2012","Not on tenure track/No tenure system system total","91","52","39","0","0","0","4","2","2","3","0","3","4","2","2","0","0","0","77","47","30","2","1","1","0","0","0","1","0","1","-2"
"112075","Concordia University-Irvine","2012","Not on tenure/no tenure system, professors","30","19","11","0","0","0","0","0","0","1","0","1","2","2","0","0","0","0","25","16","9","2","1","1","0","0","0","0","0","0","-2"
"112075","Concordia University-Irvine","2012","Not on tenure/no tenure system, associate professors","15","13","2","0","0","0","3","2","1","0","0","0","0","0","0","0","0","0","12","11","1","0","0","0","0","0","0","0","0","0","-2"
"112075","Concordia University-Irvine","2012","Not on tenure/no tenure system, assistant professors","25","14","11","0","0","0","0","0","0","1","0","1","1","0","1","0","0","0","23","14","9","0","0","0","0","0","0","0","0","0","-2"
"112075","Concordia University-Irvine","2012","Not on tenure/no tenure system, no academic rank","21","6","15","0","0","0","1","0","1","1","0","1","1","0","1","0","0","0","17","6","11","0","0","0","0","0","0","1","0","1","-2"
"112084","San Diego Christian College","2012","Not on tenure track/No tenure system system total","18","11","7","0","0","0","1","1","0","1","0","1","0","0","0","0","0","0","16","10","6","0","0","0","0","0","0","0","0","0","-2"
"112084","San Diego Christian College","2012","Not on tenure/no tenure system, professors","1","1","0","0","0","0","0","0","0","0","0","0","0","0","0","0","0","0","1","1","0","0","0","0","0","0","0","0","0","0","-2"
"112084","San Diego Christian College","2012","Not on tenure/no tenure system, associate professors","4","3","1","0","0","0","0","0","0","0","0","0","0","0","0","0","0","0","4","3","1","0","0","0","0","0","0","0","0","0","-2"
"112084","San Diego Christian College","2012","Not on tenure/no tenure system, assistant professors","12","6","6","0","0","0","1","1","0","1","0","1","0","0","0","0","0","0","10","5","5","0","0","0","0","0","0","0","0","0","-2"
"112084","San Diego Christian College","2012","Not on tenure/no tenure system, no academic rank","1","1","0","0","0","0","0","0","0","0","0","0","0","0","0","0","0","0","1","1","0","0","0","0","0","0","0","0","0","0","-2"
"113236","Cypress College","2012","Tenured total","185","80","105","1","1","0","18","6","12","3","0","3","21","12","9","1","0","1","103","45","58","7","1","6","28","14","14","3","1","2","-2"
"113236","Cypress College","2012","Tenured, instructors","185","80","105","1","1","0","18","6","12","3","0","3","21","12","9","1","0","1","103","45","58","7","1","6","28","14","14","3","1","2","-2"
"113236","Cypress College","2012","On-Tenure track total","15","4","11","0","0","0","2","0","2","1","0","1","4","0","4","0","0","0","6","3","3","2","1","1","0","0","0","0","0","0","-2"
"113236","Cypress College","2012","On-tenure track, instructors","15","4","11","0","0","0","2","0","2","1","0","1","4","0","4","0","0","0","6","3","3","2","1","1","0","0","0","0","0","0","-2"
"113236","Cypress College","2012","Not on tenure track/No tenure system system total","4","3","1","0","0","0","0","0","0","0","0","0","2","2","0","0","0","0","2","1","1","0","0","0","0","0","0","0","0","0","-2"
"113236","Cypress College","2012","Not on tenure/no tenure system, instructors","4","3","1","0","0","0","0","0","0","0","0","0","2","2","0","0","0","0","2","1","1","0","0","0","0","0","0","0","0","0","-2"
"114433","Feather River Community College District","2012","Tenured total","19","11","8","0","0","0","0","0","0","0","0","0","0","0","0","0","0","0","19","11","8","0","0","0","0","0","0","0","0","0","-2"
"114433","Feather River Community College District","2012","Tenured, instructors","19","11","8","0","0","0","0","0","0","0","0","0","0","0","0","0","0","0","19","11","8","0","0","0","0","0","0","0","0","0","-2"
"114433","Feather River Community College District","2012","On-Tenure track total","6","5","1","0","0","0","0","0","0","0","0","0","0","0","0","0","0","0","6","5","1","0","0","0","0","0","0","0","0","0","-2"
"114433","Feather River Community College District","2012","On-tenure track, instructors","6","5","1","0","0","0","0","0","0","0","0","0","0","0","0","0","0","0","6","5","1","0","0","0","0","0","0","0","0","0","-2"
"114716","Foothill College","2012","Tenured total","127","47","80","0","0","0","17","5","12","7","2","5","16","5","11","0","0","0","84","34","50","1","0","1","2","1","1","0","0","0","-2"
"114716","Foothill College","2012","Tenured, instructors","127","47","80","0","0","0","17","5","12","7","2","5","16","5","11","0","0","0","84","34","50","1","0","1","2","1","1","0","0","0","-2"
"114716","Foothill College","2012","On-Tenure track total","56","25","31","0","0","0","8","2","6","1","0","1","8","3","5","0","0","0","36","18","18","0","0","0","3","2","1","0","0","0","-2"
"114716","Foothill College","2012","On-tenure track, instructors","56","25","31","0","0","0","8","2","6","1","0","1","8","3","5","0","0","0","36","18","18","0","0","0","3","2","1","0","0","0","-2"
"114813","Fresno Pacific University","2012","Tenured total","39","27","12","0","0","0","1","1","0","0","0","0","0","0","0","0","0","0","36","24","12","0","0","0","2","2","0","0","0","0","-2"
"114813","Fresno Pacific University","2012","Tenured, professors","9","7","2","0","0","0","0","0","0","0","0","0","0","0","0","0","0","0","8","6","2","0","0","0","1","1","0","0","0","0","-2"
"114813","Fresno Pacific University","2012","Tenured, associate professors","28","19","9","0","0","0","0","0","0","0","0","0","0","0","0","0","0","0","27","18","9","0","0","0","1","1","0","0","0","0","-2"
"114813","Fresno Pacific University","2012","Tenured, assistant professors","2","1","1","0","0","0","1","1","0","0","0","0","0","0","0","0","0","0","1","0","1","0","0","0","0","0","0","0","0","0","-2"
"114813","Fresno Pacific University","2012","On-Tenure track total","25","18","7","1","1","0","1","0","1","2","1","1","0","0","0","0","0","0","20","15","5","0","0","0","1","1","0","0","0","0","-2"
"114813","Fresno Pacific University","2012","On-tenure track, professors","1","1","0","0","0","0","0","0","0","0","0","0","0","0","0","0","0","0","0","0","0","0","0","0","1","1","0","0","0","0","-2"
"114813","Fresno Pacific University","2012","On-tenure track, associate professors","3","3","0","0","0","0","0","0","0","0","0","0","0","0","0","0","0","0","3","3","0","0","0","0","0","0","0","0","0","0","-2"
"114813","Fresno Pacific University","2012","On-tenure track, assistant professors","20","13","7","1","1","0","1","0","1","2","1","1","0","0","0","0","0","0","16","11","5","0","0","0","0","0","0","0","0","0","-2"
"114813","Fresno Pacific University","2012","On-tenure track, instructors","1","1","0","0","0","0","0","0","0","0","0","0","0","0","0","0","0","0","1","1","0","0","0","0","0","0","0","0","0","0","-2"
"114813","Fresno Pacific University","2012","Not on tenure track/No tenure system system total","31","15","16","0","0","0","1","0","1","0","0","0","1","0","1","0","0","0","24","12","12","0","0","0","5","3","2","0","0","0","-2"
"114813","Fresno Pacific University","2012","Not on tenure/no tenure system, professors","1","1","0","0","0","0","0","0","0","0","0","0","0","0","0","0","0","0","1","1","0","0","0","0","0","0","0","0","0","0","-2"
"114813","Fresno Pacific University","2012","Not on tenure/no tenure system, associate professors","2","2","0","0","0","0","0","0","0","0","0","0","0","0","0","0","0","0","2","2","0","0","0","0","0","0","0","0","0","0","-2"
"114813","Fresno Pacific University","2012","Not on tenure/no tenure system, assistant professors","23","11","12","0","0","0","1","0","1","0","0","0","1","0","1","0","0","0","17","8","9","0","0","0","4","3","1","0","0","0","-2"
"114813","Fresno Pacific University","2012","Not on tenure/no tenure system, instructors","5","1","4","0","0","0","0","0","0","0","0","0","0","0","0","0","0","0","4","1","3","0","0","0","1","0","1","0","0","0","-2"
"115773","Humphreys University-Stockton and Modesto Campuses","2012","Not on tenure track/No tenure system system total","81","39","42","0","0","0","3","3","0","6","0","6","3","3","0","3","0","3","63","30","33","0","0","0","3","3","0","0","0","0","-2"
"115773","Humphreys University-Stockton and Modesto Campuses","2012","Not on tenure/no tenure system, professors","18","15","3","0","0","0","0","0","0","0","0","0","0","0","0","3","0","3","15","15","0","0","0","0","0","0","0","0","0","0","-2"
"115773","Humphreys University-Stockton and Modesto Campuses","2012","Not on tenure/no tenure system, associate professors","12","6","6","0","0","0","0","0","0","3","0","3","0","0","0","0","0","0","9","6","3","0","0","0","0","0","0","0","0","0","-2"
"115773","Humphreys University-Stockton and Modesto Campuses","2012","Not on tenure/no tenure system, assistant professors","33","15","18","0","0","0","3","3","0","0","0","0","3","3","0","0","0","0","27","9","18","0","0","0","0","0","0","0","0","0","-2"
"115773","Humphreys University-Stockton and Modesto Campuses","2012","Not on tenure/no tenure system, instructors","12","0","12","0","0","0","0","0","0","0","0","0","0","0","0","0","0","0","12","0","12","0","0","0","0","0","0","0","0","0","-2"
"115773","Humphreys University-Stockton and Modesto Campuses","2012","Not on tenure/no tenure system, no academic rank","6","3","3","0","0","0","0","0","0","3","0","3","0","0","0","0","0","0","0","0","0","0","0","0","3","3","0","0","0","0","-2"
"117104","Life Pacific University","2012","Not on tenure track/No tenure system system total","9","7","2","0","0","0","0","0","0","0","0","0","0","0","0","0","0","0","9","7","2","0","0","0","0","0","0","0","0","0","-2"
"117104","Life Pacific University","2012","Not on tenure/no tenure system, professors","3","3","0","0","0","0","0","0","0","0","0","0","0","0","0","0","0","0","3","3","0","0","0","0","0","0","0","0","0","0","-2"
"117104","Life Pacific University","2012","Not on tenure/no tenure system, associate professors","5","4","1","0","0","0","0","0","0","0","0","0","0","0","0","0","0","0","5","4","1","0","0","0","0","0","0","0","0","0","-2"
"117104","Life Pacific University","2012","Not on tenure/no tenure system, assistant professors","1","0","1","0","0","0","0","0","0","0","0","0","0","0","0","0","0","0","1","0","1","0","0","0","0","0","0","0","0","0","-2"
"118888","Mills College","2012","Tenured total","67","23","44","1","0","1","7","3","4","5","1","4","6","2","4","0","0","0","43","16","27","3","0","3","2","1","1","0","0","0","-2"
"118888","Mills College","2012","Tenured, professors","48","18","30","0","0","0","3","1","2","4","1","3","5","2","3","0","0","0","35","14","21","0","0","0","1","0","1","0","0","0","-2"
"118888","Mills College","2012","Tenured, associate professors","19","5","14","1","0","1","4","2","2","1","0","1","1","0","1","0","0","0","8","2","6","3","0","3","1","1","0","0","0","0","-2"
"118888","Mills College","2012","On-Tenure track total","12","2","10","0","0","0","1","0","1","0","0","0","0","0","0","0","0","0","8","1","7","2","1","1","1","0","1","0","0","0","-2"
"118888","Mills College","2012","On-tenure track, assistant professors","12","2","10","0","0","0","1","0","1","0","0","0","0","0","0","0","0","0","8","1","7","2","1","1","1","0","1","0","0","0","-2"
"118888","Mills College","2012","Not on tenure track/No tenure system system total","23","4","19","0","0","0","4","0","4","1","1","0","2","0","2","0","0","0","14","3","11","0","0","0","1","0","1","1","0","1","-2"
"118888","Mills College","2012","Not on tenure/no tenure system, professors","2","1","1","0","0","0","0","0","0","1","1","0","0","0","0","0","0","0","1","0","1","0","0","0","0","0","0","0","0","0","-2"
"118888","Mills College","2012","Not on tenure/no tenure system, associate professors","3","1","2","0","0","0","0","0","0","0","0","0","0","0","0","0","0","0","3","1","2","0","0","0","0","0","0","0","0","0","-2"
"118888","Mills College","2012","Not on tenure/no tenure system, assistant professors","14","2","12","0","0","0","1","0","1","0","0","0","2","0","2","0","0","0","9","2","7","0","0","0","1","0","1","1","0","1","-2"
"118888","Mills College","2012","Not on tenure/no tenure system, lecturers","4","0","4","0","0","0","3","0","3","0","0","0","0","0","0","0","0","0","1","0","1","0","0","0","0","0","0","0","0","0","-2"
"118912","MiraCosta College","2012","Tenured total","133","62","71","0","0","0","8","5","3","6","4","2","26","14","12","0","0","0","89","39","50","3","0","3","1","0","1","0","0","0","-2"
"118912","MiraCosta College","2012","Tenured, instructors","133","62","71","0","0","0","8","5","3","6","4","2","26","14","12","0","0","0","89","39","50","3","0","3","1","0","1","0","0","0","-2"
"118912","MiraCosta College","2012","On-Tenure track total","29","16","13","0","0","0","1","1","0","3","2","1","5","2","3","0","0","0","18","10","8","2","1","1","0","0","0","0","0","0","-2"
"118912","MiraCosta College","2012","On-tenure track, instructors","29","16","13","0","0","0","1","1","0","3","2","1","5","2","3","0","0","0","18","10","8","2","1","1","0","0","0","0","0","0","-2"
"118912","MiraCosta College","2012","Not on tenure track/No tenure system system total","21","5","16","0","0","0","3","0","3","2","1","1","7","3","4","0","0","0","9","1","8","0","0","0","0","0","0","0","0","0","-2"
"118912","MiraCosta College","2012","Not on tenure/no tenure system, instructors","21","5","16","0","0","0","3","0","3","2","1","1","7","3","4","0","0","0","9","1","8","0","0","0","0","0","0","0","0","0","-2"
"118976","Modesto Junior College","2012","Tenured total","155","64","91","2","0","2","7","2","5","5","2","3","15","9","6","0","0","0","112","45","67","0","0","0","13","6","7","1","0","1","-2"
"118976","Modesto Junior College","2012","Tenured, instructors","155","64","91","2","0","2","7","2","5","5","2","3","15","9","6","0","0","0","112","45","67","0","0","0","13","6","7","1","0","1","-2"
"118976","Modesto Junior College","2012","On-Tenure track total","66","39","27","0","0","0","1","0","1","4","1","3","4","3","1","0","0","0","49","32","17","0","0","0","8","3","5","0","0","0","-2"
"118976","Modesto Junior College","2012","On-tenure track, instructors","66","39","27","0","0","0","1","0","1","4","1","3","4","3","1","0","0","0","49","32","17","0","0","0","8","3","5","0","0","0","-2"
"118976","Modesto Junior College","2012","Not on tenure track/No tenure system system total","3","0","3","0","0","0","0","0","0","0","0","0","0","0","0","0","0","0","3","0","3","0","0","0","0","0","0","0","0","0","-2"
"118976","Modesto Junior College","2012","Not on tenure/no tenure system, instructors","3","0","3","0","0","0","0","0","0","0","0","0","0","0","0","0","0","0","3","0","3","0","0","0","0","0","0","0","0","0","-2"
"119605","National University","2012","Not on tenure track/No tenure system system total","261","126","135","3","1","2","17","8","9","13","4","9","14","6","8","0","0","0","172","84","88","0","0","0","42","23","19","0","0","0","-2"
"119605","National University","2012","Not on tenure/no tenure system, professors","67","42","25","2","1","1","4","3","1","1","1","0","3","1","2","0","0","0","48","31","17","0","0","0","9","5","4","0","0","0","-2"
"119605","National University","2012","Not on tenure/no tenure system, associate professors","89","44","45","1","0","1","5","3","2","4","0","4","6","4","2","0","0","0","56","26","30","0","0","0","17","11","6","0","0","0","-2"
"119605","National University","2012","Not on tenure/no tenure system, assistant professors","84","34","50","0","0","0","6","1","5","6","3","3","4","1","3","0","0","0","55","22","33","0","0","0","13","7","6","0","0","0","-2"
"119605","National University","2012","Not on tenure/no tenure system, instructors","17","5","12","0","0","0","2","1","1","2","0","2","1","0","1","0","0","0","11","4","7","0","0","0","1","0","1","0","0","0","-2"
"119605","National University","2012","Not on tenure/no tenure system, no academic rank","4","1","3","0","0","0","0","0","0","0","0","0","0","0","0","0","0","0","2","1","1","0","0","0","2","0","2","0","0","0","-2"
"120768","Pacific Oaks College","2012","Not on tenure track/No tenure system system total","13","2","11","0","0","0","1","0","1","3","0","3","2","0","2","0","0","0","6","2","4","1","0","1","0","0","0","0","0","0","-2"
"120768","Pacific Oaks College","2012","Not on tenure/no tenure system, no academic rank","13","2","11","0","0","0","1","0","1","3","0","3","2","0","2","0","0","0","6","2","4","1","0","1","0","0","0","0","0","0","-2"
"121619","Santa Ana College","2012","Tenured total","161","72","89","4","2","2","15","7","8","4","2","2","32","12","20","0","0","0","103","47","56","0","0","0","1","0","1","2","2","0","-2"
"121619","Santa Ana College","2012","Tenured, instructors","161","72","89","4","2","2","15","7","8","4","2","2","32","12","20","0","0","0","103","47","56","0","0","0","1","0","1","2","2","0","-2"
"121619","Santa Ana College","2012","On-Tenure track total","53","23","30","0","0","0","9","4","5","1","0","1","15","7","8","0","0","0","28","12","16","0","0","0","0","0","0","0","0","0","-2"
"121619","Santa Ana College","2012","On-tenure track, instructors","53","23","30","0","0","0","9","4","5","1","0","1","15","7","8","0","0","0","28","12","16","0","0","0","0","0","0","0","0","0","-2"
"121619","Santa Ana College","2012","Not on tenure track/No tenure system system total","4","2","2","0","0","0","0","0","0","0","0","0","0","0","0","0","0","0","3","2","1","0","0","0","0","0","0","1","0","1","-2"
"121619","Santa Ana College","2012","Not on tenure/no tenure system, instructors","4","2","2","0","0","0","0","0","0","0","0","0","0","0","0","0","0","0","3","2","1","0","0","0","0","0","0","1","0","1","-2"
"121691","University of Redlands","2012","Tenured total","123","65","58","0","0","0","13","8","5","4","2","2","2","1","1","0","0","0","102","53","49","0","0","0","1","0","1","1","1","0","-2"
"121691","University of Redlands","2012","Tenured, professors","87","50","37","0","0","0","10","8","2","1","1","0","2","1","1","0","0","0","73","40","33","0","0","0","1","0","1","0","0","0","-2"
"121691","University of Redlands","2012","Tenured, associate professors","36","15","21","0","0","0","3","0","3","3","1","2","0","0","0","0","0","0","29","13","16","0","0","0","0","0","0","1","1","0","-2"
"121691","University of Redlands","2012","On-Tenure track total","48","25","23","1","1","0","6","2","4","2","1","1","2","1","1","0","0","0","34","18","16","0","0","0","1","1","0","2","1","1","-2"
"121691","University of Redlands","2012","On-tenure track, professors","2","1","1","0","0","0","0","0","0","0","0","0","0","0","0","0","0","0","2","1","1","0","0","0","0","0","0","0","0","0","-2"
"121691","University of Redlands","2012","On-tenure track, associate professors","19","10","9","0","0","0","2","1","1","1","0","1","0","0","0","0","0","0","15","8","7","0","0","0","1","1","0","0","0","0","-2"
"121691","University of Redlands","2012","On-tenure track, assistant professors","27","14","13","1","1","0","4","1","3","1","1","0","2","1","1","0","0","0","17","9","8","0","0","0","0","0","0","2","1","1","-2"
"121691","University of Redlands","2012","Not on tenure track/No tenure system system total","27","14","13","1","1","0","1","1","0","2","1","1","2","2","0","0","0","0","20","8","12","0","0","0","1","1","0","0","0","0","-2"
"121691","University of Redlands","2012","Not on tenure/no tenure system, professors","1","1","0","0","0","0","0","0","0","0","0","0","0","0","0","0","0","0","1","1","0","0","0","0","0","0","0","0","0","0","-2"
"121691","University of Redlands","2012","Not on tenure/no tenure system, lecturers","10","3","7","0","0","0","0","0","0","0","0","0","1","1","0","0","0","0","9","2","7","0","0","0","0","0","0","0","0","0","-2"
"121691","University of Redlands","2012","Not on tenure/no tenure system, no academic rank","16","10","6","1","1","0","1","1","0","2","1","1","1","1","0","0","0","0","10","5","5","0","0","0","1","1","0","0","0","0","-2"
"121886","Rio Hondo College","2012","Tenured total","165","82","83","2","2","0","15","7","8","6","4","2","48","19","29","0","0","0","90","48","42","2","1","1","1","0","1","1","1","0","-2"
"121886","Rio Hondo College","2012","Tenured, instructors","165","82","83","2","2","0","15","7","8","6","4","2","48","19","29","0","0","0","90","48","42","2","1","1","1","0","1","1","1","0","-2"
"121886","Rio Hondo College","2012","On-Tenure track total","23","14","9","0","0","0","3","1","2","2","1","1","8","4","4","0","0","0","8","6","2","1","1","0","0","0","0","1","1","0","-2"
"121886","Rio Hondo College","2012","On-tenure track, instructors","23","14","9","0","0","0","3","1","2","2","1","1","8","4","4","0","0","0","8","6","2","1","1","0","0","0","0","1","1","0","-2"
"122375","San Diego Mesa College","2012","Tenured total","260","135","125","2","1","1","22","8","14","23","14","9","31","16","15","0","0","0","158","84","74","0","0","0","24","12","12","0","0","0","-2"
"122375","San Diego Mesa College","2012","Tenured, instructors","260","135","125","2","1","1","22","8","14","23","14","9","31","16","15","0","0","0","158","84","74","0","0","0","24","12","12","0","0","0","-2"
"122375","San Diego Mesa College","2012","On-Tenure track total","9","0","9","0","0","0","0","0","0","0","0","0","0","0","0","0","0","0","5","0","5","0","0","0","3","0","3","1","0","1","-2"
"122375","San Diego Mesa College","2012","On-tenure track, instructors","9","0","9","0","0","0","0","0","0","0","0","0","0","0","0","0","0","0","5","0","5","0","0","0","3","0","3","1","0","1","-2"
"122375","San Diego Mesa College","2012","Not on tenure track/No tenure system system total","4","2","2","0","0","0","2","1","1","0","0","0","0","0","0","0","0","0","1","1","0","0","0","0","1","0","1","0","0","0","-2"
"122375","San Diego Mesa College","2012","Not on tenure/no tenure system, instructors","4","2","2","0","0","0","2","1","1","0","0","0","0","0","0","0","0","0","1","1","0","0","0","0","1","0","1","0","0","0","-2"
"122977","Santa Monica College","2012","Tenured total","276","117","159","0","0","0","29","13","16","33","13","20","35","14","21","0","0","0","168","75","93","0","0","0","1","0","1","10","2","8","-2"
"122977","Santa Monica College","2012","Tenured, instructors","276","117","159","0","0","0","29","13","16","33","13","20","35","14","21","0","0","0","168","75","93","0","0","0","1","0","1","10","2","8","-2"
"122977","Santa Monica College","2012","On-Tenure track total","39","17","22","0","0","0","4","1","3","3","2","1","3","1","2","2","0","2","17","8","9","1","0","1","0","0","0","9","5","4","-2"
"122977","Santa Monica College","2012","On-tenure track, instructors","39","17","22","0","0","0","4","1","3","3","2","1","3","1","2","2","0","2","17","8","9","1","0","1","0","0","0","9","5","4","-2"
"123509","Skyline College","2012","Tenured total","96","51","45","0","0","0","18","8","10","7","6","1","17","7","10","0","0","0","53","30","23","0","0","0","0","0","0","1","0","1","-2"
"123509","Skyline College","2012","Tenured, instructors","96","51","45","0","0","0","18","8","10","7","6","1","17","7","10","0","0","0","53","30","23","0","0","0","0","0","0","1","0","1","-2"
"123509","Skyline College","2012","On-Tenure track total","21","9","12","0","0","0","3","1","2","1","1","0","5","2","3","1","0","1","6","2","4","0","0","0","5","3","2","0","0","0","-2"
"123509","Skyline College","2012","On-tenure track, instructors","21","9","12","0","0","0","3","1","2","1","1","0","5","2","3","1","0","1","6","2","4","0","0","0","5","3","2","0","0","0","-2"
"123509","Skyline College","2012","Not on tenure track/No tenure system system total","9","3","6","0","0","0","2","0","2","0","0","0","1","1","0","0","0","0","6","2","4","0","0","0","0","0","0","0","0","0","-2"
"123509","Skyline College","2012","Not on tenure/no tenure system, instructors","9","3","6","0","0","0","2","0","2","0","0","0","1","1","0","0","0","0","6","2","4","0","0","0","0","0","0","0","0","0","-2"
"123554","Saint Mary's College of California","2012","Tenured total","134","72","62","1","0","1","15","10","5","3","1","2","6","3","3","0","0","0","105","56","49","0","0","0","4","2","2","0","0","0","-2"
"123554","Saint Mary's College of California","2012","Tenured, professors","81","49","32","0","0","0","6","6","0","0","0","0","5","3","2","0","0","0","69","39","30","0","0","0","1","1","0","0","0","0","-2"
"123554","Saint Mary's College of California","2012","Tenured, associate professors","53","23","30","1","0","1","9","4","5","3","1","2","1","0","1","0","0","0","36","17","19","0","0","0","3","1","2","0","0","0","-2"
"123554","Saint Mary's College of California","2012","On-Tenure track total","37","14","23","0","0","0","6","0","6","0","0","0","4","1","3","0","0","0","15","8","7","1","1","0","4","1","3","7","3","4","-2"
"123554","Saint Mary's College of California","2012","On-tenure track, professors","1","0","1","0","0","0","1","0","1","0","0","0","0","0","0","0","0","0","0","0","0","0","0","0","0","0","0","0","0","0","-2"
"123554","Saint Mary's College of California","2012","On-tenure track, associate professors","11","5","6","0","0","0","1","0","1","0","0","0","1","1","0","0","0","0","4","3","1","0","0","0","1","0","1","4","1","3","-2"
"123554","Saint Mary's College of California","2012","On-tenure track, assistant professors","25","9","16","0","0","0","4","0","4","0","0","0","3","0","3","0","0","0","11","5","6","1","1","0","3","1","2","3","2","1","-2"
"123554","Saint Mary's College of California","2012","Not on tenure track/No tenure system system total","26","9","17","0","0","0","1","0","1","0","0","0","0","0","0","0","0","0","21","6","15","0","0","0","3","2","1","1","1","0","-2"
"123554","Saint Mary's College of California","2012","Not on tenure/no tenure system, associate professors","14","4","10","0","0","0","1","0","1","0","0","0","0","0","0","0","0","0","11","2","9","0","0","0","2","2","0","0","0","0","-2"
"123554","Saint Mary's College of California","2012","Not on tenure/no tenure system, assistant professors","12","5","7","0","0","0","0","0","0","0","0","0","0","0","0","0","0","0","10","4","6","0","0","0","1","0","1","1","1","0","-2"
"123563","Solano Community College","2012","Tenured total","141","63","78","0","0","0","6","3","3","11","4","7","15","6","9","0","0","0","109","50","59","0","0","0","0","0","0","0","0","0","-2"
"123563","Solano Community College","2012","Tenured, instructors","141","63","78","0","0","0","6","3","3","11","4","7","15","6","9","0","0","0","109","50","59","0","0","0","0","0","0","0","0","0","-2"
"123563","Solano Community College","2012","On-Tenure track total","5","4","1","0","0","0","0","0","0","0","0","0","0","0","0","0","0","0","5","4","1","0","0","0","0","0","0","0","0","0","-2"
"123563","Solano Community College","2012","On-tenure track, instructors","5","4","1","0","0","0","0","0","0","0","0","0","0","0","0","0","0","0","5","4","1","0","0","0","0","0","0","0","0","0","-2"
"123563","Solano Community College","2012","Not on tenure track/No tenure system system total","3","0","3","0","0","0","0","0","0","1","0","1","1","0","1","0","0","0","1","0","1","0","0","0","0","0","0","0","0","0","-2"
"123563","Solano Community College","2012","Not on tenure/no tenure system, instructors","3","0","3","0","0","0","0","0","0","1","0","1","1","0","1","0","0","0","1","0","1","0","0","0","0","0","0","0","0","0","-2"
"123572","Sonoma State University","2012","Tenured total","178","93","85","0","0","0","14","9","5","3","1","2","9","4","5","1","1","0","144","74","70","2","1","1","5","3","2","0","0","0","-2"
"123572","Sonoma State University","2012","Tenured, professors","126","69","57","0","0","0","9","6","3","3","1","2","5","2","3","1","1","0","102","56","46","2","1","1","4","2","2","0","0","0","-2"
"123572","Sonoma State University","2012","Tenured, associate professors","52","24","28","0","0","0","5","3","2","0","0","0","4","2","2","0","0","0","42","18","24","0","0","0","1","1","0","0","0","0","-2"
"123572","Sonoma State University","2012","On-Tenure track total","44","25","19","0","0","0","5","5","0","1","0","1","4","2","2","0","0","0","29","15","14","1","1","0","3","1","2","1","1","0","-2"
"123572","Sonoma State University","2012","On-tenure track, associate professors","2","1","1","0","0","0","0","0","0","0","0","0","0","0","0","0","0","0","2","1","1","0","0","0","0","0","0","0","0","0","-2"
"123572","Sonoma State University","2012","On-tenure track, assistant professors","42","24","18","0","0","0","5","5","0","1","0","1","4","2","2","0","0","0","27","14","13","1","1","0","3","1","2","1","1","0","-2"
"123572","Sonoma State University","2012","Not on tenure track/No tenure system system total","27","11","16","0","0","0","0","0","0","0","0","0","0","0","0","0","0","0","24","10","14","1","0","1","2","1","1","0","0","0","-2"
"123572","Sonoma State University","2012","Not on tenure/no tenure system, lecturers","27","11","16","0","0","0","0","0","0","0","0","0","0","0","0","0","0","0","24","10","14","1","0","1","2","1","1","0","0","0","-2"
"125471","West Los Angeles College","2012","Tenured total","64","28","36","0","0","0","9","3","6","17","5","12","5","1","4","0","0","0","31","17","14","0","0","0","2","2","0","0","0","0","-2"
"125471","West Los Angeles College","2012","Tenured, instructors","64","28","36","0","0","0","9","3","6","17","5","12","5","1","4","0","0","0","31","17","14","0","0","0","2","2","0","0","0","0","-2"
"125471","West Los Angeles College","2012","On-Tenure track total","14","4","10","0","0","0","1","1","0","2","0","2","4","2","2","0","0","0","2","0","2","0","0","0","5","1","4","0","0","0","-2"
"125471","West Los Angeles College","2012","On-tenure track, instructors","14","4","10","0","0","0","1","1","0","2","0","2","4","2","2","0","0","0","2","0","2","0","0","0","5","1","4","0","0","0","-2"
"125471","West Los Angeles College","2012","Not on tenure track/No tenure system system total","17","10","7","0","0","0","2","2","0","1","1","0","3","1","2","0","0","0","8","4","4","0","0","0","3","2","1","0","0","0","-2"
"125471","West Los Angeles College","2012","Not on tenure/no tenure system, instructors","17","10","7","0","0","0","2","2","0","1","1","0","3","1","2","0","0","0","8","4","4","0","0","0","3","2","1","0","0","0","-2"
"126182","Adams State University","2012","Tenured total","61","38","23","0","0","0","0","0","0","0","0","0","9","6","3","0","0","0","49","30","19","1","1","0","2","1","1","0","0","0","-2"
"126182","Adams State University","2012","Tenured, professors","39","24","15","0","0","0","0","0","0","0","0","0","3","2","1","0","0","0","35","21","14","0","0","0","1","1","0","0","0","0","-2"
"126182","Adams State University","2012","Tenured, associate professors","20","12","8","0","0","0","0","0","0","0","0","0","5","3","2","0","0","0","13","8","5","1","1","0","1","0","1","0","0","0","-2"
"126182","Adams State University","2012","Tenured, assistant professors","2","2","0","0","0","0","0","0","0","0","0","0","1","1","0","0","0","0","1","1","0","0","0","0","0","0","0","0","0","0","-2"
"126182","Adams State University","2012","On-Tenure track total","40","17","23","0","0","0","3","2","1","0","0","0","6","1","5","1","0","1","30","14","16","0","0","0","0","0","0","0","0","0","-2"
"126182","Adams State University","2012","On-tenure track, associate professors","1","1","0","0","0","0","0","0","0","0","0","0","0","0","0","0","0","0","1","1","0","0","0","0","0","0","0","0","0","0","-2"
"126182","Adams State University","2012","On-tenure track, assistant professors","39","16","23","0","0","0","3","2","1","0","0","0","6","1","5","1","0","1","29","13","16","0","0","0","0","0","0","0","0","0","-2"
"126182","Adams State University","2012","Not on tenure track/No tenure system system total","11","5","6","0","0","0","0","0","0","0","0","0","2","0","2","0","0","0","9","5","4","0","0","0","0","0","0","0","0","0","-2"
"126182","Adams State University","2012","Not on tenure/no tenure system, no academic rank","11","5","6","0","0","0","0","0","0","0","0","0","2","0","2","0","0","0","9","5","4","0","0","0","0","0","0","0","0","0","-2"
"126562","University of Colorado Denver/Anschutz Medical Campus","2012","Tenured total","552","385","167","4","2","2","38","25","13","7","5","2","18","12","6","0","0","0","473","336","137","1","0","1","11","5","6","0","0","0","-2"
"126562","University of Colorado Denver/Anschutz Medical Campus","2012","Tenured, professors","355","268","87","2","1","1","19","14","5","4","4","0","7","3","4","0","0","0","320","244","76","0","0","0","3","2","1","0","0","0","-2"
"126562","University of Colorado Denver/Anschutz Medical Campus","2012","Tenured, associate professors","197","117","80","2","1","1","19","11","8","3","1","2","11","9","2","0","0","0","153","92","61","1","0","1","8","3","5","0","0","0","-2"
"126562","University of Colorado Denver/Anschutz Medical Campus","2012","On-Tenure track total","1304","689","615","7","3","4","135","79","56","15","3","12","53","28","25","4","2","2","946","501","445","3","1","2","120","59","61","21","13","8","-2"
"126562","University of Colorado Denver/Anschutz Medical Campus","2012","On-tenure track, professors","149","103","46","0","0","0","13","9","4","0","0","0","6","5","1","0","0","0","121","82","39","0","0","0","8","7","1","1","0","1","-2"
"126562","University of Colorado Denver/Anschutz Medical Campus","2012","On-tenure track, associate professors","384","204","180","4","1","3","30","20","10","2","0","2","15","9","6","1","1","0","302","157","145","2","0","2","27","15","12","1","1","0","-2"
"126562","University of Colorado Denver/Anschutz Medical Campus","2012","On-tenure track, assistant professors","771","382","389","3","2","1","92","50","42","13","3","10","32","14","18","3","1","2","523","262","261","1","1","0","85","37","48","19","12","7","-2"
"126562","University of Colorado Denver/Anschutz Medical Campus","2012","Not on tenure track/No tenure system system total","1085","345","740","8","3","5","54","27","27","14","6","8","44","12","32","0","0","0","823","260","563","3","2","1","125","29","96","14","6","8","-2"
"126562","University of Colorado Denver/Anschutz Medical Campus","2012","Not on tenure/no tenure system, professors","17","12","5","0","0","0","0","0","0","0","0","0","0","0","0","0","0","0","17","12","5","0","0","0","0","0","0","0","0","0","-2"
"126562","University of Colorado Denver/Anschutz Medical Campus","2012","Not on tenure/no tenure system, associate professors","57","34","23","1","1","0","4","3","1","0","0","0","2","2","0","0","0","0","46","24","22","0","0","0","4","4","0","0","0","0","-2"
"126562","University of Colorado Denver/Anschutz Medical Campus","2012","Not on tenure/no tenure system, assistant professors","59","30","29","0","0","0","7","2","5","2","2","0","6","3","3","0","0","0","37","20","17","0","0","0","3","2","1","4","1","3","-2"
"126562","University of Colorado Denver/Anschutz Medical Campus","2012","Not on tenure/no tenure system, instructors","952","269","683","7","2","5","43","22","21","12","4","8","36","7","29","0","0","0","723","204","519","3","2","1","118","23","95","10","5","5","-2"
"126942","Community College of Denver","2012","Not on tenure track/No tenure system system total","124","56","68","2","0","2","7","2","5","6","3","3","7","3","4","0","0","0","100","48","52","1","0","1","1","0","1","0","0","0","-2"
"126942","Community College of Denver","2012","Not on tenure/no tenure system, professors","31","14","17","0","0","0","2","1","1","4","1","3","1","0","1","0","0","0","24","12","12","0","0","0","0","0","0","0","0","0","-2"
"126942","Community College of Denver","2012","Not on tenure/no tenure system, associate professors","19","7","12","0","0","0","2","1","1","0","0","0","2","1","1","0","0","0","15","5","10","0","0","0","0","0","0","0","0","0","-2"
"126942","Community College of Denver","2012","Not on tenure/no tenure system, assistant professors","10","6","4","0","0","0","1","0","1","0","0","0","1","1","0","0","0","0","8","5","3","0","0","0","0","0","0","0","0","0","-2"
"126942","Community College of Denver","2012","Not on tenure/no tenure system, instructors","64","29","35","2","0","2","2","0","2","2","2","0","3","1","2","0","0","0","53","26","27","1","0","1","1","0","1","0","0","0","-2"
"127617","Morgan Community College","2012","Not on tenure track/No tenure system system total","33","12","21","0","0","0","0","0","0","0","0","0","0","0","0","0","0","0","33","12","21","0","0","0","0","0","0","0","0","0","-2"
"127617","Morgan Community College","2012","Not on tenure/no tenure system, no academic rank","33","12","21","0","0","0","0","0","0","0","0","0","0","0","0","0","0","0","33","12","21","0","0","0","0","0","0","0","0","0","-2"
"127884","Pueblo Community College","2012","Not on tenure track/No tenure system system total","100","43","57","1","1","0","0","0","0","0","0","0","16","10","6","0","0","0","80","31","49","0","0","0","3","1","2","0","0","0","-2"
"127884","Pueblo Community College","2012","Not on tenure/no tenure system, no academic rank","100","43","57","1","1","0","0","0","0","0","0","0","16","10","6","0","0","0","80","31","49","0","0","0","3","1","2","0","0","0","-2"
"128744","University of Bridgeport","2012","Tenured total","49","33","16","0","0","0","10","8","2","2","2","0","1","0","1","0","0","0","36","23","13","0","0","0","0","0","0","0","0","0","-2"
"128744","University of Bridgeport","2012","Tenured, professors","18","15","3","0","0","0","4","3","1","0","0","0","0","0","0","0","0","0","14","12","2","0","0","0","0","0","0","0","0","0","-2"
"128744","University of Bridgeport","2012","Tenured, associate professors","28","18","10","0","0","0","6","5","1","2","2","0","1","0","1","0","0","0","19","11","8","0","0","0","0","0","0","0","0","0","-2"
"128744","University of Bridgeport","2012","Tenured, assistant professors","3","0","3","0","0","0","0","0","0","0","0","0","0","0","0","0","0","0","3","0","3","0","0","0","0","0","0","0","0","0","-2"
"128744","University of Bridgeport","2012","On-Tenure track total","37","22","15","0","0","0","7","6","1","1","0","1","0","0","0","0","0","0","29","16","13","0","0","0","0","0","0","0","0","0","-2"
"128744","University of Bridgeport","2012","On-tenure track, associate professors","13","8","5","0","0","0","1","1","0","0","0","0","0","0","0","0","0","0","12","7","5","0","0","0","0","0","0","0","0","0","-2"
"128744","University of Bridgeport","2012","On-tenure track, assistant professors","24","14","10","0","0","0","6","5","1","1","0","1","0","0","0","0","0","0","17","9","8","0","0","0","0","0","0","0","0","0","-2"
"128744","University of Bridgeport","2012","Not on tenure track/No tenure system system total","35","20","15","0","0","0","2","1","1","0","0","0","0","0","0","0","0","0","33","19","14","0","0","0","0","0","0","0","0","0","-2"
"128744","University of Bridgeport","2012","Not on tenure/no tenure system, associate professors","2","1","1","0","0","0","0","0","0","0","0","0","0","0","0","0","0","0","2","1","1","0","0","0","0","0","0","0","0","0","-2"
"128744","University of Bridgeport","2012","Not on tenure/no tenure system, assistant professors","16","9","7","0","0","0","0","0","0","0","0","0","0","0","0","0","0","0","16","9","7","0","0","0","0","0","0","0","0","0","-2"
"128744","University of Bridgeport","2012","Not on tenure/no tenure system, lecturers","17","10","7","0","0","0","2","1","1","0","0","0","0","0","0","0","0","0","15","9","6","0","0","0","0","0","0","0","0","0","-2"
"132471","Barry University","2012","Tenured total","14","9","5","0","0","0","0","0","0","2","2","0","0","0","0","0","0","0","12","7","5","0","0","0","0","0","0","0","0","0","-2"
"132471","Barry University","2012","Tenured, professors","10","6","4","0","0","0","0","0","0","2","2","0","0","0","0","0","0","0","8","4","4","0","0","0","0","0","0","0","0","0","-2"
"132471","Barry University","2012","Tenured, associate professors","4","3","1","0","0","0","0","0","0","0","0","0","0","0","0","0","0","0","4","3","1","0","0","0","0","0","0","0","0","0","-2"
"132471","Barry University","2012","On-Tenure track total","20","9","11","0","0","0","3","0","3","1","0","1","2","2","0","0","0","0","11","6","5","2","0","2","1","1","0","0","0","0","-2"
"132471","Barry University","2012","On-tenure track, associate professors","11","7","4","0","0","0","1","0","1","0","0","0","2","2","0","0","0","0","6","4","2","1","0","1","1","1","0","0","0","0","-2"
"132471","Barry University","2012","On-tenure track, assistant professors","9","2","7","0","0","0","2","0","2","1","0","1","0","0","0","0","0","0","5","2","3","1","0","1","0","0","0","0","0","0","-2"
"132471","Barry University","2012","Not on tenure track/No tenure system system total","333","151","182","2","1","1","15","9","6","24","3","21","59","28","31","0","0","0","210","100","110","2","0","2","12","6","6","9","4","5","-2"
"132471","Barry University","2012","Not on tenure/no tenure system, professors","73","43","30","1","1","0","5","4","1","4","0","4","8","6","2","0","0","0","54","31","23","0","0","0","0","0","0","1","1","0","-2"
"132471","Barry University","2012","Not on tenure/no tenure system, associate professors","97","40","57","1","0","1","3","2","1","7","3","4","23","7","16","0","0","0","61","28","33","0","0","0","2","0","2","0","0","0","-2"
"132471","Barry University","2012","Not on tenure/no tenure system, assistant professors","121","52","69","0","0","0","7","3","4","10","0","10","14","8","6","0","0","0","76","33","43","0","0","0","7","5","2","7","3","4","-2"
"132471","Barry University","2012","Not on tenure/no tenure system, instructors","41","15","26","0","0","0","0","0","0","3","0","3","14","7","7","0","0","0","18","7","11","2","0","2","3","1","2","1","0","1","-2"
"132471","Barry University","2012","Not on tenure/no tenure system, lecturers","1","1","0","0","0","0","0","0","0","0","0","0","0","0","0","0","0","0","1","1","0","0","0","0","0","0","0","0","0","0","-2"
"132709","Broward College","2012","Tenured total","276","133","143","5","0","5","11","8","3","39","14","25","48","28","20","0","0","0","169","82","87","0","0","0","4","1","3","0","0","0","-2"
"132709","Broward College","2012","Tenured, professors","59","37","22","2","0","2","4","2","2","5","2","3","9","7","2","0","0","0","39","26","13","0","0","0","0","0","0","0","0","0","-2"
"132709","Broward College","2012","Tenured, associate professors","24","9","15","0","0","0","0","0","0","4","1","3","4","1","3","0","0","0","16","7","9","0","0","0","0","0","0","0","0","0","-2"
"132709","Broward College","2012","Tenured, assistant professors","174","78","96","3","0","3","7","6","1","28","10","18","32","18","14","0","0","0","100","43","57","0","0","0","4","1","3","0","0","0","-2"
"132709","Broward College","2012","Tenured, instructors","19","9","10","0","0","0","0","0","0","2","1","1","3","2","1","0","0","0","14","6","8","0","0","0","0","0","0","0","0","0","-2"
"132709","Broward College","2012","On-Tenure track total","105","51","54","0","0","0","5","4","1","24","10","14","18","8","10","0","0","0","47","22","25","0","0","0","10","7","3","1","0","1","-2"
"132709","Broward College","2012","On-tenure track, assistant professors","100","48","52","0","0","0","5","4","1","23","10","13","18","8","10","0","0","0","44","20","24","0","0","0","9","6","3","1","0","1","-2"
"132709","Broward College","2012","On-tenure track, instructors","5","3","2","0","0","0","0","0","0","1","0","1","0","0","0","0","0","0","3","2","1","0","0","0","1","1","0","0","0","0","-2"
"132709","Broward College","2012","Not on tenure track/No tenure system system total","16","10","6","1","0","1","1","1","0","2","1","1","0","0","0","0","0","0","10","7","3","0","0","0","2","1","1","0","0","0","-2"
"132709","Broward College","2012","Not on tenure/no tenure system, professors","1","1","0","0","0","0","0","0","0","0","0","0","0","0","0","0","0","0","1","1","0","0","0","0","0","0","0","0","0","0","-2"
"132709","Broward College","2012","Not on tenure/no tenure system, assistant professors","4","2","2","0","0","0","0","0","0","2","1","1","0","0","0","0","0","0","2","1","1","0","0","0","0","0","0","0","0","0","-2"
"132709","Broward College","2012","Not on tenure/no tenure system, instructors","2","1","1","0","0","0","0","0","0","0","0","0","0","0","0","0","0","0","2","1","1","0","0","0","0","0","0","0","0","0","-2"
"132709","Broward College","2012","Not on tenure/no tenure system, lecturers","9","6","3","1","0","1","1","1","0","0","0","0","0","0","0","0","0","0","5","4","1","0","0","0","2","1","1","0","0","0","-2"
"132903","University of Central Florida","2012","Tenured total","573","411","162","3","3","0","92","78","14","28","18","10","36","24","12","0","0","0","411","287","124","1","0","1","0","0","0","2","1","1","-2"
"132903","University of Central Florida","2012","Tenured, professors","234","184","50","0","0","0","43","37","6","2","1","1","12","9","3","0","0","0","176","137","39","1","0","1","0","0","0","0","0","0","-2"
"132903","University of Central Florida","2012","Tenured, associate professors","335","223","112","3","3","0","49","41","8","26","17","9","24","15","9","0","0","0","231","146","85","0","0","0","0","0","0","2","1","1","-2"
"132903","University of Central Florida","2012","Tenured, assistant professors","4","4","0","0","0","0","0","0","0","0","0","0","0","0","0","0","0","0","4","4","0","0","0","0","0","0","0","0","0","0","-2"
"132903","University of Central Florida","2012","On-Tenure track total","185","106","79","0","0","0","26","19","7","7","3","4","17","8","9","0","0","0","103","56","47","0","0","0","0","0","0","32","20","12","-2"
"132903","University of Central Florida","2012","On-tenure track, associate professors","10","8","2","0","0","0","0","0","0","0","0","0","2","2","0","0","0","0","8","6","2","0","0","0","0","0","0","0","0","0","-2"
"132903","University of Central Florida","2012","On-tenure track, assistant professors","175","98","77","0","0","0","26","19","7","7","3","4","15","6","9","0","0","0","95","50","45","0","0","0","0","0","0","32","20","12","-2"
"132903","University of Central Florida","2012","Not on tenure track/No tenure system system total","460","219","241","1","1","0","11","6","5","16","7","9","37","16","21","0","0","0","381","181","200","4","2","2","0","0","0","10","6","4","-2"
"132903","University of Central Florida","2012","Not on tenure/no tenure system, professors","8","6","2","0","0","0","1","1","0","0","0","0","1","0","1","0","0","0","5","4","1","0","0","0","0","0","0","1","1","0","-2"
"132903","University of Central Florida","2012","Not on tenure/no tenure system, associate professors","10","5","5","0","0","0","0","0","0","0","0","0","2","0","2","0","0","0","8","5","3","0","0","0","0","0","0","0","0","0","-2"
"132903","University of Central Florida","2012","Not on tenure/no tenure system, assistant professors","34","19","15","0","0","0","2","1","1","1","1","0","5","3","2","0","0","0","24","13","11","0","0","0","0","0","0","2","1","1","-2"
"132903","University of Central Florida","2012","Not on tenure/no tenure system, instructors","318","128","190","1","1","0","2","0","2","8","1","7","21","5","16","0","0","0","279","118","161","3","1","2","0","0","0","4","2","2","-2"
"132903","University of Central Florida","2012","Not on tenure/no tenure system, lecturers","87","60","27","0","0","0","6","4","2","7","5","2","8","8","0","0","0","0","62","40","22","1","1","0","0","0","0","3","2","1","-2"
"132903","University of Central Florida","2012","Not on tenure/no tenure system, no academic rank","3","1","2","0","0","0","0","0","0","0","0","0","0","0","0","0","0","0","3","1","2","0","0","0","0","0","0","0","0","0","-2"
"133508","Florida SouthWestern State College","2012","Tenured total","76","30","46","0","0","0","2","1","1","2","0","2","2","1","1","0","0","0","69","27","42","0","0","0","1","1","0","0","0","0","-2"
"133508","Florida SouthWestern State College","2012","Tenured, no academic rank","76","30","46","0","0","0","2","1","1","2","0","2","2","1","1","0","0","0","69","27","42","0","0","0","1","1","0","0","0","0","-2"
"133508","Florida SouthWestern State College","2012","On-Tenure track total","89","40","49","1","0","1","0","0","0","6","3","3","3","2","1","0","0","0","70","31","39","0","0","0","1","1","0","8","3","5","-2"
"133508","Florida SouthWestern State College","2012","On-tenure track, no academic rank","89","40","49","1","0","1","0","0","0","6","3","3","3","2","1","0","0","0","70","31","39","0","0","0","1","1","0","8","3","5","-2"
"133508","Florida SouthWestern State College","2012","Not on tenure track/No tenure system system total","4","3","1","0","0","0","0","0","0","0","0","0","1","1","0","0","0","0","3","2","1","0","0","0","0","0","0","0","0","0","-2"
"133508","Florida SouthWestern State College","2012","Not on tenure/no tenure system, no academic rank","4","3","1","0","0","0","0","0","0","0","0","0","1","1","0","0","0","0","3","2","1","0","0","0","0","0","0","0","0","0","-2"
"133669","Florida Atlantic University","2012","Tenured total","439","295","144","1","1","0","70","58","12","27","10","17","27","12","15","0","0","0","306","206","100","1","1","0","0","0","0","7","7","0","-2"
"133669","Florida Atlantic University","2012","Tenured, professors","203","150","53","1","1","0","35","31","4","10","5","5","10","5","5","0","0","0","146","107","39","0","0","0","0","0","0","1","1","0","-2"
"133669","Florida Atlantic University","2012","Tenured, associate professors","236","145","91","0","0","0","35","27","8","17","5","12","17","7","10","0","0","0","160","99","61","1","1","0","0","0","0","6","6","0","-2"
"133669","Florida Atlantic University","2012","On-Tenure track total","114","57","57","0","0","0","13","6","7","4","0","4","10","6","4","0","0","0","72","38","34","2","1","1","0","0","0","13","6","7","-2"
"133669","Florida Atlantic University","2012","On-tenure track, associate professors","6","1","5","0","0","0","1","0","1","1","0","1","0","0","0","0","0","0","4","1","3","0","0","0","0","0","0","0","0","0","-2"
"133669","Florida Atlantic University","2012","On-tenure track, assistant professors","108","56","52","0","0","0","12","6","6","3","0","3","10","6","4","0","0","0","68","37","31","2","1","1","0","0","0","13","6","7","-2"
"133669","Florida Atlantic University","2012","Not on tenure track/No tenure system system total","209","89","120","0","0","0","9","3","6","12","6","6","22","7","15","0","0","0","153","69","84","7","1","6","0","0","0","6","3","3","-2"
"133669","Florida Atlantic University","2012","Not on tenure/no tenure system, associate professors","7","4","3","0","0","0","0","0","0","0","0","0","1","0","1","0","0","0","5","4","1","1","0","1","0","0","0","0","0","0","-2"
"133669","Florida Atlantic University","2012","Not on tenure/no tenure system, assistant professors","27","8","19","0","0","0","2","2","0","2","0","2","5","3","2","0","0","0","15","3","12","1","0","1","0","0","0","2","0","2","-2"
"133669","Florida Atlantic University","2012","Not on tenure/no tenure system, instructors","173","77","96","0","0","0","7","1","6","10","6","4","16","4","12","0","0","0","131","62","69","5","1","4","0","0","0","4","3","1","-2"
"133669","Florida Atlantic University","2012","Not on tenure/no tenure system, lecturers","1","0","1","0","0","0","0","0","0","0","0","0","0","0","0","0","0","0","1","0","1","0","0","0","0","0","0","0","0","0","-2"
"133669","Florida Atlantic University","2012","Not on tenure/no tenure system, no academic rank","1","0","1","0","0","0","0","0","0","0","0","0","0","0","0","0","0","0","1","0","1","0","0","0","0","0","0","0","0","0","-2"
"133872","AdventHealth University","2012","Not on tenure track/No tenure system system total","62","17","45","0","0","0","5","0","5","10","1","9","3","2","1","0","0","0","44","14","30","0","0","0","0","0","0","0","0","0","-2"
"133872","AdventHealth University","2012","Not on tenure/no tenure system, professors","11","5","6","0","0","0","0","0","0","4","0","4","0","0","0","0","0","0","7","5","2","0","0","0","0","0","0","0","0","0","-2"
"133872","AdventHealth University","2012","Not on tenure/no tenure system, associate professors","19","6","13","0","0","0","0","0","0","2","1","1","1","0","1","0","0","0","16","5","11","0","0","0","0","0","0","0","0","0","-2"
"133872","AdventHealth University","2012","Not on tenure/no tenure system, assistant professors","24","6","18","0","0","0","3","0","3","3","0","3","2","2","0","0","0","0","16","4","12","0","0","0","0","0","0","0","0","0","-2"
"133872","AdventHealth University","2012","Not on tenure/no tenure system, instructors","8","0","8","0","0","0","2","0","2","1","0","1","0","0","0","0","0","0","5","0","5","0","0","0","0","0","0","0","0","0","-2"
"133960","The College of the Florida Keys","2012","Tenured total","7","3","4","1","1","0","0","0","0","0","0","0","1","0","1","0","0","0","4","2","2","0","0","0","1","0","1","0","0","0","-2"
"133960","The College of the Florida Keys","2012","Tenured, professors","4","3","1","1","1","0","0","0","0","0","0","0","0","0","0","0","0","0","2","2","0","0","0","0","1","0","1","0","0","0","-2"
"133960","The College of the Florida Keys","2012","Tenured, associate professors","2","0","2","0","0","0","0","0","0","0","0","0","0","0","0","0","0","0","2","0","2","0","0","0","0","0","0","0","0","0","-2"
"133960","The College of the Florida Keys","2012","Tenured, assistant professors","1","0","1","0","0","0","0","0","0","0","0","0","1","0","1","0","0","0","0","0","0","0","0","0","0","0","0","0","0","0","-2"
"133960","The College of the Florida Keys","2012","On-Tenure track total","11","5","6","0","0","0","0","0","0","0","0","0","0","0","0","0","0","0","10","5","5","1","0","1","0","0","0","0","0","0","-2"
"133960","The College of the Florida Keys","2012","On-tenure track, professors","3","3","0","0","0","0","0","0","0","0","0","0","0","0","0","0","0","0","3","3","0","0","0","0","0","0","0","0","0","0","-2"
"133960","The College of the Florida Keys","2012","On-tenure track, associate professors","4","1","3","0","0","0","0","0","0","0","0","0","0","0","0","0","0","0","3","1","2","1","0","1","0","0","0","0","0","0","-2"
"133960","The College of the Florida Keys","2012","On-tenure track, assistant professors","4","1","3","0","0","0","0","0","0","0","0","0","0","0","0","0","0","0","4","1","3","0","0","0","0","0","0","0","0","0","-2"
"133960","The College of the Florida Keys","2012","Not on tenure track/No tenure system system total","10","3","7","0","0","0","0","0","0","0","0","0","0","0","0","0","0","0","8","3","5","1","0","1","1","0","1","0","0","0","-2"
"133960","The College of the Florida Keys","2012","Not on tenure/no tenure system, professors","1","0","1","0","0","0","0","0","0","0","0","0","0","0","0","0","0","0","0","0","0","1","0","1","0","0","0","0","0","0","-2"
"133960","The College of the Florida Keys","2012","Not on tenure/no tenure system, associate professors","3","2","1","0","0","0","0","0","0","0","0","0","0","0","0","0","0","0","3","2","1","0","0","0","0","0","0","0","0","0","-2"
"133960","The College of the Florida Keys","2012","Not on tenure/no tenure system, assistant professors","3","0","3","0","0","0","0","0","0","0","0","0","0","0","0","0","0","0","2","0","2","0","0","0","1","0","1","0","0","0","-2"
"133960","The College of the Florida Keys","2012","Not on tenure/no tenure system, instructors","3","1","2","0","0","0","0","0","0","0","0","0","0","0","0","0","0","0","3","1","2","0","0","0","0","0","0","0","0","0","-2"
"134608","Indian River State College","2012","Tenured total","148","69","79","2","0","2","7","3","4","15","7","8","9","3","6","0","0","0","112","53","59","2","2","0","0","0","0","1","1","0","-2"
"134608","Indian River State College","2012","Tenured, professors","35","17","18","1","0","1","2","1","1","4","2","2","1","1","0","0","0","0","26","12","14","1","1","0","0","0","0","0","0","0","-2"
"134608","Indian River State College","2012","Tenured, associate professors","42","20","22","0","0","0","2","1","1","4","2","2","2","1","1","0","0","0","33","15","18","0","0","0","0","0","0","1","1","0","-2"
"134608","Indian River State College","2012","Tenured, assistant professors","57","26","31","1","0","1","3","1","2","7","3","4","6","1","5","0","0","0","39","20","19","1","1","0","0","0","0","0","0","0","-2"
"134608","Indian River State College","2012","Tenured, instructors","14","6","8","0","0","0","0","0","0","0","0","0","0","0","0","0","0","0","14","6","8","0","0","0","0","0","0","0","0","0","-2"
"134608","Indian River State College","2012","On-Tenure track total","52","19","33","0","0","0","1","0","1","5","2","3","1","0","1","1","0","1","44","17","27","0","0","0","0","0","0","0","0","0","-2"
"134608","Indian River State College","2012","On-tenure track, associate professors","1","0","1","0","0","0","0","0","0","0","0","0","0","0","0","0","0","0","1","0","1","0","0","0","0","0","0","0","0","0","-2"
"134608","Indian River State College","2012","On-tenure track, assistant professors","43","19","24","0","0","0","1","0","1","4","2","2","1","0","1","1","0","1","36","17","19","0","0","0","0","0","0","0","0","0","-2"
"134608","Indian River State College","2012","On-tenure track, instructors","8","0","8","0","0","0","0","0","0","1","0","1","0","0","0","0","0","0","7","0","7","0","0","0","0","0","0","0","0","0","-2"
"135081","Keiser University-Ft Lauderdale","2012","Not on tenure track/No tenure system system total","975","384","591","4","2","2","35","17","18","135","44","91","123","49","74","1","0","1","661","266","395","16","6","10","0","0","0","0","0","0","-2"
"135081","Keiser University-Ft Lauderdale","2012","Not on tenure/no tenure system, instructors","975","384","591","4","2","2","35","17","18","135","44","91","123","49","74","1","0","1","661","266","395","16","6","10","0","0","0","0","0","0","-2"
"135717","Miami Dade College","2012","Tenured total","576","271","305","2","1","1","31","13","18","78","27","51","245","119","126","0","0","0","214","109","105","6","2","4","0","0","0","0","0","0","-2"
"135717","Miami Dade College","2012","Tenured, professors","158","75","83","1","1","0","6","1","5","17","6","11","53","21","32","0","0","0","78","44","34","3","2","1","0","0","0","0","0","0","-2"
"135717","Miami Dade College","2012","Tenured, associate professors","283","136","147","0","0","0","15","8","7","42","16","26","139","67","72","0","0","0","86","45","41","1","0","1","0","0","0","0","0","0","-2"
"135717","Miami Dade College","2012","Tenured, assistant professors","125","52","73","1","0","1","10","4","6","18","5","13","48","27","21","0","0","0","46","16","30","2","0","2","0","0","0","0","0","0","-2"
"135717","Miami Dade College","2012","Tenured, instructors","10","8","2","0","0","0","0","0","0","1","0","1","5","4","1","0","0","0","4","4","0","0","0","0","0","0","0","0","0","0","-2"
"135717","Miami Dade College","2012","On-Tenure track total","79","37","42","1","0","1","1","0","1","17","5","12","36","17","19","0","0","0","23","15","8","1","0","1","0","0","0","0","0","0","-2"
"135717","Miami Dade College","2012","On-tenure track, assistant professors","19","8","11","0","0","0","0","0","0","2","0","2","10","4","6","0","0","0","7","4","3","0","0","0","0","0","0","0","0","0","-2"
"135717","Miami Dade College","2012","On-tenure track, instructors","60","29","31","1","0","1","1","0","1","15","5","10","26","13","13","0","0","0","16","11","5","1","0","1","0","0","0","0","0","0","-2"
"135717","Miami Dade College","2012","Not on tenure track/No tenure system system total","4","2","2","0","0","0","0","0","0","2","1","1","2","1","1","0","0","0","0","0","0","0","0","0","0","0","0","0","0","0","-2"
"135717","Miami Dade College","2012","Not on tenure/no tenure system, assistant professors","1","0","1","0","0","0","0","0","0","0","0","0","1","0","1","0","0","0","0","0","0","0","0","0","0","0","0","0","0","0","-2"
"135717","Miami Dade College","2012","Not on tenure/no tenure system, instructors","3","2","1","0","0","0","0","0","0","2","1","1","1","1","0","0","0","0","0","0","0","0","0","0","0","0","0","0","0","0","-2"
"136358","Palm Beach State College","2012","Tenured total","221","90","131","0","0","0","8","7","1","28","13","15","24","6","18","0","0","0","149","57","92","1","1","0","11","6","5","0","0","0","-2"
"136358","Palm Beach State College","2012","Tenured, professors","23","18","5","0","0","0","3","3","0","2","2","0","3","2","1","0","0","0","12","8","4","0","0","0","3","3","0","0","0","0","-2"
"136358","Palm Beach State College","2012","Tenured, associate professors","18","10","8","0","0","0","2","2","0","4","2","2","2","1","1","0","0","0","9","4","5","1","1","0","0","0","0","0","0","0","-2"
"136358","Palm Beach State College","2012","Tenured, assistant professors","26","7","19","0","0","0","0","0","0","4","1","3","2","0","2","0","0","0","20","6","14","0","0","0","0","0","0","0","0","0","-2"
"136358","Palm Beach State College","2012","Tenured, instructors","153","55","98","0","0","0","3","2","1","18","8","10","17","3","14","0","0","0","107","39","68","0","0","0","8","3","5","0","0","0","-2"
"136358","Palm Beach State College","2012","Tenured, no academic rank","1","0","1","0","0","0","0","0","0","0","0","0","0","0","0","0","0","0","1","0","1","0","0","0","0","0","0","0","0","0","-2"
"136358","Palm Beach State College","2012","On-Tenure track total","55","29","26","1","0","1","2","2","0","9","4","5","3","1","2","0","0","0","37","20","17","0","0","0","2","2","0","1","0","1","-2"
"136358","Palm Beach State College","2012","On-tenure track, professors","2","1","1","0","0","0","0","0","0","0","0","0","0","0","0","0","0","0","2","1","1","0","0","0","0","0","0","0","0","0","-2"
"136358","Palm Beach State College","2012","On-tenure track, associate professors","5","3","2","0","0","0","0","0","0","0","0","0","0","0","0","0","0","0","5","3","2","0","0","0","0","0","0","0","0","0","-2"
"136358","Palm Beach State College","2012","On-tenure track, assistant professors","14","6","8","0","0","0","0","0","0","4","1","3","1","0","1","0","0","0","7","4","3","0","0","0","1","1","0","1","0","1","-2"
"136358","Palm Beach State College","2012","On-tenure track, instructors","31","18","13","1","0","1","2","2","0","4","3","1","2","1","1","0","0","0","21","11","10","0","0","0","1","1","0","0","0","0","-2"
"136358","Palm Beach State College","2012","On-tenure track, no academic rank","3","1","2","0","0","0","0","0","0","1","0","1","0","0","0","0","0","0","2","1","1","0","0","0","0","0","0","0","0","0","-2"
"136358","Palm Beach State College","2012","Not on tenure track/No tenure system system total","21","8","13","0","0","0","0","0","0","2","1","1","3","1","2","0","0","0","16","6","10","0","0","0","0","0","0","0","0","0","-2"
"136358","Palm Beach State College","2012","Not on tenure/no tenure system, no academic rank","21","8","13","0","0","0","0","0","0","2","1","1","3","1","2","0","0","0","16","6","10","0","0","0","0","0","0","0","0","0","-2"
"136516","Polk State College","2012","Tenured total","94","37","57","2","1","1","1","1","0","6","2","4","6","1","5","0","0","0","78","31","47","0","0","0","0","0","0","1","1","0","-2"
"136516","Polk State College","2012","Tenured, no academic rank","94","37","57","2","1","1","1","1","0","6","2","4","6","1","5","0","0","0","78","31","47","0","0","0","0","0","0","1","1","0","-2"
"136516","Polk State College","2012","On-Tenure track total","49","22","27","0","0","0","0","0","0","4","2","2","2","1","1","0","0","0","41","19","22","1","0","1","0","0","0","1","0","1","-2"
"136516","Polk State College","2012","On-tenure track, no academic rank","49","22","27","0","0","0","0","0","0","4","2","2","2","1","1","0","0","0","41","19","22","1","0","1","0","0","0","1","0","1","-2"
"136516","Polk State College","2012","Not on tenure track/No tenure system system total","6","2","4","0","0","0","0","0","0","0","0","0","0","0","0","0","0","0","6","2","4","0","0","0","0","0","0","0","0","0","-2"
"136516","Polk State College","2012","Not on tenure/no tenure system, no academic rank","6","2","4","0","0","0","0","0","0","0","0","0","0","0","0","0","0","0","6","2","4","0","0","0","0","0","0","0","0","0","-2"
"137209","Seminole State College of Florida","2012","Tenured total","154","54","100","0","0","0","4","2","2","8","3","5","12","5","7","1","1","0","127","42","85","2","1","1","0","0","0","0","0","0","-2"
"137209","Seminole State College of Florida","2012","Tenured, no academic rank","154","54","100","0","0","0","4","2","2","8","3","5","12","5","7","1","1","0","127","42","85","2","1","1","0","0","0","0","0","0","-2"
"137209","Seminole State College of Florida","2012","On-Tenure track total","49","26","23","0","0","0","2","2","0","4","2","2","3","2","1","0","0","0","40","20","20","0","0","0","0","0","0","0","0","0","-2"
"137209","Seminole State College of Florida","2012","On-tenure track, no academic rank","49","26","23","0","0","0","2","2","0","4","2","2","3","2","1","0","0","0","40","20","20","0","0","0","0","0","0","0","0","0","-2"
"137315","South Florida State College","2012","Tenured total","50","25","25","0","0","0","1","0","1","1","0","1","0","0","0","0","0","0","48","25","23","0","0","0","0","0","0","0","0","0","-2"
"137315","South Florida State College","2012","Tenured, instructors","50","25","25","0","0","0","1","0","1","1","0","1","0","0","0","0","0","0","48","25","23","0","0","0","0","0","0","0","0","0","-2"
"137315","South Florida State College","2012","On-Tenure track total","16","5","11","0","0","0","0","0","0","2","0","2","0","0","0","0","0","0","14","5","9","0","0","0","0","0","0","0","0","0","-2"
"137315","South Florida State College","2012","On-tenure track, instructors","16","5","11","0","0","0","0","0","0","2","0","2","0","0","0","0","0","0","14","5","9","0","0","0","0","0","0","0","0","0","-2"
"137476","St. Thomas University","2012","Tenured total","18","12","6","0","0","0","0","0","0","2","1","1","1","1","0","0","0","0","15","10","5","0","0","0","0","0","0","0","0","0","-2"
"137476","St. Thomas University","2012","Tenured, professors","17","11","6","0","0","0","0","0","0","2","1","1","1","1","0","0","0","0","14","9","5","0","0","0","0","0","0","0","0","0","-2"
"137476","St. Thomas University","2012","Tenured, associate professors","1","1","0","0","0","0","0","0","0","0","0","0","0","0","0","0","0","0","1","1","0","0","0","0","0","0","0","0","0","0","-2"
"137476","St. Thomas University","2012","On-Tenure track total","2","1","1","0","0","0","1","1","0","0","0","0","0","0","0","0","0","0","1","0","1","0","0","0","0","0","0","0","0","0","-2"
"137476","St. Thomas University","2012","On-tenure track, professors","2","1","1","0","0","0","1","1","0","0","0","0","0","0","0","0","0","0","1","0","1","0","0","0","0","0","0","0","0","0","-2"
"137476","St. Thomas University","2012","Not on tenure track/No tenure system system total","92","49","43","0","0","0","5","3","2","9","4","5","22","11","11","0","0","0","55","31","24","0","0","0","0","0","0","1","0","1","-2"
"137476","St. Thomas University","2012","Not on tenure/no tenure system, professors","27","15","12","0","0","0","1","1","0","0","0","0","5","3","2","0","0","0","21","11","10","0","0","0","0","0","0","0","0","0","-2"
"137476","St. Thomas University","2012","Not on tenure/no tenure system, associate professors","29","18","11","0","0","0","2","0","2","4","1","3","4","3","1","0","0","0","19","14","5","0","0","0","0","0","0","0","0","0","-2"
"137476","St. Thomas University","2012","Not on tenure/no tenure system, assistant professors","27","11","16","0","0","0","2","2","0","3","1","2","10","4","6","0","0","0","11","4","7","0","0","0","0","0","0","1","0","1","-2"
"137476","St. Thomas University","2012","Not on tenure/no tenure system, instructors","7","4","3","0","0","0","0","0","0","2","2","0","2","0","2","0","0","0","3","2","1","0","0","0","0","0","0","0","0","0","-2"
"137476","St. Thomas University","2012","Not on tenure/no tenure system, lecturers","1","1","0","0","0","0","0","0","0","0","0","0","1","1","0","0","0","0","0","0","0","0","0","0","0","0","0","0","0","0","-2"
"137476","St. Thomas University","2012","Not on tenure/no tenure system, no academic rank","1","0","1","0","0","0","0","0","0","0","0","0","0","0","0","0","0","0","1","0","1","0","0","0","0","0","0","0","0","0","-2"
"138187","Valencia College","2012","Tenured total","276","119","157","3","1","2","10","5","5","17","8","9","26","9","17","0","0","0","217","94","123","0","0","0","3","2","1","0","0","0","-2"
"138187","Valencia College","2012","Tenured, no academic rank","276","119","157","3","1","2","10","5","5","17","8","9","26","9","17","0","0","0","217","94","123","0","0","0","3","2","1","0","0","0","-2"
"138187","Valencia College","2012","On-Tenure track total","101","38","63","0","0","0","7","3","4","16","9","7","10","3","7","0","0","0","64","22","42","0","0","0","4","1","3","0","0","0","-2"
"138187","Valencia College","2012","On-tenure track, no academic rank","101","38","63","0","0","0","7","3","4","16","9","7","10","3","7","0","0","0","64","22","42","0","0","0","4","1","3","0","0","0","-2"
"138187","Valencia College","2012","Not on tenure track/No tenure system system total","23","12","11","0","0","0","0","0","0","2","1","1","2","0","2","0","0","0","18","10","8","0","0","0","1","1","0","0","0","0","-2"
"138187","Valencia College","2012","Not on tenure/no tenure system, no academic rank","23","12","11","0","0","0","0","0","0","2","1","1","2","0","2","0","0","0","18","10","8","0","0","0","1","1","0","0","0","0","-2"
"139463","Dalton State College","2012","Tenured total","56","26","30","0","0","0","1","1","0","2","0","2","0","0","0","0","0","0","52","24","28","1","1","0","0","0","0","0","0","0","-2"
"139463","Dalton State College","2012","Tenured, professors","13","9","4","0","0","0","1","1","0","0","0","0","0","0","0","0","0","0","12","8","4","0","0","0","0","0","0","0","0","0","-2"
"139463","Dalton State College","2012","Tenured, associate professors","37","14","23","0","0","0","0","0","0","1","0","1","0","0","0","0","0","0","35","13","22","1","1","0","0","0","0","0","0","0","-2"
"139463","Dalton State College","2012","Tenured, assistant professors","6","3","3","0","0","0","0","0","0","1","0","1","0","0","0","0","0","0","5","3","2","0","0","0","0","0","0","0","0","0","-2"
"139463","Dalton State College","2012","On-Tenure track total","77","34","43","0","0","0","4","3","1","4","3","1","1","0","1","0","0","0","64","25","39","0","0","0","2","2","0","2","1","1","-2"
"139463","Dalton State College","2012","On-tenure track, professors","1","1","0","0","0","0","0","0","0","0","0","0","0","0","0","0","0","0","1","1","0","0","0","0","0","0","0","0","0","0","-2"
"139463","Dalton State College","2012","On-tenure track, associate professors","11","8","3","0","0","0","0","0","0","1","1","0","0","0","0","0","0","0","9","6","3","0","0","0","1","1","0","0","0","0","-2"
"139463","Dalton State College","2012","On-tenure track, assistant professors","57","24","33","0","0","0","4","3","1","3","2","1","1","0","1","0","0","0","46","17","29","0","0","0","1","1","0","2","1","1","-2"
"139463","Dalton State College","2012","On-tenure track, instructors","8","1","7","0","0","0","0","0","0","0","0","0","0","0","0","0","0","0","8","1","7","0","0","0","0","0","0","0","0","0","-2"
"139463","Dalton State College","2012","Not on tenure track/No tenure system system total","18","12","6","0","0","0","1","0","1","0","0","0","1","1","0","0","0","0","16","11","5","0","0","0","0","0","0","0","0","0","-2"
"139463","Dalton State College","2012","Not on tenure/no tenure system, professors","1","1","0","0","0","0","0","0","0","0","0","0","0","0","0","0","0","0","1","1","0","0","0","0","0","0","0","0","0","0","-2"
"139463","Dalton State College","2012","Not on tenure/no tenure system, assistant professors","2","0","2","0","0","0","0","0","0","0","0","0","0","0","0","0","0","0","2","0","2","0","0","0","0","0","0","0","0","0","-2"
"139463","Dalton State College","2012","Not on tenure/no tenure system, instructors","5","4","1","0","0","0","0","0","0","0","0","0","1","1","0","0","0","0","4","3","1","0","0","0","0","0","0","0","0","0","-2"
"139463","Dalton State College","2012","Not on tenure/no tenure system, lecturers","10","7","3","0","0","0","1","0","1","0","0","0","0","0","0","0","0","0","9","7","2","0","0","0","0","0","0","0","0","0","-2"
"143978","The Chicago School of Professional Psychology at Chicago","2012","Not on tenure track/No tenure system system total","82","34","48","1","0","1","3","1","2","10","4","6","6","2","4","0","0","0","57","25","32","2","0","2","3","2","1","0","0","0","-2"
"143978","The Chicago School of Professional Psychology at Chicago","2012","Not on tenure/no tenure system, professors","8","5","3","1","0","1","0","0","0","1","1","0","0","0","0","0","0","0","5","3","2","0","0","0","1","1","0","0","0","0","-2"
"143978","The Chicago School of Professional Psychology at Chicago","2012","Not on tenure/no tenure system, associate professors","39","18","21","0","0","0","1","0","1","6","2","4","2","0","2","0","0","0","28","15","13","0","0","0","2","1","1","0","0","0","-2"
"143978","The Chicago School of Professional Psychology at Chicago","2012","Not on tenure/no tenure system, assistant professors","33","10","23","0","0","0","2","1","1","3","1","2","4","2","2","0","0","0","22","6","16","2","0","2","0","0","0","0","0","0","-2"
"143978","The Chicago School of Professional Psychology at Chicago","2012","Not on tenure/no tenure system, instructors","1","0","1","0","0","0","0","0","0","0","0","0","0","0","0","0","0","0","1","0","1","0","0","0","0","0","0","0","0","0","-2"
"143978","The Chicago School of Professional Psychology at Chicago","2012","Not on tenure/no tenure system, lecturers","1","1","0","0","0","0","0","0","0","0","0","0","0","0","0","0","0","0","1","1","0","0","0","0","0","0","0","0","0","0","-2"
"144351","Concordia University-Chicago","2012","Tenured total","35","17","18","0","0","0","0","0","0","0","0","0","0","0","0","0","0","0","35","17","18","0","0","0","0","0","0","0","0","0","-2"
"144351","Concordia University-Chicago","2012","Tenured, professors","30","17","13","0","0","0","0","0","0","0","0","0","0","0","0","0","0","0","30","17","13","0","0","0","0","0","0","0","0","0","-2"
"144351","Concordia University-Chicago","2012","Tenured, associate professors","5","0","5","0","0","0","0","0","0","0","0","0","0","0","0","0","0","0","5","0","5","0","0","0","0","0","0","0","0","0","-2"
"144351","Concordia University-Chicago","2012","On-Tenure track total","99","40","59","0","0","0","4","2","2","5","1","4","3","0","3","0","0","0","81","36","45","0","0","0","4","0","4","2","1","1","-2"
"144351","Concordia University-Chicago","2012","On-tenure track, professors","6","3","3","0","0","0","0","0","0","1","0","1","0","0","0","0","0","0","5","3","2","0","0","0","0","0","0","0","0","0","-2"
"144351","Concordia University-Chicago","2012","On-tenure track, associate professors","44","14","30","0","0","0","1","0","1","2","0","2","1","0","1","0","0","0","38","14","24","0","0","0","2","0","2","0","0","0","-2"
"144351","Concordia University-Chicago","2012","On-tenure track, assistant professors","49","23","26","0","0","0","3","2","1","2","1","1","2","0","2","0","0","0","38","19","19","0","0","0","2","0","2","2","1","1","-2"
"144351","Concordia University-Chicago","2012","Not on tenure track/No tenure system system total","108","47","61","0","0","0","3","0","3","13","3","10","2","0","2","0","0","0","79","39","40","0","0","0","9","5","4","2","0","2","-2"
"144351","Concordia University-Chicago","2012","Not on tenure/no tenure system, professors","1","1","0","0","0","0","0","0","0","0","0","0","0","0","0","0","0","0","1","1","0","0","0","0","0","0","0","0","0","0","-2"
"144351","Concordia University-Chicago","2012","Not on tenure/no tenure system, associate professors","1","0","1","0","0","0","0","0","0","0","0","0","0","0","0","0","0","0","1","0","1","0","0","0","0","0","0","0","0","0","-2"
"144351","Concordia University-Chicago","2012","Not on tenure/no tenure system, assistant professors","7","2","5","0","0","0","0","0","0","2","0","2","0","0","0","0","0","0","4","2","2","0","0","0","0","0","0","1","0","1","-2"
"144351","Concordia University-Chicago","2012","Not on tenure/no tenure system, instructors","99","44","55","0","0","0","3","0","3","11","3","8","2","0","2","0","0","0","73","36","37","0","0","0","9","5","4","1","0","1","-2"
"145600","University of Illinois Chicago","2012","Tenured total","822","543","279","1","0","1","138","101","37","29","15","14","51","28","23","0","0","0","585","388","197","2","1","1","7","5","2","9","5","4","-2"
"145600","University of Illinois Chicago","2012","Tenured, professors","427","310","117","0","0","0","77","62","15","6","5","1","18","10","8","0","0","0","320","229","91","0","0","0","3","2","1","3","2","1","-2"
"145600","University of Illinois Chicago","2012","Tenured, associate professors","359","212","147","0","0","0","53","33","20","21","10","11","30","17","13","0","0","0","244","145","99","2","1","1","4","3","1","5","3","2","-2"
"145600","University of Illinois Chicago","2012","Tenured, assistant professors","35","20","15","1","0","1","7","5","2","2","0","2","3","1","2","0","0","0","21","14","7","0","0","0","0","0","0","1","0","1","-2"
"145600","University of Illinois Chicago","2012","Tenured, no academic rank","1","1","0","0","0","0","1","1","0","0","0","0","0","0","0","0","0","0","0","0","0","0","0","0","0","0","0","0","0","0","-2"
"145600","University of Illinois Chicago","2012","On-Tenure track total","394","192","202","1","0","1","83","47","36","34","14","20","30","10","20","1","0","1","187","90","97","7","2","5","9","5","4","42","24","18","-2"
"145600","University of Illinois Chicago","2012","On-tenure track, professors","14","9","5","0","0","0","1","1","0","0","0","0","0","0","0","0","0","0","12","7","5","1","1","0","0","0","0","0","0","0","-2"
"145600","University of Illinois Chicago","2012","On-tenure track, associate professors","31","18","13","0","0","0","7","4","3","2","1","1","0","0","0","0","0","0","21","12","9","1","1","0","0","0","0","0","0","0","-2"
"145600","University of Illinois Chicago","2012","On-tenure track, assistant professors","349","165","184","1","0","1","75","42","33","32","13","19","30","10","20","1","0","1","154","71","83","5","0","5","9","5","4","42","24","18","-2"
"145600","University of Illinois Chicago","2012","Not on tenure track/No tenure system system total","512","228","284","0","0","0","53","25","28","31","11","20","28","15","13","0","0","0","360","160","200","4","1","3","13","6","7","23","10","13","-2"
"145600","University of Illinois Chicago","2012","Not on tenure/no tenure system, professors","22","14","8","0","0","0","3","3","0","0","0","0","0","0","0","0","0","0","18","10","8","0","0","0","0","0","0","1","1","0","-2"
"145600","University of Illinois Chicago","2012","Not on tenure/no tenure system, associate professors","60","24","36","0","0","0","7","2","5","7","2","5","1","0","1","0","0","0","43","19","24","0","0","0","2","1","1","0","0","0","-2"
"145600","University of Illinois Chicago","2012","Not on tenure/no tenure system, assistant professors","226","104","122","0","0","0","30","14","16","13","7","6","15","7","8","0","0","0","146","68","78","1","0","1","6","3","3","15","5","10","-2"
"145600","University of Illinois Chicago","2012","Not on tenure/no tenure system, instructors","55","11","44","0","0","0","4","3","1","6","2","4","1","1","0","0","0","0","39","4","35","1","0","1","2","1","1","2","0","2","-2"
"145600","University of Illinois Chicago","2012","Not on tenure/no tenure system, lecturers","141","72","69","0","0","0","8","2","6","4","0","4","10","7","3","0","0","0","109","57","52","2","1","1","3","1","2","5","4","1","-2"
"145600","University of Illinois Chicago","2012","Not on tenure/no tenure system, no academic rank","8","3","5","0","0","0","1","1","0","1","0","1","1","0","1","0","0","0","5","2","3","0","0","0","0","0","0","0","0","0","-2"
"147536","National Louis University","2012","Tenured total","75","35","40","0","0","0","2","0","2","2","2","0","1","1","0","0","0","0","68","30","38","1","1","0","0","0","0","1","1","0","-2"
"147536","National Louis University","2012","Tenured, professors","19","11","8","0","0","0","0","0","0","0","0","0","0","0","0","0","0","0","18","10","8","0","0","0","0","0","0","1","1","0","-2"
"147536","National Louis University","2012","Tenured, associate professors","50","20","30","0","0","0","2","0","2","1","1","0","1","1","0","0","0","0","46","18","28","0","0","0","0","0","0","0","0","0","-2"
"147536","National Louis University","2012","Tenured, assistant professors","6","4","2","0","0","0","0","0","0","1","1","0","0","0","0","0","0","0","4","2","2","1","1","0","0","0","0","0","0","0","-2"
"147536","National Louis University","2012","On-Tenure track total","20","8","12","0","0","0","3","1","2","3","2","1","2","1","1","0","0","0","12","4","8","0","0","0","0","0","0","0","0","0","-2"
"147536","National Louis University","2012","On-tenure track, assistant professors","20","8","12","0","0","0","3","1","2","3","2","1","2","1","1","0","0","0","12","4","8","0","0","0","0","0","0","0","0","0","-2"
"147536","National Louis University","2012","Not on tenure track/No tenure system system total","44","15","29","0","0","0","1","0","1","2","0","2","2","1","1","0","0","0","37","13","24","1","0","1","1","1","0","0","0","0","-2"
"147536","National Louis University","2012","Not on tenure/no tenure system, associate professors","5","1","4","0","0","0","0","0","0","1","0","1","0","0","0","0","0","0","4","1","3","0","0","0","0","0","0","0","0","0","-2"
"147536","National Louis University","2012","Not on tenure/no tenure system, assistant professors","28","12","16","0","0","0","1","0","1","1","0","1","1","1","0","0","0","0","23","10","13","1","0","1","1","1","0","0","0","0","-2"
"147536","National Louis University","2012","Not on tenure/no tenure system, instructors","11","2","9","0","0","0","0","0","0","0","0","0","1","0","1","0","0","0","10","2","8","0","0","0","0","0","0","0","0","0","-2"
"147679","North Park University","2012","Tenured total","73","35","38","0","0","0","7","5","2","4","1","3","3","1","2","0","0","0","59","28","31","0","0","0","0","0","0","0","0","0","-2"
"147679","North Park University","2012","Tenured, professors","49","27","22","0","0","0","3","2","1","3","1","2","2","1","1","0","0","0","41","23","18","0","0","0","0","0","0","0","0","0","-2"
"147679","North Park University","2012","Tenured, associate professors","21","7","14","0","0","0","4","3","1","1","0","1","1","0","1","0","0","0","15","4","11","0","0","0","0","0","0","0","0","0","-2"
"147679","North Park University","2012","Tenured, assistant professors","3","1","2","0","0","0","0","0","0","0","0","0","0","0","0","0","0","0","3","1","2","0","0","0","0","0","0","0","0","0","-2"
"147679","North Park University","2012","On-Tenure track total","21","10","11","0","0","0","2","1","1","0","0","0","2","0","2","0","0","0","17","9","8","0","0","0","0","0","0","0","0","0","-2"
"147679","North Park University","2012","On-tenure track, professors","2","2","0","0","0","0","0","0","0","0","0","0","0","0","0","0","0","0","2","2","0","0","0","0","0","0","0","0","0","0","-2"
"147679","North Park University","2012","On-tenure track, associate professors","6","3","3","0","0","0","0","0","0","0","0","0","1","0","1","0","0","0","5","3","2","0","0","0","0","0","0","0","0","0","-2"
"147679","North Park University","2012","On-tenure track, assistant professors","13","5","8","0","0","0","2","1","1","0","0","0","1","0","1","0","0","0","10","4","6","0","0","0","0","0","0","0","0","0","-2"
"147679","North Park University","2012","Not on tenure track/No tenure system system total","26","8","18","0","0","0","0","0","0","1","0","1","0","0","0","0","0","0","24","7","17","1","1","0","0","0","0","0","0","0","-2"
"147679","North Park University","2012","Not on tenure/no tenure system, professors","4","1","3","0","0","0","0","0","0","0","0","0","0","0","0","0","0","0","4","1","3","0","0","0","0","0","0","0","0","0","-2"
"147679","North Park University","2012","Not on tenure/no tenure system, associate professors","7","1","6","0","0","0","0","0","0","1","0","1","0","0","0","0","0","0","6","1","5","0","0","0","0","0","0","0","0","0","-2"
"147679","North Park University","2012","Not on tenure/no tenure system, assistant professors","15","6","9","0","0","0","0","0","0","0","0","0","0","0","0","0","0","0","14","5","9","1","1","0","0","0","0","0","0","0","-2"
"147776","Northeastern Illinois University","2012","Tenured total","147","68","79","0","0","0","20","11","9","11","6","5","17","5","12","0","0","0","95","42","53","0","0","0","4","4","0","0","0","0","-2"
"147776","Northeastern Illinois University","2012","Tenured, professors","58","27","31","0","0","0","12","7","5","1","1","0","6","0","6","0","0","0","39","19","20","0","0","0","0","0","0","0","0","0","-2"
"147776","Northeastern Illinois University","2012","Tenured, associate professors","83","36","47","0","0","0","7","3","4","8","3","5","10","4","6","0","0","0","54","22","32","0","0","0","4","4","0","0","0","0","-2"
"147776","Northeastern Illinois University","2012","Tenured, assistant professors","6","5","1","0","0","0","1","1","0","2","2","0","1","1","0","0","0","0","2","1","1","0","0","0","0","0","0","0","0","0","-2"
"147776","Northeastern Illinois University","2012","On-Tenure track total","94","41","53","0","0","0","14","6","8","6","2","4","15","7","8","0","0","0","42","16","26","0","0","0","12","8","4","5","2","3","-2"
"147776","Northeastern Illinois University","2012","On-tenure track, associate professors","3","1","2","0","0","0","0","0","0","0","0","0","1","1","0","0","0","0","2","0","2","0","0","0","0","0","0","0","0","0","-2"
"147776","Northeastern Illinois University","2012","On-tenure track, assistant professors","91","40","51","0","0","0","14","6","8","6","2","4","14","6","8","0","0","0","40","16","24","0","0","0","12","8","4","5","2","3","-2"
"147776","Northeastern Illinois University","2012","Not on tenure track/No tenure system system total","143","66","77","0","0","0","6","4","2","7","4","3","9","4","5","0","0","0","110","48","62","0","0","0","11","6","5","0","0","0","-2"
"147776","Northeastern Illinois University","2012","Not on tenure/no tenure system, instructors","143","66","77","0","0","0","6","4","2","7","4","3","9","4","5","0","0","0","110","48","62","0","0","0","11","6","5","0","0","0","-2"
"148335","Robert Morris University Illinois","2012","Not on tenure track/No tenure system system total","124","65","59","0","0","0","14","10","4","12","4","8","3","3","0","0","0","0","95","48","47","0","0","0","0","0","0","0","0","0","-2"
"148335","Robert Morris University Illinois","2012","Not on tenure/no tenure system, no academic rank","124","65","59","0","0","0","14","10","4","12","4","8","3","3","0","0","0","0","95","48","47","0","0","0","0","0","0","0","0","0","-2"
"148487","Roosevelt University","2012","Tenured total","145","87","58","1","1","0","10","7","3","8","4","4","7","5","2","0","0","0","106","60","46","2","0","2","11","10","1","0","0","0","-2"
"148487","Roosevelt University","2012","Tenured, professors","48","35","13","0","0","0","5","4","1","5","3","2","3","3","0","0","0","0","31","22","9","0","0","0","4","3","1","0","0","0","-2"
"148487","Roosevelt University","2012","Tenured, associate professors","94","50","44","1","1","0","5","3","2","3","1","2","4","2","2","0","0","0","72","36","36","2","0","2","7","7","0","0","0","0","-2"
"148487","Roosevelt University","2012","Tenured, assistant professors","3","2","1","0","0","0","0","0","0","0","0","0","0","0","0","0","0","0","3","2","1","0","0","0","0","0","0","0","0","0","-2"
"148487","Roosevelt University","2012","On-Tenure track total","64","35","29","0","0","0","13","5","8","5","2","3","1","1","0","0","0","0","37","20","17","3","3","0","5","4","1","0","0","0","-2"
"148487","Roosevelt University","2012","On-tenure track, professors","1","1","0","0","0","0","0","0","0","0","0","0","0","0","0","0","0","0","0","0","0","1","1","0","0","0","0","0","0","0","-2"
"148487","Roosevelt University","2012","On-tenure track, associate professors","6","5","1","0","0","0","0","0","0","0","0","0","0","0","0","0","0","0","4","3","1","1","1","0","1","1","0","0","0","0","-2"
"148487","Roosevelt University","2012","On-tenure track, assistant professors","57","29","28","0","0","0","13","5","8","5","2","3","1","1","0","0","0","0","33","17","16","1","1","0","4","3","1","0","0","0","-2"
"148487","Roosevelt University","2012","Not on tenure track/No tenure system system total","37","18","19","0","0","0","5","1","4","3","2","1","2","1","1","0","0","0","25","14","11","1","0","1","1","0","1","0","0","0","-2"
"148487","Roosevelt University","2012","Not on tenure/no tenure system, professors","2","2","0","0","0","0","0","0","0","0","0","0","0","0","0","0","0","0","2","2","0","0","0","0","0","0","0","0","0","0","-2"
"148487","Roosevelt University","2012","Not on tenure/no tenure system, associate professors","1","0","1","0","0","0","0","0","0","0","0","0","0","0","0","0","0","0","1","0","1","0","0","0","0","0","0","0","0","0","-2"
"148487","Roosevelt University","2012","Not on tenure/no tenure system, assistant professors","10","6","4","0","0","0","3","0","3","0","0","0","1","1","0","0","0","0","6","5","1","0","0","0","0","0","0","0","0","0","-2"
"148487","Roosevelt University","2012","Not on tenure/no tenure system, lecturers","22","9","13","0","0","0","2","1","1","3","2","1","0","0","0","0","0","0","15","6","9","1","0","1","1","0","1","0","0","0","-2"
"148487","Roosevelt University","2012","Not on tenure/no tenure system, no academic rank","2","1","1","0","0","0","0","0","0","0","0","0","1","0","1","0","0","0","1","1","0","0","0","0","0","0","0","0","0","0","-2"
"148496","Dominican University","2012","Tenured total","71","33","38","0","0","0","1","1","0","1","1","0","1","1","0","0","0","0","68","30","38","0","0","0","0","0","0","0","0","0","-2"
"148496","Dominican University","2012","Tenured, professors","44","25","19","0","0","0","0","0","0","0","0","0","1","1","0","0","0","0","43","24","19","0","0","0","0","0","0","0","0","0","-2"
"148496","Dominican University","2012","Tenured, associate professors","16","4","12","0","0","0","1","1","0","0","0","0","0","0","0","0","0","0","15","3","12","0","0","0","0","0","0","0","0","0","-2"
"148496","Dominican University","2012","Tenured, assistant professors","11","4","7","0","0","0","0","0","0","1","1","0","0","0","0","0","0","0","10","3","7","0","0","0","0","0","0","0","0","0","-2"
"148496","Dominican University","2012","On-Tenure track total","61","20","41","0","0","0","5","2","3","6","2","4","2","0","2","1","0","1","46","15","31","0","0","0","1","1","0","0","0","0","-2"
"148496","Dominican University","2012","On-tenure track, professors","1","1","0","0","0","0","1","1","0","0","0","0","0","0","0","0","0","0","0","0","0","0","0","0","0","0","0","0","0","0","-2"
"148496","Dominican University","2012","On-tenure track, associate professors","15","4","11","0","0","0","0","0","0","2","0","2","0","0","0","1","0","1","12","4","8","0","0","0","0","0","0","0","0","0","-2"
"148496","Dominican University","2012","On-tenure track, assistant professors","41","13","28","0","0","0","3","1","2","4","2","2","2","0","2","0","0","0","31","9","22","0","0","0","1","1","0","0","0","0","-2"
"148496","Dominican University","2012","On-tenure track, instructors","4","2","2","0","0","0","1","0","1","0","0","0","0","0","0","0","0","0","3","2","1","0","0","0","0","0","0","0","0","0","-2"
"148496","Dominican University","2012","Not on tenure track/No tenure system system total","21","9","12","0","0","0","0","0","0","1","1","0","0","0","0","0","0","0","20","8","12","0","0","0","0","0","0","0","0","0","-2"
"148496","Dominican University","2012","Not on tenure/no tenure system, assistant professors","3","0","3","0","0","0","0","0","0","0","0","0","0","0","0","0","0","0","3","0","3","0","0","0","0","0","0","0","0","0","-2"
"148496","Dominican University","2012","Not on tenure/no tenure system, instructors","1","1","0","0","0","0","0","0","0","1","1","0","0","0","0","0","0","0","0","0","0","0","0","0","0","0","0","0","0","0","-2"
"148496","Dominican University","2012","Not on tenure/no tenure system, lecturers","17","8","9","0","0","0","0","0","0","0","0","0","0","0","0","0","0","0","17","8","9","0","0","0","0","0","0","0","0","0","-2"
"148511","Rush University","2012","Tenured total","188","119","69","1","1","0","31","18","13","2","1","1","5","4","1","1","1","0","147","93","54","1","1","0","0","0","0","0","0","0","-2"
"148511","Rush University","2012","Tenured, professors","80","57","23","0","0","0","13","9","4","0","0","0","0","0","0","0","0","0","67","48","19","0","0","0","0","0","0","0","0","0","-2"
"148511","Rush University","2012","Tenured, associate professors","108","62","46","1","1","0","18","9","9","2","1","1","5","4","1","1","1","0","80","45","35","1","1","0","0","0","0","0","0","0","-2"
"148511","Rush University","2012","On-Tenure track total","674","307","367","0","0","0","180","88","92","21","8","13","19","8","11","0","0","0","447","200","247","7","3","4","0","0","0","0","0","0","-2"
"148511","Rush University","2012","On-tenure track, assistant professors","446","225","221","0","0","0","127","65","62","13","5","8","12","4","8","0","0","0","292","150","142","2","1","1","0","0","0","0","0","0","-2"
"148511","Rush University","2012","On-tenure track, instructors","228","82","146","0","0","0","53","23","30","8","3","5","7","4","3","0","0","0","155","50","105","5","2","3","0","0","0","0","0","0","-2"
"148511","Rush University","2012","Not on tenure track/No tenure system system total","193","14","179","0","0","0","4","0","4","13","1","12","2","0","2","0","0","0","103","13","90","71","0","71","0","0","0","0","0","0","-2"
"148511","Rush University","2012","Not on tenure/no tenure system, professors","24","3","21","0","0","0","0","0","0","0","0","0","0","0","0","0","0","0","17","3","14","7","0","7","0","0","0","0","0","0","-2"
"148511","Rush University","2012","Not on tenure/no tenure system, associate professors","37","3","34","0","0","0","0","0","0","2","0","2","0","0","0","0","0","0","21","3","18","14","0","14","0","0","0","0","0","0","-2"
"148511","Rush University","2012","Not on tenure/no tenure system, assistant professors","61","2","59","0","0","0","2","0","2","7","1","6","0","0","0","0","0","0","27","1","26","25","0","25","0","0","0","0","0","0","-2"
"148511","Rush University","2012","Not on tenure/no tenure system, instructors","71","6","65","0","0","0","2","0","2","4","0","4","2","0","2","0","0","0","38","6","32","25","0","25","0","0","0","0","0","0","-2"
"148627","Saint Xavier University","2012","Tenured total","102","48","54","0","0","0","5","3","2","7","4","3","1","0","1","0","0","0","88","40","48","0","0","0","1","1","0","0","0","0","-2"
"148627","Saint Xavier University","2012","Tenured, professors","30","17","13","0","0","0","1","1","0","1","1","0","0","0","0","0","0","0","27","14","13","0","0","0","1","1","0","0","0","0","-2"
"148627","Saint Xavier University","2012","Tenured, associate professors","70","31","39","0","0","0","4","2","2","5","3","2","1","0","1","0","0","0","60","26","34","0","0","0","0","0","0","0","0","0","-2"
"148627","Saint Xavier University","2012","Tenured, assistant professors","2","0","2","0","0","0","0","0","0","1","0","1","0","0","0","0","0","0","1","0","1","0","0","0","0","0","0","0","0","0","-2"
"148627","Saint Xavier University","2012","On-Tenure track total","48","19","29","1","0","1","5","2","3","2","2","0","2","1","1","0","0","0","31","9","22","0","0","0","7","5","2","0","0","0","-2"
"148627","Saint Xavier University","2012","On-tenure track, associate professors","12","8","4","0","0","0","1","1","0","1","1","0","0","0","0","0","0","0","8","4","4","0","0","0","2","2","0","0","0","0","-2"
"148627","Saint Xavier University","2012","On-tenure track, assistant professors","36","11","25","1","0","1","4","1","3","1","1","0","2","1","1","0","0","0","23","5","18","0","0","0","5","3","2","0","0","0","-2"
"148627","Saint Xavier University","2012","Not on tenure track/No tenure system system total","29","7","22","0","0","0","0","0","0","1","0","1","1","0","1","0","0","0","23","5","18","0","0","0","4","2","2","0","0","0","-2"
"148627","Saint Xavier University","2012","Not on tenure/no tenure system, assistant professors","19","4","15","0","0","0","0","0","0","1","0","1","0","0","0","0","0","0","16","4","12","0","0","0","2","0","2","0","0","0","-2"
"148627","Saint Xavier University","2012","Not on tenure/no tenure system, instructors","1","0","1","0","0","0","0","0","0","0","0","0","0","0","0","0","0","0","1","0","1","0","0","0","0","0","0","0","0","0","-2"
"148627","Saint Xavier University","2012","Not on tenure/no tenure system, lecturers","9","3","6","0","0","0","0","0","0","0","0","0","1","0","1","0","0","0","6","1","5","0","0","0","2","2","0","0","0","0","-2"
"149639","VanderCook College of Music","2012","Not on tenure track/No tenure system system total","11","4","7","0","0","0","2","0","2","1","1","0","0","0","0","0","0","0","8","3","5","0","0","0","0","0","0","0","0","0","-2"
"149639","VanderCook College of Music","2012","Not on tenure/no tenure system, professors","4","2","2","0","0","0","0","0","0","0","0","0","0","0","0","0","0","0","4","2","2","0","0","0","0","0","0","0","0","0","-2"
"149639","VanderCook College of Music","2012","Not on tenure/no tenure system, associate professors","5","0","5","0","0","0","2","0","2","0","0","0","0","0","0","0","0","0","3","0","3","0","0","0","0","0","0","0","0","0","-2"
"149639","VanderCook College of Music","2012","Not on tenure/no tenure system, assistant professors","2","2","0","0","0","0","0","0","0","1","1","0","0","0","0","0","0","0","1","1","0","0","0","0","0","0","0","0","0","0","-2"
"150172","Calumet College of Saint Joseph","2012","Tenured total","17","14","3","0","0","0","0","0","0","0","0","0","0","0","0","0","0","0","17","14","3","0","0","0","0","0","0","0","0","0","-2"
"150172","Calumet College of Saint Joseph","2012","Tenured, professors","5","4","1","0","0","0","0","0","0","0","0","0","0","0","0","0","0","0","5","4","1","0","0","0","0","0","0","0","0","0","-2"
"150172","Calumet College of Saint Joseph","2012","Tenured, associate professors","10","8","2","0","0","0","0","0","0","0","0","0","0","0","0","0","0","0","10","8","2","0","0","0","0","0","0","0","0","0","-2"
"150172","Calumet College of Saint Joseph","2012","Tenured, assistant professors","2","2","0","0","0","0","0","0","0","0","0","0","0","0","0","0","0","0","2","2","0","0","0","0","0","0","0","0","0","0","-2"
"150172","Calumet College of Saint Joseph","2012","On-Tenure track total","11","6","5","0","0","0","0","0","0","0","0","0","0","0","0","0","0","0","11","6","5","0","0","0","0","0","0","0","0","0","-2"
"150172","Calumet College of Saint Joseph","2012","On-tenure track, associate professors","1","0","1","0","0","0","0","0","0","0","0","0","0","0","0","0","0","0","1","0","1","0","0","0","0","0","0","0","0","0","-2"
"150172","Calumet College of Saint Joseph","2012","On-tenure track, assistant professors","10","6","4","0","0","0","0","0","0","0","0","0","0","0","0","0","0","0","10","6","4","0","0","0","0","0","0","0","0","0","-2"
"150172","Calumet College of Saint Joseph","2012","Not on tenure track/No tenure system system total","5","4","1","0","0","0","1","0","1","1","1","0","1","1","0","0","0","0","2","2","0","0","0","0","0","0","0","0","0","0","-2"
"150172","Calumet College of Saint Joseph","2012","Not on tenure/no tenure system, instructors","4","4","0","0","0","0","0","0","0","1","1","0","1","1","0","0","0","0","2","2","0","0","0","0","0","0","0","0","0","0","-2"
"150172","Calumet College of Saint Joseph","2012","Not on tenure/no tenure system, lecturers","1","0","1","0","0","0","1","0","1","0","0","0","0","0","0","0","0","0","0","0","0","0","0","0","0","0","0","0","0","0","-2"
"151360","Indiana University-Northwest","2012","Tenured total","70","44","26","0","0","0","9","6","3","5","3","2","5","3","2","0","0","0","50","31","19","1","1","0","0","0","0","0","0","0","-2"
"151360","Indiana University-Northwest","2012","Tenured, professors","31","22","9","0","0","0","4","4","0","2","1","1","1","0","1","0","0","0","23","16","7","1","1","0","0","0","0","0","0","0","-2"
"151360","Indiana University-Northwest","2012","Tenured, associate professors","39","22","17","0","0","0","5","2","3","3","2","1","4","3","1","0","0","0","27","15","12","0","0","0","0","0","0","0","0","0","-2"
"151360","Indiana University-Northwest","2012","On-Tenure track total","46","23","23","1","0","1","6","3","3","7","2","5","1","1","0","0","0","0","30","17","13","1","0","1","0","0","0","0","0","0","-2"
"151360","Indiana University-Northwest","2012","On-tenure track, associate professors","6","4","2","0","0","0","1","1","0","0","0","0","0","0","0","0","0","0","5","3","2","0","0","0","0","0","0","0","0","0","-2"
"151360","Indiana University-Northwest","2012","On-tenure track, assistant professors","40","19","21","1","0","1","5","2","3","7","2","5","1","1","0","0","0","0","25","14","11","1","0","1","0","0","0","0","0","0","-2"
"151360","Indiana University-Northwest","2012","Not on tenure track/No tenure system system total","60","16","44","0","0","0","5","1","4","3","0","3","2","1","1","0","0","0","49","14","35","1","0","1","0","0","0","0","0","0","-2"
"151360","Indiana University-Northwest","2012","Not on tenure/no tenure system, professors","1","1","0","0","0","0","0","0","0","0","0","0","0","0","0","0","0","0","1","1","0","0","0","0","0","0","0","0","0","0","-2"
"151360","Indiana University-Northwest","2012","Not on tenure/no tenure system, associate professors","5","0","5","0","0","0","1","0","1","1","0","1","0","0","0","0","0","0","3","0","3","0","0","0","0","0","0","0","0","0","-2"
"151360","Indiana University-Northwest","2012","Not on tenure/no tenure system, assistant professors","16","2","14","0","0","0","0","0","0","1","0","1","0","0","0","0","0","0","15","2","13","0","0","0","0","0","0","0","0","0","-2"
"151360","Indiana University-Northwest","2012","Not on tenure/no tenure system, instructors","2","1","1","0","0","0","0","0","0","0","0","0","0","0","0","0","0","0","2","1","1","0","0","0","0","0","0","0","0","0","-2"
"151360","Indiana University-Northwest","2012","Not on tenure/no tenure system, lecturers","36","12","24","0","0","0","4","1","3","1","0","1","2","1","1","0","0","0","28","10","18","1","0","1","0","0","0","0","0","0","-2"
"160409","Saint Joseph Seminary College","2012","Not on tenure track/No tenure system system total","24","18","6","0","0","0","0","0","0","0","0","0","0","0","0","0","0","0","24","18","6","0","0","0","0","0","0","0","0","0","-2"
"160409","Saint Joseph Seminary College","2012","Not on tenure/no tenure system, professors","24","18","6","0","0","0","0","0","0","0","0","0","0","0","0","0","0","0","24","18","6","0","0","0","0","0","0","0","0","0","-2"
"165167","Cambridge College","2012","Not on tenure track/No tenure system system total","28","14","14","0","0","0","4","3","1","4","0","4","1","1","0","10","10","0","9","0","9","0","0","0","0","0","0","0","0","0","-2"
"165167","Cambridge College","2012","Not on tenure/no tenure system, professors","19","11","8","0","0","0","3","2","1","4","0","4","1","1","0","8","8","0","3","0","3","0","0","0","0","0","0","0","0","0","-2"
"165167","Cambridge College","2012","Not on tenure/no tenure system, associate professors","5","3","2","0","0","0","1","1","0","0","0","0","0","0","0","2","2","0","2","0","2","0","0","0","0","0","0","0","0","0","-2"
"165167","Cambridge College","2012","Not on tenure/no tenure system, assistant professors","4","0","4","0","0","0","0","0","0","0","0","0","0","0","0","0","0","0","4","0","4","0","0","0","0","0","0","0","0","0","-2"
"165884","Benjamin Franklin Institute of Technology","2012","Not on tenure track/No tenure system system total","32","23","9","0","0","0","1","1","0","1","0","1","0","0","0","0","0","0","30","22","8","0","0","0","0","0","0","0","0","0","-2"
"165884","Benjamin Franklin Institute of Technology","2012","Not on tenure/no tenure system, professors","3","2","1","0","0","0","0","0","0","0","0","0","0","0","0","0","0","0","3","2","1","0","0","0","0","0","0","0","0","0","-2"
"165884","Benjamin Franklin Institute of Technology","2012","Not on tenure/no tenure system, associate professors","5","3","2","0","0","0","0","0","0","0","0","0","0","0","0","0","0","0","5","3","2","0","0","0","0","0","0","0","0","0","-2"
"165884","Benjamin Franklin Institute of Technology","2012","Not on tenure/no tenure system, assistant professors","15","13","2","0","0","0","1","1","0","0","0","0","0","0","0","0","0","0","14","12","2","0","0","0","0","0","0","0","0","0","-2"
"165884","Benjamin Franklin Institute of Technology","2012","Not on tenure/no tenure system, instructors","9","5","4","0","0","0","0","0","0","1","0","1","0","0","0","0","0","0","8","5","3","0","0","0","0","0","0","0","0","0","-2"
"182005","College of Southern Nevada","2012","Tenured total","314","183","131","2","1","1","22","12","10","13","6","7","19","8","11","0","0","0","253","151","102","3","3","0","0","0","0","2","2","0","-2"
"182005","College of Southern Nevada","2012","Tenured, professors","314","183","131","2","1","1","22","12","10","13","6","7","19","8","11","0","0","0","253","151","102","3","3","0","0","0","0","2","2","0","-2"
"182005","College of Southern Nevada","2012","On-Tenure track total","102","48","54","1","1","0","10","4","6","8","3","5","6","3","3","0","0","0","75","36","39","0","0","0","0","0","0","2","1","1","-2"
"182005","College of Southern Nevada","2012","On-tenure track, instructors","102","48","54","1","1","0","10","4","6","8","3","5","6","3","3","0","0","0","75","36","39","0","0","0","0","0","0","2","1","1","-2"
"182005","College of Southern Nevada","2012","Not on tenure track/No tenure system system total","67","32","35","0","0","0","6","4","2","4","0","4","5","5","0","0","0","0","51","22","29","1","1","0","0","0","0","0","0","0","-2"
"182005","College of Southern Nevada","2012","Not on tenure/no tenure system, instructors","67","32","35","0","0","0","6","4","2","4","0","4","5","5","0","0","0","0","51","22","29","1","1","0","0","0","0","0","0","0","-2"
"182500","Truckee Meadows Community College","2012","Tenured total","120","64","56","2","1","1","4","0","4","0","0","0","5","3","2","0","0","0","107","59","48","2","1","1","0","0","0","0","0","0","-2"
"182500","Truckee Meadows Community College","2012","Tenured, professors","120","64","56","2","1","1","4","0","4","0","0","0","5","3","2","0","0","0","107","59","48","2","1","1","0","0","0","0","0","0","-2"
"182500","Truckee Meadows Community College","2012","On-Tenure track total","11","3","8","0","0","0","1","0","1","1","0","1","0","0","0","0","0","0","9","3","6","0","0","0","0","0","0","0","0","0","-2"
"182500","Truckee Meadows Community College","2012","On-tenure track, instructors","11","3","8","0","0","0","1","0","1","1","0","1","0","0","0","0","0","0","9","3","6","0","0","0","0","0","0","0","0","0","-2"
"182500","Truckee Meadows Community College","2012","Not on tenure track/No tenure system system total","35","14","21","0","0","0","2","1","1","0","0","0","2","1","1","0","0","0","31","12","19","0","0","0","0","0","0","0","0","0","-2"
"182500","Truckee Meadows Community College","2012","Not on tenure/no tenure system, instructors","35","14","21","0","0","0","2","1","1","0","0","0","2","1","1","0","0","0","31","12","19","0","0","0","0","0","0","0","0","0","-2"
"185129","New Jersey City University","2012","Tenured total","202","103","99","0","0","0","20","9","11","34","13","21","20","7","13","0","0","0","128","74","54","0","0","0","0","0","0","0","0","0","-2"
"185129","New Jersey City University","2012","Tenured, professors","85","45","40","0","0","0","9","4","5","12","4","8","8","3","5","0","0","0","56","34","22","0","0","0","0","0","0","0","0","0","-2"
"185129","New Jersey City University","2012","Tenured, associate professors","76","39","37","0","0","0","10","5","5","13","5","8","7","4","3","0","0","0","46","25","21","0","0","0","0","0","0","0","0","0","-2"
"185129","New Jersey City University","2012","Tenured, assistant professors","41","19","22","0","0","0","1","0","1","9","4","5","5","0","5","0","0","0","26","15","11","0","0","0","0","0","0","0","0","0","-2"
"185129","New Jersey City University","2012","On-Tenure track total","35","13","22","0","0","0","2","0","2","3","1","2","2","1","1","0","0","0","28","11","17","0","0","0","0","0","0","0","0","0","-2"
"185129","New Jersey City University","2012","On-tenure track, associate professors","5","1","4","0","0","0","0","0","0","0","0","0","0","0","0","0","0","0","5","1","4","0","0","0","0","0","0","0","0","0","-2"
"185129","New Jersey City University","2012","On-tenure track, assistant professors","29","12","17","0","0","0","2","0","2","3","1","2","2","1","1","0","0","0","22","10","12","0","0","0","0","0","0","0","0","0","-2"
"185129","New Jersey City University","2012","On-tenure track, instructors","1","0","1","0","0","0","0","0","0","0","0","0","0","0","0","0","0","0","1","0","1","0","0","0","0","0","0","0","0","0","-2"
"185129","New Jersey City University","2012","Not on tenure track/No tenure system system total","3","2","1","0","0","0","0","0","0","0","0","0","0","0","0","0","0","0","2","1","1","0","0","0","1","1","0","0","0","0","-2"
"185129","New Jersey City University","2012","Not on tenure/no tenure system, assistant professors","1","0","1","0","0","0","0","0","0","0","0","0","0","0","0","0","0","0","1","0","1","0","0","0","0","0","0","0","0","0","-2"
"185129","New Jersey City University","2012","Not on tenure/no tenure system, instructors","2","2","0","0","0","0","0","0","0","0","0","0","0","0","0","0","0","0","1","1","0","0","0","0","1","1","0","0","0","0","-2"
"185590","Montclair State University","2012","Tenured total","411","220","191","0","0","0","53","34","19","32","13","19","28","15","13","0","0","0","288","150","138","5","5","0","2","1","1","3","2","1","-2"
"185590","Montclair State University","2012","Tenured, professors","175","105","70","0","0","0","25","19","6","11","6","5","9","5","4","0","0","0","127","72","55","2","2","0","1","1","0","0","0","0","-2"
"185590","Montclair State University","2012","Tenured, associate professors","202","104","98","0","0","0","26","14","12","13","7","6","17","9","8","0","0","0","140","70","70","3","3","0","1","0","1","2","1","1","-2"
"185590","Montclair State University","2012","Tenured, assistant professors","34","11","23","0","0","0","2","1","1","8","0","8","2","1","1","0","0","0","21","8","13","0","0","0","0","0","0","1","1","0","-2"
"185590","Montclair State University","2012","On-Tenure track total","123","61","62","0","0","0","13","4","9","9","5","4","4","1","3","0","0","0","70","38","32","2","1","1","9","5","4","16","7","9","-2"
"185590","Montclair State University","2012","On-tenure track, professors","7","4","3","0","0","0","0","0","0","0","0","0","1","0","1","0","0","0","5","3","2","1","1","0","0","0","0","0","0","0","-2"
"185590","Montclair State University","2012","On-tenure track, associate professors","13","9","4","0","0","0","0","0","0","1","1","0","0","0","0","0","0","0","10","6","4","0","0","0","1","1","0","1","1","0","-2"
"185590","Montclair State University","2012","On-tenure track, assistant professors","103","48","55","0","0","0","13","4","9","8","4","4","3","1","2","0","0","0","55","29","26","1","0","1","8","4","4","15","6","9","-2"
"185590","Montclair State University","2012","Not on tenure track/No tenure system system total","45","16","29","0","0","0","2","1","1","1","0","1","4","1","3","0","0","0","33","14","19","0","0","0","4","0","4","1","0","1","-2"
"185590","Montclair State University","2012","Not on tenure/no tenure system, associate professors","3","2","1","0","0","0","0","0","0","0","0","0","0","0","0","0","0","0","3","2","1","0","0","0","0","0","0","0","0","0","-2"
"185590","Montclair State University","2012","Not on tenure/no tenure system, assistant professors","28","11","17","0","0","0","2","1","1","1","0","1","2","0","2","0","0","0","19","10","9","0","0","0","3","0","3","1","0","1","-2"
"185590","Montclair State University","2012","Not on tenure/no tenure system, instructors","14","3","11","0","0","0","0","0","0","0","0","0","2","1","1","0","0","0","11","2","9","0","0","0","1","0","1","0","0","0","-2"
"186399","Rutgers University-Newark","2012","Tenured total","227","158","69","0","0","0","20","16","4","17","11","6","6","5","1","0","0","0","170","117","53","0","0","0","3","1","2","11","8","3","-2"
"186399","Rutgers University-Newark","2012","Tenured, professors","143","104","39","0","0","0","14","13","1","7","6","1","4","3","1","0","0","0","113","80","33","0","0","0","2","1","1","3","1","2","-2"
"186399","Rutgers University-Newark","2012","Tenured, associate professors","84","54","30","0","0","0","6","3","3","10","5","5","2","2","0","0","0","0","57","37","20","0","0","0","1","0","1","8","7","1","-2"
"186399","Rutgers University-Newark","2012","On-Tenure track total","132","78","54","1","0","1","14","9","5","10","3","7","5","4","1","0","0","0","36","22","14","1","1","0","38","21","17","27","18","9","-2"
"186399","Rutgers University-Newark","2012","On-tenure track, professors","2","1","1","0","0","0","1","0","1","0","0","0","0","0","0","0","0","0","1","1","0","0","0","0","0","0","0","0","0","0","-2"
"186399","Rutgers University-Newark","2012","On-tenure track, associate professors","15","9","6","0","0","0","2","2","0","2","1","1","1","1","0","0","0","0","6","3","3","0","0","0","3","2","1","1","0","1","-2"
"186399","Rutgers University-Newark","2012","On-tenure track, assistant professors","114","68","46","1","0","1","11","7","4","8","2","6","4","3","1","0","0","0","29","18","11","1","1","0","34","19","15","26","18","8","-2"
"186399","Rutgers University-Newark","2012","On-tenure track, instructors","1","0","1","0","0","0","0","0","0","0","0","0","0","0","0","0","0","0","0","0","0","0","0","0","1","0","1","0","0","0","-2"
"186399","Rutgers University-Newark","2012","Not on tenure track/No tenure system system total","112","58","54","0","0","0","6","4","2","9","6","3","2","2","0","0","0","0","57","32","25","2","1","1","31","10","21","5","3","2","-2"
"186399","Rutgers University-Newark","2012","Not on tenure/no tenure system, professors","15","7","8","0","0","0","2","1","1","2","1","1","1","1","0","0","0","0","8","3","5","0","0","0","2","1","1","0","0","0","-2"
"186399","Rutgers University-Newark","2012","Not on tenure/no tenure system, associate professors","5","2","3","0","0","0","0","0","0","1","1","0","0","0","0","0","0","0","3","1","2","0","0","0","1","0","1","0","0","0","-2"
"186399","Rutgers University-Newark","2012","Not on tenure/no tenure system, assistant professors","25","9","16","0","0","0","1","1","0","1","0","1","0","0","0","0","0","0","8","4","4","1","0","1","12","3","9","2","1","1","-2"
"186399","Rutgers University-Newark","2012","Not on tenure/no tenure system, instructors","62","38","24","0","0","0","2","2","0","5","4","1","1","1","0","0","0","0","36","23","13","1","1","0","14","5","9","3","2","1","-2"
"186399","Rutgers University-Newark","2012","Not on tenure/no tenure system, lecturers","5","2","3","0","0","0","1","0","1","0","0","0","0","0","0","0","0","0","2","1","1","0","0","0","2","1","1","0","0","0","-2"
"187648","Eastern New Mexico University-Main Campus","2012","Tenured total","76","40","36","0","0","0","4","3","1","0","0","0","5","3","2","0","0","0","61","32","29","2","0","2","0","0","0","4","2","2","-2"
"187648","Eastern New Mexico University-Main Campus","2012","Tenured, professors","32","19","13","0","0","0","3","3","0","0","0","0","3","2","1","0","0","0","24","14","10","2","0","2","0","0","0","0","0","0","-2"
"187648","Eastern New Mexico University-Main Campus","2012","Tenured, associate professors","38","17","21","0","0","0","1","0","1","0","0","0","2","1","1","0","0","0","31","14","17","0","0","0","0","0","0","4","2","2","-2"
"187648","Eastern New Mexico University-Main Campus","2012","Tenured, assistant professors","3","2","1","0","0","0","0","0","0","0","0","0","0","0","0","0","0","0","3","2","1","0","0","0","0","0","0","0","0","0","-2"
"187648","Eastern New Mexico University-Main Campus","2012","Tenured, instructors","3","2","1","0","0","0","0","0","0","0","0","0","0","0","0","0","0","0","3","2","1","0","0","0","0","0","0","0","0","0","-2"
"187648","Eastern New Mexico University-Main Campus","2012","On-Tenure track total","45","26","19","0","0","0","1","0","1","1","0","1","2","2","0","0","0","0","36","20","16","1","1","0","1","0","1","3","3","0","-2"
"187648","Eastern New Mexico University-Main Campus","2012","On-tenure track, associate professors","1","1","0","0","0","0","0","0","0","0","0","0","0","0","0","0","0","0","1","1","0","0","0","0","0","0","0","0","0","0","-2"
"187648","Eastern New Mexico University-Main Campus","2012","On-tenure track, assistant professors","38","23","15","0","0","0","1","0","1","1","0","1","2","2","0","0","0","0","29","17","12","1","1","0","1","0","1","3","3","0","-2"
"187648","Eastern New Mexico University-Main Campus","2012","On-tenure track, instructors","6","2","4","0","0","0","0","0","0","0","0","0","0","0","0","0","0","0","6","2","4","0","0","0","0","0","0","0","0","0","-2"
"187648","Eastern New Mexico University-Main Campus","2012","Not on tenure track/No tenure system system total","30","8","22","0","0","0","0","0","0","1","0","1","1","0","1","0","0","0","27","8","19","0","0","0","1","0","1","0","0","0","-2"
"187648","Eastern New Mexico University-Main Campus","2012","Not on tenure/no tenure system, assistant professors","3","1","2","0","0","0","0","0","0","0","0","0","0","0","0","0","0","0","3","1","2","0","0","0","0","0","0","0","0","0","-2"
"187648","Eastern New Mexico University-Main Campus","2012","Not on tenure/no tenure system, instructors","26","6","20","0","0","0","0","0","0","1","0","1","1","0","1","0","0","0","23","6","17","0","0","0","1","0","1","0","0","0","-2"
"187648","Eastern New Mexico University-Main Campus","2012","Not on tenure/no tenure system, lecturers","1","1","0","0","0","0","0","0","0","0","0","0","0","0","0","0","0","0","1","1","0","0","0","0","0","0","0","0","0","0","-2"
"187985","University of New Mexico-Main Campus","2012","Tenured total","568","345","223","16","5","11","43","32","11","7","3","4","67","31","36","0","0","0","425","267","158","1","1","0","8","5","3","1","1","0","-2"
"187985","University of New Mexico-Main Campus","2012","Tenured, professors","293","198","95","6","3","3","23","18","5","3","2","1","28","14","14","0","0","0","230","158","72","0","0","0","3","3","0","0","0","0","-2"
"187985","University of New Mexico-Main Campus","2012","Tenured, associate professors","267","142","125","10","2","8","19","13","6","3","1","2","38","17","21","0","0","0","191","106","85","1","1","0","4","1","3","1","1","0","-2"
"187985","University of New Mexico-Main Campus","2012","Tenured, assistant professors","8","5","3","0","0","0","1","1","0","1","0","1","1","0","1","0","0","0","4","3","1","0","0","0","1","1","0","0","0","0","-2"
"187985","University of New Mexico-Main Campus","2012","On-Tenure track total","230","118","112","8","3","5","19","11","8","8","4","4","22","10","12","0","0","0","131","64","67","2","0","2","11","5","6","29","21","8","-2"
"187985","University of New Mexico-Main Campus","2012","On-tenure track, professors","1","0","1","0","0","0","0","0","0","0","0","0","0","0","0","0","0","0","1","0","1","0","0","0","0","0","0","0","0","0","-2"
"187985","University of New Mexico-Main Campus","2012","On-tenure track, associate professors","7","4","3","1","0","1","1","1","0","0","0","0","1","0","1","0","0","0","4","3","1","0","0","0","0","0","0","0","0","0","-2"
"187985","University of New Mexico-Main Campus","2012","On-tenure track, assistant professors","222","114","108","7","3","4","18","10","8","8","4","4","21","10","11","0","0","0","126","61","65","2","0","2","11","5","6","29","21","8","-2"
"187985","University of New Mexico-Main Campus","2012","Not on tenure track/No tenure system system total","216","86","130","7","2","5","4","1","3","6","4","2","30","14","16","0","0","0","154","60","94","2","1","1","7","2","5","6","2","4","-2"
"187985","University of New Mexico-Main Campus","2012","Not on tenure/no tenure system, professors","6","4","2","0","0","0","0","0","0","0","0","0","1","1","0","0","0","0","4","2","2","0","0","0","0","0","0","1","1","0","-2"
"187985","University of New Mexico-Main Campus","2012","Not on tenure/no tenure system, associate professors","10","0","10","0","0","0","0","0","0","0","0","0","1","0","1","0","0","0","7","0","7","0","0","0","2","0","2","0","0","0","-2"
"187985","University of New Mexico-Main Campus","2012","Not on tenure/no tenure system, assistant professors","40","16","24","2","0","2","2","0","2","1","0","1","5","4","1","0","0","0","24","10","14","2","1","1","1","0","1","3","1","2","-2"
"187985","University of New Mexico-Main Campus","2012","Not on tenure/no tenure system, instructors","12","4","8","1","1","0","0","0","0","0","0","0","2","0","2","0","0","0","9","3","6","0","0","0","0","0","0","0","0","0","-2"
"187985","University of New Mexico-Main Campus","2012","Not on tenure/no tenure system, lecturers","148","62","86","4","1","3","2","1","1","5","4","1","21","9","12","0","0","0","110","45","65","0","0","0","4","2","2","2","0","2","-2"
"188030","New Mexico State University-Main Campus","2012","Tenured total","405","267","138","5","3","2","38","30","8","6","4","2","42","27","15","0","0","0","297","188","109","3","2","1","7","6","1","7","7","0","-2"
"188030","New Mexico State University-Main Campus","2012","Tenured, professors","195","146","49","1","1","0","18","15","3","2","2","0","13","11","2","0","0","0","155","112","43","0","0","0","5","4","1","1","1","0","-2"
"188030","New Mexico State University-Main Campus","2012","Tenured, associate professors","202","116","86","4","2","2","19","14","5","4","2","2","29","16","13","0","0","0","136","73","63","3","2","1","1","1","0","6","6","0","-2"
"188030","New Mexico State University-Main Campus","2012","Tenured, assistant professors","8","5","3","0","0","0","1","1","0","0","0","0","0","0","0","0","0","0","6","3","3","0","0","0","1","1","0","0","0","0","-2"
"188030","New Mexico State University-Main Campus","2012","On-Tenure track total","160","74","86","1","1","0","16","7","9","2","1","1","27","9","18","0","0","0","77","34","43","1","0","1","15","9","6","21","13","8","-2"
"188030","New Mexico State University-Main Campus","2012","On-tenure track, associate professors","6","4","2","0","0","0","0","0","0","0","0","0","1","0","1","0","0","0","4","3","1","0","0","0","1","1","0","0","0","0","-2"
"188030","New Mexico State University-Main Campus","2012","On-tenure track, assistant professors","153","70","83","1","1","0","16","7","9","2","1","1","26","9","17","0","0","0","73","31","42","0","0","0","14","8","6","21","13","8","-2"
"188030","New Mexico State University-Main Campus","2012","On-tenure track, instructors","1","0","1","0","0","0","0","0","0","0","0","0","0","0","0","0","0","0","0","0","0","1","0","1","0","0","0","0","0","0","-2"
"188030","New Mexico State University-Main Campus","2012","Not on tenure track/No tenure system system total","96","31","65","1","1","0","3","2","1","1","0","1","18","3","15","0","0","0","66","24","42","2","1","1","5","0","5","0","0","0","-2"
"188030","New Mexico State University-Main Campus","2012","Not on tenure/no tenure system, professors","13","6","7","0","0","0","0","0","0","0","0","0","1","1","0","0","0","0","12","5","7","0","0","0","0","0","0","0","0","0","-2"
"188030","New Mexico State University-Main Campus","2012","Not on tenure/no tenure system, associate professors","25","6","19","0","0","0","0","0","0","1","0","1","4","1","3","0","0","0","19","5","14","0","0","0","1","0","1","0","0","0","-2"
"188030","New Mexico State University-Main Campus","2012","Not on tenure/no tenure system, assistant professors","46","15","31","1","1","0","2","1","1","0","0","0","10","1","9","0","0","0","28","11","17","2","1","1","3","0","3","0","0","0","-2"
"188030","New Mexico State University-Main Campus","2012","Not on tenure/no tenure system, instructors","12","4","8","0","0","0","1","1","0","0","0","0","3","0","3","0","0","0","7","3","4","0","0","0","1","0","1","0","0","0","-2"
"188304","Western New Mexico University","2012","Tenured total","50","21","29","0","0","0","0","0","0","0","0","0","6","3","3","0","0","0","38","15","23","0","0","0","6","3","3","0","0","0","-2"
"188304","Western New Mexico University","2012","Tenured, professors","35","14","21","0","0","0","0","0","0","0","0","0","3","1","2","0","0","0","26","10","16","0","0","0","6","3","3","0","0","0","-2"
"188304","Western New Mexico University","2012","Tenured, associate professors","15","7","8","0","0","0","0","0","0","0","0","0","3","2","1","0","0","0","12","5","7","0","0","0","0","0","0","0","0","0","-2"
"188304","Western New Mexico University","2012","On-Tenure track total","39","19","20","0","0","0","3","3","0","0","0","0","7","5","2","0","0","0","21","7","14","0","0","0","8","4","4","0","0","0","-2"
"188304","Western New Mexico University","2012","On-tenure track, associate professors","4","3","1","0","0","0","0","0","0","0","0","0","0","0","0","0","0","0","2","1","1","0","0","0","2","2","0","0","0","0","-2"
"188304","Western New Mexico University","2012","On-tenure track, assistant professors","35","16","19","0","0","0","3","3","0","0","0","0","7","5","2","0","0","0","19","6","13","0","0","0","6","2","4","0","0","0","-2"
"188304","Western New Mexico University","2012","Not on tenure track/No tenure system system total","13","5","8","0","0","0","0","0","0","0","0","0","2","0","2","0","0","0","11","5","6","0","0","0","0","0","0","0","0","0","-2"
"188304","Western New Mexico University","2012","Not on tenure/no tenure system, professors","1","1","0","0","0","0","0","0","0","0","0","0","0","0","0","0","0","0","1","1","0","0","0","0","0","0","0","0","0","0","-2"
"188304","Western New Mexico University","2012","Not on tenure/no tenure system, associate professors","1","1","0","0","0","0","0","0","0","0","0","0","0","0","0","0","0","0","1","1","0","0","0","0","0","0","0","0","0","0","-2"
"188304","Western New Mexico University","2012","Not on tenure/no tenure system, assistant professors","10","3","7","0","0","0","0","0","0","0","0","0","2","0","2","0","0","0","8","3","5","0","0","0","0","0","0","0","0","0","-2"
"188304","Western New Mexico University","2012","Not on tenure/no tenure system, instructors","1","0","1","0","0","0","0","0","0","0","0","0","0","0","0","0","0","0","1","0","1","0","0","0","0","0","0","0","0","0","-2"
"189413","Boricua College","2012","Not on tenure track/No tenure system system total","57","25","32","0","0","0","0","0","0","3","2","1","51","23","28","0","0","0","3","0","3","0","0","0","0","0","0","0","0","0","-2"
"189413","Boricua College","2012","Not on tenure/no tenure system, professors","6","3","3","0","0","0","0","0","0","1","1","0","5","2","3","0","0","0","0","0","0","0","0","0","0","0","0","0","0","0","-2"
"189413","Boricua College","2012","Not on tenure/no tenure system, associate professors","8","5","3","0","0","0","0","0","0","0","0","0","7","5","2","0","0","0","1","0","1","0","0","0","0","0","0","0","0","0","-2"
"189413","Boricua College","2012","Not on tenure/no tenure system, assistant professors","17","7","10","0","0","0","0","0","0","0","0","0","16","7","9","0","0","0","1","0","1","0","0","0","0","0","0","0","0","0","-2"
"189413","Boricua College","2012","Not on tenure/no tenure system, instructors","25","10","15","0","0","0","0","0","0","2","1","1","22","9","13","0","0","0","1","0","1","0","0","0","0","0","0","0","0","0","-2"
"189413","Boricua College","2012","Not on tenure/no tenure system, lecturers","1","0","1","0","0","0","0","0","0","0","0","0","1","0","1","0","0","0","0","0","0","0","0","0","0","0","0","0","0","0","-2"
"190558","College of Staten Island CUNY","2012","Tenured total","240","139","101","1","1","0","35","20","15","6","4","2","13","8","5","0","0","0","185","106","79","0","0","0","0","0","0","0","0","0","-2"
"190558","College of Staten Island CUNY","2012","Tenured, professors","97","65","32","0","0","0","12","8","4","2","1","1","6","5","1","0","0","0","77","51","26","0","0","0","0","0","0","0","0","0","-2"
"190558","College of Staten Island CUNY","2012","Tenured, associate professors","115","60","55","1","1","0","21","12","9","3","2","1","6","3","3","0","0","0","84","42","42","0","0","0","0","0","0","0","0","0","-2"
"190558","College of Staten Island CUNY","2012","Tenured, assistant professors","20","11","9","0","0","0","1","0","1","1","1","0","0","0","0","0","0","0","18","10","8","0","0","0","0","0","0","0","0","0","-2"
"190558","College of Staten Island CUNY","2012","Tenured, lecturers","8","3","5","0","0","0","1","0","1","0","0","0","1","0","1","0","0","0","6","3","3","0","0","0","0","0","0","0","0","0","-2"
"190558","College of Staten Island CUNY","2012","On-Tenure track total","111","50","61","0","0","0","11","5","6","7","3","4","6","3","3","0","0","0","84","38","46","1","0","1","0","0","0","2","1","1","-2"
"190558","College of Staten Island CUNY","2012","On-tenure track, associate professors","11","8","3","0","0","0","3","2","1","1","1","0","1","1","0","0","0","0","5","4","1","1","0","1","0","0","0","0","0","0","-2"
"190558","College of Staten Island CUNY","2012","On-tenure track, assistant professors","82","35","47","0","0","0","8","3","5","6","2","4","4","2","2","0","0","0","63","28","35","0","0","0","0","0","0","1","0","1","-2"
"190558","College of Staten Island CUNY","2012","On-tenure track, lecturers","18","7","11","0","0","0","0","0","0","0","0","0","1","0","1","0","0","0","16","6","10","0","0","0","0","0","0","1","1","0","-2"
"190558","College of Staten Island CUNY","2012","Not on tenure track/No tenure system system total","11","3","8","0","0","0","3","0","3","1","0","1","1","1","0","0","0","0","5","2","3","0","0","0","0","0","0","1","0","1","-2"
"190558","College of Staten Island CUNY","2012","Not on tenure/no tenure system, lecturers","11","3","8","0","0","0","3","0","3","1","0","1","1","1","0","0","0","0","5","2","3","0","0","0","0","0","0","1","0","1","-2"
"190594","CUNY Hunter College","2012","Tenured total","477","242","235","0","0","0","39","18","21","48","22","26","50","20","30","0","0","0","339","182","157","0","0","0","0","0","0","1","0","1","-2"
"190594","CUNY Hunter College","2012","Tenured, professors","234","128","106","0","0","0","11","7","4","17","10","7","18","10","8","0","0","0","187","101","86","0","0","0","0","0","0","1","0","1","-2"
"190594","CUNY Hunter College","2012","Tenured, associate professors","202","95","107","0","0","0","23","10","13","21","9","12","27","8","19","0","0","0","131","68","63","0","0","0","0","0","0","0","0","0","-2"
"190594","CUNY Hunter College","2012","Tenured, assistant professors","22","11","11","0","0","0","4","1","3","5","2","3","2","2","0","0","0","0","11","6","5","0","0","0","0","0","0","0","0","0","-2"
"190594","CUNY Hunter College","2012","Tenured, lecturers","19","8","11","0","0","0","1","0","1","5","1","4","3","0","3","0","0","0","10","7","3","0","0","0","0","0","0","0","0","0","-2"
"190594","CUNY Hunter College","2012","On-Tenure track total","167","79","88","0","0","0","20","9","11","10","5","5","15","9","6","0","0","0","106","51","55","0","0","0","0","0","0","16","5","11","-2"
"190594","CUNY Hunter College","2012","On-tenure track, professors","9","5","4","0","0","0","1","1","0","0","0","0","0","0","0","0","0","0","8","4","4","0","0","0","0","0","0","0","0","0","-2"
"190594","CUNY Hunter College","2012","On-tenure track, associate professors","23","15","8","0","0","0","6","4","2","1","0","1","3","2","1","0","0","0","12","9","3","0","0","0","0","0","0","1","0","1","-2"
"190594","CUNY Hunter College","2012","On-tenure track, assistant professors","116","52","64","0","0","0","12","4","8","9","5","4","10","6","4","0","0","0","74","32","42","0","0","0","0","0","0","11","5","6","-2"
"190594","CUNY Hunter College","2012","On-tenure track, lecturers","19","7","12","0","0","0","1","0","1","0","0","0","2","1","1","0","0","0","12","6","6","0","0","0","0","0","0","4","0","4","-2"
"190594","CUNY Hunter College","2012","Not on tenure track/No tenure system system total","69","37","32","0","0","0","4","3","1","3","1","2","3","3","0","0","0","0","57","29","28","0","0","0","0","0","0","2","1","1","-2"
"190594","CUNY Hunter College","2012","Not on tenure/no tenure system, professors","34","17","17","0","0","0","2","1","1","1","0","1","1","1","0","0","0","0","30","15","15","0","0","0","0","0","0","0","0","0","-2"
"190594","CUNY Hunter College","2012","Not on tenure/no tenure system, associate professors","7","3","4","0","0","0","0","0","0","0","0","0","2","2","0","0","0","0","5","1","4","0","0","0","0","0","0","0","0","0","-2"
"190594","CUNY Hunter College","2012","Not on tenure/no tenure system, assistant professors","12","6","6","0","0","0","0","0","0","0","0","0","0","0","0","0","0","0","12","6","6","0","0","0","0","0","0","0","0","0","-2"
"190594","CUNY Hunter College","2012","Not on tenure/no tenure system, instructors","3","2","1","0","0","0","0","0","0","0","0","0","0","0","0","0","0","0","3","2","1","0","0","0","0","0","0","0","0","0","-2"
"190594","CUNY Hunter College","2012","Not on tenure/no tenure system, lecturers","13","9","4","0","0","0","2","2","0","2","1","1","0","0","0","0","0","0","7","5","2","0","0","0","0","0","0","2","1","1","-2"
"190600","CUNY John Jay College of Criminal Justice","2012","Tenured total","243","136","107","0","0","0","17","5","12","28","15","13","21","9","12","0","0","0","172","105","67","0","0","0","0","0","0","5","2","3","-2"
"190600","CUNY John Jay College of Criminal Justice","2012","Tenured, professors","86","57","29","0","0","0","4","2","2","8","4","4","4","2","2","0","0","0","70","49","21","0","0","0","0","0","0","0","0","0","-2"
"190600","CUNY John Jay College of Criminal Justice","2012","Tenured, associate professors","115","62","53","0","0","0","8","2","6","12","7","5","11","4","7","0","0","0","80","48","32","0","0","0","0","0","0","4","1","3","-2"
"190600","CUNY John Jay College of Criminal Justice","2012","Tenured, assistant professors","29","9","20","0","0","0","4","1","3","6","2","4","3","2","1","0","0","0","16","4","12","0","0","0","0","0","0","0","0","0","-2"
"190600","CUNY John Jay College of Criminal Justice","2012","Tenured, lecturers","13","8","5","0","0","0","1","0","1","2","2","0","3","1","2","0","0","0","6","4","2","0","0","0","0","0","0","1","1","0","-2"
"190600","CUNY John Jay College of Criminal Justice","2012","On-Tenure track total","130","65","65","0","0","0","10","4","6","18","11","7","16","7","9","3","1","2","75","40","35","0","0","0","0","0","0","8","2","6","-2"
"190600","CUNY John Jay College of Criminal Justice","2012","On-tenure track, associate professors","25","12","13","0","0","0","3","2","1","4","2","2","3","2","1","0","0","0","13","5","8","0","0","0","0","0","0","2","1","1","-2"
"190600","CUNY John Jay College of Criminal Justice","2012","On-tenure track, assistant professors","91","48","43","0","0","0","6","2","4","11","8","3","13","5","8","2","1","1","53","31","22","0","0","0","0","0","0","6","1","5","-2"
"190600","CUNY John Jay College of Criminal Justice","2012","On-tenure track, lecturers","14","5","9","0","0","0","1","0","1","3","1","2","0","0","0","1","0","1","9","4","5","0","0","0","0","0","0","0","0","0","-2"
"190600","CUNY John Jay College of Criminal Justice","2012","Not on tenure track/No tenure system system total","31","19","12","0","0","0","0","0","0","0","0","0","4","3","1","1","0","1","25","16","9","1","0","1","0","0","0","0","0","0","-2"
"190600","CUNY John Jay College of Criminal Justice","2012","Not on tenure/no tenure system, professors","5","4","1","0","0","0","0","0","0","0","0","0","0","0","0","0","0","0","5","4","1","0","0","0","0","0","0","0","0","0","-2"
"190600","CUNY John Jay College of Criminal Justice","2012","Not on tenure/no tenure system, associate professors","4","4","0","0","0","0","0","0","0","0","0","0","0","0","0","0","0","0","4","4","0","0","0","0","0","0","0","0","0","0","-2"
"190600","CUNY John Jay College of Criminal Justice","2012","Not on tenure/no tenure system, assistant professors","10","4","6","0","0","0","0","0","0","0","0","0","2","1","1","0","0","0","8","3","5","0","0","0","0","0","0","0","0","0","-2"
"190600","CUNY John Jay College of Criminal Justice","2012","Not on tenure/no tenure system, instructors","3","1","2","0","0","0","0","0","0","0","0","0","0","0","0","0","0","0","3","1","2","0","0","0","0","0","0","0","0","0","-2"
"190600","CUNY John Jay College of Criminal Justice","2012","Not on tenure/no tenure system, lecturers","9","6","3","0","0","0","0","0","0","0","0","0","2","2","0","1","0","1","5","4","1","1","0","1","0","0","0","0","0","0","-2"
"190637","CUNY Lehman College","2012","Tenured total","228","119","109","1","0","1","10","7","3","16","8","8","32","16","16","0","0","0","166","87","79","0","0","0","0","0","0","3","1","2","-2"
"190637","CUNY Lehman College","2012","Tenured, professors","94","64","30","1","0","1","1","0","1","2","1","1","11","9","2","0","0","0","79","54","25","0","0","0","0","0","0","0","0","0","-2"
"190637","CUNY Lehman College","2012","Tenured, associate professors","83","35","48","0","0","0","6","4","2","3","3","0","14","3","11","0","0","0","58","24","34","0","0","0","0","0","0","2","1","1","-2"
"190637","CUNY Lehman College","2012","Tenured, assistant professors","26","9","17","0","0","0","3","3","0","7","2","5","2","1","1","0","0","0","14","3","11","0","0","0","0","0","0","0","0","0","-2"
"190637","CUNY Lehman College","2012","Tenured, lecturers","25","11","14","0","0","0","0","0","0","4","2","2","5","3","2","0","0","0","15","6","9","0","0","0","0","0","0","1","0","1","-2"
"190637","CUNY Lehman College","2012","On-Tenure track total","119","48","71","1","0","1","11","4","7","14","4","10","17","9","8","0","0","0","74","30","44","0","0","0","0","0","0","2","1","1","-2"
"190637","CUNY Lehman College","2012","On-tenure track, associate professors","13","6","7","0","0","0","1","1","0","0","0","0","3","2","1","0","0","0","9","3","6","0","0","0","0","0","0","0","0","0","-2"
"190637","CUNY Lehman College","2012","On-tenure track, assistant professors","84","33","51","1","0","1","10","3","7","11","3","8","11","5","6","0","0","0","49","21","28","0","0","0","0","0","0","2","1","1","-2"
"190637","CUNY Lehman College","2012","On-tenure track, lecturers","22","9","13","0","0","0","0","0","0","3","1","2","3","2","1","0","0","0","16","6","10","0","0","0","0","0","0","0","0","0","-2"
"190637","CUNY Lehman College","2012","Not on tenure track/No tenure system system total","32","16","16","0","0","0","1","0","1","4","2","2","6","3","3","0","0","0","21","11","10","0","0","0","0","0","0","0","0","0","-2"
"190637","CUNY Lehman College","2012","Not on tenure/no tenure system, professors","7","3","4","0","0","0","0","0","0","0","0","0","2","1","1","0","0","0","5","2","3","0","0","0","0","0","0","0","0","0","-2"
"190637","CUNY Lehman College","2012","Not on tenure/no tenure system, assistant professors","4","1","3","0","0","0","0","0","0","2","1","1","0","0","0","0","0","0","2","0","2","0","0","0","0","0","0","0","0","0","-2"
"190637","CUNY Lehman College","2012","Not on tenure/no tenure system, instructors","1","0","1","0","0","0","0","0","0","0","0","0","0","0","0","0","0","0","1","0","1","0","0","0","0","0","0","0","0","0","-2"
"190637","CUNY Lehman College","2012","Not on tenure/no tenure system, lecturers","20","12","8","0","0","0","1","0","1","2","1","1","4","2","2","0","0","0","13","9","4","0","0","0","0","0","0","0","0","0","-2"
"190655","CUNY New York City College of Technology","2012","Tenured total","229","129","100","1","1","0","29","13","16","34","19","15","12","7","5","0","0","0","151","87","64","0","0","0","0","0","0","2","2","0","-2"
"190655","CUNY New York City College of Technology","2012","Tenured, professors","61","37","24","0","0","0","5","0","5","5","3","2","5","3","2","0","0","0","46","31","15","0","0","0","0","0","0","0","0","0","-2"
"190655","CUNY New York City College of Technology","2012","Tenured, associate professors","89","47","42","0","0","0","13","6","7","13","7","6","4","2","2","0","0","0","57","30","27","0","0","0","0","0","0","2","2","0","-2"
"190655","CUNY New York City College of Technology","2012","Tenured, assistant professors","54","34","20","1","1","0","10","6","4","6","5","1","2","1","1","0","0","0","35","21","14","0","0","0","0","0","0","0","0","0","-2"
"190655","CUNY New York City College of Technology","2012","Tenured, lecturers","25","11","14","0","0","0","1","1","0","10","4","6","1","1","0","0","0","0","13","5","8","0","0","0","0","0","0","0","0","0","-2"
"190655","CUNY New York City College of Technology","2012","On-Tenure track total","174","83","91","1","0","1","22","13","9","18","7","11","15","6","9","1","1","0","102","45","57","0","0","0","0","0","0","15","11","4","-2"
"190655","CUNY New York City College of Technology","2012","On-tenure track, associate professors","16","7","9","0","0","0","0","0","0","1","0","1","0","0","0","0","0","0","13","5","8","0","0","0","0","0","0","2","2","0","-2"
"190655","CUNY New York City College of Technology","2012","On-tenure track, assistant professors","149","71","78","1","0","1","22","13","9","15","6","9","14","6","8","1","1","0","83","36","47","0","0","0","0","0","0","13","9","4","-2"
"190655","CUNY New York City College of Technology","2012","On-tenure track, instructors","1","0","1","0","0","0","0","0","0","0","0","0","1","0","1","0","0","0","0","0","0","0","0","0","0","0","0","0","0","0","-2"
"190655","CUNY New York City College of Technology","2012","On-tenure track, lecturers","8","5","3","0","0","0","0","0","0","2","1","1","0","0","0","0","0","0","6","4","2","0","0","0","0","0","0","0","0","0","-2"
"190655","CUNY New York City College of Technology","2012","Not on tenure track/No tenure system system total","14","6","8","0","0","0","1","0","1","2","1","1","3","2","1","0","0","0","7","3","4","0","0","0","0","0","0","1","0","1","-2"
"190655","CUNY New York City College of Technology","2012","Not on tenure/no tenure system, professors","1","0","1","0","0","0","0","0","0","0","0","0","0","0","0","0","0","0","1","0","1","0","0","0","0","0","0","0","0","0","-2"
"190655","CUNY New York City College of Technology","2012","Not on tenure/no tenure system, assistant professors","4","2","2","0","0","0","0","0","0","1","1","0","0","0","0","0","0","0","2","1","1","0","0","0","0","0","0","1","0","1","-2"
"190655","CUNY New York City College of Technology","2012","Not on tenure/no tenure system, instructors","5","2","3","0","0","0","1","0","1","0","0","0","0","0","0","0","0","0","4","2","2","0","0","0","0","0","0","0","0","0","-2"
"190655","CUNY New York City College of Technology","2012","Not on tenure/no tenure system, lecturers","4","2","2","0","0","0","0","0","0","1","0","1","3","2","1","0","0","0","0","0","0","0","0","0","0","0","0","0","0","0","-2"
"190664","CUNY Queens College","2012","Tenured total","411","246","165","1","0","1","41","19","22","19","12","7","23","11","12","0","0","0","319","202","117","1","1","0","0","0","0","7","1","6","-2"
"190664","CUNY Queens College","2012","Tenured, professors","206","143","63","0","0","0","16","8","8","10","6","4","8","5","3","0","0","0","172","124","48","0","0","0","0","0","0","0","0","0","-2"
"190664","CUNY Queens College","2012","Tenured, associate professors","141","72","69","0","0","0","20","10","10","6","4","2","11","2","9","0","0","0","98","54","44","1","1","0","0","0","0","5","1","4","-2"
"190664","CUNY Queens College","2012","Tenured, assistant professors","28","13","15","1","0","1","3","1","2","2","1","1","2","2","0","0","0","0","18","9","9","0","0","0","0","0","0","2","0","2","-2"
"190664","CUNY Queens College","2012","Tenured, lecturers","36","18","18","0","0","0","2","0","2","1","1","0","2","2","0","0","0","0","31","15","16","0","0","0","0","0","0","0","0","0","-2"
"190664","CUNY Queens College","2012","On-Tenure track total","172","75","97","0","0","0","18","8","10","13","4","9","8","4","4","1","1","0","106","49","57","0","0","0","0","0","0","26","9","17","-2"
"190664","CUNY Queens College","2012","On-tenure track, associate professors","5","1","4","0","0","0","1","1","0","1","0","1","0","0","0","0","0","0","3","0","3","0","0","0","0","0","0","0","0","0","-2"
"190664","CUNY Queens College","2012","On-tenure track, assistant professors","133","63","70","0","0","0","17","7","10","12","4","8","7","3","4","1","1","0","72","39","33","0","0","0","0","0","0","24","9","15","-2"
"190664","CUNY Queens College","2012","On-tenure track, lecturers","34","11","23","0","0","0","0","0","0","0","0","0","1","1","0","0","0","0","31","10","21","0","0","0","0","0","0","2","0","2","-2"
"190664","CUNY Queens College","2012","Not on tenure track/No tenure system system total","26","16","10","0","0","0","4","2","2","5","2","3","1","0","1","0","0","0","16","12","4","0","0","0","0","0","0","0","0","0","-2"
"190664","CUNY Queens College","2012","Not on tenure/no tenure system, professors","9","5","4","0","0","0","2","1","1","3","1","2","0","0","0","0","0","0","4","3","1","0","0","0","0","0","0","0","0","0","-2"
"190664","CUNY Queens College","2012","Not on tenure/no tenure system, associate professors","1","1","0","0","0","0","0","0","0","0","0","0","0","0","0","0","0","0","1","1","0","0","0","0","0","0","0","0","0","0","-2"
"190664","CUNY Queens College","2012","Not on tenure/no tenure system, assistant professors","7","4","3","0","0","0","0","0","0","2","1","1","0","0","0","0","0","0","5","3","2","0","0","0","0","0","0","0","0","0","-2"
"190664","CUNY Queens College","2012","Not on tenure/no tenure system, instructors","6","3","3","0","0","0","1","0","1","0","0","0","1","0","1","0","0","0","4","3","1","0","0","0","0","0","0","0","0","0","-2"
"190664","CUNY Queens College","2012","Not on tenure/no tenure system, lecturers","3","3","0","0","0","0","1","1","0","0","0","0","0","0","0","0","0","0","2","2","0","0","0","0","0","0","0","0","0","0","-2"
"190691","CUNY York College","2012","Tenured total","109","63","46","0","0","0","14","13","1","20","12","8","10","3","7","0","0","0","65","35","30","0","0","0","0","0","0","0","0","0","-2"
"190691","CUNY York College","2012","Tenured, professors","36","21","15","0","0","0","3","3","0","1","1","0","2","1","1","0","0","0","30","16","14","0","0","0","0","0","0","0","0","0","-2"
"190691","CUNY York College","2012","Tenured, associate professors","51","28","23","0","0","0","8","7","1","13","7","6","6","2","4","0","0","0","24","12","12","0","0","0","0","0","0","0","0","0","-2"
"190691","CUNY York College","2012","Tenured, assistant professors","12","9","3","0","0","0","3","3","0","3","2","1","1","0","1","0","0","0","5","4","1","0","0","0","0","0","0","0","0","0","-2"
"190691","CUNY York College","2012","Tenured, lecturers","10","5","5","0","0","0","0","0","0","3","2","1","1","0","1","0","0","0","6","3","3","0","0","0","0","0","0","0","0","0","-2"
"190691","CUNY York College","2012","On-Tenure track total","85","36","49","0","0","0","13","4","9","17","6","11","3","2","1","0","0","0","48","22","26","0","0","0","0","0","0","4","2","2","-2"
"190691","CUNY York College","2012","On-tenure track, professors","1","1","0","0","0","0","1","1","0","0","0","0","0","0","0","0","0","0","0","0","0","0","0","0","0","0","0","0","0","0","-2"
"190691","CUNY York College","2012","On-tenure track, associate professors","10","3","7","0","0","0","0","0","0","2","1","1","0","0","0","0","0","0","8","2","6","0","0","0","0","0","0","0","0","0","-2"
"190691","CUNY York College","2012","On-tenure track, assistant professors","58","25","33","0","0","0","10","2","8","9","3","6","3","2","1","0","0","0","32","16","16","0","0","0","0","0","0","4","2","2","-2"
"190691","CUNY York College","2012","On-tenure track, lecturers","16","7","9","0","0","0","2","1","1","6","2","4","0","0","0","0","0","0","8","4","4","0","0","0","0","0","0","0","0","0","-2"
"190691","CUNY York College","2012","Not on tenure track/No tenure system system total","7","4","3","0","0","0","1","1","0","3","1","2","0","0","0","0","0","0","3","2","1","0","0","0","0","0","0","0","0","0","-2"
"190691","CUNY York College","2012","Not on tenure/no tenure system, professors","3","2","1","0","0","0","0","0","0","2","1","1","0","0","0","0","0","0","1","1","0","0","0","0","0","0","0","0","0","0","-2"
"190691","CUNY York College","2012","Not on tenure/no tenure system, assistant professors","3","1","2","0","0","0","1","1","0","1","0","1","0","0","0","0","0","0","1","0","1","0","0","0","0","0","0","0","0","0","-2"
"190691","CUNY York College","2012","Not on tenure/no tenure system, lecturers","1","1","0","0","0","0","0","0","0","0","0","0","0","0","0","0","0","0","1","1","0","0","0","0","0","0","0","0","0","0","-2"
"193016","Mercy College","2012","Tenured total","43","23","20","0","0","0","9","5","4","3","2","1","0","0","0","0","0","0","31","16","15","0","0","0","0","0","0","0","0","0","-2"
"193016","Mercy College","2012","Tenured, professors","21","12","9","0","0","0","2","2","0","1","1","0","0","0","0","0","0","0","18","9","9","0","0","0","0","0","0","0","0","0","-2"
"193016","Mercy College","2012","Tenured, associate professors","17","8","9","0","0","0","4","2","2","2","1","1","0","0","0","0","0","0","11","5","6","0","0","0","0","0","0","0","0","0","-2"
"193016","Mercy College","2012","Tenured, assistant professors","5","3","2","0","0","0","3","1","2","0","0","0","0","0","0","0","0","0","2","2","0","0","0","0","0","0","0","0","0","0","-2"
"193016","Mercy College","2012","On-Tenure track total","41","7","34","0","0","0","5","0","5","2","0","2","3","1","2","0","0","0","29","6","23","0","0","0","2","0","2","0","0","0","-2"
"193016","Mercy College","2012","On-tenure track, associate professors","14","3","11","0","0","0","1","0","1","2","0","2","2","0","2","0","0","0","8","3","5","0","0","0","1","0","1","0","0","0","-2"
"193016","Mercy College","2012","On-tenure track, assistant professors","26","4","22","0","0","0","3","0","3","0","0","0","1","1","0","0","0","0","21","3","18","0","0","0","1","0","1","0","0","0","-2"
"193016","Mercy College","2012","On-tenure track, instructors","1","0","1","0","0","0","1","0","1","0","0","0","0","0","0","0","0","0","0","0","0","0","0","0","0","0","0","0","0","0","-2"
"193016","Mercy College","2012","Not on tenure track/No tenure system system total","104","42","62","0","0","0","7","5","2","6","1","5","5","3","2","0","0","0","85","32","53","0","0","0","1","1","0","0","0","0","-2"
"193016","Mercy College","2012","Not on tenure/no tenure system, professors","5","2","3","0","0","0","0","0","0","0","0","0","0","0","0","0","0","0","5","2","3","0","0","0","0","0","0","0","0","0","-2"
"193016","Mercy College","2012","Not on tenure/no tenure system, associate professors","30","12","18","0","0","0","1","0","1","0","0","0","0","0","0","0","0","0","28","11","17","0","0","0","1","1","0","0","0","0","-2"
"193016","Mercy College","2012","Not on tenure/no tenure system, assistant professors","55","24","31","0","0","0","5","4","1","6","1","5","4","3","1","0","0","0","40","16","24","0","0","0","0","0","0","0","0","0","-2"
"193016","Mercy College","2012","Not on tenure/no tenure system, instructors","14","4","10","0","0","0","1","1","0","0","0","0","1","0","1","0","0","0","12","3","9","0","0","0","0","0","0","0","0","0","-2"
"193399","College of Mount Saint Vincent","2012","Tenured total","44","20","24","0","0","0","1","0","1","0","0","0","0","0","0","0","0","0","43","20","23","0","0","0","0","0","0","0","0","0","-2"
"193399","College of Mount Saint Vincent","2012","Tenured, professors","12","5","7","0","0","0","0","0","0","0","0","0","0","0","0","0","0","0","12","5","7","0","0","0","0","0","0","0","0","0","-2"
"193399","College of Mount Saint Vincent","2012","Tenured, associate professors","25","11","14","0","0","0","1","0","1","0","0","0","0","0","0","0","0","0","24","11","13","0","0","0","0","0","0","0","0","0","-2"
"193399","College of Mount Saint Vincent","2012","Tenured, assistant professors","7","4","3","0","0","0","0","0","0","0","0","0","0","0","0","0","0","0","7","4","3","0","0","0","0","0","0","0","0","0","-2"
"193399","College of Mount Saint Vincent","2012","On-Tenure track total","28","6","22","0","0","0","2","1","1","2","0","2","4","1","3","0","0","0","19","4","15","1","0","1","0","0","0","0","0","0","-2"
"193399","College of Mount Saint Vincent","2012","On-tenure track, associate professors","1","0","1","0","0","0","0","0","0","0","0","0","0","0","0","0","0","0","1","0","1","0","0","0","0","0","0","0","0","0","-2"
"193399","College of Mount Saint Vincent","2012","On-tenure track, assistant professors","21","5","16","0","0","0","2","1","1","1","0","1","4","1","3","0","0","0","13","3","10","1","0","1","0","0","0","0","0","0","-2"
"193399","College of Mount Saint Vincent","2012","On-tenure track, instructors","6","1","5","0","0","0","0","0","0","1","0","1","0","0","0","0","0","0","5","1","4","0","0","0","0","0","0","0","0","0","-2"
"193399","College of Mount Saint Vincent","2012","Not on tenure track/No tenure system system total","5","1","4","0","0","0","0","0","0","1","0","1","0","0","0","0","0","0","4","1","3","0","0","0","0","0","0","0","0","0","-2"
"193399","College of Mount Saint Vincent","2012","Not on tenure/no tenure system, assistant professors","1","0","1","0","0","0","0","0","0","0","0","0","0","0","0","0","0","0","1","0","1","0","0","0","0","0","0","0","0","0","-2"
"193399","College of Mount Saint Vincent","2012","Not on tenure/no tenure system, instructors","4","1","3","0","0","0","0","0","0","1","0","1","0","0","0","0","0","0","3","1","2","0","0","0","0","0","0","0","0","0","-2"
"196219","SUNY at Purchase College","2012","Tenured total","94","43","51","0","0","0","5","2","3","3","2","1","1","1","0","0","0","0","84","37","47","0","0","0","1","1","0","0","0","0","-2"
"196219","SUNY at Purchase College","2012","Tenured, professors","42","24","18","0","0","0","2","1","1","1","1","0","0","0","0","0","0","0","38","21","17","0","0","0","1","1","0","0","0","0","-2"
"196219","SUNY at Purchase College","2012","Tenured, associate professors","52","19","33","0","0","0","3","1","2","2","1","1","1","1","0","0","0","0","46","16","30","0","0","0","0","0","0","0","0","0","-2"
"196219","SUNY at Purchase College","2012","On-Tenure track total","51","23","28","0","0","0","3","0","3","1","0","1","1","0","1","0","0","0","40","20","20","2","1","1","0","0","0","4","2","2","-2"
"196219","SUNY at Purchase College","2012","On-tenure track, associate professors","8","2","6","0","0","0","2","0","2","0","0","0","0","0","0","0","0","0","5","1","4","1","1","0","0","0","0","0","0","0","-2"
"196219","SUNY at Purchase College","2012","On-tenure track, assistant professors","43","21","22","0","0","0","1","0","1","1","0","1","1","0","1","0","0","0","35","19","16","1","0","1","0","0","0","4","2","2","-2"
"196219","SUNY at Purchase College","2012","Not on tenure track/No tenure system system total","15","5","10","0","0","0","1","0","1","1","0","1","0","0","0","0","0","0","11","4","7","0","0","0","0","0","0","2","1","1","-2"
"196219","SUNY at Purchase College","2012","Not on tenure/no tenure system, associate professors","1","1","0","0","0","0","0","0","0","0","0","0","0","0","0","0","0","0","1","1","0","0","0","0","0","0","0","0","0","0","-2"
"196219","SUNY at Purchase College","2012","Not on tenure/no tenure system, assistant professors","10","3","7","0","0","0","1","0","1","1","0","1","0","0","0","0","0","0","7","3","4","0","0","0","0","0","0","1","0","1","-2"
"196219","SUNY at Purchase College","2012","Not on tenure/no tenure system, lecturers","4","1","3","0","0","0","0","0","0","0","0","0","0","0","0","0","0","0","3","0","3","0","0","0","0","0","0","1","1","0","-2"
"196237","SUNY College at Old Westbury","2012","Tenured total","83","39","44","0","0","0","11","5","6","11","7","4","8","6","2","0","0","0","52","21","31","0","0","0","0","0","0","1","0","1","-2"
"196237","SUNY College at Old Westbury","2012","Tenured, professors","30","16","14","0","0","0","7","5","2","4","3","1","4","3","1","0","0","0","15","5","10","0","0","0","0","0","0","0","0","0","-2"
"196237","SUNY College at Old Westbury","2012","Tenured, associate professors","52","22","30","0","0","0","4","0","4","7","4","3","4","3","1","0","0","0","36","15","21","0","0","0","0","0","0","1","0","1","-2"
"196237","SUNY College at Old Westbury","2012","Tenured, instructors","1","1","0","0","0","0","0","0","0","0","0","0","0","0","0","0","0","0","1","1","0","0","0","0","0","0","0","0","0","0","-2"
"196237","SUNY College at Old Westbury","2012","On-Tenure track total","42","21","21","0","0","0","11","4","7","4","2","2","1","1","0","0","0","0","23","12","11","1","0","1","0","0","0","2","2","0","-2"
"196237","SUNY College at Old Westbury","2012","On-tenure track, associate professors","1","1","0","0","0","0","0","0","0","0","0","0","0","0","0","0","0","0","1","1","0","0","0","0","0","0","0","0","0","0","-2"
"196237","SUNY College at Old Westbury","2012","On-tenure track, assistant professors","38","19","19","0","0","0","10","4","6","4","2","2","1","1","0","0","0","0","20","10","10","1","0","1","0","0","0","2","2","0","-2"
"196237","SUNY College at Old Westbury","2012","On-tenure track, instructors","3","1","2","0","0","0","1","0","1","0","0","0","0","0","0","0","0","0","2","1","1","0","0","0","0","0","0","0","0","0","-2"
"196237","SUNY College at Old Westbury","2012","Not on tenure track/No tenure system system total","18","5","13","0","0","0","2","0","2","3","2","1","0","0","0","0","0","0","13","3","10","0","0","0","0","0","0","0","0","0","-2"
"196237","SUNY College at Old Westbury","2012","Not on tenure/no tenure system, associate professors","1","1","0","0","0","0","0","0","0","1","1","0","0","0","0","0","0","0","0","0","0","0","0","0","0","0","0","0","0","0","-2"
"196237","SUNY College at Old Westbury","2012","Not on tenure/no tenure system, assistant professors","4","2","2","0","0","0","0","0","0","1","1","0","0","0","0","0","0","0","3","1","2","0","0","0","0","0","0","0","0","0","-2"
"196237","SUNY College at Old Westbury","2012","Not on tenure/no tenure system, instructors","7","1","6","0","0","0","1","0","1","0","0","0","0","0","0","0","0","0","6","1","5","0","0","0","0","0","0","0","0","0","-2"
"196237","SUNY College at Old Westbury","2012","Not on tenure/no tenure system, lecturers","6","1","5","0","0","0","1","0","1","1","0","1","0","0","0","0","0","0","4","1","3","0","0","0","0","0","0","0","0","0","-2"
"222831","Angelo State University","2012","Tenured total","115","78","37","3","2","1","4","3","1","1","1","0","6","3","3","0","0","0","101","69","32","0","0","0","0","0","0","0","0","0","-2"
"222831","Angelo State University","2012","Tenured, professors","68","47","21","3","2","1","1","0","1","0","0","0","2","2","0","0","0","0","62","43","19","0","0","0","0","0","0","0","0","0","-2"
"222831","Angelo State University","2012","Tenured, associate professors","42","28","14","0","0","0","3","3","0","1","1","0","3","1","2","0","0","0","35","23","12","0","0","0","0","0","0","0","0","0","-2"
"222831","Angelo State University","2012","Tenured, assistant professors","5","3","2","0","0","0","0","0","0","0","0","0","1","0","1","0","0","0","4","3","1","0","0","0","0","0","0","0","0","0","-2"
"222831","Angelo State University","2012","On-Tenure track total","84","47","37","2","0","2","8","6","2","5","3","2","7","3","4","0","0","0","62","35","27","0","0","0","0","0","0","0","0","0","-2"
"222831","Angelo State University","2012","On-tenure track, associate professors","4","3","1","0","0","0","0","0","0","0","0","0","0","0","0","0","0","0","4","3","1","0","0","0","0","0","0","0","0","0","-2"
"222831","Angelo State University","2012","On-tenure track, assistant professors","80","44","36","2","0","2","8","6","2","5","3","2","7","3","4","0","0","0","58","32","26","0","0","0","0","0","0","0","0","0","-2"
"222831","Angelo State University","2012","Not on tenure track/No tenure system system total","74","30","44","0","0","0","2","0","2","1","0","1","10","4","6","0","0","0","61","26","35","0","0","0","0","0","0","0","0","0","-2"
"222831","Angelo State University","2012","Not on tenure/no tenure system, professors","1","1","0","0","0","0","0","0","0","0","0","0","0","0","0","0","0","0","1","1","0","0","0","0","0","0","0","0","0","0","-2"
"222831","Angelo State University","2012","Not on tenure/no tenure system, assistant professors","6","4","2","0","0","0","1","0","1","0","0","0","0","0","0","0","0","0","5","4","1","0","0","0","0","0","0","0","0","0","-2"
"222831","Angelo State University","2012","Not on tenure/no tenure system, instructors","40","18","22","0","0","0","0","0","0","0","0","0","5","4","1","0","0","0","35","14","21","0","0","0","0","0","0","0","0","0","-2"
"222831","Angelo State University","2012","Not on tenure/no tenure system, no academic rank","27","7","20","0","0","0","1","0","1","1","0","1","5","0","5","0","0","0","20","7","13","0","0","0","0","0","0","0","0","0","-2"
"222992","Austin Community College District","2012","Not on tenure track/No tenure system system total","548","249","299","2","0","2","24","7","17","36","18","18","71","38","33","2","2","0","404","182","222","9","2","7","0","0","0","0","0","0","-2"
"222992","Austin Community College District","2012","Not on tenure/no tenure system, professors","344","176","168","1","0","1","10","3","7","24","12","12","41","25","16","1","1","0","262","135","127","5","0","5","0","0","0","0","0","0","-2"
"222992","Austin Community College District","2012","Not on tenure/no tenure system, associate professors","153","51","102","1","0","1","11","3","8","11","5","6","23","9","14","0","0","0","105","33","72","2","1","1","0","0","0","0","0","0","-2"
"222992","Austin Community College District","2012","Not on tenure/no tenure system, assistant professors","51","22","29","0","0","0","3","1","2","1","1","0","7","4","3","1","1","0","37","14","23","2","1","1","0","0","0","0","0","0","-2"
"224004","Concordia University Texas","2012","Tenured total","12","10","2","0","0","0","0","0","0","0","0","0","0","0","0","0","0","0","12","10","2","0","0","0","0","0","0","0","0","0","-2"
"224004","Concordia University Texas","2012","Tenured, professors","8","7","1","0","0","0","0","0","0","0","0","0","0","0","0","0","0","0","8","7","1","0","0","0","0","0","0","0","0","0","-2"
"224004","Concordia University Texas","2012","Tenured, associate professors","4","3","1","0","0","0","0","0","0","0","0","0","0","0","0","0","0","0","4","3","1","0","0","0","0","0","0","0","0","0","-2"
"224004","Concordia University Texas","2012","On-Tenure track total","51","29","22","0","0","0","1","1","0","1","0","1","0","0","0","0","0","0","49","28","21","0","0","0","0","0","0","0","0","0","-2"
"224004","Concordia University Texas","2012","On-tenure track, professors","6","4","2","0","0","0","0","0","0","0","0","0","0","0","0","0","0","0","6","4","2","0","0","0","0","0","0","0","0","0","-2"
"224004","Concordia University Texas","2012","On-tenure track, associate professors","3","2","1","0","0","0","0","0","0","0","0","0","0","0","0","0","0","0","3","2","1","0","0","0","0","0","0","0","0","0","-2"
"224004","Concordia University Texas","2012","On-tenure track, assistant professors","42","23","19","0","0","0","1","1","0","1","0","1","0","0","0","0","0","0","40","22","18","0","0","0","0","0","0","0","0","0","-2"
"224004","Concordia University Texas","2012","Not on tenure track/No tenure system system total","6","6","0","0","0","0","0","0","0","1","1","0","1","1","0","0","0","0","4","4","0","0","0","0","0","0","0","0","0","0","-2"
"224004","Concordia University Texas","2012","Not on tenure/no tenure system, associate professors","1","1","0","0","0","0","0","0","0","0","0","0","0","0","0","0","0","0","1","1","0","0","0","0","0","0","0","0","0","0","-2"
"224004","Concordia University Texas","2012","Not on tenure/no tenure system, no academic rank","5","5","0","0","0","0","0","0","0","1","1","0","1","1","0","0","0","0","3","3","0","0","0","0","0","0","0","0","0","0","-2"
"224961","Galveston College","2012","Tenured total","27","15","12","1","1","0","1","1","0","4","1","3","4","2","2","0","0","0","17","10","7","0","0","0","0","0","0","0","0","0","-2"
"224961","Galveston College","2012","Tenured, professors","5","2","3","0","0","0","0","0","0","1","0","1","0","0","0","0","0","0","4","2","2","0","0","0","0","0","0","0","0","0","-2"
"224961","Galveston College","2012","Tenured, associate professors","5","3","2","0","0","0","0","0","0","1","1","0","2","1","1","0","0","0","2","1","1","0","0","0","0","0","0","0","0","0","-2"
"224961","Galveston College","2012","Tenured, assistant professors","5","3","2","0","0","0","1","1","0","1","0","1","0","0","0","0","0","0","3","2","1","0","0","0","0","0","0","0","0","0","-2"
"224961","Galveston College","2012","Tenured, instructors","12","7","5","1","1","0","0","0","0","1","0","1","2","1","1","0","0","0","8","5","3","0","0","0","0","0","0","0","0","0","-2"
"224961","Galveston College","2012","On-Tenure track total","22","12","10","0","0","0","1","0","1","3","2","1","1","1","0","0","0","0","17","9","8","0","0","0","0","0","0","0","0","0","-2"
"224961","Galveston College","2012","On-tenure track, assistant professors","1","1","0","0","0","0","0","0","0","0","0","0","0","0","0","0","0","0","1","1","0","0","0","0","0","0","0","0","0","0","-2"
"224961","Galveston College","2012","On-tenure track, instructors","21","11","10","0","0","0","1","0","1","3","2","1","1","1","0","0","0","0","16","8","8","0","0","0","0","0","0","0","0","0","-2"
"224961","Galveston College","2012","Not on tenure track/No tenure system system total","2","0","2","0","0","0","0","0","0","0","0","0","1","0","1","0","0","0","1","0","1","0","0","0","0","0","0","0","0","0","-2"
"224961","Galveston College","2012","Not on tenure/no tenure system, instructors","2","0","2","0","0","0","0","0","0","0","0","0","1","0","1","0","0","0","1","0","1","0","0","0","0","0","0","0","0","0","-2"
"225399","Houston Baptist University","2012","Not on tenure track/No tenure system system total","114","58","56","1","0","1","4","3","1","8","1","7","8","4","4","0","0","0","88","48","40","3","2","1","2","0","2","0","0","0","-2"
"225399","Houston Baptist University","2012","Not on tenure/no tenure system, professors","37","21","16","1","0","1","0","0","0","1","0","1","1","0","1","0","0","0","32","20","12","2","1","1","0","0","0","0","0","0","-2"
"225399","Houston Baptist University","2012","Not on tenure/no tenure system, associate professors","23","15","8","0","0","0","2","2","0","1","0","1","3","3","0","0","0","0","17","10","7","0","0","0","0","0","0","0","0","0","-2"
"225399","Houston Baptist University","2012","Not on tenure/no tenure system, assistant professors","49","19","30","0","0","0","2","1","1","5","1","4","4","1","3","0","0","0","35","15","20","1","1","0","2","0","2","0","0","0","-2"
"225399","Houston Baptist University","2012","Not on tenure/no tenure system, instructors","5","3","2","0","0","0","0","0","0","1","0","1","0","0","0","0","0","0","4","3","1","0","0","0","0","0","0","0","0","0","-2"
"225414","University of Houston-Clear Lake","2012","Tenured total","141","89","52","0","0","0","22","16","6","6","4","2","4","1","3","0","0","0","108","67","41","1","1","0","0","0","0","0","0","0","-2"
"225414","University of Houston-Clear Lake","2012","Tenured, professors","50","37","13","0","0","0","11","8","3","1","1","0","1","0","1","0","0","0","37","28","9","0","0","0","0","0","0","0","0","0","-2"
"225414","University of Houston-Clear Lake","2012","Tenured, associate professors","91","52","39","0","0","0","11","8","3","5","3","2","3","1","2","0","0","0","71","39","32","1","1","0","0","0","0","0","0","0","-2"
"225414","University of Houston-Clear Lake","2012","On-Tenure track total","72","29","43","0","0","0","10","5","5","8","1","7","4","0","4","0","0","0","41","16","25","1","1","0","0","0","0","8","6","2","-2"
"225414","University of Houston-Clear Lake","2012","On-tenure track, associate professors","1","1","0","0","0","0","0","0","0","0","0","0","0","0","0","0","0","0","1","1","0","0","0","0","0","0","0","0","0","0","-2"
"225414","University of Houston-Clear Lake","2012","On-tenure track, assistant professors","71","28","43","0","0","0","10","5","5","8","1","7","4","0","4","0","0","0","40","15","25","1","1","0","0","0","0","8","6","2","-2"
"225414","University of Houston-Clear Lake","2012","Not on tenure track/No tenure system system total","37","15","22","0","0","0","3","2","1","0","0","0","1","0","1","0","0","0","30","12","18","2","0","2","0","0","0","1","1","0","-2"
"225414","University of Houston-Clear Lake","2012","Not on tenure/no tenure system, lecturers","27","10","17","0","0","0","2","1","1","0","0","0","0","0","0","0","0","0","23","9","14","2","0","2","0","0","0","0","0","0","-2"
"225414","University of Houston-Clear Lake","2012","Not on tenure/no tenure system, no academic rank","10","5","5","0","0","0","1","1","0","0","0","0","1","0","1","0","0","0","7","3","4","0","0","0","0","0","0","1","1","0","-2"
"225432","University of Houston-Downtown","2012","Tenured total","165","95","70","0","0","0","29","21","8","10","3","7","14","9","5","0","0","0","111","61","50","1","1","0","0","0","0","0","0","0","-2"
"225432","University of Houston-Downtown","2012","Tenured, professors","56","36","20","0","0","0","11","8","3","6","2","4","5","4","1","0","0","0","34","22","12","0","0","0","0","0","0","0","0","0","-2"
"225432","University of Houston-Downtown","2012","Tenured, associate professors","109","59","50","0","0","0","18","13","5","4","1","3","9","5","4","0","0","0","77","39","38","1","1","0","0","0","0","0","0","0","-2"
"225432","University of Houston-Downtown","2012","On-Tenure track total","82","41","41","1","0","1","10","5","5","8","1","7","8","5","3","0","0","0","50","26","24","0","0","0","0","0","0","5","4","1","-2"
"225432","University of Houston-Downtown","2012","On-tenure track, assistant professors","81","40","41","1","0","1","10","5","5","8","1","7","8","5","3","0","0","0","49","25","24","0","0","0","0","0","0","5","4","1","-2"
"225432","University of Houston-Downtown","2012","On-tenure track, instructors","1","1","0","0","0","0","0","0","0","0","0","0","0","0","0","0","0","0","1","1","0","0","0","0","0","0","0","0","0","0","-2"
"225432","University of Houston-Downtown","2012","Not on tenure track/No tenure system system total","81","34","47","0","0","0","12","5","7","8","4","4","3","2","1","1","0","1","56","23","33","1","0","1","0","0","0","0","0","0","-2"
"225432","University of Houston-Downtown","2012","Not on tenure/no tenure system, lecturers","65","28","37","0","0","0","12","5","7","6","3","3","3","2","1","1","0","1","42","18","24","1","0","1","0","0","0","0","0","0","-2"
"225432","University of Houston-Downtown","2012","Not on tenure/no tenure system, no academic rank","16","6","10","0","0","0","0","0","0","2","1","1","0","0","0","0","0","0","14","5","9","0","0","0","0","0","0","0","0","0","-2"
"225502","University of Houston-Victoria","2012","Tenured total","45","28","17","0","0","0","15","13","2","0","0","0","4","2","2","1","1","0","24","11","13","0","0","0","0","0","0","1","1","0","-2"
"225502","University of Houston-Victoria","2012","Tenured, professors","17","13","4","0","0","0","5","4","1","0","0","0","2","1","1","1","1","0","9","7","2","0","0","0","0","0","0","0","0","0","-2"
"225502","University of Houston-Victoria","2012","Tenured, associate professors","28","15","13","0","0","0","10","9","1","0","0","0","2","1","1","0","0","0","15","4","11","0","0","0","0","0","0","1","1","0","-2"
"225502","University of Houston-Victoria","2012","On-Tenure track total","43","20","23","0","0","0","8","4","4","3","2","1","4","1","3","0","0","0","18","9","9","0","0","0","0","0","0","10","4","6","-2"
"225502","University of Houston-Victoria","2012","On-tenure track, associate professors","3","1","2","0","0","0","2","1","1","0","0","0","0","0","0","0","0","0","1","0","1","0","0","0","0","0","0","0","0","0","-2"
"225502","University of Houston-Victoria","2012","On-tenure track, assistant professors","40","19","21","0","0","0","6","3","3","3","2","1","4","1","3","0","0","0","17","9","8","0","0","0","0","0","0","10","4","6","-2"
"225502","University of Houston-Victoria","2012","Not on tenure track/No tenure system system total","18","8","10","0","0","0","2","2","0","0","0","0","5","1","4","0","0","0","7","2","5","0","0","0","0","0","0","4","3","1","-2"
"225502","University of Houston-Victoria","2012","Not on tenure/no tenure system, instructors","8","3","5","0","0","0","1","1","0","0","0","0","3","0","3","0","0","0","2","1","1","0","0","0","0","0","0","2","1","1","-2"
"225502","University of Houston-Victoria","2012","Not on tenure/no tenure system, lecturers","8","5","3","0","0","0","1","1","0","0","0","0","2","1","1","0","0","0","3","1","2","0","0","0","0","0","0","2","2","0","-2"
"225502","University of Houston-Victoria","2012","Not on tenure/no tenure system, no academic rank","2","0","2","0","0","0","0","0","0","0","0","0","0","0","0","0","0","0","2","0","2","0","0","0","0","0","0","0","0","0","-2"
"225575","Huston-Tillotson University","2012","Tenured total","9","2","7","0","0","0","0","0","0","5","1","4","0","0","0","0","0","0","4","1","3","0","0","0","0","0","0","0","0","0","-2"
"225575","Huston-Tillotson University","2012","Tenured, professors","9","2","7","0","0","0","0","0","0","5","1","4","0","0","0","0","0","0","4","1","3","0","0","0","0","0","0","0","0","0","-2"
"225575","Huston-Tillotson University","2012","On-Tenure track total","4","1","3","0","0","0","0","0","0","2","0","2","1","1","0","0","0","0","1","0","1","0","0","0","0","0","0","0","0","0","-2"
"225575","Huston-Tillotson University","2012","On-tenure track, associate professors","2","0","2","0","0","0","0","0","0","2","0","2","0","0","0","0","0","0","0","0","0","0","0","0","0","0","0","0","0","0","-2"
"225575","Huston-Tillotson University","2012","On-tenure track, assistant professors","2","1","1","0","0","0","0","0","0","0","0","0","1","1","0","0","0","0","1","0","1","0","0","0","0","0","0","0","0","0","-2"
"225575","Huston-Tillotson University","2012","Not on tenure track/No tenure system system total","38","22","16","0","0","0","1","0","1","13","5","8","4","3","1","0","0","0","17","11","6","0","0","0","0","0","0","3","3","0","-2"
"225575","Huston-Tillotson University","2012","Not on tenure/no tenure system, professors","5","5","0","0","0","0","0","0","0","1","1","0","1","1","0","0","0","0","3","3","0","0","0","0","0","0","0","0","0","0","-2"
"225575","Huston-Tillotson University","2012","Not on tenure/no tenure system, associate professors","5","2","3","0","0","0","0","0","0","2","1","1","0","0","0","0","0","0","3","1","2","0","0","0","0","0","0","0","0","0","-2"
"225575","Huston-Tillotson University","2012","Not on tenure/no tenure system, assistant professors","21","11","10","0","0","0","0","0","0","8","2","6","2","1","1","0","0","0","9","6","3","0","0","0","0","0","0","2","2","0","-2"
"225575","Huston-Tillotson University","2012","Not on tenure/no tenure system, instructors","7","4","3","0","0","0","1","0","1","2","1","1","1","1","0","0","0","0","2","1","1","0","0","0","0","0","0","1","1","0","-2"
"226134","Laredo College","2012","Tenured total","135","81","54","0","0","0","5","2","3","1","1","0","100","58","42","0","0","0","21","15","6","2","2","0","6","3","3","0","0","0","-2"
"226134","Laredo College","2012","Tenured, instructors","135","81","54","0","0","0","5","2","3","1","1","0","100","58","42","0","0","0","21","15","6","2","2","0","6","3","3","0","0","0","-2"
"226134","Laredo College","2012","On-Tenure track total","56","30","26","0","0","0","2","2","0","2","0","2","44","25","19","0","0","0","6","3","3","0","0","0","2","0","2","0","0","0","-2"
"226134","Laredo College","2012","On-tenure track, instructors","56","30","26","0","0","0","2","2","0","2","0","2","44","25","19","0","0","0","6","3","3","0","0","0","2","0","2","0","0","0","-2"
"226134","Laredo College","2012","Not on tenure track/No tenure system system total","9","7","2","0","0","0","0","0","0","0","0","0","7","5","2","0","0","0","2","2","0","0","0","0","0","0","0","0","0","0","-2"
"226134","Laredo College","2012","Not on tenure/no tenure system, instructors","9","7","2","0","0","0","0","0","0","0","0","0","7","5","2","0","0","0","2","2","0","0","0","0","0","0","0","0","0","0","-2"
"226152","Texas A & M International University","2012","Tenured total","76","55","21","0","0","0","13","10","3","1","1","0","23","18","5","0","0","0","36","24","12","0","0","0","0","0","0","3","2","1","-2"
"226152","Texas A & M International University","2012","Tenured, professors","28","24","4","0","0","0","6","6","0","0","0","0","9","9","0","0","0","0","12","8","4","0","0","0","0","0","0","1","1","0","-2"
"226152","Texas A & M International University","2012","Tenured, associate professors","43","29","14","0","0","0","7","4","3","1","1","0","13","9","4","0","0","0","21","14","7","0","0","0","0","0","0","1","1","0","-2"
"226152","Texas A & M International University","2012","Tenured, assistant professors","4","1","3","0","0","0","0","0","0","0","0","0","1","0","1","0","0","0","2","1","1","0","0","0","0","0","0","1","0","1","-2"
"226152","Texas A & M International University","2012","Tenured, lecturers","1","1","0","0","0","0","0","0","0","0","0","0","0","0","0","0","0","0","1","1","0","0","0","0","0","0","0","0","0","0","-2"
"226152","Texas A & M International University","2012","On-Tenure track total","52","27","25","0","0","0","6","3","3","2","2","0","12","6","6","0","0","0","23","10","13","0","0","0","1","1","0","8","5","3","-2"
"226152","Texas A & M International University","2012","On-tenure track, associate professors","5","1","4","0","0","0","1","0","1","0","0","0","0","0","0","0","0","0","4","1","3","0","0","0","0","0","0","0","0","0","-2"
"226152","Texas A & M International University","2012","On-tenure track, assistant professors","47","26","21","0","0","0","5","3","2","2","2","0","12","6","6","0","0","0","19","9","10","0","0","0","1","1","0","8","5","3","-2"
"226152","Texas A & M International University","2012","Not on tenure track/No tenure system system total","63","20","43","0","0","0","3","0","3","3","1","2","32","11","21","0","0","0","20","5","15","1","0","1","0","0","0","4","3","1","-2"
"226152","Texas A & M International University","2012","Not on tenure/no tenure system, associate professors","2","1","1","0","0","0","0","0","0","0","0","0","1","0","1","0","0","0","1","1","0","0","0","0","0","0","0","0","0","0","-2"
"226152","Texas A & M International University","2012","Not on tenure/no tenure system, assistant professors","21","7","14","0","0","0","2","0","2","0","0","0","9","2","7","0","0","0","6","2","4","0","0","0","0","0","0","4","3","1","-2"
"226152","Texas A & M International University","2012","Not on tenure/no tenure system, instructors","34","11","23","0","0","0","1","0","1","3","1","2","18","8","10","0","0","0","11","2","9","1","0","1","0","0","0","0","0","0","-2"
"226152","Texas A & M International University","2012","Not on tenure/no tenure system, lecturers","6","1","5","0","0","0","0","0","0","0","0","0","4","1","3","0","0","0","2","0","2","0","0","0","0","0","0","0","0","0","-2"
"226587","McMurry University","2012","Tenured total","38","24","14","1","1","0","0","0","0","0","0","0","2","0","2","0","0","0","35","23","12","0","0","0","0","0","0","0","0","0","-2"
"226587","McMurry University","2012","Tenured, professors","17","10","7","1","1","0","0","0","0","0","0","0","0","0","0","0","0","0","16","9","7","0","0","0","0","0","0","0","0","0","-2"
"226587","McMurry University","2012","Tenured, associate professors","20","14","6","0","0","0","0","0","0","0","0","0","2","0","2","0","0","0","18","14","4","0","0","0","0","0","0","0","0","0","-2"
"226587","McMurry University","2012","Tenured, assistant professors","1","0","1","0","0","0","0","0","0","0","0","0","0","0","0","0","0","0","1","0","1","0","0","0","0","0","0","0","0","0","-2"
"226587","McMurry University","2012","On-Tenure track total","15","12","3","0","0","0","1","0","1","0","0","0","1","1","0","0","0","0","13","11","2","0","0","0","0","0","0","0","0","0","-2"
"226587","McMurry University","2012","On-tenure track, professors","1","1","0","0","0","0","0","0","0","0","0","0","0","0","0","0","0","0","1","1","0","0","0","0","0","0","0","0","0","0","-2"
"226587","McMurry University","2012","On-tenure track, associate professors","1","1","0","0","0","0","0","0","0","0","0","0","0","0","0","0","0","0","1","1","0","0","0","0","0","0","0","0","0","0","-2"
"226587","McMurry University","2012","On-tenure track, assistant professors","13","10","3","0","0","0","1","0","1","0","0","0","1","1","0","0","0","0","11","9","2","0","0","0","0","0","0","0","0","0","-2"
"226587","McMurry University","2012","Not on tenure track/No tenure system system total","27","10","17","0","0","0","0","0","0","1","0","1","1","0","1","0","0","0","25","10","15","0","0","0","0","0","0","0","0","0","-2"
"226587","McMurry University","2012","Not on tenure/no tenure system, assistant professors","5","3","2","0","0","0","0","0","0","0","0","0","0","0","0","0","0","0","5","3","2","0","0","0","0","0","0","0","0","0","-2"
"226587","McMurry University","2012","Not on tenure/no tenure system, instructors","22","7","15","0","0","0","0","0","0","1","0","1","1","0","1","0","0","0","20","7","13","0","0","0","0","0","0","0","0","0","-2"
"227216","University of North Texas","2012","Tenured total","573","398","175","3","2","1","69","53","16","20","10","10","30","19","11","0","0","0","422","292","130","5","3","2","19","15","4","5","4","1","-2"
"227216","University of North Texas","2012","Tenured, professors","282","223","59","1","1","0","27","24","3","6","4","2","12","9","3","0","0","0","221","172","49","2","2","0","12","10","2","1","1","0","-2"
"227216","University of North Texas","2012","Tenured, associate professors","287","172","115","2","1","1","42","29","13","13","6","7","18","10","8","0","0","0","198","117","81","3","1","2","7","5","2","4","3","1","-2"
"227216","University of North Texas","2012","Tenured, assistant professors","2","2","0","0","0","0","0","0","0","0","0","0","0","0","0","0","0","0","2","2","0","0","0","0","0","0","0","0","0","0","-2"
"227216","University of North Texas","2012","Tenured, instructors","2","1","1","0","0","0","0","0","0","1","0","1","0","0","0","0","0","0","1","1","0","0","0","0","0","0","0","0","0","0","-2"
"227216","University of North Texas","2012","On-Tenure track total","207","123","84","1","1","0","48","35","13","12","3","9","18","10","8","0","0","0","114","68","46","0","0","0","1","1","0","13","5","8","-2"
"227216","University of North Texas","2012","On-tenure track, professors","2","2","0","0","0","0","0","0","0","0","0","0","1","1","0","0","0","0","0","0","0","0","0","0","0","0","0","1","1","0","-2"
"227216","University of North Texas","2012","On-tenure track, associate professors","8","7","1","0","0","0","2","2","0","0","0","0","0","0","0","0","0","0","6","5","1","0","0","0","0","0","0","0","0","0","-2"
"227216","University of North Texas","2012","On-tenure track, assistant professors","196","113","83","1","1","0","46","33","13","12","3","9","17","9","8","0","0","0","107","62","45","0","0","0","1","1","0","12","4","8","-2"
"227216","University of North Texas","2012","On-tenure track, instructors","1","1","0","0","0","0","0","0","0","0","0","0","0","0","0","0","0","0","1","1","0","0","0","0","0","0","0","0","0","0","-2"
"227216","University of North Texas","2012","Not on tenure track/No tenure system system total","289","102","187","1","0","1","16","4","12","8","4","4","24","6","18","0","0","0","222","82","140","9","1","8","5","3","2","4","2","2","-2"
"227216","University of North Texas","2012","Not on tenure/no tenure system, professors","2","1","1","0","0","0","0","0","0","0","0","0","0","0","0","0","0","0","2","1","1","0","0","0","0","0","0","0","0","0","-2"
"227216","University of North Texas","2012","Not on tenure/no tenure system, associate professors","2","0","2","0","0","0","0","0","0","0","0","0","0","0","0","0","0","0","2","0","2","0","0","0","0","0","0","0","0","0","-2"
"227216","University of North Texas","2012","Not on tenure/no tenure system, assistant professors","3","0","3","0","0","0","0","0","0","0","0","0","0","0","0","0","0","0","2","0","2","1","0","1","0","0","0","0","0","0","-2"
"227216","University of North Texas","2012","Not on tenure/no tenure system, instructors","12","4","8","0","0","0","1","1","0","0","0","0","0","0","0","0","0","0","10","2","8","1","1","0","0","0","0","0","0","0","-2"
"227216","University of North Texas","2012","Not on tenure/no tenure system, lecturers","200","77","123","0","0","0","12","3","9","8","4","4","11","3","8","0","0","0","156","63","93","5","0","5","4","2","2","4","2","2","-2"
"227216","University of North Texas","2012","Not on tenure/no tenure system, no academic rank","70","20","50","1","0","1","3","0","3","0","0","0","13","3","10","0","0","0","50","16","34","2","0","2","1","1","0","0","0","0","-2"
"227368","The University of Texas Rio Grande Valley","2012","Tenured total","322","218","104","0","0","0","52","41","11","8","6","2","83","44","39","0","0","0","150","108","42","14","11","3","15","8","7","0","0","0","-2"
"227368","The University of Texas Rio Grande Valley","2012","Tenured, professors","121","92","29","0","0","0","17","15","2","1","1","0","29","18","11","0","0","0","59","47","12","9","6","3","6","5","1","0","0","0","-2"
"227368","The University of Texas Rio Grande Valley","2012","Tenured, associate professors","185","117","68","0","0","0","29","22","7","6","5","1","50","25","25","0","0","0","88","58","30","4","4","0","8","3","5","0","0","0","-2"
"227368","The University of Texas Rio Grande Valley","2012","Tenured, assistant professors","16","9","7","0","0","0","6","4","2","1","0","1","4","1","3","0","0","0","3","3","0","1","1","0","1","0","1","0","0","0","-2"
"227368","The University of Texas Rio Grande Valley","2012","On-Tenure track total","151","89","62","1","1","0","29","17","12","8","8","0","39","17","22","0","0","0","64","38","26","5","4","1","5","4","1","0","0","0","-2"
"227368","The University of Texas Rio Grande Valley","2012","On-tenure track, associate professors","4","3","1","0","0","0","0","0","0","0","0","0","0","0","0","0","0","0","3","2","1","0","0","0","1","1","0","0","0","0","-2"
"227368","The University of Texas Rio Grande Valley","2012","On-tenure track, assistant professors","124","75","49","0","0","0","28","16","12","7","7","0","28","14","14","0","0","0","53","32","21","5","4","1","3","2","1","0","0","0","-2"
"227368","The University of Texas Rio Grande Valley","2012","On-tenure track, lecturers","18","9","9","0","0","0","1","1","0","1","1","0","8","3","5","0","0","0","7","3","4","0","0","0","1","1","0","0","0","0","-2"
"227368","The University of Texas Rio Grande Valley","2012","On-tenure track, no academic rank","5","2","3","1","1","0","0","0","0","0","0","0","3","0","3","0","0","0","1","1","0","0","0","0","0","0","0","0","0","0","-2"
"227368","The University of Texas Rio Grande Valley","2012","Not on tenure track/No tenure system system total","181","91","90","0","0","0","23","7","16","1","0","1","88","43","45","0","0","0","62","38","24","3","1","2","4","2","2","0","0","0","-2"
"227368","The University of Texas Rio Grande Valley","2012","Not on tenure/no tenure system, assistant professors","5","3","2","0","0","0","0","0","0","0","0","0","4","3","1","0","0","0","1","0","1","0","0","0","0","0","0","0","0","0","-2"
"227368","The University of Texas Rio Grande Valley","2012","Not on tenure/no tenure system, lecturers","119","61","58","0","0","0","17","5","12","1","0","1","53","27","26","0","0","0","44","27","17","3","1","2","1","1","0","0","0","0","-2"
"227368","The University of Texas Rio Grande Valley","2012","Not on tenure/no tenure system, no academic rank","57","27","30","0","0","0","6","2","4","0","0","0","31","13","18","0","0","0","17","11","6","0","0","0","3","1","2","0","0","0","-2"
"227845","Saint Edward's University","2012","Tenured total","60","38","22","0","0","0","1","1","0","1","0","1","2","0","2","0","0","0","55","36","19","1","1","0","0","0","0","0","0","0","-2"
"227845","Saint Edward's University","2012","Tenured, professors","37","25","12","0","0","0","0","0","0","0","0","0","0","0","0","0","0","0","36","24","12","1","1","0","0","0","0","0","0","0","-2"
"227845","Saint Edward's University","2012","Tenured, associate professors","23","13","10","0","0","0","1","1","0","1","0","1","2","0","2","0","0","0","19","12","7","0","0","0","0","0","0","0","0","0","-2"
"227845","Saint Edward's University","2012","On-Tenure track total","122","62","60","1","1","0","5","4","1","2","0","2","12","4","8","0","0","0","99","52","47","1","1","0","0","0","0","2","0","2","-2"
"227845","Saint Edward's University","2012","On-tenure track, professors","1","1","0","1","1","0","0","0","0","0","0","0","0","0","0","0","0","0","0","0","0","0","0","0","0","0","0","0","0","0","-2"
"227845","Saint Edward's University","2012","On-tenure track, associate professors","55","26","29","0","0","0","3","2","1","0","0","0","4","1","3","0","0","0","47","22","25","1","1","0","0","0","0","0","0","0","-2"
"227845","Saint Edward's University","2012","On-tenure track, assistant professors","66","35","31","0","0","0","2","2","0","2","0","2","8","3","5","0","0","0","52","30","22","0","0","0","0","0","0","2","0","2","-2"
"227845","Saint Edward's University","2012","Not on tenure track/No tenure system system total","33","14","19","0","0","0","1","1","0","0","0","0","2","1","1","0","0","0","30","12","18","0","0","0","0","0","0","0","0","0","-2"
"227845","Saint Edward's University","2012","Not on tenure/no tenure system, associate professors","1","0","1","0","0","0","0","0","0","0","0","0","0","0","0","0","0","0","1","0","1","0","0","0","0","0","0","0","0","0","-2"
"227845","Saint Edward's University","2012","Not on tenure/no tenure system, assistant professors","20","7","13","0","0","0","0","0","0","0","0","0","2","1","1","0","0","0","18","6","12","0","0","0","0","0","0","0","0","0","-2"
"227845","Saint Edward's University","2012","Not on tenure/no tenure system, instructors","10","5","5","0","0","0","0","0","0","0","0","0","0","0","0","0","0","0","10","5","5","0","0","0","0","0","0","0","0","0","-2"
"227845","Saint Edward's University","2012","Not on tenure/no tenure system, no academic rank","2","2","0","0","0","0","1","1","0","0","0","0","0","0","0","0","0","0","1","1","0","0","0","0","0","0","0","0","0","0","-2"
"227863","University of St Thomas","2012","Tenured total","79","55","24","0","0","0","3","1","2","1","1","0","5","2","3","0","0","0","64","47","17","0","0","0","6","4","2","0","0","0","-2"
"227863","University of St Thomas","2012","Tenured, professors","37","23","14","0","0","0","2","1","1","0","0","0","1","0","1","0","0","0","33","21","12","0","0","0","1","1","0","0","0","0","-2"
"227863","University of St Thomas","2012","Tenured, associate professors","40","30","10","0","0","0","1","0","1","1","1","0","3","1","2","0","0","0","30","25","5","0","0","0","5","3","2","0","0","0","-2"
"227863","University of St Thomas","2012","Tenured, assistant professors","2","2","0","0","0","0","0","0","0","0","0","0","1","1","0","0","0","0","1","1","0","0","0","0","0","0","0","0","0","0","-2"
"227863","University of St Thomas","2012","On-Tenure track total","39","19","20","0","0","0","3","2","1","1","1","0","9","4","5","0","0","0","17","6","11","2","2","0","3","3","0","4","1","3","-2"
"227863","University of St Thomas","2012","On-tenure track, associate professors","6","4","2","0","0","0","1","0","1","1","1","0","2","2","0","0","0","0","1","0","1","1","1","0","0","0","0","0","0","0","-2"
"227863","University of St Thomas","2012","On-tenure track, assistant professors","33","15","18","0","0","0","2","2","0","0","0","0","7","2","5","0","0","0","16","6","10","1","1","0","3","3","0","4","1","3","-2"
"227863","University of St Thomas","2012","Not on tenure track/No tenure system system total","40","24","16","0","0","0","2","1","1","2","0","2","3","2","1","0","0","0","24","18","6","1","0","1","3","2","1","5","1","4","-2"
"227863","University of St Thomas","2012","Not on tenure/no tenure system, professors","4","3","1","0","0","0","0","0","0","0","0","0","0","0","0","0","0","0","2","2","0","0","0","0","2","1","1","0","0","0","-2"
"227863","University of St Thomas","2012","Not on tenure/no tenure system, associate professors","3","1","2","0","0","0","0","0","0","0","0","0","0","0","0","0","0","0","3","1","2","0","0","0","0","0","0","0","0","0","-2"
"227863","University of St Thomas","2012","Not on tenure/no tenure system, assistant professors","8","3","5","0","0","0","0","0","0","0","0","0","1","1","0","0","0","0","3","2","1","1","0","1","0","0","0","3","0","3","-2"
"227863","University of St Thomas","2012","Not on tenure/no tenure system, instructors","25","17","8","0","0","0","2","1","1","2","0","2","2","1","1","0","0","0","16","13","3","0","0","0","1","1","0","2","1","1","-2"
"228042","Schreiner University","2012","Tenured total","21","14","7","0","0","0","0","0","0","0","0","0","0","0","0","0","0","0","21","14","7","0","0","0","0","0","0","0","0","0","-2"
"228042","Schreiner University","2012","Tenured, professors","13","9","4","0","0","0","0","0","0","0","0","0","0","0","0","0","0","0","13","9","4","0","0","0","0","0","0","0","0","0","-2"
"228042","Schreiner University","2012","Tenured, associate professors","8","5","3","0","0","0","0","0","0","0","0","0","0","0","0","0","0","0","8","5","3","0","0","0","0","0","0","0","0","0","-2"
"228042","Schreiner University","2012","On-Tenure track total","18","9","9","0","0","0","2","1","1","0","0","0","2","1","1","0","0","0","14","7","7","0","0","0","0","0","0","0","0","0","-2"
"228042","Schreiner University","2012","On-tenure track, associate professors","2","2","0","0","0","0","0","0","0","0","0","0","0","0","0","0","0","0","2","2","0","0","0","0","0","0","0","0","0","0","-2"
"228042","Schreiner University","2012","On-tenure track, assistant professors","16","7","9","0","0","0","2","1","1","0","0","0","2","1","1","0","0","0","12","5","7","0","0","0","0","0","0","0","0","0","-2"
"228042","Schreiner University","2012","Not on tenure track/No tenure system system total","16","6","10","0","0","0","0","0","0","0","0","0","2","1","1","0","0","0","14","5","9","0","0","0","0","0","0","0","0","0","-2"
"228042","Schreiner University","2012","Not on tenure/no tenure system, assistant professors","5","5","0","0","0","0","0","0","0","0","0","0","1","1","0","0","0","0","4","4","0","0","0","0","0","0","0","0","0","0","-2"
"228042","Schreiner University","2012","Not on tenure/no tenure system, instructors","11","1","10","0","0","0","0","0","0","0","0","0","1","0","1","0","0","0","10","1","9","0","0","0","0","0","0","0","0","0","-2"
"228149","St. Mary's University","2012","Tenured total","135","92","43","1","1","0","5","5","0","3","3","0","14","9","5","2","2","0","104","66","38","0","0","0","0","0","0","6","6","0","-2"
"228149","St. Mary's University","2012","Tenured, professors","83","61","22","0","0","0","5","5","0","3","3","0","8","4","4","1","1","0","64","46","18","0","0","0","0","0","0","2","2","0","-2"
"228149","St. Mary's University","2012","Tenured, associate professors","44","25","19","1","1","0","0","0","0","0","0","0","5","4","1","1","1","0","33","15","18","0","0","0","0","0","0","4","4","0","-2"
"228149","St. Mary's University","2012","Tenured, assistant professors","8","6","2","0","0","0","0","0","0","0","0","0","1","1","0","0","0","0","7","5","2","0","0","0","0","0","0","0","0","0","-2"
"228149","St. Mary's University","2012","On-Tenure track total","31","19","12","0","0","0","1","1","0","1","0","1","3","3","0","0","0","0","21","11","10","0","0","0","0","0","0","5","4","1","-2"
"228149","St. Mary's University","2012","On-tenure track, associate professors","2","1","1","0","0","0","0","0","0","1","0","1","1","1","0","0","0","0","0","0","0","0","0","0","0","0","0","0","0","0","-2"
"228149","St. Mary's University","2012","On-tenure track, assistant professors","29","18","11","0","0","0","1","1","0","0","0","0","2","2","0","0","0","0","21","11","10","0","0","0","0","0","0","5","4","1","-2"
"228149","St. Mary's University","2012","Not on tenure track/No tenure system system total","41","23","18","0","0","0","0","0","0","0","0","0","10","5","5","0","0","0","29","17","12","0","0","0","0","0","0","2","1","1","-2"
"228149","St. Mary's University","2012","Not on tenure/no tenure system, professors","4","1","3","0","0","0","0","0","0","0","0","0","0","0","0","0","0","0","4","1","3","0","0","0","0","0","0","0","0","0","-2"
"228149","St. Mary's University","2012","Not on tenure/no tenure system, associate professors","6","2","4","0","0","0","0","0","0","0","0","0","1","0","1","0","0","0","5","2","3","0","0","0","0","0","0","0","0","0","-2"
"228149","St. Mary's University","2012","Not on tenure/no tenure system, assistant professors","19","14","5","0","0","0","0","0","0","0","0","0","4","2","2","0","0","0","14","11","3","0","0","0","0","0","0","1","1","0","-2"
"228149","St. Mary's University","2012","Not on tenure/no tenure system, instructors","2","2","0","0","0","0","0","0","0","0","0","0","1","1","0","0","0","0","1","1","0","0","0","0","0","0","0","0","0","0","-2"
"228149","St. Mary's University","2012","Not on tenure/no tenure system, lecturers","10","4","6","0","0","0","0","0","0","0","0","0","4","2","2","0","0","0","5","2","3","0","0","0","0","0","0","1","0","1","-2"
"228468","Southwestern Adventist University","2012","Tenured total","16","12","4","0","0","0","0","0","0","1","1","0","0","0","0","0","0","0","15","11","4","0","0","0","0","0","0","0","0","0","-2"
"228468","Southwestern Adventist University","2012","Tenured, professors","15","12","3","0","0","0","0","0","0","1","1","0","0","0","0","0","0","0","14","11","3","0","0","0","0","0","0","0","0","0","-2"
"228468","Southwestern Adventist University","2012","Tenured, associate professors","1","0","1","0","0","0","0","0","0","0","0","0","0","0","0","0","0","0","1","0","1","0","0","0","0","0","0","0","0","0","-2"
"228468","Southwestern Adventist University","2012","On-Tenure track total","36","21","15","1","1","0","1","0","1","4","4","0","4","3","1","1","0","1","23","11","12","0","0","0","0","0","0","2","2","0","-2"
"228468","Southwestern Adventist University","2012","On-tenure track, professors","3","2","1","0","0","0","0","0","0","1","1","0","1","1","0","0","0","0","1","0","1","0","0","0","0","0","0","0","0","0","-2"
"228468","Southwestern Adventist University","2012","On-tenure track, associate professors","13","8","5","0","0","0","0","0","0","2","2","0","1","0","1","0","0","0","9","5","4","0","0","0","0","0","0","1","1","0","-2"
"228468","Southwestern Adventist University","2012","On-tenure track, assistant professors","16","9","7","1","1","0","1","0","1","0","0","0","2","2","0","1","0","1","10","5","5","0","0","0","0","0","0","1","1","0","-2"
"228468","Southwestern Adventist University","2012","On-tenure track, instructors","4","2","2","0","0","0","0","0","0","1","1","0","0","0","0","0","0","0","3","1","2","0","0","0","0","0","0","0","0","0","-2"
"228501","Sul Ross State University","2012","Tenured total","70","47","23","1","1","0","4","4","0","1","1","0","8","5","3","0","0","0","55","36","19","1","0","1","0","0","0","0","0","0","-2"
"228501","Sul Ross State University","2012","Tenured, professors","36","26","10","0","0","0","3","3","0","1","1","0","1","0","1","0","0","0","31","22","9","0","0","0","0","0","0","0","0","0","-2"
"228501","Sul Ross State University","2012","Tenured, associate professors","30","18","12","1","1","0","1","1","0","0","0","0","6","4","2","0","0","0","21","12","9","1","0","1","0","0","0","0","0","0","-2"
"228501","Sul Ross State University","2012","Tenured, assistant professors","4","3","1","0","0","0","0","0","0","0","0","0","1","1","0","0","0","0","3","2","1","0","0","0","0","0","0","0","0","0","-2"
"228501","Sul Ross State University","2012","On-Tenure track total","23","11","12","0","0","0","0","0","0","0","0","0","4","4","0","0","0","0","19","7","12","0","0","0","0","0","0","0","0","0","-2"
"228501","Sul Ross State University","2012","On-tenure track, associate professors","3","3","0","0","0","0","0","0","0","0","0","0","1","1","0","0","0","0","2","2","0","0","0","0","0","0","0","0","0","0","-2"
"228501","Sul Ross State University","2012","On-tenure track, assistant professors","18","7","11","0","0","0","0","0","0","0","0","0","3","3","0","0","0","0","15","4","11","0","0","0","0","0","0","0","0","0","-2"
"228501","Sul Ross State University","2012","On-tenure track, instructors","2","1","1","0","0","0","0","0","0","0","0","0","0","0","0","0","0","0","2","1","1","0","0","0","0","0","0","0","0","0","-2"
"228501","Sul Ross State University","2012","Not on tenure track/No tenure system system total","22","13","9","0","0","0","0","0","0","0","0","0","6","4","2","0","0","0","16","9","7","0","0","0","0","0","0","0","0","0","-2"
"228501","Sul Ross State University","2012","Not on tenure/no tenure system, professors","1","1","0","0","0","0","0","0","0","0","0","0","1","1","0","0","0","0","0","0","0","0","0","0","0","0","0","0","0","0","-2"
"228501","Sul Ross State University","2012","Not on tenure/no tenure system, instructors","2","1","1","0","0","0","0","0","0","0","0","0","0","0","0","0","0","0","2","1","1","0","0","0","0","0","0","0","0","0","-2"
"228501","Sul Ross State University","2012","Not on tenure/no tenure system, lecturers","19","11","8","0","0","0","0","0","0","0","0","0","5","3","2","0","0","0","14","8","6","0","0","0","0","0","0","0","0","0","-2"
"228705","Texas A & M University-Kingsville","2012","Tenured total","167","121","46","1","1","0","25","22","3","6","4","2","23","18","5","0","0","0","108","73","35","0","0","0","1","1","0","3","2","1","-2"
"228705","Texas A & M University-Kingsville","2012","Tenured, professors","87","69","18","1","1","0","10","10","0","3","3","0","11","7","4","0","0","0","61","47","14","0","0","0","1","1","0","0","0","0","-2"
"228705","Texas A & M University-Kingsville","2012","Tenured, associate professors","57","39","18","0","0","0","14","11","3","1","1","0","11","10","1","0","0","0","30","17","13","0","0","0","0","0","0","1","0","1","-2"
"228705","Texas A & M University-Kingsville","2012","Tenured, assistant professors","23","13","10","0","0","0","1","1","0","2","0","2","1","1","0","0","0","0","17","9","8","0","0","0","0","0","0","2","2","0","-2"
"228705","Texas A & M University-Kingsville","2012","On-Tenure track total","75","36","39","1","1","0","3","2","1","3","3","0","7","1","6","0","0","0","52","22","30","0","0","0","0","0","0","9","7","2","-2"
"228705","Texas A & M University-Kingsville","2012","On-tenure track, professors","3","3","0","0","0","0","0","0","0","0","0","0","0","0","0","0","0","0","2","2","0","0","0","0","0","0","0","1","1","0","-2"
"228705","Texas A & M University-Kingsville","2012","On-tenure track, associate professors","10","5","5","0","0","0","0","0","0","1","1","0","1","0","1","0","0","0","7","3","4","0","0","0","0","0","0","1","1","0","-2"
"228705","Texas A & M University-Kingsville","2012","On-tenure track, assistant professors","62","28","34","1","1","0","3","2","1","2","2","0","6","1","5","0","0","0","43","17","26","0","0","0","0","0","0","7","5","2","-2"
"228705","Texas A & M University-Kingsville","2012","Not on tenure track/No tenure system system total","162","87","75","3","0","3","7","4","3","7","6","1","38","21","17","1","0","1","89","48","41","2","1","1","3","1","2","12","6","6","-2"
"228705","Texas A & M University-Kingsville","2012","Not on tenure/no tenure system, professors","5","4","1","0","0","0","1","1","0","0","0","0","0","0","0","0","0","0","4","3","1","0","0","0","0","0","0","0","0","0","-2"
"228705","Texas A & M University-Kingsville","2012","Not on tenure/no tenure system, associate professors","9","7","2","0","0","0","1","1","0","0","0","0","1","1","0","0","0","0","5","4","1","0","0","0","0","0","0","2","1","1","-2"
"228705","Texas A & M University-Kingsville","2012","Not on tenure/no tenure system, assistant professors","60","32","28","0","0","0","3","1","2","1","1","0","11","6","5","1","0","1","36","20","16","0","0","0","0","0","0","8","4","4","-2"
"228705","Texas A & M University-Kingsville","2012","Not on tenure/no tenure system, lecturers","88","44","44","3","0","3","2","1","1","6","5","1","26","14","12","0","0","0","44","21","23","2","1","1","3","1","2","2","1","1","-2"
"228981","Texas Lutheran University","2012","Tenured total","43","25","18","0","0","0","0","0","0","0","0","0","2","1","1","0","0","0","40","23","17","0","0","0","1","1","0","0","0","0","-2"
"228981","Texas Lutheran University","2012","Tenured, professors","21","14","7","0","0","0","0","0","0","0","0","0","0","0","0","0","0","0","21","14","7","0","0","0","0","0","0","0","0","0","-2"
"228981","Texas Lutheran University","2012","Tenured, associate professors","20","9","11","0","0","0","0","0","0","0","0","0","2","1","1","0","0","0","17","7","10","0","0","0","1","1","0","0","0","0","-2"
"228981","Texas Lutheran University","2012","Tenured, assistant professors","2","2","0","0","0","0","0","0","0","0","0","0","0","0","0","0","0","0","2","2","0","0","0","0","0","0","0","0","0","0","-2"
"228981","Texas Lutheran University","2012","On-Tenure track total","20","12","8","0","0","0","1","0","1","2","2","0","3","2","1","0","0","0","14","8","6","0","0","0","0","0","0","0","0","0","-2"
"228981","Texas Lutheran University","2012","On-tenure track, associate professors","2","1","1","0","0","0","0","0","0","0","0","0","0","0","0","0","0","0","2","1","1","0","0","0","0","0","0","0","0","0","-2"
"228981","Texas Lutheran University","2012","On-tenure track, assistant professors","17","10","7","0","0","0","1","0","1","1","1","0","3","2","1","0","0","0","12","7","5","0","0","0","0","0","0","0","0","0","-2"
"228981","Texas Lutheran University","2012","On-tenure track, instructors","1","1","0","0","0","0","0","0","0","1","1","0","0","0","0","0","0","0","0","0","0","0","0","0","0","0","0","0","0","0","-2"
"228981","Texas Lutheran University","2012","Not on tenure track/No tenure system system total","10","3","7","0","0","0","0","0","0","0","0","0","2","1","1","0","0","0","8","2","6","0","0","0","0","0","0","0","0","0","-2"
"228981","Texas Lutheran University","2012","Not on tenure/no tenure system, assistant professors","3","1","2","0","0","0","0","0","0","0","0","0","2","1","1","0","0","0","1","0","1","0","0","0","0","0","0","0","0","0","-2"
"228981","Texas Lutheran University","2012","Not on tenure/no tenure system, instructors","2","1","1","0","0","0","0","0","0","0","0","0","0","0","0","0","0","0","2","1","1","0","0","0","0","0","0","0","0","0","-2"
"228981","Texas Lutheran University","2012","Not on tenure/no tenure system, lecturers","5","1","4","0","0","0","0","0","0","0","0","0","0","0","0","0","0","0","5","1","4","0","0","0","0","0","0","0","0","0","-2"
"229018","The University of Texas Permian Basin","2012","Tenured total","54","35","19","1","0","1","2","0","2","0","0","0","3","0","3","4","4","0","44","31","13","0","0","0","0","0","0","0","0","0","-2"
"229018","The University of Texas Permian Basin","2012","Tenured, professors","19","14","5","0","0","0","0","0","0","0","0","0","2","0","2","0","0","0","17","14","3","0","0","0","0","0","0","0","0","0","-2"
"229018","The University of Texas Permian Basin","2012","Tenured, associate professors","35","21","14","1","0","1","2","0","2","0","0","0","1","0","1","4","4","0","27","17","10","0","0","0","0","0","0","0","0","0","-2"
"229018","The University of Texas Permian Basin","2012","On-Tenure track total","27","17","10","0","0","0","2","1","1","1","0","1","3","2","1","2","2","0","19","12","7","0","0","0","0","0","0","0","0","0","-2"
"229018","The University of Texas Permian Basin","2012","On-tenure track, professors","1","1","0","0","0","0","0","0","0","0","0","0","0","0","0","0","0","0","1","1","0","0","0","0","0","0","0","0","0","0","-2"
"229018","The University of Texas Permian Basin","2012","On-tenure track, associate professors","4","4","0","0","0","0","1","1","0","0","0","0","1","1","0","0","0","0","2","2","0","0","0","0","0","0","0","0","0","0","-2"
"229018","The University of Texas Permian Basin","2012","On-tenure track, assistant professors","22","12","10","0","0","0","1","0","1","1","0","1","2","1","1","2","2","0","16","9","7","0","0","0","0","0","0","0","0","0","-2"
"229018","The University of Texas Permian Basin","2012","Not on tenure track/No tenure system system total","30","7","23","0","0","0","1","0","1","0","0","0","1","1","0","0","0","0","28","6","22","0","0","0","0","0","0","0","0","0","-2"
"229018","The University of Texas Permian Basin","2012","Not on tenure/no tenure system, professors","3","1","2","0","0","0","0","0","0","0","0","0","0","0","0","0","0","0","3","1","2","0","0","0","0","0","0","0","0","0","-2"
"229018","The University of Texas Permian Basin","2012","Not on tenure/no tenure system, assistant professors","1","1","0","0","0","0","0","0","0","0","0","0","0","0","0","0","0","0","1","1","0","0","0","0","0","0","0","0","0","0","-2"
"229018","The University of Texas Permian Basin","2012","Not on tenure/no tenure system, lecturers","26","5","21","0","0","0","1","0","1","0","0","0","1","1","0","0","0","0","24","4","20","0","0","0","0","0","0","0","0","0","-2"
"229160","Texas Wesleyan University","2012","Tenured total","99","52","47","0","0","0","6","3","3","3","3","0","5","3","2","0","0","0","84","42","42","0","0","0","1","1","0","0","0","0","-2"
"229160","Texas Wesleyan University","2012","Tenured, professors","64","38","26","0","0","0","3","2","1","3","3","0","4","3","1","0","0","0","53","29","24","0","0","0","1","1","0","0","0","0","-2"
"229160","Texas Wesleyan University","2012","Tenured, associate professors","33","14","19","0","0","0","3","1","2","0","0","0","1","0","1","0","0","0","29","13","16","0","0","0","0","0","0","0","0","0","-2"
"229160","Texas Wesleyan University","2012","Tenured, assistant professors","2","0","2","0","0","0","0","0","0","0","0","0","0","0","0","0","0","0","2","0","2","0","0","0","0","0","0","0","0","0","-2"
"229160","Texas Wesleyan University","2012","On-Tenure track total","51","22","29","0","0","0","3","1","2","1","1","0","4","1","3","0","0","0","40","18","22","0","0","0","3","1","2","0","0","0","-2"
"229160","Texas Wesleyan University","2012","On-tenure track, associate professors","18","11","7","0","0","0","1","0","1","1","1","0","1","0","1","0","0","0","13","9","4","0","0","0","2","1","1","0","0","0","-2"
"229160","Texas Wesleyan University","2012","On-tenure track, assistant professors","33","11","22","0","0","0","2","1","1","0","0","0","3","1","2","0","0","0","27","9","18","0","0","0","1","0","1","0","0","0","-2"
"229160","Texas Wesleyan University","2012","Not on tenure track/No tenure system system total","23","7","16","1","0","1","1","1","0","0","0","0","2","1","1","0","0","0","19","5","14","0","0","0","0","0","0","0","0","0","-2"
"229160","Texas Wesleyan University","2012","Not on tenure/no tenure system, professors","1","0","1","0","0","0","0","0","0","0","0","0","1","0","1","0","0","0","0","0","0","0","0","0","0","0","0","0","0","0","-2"
"229160","Texas Wesleyan University","2012","Not on tenure/no tenure system, associate professors","1","1","0","0","0","0","0","0","0","0","0","0","0","0","0","0","0","0","1","1","0","0","0","0","0","0","0","0","0","0","-2"
"229160","Texas Wesleyan University","2012","Not on tenure/no tenure system, assistant professors","10","5","5","0","0","0","1","1","0","0","0","0","1","1","0","0","0","0","8","3","5","0","0","0","0","0","0","0","0","0","-2"
"229160","Texas Wesleyan University","2012","Not on tenure/no tenure system, instructors","11","1","10","1","0","1","0","0","0","0","0","0","0","0","0","0","0","0","10","1","9","0","0","0","0","0","0","0","0","0","-2"
"229337","Texas Tech University Health Sciences Center","2012","Tenured total","150","112","38","0","0","0","18","16","2","3","1","2","11","9","2","0","0","0","118","86","32","0","0","0","0","0","0","0","0","0","-2"
"229337","Texas Tech University Health Sciences Center","2012","Tenured, professors","105","83","22","0","0","0","14","12","2","3","1","2","8","7","1","0","0","0","80","63","17","0","0","0","0","0","0","0","0","0","-2"
"229337","Texas Tech University Health Sciences Center","2012","Tenured, associate professors","42","28","14","0","0","0","4","4","0","0","0","0","3","2","1","0","0","0","35","22","13","0","0","0","0","0","0","0","0","0","-2"
"229337","Texas Tech University Health Sciences Center","2012","Tenured, assistant professors","3","1","2","0","0","0","0","0","0","0","0","0","0","0","0","0","0","0","3","1","2","0","0","0","0","0","0","0","0","0","-2"
"229337","Texas Tech University Health Sciences Center","2012","On-Tenure track total","72","42","30","0","0","0","17","7","10","2","1","1","8","5","3","0","0","0","38","24","14","0","0","0","1","1","0","6","4","2","-2"
"229337","Texas Tech University Health Sciences Center","2012","On-tenure track, professors","8","6","2","0","0","0","1","0","1","0","0","0","0","0","0","0","0","0","6","5","1","0","0","0","0","0","0","1","1","0","-2"
"229337","Texas Tech University Health Sciences Center","2012","On-tenure track, associate professors","29","18","11","0","0","0","8","5","3","1","0","1","3","1","2","0","0","0","15","10","5","0","0","0","1","1","0","1","1","0","-2"
"229337","Texas Tech University Health Sciences Center","2012","On-tenure track, assistant professors","35","18","17","0","0","0","8","2","6","1","1","0","5","4","1","0","0","0","17","9","8","0","0","0","0","0","0","4","2","2","-2"
"229337","Texas Tech University Health Sciences Center","2012","Not on tenure track/No tenure system system total","610","309","301","4","3","1","74","42","32","27","6","21","91","47","44","0","0","0","366","176","190","0","0","0","6","4","2","42","31","11","-2"
"229337","Texas Tech University Health Sciences Center","2012","Not on tenure/no tenure system, professors","44","30","14","1","1","0","5","4","1","0","0","0","2","2","0","0","0","0","36","23","13","0","0","0","0","0","0","0","0","0","-2"
"229337","Texas Tech University Health Sciences Center","2012","Not on tenure/no tenure system, associate professors","143","89","54","0","0","0","23","14","9","6","1","5","15","13","2","0","0","0","94","58","36","0","0","0","1","0","1","4","3","1","-2"
"229337","Texas Tech University Health Sciences Center","2012","Not on tenure/no tenure system, assistant professors","289","145","144","3","2","1","34","18","16","18","5","13","43","21","22","0","0","0","156","71","85","0","0","0","4","4","0","31","24","7","-2"
"229337","Texas Tech University Health Sciences Center","2012","Not on tenure/no tenure system, instructors","53","15","38","0","0","0","4","2","2","1","0","1","10","3","7","0","0","0","33","6","27","0","0","0","0","0","0","5","4","1","-2"
"229337","Texas Tech University Health Sciences Center","2012","Not on tenure/no tenure system, no academic rank","81","30","51","0","0","0","8","4","4","2","0","2","21","8","13","0","0","0","47","18","29","0","0","0","1","0","1","2","0","2","-2"
"235422","Heritage University","2012","Not on tenure track/No tenure system system total","63","25","38","8","2","6","1","1","0","3","1","2","10","2","8","1","1","0","38","16","22","1","1","0","1","1","0","0","0","0","-2"
"235422","Heritage University","2012","Not on tenure/no tenure system, professors","8","2","6","2","1","1","0","0","0","0","0","0","1","0","1","0","0","0","4","0","4","1","1","0","0","0","0","0","0","0","-2"
"235422","Heritage University","2012","Not on tenure/no tenure system, associate professors","15","7","8","1","0","1","1","1","0","1","0","1","1","0","1","0","0","0","11","6","5","0","0","0","0","0","0","0","0","0","-2"
"235422","Heritage University","2012","Not on tenure/no tenure system, assistant professors","27","11","16","2","0","2","0","0","0","1","1","0","6","2","4","1","1","0","17","7","10","0","0","0","0","0","0","0","0","0","-2"
"235422","Heritage University","2012","Not on tenure/no tenure system, instructors","12","5","7","3","1","2","0","0","0","1","0","1","2","0","2","0","0","0","5","3","2","0","0","0","1","1","0","0","0","0","-2"
"235422","Heritage University","2012","Not on tenure/no tenure system, no academic rank","1","0","1","0","0","0","0","0","0","0","0","0","0","0","0","0","0","0","1","0","1","0","0","0","0","0","0","0","0","0","-2"
"236975","Wenatchee Valley College","2012","Tenured total","56","31","25","0","0","0","0","0","0","0","0","0","3","3","0","0","0","0","51","27","24","2","1","1","0","0","0","0","0","0","-2"
"236975","Wenatchee Valley College","2012","Tenured, no academic rank","56","31","25","0","0","0","0","0","0","0","0","0","3","3","0","0","0","0","51","27","24","2","1","1","0","0","0","0","0","0","-2"
"236975","Wenatchee Valley College","2012","On-Tenure track total","9","5","4","0","0","0","1","0","1","0","0","0","0","0","0","0","0","0","8","5","3","0","0","0","0","0","0","0","0","0","-2"
"236975","Wenatchee Valley College","2012","On-tenure track, no academic rank","9","5","4","0","0","0","1","0","1","0","0","0","0","0","0","0","0","0","8","5","3","0","0","0","0","0","0","0","0","0","-2"
"236975","Wenatchee Valley College","2012","Not on tenure track/No tenure system system total","6","3","3","0","0","0","0","0","0","0","0","0","0","0","0","0","0","0","6","3","3","0","0","0","0","0","0","0","0","0","-2"
"236975","Wenatchee Valley College","2012","Not on tenure/no tenure system, no academic rank","6","3","3","0","0","0","0","0","0","0","0","0","0","0","0","0","0","0","6","3","3","0","0","0","0","0","0","0","0","0","-2"
"237109","Yakima Valley College","2012","Tenured total","60","28","32","2","1","1","1","1","0","0","0","0","2","2","0","0","0","0","55","24","31","0","0","0","0","0","0","0","0","0","-2"
"237109","Yakima Valley College","2012","Tenured, instructors","60","28","32","2","1","1","1","1","0","0","0","0","2","2","0","0","0","0","55","24","31","0","0","0","0","0","0","0","0","0","-2"
"237109","Yakima Valley College","2012","On-Tenure track total","11","5","6","0","0","0","1","0","1","0","0","0","0","0","0","0","0","0","10","5","5","0","0","0","0","0","0","0","0","0","-2"
"237109","Yakima Valley College","2012","On-tenure track, instructors","11","5","6","0","0","0","1","0","1","0","0","0","0","0","0","0","0","0","10","5","5","0","0","0","0","0","0","0","0","0","-2"
"237109","Yakima Valley College","2012","Not on tenure track/No tenure system system total","18","10","8","0","0","0","0","0","0","0","0","0","3","1","2","0","0","0","15","9","6","0","0","0","0","0","0","0","0","0","-2"
"237109","Yakima Valley College","2012","Not on tenure/no tenure system, instructors","18","10","8","0","0","0","0","0","0","0","0","0","3","1","2","0","0","0","15","9","6","0","0","0","0","0","0","0","0","0","-2"
"238193","Alverno College","2012","Tenured total","81","18","63","0","0","0","2","0","2","3","1","2","1","0","1","0","0","0","75","17","58","0","0","0","0","0","0","0","0","0","-2"
"238193","Alverno College","2012","Tenured, professors","42","12","30","0","0","0","1","0","1","1","1","0","0","0","0","0","0","0","40","11","29","0","0","0","0","0","0","0","0","0","-2"
"238193","Alverno College","2012","Tenured, associate professors","25","4","21","0","0","0","0","0","0","1","0","1","0","0","0","0","0","0","24","4","20","0","0","0","0","0","0","0","0","0","-2"
"238193","Alverno College","2012","Tenured, assistant professors","14","2","12","0","0","0","1","0","1","1","0","1","1","0","1","0","0","0","11","2","9","0","0","0","0","0","0","0","0","0","-2"
"238193","Alverno College","2012","On-Tenure track total","37","7","30","0","0","0","0","0","0","3","0","3","2","0","2","0","0","0","31","6","25","0","0","0","1","1","0","0","0","0","-2"
"238193","Alverno College","2012","On-tenure track, associate professors","1","0","1","0","0","0","0","0","0","0","0","0","0","0","0","0","0","0","1","0","1","0","0","0","0","0","0","0","0","0","-2"
"238193","Alverno College","2012","On-tenure track, assistant professors","36","7","29","0","0","0","0","0","0","3","0","3","2","0","2","0","0","0","30","6","24","0","0","0","1","1","0","0","0","0","-2"
"241191","Universidad Adventista de las Antillas","2012","Tenured total","35","15","20","0","0","0","0","0","0","0","0","0","34","15","19","0","0","0","1","0","1","0","0","0","0","0","0","0","0","0","-2"
"241191","Universidad Adventista de las Antillas","2012","Tenured, professors","3","0","3","0","0","0","0","0","0","0","0","0","3","0","3","0","0","0","0","0","0","0","0","0","0","0","0","0","0","0","-2"
"241191","Universidad Adventista de las Antillas","2012","Tenured, associate professors","12","5","7","0","0","0","0","0","0","0","0","0","12","5","7","0","0","0","0","0","0","0","0","0","0","0","0","0","0","0","-2"
"241191","Universidad Adventista de las Antillas","2012","Tenured, assistant professors","15","7","8","0","0","0","0","0","0","0","0","0","15","7","8","0","0","0","0","0","0","0","0","0","0","0","0","0","0","0","-2"
"241191","Universidad Adventista de las Antillas","2012","Tenured, instructors","5","3","2","0","0","0","0","0","0","0","0","0","4","3","1","0","0","0","1","0","1","0","0","0","0","0","0","0","0","0","-2"
"241191","Universidad Adventista de las Antillas","2012","On-Tenure track total","4","2","2","0","0","0","0","0","0","0","0","0","4","2","2","0","0","0","0","0","0","0","0","0","0","0","0","0","0","0","-2"
"241191","Universidad Adventista de las Antillas","2012","On-tenure track, no academic rank","4","2","2","0","0","0","0","0","0","0","0","0","4","2","2","0","0","0","0","0","0","0","0","0","0","0","0","0","0","0","-2"
"241191","Universidad Adventista de las Antillas","2012","Not on tenure track/No tenure system system total","5","2","3","0","0","0","0","0","0","0","0","0","5","2","3","0","0","0","0","0","0","0","0","0","0","0","0","0","0","0","-2"
"241191","Universidad Adventista de las Antillas","2012","Not on tenure/no tenure system, no academic rank","5","2","3","0","0","0","0","0","0","0","0","0","5","2","3","0","0","0","0","0","0","0","0","0","0","0","0","0","0","0","-2"
"241614","Universidad Teologica del Caribe","2012","Tenured total","6","4","2","0","0","0","0","0","0","0","0","0","6","4","2","0","0","0","0","0","0","0","0","0","0","0","0","0","0","0","-2"
"241614","Universidad Teologica del Caribe","2012","Tenured, professors","1","0","1","0","0","0","0","0","0","0","0","0","1","0","1","0","0","0","0","0","0","0","0","0","0","0","0","0","0","0","-2"
"241614","Universidad Teologica del Caribe","2012","Tenured, associate professors","2","2","0","0","0","0","0","0","0","0","0","0","2","2","0","0","0","0","0","0","0","0","0","0","0","0","0","0","0","0","-2"
"241614","Universidad Teologica del Caribe","2012","Tenured, instructors","3","2","1","0","0","0","0","0","0","0","0","0","3","2","1","0","0","0","0","0","0","0","0","0","0","0","0","0","0","0","-2"
"241766","Conservatory of Music of Puerto Rico","2012","Tenured total","28","22","6","0","0","0","0","0","0","0","0","0","26","21","5","0","0","0","2","1","1","0","0","0","0","0","0","0","0","0","-2"
"241766","Conservatory of Music of Puerto Rico","2012","Tenured, professors","8","4","4","0","0","0","0","0","0","0","0","0","7","4","3","0","0","0","1","0","1","0","0","0","0","0","0","0","0","0","-2"
"241766","Conservatory of Music of Puerto Rico","2012","Tenured, associate professors","8","7","1","0","0","0","0","0","0","0","0","0","7","6","1","0","0","0","1","1","0","0","0","0","0","0","0","0","0","0","-2"
"241766","Conservatory of Music of Puerto Rico","2012","Tenured, assistant professors","9","9","0","0","0","0","0","0","0","0","0","0","9","9","0","0","0","0","0","0","0","0","0","0","0","0","0","0","0","0","-2"
"241766","Conservatory of Music of Puerto Rico","2012","Tenured, instructors","3","2","1","0","0","0","0","0","0","0","0","0","3","2","1","0","0","0","0","0","0","0","0","0","0","0","0","0","0","0","-2"
"241766","Conservatory of Music of Puerto Rico","2012","On-Tenure track total","10","8","2","0","0","0","0","0","0","0","0","0","10","8","2","0","0","0","0","0","0","0","0","0","0","0","0","0","0","0","-2"
"241766","Conservatory of Music of Puerto Rico","2012","On-tenure track, assistant professors","6","4","2","0","0","0","0","0","0","0","0","0","6","4","2","0","0","0","0","0","0","0","0","0","0","0","0","0","0","0","-2"
"241766","Conservatory of Music of Puerto Rico","2012","On-tenure track, instructors","4","4","0","0","0","0","0","0","0","0","0","0","4","4","0","0","0","0","0","0","0","0","0","0","0","0","0","0","0","0","-2"
"241766","Conservatory of Music of Puerto Rico","2012","Not on tenure track/No tenure system system total","11","7","4","0","0","0","0","0","0","0","0","0","7","5","2","0","0","0","4","2","2","0","0","0","0","0","0","0","0","0","-2"
"241766","Conservatory of Music of Puerto Rico","2012","Not on tenure/no tenure system, instructors","2","2","0","0","0","0","0","0","0","0","0","0","2","2","0","0","0","0","0","0","0","0","0","0","0","0","0","0","0","0","-2"
"241766","Conservatory of Music of Puerto Rico","2012","Not on tenure/no tenure system, no academic rank","9","5","4","0","0","0","0","0","0","0","0","0","5","3","2","0","0","0","4","2","2","0","0","0","0","0","0","0","0","0","-2"
"241951","Escuela de Artes Plasticas y Diseno de Puerto Rico","2012","Tenured total","13","8","5","0","0","0","0","0","0","0","0","0","13","8","5","0","0","0","0","0","0","0","0","0","0","0","0","0","0","0","-2"
"241951","Escuela de Artes Plasticas y Diseno de Puerto Rico","2012","Tenured, professors","3","2","1","0","0","0","0","0","0","0","0","0","3","2","1","0","0","0","0","0","0","0","0","0","0","0","0","0","0","0","-2"
"241951","Escuela de Artes Plasticas y Diseno de Puerto Rico","2012","Tenured, associate professors","3","1","2","0","0","0","0","0","0","0","0","0","3","1","2","0","0","0","0","0","0","0","0","0","0","0","0","0","0","0","-2"
"241951","Escuela de Artes Plasticas y Diseno de Puerto Rico","2012","Tenured, assistant professors","1","1","0","0","0","0","0","0","0","0","0","0","1","1","0","0","0","0","0","0","0","0","0","0","0","0","0","0","0","0","-2"
"241951","Escuela de Artes Plasticas y Diseno de Puerto Rico","2012","Tenured, instructors","6","4","2","0","0","0","0","0","0","0","0","0","6","4","2","0","0","0","0","0","0","0","0","0","0","0","0","0","0","0","-2"
"241951","Escuela de Artes Plasticas y Diseno de Puerto Rico","2012","On-Tenure track total","2","0","2","0","0","0","0","0","0","0","0","0","2","0","2","0","0","0","0","0","0","0","0","0","0","0","0","0","0","0","-2"
"241951","Escuela de Artes Plasticas y Diseno de Puerto Rico","2012","On-tenure track, instructors","2","0","2","0","0","0","0","0","0","0","0","0","2","0","2","0","0","0","0","0","0","0","0","0","0","0","0","0","0","0","-2"
"242121","Humacao Community College","2012","Not on tenure track/No tenure system system total","9","2","7","0","0","0","0","0","0","0","0","0","9","2","7","0","0","0","0","0","0","0","0","0","0","0","0","0","0","0","-2"
"242121","Humacao Community College","2012","Not on tenure/no tenure system, professors","9","2","7","0","0","0","0","0","0","0","0","0","9","2","7","0","0","0","0","0","0","0","0","0","0","0","0","0","0","0","-2"
"242617","Inter American University of Puerto Rico-San German","2012","Tenured total","79","36","43","0","0","0","0","0","0","1","1","0","77","34","43","0","0","0","1","1","0","0","0","0","0","0","0","0","0","0","-2"
"242617","Inter American University of Puerto Rico-San German","2012","Tenured, professors","23","13","10","0","0","0","0","0","0","0","0","0","23","13","10","0","0","0","0","0","0","0","0","0","0","0","0","0","0","0","-2"
"242617","Inter American University of Puerto Rico-San German","2012","Tenured, associate professors","38","19","19","0","0","0","0","0","0","1","1","0","36","17","19","0","0","0","1","1","0","0","0","0","0","0","0","0","0","0","-2"
"242617","Inter American University of Puerto Rico-San German","2012","Tenured, assistant professors","18","4","14","0","0","0","0","0","0","0","0","0","18","4","14","0","0","0","0","0","0","0","0","0","0","0","0","0","0","0","-2"
"242617","Inter American University of Puerto Rico-San German","2012","On-Tenure track total","33","11","22","0","0","0","0","0","0","0","0","0","33","11","22","0","0","0","0","0","0","0","0","0","0","0","0","0","0","0","-2"
"242617","Inter American University of Puerto Rico-San German","2012","On-tenure track, associate professors","11","4","7","0","0","0","0","0","0","0","0","0","11","4","7","0","0","0","0","0","0","0","0","0","0","0","0","0","0","0","-2"
"242617","Inter American University of Puerto Rico-San German","2012","On-tenure track, assistant professors","19","5","14","0","0","0","0","0","0","0","0","0","19","5","14","0","0","0","0","0","0","0","0","0","0","0","0","0","0","0","-2"
"242617","Inter American University of Puerto Rico-San German","2012","On-tenure track, instructors","3","2","1","0","0","0","0","0","0","0","0","0","3","2","1","0","0","0","0","0","0","0","0","0","0","0","0","0","0","0","-2"
"242617","Inter American University of Puerto Rico-San German","2012","Not on tenure track/No tenure system system total","8","3","5","0","0","0","0","0","0","0","0","0","8","3","5","0","0","0","0","0","0","0","0","0","0","0","0","0","0","0","-2"
"242617","Inter American University of Puerto Rico-San German","2012","Not on tenure/no tenure system, assistant professors","4","2","2","0","0","0","0","0","0","0","0","0","4","2","2","0","0","0","0","0","0","0","0","0","0","0","0","0","0","0","-2"
"242617","Inter American University of Puerto Rico-San German","2012","Not on tenure/no tenure system, instructors","4","1","3","0","0","0","0","0","0","0","0","0","4","1","3","0","0","0","0","0","0","0","0","0","0","0","0","0","0","0","-2"
"242626","Inter American University of Puerto Rico-Aguadilla","2012","Tenured total","65","28","37","0","0","0","1","0","1","0","0","0","64","28","36","0","0","0","0","0","0","0","0","0","0","0","0","0","0","0","-2"
"242626","Inter American University of Puerto Rico-Aguadilla","2012","Tenured, professors","11","4","7","0","0","0","0","0","0","0","0","0","11","4","7","0","0","0","0","0","0","0","0","0","0","0","0","0","0","0","-2"
"242626","Inter American University of Puerto Rico-Aguadilla","2012","Tenured, associate professors","26","6","20","0","0","0","1","0","1","0","0","0","25","6","19","0","0","0","0","0","0","0","0","0","0","0","0","0","0","0","-2"
"242626","Inter American University of Puerto Rico-Aguadilla","2012","Tenured, assistant professors","27","17","10","0","0","0","0","0","0","0","0","0","27","17","10","0","0","0","0","0","0","0","0","0","0","0","0","0","0","0","-2"
"242626","Inter American University of Puerto Rico-Aguadilla","2012","Tenured, instructors","1","1","0","0","0","0","0","0","0","0","0","0","1","1","0","0","0","0","0","0","0","0","0","0","0","0","0","0","0","0","-2"
"242626","Inter American University of Puerto Rico-Aguadilla","2012","On-Tenure track total","9","1","8","0","0","0","0","0","0","0","0","0","9","1","8","0","0","0","0","0","0","0","0","0","0","0","0","0","0","0","-2"
"242626","Inter American University of Puerto Rico-Aguadilla","2012","On-tenure track, associate professors","4","0","4","0","0","0","0","0","0","0","0","0","4","0","4","0","0","0","0","0","0","0","0","0","0","0","0","0","0","0","-2"
"242626","Inter American University of Puerto Rico-Aguadilla","2012","On-tenure track, assistant professors","2","1","1","0","0","0","0","0","0","0","0","0","2","1","1","0","0","0","0","0","0","0","0","0","0","0","0","0","0","0","-2"
"242626","Inter American University of Puerto Rico-Aguadilla","2012","On-tenure track, instructors","3","0","3","0","0","0","0","0","0","0","0","0","3","0","3","0","0","0","0","0","0","0","0","0","0","0","0","0","0","0","-2"
"242626","Inter American University of Puerto Rico-Aguadilla","2012","Not on tenure track/No tenure system system total","5","2","3","0","0","0","0","0","0","0","0","0","5","2","3","0","0","0","0","0","0","0","0","0","0","0","0","0","0","0","-2"
"242626","Inter American University of Puerto Rico-Aguadilla","2012","Not on tenure/no tenure system, assistant professors","2","0","2","0","0","0","0","0","0","0","0","0","2","0","2","0","0","0","0","0","0","0","0","0","0","0","0","0","0","0","-2"
"242626","Inter American University of Puerto Rico-Aguadilla","2012","Not on tenure/no tenure system, instructors","3","2","1","0","0","0","0","0","0","0","0","0","3","2","1","0","0","0","0","0","0","0","0","0","0","0","0","0","0","0","-2"
"242635","Inter American University of Puerto Rico-Arecibo","2012","Tenured total","58","31","27","0","0","0","0","0","0","0","0","0","58","31","27","0","0","0","0","0","0","0","0","0","0","0","0","0","0","0","-2"
"242635","Inter American University of Puerto Rico-Arecibo","2012","Tenured, professors","19","10","9","0","0","0","0","0","0","0","0","0","19","10","9","0","0","0","0","0","0","0","0","0","0","0","0","0","0","0","-2"
"242635","Inter American University of Puerto Rico-Arecibo","2012","Tenured, associate professors","18","11","7","0","0","0","0","0","0","0","0","0","18","11","7","0","0","0","0","0","0","0","0","0","0","0","0","0","0","0","-2"
"242635","Inter American University of Puerto Rico-Arecibo","2012","Tenured, assistant professors","20","10","10","0","0","0","0","0","0","0","0","0","20","10","10","0","0","0","0","0","0","0","0","0","0","0","0","0","0","0","-2"
"242635","Inter American University of Puerto Rico-Arecibo","2012","Tenured, instructors","1","0","1","0","0","0","0","0","0","0","0","0","1","0","1","0","0","0","0","0","0","0","0","0","0","0","0","0","0","0","-2"
"242635","Inter American University of Puerto Rico-Arecibo","2012","On-Tenure track total","24","10","14","0","0","0","0","0","0","0","0","0","24","10","14","0","0","0","0","0","0","0","0","0","0","0","0","0","0","0","-2"
"242635","Inter American University of Puerto Rico-Arecibo","2012","On-tenure track, professors","1","0","1","0","0","0","0","0","0","0","0","0","1","0","1","0","0","0","0","0","0","0","0","0","0","0","0","0","0","0","-2"
"242635","Inter American University of Puerto Rico-Arecibo","2012","On-tenure track, associate professors","7","3","4","0","0","0","0","0","0","0","0","0","7","3","4","0","0","0","0","0","0","0","0","0","0","0","0","0","0","0","-2"
"242635","Inter American University of Puerto Rico-Arecibo","2012","On-tenure track, assistant professors","10","5","5","0","0","0","0","0","0","0","0","0","10","5","5","0","0","0","0","0","0","0","0","0","0","0","0","0","0","0","-2"
"242635","Inter American University of Puerto Rico-Arecibo","2012","On-tenure track, instructors","6","2","4","0","0","0","0","0","0","0","0","0","6","2","4","0","0","0","0","0","0","0","0","0","0","0","0","0","0","0","-2"
"242635","Inter American University of Puerto Rico-Arecibo","2012","Not on tenure track/No tenure system system total","12","4","8","0","0","0","0","0","0","0","0","0","12","4","8","0","0","0","0","0","0","0","0","0","0","0","0","0","0","0","-2"
"242635","Inter American University of Puerto Rico-Arecibo","2012","Not on tenure/no tenure system, assistant professors","5","2","3","0","0","0","0","0","0","0","0","0","5","2","3","0","0","0","0","0","0","0","0","0","0","0","0","0","0","0","-2"
"242635","Inter American University of Puerto Rico-Arecibo","2012","Not on tenure/no tenure system, instructors","7","2","5","0","0","0","0","0","0","0","0","0","7","2","5","0","0","0","0","0","0","0","0","0","0","0","0","0","0","0","-2"
"242644","Inter American University of Puerto Rico-Barranquitas","2012","Tenured total","18","8","10","0","0","0","0","0","0","0","0","0","18","8","10","0","0","0","0","0","0","0","0","0","0","0","0","0","0","0","-2"
"242644","Inter American University of Puerto Rico-Barranquitas","2012","Tenured, professors","2","2","0","0","0","0","0","0","0","0","0","0","2","2","0","0","0","0","0","0","0","0","0","0","0","0","0","0","0","0","-2"
"242644","Inter American University of Puerto Rico-Barranquitas","2012","Tenured, associate professors","7","2","5","0","0","0","0","0","0","0","0","0","7","2","5","0","0","0","0","0","0","0","0","0","0","0","0","0","0","0","-2"
"242644","Inter American University of Puerto Rico-Barranquitas","2012","Tenured, assistant professors","9","4","5","0","0","0","0","0","0","0","0","0","9","4","5","0","0","0","0","0","0","0","0","0","0","0","0","0","0","0","-2"
"242644","Inter American University of Puerto Rico-Barranquitas","2012","On-Tenure track total","8","3","5","0","0","0","0","0","0","0","0","0","8","3","5","0","0","0","0","0","0","0","0","0","0","0","0","0","0","0","-2"
"242644","Inter American University of Puerto Rico-Barranquitas","2012","On-tenure track, associate professors","1","0","1","0","0","0","0","0","0","0","0","0","1","0","1","0","0","0","0","0","0","0","0","0","0","0","0","0","0","0","-2"
"242644","Inter American University of Puerto Rico-Barranquitas","2012","On-tenure track, assistant professors","6","2","4","0","0","0","0","0","0","0","0","0","6","2","4","0","0","0","0","0","0","0","0","0","0","0","0","0","0","0","-2"
"242644","Inter American University of Puerto Rico-Barranquitas","2012","On-tenure track, instructors","1","1","0","0","0","0","0","0","0","0","0","0","1","1","0","0","0","0","0","0","0","0","0","0","0","0","0","0","0","0","-2"
"242644","Inter American University of Puerto Rico-Barranquitas","2012","Not on tenure track/No tenure system system total","11","4","7","0","0","0","0","0","0","0","0","0","11","4","7","0","0","0","0","0","0","0","0","0","0","0","0","0","0","0","-2"
"242644","Inter American University of Puerto Rico-Barranquitas","2012","Not on tenure/no tenure system, associate professors","1","1","0","0","0","0","0","0","0","0","0","0","1","1","0","0","0","0","0","0","0","0","0","0","0","0","0","0","0","0","-2"
"242644","Inter American University of Puerto Rico-Barranquitas","2012","Not on tenure/no tenure system, assistant professors","1","1","0","0","0","0","0","0","0","0","0","0","1","1","0","0","0","0","0","0","0","0","0","0","0","0","0","0","0","0","-2"
"242644","Inter American University of Puerto Rico-Barranquitas","2012","Not on tenure/no tenure system, instructors","9","2","7","0","0","0","0","0","0","0","0","0","9","2","7","0","0","0","0","0","0","0","0","0","0","0","0","0","0","0","-2"
"242653","Inter American University of Puerto Rico-Metro","2012","Tenured total","174","76","98","0","0","0","0","0","0","1","1","0","170","72","98","3","3","0","0","0","0","0","0","0","0","0","0","0","0","0","-2"
"242653","Inter American University of Puerto Rico-Metro","2012","Tenured, professors","80","34","46","0","0","0","0","0","0","0","0","0","77","31","46","3","3","0","0","0","0","0","0","0","0","0","0","0","0","0","-2"
"242653","Inter American University of Puerto Rico-Metro","2012","Tenured, associate professors","80","36","44","0","0","0","0","0","0","1","1","0","79","35","44","0","0","0","0","0","0","0","0","0","0","0","0","0","0","0","-2"
"242653","Inter American University of Puerto Rico-Metro","2012","Tenured, assistant professors","14","6","8","0","0","0","0","0","0","0","0","0","14","6","8","0","0","0","0","0","0","0","0","0","0","0","0","0","0","0","-2"
"242653","Inter American University of Puerto Rico-Metro","2012","On-Tenure track total","21","15","6","0","0","0","0","0","0","0","0","0","21","15","6","0","0","0","0","0","0","0","0","0","0","0","0","0","0","0","-2"
"242653","Inter American University of Puerto Rico-Metro","2012","On-tenure track, professors","8","6","2","0","0","0","0","0","0","0","0","0","8","6","2","0","0","0","0","0","0","0","0","0","0","0","0","0","0","0","-2"
"242653","Inter American University of Puerto Rico-Metro","2012","On-tenure track, associate professors","4","3","1","0","0","0","0","0","0","0","0","0","4","3","1","0","0","0","0","0","0","0","0","0","0","0","0","0","0","0","-2"
"242653","Inter American University of Puerto Rico-Metro","2012","On-tenure track, assistant professors","8","6","2","0","0","0","0","0","0","0","0","0","8","6","2","0","0","0","0","0","0","0","0","0","0","0","0","0","0","0","-2"
"242653","Inter American University of Puerto Rico-Metro","2012","On-tenure track, instructors","1","0","1","0","0","0","0","0","0","0","0","0","1","0","1","0","0","0","0","0","0","0","0","0","0","0","0","0","0","0","-2"
"242653","Inter American University of Puerto Rico-Metro","2012","Not on tenure track/No tenure system system total","21","7","14","0","0","0","0","0","0","0","0","0","21","7","14","0","0","0","0","0","0","0","0","0","0","0","0","0","0","0","-2"
"242653","Inter American University of Puerto Rico-Metro","2012","Not on tenure/no tenure system, professors","1","1","0","0","0","0","0","0","0","0","0","0","1","1","0","0","0","0","0","0","0","0","0","0","0","0","0","0","0","0","-2"
"242653","Inter American University of Puerto Rico-Metro","2012","Not on tenure/no tenure system, associate professors","2","1","1","0","0","0","0","0","0","0","0","0","2","1","1","0","0","0","0","0","0","0","0","0","0","0","0","0","0","0","-2"
"242653","Inter American University of Puerto Rico-Metro","2012","Not on tenure/no tenure system, assistant professors","8","4","4","0","0","0","0","0","0","0","0","0","8","4","4","0","0","0","0","0","0","0","0","0","0","0","0","0","0","0","-2"
"242653","Inter American University of Puerto Rico-Metro","2012","Not on tenure/no tenure system, instructors","10","1","9","0","0","0","0","0","0","0","0","0","10","1","9","0","0","0","0","0","0","0","0","0","0","0","0","0","0","0","-2"
"242662","Inter American University of Puerto Rico-Ponce","2012","Tenured total","60","32","28","0","0","0","0","0","0","0","0","0","60","32","28","0","0","0","0","0","0","0","0","0","0","0","0","0","0","0","-2"
"242662","Inter American University of Puerto Rico-Ponce","2012","Tenured, professors","11","5","6","0","0","0","0","0","0","0","0","0","11","5","6","0","0","0","0","0","0","0","0","0","0","0","0","0","0","0","-2"
"242662","Inter American University of Puerto Rico-Ponce","2012","Tenured, associate professors","24","12","12","0","0","0","0","0","0","0","0","0","24","12","12","0","0","0","0","0","0","0","0","0","0","0","0","0","0","0","-2"
"242662","Inter American University of Puerto Rico-Ponce","2012","Tenured, assistant professors","20","12","8","0","0","0","0","0","0","0","0","0","20","12","8","0","0","0","0","0","0","0","0","0","0","0","0","0","0","0","-2"
"242662","Inter American University of Puerto Rico-Ponce","2012","Tenured, instructors","5","3","2","0","0","0","0","0","0","0","0","0","5","3","2","0","0","0","0","0","0","0","0","0","0","0","0","0","0","0","-2"
"242662","Inter American University of Puerto Rico-Ponce","2012","On-Tenure track total","11","5","6","0","0","0","0","0","0","0","0","0","11","5","6","0","0","0","0","0","0","0","0","0","0","0","0","0","0","0","-2"
"242662","Inter American University of Puerto Rico-Ponce","2012","On-tenure track, professors","1","0","1","0","0","0","0","0","0","0","0","0","1","0","1","0","0","0","0","0","0","0","0","0","0","0","0","0","0","0","-2"
"242662","Inter American University of Puerto Rico-Ponce","2012","On-tenure track, associate professors","5","4","1","0","0","0","0","0","0","0","0","0","5","4","1","0","0","0","0","0","0","0","0","0","0","0","0","0","0","0","-2"
"242662","Inter American University of Puerto Rico-Ponce","2012","On-tenure track, assistant professors","4","1","3","0","0","0","0","0","0","0","0","0","4","1","3","0","0","0","0","0","0","0","0","0","0","0","0","0","0","0","-2"
"242662","Inter American University of Puerto Rico-Ponce","2012","On-tenure track, instructors","1","0","1","0","0","0","0","0","0","0","0","0","1","0","1","0","0","0","0","0","0","0","0","0","0","0","0","0","0","0","-2"
"242662","Inter American University of Puerto Rico-Ponce","2012","Not on tenure track/No tenure system system total","25","5","20","0","0","0","0","0","0","0","0","0","25","5","20","0","0","0","0","0","0","0","0","0","0","0","0","0","0","0","-2"
"242662","Inter American University of Puerto Rico-Ponce","2012","Not on tenure/no tenure system, professors","2","0","2","0","0","0","0","0","0","0","0","0","2","0","2","0","0","0","0","0","0","0","0","0","0","0","0","0","0","0","-2"
"242662","Inter American University of Puerto Rico-Ponce","2012","Not on tenure/no tenure system, associate professors","3","1","2","0","0","0","0","0","0","0","0","0","3","1","2","0","0","0","0","0","0","0","0","0","0","0","0","0","0","0","-2"
"242662","Inter American University of Puerto Rico-Ponce","2012","Not on tenure/no tenure system, assistant professors","13","2","11","0","0","0","0","0","0","0","0","0","13","2","11","0","0","0","0","0","0","0","0","0","0","0","0","0","0","0","-2"
"242662","Inter American University of Puerto Rico-Ponce","2012","Not on tenure/no tenure system, instructors","7","2","5","0","0","0","0","0","0","0","0","0","7","2","5","0","0","0","0","0","0","0","0","0","0","0","0","0","0","0","-2"
"242680","Inter American University of Puerto Rico-Fajardo","2012","Tenured total","23","7","16","0","0","0","0","0","0","0","0","0","23","7","16","0","0","0","0","0","0","0","0","0","0","0","0","0","0","0","-2"
"242680","Inter American University of Puerto Rico-Fajardo","2012","Tenured, professors","4","2","2","0","0","0","0","0","0","0","0","0","4","2","2","0","0","0","0","0","0","0","0","0","0","0","0","0","0","0","-2"
"242680","Inter American University of Puerto Rico-Fajardo","2012","Tenured, associate professors","9","4","5","0","0","0","0","0","0","0","0","0","9","4","5","0","0","0","0","0","0","0","0","0","0","0","0","0","0","0","-2"
"242680","Inter American University of Puerto Rico-Fajardo","2012","Tenured, assistant professors","10","1","9","0","0","0","0","0","0","0","0","0","10","1","9","0","0","0","0","0","0","0","0","0","0","0","0","0","0","0","-2"
"242680","Inter American University of Puerto Rico-Fajardo","2012","On-Tenure track total","12","8","4","0","0","0","0","0","0","0","0","0","12","8","4","0","0","0","0","0","0","0","0","0","0","0","0","0","0","0","-2"
"242680","Inter American University of Puerto Rico-Fajardo","2012","On-tenure track, associate professors","1","0","1","0","0","0","0","0","0","0","0","0","1","0","1","0","0","0","0","0","0","0","0","0","0","0","0","0","0","0","-2"
"242680","Inter American University of Puerto Rico-Fajardo","2012","On-tenure track, assistant professors","9","6","3","0","0","0","0","0","0","0","0","0","9","6","3","0","0","0","0","0","0","0","0","0","0","0","0","0","0","0","-2"
"242680","Inter American University of Puerto Rico-Fajardo","2012","On-tenure track, instructors","2","2","0","0","0","0","0","0","0","0","0","0","2","2","0","0","0","0","0","0","0","0","0","0","0","0","0","0","0","0","-2"
"242680","Inter American University of Puerto Rico-Fajardo","2012","Not on tenure track/No tenure system system total","4","0","4","0","0","0","0","0","0","0","0","0","4","0","4","0","0","0","0","0","0","0","0","0","0","0","0","0","0","0","-2"
"242680","Inter American University of Puerto Rico-Fajardo","2012","Not on tenure/no tenure system, instructors","4","0","4","0","0","0","0","0","0","0","0","0","4","0","4","0","0","0","0","0","0","0","0","0","0","0","0","0","0","0","-2"
"242699","Inter American University of Puerto Rico-Guayama","2012","Tenured total","27","15","12","0","0","0","0","0","0","0","0","0","27","15","12","0","0","0","0","0","0","0","0","0","0","0","0","0","0","0","-2"
"242699","Inter American University of Puerto Rico-Guayama","2012","Tenured, professors","6","4","2","0","0","0","0","0","0","0","0","0","6","4","2","0","0","0","0","0","0","0","0","0","0","0","0","0","0","0","-2"
"242699","Inter American University of Puerto Rico-Guayama","2012","Tenured, associate professors","7","4","3","0","0","0","0","0","0","0","0","0","7","4","3","0","0","0","0","0","0","0","0","0","0","0","0","0","0","0","-2"
"242699","Inter American University of Puerto Rico-Guayama","2012","Tenured, assistant professors","14","7","7","0","0","0","0","0","0","0","0","0","14","7","7","0","0","0","0","0","0","0","0","0","0","0","0","0","0","0","-2"
"242699","Inter American University of Puerto Rico-Guayama","2012","On-Tenure track total","9","2","7","0","0","0","0","0","0","0","0","0","9","2","7","0","0","0","0","0","0","0","0","0","0","0","0","0","0","0","-2"
"242699","Inter American University of Puerto Rico-Guayama","2012","On-tenure track, associate professors","2","1","1","0","0","0","0","0","0","0","0","0","2","1","1","0","0","0","0","0","0","0","0","0","0","0","0","0","0","0","-2"
"242699","Inter American University of Puerto Rico-Guayama","2012","On-tenure track, assistant professors","6","1","5","0","0","0","0","0","0","0","0","0","6","1","5","0","0","0","0","0","0","0","0","0","0","0","0","0","0","0","-2"
"242699","Inter American University of Puerto Rico-Guayama","2012","On-tenure track, instructors","1","0","1","0","0","0","0","0","0","0","0","0","1","0","1","0","0","0","0","0","0","0","0","0","0","0","0","0","0","0","-2"
"242699","Inter American University of Puerto Rico-Guayama","2012","Not on tenure track/No tenure system system total","6","4","2","0","0","0","0","0","0","0","0","0","6","4","2","0","0","0","0","0","0","0","0","0","0","0","0","0","0","0","-2"
"242699","Inter American University of Puerto Rico-Guayama","2012","Not on tenure/no tenure system, associate professors","2","1","1","0","0","0","0","0","0","0","0","0","2","1","1","0","0","0","0","0","0","0","0","0","0","0","0","0","0","0","-2"
"242699","Inter American University of Puerto Rico-Guayama","2012","Not on tenure/no tenure system, assistant professors","1","0","1","0","0","0","0","0","0","0","0","0","1","0","1","0","0","0","0","0","0","0","0","0","0","0","0","0","0","0","-2"
"242699","Inter American University of Puerto Rico-Guayama","2012","Not on tenure/no tenure system, instructors","3","3","0","0","0","0","0","0","0","0","0","0","3","3","0","0","0","0","0","0","0","0","0","0","0","0","0","0","0","0","-2"
"242705","Inter American University of Puerto Rico-Bayamon","2012","Tenured total","54","27","27","0","0","0","0","0","0","0","0","0","54","27","27","0","0","0","0","0","0","0","0","0","0","0","0","0","0","0","-2"
"242705","Inter American University of Puerto Rico-Bayamon","2012","Tenured, professors","9","8","1","0","0","0","0","0","0","0","0","0","9","8","1","0","0","0","0","0","0","0","0","0","0","0","0","0","0","0","-2"
"242705","Inter American University of Puerto Rico-Bayamon","2012","Tenured, associate professors","21","8","13","0","0","0","0","0","0","0","0","0","21","8","13","0","0","0","0","0","0","0","0","0","0","0","0","0","0","0","-2"
"242705","Inter American University of Puerto Rico-Bayamon","2012","Tenured, assistant professors","24","11","13","0","0","0","0","0","0","0","0","0","24","11","13","0","0","0","0","0","0","0","0","0","0","0","0","0","0","0","-2"
"242705","Inter American University of Puerto Rico-Bayamon","2012","On-Tenure track total","23","16","7","0","0","0","0","0","0","0","0","0","23","16","7","0","0","0","0","0","0","0","0","0","0","0","0","0","0","0","-2"
"242705","Inter American University of Puerto Rico-Bayamon","2012","On-tenure track, associate professors","5","5","0","0","0","0","0","0","0","0","0","0","5","5","0","0","0","0","0","0","0","0","0","0","0","0","0","0","0","0","-2"
"242705","Inter American University of Puerto Rico-Bayamon","2012","On-tenure track, assistant professors","12","8","4","0","0","0","0","0","0","0","0","0","12","8","4","0","0","0","0","0","0","0","0","0","0","0","0","0","0","0","-2"
"242705","Inter American University of Puerto Rico-Bayamon","2012","On-tenure track, instructors","6","3","3","0","0","0","0","0","0","0","0","0","6","3","3","0","0","0","0","0","0","0","0","0","0","0","0","0","0","0","-2"
"242705","Inter American University of Puerto Rico-Bayamon","2012","Not on tenure track/No tenure system system total","20","12","8","0","0","0","0","0","0","0","0","0","20","12","8","0","0","0","0","0","0","0","0","0","0","0","0","0","0","0","-2"
"242705","Inter American University of Puerto Rico-Bayamon","2012","Not on tenure/no tenure system, associate professors","2","2","0","0","0","0","0","0","0","0","0","0","2","2","0","0","0","0","0","0","0","0","0","0","0","0","0","0","0","0","-2"
"242705","Inter American University of Puerto Rico-Bayamon","2012","Not on tenure/no tenure system, assistant professors","7","3","4","0","0","0","0","0","0","0","0","0","7","3","4","0","0","0","0","0","0","0","0","0","0","0","0","0","0","0","-2"
"242705","Inter American University of Puerto Rico-Bayamon","2012","Not on tenure/no tenure system, instructors","11","7","4","0","0","0","0","0","0","0","0","0","11","7","4","0","0","0","0","0","0","0","0","0","0","0","0","0","0","0","-2"
"243115","University of Puerto Rico-Arecibo","2012","Tenured total","153","72","81","0","0","0","0","0","0","0","0","0","153","72","81","0","0","0","0","0","0","0","0","0","0","0","0","0","0","0","-2"
"243115","University of Puerto Rico-Arecibo","2012","Tenured, professors","63","31","32","0","0","0","0","0","0","0","0","0","63","31","32","0","0","0","0","0","0","0","0","0","0","0","0","0","0","0","-2"
"243115","University of Puerto Rico-Arecibo","2012","Tenured, associate professors","50","21","29","0","0","0","0","0","0","0","0","0","50","21","29","0","0","0","0","0","0","0","0","0","0","0","0","0","0","0","-2"
"243115","University of Puerto Rico-Arecibo","2012","Tenured, assistant professors","34","16","18","0","0","0","0","0","0","0","0","0","34","16","18","0","0","0","0","0","0","0","0","0","0","0","0","0","0","0","-2"
"243115","University of Puerto Rico-Arecibo","2012","Tenured, instructors","6","4","2","0","0","0","0","0","0","0","0","0","6","4","2","0","0","0","0","0","0","0","0","0","0","0","0","0","0","0","-2"
"243115","University of Puerto Rico-Arecibo","2012","On-Tenure track total","10","3","7","0","0","0","0","0","0","0","0","0","10","3","7","0","0","0","0","0","0","0","0","0","0","0","0","0","0","0","-2"
"243115","University of Puerto Rico-Arecibo","2012","On-tenure track, assistant professors","6","1","5","0","0","0","0","0","0","0","0","0","6","1","5","0","0","0","0","0","0","0","0","0","0","0","0","0","0","0","-2"
"243115","University of Puerto Rico-Arecibo","2012","On-tenure track, instructors","4","2","2","0","0","0","0","0","0","0","0","0","4","2","2","0","0","0","0","0","0","0","0","0","0","0","0","0","0","0","-2"
"243115","University of Puerto Rico-Arecibo","2012","Not on tenure track/No tenure system system total","18","8","10","0","0","0","0","0","0","0","0","0","18","8","10","0","0","0","0","0","0","0","0","0","0","0","0","0","0","0","-2"
"243115","University of Puerto Rico-Arecibo","2012","Not on tenure/no tenure system, instructors","18","8","10","0","0","0","0","0","0","0","0","0","18","8","10","0","0","0","0","0","0","0","0","0","0","0","0","0","0","0","-2"
"243142","University of Puerto Rico-Carolina","2012","Tenured total","84","45","39","0","0","0","0","0","0","0","0","0","71","38","33","0","0","0","0","0","0","0","0","0","13","7","6","0","0","0","-2"
"243142","University of Puerto Rico-Carolina","2012","Tenured, professors","19","9","10","0","0","0","0","0","0","0","0","0","16","7","9","0","0","0","0","0","0","0","0","0","3","2","1","0","0","0","-2"
"243142","University of Puerto Rico-Carolina","2012","Tenured, associate professors","39","21","18","0","0","0","0","0","0","0","0","0","30","16","14","0","0","0","0","0","0","0","0","0","9","5","4","0","0","0","-2"
"243142","University of Puerto Rico-Carolina","2012","Tenured, assistant professors","20","11","9","0","0","0","0","0","0","0","0","0","20","11","9","0","0","0","0","0","0","0","0","0","0","0","0","0","0","0","-2"
"243142","University of Puerto Rico-Carolina","2012","Tenured, instructors","6","4","2","0","0","0","0","0","0","0","0","0","5","4","1","0","0","0","0","0","0","0","0","0","1","0","1","0","0","0","-2"
"243142","University of Puerto Rico-Carolina","2012","On-Tenure track total","17","9","8","0","0","0","0","0","0","0","0","0","16","8","8","0","0","0","0","0","0","0","0","0","1","1","0","0","0","0","-2"
"243142","University of Puerto Rico-Carolina","2012","On-tenure track, associate professors","1","1","0","0","0","0","0","0","0","0","0","0","1","1","0","0","0","0","0","0","0","0","0","0","0","0","0","0","0","0","-2"
"243142","University of Puerto Rico-Carolina","2012","On-tenure track, assistant professors","8","6","2","0","0","0","0","0","0","0","0","0","7","5","2","0","0","0","0","0","0","0","0","0","1","1","0","0","0","0","-2"
"243142","University of Puerto Rico-Carolina","2012","On-tenure track, instructors","8","2","6","0","0","0","0","0","0","0","0","0","8","2","6","0","0","0","0","0","0","0","0","0","0","0","0","0","0","0","-2"
"243142","University of Puerto Rico-Carolina","2012","Not on tenure track/No tenure system system total","26","15","11","0","0","0","0","0","0","0","0","0","25","15","10","0","0","0","0","0","0","0","0","0","1","0","1","0","0","0","-2"
"243142","University of Puerto Rico-Carolina","2012","Not on tenure/no tenure system, assistant professors","1","1","0","0","0","0","0","0","0","0","0","0","1","1","0","0","0","0","0","0","0","0","0","0","0","0","0","0","0","0","-2"
"243142","University of Puerto Rico-Carolina","2012","Not on tenure/no tenure system, instructors","25","14","11","0","0","0","0","0","0","0","0","0","24","14","10","0","0","0","0","0","0","0","0","0","1","0","1","0","0","0","-2"
"243179","University of Puerto Rico-Humacao","2012","Tenured total","178","86","92","0","0","0","1","1","0","0","0","0","117","49","68","0","0","0","2","1","1","1","1","0","57","34","23","0","0","0","-2"
"243179","University of Puerto Rico-Humacao","2012","Tenured, professors","98","51","47","0","0","0","1","1","0","0","0","0","59","25","34","0","0","0","2","1","1","1","1","0","35","23","12","0","0","0","-2"
"243179","University of Puerto Rico-Humacao","2012","Tenured, associate professors","57","21","36","0","0","0","0","0","0","0","0","0","41","14","27","0","0","0","0","0","0","0","0","0","16","7","9","0","0","0","-2"
"243179","University of Puerto Rico-Humacao","2012","Tenured, assistant professors","22","13","9","0","0","0","0","0","0","0","0","0","17","10","7","0","0","0","0","0","0","0","0","0","5","3","2","0","0","0","-2"
"243179","University of Puerto Rico-Humacao","2012","Tenured, instructors","1","1","0","0","0","0","0","0","0","0","0","0","0","0","0","0","0","0","0","0","0","0","0","0","1","1","0","0","0","0","-2"
"243179","University of Puerto Rico-Humacao","2012","On-Tenure track total","14","8","6","0","0","0","0","0","0","1","0","1","10","7","3","0","0","0","0","0","0","0","0","0","2","0","2","1","1","0","-2"
"243179","University of Puerto Rico-Humacao","2012","On-tenure track, assistant professors","14","8","6","0","0","0","0","0","0","1","0","1","10","7","3","0","0","0","0","0","0","0","0","0","2","0","2","1","1","0","-2"
"243179","University of Puerto Rico-Humacao","2012","Not on tenure track/No tenure system system total","17","4","13","0","0","0","0","0","0","0","0","0","12","1","11","0","0","0","0","0","0","0","0","0","5","3","2","0","0","0","-2"
"243179","University of Puerto Rico-Humacao","2012","Not on tenure/no tenure system, assistant professors","3","1","2","0","0","0","0","0","0","0","0","0","2","0","2","0","0","0","0","0","0","0","0","0","1","1","0","0","0","0","-2"
"243179","University of Puerto Rico-Humacao","2012","Not on tenure/no tenure system, instructors","14","3","11","0","0","0","0","0","0","0","0","0","10","1","9","0","0","0","0","0","0","0","0","0","4","2","2","0","0","0","-2"
"243188","University of Puerto Rico-Utuado","2012","Tenured total","47","26","21","0","0","0","0","0","0","0","0","0","41","22","19","0","0","0","0","0","0","0","0","0","6","4","2","0","0","0","-2"
"243188","University of Puerto Rico-Utuado","2012","Tenured, professors","14","9","5","0","0","0","0","0","0","0","0","0","13","8","5","0","0","0","0","0","0","0","0","0","1","1","0","0","0","0","-2"
"243188","University of Puerto Rico-Utuado","2012","Tenured, associate professors","17","8","9","0","0","0","0","0","0","0","0","0","16","7","9","0","0","0","0","0","0","0","0","0","1","1","0","0","0","0","-2"
"243188","University of Puerto Rico-Utuado","2012","Tenured, assistant professors","14","7","7","0","0","0","0","0","0","0","0","0","10","5","5","0","0","0","0","0","0","0","0","0","4","2","2","0","0","0","-2"
"243188","University of Puerto Rico-Utuado","2012","Tenured, instructors","2","2","0","0","0","0","0","0","0","0","0","0","2","2","0","0","0","0","0","0","0","0","0","0","0","0","0","0","0","0","-2"
"243188","University of Puerto Rico-Utuado","2012","On-Tenure track total","12","7","5","0","0","0","0","0","0","0","0","0","12","7","5","0","0","0","0","0","0","0","0","0","0","0","0","0","0","0","-2"
"243188","University of Puerto Rico-Utuado","2012","On-tenure track, assistant professors","10","7","3","0","0","0","0","0","0","0","0","0","10","7","3","0","0","0","0","0","0","0","0","0","0","0","0","0","0","0","-2"
"243188","University of Puerto Rico-Utuado","2012","On-tenure track, instructors","2","0","2","0","0","0","0","0","0","0","0","0","2","0","2","0","0","0","0","0","0","0","0","0","0","0","0","0","0","0","-2"
"243188","University of Puerto Rico-Utuado","2012","Not on tenure track/No tenure system system total","10","4","6","0","0","0","0","0","0","0","0","0","8","3","5","0","0","0","0","0","0","0","0","0","2","1","1","0","0","0","-2"
"243188","University of Puerto Rico-Utuado","2012","Not on tenure/no tenure system, associate professors","1","0","1","0","0","0","0","0","0","0","0","0","0","0","0","0","0","0","0","0","0","0","0","0","1","0","1","0","0","0","-2"
"243188","University of Puerto Rico-Utuado","2012","Not on tenure/no tenure system, assistant professors","1","0","1","0","0","0","0","0","0","0","0","0","1","0","1","0","0","0","0","0","0","0","0","0","0","0","0","0","0","0","-2"
"243188","University of Puerto Rico-Utuado","2012","Not on tenure/no tenure system, instructors","8","4","4","0","0","0","0","0","0","0","0","0","7","3","4","0","0","0","0","0","0","0","0","0","1","1","0","0","0","0","-2"
"243212","University of Puerto Rico-Ponce","2012","Tenured total","97","40","57","0","0","0","0","0","0","0","0","0","93","38","55","0","0","0","0","0","0","0","0","0","4","2","2","0","0","0","-2"
"243212","University of Puerto Rico-Ponce","2012","Tenured, professors","31","10","21","0","0","0","0","0","0","0","0","0","31","10","21","0","0","0","0","0","0","0","0","0","0","0","0","0","0","0","-2"
"243212","University of Puerto Rico-Ponce","2012","Tenured, associate professors","28","14","14","0","0","0","0","0","0","0","0","0","27","14","13","0","0","0","0","0","0","0","0","0","1","0","1","0","0","0","-2"
"243212","University of Puerto Rico-Ponce","2012","Tenured, assistant professors","26","9","17","0","0","0","0","0","0","0","0","0","24","8","16","0","0","0","0","0","0","0","0","0","2","1","1","0","0","0","-2"
"243212","University of Puerto Rico-Ponce","2012","Tenured, instructors","12","7","5","0","0","0","0","0","0","0","0","0","11","6","5","0","0","0","0","0","0","0","0","0","1","1","0","0","0","0","-2"
"243212","University of Puerto Rico-Ponce","2012","On-Tenure track total","6","1","5","0","0","0","0","0","0","0","0","0","6","1","5","0","0","0","0","0","0","0","0","0","0","0","0","0","0","0","-2"
"243212","University of Puerto Rico-Ponce","2012","On-tenure track, associate professors","1","0","1","0","0","0","0","0","0","0","0","0","1","0","1","0","0","0","0","0","0","0","0","0","0","0","0","0","0","0","-2"
"243212","University of Puerto Rico-Ponce","2012","On-tenure track, assistant professors","3","1","2","0","0","0","0","0","0","0","0","0","3","1","2","0","0","0","0","0","0","0","0","0","0","0","0","0","0","0","-2"
"243212","University of Puerto Rico-Ponce","2012","On-tenure track, instructors","2","0","2","0","0","0","0","0","0","0","0","0","2","0","2","0","0","0","0","0","0","0","0","0","0","0","0","0","0","0","-2"
"243212","University of Puerto Rico-Ponce","2012","Not on tenure track/No tenure system system total","24","10","14","0","0","0","0","0","0","0","0","0","24","10","14","0","0","0","0","0","0","0","0","0","0","0","0","0","0","0","-2"
"243212","University of Puerto Rico-Ponce","2012","Not on tenure/no tenure system, assistant professors","1","0","1","0","0","0","0","0","0","0","0","0","1","0","1","0","0","0","0","0","0","0","0","0","0","0","0","0","0","0","-2"
"243212","University of Puerto Rico-Ponce","2012","Not on tenure/no tenure system, instructors","23","10","13","0","0","0","0","0","0","0","0","0","23","10","13","0","0","0","0","0","0","0","0","0","0","0","0","0","0","0","-2"
"243443","Universidad del Sagrado Corazon","2012","Tenured total","94","35","59","0","0","0","1","1","0","0","0","0","91","34","57","0","0","0","2","0","2","0","0","0","0","0","0","0","0","0","-2"
"243443","Universidad del Sagrado Corazon","2012","Tenured, professors","66","22","44","0","0","0","1","1","0","0","0","0","63","21","42","0","0","0","2","0","2","0","0","0","0","0","0","0","0","0","-2"
"243443","Universidad del Sagrado Corazon","2012","Tenured, associate professors","11","7","4","0","0","0","0","0","0","0","0","0","11","7","4","0","0","0","0","0","0","0","0","0","0","0","0","0","0","0","-2"
"243443","Universidad del Sagrado Corazon","2012","Tenured, assistant professors","12","3","9","0","0","0","0","0","0","0","0","0","12","3","9","0","0","0","0","0","0","0","0","0","0","0","0","0","0","0","-2"
"243443","Universidad del Sagrado Corazon","2012","Tenured, instructors","5","3","2","0","0","0","0","0","0","0","0","0","5","3","2","0","0","0","0","0","0","0","0","0","0","0","0","0","0","0","-2"
"243443","Universidad del Sagrado Corazon","2012","On-Tenure track total","9","0","9","0","0","0","0","0","0","0","0","0","9","0","9","0","0","0","0","0","0","0","0","0","0","0","0","0","0","0","-2"
"243443","Universidad del Sagrado Corazon","2012","On-tenure track, associate professors","1","0","1","0","0","0","0","0","0","0","0","0","1","0","1","0","0","0","0","0","0","0","0","0","0","0","0","0","0","0","-2"
"243443","Universidad del Sagrado Corazon","2012","On-tenure track, assistant professors","4","0","4","0","0","0","0","0","0","0","0","0","4","0","4","0","0","0","0","0","0","0","0","0","0","0","0","0","0","0","-2"
"243443","Universidad del Sagrado Corazon","2012","On-tenure track, instructors","4","0","4","0","0","0","0","0","0","0","0","0","4","0","4","0","0","0","0","0","0","0","0","0","0","0","0","0","0","0","-2"
"243577","Universidad Politecnica de Puerto Rico","2012","Tenured total","29","17","12","0","0","0","1","1","0","0","0","0","28","16","12","0","0","0","0","0","0","0","0","0","0","0","0","0","0","0","-2"
"243577","Universidad Politecnica de Puerto Rico","2012","Tenured, professors","19","13","6","0","0","0","1","1","0","0","0","0","18","12","6","0","0","0","0","0","0","0","0","0","0","0","0","0","0","0","-2"
"243577","Universidad Politecnica de Puerto Rico","2012","Tenured, associate professors","10","4","6","0","0","0","0","0","0","0","0","0","10","4","6","0","0","0","0","0","0","0","0","0","0","0","0","0","0","0","-2"
"243577","Universidad Politecnica de Puerto Rico","2012","Not on tenure track/No tenure system system total","119","76","43","0","0","0","0","0","0","0","0","0","116","73","43","0","0","0","3","3","0","0","0","0","0","0","0","0","0","0","-2"
"243577","Universidad Politecnica de Puerto Rico","2012","Not on tenure/no tenure system, professors","18","15","3","0","0","0","0","0","0","0","0","0","17","14","3","0","0","0","1","1","0","0","0","0","0","0","0","0","0","0","-2"
"243577","Universidad Politecnica de Puerto Rico","2012","Not on tenure/no tenure system, associate professors","71","46","25","0","0","0","0","0","0","0","0","0","69","44","25","0","0","0","2","2","0","0","0","0","0","0","0","0","0","0","-2"
"243577","Universidad Politecnica de Puerto Rico","2012","Not on tenure/no tenure system, assistant professors","23","11","12","0","0","0","0","0","0","0","0","0","23","11","12","0","0","0","0","0","0","0","0","0","0","0","0","0","0","0","-2"
"243577","Universidad Politecnica de Puerto Rico","2012","Not on tenure/no tenure system, instructors","7","4","3","0","0","0","0","0","0","0","0","0","7","4","3","0","0","0","0","0","0","0","0","0","0","0","0","0","0","0","-2"
"245953","Mid-America Christian University","2012","Not on tenure track/No tenure system system total","30","18","12","1","1","0","0","0","0","1","1","0","2","1","1","0","0","0","23","13","10","1","1","0","2","1","1","0","0","0","-2"
"245953","Mid-America Christian University","2012","Not on tenure/no tenure system, professors","3","3","0","1","1","0","0","0","0","0","0","0","0","0","0","0","0","0","2","2","0","0","0","0","0","0","0","0","0","0","-2"
"245953","Mid-America Christian University","2012","Not on tenure/no tenure system, associate professors","7","4","3","0","0","0","0","0","0","0","0","0","0","0","0","0","0","0","6","3","3","0","0","0","1","1","0","0","0","0","-2"
"245953","Mid-America Christian University","2012","Not on tenure/no tenure system, assistant professors","11","7","4","0","0","0","0","0","0","0","0","0","1","1","0","0","0","0","8","5","3","1","1","0","1","0","1","0","0","0","-2"
"245953","Mid-America Christian University","2012","Not on tenure/no tenure system, instructors","9","4","5","0","0","0","0","0","0","1","1","0","1","0","1","0","0","0","7","3","4","0","0","0","0","0","0","0","0","0","-2"
"366711","California State University-San Marcos","2012","Tenured total","166","85","81","1","0","1","24","18","6","6","5","1","22","11","11","1","1","0","103","46","57","2","0","2","6","4","2","1","0","1","-2"
"366711","California State University-San Marcos","2012","Tenured, professors","97","44","53","0","0","0","11","7","4","2","1","1","15","8","7","0","0","0","67","27","40","1","0","1","1","1","0","0","0","0","-2"
"366711","California State University-San Marcos","2012","Tenured, associate professors","67","40","27","1","0","1","12","11","1","3","3","0","7","3","4","1","1","0","36","19","17","1","0","1","5","3","2","1","0","1","-2"
"366711","California State University-San Marcos","2012","Tenured, assistant professors","2","1","1","0","0","0","1","0","1","1","1","0","0","0","0","0","0","0","0","0","0","0","0","0","0","0","0","0","0","0","-2"
"366711","California State University-San Marcos","2012","On-Tenure track total","56","22","34","2","1","1","7","5","2","0","0","0","12","2","10","0","0","0","30","12","18","1","0","1","1","0","1","3","2","1","-2"
"366711","California State University-San Marcos","2012","On-tenure track, associate professors","1","1","0","0","0","0","0","0","0","0","0","0","0","0","0","0","0","0","1","1","0","0","0","0","0","0","0","0","0","0","-2"
"366711","California State University-San Marcos","2012","On-tenure track, assistant professors","55","21","34","2","1","1","7","5","2","0","0","0","12","2","10","0","0","0","29","11","18","1","0","1","1","0","1","3","2","1","-2"
"366711","California State University-San Marcos","2012","Not on tenure track/No tenure system system total","67","19","48","0","0","0","3","2","1","1","0","1","5","3","2","0","0","0","55","14","41","1","0","1","2","0","2","0","0","0","-2"
"366711","California State University-San Marcos","2012","Not on tenure/no tenure system, lecturers","67","19","48","0","0","0","3","2","1","1","0","1","5","3","2","0","0","0","55","14","41","1","0","1","2","0","2","0","0","0","-2"
"409698","California State University-Monterey Bay","2012","Tenured total","84","45","39","1","1","0","16","7","9","5","3","2","17","8","9","1","0","1","42","24","18","0","0","0","2","2","0","0","0","0","-2"
"409698","California State University-Monterey Bay","2012","Tenured, professors","49","32","17","1","1","0","11","6","5","2","1","1","10","7","3","1","0","1","24","17","7","0","0","0","0","0","0","0","0","0","-2"
"409698","California State University-Monterey Bay","2012","Tenured, associate professors","31","10","21","0","0","0","5","1","4","2","1","1","7","1","6","0","0","0","15","5","10","0","0","0","2","2","0","0","0","0","-2"
"409698","California State University-Monterey Bay","2012","Tenured, assistant professors","1","1","0","0","0","0","0","0","0","1","1","0","0","0","0","0","0","0","0","0","0","0","0","0","0","0","0","0","0","0","-2"
"409698","California State University-Monterey Bay","2012","Tenured, no academic rank","3","2","1","0","0","0","0","0","0","0","0","0","0","0","0","0","0","0","3","2","1","0","0","0","0","0","0","0","0","0","-2"
"409698","California State University-Monterey Bay","2012","On-Tenure track total","32","12","20","0","0","0","5","2","3","1","1","0","6","4","2","0","0","0","17","4","13","0","0","0","3","1","2","0","0","0","-2"
"409698","California State University-Monterey Bay","2012","On-tenure track, professors","1","1","0","0","0","0","0","0","0","0","0","0","1","1","0","0","0","0","0","0","0","0","0","0","0","0","0","0","0","0","-2"
"409698","California State University-Monterey Bay","2012","On-tenure track, assistant professors","31","11","20","0","0","0","5","2","3","1","1","0","5","3","2","0","0","0","17","4","13","0","0","0","3","1","2","0","0","0","-2"
"409698","California State University-Monterey Bay","2012","Not on tenure track/No tenure system system total","54","16","38","1","0","1","2","1","1","1","0","1","7","1","6","0","0","0","40","14","26","0","0","0","3","0","3","0","0","0","-2"
"409698","California State University-Monterey Bay","2012","Not on tenure/no tenure system, lecturers","54","16","38","1","0","1","2","1","1","1","0","1","7","1","6","0","0","0","40","14","26","0","0","0","3","0","3","0","0","0","-2"
"416801","The University of Texas MD Anderson Cancer Center","2012","Tenured total","226","174","52","0","0","0","44","31","13","5","2","3","15","10","5","0","0","0","162","131","31","0","0","0","0","0","0","0","0","0","-2"
"416801","The University of Texas MD Anderson Cancer Center","2012","Tenured, professors","176","144","32","0","0","0","29","21","8","3","2","1","12","7","5","0","0","0","132","114","18","0","0","0","0","0","0","0","0","0","-2"
"416801","The University of Texas MD Anderson Cancer Center","2012","Tenured, associate professors","50","30","20","0","0","0","15","10","5","2","0","2","3","3","0","0","0","0","30","17","13","0","0","0","0","0","0","0","0","0","-2"
"416801","The University of Texas MD Anderson Cancer Center","2012","On-Tenure track total","80","50","30","0","0","0","24","17","7","4","3","1","8","4","4","0","0","0","44","26","18","0","0","0","0","0","0","0","0","0","-2"
"416801","The University of Texas MD Anderson Cancer Center","2012","On-tenure track, professors","5","1","4","0","0","0","1","0","1","0","0","0","0","0","0","0","0","0","4","1","3","0","0","0","0","0","0","0","0","0","-2"
"416801","The University of Texas MD Anderson Cancer Center","2012","On-tenure track, associate professors","14","10","4","0","0","0","4","2","2","1","1","0","1","1","0","0","0","0","8","6","2","0","0","0","0","0","0","0","0","0","-2"
"416801","The University of Texas MD Anderson Cancer Center","2012","On-tenure track, assistant professors","59","37","22","0","0","0","18","14","4","2","1","1","7","3","4","0","0","0","32","19","13","0","0","0","0","0","0","0","0","0","-2"
"416801","The University of Texas MD Anderson Cancer Center","2012","On-tenure track, lecturers","2","2","0","0","0","0","1","1","0","1","1","0","0","0","0","0","0","0","0","0","0","0","0","0","0","0","0","0","0","0","-2"
"416801","The University of Texas MD Anderson Cancer Center","2012","Not on tenure track/No tenure system system total","561","322","239","2","1","1","203","122","81","27","10","17","44","29","15","2","0","2","283","160","123","0","0","0","0","0","0","0","0","0","-2"
"416801","The University of Texas MD Anderson Cancer Center","2012","Not on tenure/no tenure system, lecturers","561","322","239","2","1","1","203","122","81","27","10","17","44","29","15","2","0","2","283","160","123","0","0","0","0","0","0","0","0","0","-2"
"440794","Pillar College","2012","Tenured total","2","1","1","0","0","0","0","0","0","0","0","0","0","0","0","0","0","0","2","1","1","0","0","0","0","0","0","0","0","0","-2"
"440794","Pillar College","2012","Tenured, professors","2","1","1","0","0","0","0","0","0","0","0","0","0","0","0","0","0","0","2","1","1","0","0","0","0","0","0","0","0","0","-2"
"440794","Pillar College","2012","Not on tenure track/No tenure system system total","6","3","3","0","0","0","1","1","0","3","0","3","0","0","0","0","0","0","2","2","0","0","0","0","0","0","0","0","0","0","-2"
"440794","Pillar College","2012","Not on tenure/no tenure system, professors","1","1","0","0","0","0","1","1","0","0","0","0","0","0","0","0","0","0","0","0","0","0","0","0","0","0","0","0","0","0","-2"
"440794","Pillar College","2012","Not on tenure/no tenure system, associate professors","2","1","1","0","0","0","0","0","0","1","0","1","0","0","0","0","0","0","1","1","0","0","0","0","0","0","0","0","0","0","-2"
"440794","Pillar College","2012","Not on tenure/no tenure system, assistant professors","3","1","2","0","0","0","0","0","0","2","0","2","0","0","0","0","0","0","1","1","0","0","0","0","0","0","0","0","0","0","-2"
"441937","California State University-Channel Islands","2012","Tenured total","67","38","29","0","0","0","3","2","1","1","1","0","12","6","6","0","0","0","46","24","22","1","1","0","3","3","0","1","1","0","-2"
"441937","California State University-Channel Islands","2012","Tenured, professors","34","21","13","0","0","0","1","1","0","0","0","0","4","2","2","0","0","0","27","16","11","1","1","0","1","1","0","0","0","0","-2"
"441937","California State University-Channel Islands","2012","Tenured, associate professors","33","17","16","0","0","0","2","1","1","1","1","0","8","4","4","0","0","0","19","8","11","0","0","0","2","2","0","1","1","0","-2"
"441937","California State University-Channel Islands","2012","On-Tenure track total","16","7","9","0","0","0","2","0","2","0","0","0","2","1","1","0","0","0","10","4","6","0","0","0","1","1","0","1","1","0","-2"
"441937","California State University-Channel Islands","2012","On-tenure track, associate professors","3","1","2","0","0","0","2","0","2","0","0","0","0","0","0","0","0","0","0","0","0","0","0","0","0","0","0","1","1","0","-2"
"441937","California State University-Channel Islands","2012","On-tenure track, assistant professors","13","6","7","0","0","0","0","0","0","0","0","0","2","1","1","0","0","0","10","4","6","0","0","0","1","1","0","0","0","0","-2"
"441937","California State University-Channel Islands","2012","Not on tenure track/No tenure system system total","69","35","34","0","0","0","4","2","2","0","0","0","8","6","2","0","0","0","50","23","27","4","2","2","1","1","0","2","1","1","-2"
"441937","California State University-Channel Islands","2012","Not on tenure/no tenure system, lecturers","69","35","34","0","0","0","4","2","2","0","0","0","8","6","2","0","0","0","50","23","27","4","2","2","1","1","0","2","1","1","-2"
"449870","University of the West","2012","Tenured total","3","2","1","0","0","0","1","1","0","0","0","0","1","0","1","0","0","0","1","1","0","0","0","0","0","0","0","0","0","0","-2"
"449870","University of the West","2012","Tenured, assistant professors","3","2","1","0","0","0","1","1","0","0","0","0","1","0","1","0","0","0","1","1","0","0","0","0","0","0","0","0","0","0","-2"
"449870","University of the West","2012","On-Tenure track total","4","3","1","0","0","0","3","2","1","0","0","0","0","0","0","0","0","0","1","1","0","0","0","0","0","0","0","0","0","0","-2"
"449870","University of the West","2012","On-tenure track, assistant professors","4","3","1","0","0","0","3","2","1","0","0","0","0","0","0","0","0","0","1","1","0","0","0","0","0","0","0","0","0","0","-2"
"449870","University of the West","2012","Not on tenure track/No tenure system system total","11","9","2","0","0","0","4","4","0","1","0","1","1","1","0","0","0","0","3","2","1","0","0","0","0","0","0","2","2","0","-2"
"449870","University of the West","2012","Not on tenure/no tenure system, associate professors","2","2","0","0","0","0","2","2","0","0","0","0","0","0","0","0","0","0","0","0","0","0","0","0","0","0","0","0","0","0","-2"
"449870","University of the West","2012","Not on tenure/no tenure system, assistant professors","3","2","1","0","0","0","1","1","0","1","0","1","0","0","0","0","0","0","1","1","0","0","0","0","0","0","0","0","0","0","-2"
"449870","University of the West","2012","Not on tenure/no tenure system, instructors","4","4","0","0","0","0","1","1","0","0","0","0","1","1","0","0","0","0","0","0","0","0","0","0","0","0","0","2","2","0","-2"
"449870","University of the West","2012","Not on tenure/no tenure system, no academic rank","2","1","1","0","0","0","0","0","0","0","0","0","0","0","0","0","0","0","2","1","1","0","0","0","0","0","0","0","0","0","-2"
