"unitid","institution name","year","S2018_IS.Instructional staff category","S2018_IS_RV.Grand total","S2018_IS_RV.Grand total men","S2018_IS_RV.Grand total women","S2018_IS_RV.American Indian or Alaska Native total","S2018_IS_RV.American Indian or Alaska Native men","S2018_IS_RV.American Indian or Alaska Native women","S2018_IS_RV.Asian total","S2018_IS_RV.Asian men","S2018_IS_RV.Asian women","S2018_IS_RV.Black or African American total","S2018_IS_RV.Black or African American men","S2018_IS_RV.Black or African American women","S2018_IS_RV.Hispanic or Latino total","S2018_IS_RV.Hispanic or Latino men","S2018_IS_RV.Hispanic or Latino women","S2018_IS_RV.Native Hawaiian or Other Pacific Islander total","S2018_IS_RV.Native Hawaiian or Other Pacific Islander men","S2018_IS_RV.Native Hawaiian or Other Pacific Islander women","S2018_IS_RV.White total","S2018_IS_RV.White men","S2018_IS_RV.White women","S2018_IS_RV.Two or more races total","S2018_IS_RV.Two or more races men","S2018_IS_RV.Two or more races women","S2018_IS_RV.Race/ethnicity unknown total","S2018_IS_RV.Race/ethnicity unknown men","S2018_IS_RV.Race/ethnicity unknown women","S2018_IS_RV.Nonresident alien total","S2018_IS_RV.Nonresident alien men","S2018_IS_RV.Nonresident alien women","IDX_HR"
"100654","Alabama A & M University","2018","Tenured total","83","63","20","0","0","0","10","9","1","63","48","15","0","0","0","0","0","0","2","0","2","0","0","0","1","0","1","7","6","1","-2"
"100654","Alabama A & M University","2018","Tenured, professors","47","37","10","0","0","0","7","7","0","36","28","8","0","0","0","0","0","0","1","0","1","0","0","0","1","0","1","2","2","0","-2"
"100654","Alabama A & M University","2018","Tenured, associate professors","25","20","5","0","0","0","3","2","1","17","15","2","0","0","0","0","0","0","1","0","1","0","0","0","0","0","0","4","3","1","-2"
"100654","Alabama A & M University","2018","Tenured, assistant professors","11","6","5","0","0","0","0","0","0","10","5","5","0","0","0","0","0","0","0","0","0","0","0","0","0","0","0","1","1","0","-2"
"100654","Alabama A & M University","2018","On-Tenure track total","60","27","33","0","0","0","9","4","5","31","10","21","0","0","0","0","0","0","7","6","1","0","0","0","0","0","0","13","7","6","-2"
"100654","Alabama A & M University","2018","On-tenure track, professors","2","2","0","0","0","0","0","0","0","0","0","0","0","0","0","0","0","0","1","1","0","0","0","0","0","0","0","1","1","0","-2"
"100654","Alabama A & M University","2018","On-tenure track, associate professors","17","8","9","0","0","0","6","3","3","6","2","4","0","0","0","0","0","0","1","1","0","0","0","0","0","0","0","4","2","2","-2"
"100654","Alabama A & M University","2018","On-tenure track, assistant professors","37","15","22","0","0","0","3","1","2","22","7","15","0","0","0","0","0","0","5","4","1","0","0","0","0","0","0","7","3","4","-2"
"100654","Alabama A & M University","2018","On-tenure track, instructors","3","1","2","0","0","0","0","0","0","2","0","2","0","0","0","0","0","0","0","0","0","0","0","0","0","0","0","1","1","0","-2"
"100654","Alabama A & M University","2018","On-tenure track, no academic rank","1","1","0","0","0","0","0","0","0","1","1","0","0","0","0","0","0","0","0","0","0","0","0","0","0","0","0","0","0","0","-2"
"100654","Alabama A & M University","2018","Not on tenure track/No tenure system system total","116","48","68","1","0","1","6","4","2","76","27","49","0","0","0","0","0","0","23","11","12","0","0","0","0","0","0","10","6","4","-2"
"100654","Alabama A & M University","2018","Not on tenure/no tenure system, professors","5","3","2","0","0","0","0","0","0","3","2","1","0","0","0","0","0","0","1","1","0","0","0","0","0","0","0","1","0","1","-2"
"100654","Alabama A & M University","2018","Not on tenure/no tenure system, associate professors","13","9","4","0","0","0","1","1","0","8","5","3","0","0","0","0","0","0","2","1","1","0","0","0","0","0","0","2","2","0","-2"
"100654","Alabama A & M University","2018","Not on tenure/no tenure system, assistant professors","52","24","28","0","0","0","2","2","0","35","14","21","0","0","0","0","0","0","11","7","4","0","0","0","0","0","0","4","1","3","-2"
"100654","Alabama A & M University","2018","Not on tenure/no tenure system, instructors","42","11","31","1","0","1","2","0","2","28","6","22","0","0","0","0","0","0","8","2","6","0","0","0","0","0","0","3","3","0","-2"
"100654","Alabama A & M University","2018","Not on tenure/no tenure system, no academic rank","4","1","3","0","0","0","1","1","0","2","0","2","0","0","0","0","0","0","1","0","1","0","0","0","0","0","0","0","0","0","-2"
"100706","University of Alabama in Huntsville","2018","Tenured total","158","123","35","0","0","0","37","34","3","8","5","3","4","3","1","0","0","0","107","80","27","1","0","1","0","0","0","1","1","0","-2"
"100706","University of Alabama in Huntsville","2018","Tenured, professors","64","53","11","0","0","0","14","13","1","2","2","0","1","1","0","0","0","0","46","36","10","0","0","0","0","0","0","1","1","0","-2"
"100706","University of Alabama in Huntsville","2018","Tenured, associate professors","93","70","23","0","0","0","23","21","2","6","3","3","2","2","0","0","0","0","61","44","17","1","0","1","0","0","0","0","0","0","-2"
"100706","University of Alabama in Huntsville","2018","Tenured, assistant professors","1","0","1","0","0","0","0","0","0","0","0","0","1","0","1","0","0","0","0","0","0","0","0","0","0","0","0","0","0","0","-2"
"100706","University of Alabama in Huntsville","2018","On-Tenure track total","69","36","33","0","0","0","16","10","6","4","1","3","0","0","0","0","0","0","35","18","17","0","0","0","0","0","0","14","7","7","-2"
"100706","University of Alabama in Huntsville","2018","On-tenure track, associate professors","5","2","3","0","0","0","2","2","0","0","0","0","0","0","0","0","0","0","3","0","3","0","0","0","0","0","0","0","0","0","-2"
"100706","University of Alabama in Huntsville","2018","On-tenure track, assistant professors","64","34","30","0","0","0","14","8","6","4","1","3","0","0","0","0","0","0","32","18","14","0","0","0","0","0","0","14","7","7","-2"
"100706","University of Alabama in Huntsville","2018","Not on tenure track/No tenure system system total","120","32","88","0","0","0","7","1","6","5","1","4","3","1","2","1","1","0","103","27","76","0","0","0","0","0","0","1","1","0","-2"
"100706","University of Alabama in Huntsville","2018","Not on tenure/no tenure system, associate professors","9","0","9","0","0","0","0","0","0","0","0","0","1","0","1","0","0","0","8","0","8","0","0","0","0","0","0","0","0","0","-2"
"100706","University of Alabama in Huntsville","2018","Not on tenure/no tenure system, assistant professors","25","4","21","0","0","0","0","0","0","1","0","1","0","0","0","0","0","0","24","4","20","0","0","0","0","0","0","0","0","0","-2"
"100706","University of Alabama in Huntsville","2018","Not on tenure/no tenure system, instructors","14","1","13","0","0","0","0","0","0","2","0","2","0","0","0","0","0","0","12","1","11","0","0","0","0","0","0","0","0","0","-2"
"100706","University of Alabama in Huntsville","2018","Not on tenure/no tenure system, lecturers","72","27","45","0","0","0","7","1","6","2","1","1","2","1","1","1","1","0","59","22","37","0","0","0","0","0","0","1","1","0","-2"
"100751","The University of Alabama","2018","Tenured total","591","385","206","0","0","0","61","46","15","36","16","20","18","10","8","1","1","0","470","309","161","1","0","1","1","1","0","3","2","1","-2"
"100751","The University of Alabama","2018","Tenured, professors","283","210","73","0","0","0","27","23","4","14","8","6","7","5","2","1","1","0","234","173","61","0","0","0","0","0","0","0","0","0","-2"
"100751","The University of Alabama","2018","Tenured, associate professors","301","173","128","0","0","0","34","23","11","22","8","14","10","4","6","0","0","0","230","135","95","1","0","1","1","1","0","3","2","1","-2"
"100751","The University of Alabama","2018","Tenured, assistant professors","7","2","5","0","0","0","0","0","0","0","0","0","1","1","0","0","0","0","6","1","5","0","0","0","0","0","0","0","0","0","-2"
"100751","The University of Alabama","2018","On-Tenure track total","401","232","169","3","2","1","42","29","13","26","12","14","4","3","1","1","0","1","274","151","123","0","0","0","0","0","0","51","35","16","-2"
"100751","The University of Alabama","2018","On-tenure track, professors","15","8","7","0","0","0","0","0","0","0","0","0","1","1","0","0","0","0","14","7","7","0","0","0","0","0","0","0","0","0","-2"
"100751","The University of Alabama","2018","On-tenure track, associate professors","20","13","7","0","0","0","4","4","0","2","2","0","0","0","0","0","0","0","14","7","7","0","0","0","0","0","0","0","0","0","-2"
"100751","The University of Alabama","2018","On-tenure track, assistant professors","366","211","155","3","2","1","38","25","13","24","10","14","3","2","1","1","0","1","246","137","109","0","0","0","0","0","0","51","35","16","-2"
"100751","The University of Alabama","2018","Not on tenure track/No tenure system system total","492","196","296","1","0","1","15","4","11","31","7","24","15","8","7","0","0","0","414","171","243","3","1","2","2","1","1","11","4","7","-2"
"100751","The University of Alabama","2018","Not on tenure/no tenure system, professors","13","8","5","0","0","0","1","1","0","1","0","1","1","1","0","0","0","0","9","5","4","0","0","0","0","0","0","1","1","0","-2"
"100751","The University of Alabama","2018","Not on tenure/no tenure system, associate professors","31","10","21","0","0","0","1","0","1","0","0","0","0","0","0","0","0","0","30","10","20","0","0","0","0","0","0","0","0","0","-2"
"100751","The University of Alabama","2018","Not on tenure/no tenure system, assistant professors","121","46","75","0","0","0","7","3","4","12","4","8","0","0","0","0","0","0","99","39","60","1","0","1","1","0","1","1","0","1","-2"
"100751","The University of Alabama","2018","Not on tenure/no tenure system, instructors","310","120","190","0","0","0","6","0","6","18","3","15","13","6","7","0","0","0","262","106","156","2","1","1","1","1","0","8","3","5","-2"
"100751","The University of Alabama","2018","Not on tenure/no tenure system, lecturers","17","12","5","1","0","1","0","0","0","0","0","0","1","1","0","0","0","0","14","11","3","0","0","0","0","0","0","1","0","1","-2"
"101675","Miles College","2018","Tenured total","6","5","1","0","0","0","2","1","1","4","4","0","0","0","0","0","0","0","0","0","0","0","0","0","0","0","0","0","0","0","-2"
"101675","Miles College","2018","Tenured, professors","6","5","1","0","0","0","2","1","1","4","4","0","0","0","0","0","0","0","0","0","0","0","0","0","0","0","0","0","0","0","-2"
"101675","Miles College","2018","On-Tenure track total","77","28","49","0","0","0","2","0","2","59","20","39","1","0","1","0","0","0","14","7","7","0","0","0","1","1","0","0","0","0","-2"
"101675","Miles College","2018","On-tenure track, professors","1","1","0","0","0","0","0","0","0","1","1","0","0","0","0","0","0","0","0","0","0","0","0","0","0","0","0","0","0","0","-2"
"101675","Miles College","2018","On-tenure track, associate professors","6","4","2","0","0","0","0","0","0","4","2","2","0","0","0","0","0","0","2","2","0","0","0","0","0","0","0","0","0","0","-2"
"101675","Miles College","2018","On-tenure track, assistant professors","25","6","19","0","0","0","2","0","2","18","4","14","0","0","0","0","0","0","4","1","3","0","0","0","1","1","0","0","0","0","-2"
"101675","Miles College","2018","On-tenure track, instructors","45","17","28","0","0","0","0","0","0","36","13","23","1","0","1","0","0","0","8","4","4","0","0","0","0","0","0","0","0","0","-2"
"102094","University of South Alabama","2018","Tenured total","241","161","80","0","0","0","23","16","7","8","5","3","1","1","0","0","0","0","207","138","69","2","1","1","0","0","0","0","0","0","-2"
"102094","University of South Alabama","2018","Tenured, professors","125","98","27","0","0","0","9","8","1","3","3","0","0","0","0","0","0","0","113","87","26","0","0","0","0","0","0","0","0","0","-2"
"102094","University of South Alabama","2018","Tenured, associate professors","109","61","48","0","0","0","13","8","5","4","1","3","1","1","0","0","0","0","89","50","39","2","1","1","0","0","0","0","0","0","-2"
"102094","University of South Alabama","2018","Tenured, assistant professors","7","2","5","0","0","0","1","0","1","1","1","0","0","0","0","0","0","0","5","1","4","0","0","0","0","0","0","0","0","0","-2"
"102094","University of South Alabama","2018","On-Tenure track total","147","93","54","1","0","1","28","19","9","3","2","1","3","3","0","0","0","0","108","67","41","4","2","2","0","0","0","0","0","0","-2"
"102094","University of South Alabama","2018","On-tenure track, professors","3","1","2","0","0","0","0","0","0","0","0","0","0","0","0","0","0","0","3","1","2","0","0","0","0","0","0","0","0","0","-2"
"102094","University of South Alabama","2018","On-tenure track, associate professors","11","8","3","0","0","0","2","1","1","0","0","0","0","0","0","0","0","0","9","7","2","0","0","0","0","0","0","0","0","0","-2"
"102094","University of South Alabama","2018","On-tenure track, assistant professors","133","84","49","1","0","1","26","18","8","3","2","1","3","3","0","0","0","0","96","59","37","4","2","2","0","0","0","0","0","0","-2"
"102094","University of South Alabama","2018","Not on tenure track/No tenure system system total","394","165","229","0","0","0","29","20","9","29","4","25","4","3","1","1","0","1","323","134","189","5","3","2","3","1","2","0","0","0","-2"
"102094","University of South Alabama","2018","Not on tenure/no tenure system, professors","30","22","8","0","0","0","5","5","0","1","0","1","2","1","1","0","0","0","21","15","6","1","1","0","0","0","0","0","0","0","-2"
"102094","University of South Alabama","2018","Not on tenure/no tenure system, associate professors","51","28","23","0","0","0","3","2","1","0","0","0","2","2","0","0","0","0","45","24","21","0","0","0","1","0","1","0","0","0","-2"
"102094","University of South Alabama","2018","Not on tenure/no tenure system, assistant professors","177","71","106","0","0","0","18","13","5","20","2","18","0","0","0","0","0","0","136","55","81","2","0","2","1","1","0","0","0","0","-2"
"102094","University of South Alabama","2018","Not on tenure/no tenure system, instructors","135","44","91","0","0","0","3","0","3","8","2","6","0","0","0","1","0","1","120","40","80","2","2","0","1","0","1","0","0","0","-2"
"102094","University of South Alabama","2018","Not on tenure/no tenure system, lecturers","1","0","1","0","0","0","0","0","0","0","0","0","0","0","0","0","0","0","1","0","1","0","0","0","0","0","0","0","0","0","-2"
"102377","Tuskegee University","2018","Tenured total","86","47","39","0","0","0","13","10","3","51","32","19","1","0","1","0","0","0","6","2","4","0","0","0","15","3","12","0","0","0","-2"
"102377","Tuskegee University","2018","Tenured, professors","44","20","24","0","0","0","7","4","3","24","14","10","0","0","0","0","0","0","4","2","2","0","0","0","9","0","9","0","0","0","-2"
"102377","Tuskegee University","2018","Tenured, associate professors","35","22","13","0","0","0","4","4","0","23","16","7","1","0","1","0","0","0","2","0","2","0","0","0","5","2","3","0","0","0","-2"
"102377","Tuskegee University","2018","Tenured, assistant professors","7","5","2","0","0","0","2","2","0","4","2","2","0","0","0","0","0","0","0","0","0","0","0","0","1","1","0","0","0","0","-2"
"102377","Tuskegee University","2018","On-Tenure track total","61","40","21","0","0","0","9","7","2","43","28","15","1","0","1","0","0","0","1","0","1","0","0","0","7","5","2","0","0","0","-2"
"102377","Tuskegee University","2018","On-tenure track, professors","1","1","0","0","0","0","1","1","0","0","0","0","0","0","0","0","0","0","0","0","0","0","0","0","0","0","0","0","0","0","-2"
"102377","Tuskegee University","2018","On-tenure track, associate professors","6","4","2","0","0","0","0","0","0","6","4","2","0","0","0","0","0","0","0","0","0","0","0","0","0","0","0","0","0","0","-2"
"102377","Tuskegee University","2018","On-tenure track, assistant professors","49","32","17","0","0","0","8","6","2","32","21","11","1","0","1","0","0","0","1","0","1","0","0","0","7","5","2","0","0","0","-2"
"102377","Tuskegee University","2018","On-tenure track, instructors","4","3","1","0","0","0","0","0","0","4","3","1","0","0","0","0","0","0","0","0","0","0","0","0","0","0","0","0","0","0","-2"
"102377","Tuskegee University","2018","On-tenure track, no academic rank","1","0","1","0","0","0","0","0","0","1","0","1","0","0","0","0","0","0","0","0","0","0","0","0","0","0","0","0","0","0","-2"
"102377","Tuskegee University","2018","Not on tenure track/No tenure system system total","108","67","41","0","0","0","11","7","4","78","46","32","0","0","0","0","0","0","2","2","0","0","0","0","17","12","5","0","0","0","-2"
"102377","Tuskegee University","2018","Not on tenure/no tenure system, professors","3","3","0","0","0","0","1","1","0","2","2","0","0","0","0","0","0","0","0","0","0","0","0","0","0","0","0","0","0","0","-2"
"102377","Tuskegee University","2018","Not on tenure/no tenure system, associate professors","13","8","5","0","0","0","7","5","2","5","3","2","0","0","0","0","0","0","0","0","0","0","0","0","1","0","1","0","0","0","-2"
"102377","Tuskegee University","2018","Not on tenure/no tenure system, assistant professors","41","27","14","0","0","0","1","1","0","32","18","14","0","0","0","0","0","0","0","0","0","0","0","0","8","8","0","0","0","0","-2"
"102377","Tuskegee University","2018","Not on tenure/no tenure system, instructors","2","2","0","0","0","0","0","0","0","2","2","0","0","0","0","0","0","0","0","0","0","0","0","0","0","0","0","0","0","0","-2"
"102377","Tuskegee University","2018","Not on tenure/no tenure system, lecturers","11","4","7","0","0","0","0","0","0","11","4","7","0","0","0","0","0","0","0","0","0","0","0","0","0","0","0","0","0","0","-2"
"102377","Tuskegee University","2018","Not on tenure/no tenure system, no academic rank","38","23","15","0","0","0","2","0","2","26","17","9","0","0","0","0","0","0","2","2","0","0","0","0","8","4","4","0","0","0","-2"
"102614","University of Alaska Fairbanks","2018","Tenured total","171","106","65","3","2","1","19","16","3","1","0","1","4","2","2","0","0","0","140","85","55","1","0","1","3","1","2","0","0","0","-2"
"102614","University of Alaska Fairbanks","2018","Tenured, professors","83","59","24","0","0","0","10","10","0","1","0","1","1","1","0","0","0","0","67","47","20","1","0","1","3","1","2","0","0","0","-2"
"102614","University of Alaska Fairbanks","2018","Tenured, associate professors","87","47","40","3","2","1","9","6","3","0","0","0","3","1","2","0","0","0","72","38","34","0","0","0","0","0","0","0","0","0","-2"
"102614","University of Alaska Fairbanks","2018","Tenured, assistant professors","1","0","1","0","0","0","0","0","0","0","0","0","0","0","0","0","0","0","1","0","1","0","0","0","0","0","0","0","0","0","-2"
"102614","University of Alaska Fairbanks","2018","On-Tenure track total","70","36","34","6","0","6","6","4","2","1","1","0","0","0","0","0","0","0","45","23","22","5","2","3","2","2","0","5","4","1","-2"
"102614","University of Alaska Fairbanks","2018","On-tenure track, professors","1","1","0","0","0","0","0","0","0","0","0","0","0","0","0","0","0","0","0","0","0","1","1","0","0","0","0","0","0","0","-2"
"102614","University of Alaska Fairbanks","2018","On-tenure track, associate professors","5","3","2","0","0","0","0","0","0","0","0","0","0","0","0","0","0","0","4","3","1","0","0","0","0","0","0","1","0","1","-2"
"102614","University of Alaska Fairbanks","2018","On-tenure track, assistant professors","64","32","32","6","0","6","6","4","2","1","1","0","0","0","0","0","0","0","41","20","21","4","1","3","2","2","0","4","4","0","-2"
"102614","University of Alaska Fairbanks","2018","Not on tenure track/No tenure system system total","79","36","43","6","3","3","2","1","1","2","1","1","6","1","5","1","0","1","51","24","27","3","1","2","6","3","3","2","2","0","-2"
"102614","University of Alaska Fairbanks","2018","Not on tenure/no tenure system, associate professors","6","1","5","1","0","1","0","0","0","0","0","0","0","0","0","1","0","1","4","1","3","0","0","0","0","0","0","0","0","0","-2"
"102614","University of Alaska Fairbanks","2018","Not on tenure/no tenure system, assistant professors","43","20","23","3","1","2","1","1","0","1","1","0","4","1","3","0","0","0","26","11","15","2","1","1","5","3","2","1","1","0","-2"
"102614","University of Alaska Fairbanks","2018","Not on tenure/no tenure system, instructors","26","14","12","2","2","0","1","0","1","1","0","1","2","0","2","0","0","0","18","12","6","1","0","1","1","0","1","0","0","0","-2"
"102614","University of Alaska Fairbanks","2018","Not on tenure/no tenure system, no academic rank","4","1","3","0","0","0","0","0","0","0","0","0","0","0","0","0","0","0","3","0","3","0","0","0","0","0","0","1","1","0","-2"
"104151","Arizona State University-Tempe","2018","Tenured total","1001","678","323","11","4","7","142","106","36","22","13","9","85","52","33","0","0","0","697","478","219","11","4","7","19","11","8","14","10","4","-2"
"104151","Arizona State University-Tempe","2018","Tenured, professors","573","415","158","3","3","0","77","61","16","11","7","4","42","26","16","0","0","0","419","305","114","7","4","3","7","4","3","7","5","2","-2"
"104151","Arizona State University-Tempe","2018","Tenured, associate professors","428","263","165","8","1","7","65","45","20","11","6","5","43","26","17","0","0","0","278","173","105","4","0","4","12","7","5","7","5","2","-2"
"104151","Arizona State University-Tempe","2018","On-Tenure track total","369","213","156","10","5","5","70","38","32","10","6","4","14","7","7","0","0","0","175","102","73","8","2","6","28","15","13","54","38","16","-2"
"104151","Arizona State University-Tempe","2018","On-tenure track, professors","1","1","0","0","0","0","0","0","0","0","0","0","0","0","0","0","0","0","1","1","0","0","0","0","0","0","0","0","0","0","-2"
"104151","Arizona State University-Tempe","2018","On-tenure track, associate professors","13","11","2","0","0","0","2","2","0","1","1","0","0","0","0","0","0","0","7","5","2","0","0","0","1","1","0","2","2","0","-2"
"104151","Arizona State University-Tempe","2018","On-tenure track, assistant professors","355","201","154","10","5","5","68","36","32","9","5","4","14","7","7","0","0","0","167","96","71","8","2","6","27","14","13","52","36","16","-2"
"104151","Arizona State University-Tempe","2018","Not on tenure track/No tenure system system total","751","370","381","7","5","2","61","25","36","16","9","7","52","25","27","0","0","0","541","261","280","8","5","3","30","17","13","36","23","13","-2"
"104151","Arizona State University-Tempe","2018","Not on tenure/no tenure system, professors","58","40","18","1","1","0","2","0","2","5","4","1","4","3","1","0","0","0","39","27","12","3","2","1","3","2","1","1","1","0","-2"
"104151","Arizona State University-Tempe","2018","Not on tenure/no tenure system, associate professors","61","38","23","2","1","1","7","5","2","1","1","0","5","4","1","0","0","0","42","25","17","0","0","0","4","2","2","0","0","0","-2"
"104151","Arizona State University-Tempe","2018","Not on tenure/no tenure system, assistant professors","124","62","62","0","0","0","7","4","3","1","0","1","7","2","5","0","0","0","88","44","44","2","1","1","5","2","3","14","9","5","-2"
"104151","Arizona State University-Tempe","2018","Not on tenure/no tenure system, instructors","196","81","115","2","1","1","10","2","8","5","3","2","21","7","14","0","0","0","147","62","85","1","1","0","6","4","2","4","1","3","-2"
"104151","Arizona State University-Tempe","2018","Not on tenure/no tenure system, lecturers","308","145","163","1","1","0","35","14","21","4","1","3","15","9","6","0","0","0","225","103","122","2","1","1","11","6","5","15","10","5","-2"
"104151","Arizona State University-Tempe","2018","Not on tenure/no tenure system, no academic rank","4","4","0","1","1","0","0","0","0","0","0","0","0","0","0","0","0","0","0","0","0","0","0","0","1","1","0","2","2","0","-2"
"104179","University of Arizona","2018","Tenured total","1114","746","368","8","3","5","118","85","33","17","11","6","77","45","32","0","0","0","805","547","258","4","1","3","81","51","30","4","3","1","-2"
"104179","University of Arizona","2018","Tenured, professors","725","517","208","4","2","2","66","50","16","8","5","3","40","26","14","0","0","0","564","402","162","2","1","1","39","29","10","2","2","0","-2"
"104179","University of Arizona","2018","Tenured, associate professors","389","229","160","4","1","3","52","35","17","9","6","3","37","19","18","0","0","0","241","145","96","2","0","2","42","22","20","2","1","1","-2"
"104179","University of Arizona","2018","On-Tenure track total","432","252","180","6","3","3","58","36","22","15","7","8","34","17","17","0","0","0","218","124","94","6","2","4","45","27","18","50","36","14","-2"
"104179","University of Arizona","2018","On-tenure track, professors","3","3","0","0","0","0","1","1","0","0","0","0","0","0","0","0","0","0","0","0","0","0","0","0","1","1","0","1","1","0","-2"
"104179","University of Arizona","2018","On-tenure track, associate professors","31","21","10","0","0","0","8","7","1","2","0","2","5","4","1","0","0","0","11","6","5","0","0","0","3","2","1","2","2","0","-2"
"104179","University of Arizona","2018","On-tenure track, assistant professors","398","228","170","6","3","3","49","28","21","13","7","6","29","13","16","0","0","0","207","118","89","6","2","4","41","24","17","47","33","14","-2"
"104179","University of Arizona","2018","Not on tenure track/No tenure system system total","499","218","281","2","1","1","28","12","16","11","6","5","54","20","34","0","0","0","330","144","186","11","6","5","36","17","19","27","12","15","-2"
"104179","University of Arizona","2018","Not on tenure/no tenure system, professors","39","23","16","0","0","0","2","1","1","0","0","0","3","1","2","0","0","0","29","18","11","0","0","0","3","2","1","2","1","1","-2"
"104179","University of Arizona","2018","Not on tenure/no tenure system, associate professors","51","21","30","0","0","0","3","1","2","2","1","1","4","1","3","0","0","0","36","15","21","0","0","0","5","2","3","1","1","0","-2"
"104179","University of Arizona","2018","Not on tenure/no tenure system, assistant professors","147","50","97","1","0","1","7","5","2","1","0","1","13","4","9","0","0","0","99","30","69","4","2","2","9","4","5","13","5","8","-2"
"104179","University of Arizona","2018","Not on tenure/no tenure system, instructors","81","38","43","0","0","0","5","1","4","1","0","1","20","8","12","0","0","0","36","21","15","2","2","0","10","3","7","7","3","4","-2"
"104179","University of Arizona","2018","Not on tenure/no tenure system, lecturers","181","86","95","1","1","0","11","4","7","7","5","2","14","6","8","0","0","0","130","60","70","5","2","3","9","6","3","4","2","2","-2"
"104586","Embry-Riddle Aeronautical University-Prescott","2018","Tenured total","45","35","10","0","0","0","5","2","3","0","0","0","1","1","0","0","0","0","38","31","7","1","1","0","0","0","0","0","0","0","-2"
"104586","Embry-Riddle Aeronautical University-Prescott","2018","Tenured, professors","20","16","4","0","0","0","2","1","1","0","0","0","0","0","0","0","0","0","17","14","3","1","1","0","0","0","0","0","0","0","-2"
"104586","Embry-Riddle Aeronautical University-Prescott","2018","Tenured, associate professors","22","17","5","0","0","0","2","1","1","0","0","0","1","1","0","0","0","0","19","15","4","0","0","0","0","0","0","0","0","0","-2"
"104586","Embry-Riddle Aeronautical University-Prescott","2018","Tenured, assistant professors","3","2","1","0","0","0","1","0","1","0","0","0","0","0","0","0","0","0","2","2","0","0","0","0","0","0","0","0","0","0","-2"
"104586","Embry-Riddle Aeronautical University-Prescott","2018","On-Tenure track total","54","39","15","0","0","0","7","5","2","2","2","0","2","2","0","0","0","0","41","29","12","1","0","1","1","1","0","0","0","0","-2"
"104586","Embry-Riddle Aeronautical University-Prescott","2018","On-tenure track, associate professors","8","7","1","0","0","0","1","1","0","1","1","0","1","1","0","0","0","0","5","4","1","0","0","0","0","0","0","0","0","0","-2"
"104586","Embry-Riddle Aeronautical University-Prescott","2018","On-tenure track, assistant professors","46","32","14","0","0","0","6","4","2","1","1","0","1","1","0","0","0","0","36","25","11","1","0","1","1","1","0","0","0","0","-2"
"104586","Embry-Riddle Aeronautical University-Prescott","2018","Not on tenure track/No tenure system system total","25","21","4","0","0","0","0","0","0","0","0","0","0","0","0","0","0","0","25","21","4","0","0","0","0","0","0","0","0","0","-2"
"104586","Embry-Riddle Aeronautical University-Prescott","2018","Not on tenure/no tenure system, professors","1","1","0","0","0","0","0","0","0","0","0","0","0","0","0","0","0","0","1","1","0","0","0","0","0","0","0","0","0","0","-2"
"104586","Embry-Riddle Aeronautical University-Prescott","2018","Not on tenure/no tenure system, associate professors","6","6","0","0","0","0","0","0","0","0","0","0","0","0","0","0","0","0","6","6","0","0","0","0","0","0","0","0","0","0","-2"
"104586","Embry-Riddle Aeronautical University-Prescott","2018","Not on tenure/no tenure system, assistant professors","13","10","3","0","0","0","0","0","0","0","0","0","0","0","0","0","0","0","13","10","3","0","0","0","0","0","0","0","0","0","-2"
"104586","Embry-Riddle Aeronautical University-Prescott","2018","Not on tenure/no tenure system, instructors","5","4","1","0","0","0","0","0","0","0","0","0","0","0","0","0","0","0","5","4","1","0","0","0","0","0","0","0","0","0","-2"
"105330","Northern Arizona University","2018","Tenured total","424","253","171","13","6","7","22","12","10","5","4","1","23","11","12","1","1","0","333","203","130","3","1","2","16","10","6","8","5","3","-2"
"105330","Northern Arizona University","2018","Tenured, professors","275","177","98","6","3","3","12","7","5","3","3","0","13","6","7","0","0","0","223","147","76","2","1","1","9","6","3","7","4","3","-2"
"105330","Northern Arizona University","2018","Tenured, associate professors","149","76","73","7","3","4","10","5","5","2","1","1","10","5","5","1","1","0","110","56","54","1","0","1","7","4","3","1","1","0","-2"
"105330","Northern Arizona University","2018","On-Tenure track total","127","72","55","3","1","2","8","3","5","0","0","0","7","2","5","0","0","0","84","49","35","4","3","1","4","3","1","17","11","6","-2"
"105330","Northern Arizona University","2018","On-tenure track, associate professors","7","6","1","0","0","0","0","0","0","0","0","0","0","0","0","0","0","0","7","6","1","0","0","0","0","0","0","0","0","0","-2"
"105330","Northern Arizona University","2018","On-tenure track, assistant professors","120","66","54","3","1","2","8","3","5","0","0","0","7","2","5","0","0","0","77","43","34","4","3","1","4","3","1","17","11","6","-2"
"105330","Northern Arizona University","2018","Not on tenure track/No tenure system system total","610","238","372","8","3","5","19","5","14","15","5","10","43","15","28","1","0","1","467","182","285","14","3","11","20","12","8","23","13","10","-2"
"105330","Northern Arizona University","2018","Not on tenure/no tenure system, professors","17","5","12","0","0","0","0","0","0","0","0","0","3","1","2","0","0","0","14","4","10","0","0","0","0","0","0","0","0","0","-2"
"105330","Northern Arizona University","2018","Not on tenure/no tenure system, associate professors","58","19","39","0","0","0","2","1","1","2","0","2","4","1","3","1","0","1","49","17","32","0","0","0","0","0","0","0","0","0","-2"
"105330","Northern Arizona University","2018","Not on tenure/no tenure system, assistant professors","156","45","111","2","0","2","4","1","3","7","3","4","13","3","10","0","0","0","117","36","81","6","1","5","3","0","3","4","1","3","-2"
"105330","Northern Arizona University","2018","Not on tenure/no tenure system, instructors","68","28","40","0","0","0","2","1","1","1","1","0","2","1","1","0","0","0","56","23","33","1","0","1","2","1","1","4","1","3","-2"
"105330","Northern Arizona University","2018","Not on tenure/no tenure system, lecturers","311","141","170","6","3","3","11","2","9","5","1","4","21","9","12","0","0","0","231","102","129","7","2","5","15","11","4","15","11","4","-2"
"110404","California Institute of Technology","2018","Tenured total","244","197","47","0","0","0","32","28","4","2","2","0","8","8","0","0","0","0","201","158","43","0","0","0","0","0","0","1","1","0","-2"
"110404","California Institute of Technology","2018","Tenured, professors","244","197","47","0","0","0","32","28","4","2","2","0","8","8","0","0","0","0","201","158","43","0","0","0","0","0","0","1","1","0","-2"
"110404","California Institute of Technology","2018","On-Tenure track total","51","37","14","0","0","0","10","6","4","1","1","0","2","0","2","0","0","0","31","25","6","1","1","0","0","0","0","6","4","2","-2"
"110404","California Institute of Technology","2018","On-tenure track, associate professors","4","3","1","0","0","0","2","1","1","0","0","0","0","0","0","0","0","0","2","2","0","0","0","0","0","0","0","0","0","0","-2"
"110404","California Institute of Technology","2018","On-tenure track, assistant professors","47","34","13","0","0","0","8","5","3","1","1","0","2","0","2","0","0","0","29","23","6","1","1","0","0","0","0","6","4","2","-2"
"110404","California Institute of Technology","2018","Not on tenure track/No tenure system system total","34","25","9","0","0","0","1","0","1","0","0","0","2","1","1","0","0","0","19","15","4","0","0","0","0","0","0","12","9","3","-2"
"110404","California Institute of Technology","2018","Not on tenure/no tenure system, instructors","16","11","5","0","0","0","0","0","0","0","0","0","0","0","0","0","0","0","4","2","2","0","0","0","0","0","0","12","9","3","-2"
"110404","California Institute of Technology","2018","Not on tenure/no tenure system, lecturers","15","11","4","0","0","0","1","0","1","0","0","0","2","1","1","0","0","0","12","10","2","0","0","0","0","0","0","0","0","0","-2"
"110404","California Institute of Technology","2018","Not on tenure/no tenure system, no academic rank","3","3","0","0","0","0","0","0","0","0","0","0","0","0","0","0","0","0","3","3","0","0","0","0","0","0","0","0","0","0","-2"
"110538","California State University-Chico","2018","Tenured total","286","167","119","1","1","0","29","16","13","4","1","3","10","7","3","0","0","0","226","130","96","2","2","0","14","10","4","0","0","0","-2"
"110538","California State University-Chico","2018","Tenured, professors","202","126","76","1","1","0","19","11","8","3","1","2","9","6","3","0","0","0","161","100","61","2","2","0","7","5","2","0","0","0","-2"
"110538","California State University-Chico","2018","Tenured, associate professors","83","41","42","0","0","0","10","5","5","1","0","1","1","1","0","0","0","0","64","30","34","0","0","0","7","5","2","0","0","0","-2"
"110538","California State University-Chico","2018","Tenured, assistant professors","1","0","1","0","0","0","0","0","0","0","0","0","0","0","0","0","0","0","1","0","1","0","0","0","0","0","0","0","0","0","-2"
"110538","California State University-Chico","2018","On-Tenure track total","165","73","92","1","0","1","13","4","9","4","1","3","7","2","5","0","0","0","101","48","53","3","0","3","17","9","8","19","9","10","-2"
"110538","California State University-Chico","2018","On-tenure track, associate professors","9","5","4","0","0","0","0","0","0","1","0","1","0","0","0","0","0","0","8","5","3","0","0","0","0","0","0","0","0","0","-2"
"110538","California State University-Chico","2018","On-tenure track, assistant professors","156","68","88","1","0","1","13","4","9","3","1","2","7","2","5","0","0","0","93","43","50","3","0","3","17","9","8","19","9","10","-2"
"110538","California State University-Chico","2018","Not on tenure track/No tenure system system total","100","45","55","0","0","0","1","0","1","1","0","1","6","1","5","0","0","0","79","39","40","2","0","2","10","5","5","1","0","1","-2"
"110538","California State University-Chico","2018","Not on tenure/no tenure system, lecturers","100","45","55","0","0","0","1","0","1","1","0","1","6","1","5","0","0","0","79","39","40","2","0","2","10","5","5","1","0","1","-2"
"110635","University of California-Berkeley","2018","Tenured total","1133","780","353","1","0","1","148","94","54","39","26","13","68","46","22","1","1","0","775","539","236","11","2","9","83","66","17","7","6","1","-2"
"110635","University of California-Berkeley","2018","Tenured, professors","821","603","218","0","0","0","109","76","33","25","21","4","45","34","11","1","1","0","596","438","158","4","2","2","38","28","10","3","3","0","-2"
"110635","University of California-Berkeley","2018","Tenured, associate professors","294","167","127","1","0","1","37","17","20","14","5","9","22","11","11","0","0","0","164","93","71","7","0","7","45","38","7","4","3","1","-2"
"110635","University of California-Berkeley","2018","Tenured, lecturers","18","10","8","0","0","0","2","1","1","0","0","0","1","1","0","0","0","0","15","8","7","0","0","0","0","0","0","0","0","0","-2"
"110635","University of California-Berkeley","2018","On-Tenure track total","239","147","92","2","1","1","26","8","18","7","5","2","16","8","8","0","0","0","99","62","37","7","5","2","57","38","19","25","20","5","-2"
"110635","University of California-Berkeley","2018","On-tenure track, professors","7","2","5","0","0","0","3","1","2","1","0","1","0","0","0","0","0","0","2","1","1","0","0","0","1","0","1","0","0","0","-2"
"110635","University of California-Berkeley","2018","On-tenure track, associate professors","1","1","0","0","0","0","0","0","0","0","0","0","0","0","0","0","0","0","1","1","0","0","0","0","0","0","0","0","0","0","-2"
"110635","University of California-Berkeley","2018","On-tenure track, assistant professors","226","141","85","2","1","1","22","7","15","6","5","1","16","8","8","0","0","0","93","58","35","7","5","2","55","37","18","25","20","5","-2"
"110635","University of California-Berkeley","2018","On-tenure track, lecturers","5","3","2","0","0","0","1","0","1","0","0","0","0","0","0","0","0","0","3","2","1","0","0","0","1","1","0","0","0","0","-2"
"110635","University of California-Berkeley","2018","Not on tenure track/No tenure system system total","379","171","208","0","0","0","66","20","46","13","5","8","23","8","15","0","0","0","179","98","81","4","1","3","61","25","36","33","14","19","-2"
"110635","University of California-Berkeley","2018","Not on tenure/no tenure system, professors","43","23","20","0","0","0","4","1","3","1","0","1","3","2","1","0","0","0","27","15","12","0","0","0","5","3","2","3","2","1","-2"
"110635","University of California-Berkeley","2018","Not on tenure/no tenure system, associate professors","18","8","10","0","0","0","3","1","2","1","0","1","1","1","0","0","0","0","7","3","4","0","0","0","5","2","3","1","1","0","-2"
"110635","University of California-Berkeley","2018","Not on tenure/no tenure system, assistant professors","44","20","24","0","0","0","10","3","7","1","0","1","1","1","0","0","0","0","10","5","5","0","0","0","11","5","6","11","6","5","-2"
"110635","University of California-Berkeley","2018","Not on tenure/no tenure system, instructors","4","2","2","0","0","0","1","0","1","1","1","0","0","0","0","0","0","0","1","0","1","0","0","0","1","1","0","0","0","0","-2"
"110635","University of California-Berkeley","2018","Not on tenure/no tenure system, lecturers","257","113","144","0","0","0","45","14","31","9","4","5","17","4","13","0","0","0","130","73","57","4","1","3","35","12","23","17","5","12","-2"
"110635","University of California-Berkeley","2018","Not on tenure/no tenure system, no academic rank","13","5","8","0","0","0","3","1","2","0","0","0","1","0","1","0","0","0","4","2","2","0","0","0","4","2","2","1","0","1","-2"
"110644","University of California-Davis","2018","Tenured total","1288","843","445","6","1","5","207","130","77","22","8","14","68","39","29","0","0","0","921","622","299","2","1","1","49","36","13","13","6","7","-2"
"110644","University of California-Davis","2018","Tenured, professors","963","666","297","5","1","4","149","102","47","11","5","6","36","20","16","0","0","0","728","513","215","1","1","0","28","22","6","5","2","3","-2"
"110644","University of California-Davis","2018","Tenured, associate professors","311","169","142","1","0","1","57","28","29","10","2","8","31","19","12","0","0","0","183","102","81","1","0","1","20","14","6","8","4","4","-2"
"110644","University of California-Davis","2018","Tenured, lecturers","14","8","6","0","0","0","1","0","1","1","1","0","1","0","1","0","0","0","10","7","3","0","0","0","1","0","1","0","0","0","-2"
"110644","University of California-Davis","2018","On-Tenure track total","338","187","151","1","0","1","41","26","15","16","6","10","31","13","18","0","0","0","171","90","81","3","2","1","19","12","7","56","38","18","-2"
"110644","University of California-Davis","2018","On-tenure track, professors","5","3","2","0","0","0","3","3","0","1","0","1","1","0","1","0","0","0","0","0","0","0","0","0","0","0","0","0","0","0","-2"
"110644","University of California-Davis","2018","On-tenure track, associate professors","2","2","0","0","0","0","0","0","0","0","0","0","0","0","0","0","0","0","1","1","0","0","0","0","0","0","0","1","1","0","-2"
"110644","University of California-Davis","2018","On-tenure track, assistant professors","300","172","128","1","0","1","38","23","15","13","6","7","29","13","16","0","0","0","147","81","66","3","2","1","17","11","6","52","36","16","-2"
"110644","University of California-Davis","2018","On-tenure track, lecturers","31","10","21","0","0","0","0","0","0","2","0","2","1","0","1","0","0","0","23","8","15","0","0","0","2","1","1","3","1","2","-2"
"110644","University of California-Davis","2018","Not on tenure track/No tenure system system total","938","511","427","0","0","0","218","111","107","15","6","9","49","26","23","1","0","1","569","318","251","8","4","4","26","13","13","52","33","19","-2"
"110644","University of California-Davis","2018","Not on tenure/no tenure system, professors","264","173","91","0","0","0","70","49","21","0","0","0","12","10","2","0","0","0","177","112","65","1","0","1","0","0","0","4","2","2","-2"
"110644","University of California-Davis","2018","Not on tenure/no tenure system, associate professors","174","92","82","0","0","0","58","26","32","3","1","2","11","6","5","0","0","0","93","53","40","2","2","0","4","1","3","3","3","0","-2"
"110644","University of California-Davis","2018","Not on tenure/no tenure system, assistant professors","286","144","142","0","0","0","71","33","38","8","2","6","14","6","8","0","0","0","146","72","74","4","2","2","8","4","4","35","25","10","-2"
"110644","University of California-Davis","2018","Not on tenure/no tenure system, lecturers","214","102","112","0","0","0","19","3","16","4","3","1","12","4","8","1","0","1","153","81","72","1","0","1","14","8","6","10","3","7","-2"
"110653","University of California-Irvine","2018","Tenured total","1046","689","357","4","2","2","199","130","69","24","16","8","53","34","19","1","1","0","731","489","242","3","1","2","19","8","11","12","8","4","-2"
"110653","University of California-Irvine","2018","Tenured, professors","722","517","205","2","1","1","133","93","40","16","13","3","37","27","10","0","0","0","518","374","144","2","0","2","9","5","4","5","4","1","-2"
"110653","University of California-Irvine","2018","Tenured, associate professors","268","148","120","2","1","1","61","34","27","7","2","5","14","7","7","1","1","0","165","95","70","1","1","0","10","3","7","7","4","3","-2"
"110653","University of California-Irvine","2018","Tenured, lecturers","56","24","32","0","0","0","5","3","2","1","1","0","2","0","2","0","0","0","48","20","28","0","0","0","0","0","0","0","0","0","-2"
"110653","University of California-Irvine","2018","On-Tenure track total","252","122","130","0","0","0","42","18","24","15","6","9","20","6","14","1","1","0","120","59","61","7","5","2","9","3","6","38","24","14","-2"
"110653","University of California-Irvine","2018","On-tenure track, professors","4","1","3","0","0","0","2","1","1","0","0","0","0","0","0","0","0","0","2","0","2","0","0","0","0","0","0","0","0","0","-2"
"110653","University of California-Irvine","2018","On-tenure track, associate professors","1","0","1","0","0","0","0","0","0","0","0","0","0","0","0","0","0","0","0","0","0","0","0","0","0","0","0","1","0","1","-2"
"110653","University of California-Irvine","2018","On-tenure track, assistant professors","214","105","109","0","0","0","37","16","21","13","6","7","18","6","12","1","1","0","97","46","51","6","5","1","8","3","5","34","22","12","-2"
"110653","University of California-Irvine","2018","On-tenure track, lecturers","33","16","17","0","0","0","3","1","2","2","0","2","2","0","2","0","0","0","21","13","8","1","0","1","1","0","1","3","2","1","-2"
"110653","University of California-Irvine","2018","Not on tenure track/No tenure system system total","689","382","307","2","0","2","223","119","104","15","7","8","34","17","17","1","1","0","345","189","156","3","2","1","30","17","13","36","30","6","-2"
"110653","University of California-Irvine","2018","Not on tenure/no tenure system, professors","156","100","56","1","0","1","59","38","21","2","1","1","8","5","3","0","0","0","76","50","26","0","0","0","7","4","3","3","2","1","-2"
"110653","University of California-Irvine","2018","Not on tenure/no tenure system, associate professors","118","77","41","0","0","0","40","27","13","6","4","2","2","2","0","1","1","0","60","36","24","0","0","0","6","4","2","3","3","0","-2"
"110653","University of California-Irvine","2018","Not on tenure/no tenure system, assistant professors","192","90","102","0","0","0","79","31","48","3","1","2","14","6","8","0","0","0","66","32","34","0","0","0","12","5","7","18","15","3","-2"
"110653","University of California-Irvine","2018","Not on tenure/no tenure system, instructors","44","28","16","0","0","0","11","6","5","1","1","0","2","1","1","0","0","0","21","12","9","2","2","0","2","2","0","5","4","1","-2"
"110653","University of California-Irvine","2018","Not on tenure/no tenure system, lecturers","179","87","92","1","0","1","34","17","17","3","0","3","8","3","5","0","0","0","122","59","63","1","0","1","3","2","1","7","6","1","-2"
"110662","University of California-Los Angeles","2018","Tenured total","1462","999","463","9","2","7","276","194","82","61","34","27","104","71","33","1","0","1","978","676","302","4","3","1","22","14","8","7","5","2","-2"
"110662","University of California-Los Angeles","2018","Tenured, professors","1186","845","341","7","2","5","212","159","53","34","21","13","80","57","23","1","0","1","826","588","238","4","3","1","16","11","5","6","4","2","-2"
"110662","University of California-Los Angeles","2018","Tenured, associate professors","269","150","119","2","0","2","63","35","28","27","13","14","24","14","10","0","0","0","147","85","62","0","0","0","5","2","3","1","1","0","-2"
"110662","University of California-Los Angeles","2018","Tenured, lecturers","7","4","3","0","0","0","1","0","1","0","0","0","0","0","0","0","0","0","5","3","2","0","0","0","1","1","0","0","0","0","-2"
"110662","University of California-Los Angeles","2018","On-Tenure track total","259","142","117","1","0","1","37","16","21","11","3","8","25","14","11","2","0","2","111","64","47","4","2","2","23","14","9","45","29","16","-2"
"110662","University of California-Los Angeles","2018","On-tenure track, professors","8","2","6","0","0","0","1","0","1","2","0","2","0","0","0","0","0","0","5","2","3","0","0","0","0","0","0","0","0","0","-2"
"110662","University of California-Los Angeles","2018","On-tenure track, assistant professors","247","137","110","1","0","1","36","16","20","9","3","6","25","14","11","2","0","2","103","59","44","4","2","2","23","14","9","44","29","15","-2"
"110662","University of California-Los Angeles","2018","On-tenure track, lecturers","4","3","1","0","0","0","0","0","0","0","0","0","0","0","0","0","0","0","3","3","0","0","0","0","0","0","0","1","0","1","-2"
"110662","University of California-Los Angeles","2018","Not on tenure track/No tenure system system total","1940","1081","859","0","0","0","544","268","276","47","14","33","97","49","48","1","0","1","1007","606","401","18","8","10","133","72","61","93","64","29","-2"
"110662","University of California-Los Angeles","2018","Not on tenure/no tenure system, professors","410","283","127","0","0","0","86","60","26","9","4","5","14","9","5","0","0","0","280","194","86","0","0","0","11","9","2","10","7","3","-2"
"110662","University of California-Los Angeles","2018","Not on tenure/no tenure system, associate professors","271","157","114","0","0","0","89","43","46","6","0","6","18","10","8","0","0","0","147","98","49","0","0","0","9","5","4","2","1","1","-2"
"110662","University of California-Los Angeles","2018","Not on tenure/no tenure system, assistant professors","626","329","297","0","0","0","200","91","109","11","2","9","31","13","18","0","0","0","272","151","121","13","6","7","41","25","16","58","41","17","-2"
"110662","University of California-Los Angeles","2018","Not on tenure/no tenure system, instructors","349","186","163","0","0","0","124","58","66","13","5","8","14","6","8","1","0","1","151","92","59","5","2","3","33","17","16","8","6","2","-2"
"110662","University of California-Los Angeles","2018","Not on tenure/no tenure system, lecturers","277","121","156","0","0","0","45","16","29","6","2","4","18","9","9","0","0","0","155","70","85","0","0","0","38","15","23","15","9","6","-2"
"110662","University of California-Los Angeles","2018","Not on tenure/no tenure system, no academic rank","7","5","2","0","0","0","0","0","0","2","1","1","2","2","0","0","0","0","2","1","1","0","0","0","1","1","0","0","0","0","-2"
"110680","University of California-San Diego","2018","Tenured total","1084","807","277","2","2","0","193","146","47","23","10","13","69","46","23","0","0","0","758","570","188","1","1","0","6","6","0","32","26","6","-2"
"110680","University of California-San Diego","2018","Tenured, professors","813","639","174","1","1","0","143","118","25","9","4","5","47","33","14","0","0","0","587","458","129","1","1","0","1","1","0","24","23","1","-2"
"110680","University of California-San Diego","2018","Tenured, associate professors","227","143","84","1","1","0","48","28","20","13","5","8","21","13","8","0","0","0","132","89","43","0","0","0","4","4","0","8","3","5","-2"
"110680","University of California-San Diego","2018","Tenured, lecturers","44","25","19","0","0","0","2","0","2","1","1","0","1","0","1","0","0","0","39","23","16","0","0","0","1","1","0","0","0","0","-2"
"110680","University of California-San Diego","2018","On-Tenure track total","283","164","119","0","0","0","50","33","17","11","1","10","23","14","9","0","0","0","148","81","67","2","0","2","6","3","3","43","32","11","-2"
"110680","University of California-San Diego","2018","On-tenure track, assistant professors","248","142","106","0","0","0","46","31","15","10","1","9","22","13","9","0","0","0","120","63","57","2","0","2","6","3","3","42","31","11","-2"
"110680","University of California-San Diego","2018","On-tenure track, lecturers","35","22","13","0","0","0","4","2","2","1","0","1","1","1","0","0","0","0","28","18","10","0","0","0","0","0","0","1","1","0","-2"
"110680","University of California-San Diego","2018","Not on tenure track/No tenure system system total","1191","625","566","6","4","2","242","122","120","13","10","3","73","42","31","1","1","0","747","387","360","0","0","0","47","23","24","62","36","26","-2"
"110680","University of California-San Diego","2018","Not on tenure/no tenure system, professors","365","221","144","1","1","0","59","29","30","7","6","1","19","14","5","0","0","0","271","164","107","0","0","0","2","2","0","6","5","1","-2"
"110680","University of California-San Diego","2018","Not on tenure/no tenure system, associate professors","263","156","107","2","2","0","71","41","30","0","0","0","19","13","6","1","1","0","153","90","63","0","0","0","5","3","2","12","6","6","-2"
"110680","University of California-San Diego","2018","Not on tenure/no tenure system, assistant professors","390","182","208","3","1","2","82","43","39","4","2","2","27","12","15","0","0","0","211","90","121","0","0","0","35","16","19","28","18","10","-2"
"110680","University of California-San Diego","2018","Not on tenure/no tenure system, lecturers","173","66","107","0","0","0","30","9","21","2","2","0","8","3","5","0","0","0","112","43","69","0","0","0","5","2","3","16","7","9","-2"
"115755","Humboldt State University","2018","Tenured total","153","87","66","2","1","1","10","6","4","2","1","1","5","1","4","0","0","0","127","76","51","1","0","1","6","2","4","0","0","0","-2"
"115755","Humboldt State University","2018","Tenured, professors","103","64","39","0","0","0","5","5","0","0","0","0","2","1","1","0","0","0","93","58","35","1","0","1","2","0","2","0","0","0","-2"
"115755","Humboldt State University","2018","Tenured, associate professors","49","22","27","2","1","1","5","1","4","2","1","1","3","0","3","0","0","0","33","17","16","0","0","0","4","2","2","0","0","0","-2"
"115755","Humboldt State University","2018","Tenured, assistant professors","1","1","0","0","0","0","0","0","0","0","0","0","0","0","0","0","0","0","1","1","0","0","0","0","0","0","0","0","0","0","-2"
"115755","Humboldt State University","2018","On-Tenure track total","77","32","45","3","0","3","2","1","1","3","2","1","8","2","6","0","0","0","42","18","24","1","1","0","10","3","7","8","5","3","-2"
"115755","Humboldt State University","2018","On-tenure track, associate professors","6","4","2","0","0","0","0","0","0","0","0","0","0","0","0","0","0","0","5","3","2","0","0","0","1","1","0","0","0","0","-2"
"115755","Humboldt State University","2018","On-tenure track, assistant professors","71","28","43","3","0","3","2","1","1","3","2","1","8","2","6","0","0","0","37","15","22","1","1","0","9","2","7","8","5","3","-2"
"115755","Humboldt State University","2018","Not on tenure track/No tenure system system total","60","26","34","4","2","2","0","0","0","2","0","2","2","1","1","0","0","0","46","19","27","0","0","0","6","4","2","0","0","0","-2"
"115755","Humboldt State University","2018","Not on tenure/no tenure system, lecturers","60","26","34","4","2","2","0","0","0","2","0","2","2","1","1","0","0","0","46","19","27","0","0","0","6","4","2","0","0","0","-2"
"119678","Naval Postgraduate School","2018","Tenured total","137","105","32","0","0","0","17","11","6","1","0","1","8","5","3","1","1","0","110","88","22","0","0","0","0","0","0","0","0","0","-2"
"119678","Naval Postgraduate School","2018","Tenured, professors","68","56","12","0","0","0","13","9","4","1","0","1","5","4","1","1","1","0","48","42","6","0","0","0","0","0","0","0","0","0","-2"
"119678","Naval Postgraduate School","2018","Tenured, associate professors","69","49","20","0","0","0","4","2","2","0","0","0","3","1","2","0","0","0","62","46","16","0","0","0","0","0","0","0","0","0","-2"
"119678","Naval Postgraduate School","2018","On-Tenure track total","57","44","13","0","0","0","2","2","0","0","0","0","2","2","0","1","1","0","52","39","13","0","0","0","0","0","0","0","0","0","-2"
"119678","Naval Postgraduate School","2018","On-tenure track, professors","1","1","0","0","0","0","0","0","0","0","0","0","0","0","0","0","0","0","1","1","0","0","0","0","0","0","0","0","0","0","-2"
"119678","Naval Postgraduate School","2018","On-tenure track, associate professors","12","10","2","0","0","0","0","0","0","0","0","0","1","1","0","1","1","0","10","8","2","0","0","0","0","0","0","0","0","0","-2"
"119678","Naval Postgraduate School","2018","On-tenure track, assistant professors","44","33","11","0","0","0","2","2","0","0","0","0","1","1","0","0","0","0","41","30","11","0","0","0","0","0","0","0","0","0","-2"
"119678","Naval Postgraduate School","2018","Not on tenure track/No tenure system system total","122","102","20","2","1","1","4","1","3","1","0","1","4","3","1","0","0","0","111","97","14","0","0","0","0","0","0","0","0","0","-2"
"119678","Naval Postgraduate School","2018","Not on tenure/no tenure system, professors","13","10","3","0","0","0","1","0","1","1","0","1","0","0","0","0","0","0","11","10","1","0","0","0","0","0","0","0","0","0","-2"
"119678","Naval Postgraduate School","2018","Not on tenure/no tenure system, lecturers","109","92","17","2","1","1","3","1","2","0","0","0","4","3","1","0","0","0","100","87","13","0","0","0","0","0","0","0","0","0","-2"
"122409","San Diego State University","2018","Tenured total","526","319","207","3","3","0","81","44","37","17","13","4","45","24","21","0","0","0","362","225","137","1","0","1","11","6","5","6","4","2","-2"
"122409","San Diego State University","2018","Tenured, professors","323","204","119","2","2","0","46","25","21","6","6","0","24","12","12","0","0","0","235","152","83","1","0","1","6","4","2","3","3","0","-2"
"122409","San Diego State University","2018","Tenured, associate professors","199","114","85","1","1","0","35","19","16","11","7","4","20","11","9","0","0","0","124","73","51","0","0","0","5","2","3","3","1","2","-2"
"122409","San Diego State University","2018","Tenured, assistant professors","1","0","1","0","0","0","0","0","0","0","0","0","0","0","0","0","0","0","1","0","1","0","0","0","0","0","0","0","0","0","-2"
"122409","San Diego State University","2018","Tenured, no academic rank","3","1","2","0","0","0","0","0","0","0","0","0","1","1","0","0","0","0","2","0","2","0","0","0","0","0","0","0","0","0","-2"
"122409","San Diego State University","2018","On-Tenure track total","219","115","104","3","1","2","33","18","15","9","1","8","22","13","9","0","0","0","99","51","48","7","4","3","18","10","8","28","17","11","-2"
"122409","San Diego State University","2018","On-tenure track, professors","1","1","0","0","0","0","0","0","0","0","0","0","0","0","0","0","0","0","1","1","0","0","0","0","0","0","0","0","0","0","-2"
"122409","San Diego State University","2018","On-tenure track, associate professors","10","5","5","0","0","0","2","1","1","0","0","0","0","0","0","0","0","0","6","3","3","0","0","0","2","1","1","0","0","0","-2"
"122409","San Diego State University","2018","On-tenure track, assistant professors","208","109","99","3","1","2","31","17","14","9","1","8","22","13","9","0","0","0","92","47","45","7","4","3","16","9","7","28","17","11","-2"
"122409","San Diego State University","2018","Not on tenure track/No tenure system system total","189","67","122","0","0","0","12","1","11","5","2","3","20","6","14","2","0","2","138","53","85","3","2","1","5","1","4","4","2","2","-2"
"122409","San Diego State University","2018","Not on tenure/no tenure system, lecturers","189","67","122","0","0","0","12","1","11","5","2","3","20","6","14","2","0","2","138","53","85","3","2","1","5","1","4","4","2","2","-2"
"122597","San Francisco State University","2018","Tenured total","512","259","253","7","4","3","127","60","67","21","11","10","33","15","18","0","0","0","283","153","130","10","5","5","27","11","16","4","0","4","-2"
"122597","San Francisco State University","2018","Tenured, professors","331","181","150","3","1","2","83","43","40","16","9","7","21","11","10","0","0","0","185","105","80","6","3","3","17","9","8","0","0","0","-2"
"122597","San Francisco State University","2018","Tenured, associate professors","171","75","96","3","2","1","42","17","25","5","2","3","11","4","7","0","0","0","94","46","48","4","2","2","8","2","6","4","0","4","-2"
"122597","San Francisco State University","2018","Tenured, assistant professors","7","2","5","1","1","0","2","0","2","0","0","0","1","0","1","0","0","0","1","1","0","0","0","0","2","0","2","0","0","0","-2"
"122597","San Francisco State University","2018","Tenured, no academic rank","3","1","2","0","0","0","0","0","0","0","0","0","0","0","0","0","0","0","3","1","2","0","0","0","0","0","0","0","0","0","-2"
"122597","San Francisco State University","2018","On-Tenure track total","201","71","130","4","0","4","47","15","32","9","4","5","12","5","7","0","0","0","98","37","61","2","0","2","9","2","7","20","8","12","-2"
"122597","San Francisco State University","2018","On-tenure track, professors","8","4","4","0","0","0","2","0","2","0","0","0","2","2","0","0","0","0","4","2","2","0","0","0","0","0","0","0","0","0","-2"
"122597","San Francisco State University","2018","On-tenure track, associate professors","10","5","5","0","0","0","5","3","2","0","0","0","0","0","0","0","0","0","4","2","2","1","0","1","0","0","0","0","0","0","-2"
"122597","San Francisco State University","2018","On-tenure track, assistant professors","183","62","121","4","0","4","40","12","28","9","4","5","10","3","7","0","0","0","90","33","57","1","0","1","9","2","7","20","8","12","-2"
"122597","San Francisco State University","2018","Not on tenure track/No tenure system system total","136","69","67","1","1","0","22","9","13","8","3","5","15","6","9","0","0","0","83","46","37","2","1","1","5","3","2","0","0","0","-2"
"122597","San Francisco State University","2018","Not on tenure/no tenure system, lecturers","136","69","67","1","1","0","22","9","13","8","3","5","15","6","9","0","0","0","83","46","37","2","1","1","5","3","2","0","0","0","-2"
"122755","San Jose State University","2018","Tenured total","431","231","200","2","2","0","109","61","48","12","6","6","29","17","12","0","0","0","240","126","114","3","1","2","33","17","16","3","1","2","-2"
"122755","San Jose State University","2018","Tenured, professors","298","173","125","1","1","0","83","52","31","4","2","2","19","14","5","0","0","0","172","96","76","3","1","2","16","7","9","0","0","0","-2"
"122755","San Jose State University","2018","Tenured, associate professors","126","52","74","1","1","0","24","7","17","8","4","4","9","2","7","0","0","0","66","29","37","0","0","0","15","8","7","3","1","2","-2"
"122755","San Jose State University","2018","Tenured, assistant professors","5","5","0","0","0","0","2","2","0","0","0","0","1","1","0","0","0","0","1","1","0","0","0","0","1","1","0","0","0","0","-2"
"122755","San Jose State University","2018","Tenured, no academic rank","2","1","1","0","0","0","0","0","0","0","0","0","0","0","0","0","0","0","1","0","1","0","0","0","1","1","0","0","0","0","-2"
"122755","San Jose State University","2018","On-Tenure track total","237","104","133","0","0","0","39","12","27","10","3","7","19","11","8","1","0","1","108","48","60","7","3","4","19","10","9","34","17","17","-2"
"122755","San Jose State University","2018","On-tenure track, associate professors","3","1","2","0","0","0","1","1","0","0","0","0","1","0","1","0","0","0","0","0","0","0","0","0","1","0","1","0","0","0","-2"
"122755","San Jose State University","2018","On-tenure track, assistant professors","233","103","130","0","0","0","38","11","27","10","3","7","18","11","7","1","0","1","107","48","59","7","3","4","18","10","8","34","17","17","-2"
"122755","San Jose State University","2018","On-tenure track, no academic rank","1","0","1","0","0","0","0","0","0","0","0","0","0","0","0","0","0","0","1","0","1","0","0","0","0","0","0","0","0","0","-2"
"122755","San Jose State University","2018","Not on tenure track/No tenure system system total","131","59","72","1","0","1","19","7","12","1","1","0","11","4","7","0","0","0","82","41","41","5","2","3","11","3","8","1","1","0","-2"
"122755","San Jose State University","2018","Not on tenure/no tenure system, lecturers","131","59","72","1","0","1","19","7","12","1","1","0","11","4","7","0","0","0","82","41","41","5","2","3","11","3","8","1","1","0","-2"
"123961","University of Southern California","2018","Tenured total","1183","872","311","2","2","0","192","142","50","31","20","11","46","29","17","0","0","0","871","653","218","19","15","4","22","11","11","0","0","0","-2"
"123961","University of Southern California","2018","Tenured, professors","832","647","185","2","2","0","121","98","23","15","13","2","25","17","8","0","0","0","646","501","145","10","8","2","13","8","5","0","0","0","-2"
"123961","University of Southern California","2018","Tenured, associate professors","349","223","126","0","0","0","71","44","27","16","7","9","21","12","9","0","0","0","223","150","73","9","7","2","9","3","6","0","0","0","-2"
"123961","University of Southern California","2018","Tenured, assistant professors","2","2","0","0","0","0","0","0","0","0","0","0","0","0","0","0","0","0","2","2","0","0","0","0","0","0","0","0","0","0","-2"
"123961","University of Southern California","2018","On-Tenure track total","304","178","126","1","0","1","57","38","19","7","3","4","14","6","8","0","0","0","114","57","57","5","2","3","54","33","21","52","39","13","-2"
"123961","University of Southern California","2018","On-tenure track, associate professors","9","5","4","0","0","0","2","1","1","0","0","0","0","0","0","0","0","0","6","4","2","0","0","0","0","0","0","1","0","1","-2"
"123961","University of Southern California","2018","On-tenure track, assistant professors","295","173","122","1","0","1","55","37","18","7","3","4","14","6","8","0","0","0","108","53","55","5","2","3","54","33","21","51","39","12","-2"
"123961","University of Southern California","2018","Not on tenure track/No tenure system system total","957","439","518","2","1","1","82","31","51","42","15","27","77","32","45","0","0","0","639","308","331","20","9","11","65","30","35","30","13","17","-2"
"123961","University of Southern California","2018","Not on tenure/no tenure system, professors","188","90","98","0","0","0","15","5","10","11","6","5","14","7","7","0","0","0","136","65","71","5","3","2","7","4","3","0","0","0","-2"
"123961","University of Southern California","2018","Not on tenure/no tenure system, associate professors","301","141","160","0","0","0","23","12","11","16","3","13","16","6","10","0","0","0","230","113","117","8","3","5","6","3","3","2","1","1","-2"
"123961","University of Southern California","2018","Not on tenure/no tenure system, assistant professors","223","100","123","2","1","1","12","2","10","11","6","5","15","6","9","0","0","0","147","64","83","1","0","1","25","15","10","10","6","4","-2"
"123961","University of Southern California","2018","Not on tenure/no tenure system, instructors","3","0","3","0","0","0","0","0","0","0","0","0","1","0","1","0","0","0","0","0","0","0","0","0","2","0","2","0","0","0","-2"
"123961","University of Southern California","2018","Not on tenure/no tenure system, lecturers","242","108","134","0","0","0","32","12","20","4","0","4","31","13","18","0","0","0","126","66","60","6","3","3","25","8","17","18","6","12","-2"
"126614","University of Colorado Boulder","2018","Tenured total","866","580","286","5","2","3","94","53","41","16","11","5","47","34","13","1","1","0","644","443","201","5","1","4","46","30","16","8","5","3","-2"
"126614","University of Colorado Boulder","2018","Tenured, professors","507","374","133","4","2","2","52","32","20","8","7","1","24","21","3","1","1","0","393","292","101","2","1","1","20","16","4","3","2","1","-2"
"126614","University of Colorado Boulder","2018","Tenured, associate professors","359","206","153","1","0","1","42","21","21","8","4","4","23","13","10","0","0","0","251","151","100","3","0","3","26","14","12","5","3","2","-2"
"126614","University of Colorado Boulder","2018","On-Tenure track total","334","198","136","1","1","0","34","23","11","5","3","2","18","9","9","2","1","1","169","103","66","6","1","5","66","38","28","33","19","14","-2"
"126614","University of Colorado Boulder","2018","On-tenure track, professors","3","2","1","0","0","0","1","1","0","0","0","0","0","0","0","0","0","0","2","1","1","0","0","0","0","0","0","0","0","0","-2"
"126614","University of Colorado Boulder","2018","On-tenure track, associate professors","19","13","6","0","0","0","2","2","0","0","0","0","1","0","1","0","0","0","14","9","5","0","0","0","2","2","0","0","0","0","-2"
"126614","University of Colorado Boulder","2018","On-tenure track, assistant professors","312","183","129","1","1","0","31","20","11","5","3","2","17","9","8","2","1","1","153","93","60","6","1","5","64","36","28","33","19","14","-2"
"126614","University of Colorado Boulder","2018","Not on tenure track/No tenure system system total","410","201","209","1","1","0","24","4","20","4","2","2","13","6","7","0","0","0","316","163","153","3","2","1","35","17","18","14","6","8","-2"
"126614","University of Colorado Boulder","2018","Not on tenure/no tenure system, instructors","410","201","209","1","1","0","24","4","20","4","2","2","13","6","7","0","0","0","316","163","153","3","2","1","35","17","18","14","6","8","-2"
"126818","Colorado State University-Fort Collins","2018","Tenured total","743","481","262","1","0","1","33","26","7","5","3","2","33","16","17","0","0","0","574","369","205","5","3","2","0","0","0","92","64","28","-2"
"126818","Colorado State University-Fort Collins","2018","Tenured, professors","450","321","129","1","0","1","25","22","3","2","1","1","17","10","7","0","0","0","367","258","109","1","1","0","0","0","0","37","29","8","-2"
"126818","Colorado State University-Fort Collins","2018","Tenured, associate professors","293","160","133","0","0","0","8","4","4","3","2","1","16","6","10","0","0","0","207","111","96","4","2","2","0","0","0","55","35","20","-2"
"126818","Colorado State University-Fort Collins","2018","On-Tenure track total","310","171","139","3","1","2","33","16","17","4","2","2","10","4","6","0","0","0","213","125","88","13","5","8","3","3","0","31","15","16","-2"
"126818","Colorado State University-Fort Collins","2018","On-tenure track, professors","7","4","3","1","0","1","0","0","0","1","0","1","0","0","0","0","0","0","5","4","1","0","0","0","0","0","0","0","0","0","-2"
"126818","Colorado State University-Fort Collins","2018","On-tenure track, associate professors","24","12","12","0","0","0","1","0","1","0","0","0","1","0","1","0","0","0","19","9","10","1","1","0","0","0","0","2","2","0","-2"
"126818","Colorado State University-Fort Collins","2018","On-tenure track, assistant professors","279","155","124","2","1","1","32","16","16","3","2","1","9","4","5","0","0","0","189","112","77","12","4","8","3","3","0","29","13","16","-2"
"126818","Colorado State University-Fort Collins","2018","Not on tenure track/No tenure system system total","356","131","225","1","0","1","7","2","5","1","0","1","18","2","16","0","0","0","304","115","189","4","1","3","7","6","1","14","5","9","-2"
"126818","Colorado State University-Fort Collins","2018","Not on tenure/no tenure system, professors","4","2","2","0","0","0","0","0","0","0","0","0","1","0","1","0","0","0","2","1","1","0","0","0","1","1","0","0","0","0","-2"
"126818","Colorado State University-Fort Collins","2018","Not on tenure/no tenure system, associate professors","111","35","76","0","0","0","1","0","1","0","0","0","8","0","8","0","0","0","93","31","62","3","1","2","0","0","0","6","3","3","-2"
"126818","Colorado State University-Fort Collins","2018","Not on tenure/no tenure system, assistant professors","18","8","10","0","0","0","1","0","1","0","0","0","0","0","0","0","0","0","17","8","9","0","0","0","0","0","0","0","0","0","-2"
"126818","Colorado State University-Fort Collins","2018","Not on tenure/no tenure system, instructors","223","86","137","1","0","1","5","2","3","1","0","1","9","2","7","0","0","0","192","75","117","1","0","1","6","5","1","8","2","6","-2"
"127060","University of Denver","2018","Tenured total","358","215","143","0","0","0","29","19","10","8","3","5","20","12","8","0","0","0","255","151","104","5","3","2","40","26","14","1","1","0","-2"
"127060","University of Denver","2018","Tenured, professors","160","112","48","0","0","0","10","8","2","2","1","1","6","4","2","0","0","0","119","82","37","4","3","1","18","13","5","1","1","0","-2"
"127060","University of Denver","2018","Tenured, associate professors","198","103","95","0","0","0","19","11","8","6","2","4","14","8","6","0","0","0","136","69","67","1","0","1","22","13","9","0","0","0","-2"
"127060","University of Denver","2018","On-Tenure track total","120","58","62","1","0","1","11","2","9","4","1","3","9","6","3","0","0","0","70","35","35","5","2","3","9","5","4","11","7","4","-2"
"127060","University of Denver","2018","On-tenure track, assistant professors","120","58","62","1","0","1","11","2","9","4","1","3","9","6","3","0","0","0","70","35","35","5","2","3","9","5","4","11","7","4","-2"
"127060","University of Denver","2018","Not on tenure track/No tenure system system total","270","117","153","1","1","0","10","3","7","7","4","3","23","9","14","0","0","0","188","83","105","10","3","7","24","8","16","7","6","1","-2"
"127060","University of Denver","2018","Not on tenure/no tenure system, professors","32","19","13","0","0","0","1","0","1","0","0","0","0","0","0","0","0","0","31","19","12","0","0","0","0","0","0","0","0","0","-2"
"127060","University of Denver","2018","Not on tenure/no tenure system, associate professors","26","11","15","0","0","0","1","1","0","0","0","0","2","2","0","0","0","0","18","7","11","3","0","3","2","1","1","0","0","0","-2"
"127060","University of Denver","2018","Not on tenure/no tenure system, assistant professors","29","8","21","0","0","0","1","0","1","2","0","2","4","2","2","0","0","0","17","5","12","0","0","0","5","1","4","0","0","0","-2"
"127060","University of Denver","2018","Not on tenure/no tenure system, lecturers","183","79","104","1","1","0","7","2","5","5","4","1","17","5","12","0","0","0","122","52","70","7","3","4","17","6","11","7","6","1","-2"
"127565","Metropolitan State University of Denver","2018","Tenured total","344","186","158","2","1","1","25","17","8","15","10","5","31","16","15","0","0","0","268","139","129","3","3","0","0","0","0","0","0","0","-2"
"127565","Metropolitan State University of Denver","2018","Tenured, professors","184","107","77","1","0","1","15","10","5","5","3","2","13","10","3","0","0","0","147","81","66","3","3","0","0","0","0","0","0","0","-2"
"127565","Metropolitan State University of Denver","2018","Tenured, associate professors","159","79","80","1","1","0","10","7","3","10","7","3","18","6","12","0","0","0","120","58","62","0","0","0","0","0","0","0","0","0","-2"
"127565","Metropolitan State University of Denver","2018","Tenured, assistant professors","1","0","1","0","0","0","0","0","0","0","0","0","0","0","0","0","0","0","1","0","1","0","0","0","0","0","0","0","0","0","-2"
"127565","Metropolitan State University of Denver","2018","On-Tenure track total","100","39","61","1","0","1","12","4","8","6","3","3","13","9","4","1","1","0","60","21","39","3","0","3","4","1","3","0","0","0","-2"
"127565","Metropolitan State University of Denver","2018","On-tenure track, assistant professors","99","38","61","1","0","1","12","4","8","6","3","3","13","9","4","1","1","0","59","20","39","3","0","3","4","1","3","0","0","0","-2"
"127565","Metropolitan State University of Denver","2018","On-tenure track, lecturers","1","1","0","0","0","0","0","0","0","0","0","0","0","0","0","0","0","0","1","1","0","0","0","0","0","0","0","0","0","0","-2"
"127565","Metropolitan State University of Denver","2018","Not on tenure track/No tenure system system total","126","50","76","0","0","0","8","2","6","7","2","5","12","8","4","0","0","0","93","36","57","4","1","3","2","1","1","0","0","0","-2"
"127565","Metropolitan State University of Denver","2018","Not on tenure/no tenure system, professors","1","1","0","0","0","0","0","0","0","0","0","0","0","0","0","0","0","0","1","1","0","0","0","0","0","0","0","0","0","0","-2"
"127565","Metropolitan State University of Denver","2018","Not on tenure/no tenure system, associate professors","2","1","1","0","0","0","0","0","0","0","0","0","0","0","0","0","0","0","2","1","1","0","0","0","0","0","0","0","0","0","-2"
"127565","Metropolitan State University of Denver","2018","Not on tenure/no tenure system, assistant professors","9","2","7","0","0","0","0","0","0","2","0","2","1","1","0","0","0","0","6","1","5","0","0","0","0","0","0","0","0","0","-2"
"127565","Metropolitan State University of Denver","2018","Not on tenure/no tenure system, lecturers","114","46","68","0","0","0","8","2","6","5","2","3","11","7","4","0","0","0","84","33","51","4","1","3","2","1","1","0","0","0","-2"
"127741","University of Northern Colorado","2018","Tenured total","301","168","133","3","2","1","13","9","4","6","5","1","15","6","9","0","0","0","254","139","115","3","2","1","0","0","0","7","5","2","-2"
"127741","University of Northern Colorado","2018","Tenured, professors","196","115","81","3","2","1","10","7","3","4","3","1","13","5","8","0","0","0","160","93","67","2","2","0","0","0","0","4","3","1","-2"
"127741","University of Northern Colorado","2018","Tenured, associate professors","105","53","52","0","0","0","3","2","1","2","2","0","2","1","1","0","0","0","94","46","48","1","0","1","0","0","0","3","2","1","-2"
"127741","University of Northern Colorado","2018","On-Tenure track total","109","50","59","0","0","0","4","1","3","3","2","1","7","4","3","1","0","1","74","32","42","3","1","2","3","2","1","14","8","6","-2"
"127741","University of Northern Colorado","2018","On-tenure track, professors","1","1","0","0","0","0","0","0","0","0","0","0","0","0","0","0","0","0","1","1","0","0","0","0","0","0","0","0","0","0","-2"
"127741","University of Northern Colorado","2018","On-tenure track, associate professors","4","1","3","0","0","0","0","0","0","0","0","0","1","0","1","0","0","0","3","1","2","0","0","0","0","0","0","0","0","0","-2"
"127741","University of Northern Colorado","2018","On-tenure track, assistant professors","103","47","56","0","0","0","4","1","3","3","2","1","6","4","2","1","0","1","69","29","40","3","1","2","3","2","1","14","8","6","-2"
"127741","University of Northern Colorado","2018","On-tenure track, lecturers","1","1","0","0","0","0","0","0","0","0","0","0","0","0","0","0","0","0","1","1","0","0","0","0","0","0","0","0","0","0","-2"
"127741","University of Northern Colorado","2018","Not on tenure track/No tenure system system total","104","25","79","0","0","0","1","0","1","0","0","0","7","2","5","1","0","1","90","23","67","1","0","1","0","0","0","4","0","4","-2"
"127741","University of Northern Colorado","2018","Not on tenure/no tenure system, professors","1","1","0","0","0","0","0","0","0","0","0","0","1","1","0","0","0","0","0","0","0","0","0","0","0","0","0","0","0","0","-2"
"127741","University of Northern Colorado","2018","Not on tenure/no tenure system, associate professors","12","3","9","0","0","0","0","0","0","0","0","0","0","0","0","0","0","0","12","3","9","0","0","0","0","0","0","0","0","0","-2"
"127741","University of Northern Colorado","2018","Not on tenure/no tenure system, assistant professors","36","7","29","0","0","0","0","0","0","0","0","0","1","1","0","0","0","0","30","6","24","1","0","1","0","0","0","4","0","4","-2"
"127741","University of Northern Colorado","2018","Not on tenure/no tenure system, instructors","9","3","6","0","0","0","0","0","0","0","0","0","0","0","0","0","0","0","9","3","6","0","0","0","0","0","0","0","0","0","-2"
"127741","University of Northern Colorado","2018","Not on tenure/no tenure system, lecturers","46","11","35","0","0","0","1","0","1","0","0","0","5","0","5","1","0","1","39","11","28","0","0","0","0","0","0","0","0","0","-2"
"128328","United States Air Force Academy","2018","Not on tenure track/No tenure system system total","208","140","68","0","0","0","8","4","4","3","1","2","4","2","2","0","0","0","193","133","60","0","0","0","0","0","0","0","0","0","-2"
"128328","United States Air Force Academy","2018","Not on tenure/no tenure system, professors","63","53","10","0","0","0","2","2","0","1","0","1","1","1","0","0","0","0","59","50","9","0","0","0","0","0","0","0","0","0","-2"
"128328","United States Air Force Academy","2018","Not on tenure/no tenure system, associate professors","40","28","12","0","0","0","1","0","1","0","0","0","1","0","1","0","0","0","38","28","10","0","0","0","0","0","0","0","0","0","-2"
"128328","United States Air Force Academy","2018","Not on tenure/no tenure system, assistant professors","79","42","37","0","0","0","5","2","3","2","1","1","1","1","0","0","0","0","71","38","33","0","0","0","0","0","0","0","0","0","-2"
"128328","United States Air Force Academy","2018","Not on tenure/no tenure system, instructors","26","17","9","0","0","0","0","0","0","0","0","0","1","0","1","0","0","0","25","17","8","0","0","0","0","0","0","0","0","0","-2"
"130776","Western Connecticut State University","2018","Tenured total","146","73","73","0","0","0","18","9","9","7","5","2","7","4","3","0","0","0","106","50","56","0","0","0","8","5","3","0","0","0","-2"
"130776","Western Connecticut State University","2018","Tenured, professors","97","52","45","0","0","0","6","3","3","4","2","2","5","3","2","0","0","0","77","41","36","0","0","0","5","3","2","0","0","0","-2"
"130776","Western Connecticut State University","2018","Tenured, associate professors","43","20","23","0","0","0","11","6","5","3","3","0","2","1","1","0","0","0","24","8","16","0","0","0","3","2","1","0","0","0","-2"
"130776","Western Connecticut State University","2018","Tenured, assistant professors","6","1","5","0","0","0","1","0","1","0","0","0","0","0","0","0","0","0","5","1","4","0","0","0","0","0","0","0","0","0","-2"
"130776","Western Connecticut State University","2018","On-Tenure track total","68","31","37","0","0","0","5","5","0","2","0","2","4","0","4","0","0","0","55","24","31","0","0","0","2","2","0","0","0","0","-2"
"130776","Western Connecticut State University","2018","On-tenure track, associate professors","11","7","4","0","0","0","0","0","0","0","0","0","0","0","0","0","0","0","10","6","4","0","0","0","1","1","0","0","0","0","-2"
"130776","Western Connecticut State University","2018","On-tenure track, assistant professors","55","23","32","0","0","0","4","4","0","2","0","2","4","0","4","0","0","0","44","18","26","0","0","0","1","1","0","0","0","0","-2"
"130776","Western Connecticut State University","2018","On-tenure track, instructors","2","1","1","0","0","0","1","1","0","0","0","0","0","0","0","0","0","0","1","0","1","0","0","0","0","0","0","0","0","0","-2"
"130776","Western Connecticut State University","2018","Not on tenure track/No tenure system system total","8","3","5","0","0","0","0","0","0","0","0","0","0","0","0","0","0","0","8","3","5","0","0","0","0","0","0","0","0","0","-2"
"130776","Western Connecticut State University","2018","Not on tenure/no tenure system, assistant professors","7","3","4","0","0","0","0","0","0","0","0","0","0","0","0","0","0","0","7","3","4","0","0","0","0","0","0","0","0","0","-2"
"130776","Western Connecticut State University","2018","Not on tenure/no tenure system, instructors","1","0","1","0","0","0","0","0","0","0","0","0","0","0","0","0","0","0","1","0","1","0","0","0","0","0","0","0","0","0","-2"
"130794","Yale University","2018","Tenured total","1043","766","277","1","1","0","110","72","38","30","17","13","32","21","11","1","1","0","814","622","192","4","2","2","34","19","15","17","11","6","-2"
"130794","Yale University","2018","Tenured, professors","938","701","237","1","1","0","89","60","29","26","15","11","26","19","7","1","1","0","750","580","170","4","2","2","28","15","13","13","8","5","-2"
"130794","Yale University","2018","Tenured, associate professors","105","65","40","0","0","0","21","12","9","4","2","2","6","2","4","0","0","0","64","42","22","0","0","0","6","4","2","4","3","1","-2"
"130794","Yale University","2018","On-Tenure track total","1117","606","511","1","1","0","186","106","80","40","16","24","53","23","30","3","1","2","606","330","276","6","3","3","127","68","59","95","58","37","-2"
"130794","Yale University","2018","On-tenure track, associate professors","364","211","153","0","0","0","72","47","25","18","6","12","14","6","8","2","1","1","235","132","103","1","1","0","15","13","2","7","5","2","-2"
"130794","Yale University","2018","On-tenure track, assistant professors","753","395","358","1","1","0","114","59","55","22","10","12","39","17","22","1","0","1","371","198","173","5","2","3","112","55","57","88","53","35","-2"
"130794","Yale University","2018","Not on tenure track/No tenure system system total","599","280","319","0","0","0","70","32","38","20","5","15","24","6","18","0","0","0","304","146","158","5","3","2","100","43","57","76","45","31","-2"
"130794","Yale University","2018","Not on tenure/no tenure system, professors","72","50","22","0","0","0","7","5","2","2","1","1","0","0","0","0","0","0","57","38","19","0","0","0","3","3","0","3","3","0","-2"
"130794","Yale University","2018","Not on tenure/no tenure system, associate professors","11","9","2","0","0","0","2","2","0","0","0","0","0","0","0","0","0","0","9","7","2","0","0","0","0","0","0","0","0","0","-2"
"130794","Yale University","2018","Not on tenure/no tenure system, assistant professors","11","3","8","0","0","0","2","1","1","1","0","1","1","1","0","0","0","0","7","1","6","0","0","0","0","0","0","0","0","0","-2"
"130794","Yale University","2018","Not on tenure/no tenure system, lecturers","505","218","287","0","0","0","59","24","35","17","4","13","23","5","18","0","0","0","231","100","131","5","3","2","97","40","57","73","42","31","-2"
"130934","Delaware State University","2018","Tenured total","128","79","49","2","2","0","26","20","6","47","26","21","4","3","1","0","0","0","46","27","19","3","1","2","0","0","0","0","0","0","-2"
"130934","Delaware State University","2018","Tenured, professors","47","33","14","2","2","0","9","8","1","14","10","4","1","1","0","0","0","0","19","11","8","2","1","1","0","0","0","0","0","0","-2"
"130934","Delaware State University","2018","Tenured, associate professors","81","46","35","0","0","0","17","12","5","33","16","17","3","2","1","0","0","0","27","16","11","1","0","1","0","0","0","0","0","0","-2"
"130934","Delaware State University","2018","On-Tenure track total","51","21","30","0","0","0","11","6","5","18","5","13","1","1","0","0","0","0","20","9","11","1","0","1","0","0","0","0","0","0","-2"
"130934","Delaware State University","2018","On-tenure track, associate professors","14","4","10","0","0","0","2","1","1","7","1","6","0","0","0","0","0","0","4","2","2","1","0","1","0","0","0","0","0","0","-2"
"130934","Delaware State University","2018","On-tenure track, assistant professors","37","17","20","0","0","0","9","5","4","11","4","7","1","1","0","0","0","0","16","7","9","0","0","0","0","0","0","0","0","0","-2"
"130934","Delaware State University","2018","Not on tenure track/No tenure system system total","39","15","24","0","0","0","5","1","4","18","9","9","2","0","2","0","0","0","13","5","8","0","0","0","1","0","1","0","0","0","-2"
"130934","Delaware State University","2018","Not on tenure/no tenure system, professors","1","1","0","0","0","0","0","0","0","1","1","0","0","0","0","0","0","0","0","0","0","0","0","0","0","0","0","0","0","0","-2"
"130934","Delaware State University","2018","Not on tenure/no tenure system, associate professors","1","1","0","0","0","0","0","0","0","0","0","0","0","0","0","0","0","0","1","1","0","0","0","0","0","0","0","0","0","0","-2"
"130934","Delaware State University","2018","Not on tenure/no tenure system, assistant professors","14","6","8","0","0","0","3","1","2","8","4","4","1","0","1","0","0","0","1","1","0","0","0","0","1","0","1","0","0","0","-2"
"130934","Delaware State University","2018","Not on tenure/no tenure system, instructors","5","3","2","0","0","0","0","0","0","2","2","0","1","0","1","0","0","0","2","1","1","0","0","0","0","0","0","0","0","0","-2"
"130934","Delaware State University","2018","Not on tenure/no tenure system, lecturers","18","4","14","0","0","0","2","0","2","7","2","5","0","0","0","0","0","0","9","2","7","0","0","0","0","0","0","0","0","0","-2"
"130943","University of Delaware","2018","Tenured total","671","434","237","0","0","0","107","72","35","30","15","15","24","17","7","0","0","0","506","328","178","0","0","0","2","1","1","2","1","1","-2"
"130943","University of Delaware","2018","Tenured, professors","385","278","107","0","0","0","56","44","12","14","8","6","12","11","1","0","0","0","303","215","88","0","0","0","0","0","0","0","0","0","-2"
"130943","University of Delaware","2018","Tenured, associate professors","286","156","130","0","0","0","51","28","23","16","7","9","12","6","6","0","0","0","203","113","90","0","0","0","2","1","1","2","1","1","-2"
"130943","University of Delaware","2018","On-Tenure track total","220","107","113","0","0","0","36","15","21","11","5","6","13","5","8","0","0","0","127","61","66","3","2","1","0","0","0","30","19","11","-2"
"130943","University of Delaware","2018","On-tenure track, associate professors","14","3","11","0","0","0","0","0","0","0","0","0","2","0","2","0","0","0","12","3","9","0","0","0","0","0","0","0","0","0","-2"
"130943","University of Delaware","2018","On-tenure track, assistant professors","206","104","102","0","0","0","36","15","21","11","5","6","11","5","6","0","0","0","115","58","57","3","2","1","0","0","0","30","19","11","-2"
"130943","University of Delaware","2018","Not on tenure track/No tenure system system total","352","145","207","1","0","1","20","8","12","20","6","14","10","4","6","0","0","0","286","118","168","1","0","1","0","0","0","14","9","5","-2"
"130943","University of Delaware","2018","Not on tenure/no tenure system, professors","18","9","9","0","0","0","3","2","1","0","0","0","0","0","0","0","0","0","15","7","8","0","0","0","0","0","0","0","0","0","-2"
"130943","University of Delaware","2018","Not on tenure/no tenure system, associate professors","69","39","30","1","0","1","6","4","2","3","2","1","2","1","1","0","0","0","57","32","25","0","0","0","0","0","0","0","0","0","-2"
"130943","University of Delaware","2018","Not on tenure/no tenure system, assistant professors","167","71","96","0","0","0","9","2","7","11","3","8","4","3","1","0","0","0","129","55","74","1","0","1","0","0","0","13","8","5","-2"
"130943","University of Delaware","2018","Not on tenure/no tenure system, instructors","98","26","72","0","0","0","2","0","2","6","1","5","4","0","4","0","0","0","85","24","61","0","0","0","0","0","0","1","1","0","-2"
"131520","Howard University","2018","Tenured total","441","268","173","1","0","1","51","38","13","258","152","106","12","2","10","0","0","0","75","47","28","1","0","1","43","29","14","0","0","0","-2"
"131520","Howard University","2018","Tenured, professors","201","141","60","1","0","1","25","23","2","117","78","39","4","1","3","0","0","0","37","27","10","1","0","1","16","12","4","0","0","0","-2"
"131520","Howard University","2018","Tenured, associate professors","236","125","111","0","0","0","25","14","11","139","73","66","7","1","6","0","0","0","38","20","18","0","0","0","27","17","10","0","0","0","-2"
"131520","Howard University","2018","Tenured, assistant professors","4","2","2","0","0","0","1","1","0","2","1","1","1","0","1","0","0","0","0","0","0","0","0","0","0","0","0","0","0","0","-2"
"131520","Howard University","2018","On-Tenure track total","186","90","96","0","0","0","22","17","5","86","39","47","3","3","0","0","0","0","26","9","17","2","0","2","47","22","25","0","0","0","-2"
"131520","Howard University","2018","On-tenure track, professors","3","2","1","0","0","0","0","0","0","1","1","0","0","0","0","0","0","0","1","0","1","0","0","0","1","1","0","0","0","0","-2"
"131520","Howard University","2018","On-tenure track, associate professors","11","7","4","0","0","0","1","1","0","2","1","1","1","1","0","0","0","0","2","1","1","0","0","0","5","3","2","0","0","0","-2"
"131520","Howard University","2018","On-tenure track, assistant professors","171","81","90","0","0","0","21","16","5","82","37","45","2","2","0","0","0","0","23","8","15","2","0","2","41","18","23","0","0","0","-2"
"131520","Howard University","2018","On-tenure track, instructors","1","0","1","0","0","0","0","0","0","1","0","1","0","0","0","0","0","0","0","0","0","0","0","0","0","0","0","0","0","0","-2"
"131520","Howard University","2018","Not on tenure track/No tenure system system total","293","137","156","1","1","0","22","12","10","168","74","94","11","7","4","0","0","0","25","12","13","1","1","0","65","30","35","0","0","0","-2"
"131520","Howard University","2018","Not on tenure/no tenure system, professors","5","4","1","0","0","0","2","2","0","1","1","0","0","0","0","0","0","0","0","0","0","0","0","0","2","1","1","0","0","0","-2"
"131520","Howard University","2018","Not on tenure/no tenure system, associate professors","41","18","23","0","0","0","2","1","1","29","11","18","0","0","0","0","0","0","2","1","1","0","0","0","8","5","3","0","0","0","-2"
"131520","Howard University","2018","Not on tenure/no tenure system, assistant professors","108","52","56","1","1","0","14","8","6","58","25","33","2","2","0","0","0","0","8","4","4","0","0","0","25","12","13","0","0","0","-2"
"131520","Howard University","2018","Not on tenure/no tenure system, instructors","53","20","33","0","0","0","3","1","2","26","9","17","2","1","1","0","0","0","10","5","5","1","1","0","11","3","8","0","0","0","-2"
"131520","Howard University","2018","Not on tenure/no tenure system, lecturers","86","43","43","0","0","0","1","0","1","54","28","26","7","4","3","0","0","0","5","2","3","0","0","0","19","9","10","0","0","0","-2"
"133553","Embry-Riddle Aeronautical University-Daytona Beach","2018","Tenured total","137","105","32","0","0","0","19","13","6","1","0","1","3","1","2","0","0","0","113","91","22","1","0","1","0","0","0","0","0","0","-2"
"133553","Embry-Riddle Aeronautical University-Daytona Beach","2018","Tenured, professors","78","66","12","0","0","0","11","9","2","0","0","0","1","1","0","0","0","0","66","56","10","0","0","0","0","0","0","0","0","0","-2"
"133553","Embry-Riddle Aeronautical University-Daytona Beach","2018","Tenured, associate professors","58","39","19","0","0","0","8","4","4","1","0","1","2","0","2","0","0","0","47","35","12","0","0","0","0","0","0","0","0","0","-2"
"133553","Embry-Riddle Aeronautical University-Daytona Beach","2018","Tenured, assistant professors","1","0","1","0","0","0","0","0","0","0","0","0","0","0","0","0","0","0","0","0","0","1","0","1","0","0","0","0","0","0","-2"
"133553","Embry-Riddle Aeronautical University-Daytona Beach","2018","On-Tenure track total","64","45","19","0","0","0","9","8","1","2","2","0","5","3","2","0","0","0","39","25","14","0","0","0","0","0","0","9","7","2","-2"
"133553","Embry-Riddle Aeronautical University-Daytona Beach","2018","On-tenure track, professors","2","2","0","0","0","0","0","0","0","0","0","0","0","0","0","0","0","0","2","2","0","0","0","0","0","0","0","0","0","0","-2"
"133553","Embry-Riddle Aeronautical University-Daytona Beach","2018","On-tenure track, associate professors","6","5","1","0","0","0","0","0","0","0","0","0","1","0","1","0","0","0","5","5","0","0","0","0","0","0","0","0","0","0","-2"
"133553","Embry-Riddle Aeronautical University-Daytona Beach","2018","On-tenure track, assistant professors","56","38","18","0","0","0","9","8","1","2","2","0","4","3","1","0","0","0","32","18","14","0","0","0","0","0","0","9","7","2","-2"
"133553","Embry-Riddle Aeronautical University-Daytona Beach","2018","Not on tenure track/No tenure system system total","115","79","36","0","0","0","7","3","4","3","2","1","6","4","2","1","1","0","92","66","26","0","0","0","1","0","1","5","3","2","-2"
"133553","Embry-Riddle Aeronautical University-Daytona Beach","2018","Not on tenure/no tenure system, professors","5","4","1","0","0","0","1","1","0","0","0","0","0","0","0","0","0","0","4","3","1","0","0","0","0","0","0","0","0","0","-2"
"133553","Embry-Riddle Aeronautical University-Daytona Beach","2018","Not on tenure/no tenure system, associate professors","33","30","3","0","0","0","2","1","1","2","2","0","3","3","0","1","1","0","25","23","2","0","0","0","0","0","0","0","0","0","-2"
"133553","Embry-Riddle Aeronautical University-Daytona Beach","2018","Not on tenure/no tenure system, assistant professors","52","32","20","0","0","0","3","1","2","1","0","1","1","1","0","0","0","0","42","27","15","0","0","0","1","0","1","4","3","1","-2"
"133553","Embry-Riddle Aeronautical University-Daytona Beach","2018","Not on tenure/no tenure system, instructors","25","13","12","0","0","0","1","0","1","0","0","0","2","0","2","0","0","0","21","13","8","0","0","0","0","0","0","1","0","1","-2"
"133650","Florida Agricultural and Mechanical University","2018","Tenured total","307","187","120","0","0","0","18","14","4","208","117","91","9","4","5","0","0","0","51","36","15","1","1","0","0","0","0","20","15","5","-2"
"133650","Florida Agricultural and Mechanical University","2018","Tenured, professors","151","104","47","0","0","0","12","11","1","97","63","34","2","1","1","0","0","0","30","21","9","0","0","0","0","0","0","10","8","2","-2"
"133650","Florida Agricultural and Mechanical University","2018","Tenured, associate professors","138","72","66","0","0","0","5","3","2","97","46","51","6","2","4","0","0","0","20","14","6","0","0","0","0","0","0","10","7","3","-2"
"133650","Florida Agricultural and Mechanical University","2018","Tenured, assistant professors","18","11","7","0","0","0","1","0","1","14","8","6","1","1","0","0","0","0","1","1","0","1","1","0","0","0","0","0","0","0","-2"
"133650","Florida Agricultural and Mechanical University","2018","On-Tenure track total","114","55","59","0","0","0","7","4","3","71","28","43","6","5","1","0","0","0","17","10","7","0","0","0","0","0","0","13","8","5","-2"
"133650","Florida Agricultural and Mechanical University","2018","On-tenure track, professors","4","1","3","0","0","0","1","0","1","1","0","1","0","0","0","0","0","0","1","1","0","0","0","0","0","0","0","1","0","1","-2"
"133650","Florida Agricultural and Mechanical University","2018","On-tenure track, associate professors","10","5","5","0","0","0","0","0","0","8","3","5","1","1","0","0","0","0","0","0","0","0","0","0","0","0","0","1","1","0","-2"
"133650","Florida Agricultural and Mechanical University","2018","On-tenure track, assistant professors","100","49","51","0","0","0","6","4","2","62","25","37","5","4","1","0","0","0","16","9","7","0","0","0","0","0","0","11","7","4","-2"
"133650","Florida Agricultural and Mechanical University","2018","Not on tenure track/No tenure system system total","160","69","91","2","2","0","4","2","2","109","36","73","3","1","2","0","0","0","24","17","7","0","0","0","0","0","0","18","11","7","-2"
"133650","Florida Agricultural and Mechanical University","2018","Not on tenure/no tenure system, professors","8","6","2","0","0","0","0","0","0","5","3","2","0","0","0","0","0","0","3","3","0","0","0","0","0","0","0","0","0","0","-2"
"133650","Florida Agricultural and Mechanical University","2018","Not on tenure/no tenure system, associate professors","3","1","2","0","0","0","1","0","1","1","0","1","0","0","0","0","0","0","1","1","0","0","0","0","0","0","0","0","0","0","-2"
"133650","Florida Agricultural and Mechanical University","2018","Not on tenure/no tenure system, assistant professors","29","14","15","0","0","0","0","0","0","20","6","14","0","0","0","0","0","0","6","5","1","0","0","0","0","0","0","3","3","0","-2"
"133650","Florida Agricultural and Mechanical University","2018","Not on tenure/no tenure system, instructors","75","24","51","0","0","0","2","1","1","51","13","38","3","1","2","0","0","0","9","4","5","0","0","0","0","0","0","10","5","5","-2"
"133650","Florida Agricultural and Mechanical University","2018","Not on tenure/no tenure system, no academic rank","45","24","21","2","2","0","1","1","0","32","14","18","0","0","0","0","0","0","5","4","1","0","0","0","0","0","0","5","3","2","-2"
"133881","Florida Institute of Technology","2018","Not on tenure track/No tenure system system total","290","218","72","5","5","0","33","27","6","5","2","3","20","10","10","16","16","0","207","156","51","1","0","1","3","2","1","0","0","0","-2"
"133881","Florida Institute of Technology","2018","Not on tenure/no tenure system, professors","80","67","13","1","1","0","8","7","1","0","0","0","2","1","1","10","10","0","58","47","11","0","0","0","1","1","0","0","0","0","-2"
"133881","Florida Institute of Technology","2018","Not on tenure/no tenure system, associate professors","90","75","15","2","2","0","12","11","1","1","1","0","4","4","0","5","5","0","65","52","13","1","0","1","0","0","0","0","0","0","-2"
"133881","Florida Institute of Technology","2018","Not on tenure/no tenure system, assistant professors","99","66","33","2","2","0","13","9","4","2","1","1","14","5","9","1","1","0","65","47","18","0","0","0","2","1","1","0","0","0","-2"
"133881","Florida Institute of Technology","2018","Not on tenure/no tenure system, instructors","21","10","11","0","0","0","0","0","0","2","0","2","0","0","0","0","0","0","19","10","9","0","0","0","0","0","0","0","0","0","-2"
"133951","Florida International University","2018","Tenured total","510","352","158","1","0","1","114","88","26","26","15","11","65","49","16","1","1","0","295","197","98","0","0","0","0","0","0","8","2","6","-2"
"133951","Florida International University","2018","Tenured, professors","252","193","59","1","0","1","47","40","7","11","10","1","45","37","8","0","0","0","147","105","42","0","0","0","0","0","0","1","1","0","-2"
"133951","Florida International University","2018","Tenured, associate professors","258","159","99","0","0","0","67","48","19","15","5","10","20","12","8","1","1","0","148","92","56","0","0","0","0","0","0","7","1","6","-2"
"133951","Florida International University","2018","On-Tenure track total","202","113","89","2","2","0","33","22","11","8","1","7","18","8","10","0","0","0","107","57","50","0","0","0","0","0","0","34","23","11","-2"
"133951","Florida International University","2018","On-tenure track, associate professors","20","12","8","1","1","0","6","4","2","2","0","2","0","0","0","0","0","0","11","7","4","0","0","0","0","0","0","0","0","0","-2"
"133951","Florida International University","2018","On-tenure track, assistant professors","182","101","81","1","1","0","27","18","9","6","1","5","18","8","10","0","0","0","96","50","46","0","0","0","0","0","0","34","23","11","-2"
"133951","Florida International University","2018","Not on tenure track/No tenure system system total","559","262","297","2","1","1","34","17","17","45","11","34","173","71","102","0","0","0","258","129","129","8","3","5","0","0","0","39","30","9","-2"
"133951","Florida International University","2018","Not on tenure/no tenure system, professors","21","14","7","0","0","0","2","1","1","0","0","0","5","4","1","0","0","0","11","6","5","0","0","0","0","0","0","3","3","0","-2"
"133951","Florida International University","2018","Not on tenure/no tenure system, associate professors","47","22","25","0","0","0","2","1","1","7","2","5","11","5","6","0","0","0","23","10","13","1","1","0","0","0","0","3","3","0","-2"
"133951","Florida International University","2018","Not on tenure/no tenure system, assistant professors","136","49","87","0","0","0","12","7","5","16","0","16","50","19","31","0","0","0","45","14","31","4","1","3","0","0","0","9","8","1","-2"
"133951","Florida International University","2018","Not on tenure/no tenure system, instructors","305","151","154","1","0","1","15","7","8","19","8","11","87","37","50","0","0","0","156","82","74","3","1","2","0","0","0","24","16","8","-2"
"133951","Florida International University","2018","Not on tenure/no tenure system, lecturers","32","16","16","1","1","0","3","1","2","3","1","2","9","3","6","0","0","0","16","10","6","0","0","0","0","0","0","0","0","0","-2"
"133951","Florida International University","2018","Not on tenure/no tenure system, no academic rank","18","10","8","0","0","0","0","0","0","0","0","0","11","3","8","0","0","0","7","7","0","0","0","0","0","0","0","0","0","0","-2"
"133979","Florida Memorial University","2018","Tenured total","26","16","10","0","0","0","5","5","0","11","5","6","2","2","0","0","0","0","8","4","4","0","0","0","0","0","0","0","0","0","-2"
"133979","Florida Memorial University","2018","Tenured, professors","7","4","3","0","0","0","3","3","0","2","0","2","0","0","0","0","0","0","2","1","1","0","0","0","0","0","0","0","0","0","-2"
"133979","Florida Memorial University","2018","Tenured, associate professors","19","12","7","0","0","0","2","2","0","9","5","4","2","2","0","0","0","0","6","3","3","0","0","0","0","0","0","0","0","0","-2"
"133979","Florida Memorial University","2018","On-Tenure track total","33","18","15","0","0","0","3","2","1","22","12","10","3","1","2","0","0","0","4","3","1","1","0","1","0","0","0","0","0","0","-2"
"133979","Florida Memorial University","2018","On-tenure track, associate professors","12","7","5","0","0","0","0","0","0","9","5","4","2","1","1","0","0","0","1","1","0","0","0","0","0","0","0","0","0","0","-2"
"133979","Florida Memorial University","2018","On-tenure track, assistant professors","21","11","10","0","0","0","3","2","1","13","7","6","1","0","1","0","0","0","3","2","1","1","0","1","0","0","0","0","0","0","-2"
"133979","Florida Memorial University","2018","Not on tenure track/No tenure system system total","8","6","2","0","0","0","1","1","0","4","3","1","2","1","1","0","0","0","1","1","0","0","0","0","0","0","0","0","0","0","-2"
"133979","Florida Memorial University","2018","Not on tenure/no tenure system, instructors","8","6","2","0","0","0","1","1","0","4","3","1","2","1","1","0","0","0","1","1","0","0","0","0","0","0","0","0","0","0","-2"
"134097","Florida State University","2018","Tenured total","788","542","246","3","3","0","114","87","27","33","15","18","28","20","8","0","0","0","601","414","187","7","2","5","0","0","0","2","1","1","-2"
"134097","Florida State University","2018","Tenured, professors","492","367","125","2","2","0","67","54","13","18","10","8","17","12","5","0","0","0","384","287","97","4","2","2","0","0","0","0","0","0","-2"
"134097","Florida State University","2018","Tenured, associate professors","296","175","121","1","1","0","47","33","14","15","5","10","11","8","3","0","0","0","217","127","90","3","0","3","0","0","0","2","1","1","-2"
"134097","Florida State University","2018","On-Tenure track total","369","203","166","1","1","0","46","28","18","18","9","9","19","10","9","0","0","0","218","112","106","7","3","4","0","0","0","60","40","20","-2"
"134097","Florida State University","2018","On-tenure track, professors","6","4","2","0","0","0","1","1","0","0","0","0","0","0","0","0","0","0","5","3","2","0","0","0","0","0","0","0","0","0","-2"
"134097","Florida State University","2018","On-tenure track, associate professors","17","9","8","0","0","0","3","2","1","1","1","0","1","0","1","0","0","0","9","3","6","0","0","0","0","0","0","3","3","0","-2"
"134097","Florida State University","2018","On-tenure track, assistant professors","346","190","156","1","1","0","42","25","17","17","8","9","18","10","8","0","0","0","204","106","98","7","3","4","0","0","0","57","37","20","-2"
"134097","Florida State University","2018","Not on tenure track/No tenure system system total","424","189","235","1","1","0","20","7","13","32","10","22","27","9","18","0","0","0","318","150","168","7","1","6","4","2","2","15","9","6","-2"
"134097","Florida State University","2018","Not on tenure/no tenure system, professors","17","7","10","0","0","0","0","0","0","3","1","2","2","0","2","0","0","0","11","6","5","1","0","1","0","0","0","0","0","0","-2"
"134097","Florida State University","2018","Not on tenure/no tenure system, associate professors","14","9","5","0","0","0","1","0","1","1","1","0","2","2","0","0","0","0","10","6","4","0","0","0","0","0","0","0","0","0","-2"
"134097","Florida State University","2018","Not on tenure/no tenure system, assistant professors","36","12","24","0","0","0","1","1","0","6","2","4","3","1","2","0","0","0","22","8","14","1","0","1","1","0","1","2","0","2","-2"
"134097","Florida State University","2018","Not on tenure/no tenure system, no academic rank","357","161","196","1","1","0","18","6","12","22","6","16","20","6","14","0","0","0","275","130","145","5","1","4","3","2","1","13","9","4","-2"
"135726","University of Miami","2018","Tenured total","831","602","229","2","2","0","112","83","29","21","14","7","98","63","35","0","0","0","582","429","153","3","2","1","5","4","1","8","5","3","-2"
"135726","University of Miami","2018","Tenured, professors","563","440","123","2","2","0","67","52","15","11","7","4","73","51","22","0","0","0","401","321","80","3","2","1","4","4","0","2","1","1","-2"
"135726","University of Miami","2018","Tenured, associate professors","268","162","106","0","0","0","45","31","14","10","7","3","25","12","13","0","0","0","181","108","73","0","0","0","1","0","1","6","4","2","-2"
"135726","University of Miami","2018","On-Tenure track total","198","124","74","1","1","0","38","28","10","10","6","4","17","12","5","0","0","0","94","52","42","1","0","1","1","1","0","36","24","12","-2"
"135726","University of Miami","2018","On-tenure track, professors","9","8","1","0","0","0","1","1","0","1","1","0","1","1","0","0","0","0","5","4","1","0","0","0","0","0","0","1","1","0","-2"
"135726","University of Miami","2018","On-tenure track, associate professors","34","24","10","0","0","0","12","10","2","1","1","0","2","2","0","0","0","0","17","9","8","0","0","0","1","1","0","1","1","0","-2"
"135726","University of Miami","2018","On-tenure track, assistant professors","155","92","63","1","1","0","25","17","8","8","4","4","14","9","5","0","0","0","72","39","33","1","0","1","0","0","0","34","22","12","-2"
"135726","University of Miami","2018","Not on tenure track/No tenure system system total","457","219","238","0","0","0","20","4","16","30","10","20","121","53","68","0","0","0","251","131","120","4","2","2","8","5","3","23","14","9","-2"
"135726","University of Miami","2018","Not on tenure/no tenure system, professors","24","17","7","0","0","0","0","0","0","2","0","2","3","3","0","0","0","0","18","13","5","0","0","0","0","0","0","1","1","0","-2"
"135726","University of Miami","2018","Not on tenure/no tenure system, associate professors","40","22","18","0","0","0","2","1","1","4","2","2","10","5","5","0","0","0","23","13","10","1","1","0","0","0","0","0","0","0","-2"
"135726","University of Miami","2018","Not on tenure/no tenure system, assistant professors","84","34","50","0","0","0","5","2","3","8","1","7","28","10","18","0","0","0","33","17","16","0","0","0","3","2","1","7","2","5","-2"
"135726","University of Miami","2018","Not on tenure/no tenure system, instructors","1","1","0","0","0","0","0","0","0","1","1","0","0","0","0","0","0","0","0","0","0","0","0","0","0","0","0","0","0","0","-2"
"135726","University of Miami","2018","Not on tenure/no tenure system, lecturers","308","145","163","0","0","0","13","1","12","15","6","9","80","35","45","0","0","0","177","88","89","3","1","2","5","3","2","15","11","4","-2"
"137351","University of South Florida-Main Campus","2018","Tenured total","710","472","238","2","1","1","109","84","25","31","15","16","44","25","19","0","0","0","506","334","172","0","0","0","3","3","0","15","10","5","-2"
"137351","University of South Florida-Main Campus","2018","Tenured, professors","378","280","98","2","1","1","57","53","4","8","5","3","26","17","9","0","0","0","282","201","81","0","0","0","2","2","0","1","1","0","-2"
"137351","University of South Florida-Main Campus","2018","Tenured, associate professors","331","192","139","0","0","0","52","31","21","23","10","13","18","8","10","0","0","0","223","133","90","0","0","0","1","1","0","14","9","5","-2"
"137351","University of South Florida-Main Campus","2018","Tenured, instructors","1","0","1","0","0","0","0","0","0","0","0","0","0","0","0","0","0","0","1","0","1","0","0","0","0","0","0","0","0","0","-2"
"137351","University of South Florida-Main Campus","2018","On-Tenure track total","261","146","115","1","0","1","52","32","20","16","6","10","20","8","12","0","0","0","131","72","59","0","0","0","7","6","1","34","22","12","-2"
"137351","University of South Florida-Main Campus","2018","On-tenure track, professors","16","13","3","0","0","0","2","2","0","0","0","0","1","0","1","0","0","0","13","11","2","0","0","0","0","0","0","0","0","0","-2"
"137351","University of South Florida-Main Campus","2018","On-tenure track, associate professors","34","20","14","0","0","0","9","9","0","2","0","2","3","1","2","0","0","0","16","8","8","0","0","0","1","1","0","3","1","2","-2"
"137351","University of South Florida-Main Campus","2018","On-tenure track, assistant professors","208","111","97","1","0","1","39","20","19","14","6","8","16","7","9","0","0","0","101","52","49","0","0","0","6","5","1","31","21","10","-2"
"137351","University of South Florida-Main Campus","2018","On-tenure track, instructors","3","2","1","0","0","0","2","1","1","0","0","0","0","0","0","0","0","0","1","1","0","0","0","0","0","0","0","0","0","0","-2"
"137351","University of South Florida-Main Campus","2018","Not on tenure track/No tenure system system total","851","380","471","1","1","0","102","50","52","44","18","26","122","61","61","1","0","1","557","235","322","0","0","0","0","0","0","24","15","9","-2"
"137351","University of South Florida-Main Campus","2018","Not on tenure/no tenure system, professors","49","34","15","0","0","0","5","3","2","2","0","2","6","5","1","0","0","0","35","25","10","0","0","0","0","0","0","1","1","0","-2"
"137351","University of South Florida-Main Campus","2018","Not on tenure/no tenure system, associate professors","83","44","39","1","1","0","12","8","4","6","3","3","14","9","5","0","0","0","49","23","26","0","0","0","0","0","0","1","0","1","-2"
"137351","University of South Florida-Main Campus","2018","Not on tenure/no tenure system, assistant professors","265","119","146","0","0","0","39","20","19","9","3","6","60","31","29","1","0","1","147","60","87","0","0","0","0","0","0","9","5","4","-2"
"137351","University of South Florida-Main Campus","2018","Not on tenure/no tenure system, instructors","387","150","237","0","0","0","27","10","17","24","9","15","30","9","21","0","0","0","295","114","181","0","0","0","0","0","0","11","8","3","-2"
"137351","University of South Florida-Main Campus","2018","Not on tenure/no tenure system, no academic rank","67","33","34","0","0","0","19","9","10","3","3","0","12","7","5","0","0","0","31","13","18","0","0","0","0","0","0","2","1","1","-2"
"139755","Georgia Institute of Technology-Main Campus","2018","Tenured total","663","524","139","0","0","0","71","59","12","22","14","8","19","13","6","0","0","0","350","280","70","1","1","0","2","2","0","198","155","43","-2"
"139755","Georgia Institute of Technology-Main Campus","2018","Tenured, professors","414","343","71","0","0","0","51","45","6","10","6","4","9","7","2","0","0","0","237","193","44","0","0","0","2","2","0","105","90","15","-2"
"139755","Georgia Institute of Technology-Main Campus","2018","Tenured, associate professors","248","181","67","0","0","0","20","14","6","12","8","4","10","6","4","0","0","0","112","87","25","1","1","0","0","0","0","93","65","28","-2"
"139755","Georgia Institute of Technology-Main Campus","2018","Tenured, no academic rank","1","0","1","0","0","0","0","0","0","0","0","0","0","0","0","0","0","0","1","0","1","0","0","0","0","0","0","0","0","0","-2"
"139755","Georgia Institute of Technology-Main Campus","2018","On-Tenure track total","170","113","57","0","0","0","22","13","9","5","3","2","2","2","0","0","0","0","69","44","25","1","1","0","5","4","1","66","46","20","-2"
"139755","Georgia Institute of Technology-Main Campus","2018","On-tenure track, professors","1","1","0","0","0","0","0","0","0","0","0","0","0","0","0","0","0","0","1","1","0","0","0","0","0","0","0","0","0","0","-2"
"139755","Georgia Institute of Technology-Main Campus","2018","On-tenure track, associate professors","11","9","2","0","0","0","3","2","1","2","2","0","0","0","0","0","0","0","0","0","0","0","0","0","0","0","0","6","5","1","-2"
"139755","Georgia Institute of Technology-Main Campus","2018","On-tenure track, assistant professors","158","103","55","0","0","0","19","11","8","3","1","2","2","2","0","0","0","0","68","43","25","1","1","0","5","4","1","60","41","19","-2"
"139755","Georgia Institute of Technology-Main Campus","2018","Not on tenure track/No tenure system system total","185","96","89","0","0","0","15","7","8","4","4","0","2","0","2","0","0","0","126","65","61","0","0","0","2","0","2","36","20","16","-2"
"139755","Georgia Institute of Technology-Main Campus","2018","Not on tenure/no tenure system, instructors","4","1","3","0","0","0","0","0","0","0","0","0","0","0","0","0","0","0","4","1","3","0","0","0","0","0","0","0","0","0","-2"
"139755","Georgia Institute of Technology-Main Campus","2018","Not on tenure/no tenure system, lecturers","95","47","48","0","0","0","8","2","6","3","3","0","2","0","2","0","0","0","64","32","32","0","0","0","1","0","1","17","10","7","-2"
"139755","Georgia Institute of Technology-Main Campus","2018","Not on tenure/no tenure system, no academic rank","86","48","38","0","0","0","7","5","2","1","1","0","0","0","0","0","0","0","58","32","26","0","0","0","1","0","1","19","10","9","-2"
"139959","University of Georgia","2018","Tenured total","1245","834","411","5","3","2","132","99","33","68","36","32","52","30","22","0","0","0","942","634","308","6","4","2","38","27","11","2","1","1","-2"
"139959","University of Georgia","2018","Tenured, professors","734","538","196","4","2","2","70","55","15","41","24","17","25","17","8","0","0","0","569","423","146","3","3","0","21","14","7","1","0","1","-2"
"139959","University of Georgia","2018","Tenured, associate professors","510","295","215","1","1","0","62","44","18","27","12","15","27","13","14","0","0","0","372","210","162","3","1","2","17","13","4","1","1","0","-2"
"139959","University of Georgia","2018","Tenured, assistant professors","1","1","0","0","0","0","0","0","0","0","0","0","0","0","0","0","0","0","1","1","0","0","0","0","0","0","0","0","0","0","-2"
"139959","University of Georgia","2018","On-Tenure track total","406","226","180","0","0","0","55","34","21","20","10","10","16","8","8","0","0","0","214","117","97","1","0","1","91","51","40","9","6","3","-2"
"139959","University of Georgia","2018","On-tenure track, professors","1","1","0","0","0","0","0","0","0","0","0","0","0","0","0","0","0","0","1","1","0","0","0","0","0","0","0","0","0","0","-2"
"139959","University of Georgia","2018","On-tenure track, associate professors","18","12","6","0","0","0","4","1","3","2","2","0","0","0","0","0","0","0","6","4","2","0","0","0","6","5","1","0","0","0","-2"
"139959","University of Georgia","2018","On-tenure track, assistant professors","387","213","174","0","0","0","51","33","18","18","8","10","16","8","8","0","0","0","207","112","95","1","0","1","85","46","39","9","6","3","-2"
"139959","University of Georgia","2018","Not on tenure track/No tenure system system total","447","210","237","2","0","2","18","7","11","13","3","10","15","3","12","0","0","0","328","156","172","4","2","2","58","31","27","9","8","1","-2"
"139959","University of Georgia","2018","Not on tenure/no tenure system, professors","20","8","12","0","0","0","0","0","0","1","1","0","0","0","0","0","0","0","18","7","11","0","0","0","1","0","1","0","0","0","-2"
"139959","University of Georgia","2018","Not on tenure/no tenure system, associate professors","37","13","24","0","0","0","1","0","1","1","0","1","2","1","1","0","0","0","26","9","17","1","0","1","5","3","2","1","0","1","-2"
"139959","University of Georgia","2018","Not on tenure/no tenure system, assistant professors","84","36","48","1","0","1","4","1","3","3","0","3","0","0","0","0","0","0","48","18","30","2","1","1","21","11","10","5","5","0","-2"
"139959","University of Georgia","2018","Not on tenure/no tenure system, instructors","75","36","39","1","0","1","3","1","2","0","0","0","8","0","8","0","0","0","53","28","25","0","0","0","9","6","3","1","1","0","-2"
"139959","University of Georgia","2018","Not on tenure/no tenure system, lecturers","231","117","114","0","0","0","10","5","5","8","2","6","5","2","3","0","0","0","183","94","89","1","1","0","22","11","11","2","2","0","-2"
"140720","Paine College","2018","Tenured total","3","3","0","0","0","0","1","1","0","1","1","0","0","0","0","0","0","0","1","1","0","0","0","0","0","0","0","0","0","0","-2"
"140720","Paine College","2018","Tenured, professors","3","3","0","0","0","0","1","1","0","1","1","0","0","0","0","0","0","0","1","1","0","0","0","0","0","0","0","0","0","0","-2"
"140720","Paine College","2018","On-Tenure track total","23","16","7","0","0","0","4","4","0","11","5","6","1","1","0","0","0","0","5","4","1","0","0","0","0","0","0","2","2","0","-2"
"140720","Paine College","2018","On-tenure track, associate professors","4","4","0","0","0","0","1","1","0","2","2","0","0","0","0","0","0","0","0","0","0","0","0","0","0","0","0","1","1","0","-2"
"140720","Paine College","2018","On-tenure track, assistant professors","19","12","7","0","0","0","3","3","0","9","3","6","1","1","0","0","0","0","5","4","1","0","0","0","0","0","0","1","1","0","-2"
"140720","Paine College","2018","Not on tenure track/No tenure system system total","9","5","4","0","0","0","1","0","1","7","5","2","0","0","0","0","0","0","1","0","1","0","0","0","0","0","0","0","0","0","-2"
"140720","Paine College","2018","Not on tenure/no tenure system, assistant professors","3","2","1","0","0","0","1","0","1","2","2","0","0","0","0","0","0","0","0","0","0","0","0","0","0","0","0","0","0","0","-2"
"140720","Paine College","2018","Not on tenure/no tenure system, instructors","6","3","3","0","0","0","0","0","0","5","3","2","0","0","0","0","0","0","1","0","1","0","0","0","0","0","0","0","0","0","-2"
"140960","Savannah State University","2018","Tenured total","76","50","26","0","0","0","20","16","4","32","22","10","1","1","0","0","0","0","14","8","6","0","0","0","2","0","2","7","3","4","-2"
"140960","Savannah State University","2018","Tenured, professors","32","25","7","0","0","0","12","11","1","14","11","3","0","0","0","0","0","0","6","3","3","0","0","0","0","0","0","0","0","0","-2"
"140960","Savannah State University","2018","Tenured, associate professors","40","23","17","0","0","0","8","5","3","16","10","6","1","1","0","0","0","0","7","4","3","0","0","0","1","0","1","7","3","4","-2"
"140960","Savannah State University","2018","Tenured, assistant professors","4","2","2","0","0","0","0","0","0","2","1","1","0","0","0","0","0","0","1","1","0","0","0","0","1","0","1","0","0","0","-2"
"140960","Savannah State University","2018","On-Tenure track total","57","28","29","0","0","0","3","2","1","25","10","15","2","1","1","1","0","1","21","12","9","0","0","0","0","0","0","5","3","2","-2"
"140960","Savannah State University","2018","On-tenure track, associate professors","4","2","2","0","0","0","0","0","0","0","0","0","0","0","0","0","0","0","4","2","2","0","0","0","0","0","0","0","0","0","-2"
"140960","Savannah State University","2018","On-tenure track, assistant professors","51","26","25","0","0","0","3","2","1","24","10","14","2","1","1","1","0","1","16","10","6","0","0","0","0","0","0","5","3","2","-2"
"140960","Savannah State University","2018","On-tenure track, instructors","1","0","1","0","0","0","0","0","0","1","0","1","0","0","0","0","0","0","0","0","0","0","0","0","0","0","0","0","0","0","-2"
"140960","Savannah State University","2018","On-tenure track, lecturers","1","0","1","0","0","0","0","0","0","0","0","0","0","0","0","0","0","0","1","0","1","0","0","0","0","0","0","0","0","0","-2"
"140960","Savannah State University","2018","Not on tenure track/No tenure system system total","62","27","35","0","0","0","4","1","3","29","9","20","2","1","1","0","0","0","21","14","7","0","0","0","4","1","3","2","1","1","-2"
"140960","Savannah State University","2018","Not on tenure/no tenure system, professors","1","1","0","0","0","0","0","0","0","1","1","0","0","0","0","0","0","0","0","0","0","0","0","0","0","0","0","0","0","0","-2"
"140960","Savannah State University","2018","Not on tenure/no tenure system, assistant professors","6","1","5","0","0","0","1","0","1","3","0","3","0","0","0","0","0","0","2","1","1","0","0","0","0","0","0","0","0","0","-2"
"140960","Savannah State University","2018","Not on tenure/no tenure system, instructors","30","14","16","0","0","0","2","1","1","13","6","7","1","0","1","0","0","0","9","6","3","0","0","0","3","0","3","2","1","1","-2"
"140960","Savannah State University","2018","Not on tenure/no tenure system, lecturers","17","7","10","0","0","0","1","0","1","8","2","6","0","0","0","0","0","0","7","4","3","0","0","0","1","1","0","0","0","0","-2"
"140960","Savannah State University","2018","Not on tenure/no tenure system, no academic rank","8","4","4","0","0","0","0","0","0","4","0","4","1","1","0","0","0","0","3","3","0","0","0","0","0","0","0","0","0","0","-2"
"141060","Spelman College","2018","Tenured total","82","24","58","2","1","1","8","3","5","55","12","43","3","1","2","0","0","0","12","6","6","1","1","0","1","0","1","0","0","0","-2"
"141060","Spelman College","2018","Tenured, professors","19","7","12","0","0","0","5","2","3","9","1","8","1","0","1","0","0","0","4","4","0","0","0","0","0","0","0","0","0","0","-2"
"141060","Spelman College","2018","Tenured, associate professors","63","17","46","2","1","1","3","1","2","46","11","35","2","1","1","0","0","0","8","2","6","1","1","0","1","0","1","0","0","0","-2"
"141060","Spelman College","2018","On-Tenure track total","43","11","32","0","0","0","9","5","4","25","4","21","3","1","2","0","0","0","5","1","4","1","0","1","0","0","0","0","0","0","-2"
"141060","Spelman College","2018","On-tenure track, associate professors","1","0","1","0","0","0","0","0","0","1","0","1","0","0","0","0","0","0","0","0","0","0","0","0","0","0","0","0","0","0","-2"
"141060","Spelman College","2018","On-tenure track, assistant professors","42","11","31","0","0","0","9","5","4","24","4","20","3","1","2","0","0","0","5","1","4","1","0","1","0","0","0","0","0","0","-2"
"141060","Spelman College","2018","Not on tenure track/No tenure system system total","52","11","41","0","0","0","1","0","1","39","6","33","4","1","3","0","0","0","8","4","4","0","0","0","0","0","0","0","0","0","-2"
"141060","Spelman College","2018","Not on tenure/no tenure system, instructors","17","3","14","0","0","0","0","0","0","16","3","13","1","0","1","0","0","0","0","0","0","0","0","0","0","0","0","0","0","0","-2"
"141060","Spelman College","2018","Not on tenure/no tenure system, lecturers","35","8","27","0","0","0","1","0","1","23","3","20","3","1","2","0","0","0","8","4","4","0","0","0","0","0","0","0","0","0","-2"
"141574","University of Hawaii at Manoa","2018","Tenured total","723","436","287","1","1","0","207","123","84","6","4","2","10","7","3","37","12","25","420","269","151","9","2","7","0","0","0","33","18","15","-2"
"141574","University of Hawaii at Manoa","2018","Tenured, professors","429","286","143","1","1","0","121","84","37","3","2","1","5","2","3","15","4","11","269","186","83","2","0","2","0","0","0","13","7","6","-2"
"141574","University of Hawaii at Manoa","2018","Tenured, associate professors","293","150","143","0","0","0","85","39","46","3","2","1","5","5","0","22","8","14","151","83","68","7","2","5","0","0","0","20","11","9","-2"
"141574","University of Hawaii at Manoa","2018","Tenured, assistant professors","1","0","1","0","0","0","1","0","1","0","0","0","0","0","0","0","0","0","0","0","0","0","0","0","0","0","0","0","0","0","-2"
"141574","University of Hawaii at Manoa","2018","On-Tenure track total","204","100","104","0","0","0","53","31","22","5","1","4","4","1","3","14","3","11","96","53","43","14","4","10","0","0","0","18","7","11","-2"
"141574","University of Hawaii at Manoa","2018","On-tenure track, professors","2","2","0","0","0","0","1","1","0","0","0","0","0","0","0","0","0","0","1","1","0","0","0","0","0","0","0","0","0","0","-2"
"141574","University of Hawaii at Manoa","2018","On-tenure track, associate professors","8","6","2","0","0","0","5","4","1","0","0","0","0","0","0","0","0","0","3","2","1","0","0","0","0","0","0","0","0","0","-2"
"141574","University of Hawaii at Manoa","2018","On-tenure track, assistant professors","194","92","102","0","0","0","47","26","21","5","1","4","4","1","3","14","3","11","92","50","42","14","4","10","0","0","0","18","7","11","-2"
"141574","University of Hawaii at Manoa","2018","Not on tenure track/No tenure system system total","222","90","132","1","0","1","68","23","45","4","0","4","9","5","4","27","12","15","86","39","47","15","5","10","1","0","1","11","6","5","-2"
"141574","University of Hawaii at Manoa","2018","Not on tenure/no tenure system, professors","12","9","3","0","0","0","7","5","2","0","0","0","0","0","0","0","0","0","4","3","1","0","0","0","0","0","0","1","1","0","-2"
"141574","University of Hawaii at Manoa","2018","Not on tenure/no tenure system, associate professors","24","10","14","0","0","0","11","5","6","0","0","0","0","0","0","2","0","2","10","4","6","1","1","0","0","0","0","0","0","0","-2"
"141574","University of Hawaii at Manoa","2018","Not on tenure/no tenure system, assistant professors","73","31","42","1","0","1","16","4","12","2","0","2","5","3","2","4","3","1","34","18","16","4","0","4","1","0","1","6","3","3","-2"
"141574","University of Hawaii at Manoa","2018","Not on tenure/no tenure system, instructors","113","40","73","0","0","0","34","9","25","2","0","2","4","2","2","21","9","12","38","14","24","10","4","6","0","0","0","4","2","2","-2"
"141644","Hawaii Pacific University","2018","Tenured total","2","2","0","0","0","0","0","0","0","0","0","0","0","0","0","0","0","0","2","2","0","0","0","0","0","0","0","0","0","0","-2"
"141644","Hawaii Pacific University","2018","Tenured, professors","1","1","0","0","0","0","0","0","0","0","0","0","0","0","0","0","0","0","1","1","0","0","0","0","0","0","0","0","0","0","-2"
"141644","Hawaii Pacific University","2018","Tenured, associate professors","1","1","0","0","0","0","0","0","0","0","0","0","0","0","0","0","0","0","1","1","0","0","0","0","0","0","0","0","0","0","-2"
"141644","Hawaii Pacific University","2018","Not on tenure track/No tenure system system total","146","77","69","3","1","2","34","17","17","1","1","0","6","0","6","4","2","2","85","55","30","5","1","4","8","0","8","0","0","0","-2"
"141644","Hawaii Pacific University","2018","Not on tenure/no tenure system, professors","26","14","12","1","0","1","5","4","1","0","0","0","0","0","0","1","0","1","10","10","0","1","0","1","8","0","8","0","0","0","-2"
"141644","Hawaii Pacific University","2018","Not on tenure/no tenure system, associate professors","47","26","21","2","1","1","12","5","7","0","0","0","1","0","1","2","2","0","28","17","11","2","1","1","0","0","0","0","0","0","-2"
"141644","Hawaii Pacific University","2018","Not on tenure/no tenure system, assistant professors","45","24","21","0","0","0","10","5","5","0","0","0","3","0","3","0","0","0","30","19","11","2","0","2","0","0","0","0","0","0","-2"
"141644","Hawaii Pacific University","2018","Not on tenure/no tenure system, instructors","12","6","6","0","0","0","2","1","1","0","0","0","1","0","1","1","0","1","8","5","3","0","0","0","0","0","0","0","0","0","-2"
"141644","Hawaii Pacific University","2018","Not on tenure/no tenure system, lecturers","16","7","9","0","0","0","5","2","3","1","1","0","1","0","1","0","0","0","9","4","5","0","0","0","0","0","0","0","0","0","-2"
"142115","Boise State University","2018","Tenured total","363","202","161","3","1","2","28","19","9","2","2","0","12","5","7","0","0","0","310","168","142","3","3","0","0","0","0","5","4","1","-2"
"142115","Boise State University","2018","Tenured, professors","168","107","61","3","1","2","9","7","2","0","0","0","5","3","2","0","0","0","149","94","55","1","1","0","0","0","0","1","1","0","-2"
"142115","Boise State University","2018","Tenured, associate professors","193","94","99","0","0","0","19","12","7","2","2","0","7","2","5","0","0","0","159","73","86","2","2","0","0","0","0","4","3","1","-2"
"142115","Boise State University","2018","Tenured, assistant professors","2","1","1","0","0","0","0","0","0","0","0","0","0","0","0","0","0","0","2","1","1","0","0","0","0","0","0","0","0","0","-2"
"142115","Boise State University","2018","On-Tenure track total","163","88","75","0","0","0","14","6","8","0","0","0","3","1","2","0","0","0","123","67","56","1","1","0","2","2","0","20","11","9","-2"
"142115","Boise State University","2018","On-tenure track, associate professors","4","2","2","0","0","0","0","0","0","0","0","0","0","0","0","0","0","0","4","2","2","0","0","0","0","0","0","0","0","0","-2"
"142115","Boise State University","2018","On-tenure track, assistant professors","159","86","73","0","0","0","14","6","8","0","0","0","3","1","2","0","0","0","119","65","54","1","1","0","2","2","0","20","11","9","-2"
"142115","Boise State University","2018","Not on tenure track/No tenure system system total","243","103","140","0","0","0","8","4","4","2","1","1","8","1","7","1","1","0","220","94","126","1","0","1","1","0","1","2","2","0","-2"
"142115","Boise State University","2018","Not on tenure/no tenure system, associate professors","16","8","8","0","0","0","0","0","0","0","0","0","0","0","0","1","1","0","14","6","8","0","0","0","0","0","0","1","1","0","-2"
"142115","Boise State University","2018","Not on tenure/no tenure system, assistant professors","55","19","36","0","0","0","2","1","1","1","0","1","2","0","2","0","0","0","50","18","32","0","0","0","0","0","0","0","0","0","-2"
"142115","Boise State University","2018","Not on tenure/no tenure system, instructors","15","10","5","0","0","0","0","0","0","1","1","0","3","0","3","0","0","0","11","9","2","0","0","0","0","0","0","0","0","0","-2"
"142115","Boise State University","2018","Not on tenure/no tenure system, lecturers","137","59","78","0","0","0","6","3","3","0","0","0","3","1","2","0","0","0","125","54","71","1","0","1","1","0","1","1","1","0","-2"
"142115","Boise State University","2018","Not on tenure/no tenure system, no academic rank","20","7","13","0","0","0","0","0","0","0","0","0","0","0","0","0","0","0","20","7","13","0","0","0","0","0","0","0","0","0","-2"
"142294","The College of Idaho","2018","Tenured total","41","25","16","0","0","0","2","0","2","0","0","0","0","0","0","0","0","0","37","25","12","1","0","1","0","0","0","1","0","1","-2"
"142294","The College of Idaho","2018","Tenured, professors","23","15","8","0","0","0","2","0","2","0","0","0","0","0","0","0","0","0","20","15","5","0","0","0","0","0","0","1","0","1","-2"
"142294","The College of Idaho","2018","Tenured, associate professors","18","10","8","0","0","0","0","0","0","0","0","0","0","0","0","0","0","0","17","10","7","1","0","1","0","0","0","0","0","0","-2"
"142294","The College of Idaho","2018","On-Tenure track total","19","8","11","0","0","0","1","1","0","0","0","0","1","0","1","0","0","0","17","7","10","0","0","0","0","0","0","0","0","0","-2"
"142294","The College of Idaho","2018","On-tenure track, assistant professors","19","8","11","0","0","0","1","1","0","0","0","0","1","0","1","0","0","0","17","7","10","0","0","0","0","0","0","0","0","0","-2"
"142294","The College of Idaho","2018","Not on tenure track/No tenure system system total","20","13","7","0","0","0","0","0","0","0","0","0","1","1","0","0","0","0","18","11","7","0","0","0","0","0","0","1","1","0","-2"
"142294","The College of Idaho","2018","Not on tenure/no tenure system, assistant professors","4","2","2","0","0","0","0","0","0","0","0","0","0","0","0","0","0","0","4","2","2","0","0","0","0","0","0","0","0","0","-2"
"142294","The College of Idaho","2018","Not on tenure/no tenure system, instructors","13","8","5","0","0","0","0","0","0","0","0","0","1","1","0","0","0","0","12","7","5","0","0","0","0","0","0","0","0","0","-2"
"142294","The College of Idaho","2018","Not on tenure/no tenure system, no academic rank","3","3","0","0","0","0","0","0","0","0","0","0","0","0","0","0","0","0","2","2","0","0","0","0","0","0","0","1","1","0","-2"
"144050","University of Chicago","2018","Tenured total","858","632","226","1","1","0","114","90","24","29","19","10","25","20","5","0","0","0","658","476","182","7","6","1","17","14","3","7","6","1","-2"
"144050","University of Chicago","2018","Tenured, professors","659","507","152","0","0","0","83","73","10","18","12","6","18","15","3","0","0","0","519","388","131","4","4","0","13","12","1","4","3","1","-2"
"144050","University of Chicago","2018","Tenured, associate professors","199","125","74","1","1","0","31","17","14","11","7","4","7","5","2","0","0","0","139","88","51","3","2","1","4","2","2","3","3","0","-2"
"144050","University of Chicago","2018","On-Tenure track total","279","185","94","0","0","0","39","28","11","8","3","5","14","8","6","0","0","0","151","102","49","4","1","3","24","17","7","39","26","13","-2"
"144050","University of Chicago","2018","On-tenure track, professors","3","3","0","0","0","0","0","0","0","0","0","0","0","0","0","0","0","0","3","3","0","0","0","0","0","0","0","0","0","0","-2"
"144050","University of Chicago","2018","On-tenure track, associate professors","32","24","8","0","0","0","6","5","1","1","1","0","0","0","0","0","0","0","22","15","7","0","0","0","2","2","0","1","1","0","-2"
"144050","University of Chicago","2018","On-tenure track, assistant professors","244","158","86","0","0","0","33","23","10","7","2","5","14","8","6","0","0","0","126","84","42","4","1","3","22","15","7","38","25","13","-2"
"144050","University of Chicago","2018","Not on tenure track/No tenure system system total","1134","609","525","0","0","0","223","129","94","46","14","32","37","18","19","1","1","0","654","360","294","10","2","8","80","41","39","83","44","39","-2"
"144050","University of Chicago","2018","Not on tenure/no tenure system, professors","211","156","55","0","0","0","33","20","13","5","3","2","3","1","2","0","0","0","164","127","37","0","0","0","4","4","0","2","1","1","-2"
"144050","University of Chicago","2018","Not on tenure/no tenure system, associate professors","194","111","83","0","0","0","52","38","14","11","4","7","3","0","3","0","0","0","117","62","55","1","0","1","6","6","0","4","1","3","-2"
"144050","University of Chicago","2018","Not on tenure/no tenure system, assistant professors","364","171","193","0","0","0","88","48","40","19","5","14","12","8","4","0","0","0","186","81","105","3","2","1","36","17","19","20","10","10","-2"
"144050","University of Chicago","2018","Not on tenure/no tenure system, instructors","94","52","42","0","0","0","6","5","1","6","1","5","7","3","4","0","0","0","32","20","12","3","0","3","11","5","6","29","18","11","-2"
"144050","University of Chicago","2018","Not on tenure/no tenure system, lecturers","197","85","112","0","0","0","22","10","12","3","1","2","6","2","4","0","0","0","124","55","69","2","0","2","16","6","10","24","11","13","-2"
"144050","University of Chicago","2018","Not on tenure/no tenure system, no academic rank","74","34","40","0","0","0","22","8","14","2","0","2","6","4","2","1","1","0","31","15","16","1","0","1","7","3","4","4","3","1","-2"
"144865","College of DuPage","2018","Tenured total","275","140","135","2","1","1","25","9","16","11","7","4","9","5","4","0","0","0","224","116","108","0","0","0","4","2","2","0","0","0","-2"
"144865","College of DuPage","2018","Tenured, professors","125","71","54","1","1","0","14","6","8","4","3","1","3","2","1","0","0","0","102","59","43","0","0","0","1","0","1","0","0","0","-2"
"144865","College of DuPage","2018","Tenured, associate professors","69","38","31","0","0","0","5","3","2","3","3","0","4","2","2","0","0","0","57","30","27","0","0","0","0","0","0","0","0","0","-2"
"144865","College of DuPage","2018","Tenured, assistant professors","70","27","43","1","0","1","4","0","4","4","1","3","2","1","1","0","0","0","56","23","33","0","0","0","3","2","1","0","0","0","-2"
"144865","College of DuPage","2018","Tenured, instructors","11","4","7","0","0","0","2","0","2","0","0","0","0","0","0","0","0","0","9","4","5","0","0","0","0","0","0","0","0","0","-2"
"144865","College of DuPage","2018","Not on tenure track/No tenure system system total","3","2","1","0","0","0","0","0","0","0","0","0","0","0","0","0","0","0","3","2","1","0","0","0","0","0","0","0","0","0","-2"
"144865","College of DuPage","2018","Not on tenure/no tenure system, assistant professors","1","1","0","0","0","0","0","0","0","0","0","0","0","0","0","0","0","0","1","1","0","0","0","0","0","0","0","0","0","0","-2"
"144865","College of DuPage","2018","Not on tenure/no tenure system, instructors","2","1","1","0","0","0","0","0","0","0","0","0","0","0","0","0","0","0","2","1","1","0","0","0","0","0","0","0","0","0","-2"
"145637","University of Illinois at Urbana-Champaign","2018","Tenured total","1271","880","391","4","1","3","227","170","57","59","30","29","79","49","30","0","0","0","875","611","264","10","7","3","13","9","4","4","3","1","-2"
"145637","University of Illinois at Urbana-Champaign","2018","Tenured, professors","813","608","205","3","1","2","132","112","20","29","18","11","47","30","17","0","0","0","588","436","152","5","3","2","7","6","1","2","2","0","-2"
"145637","University of Illinois at Urbana-Champaign","2018","Tenured, associate professors","457","271","186","1","0","1","94","57","37","30","12","18","32","19","13","0","0","0","287","175","112","5","4","1","6","3","3","2","1","1","-2"
"145637","University of Illinois at Urbana-Champaign","2018","Tenured, assistant professors","1","1","0","0","0","0","1","1","0","0","0","0","0","0","0","0","0","0","0","0","0","0","0","0","0","0","0","0","0","0","-2"
"145637","University of Illinois at Urbana-Champaign","2018","On-Tenure track total","497","280","217","2","1","1","74","35","39","28","12","16","33","21","12","0","0","0","249","139","110","13","6","7","12","8","4","86","58","28","-2"
"145637","University of Illinois at Urbana-Champaign","2018","On-tenure track, professors","1","1","0","0","0","0","0","0","0","1","1","0","0","0","0","0","0","0","0","0","0","0","0","0","0","0","0","0","0","0","-2"
"145637","University of Illinois at Urbana-Champaign","2018","On-tenure track, associate professors","5","3","2","0","0","0","0","0","0","1","0","1","0","0","0","0","0","0","4","3","1","0","0","0","0","0","0","0","0","0","-2"
"145637","University of Illinois at Urbana-Champaign","2018","On-tenure track, assistant professors","491","276","215","2","1","1","74","35","39","26","11","15","33","21","12","0","0","0","245","136","109","13","6","7","12","8","4","86","58","28","-2"
"145637","University of Illinois at Urbana-Champaign","2018","Not on tenure track/No tenure system system total","524","268","256","0","0","0","40","25","15","20","7","13","25","14","11","0","0","0","400","197","203","6","5","1","8","6","2","25","14","11","-2"
"145637","University of Illinois at Urbana-Champaign","2018","Not on tenure/no tenure system, professors","24","12","12","0","0","0","1","1","0","1","0","1","1","1","0","0","0","0","21","10","11","0","0","0","0","0","0","0","0","0","-2"
"145637","University of Illinois at Urbana-Champaign","2018","Not on tenure/no tenure system, associate professors","41","20","21","0","0","0","3","2","1","2","0","2","1","1","0","0","0","0","35","17","18","0","0","0","0","0","0","0","0","0","-2"
"145637","University of Illinois at Urbana-Champaign","2018","Not on tenure/no tenure system, assistant professors","146","65","81","0","0","0","14","8","6","9","5","4","8","3","5","0","0","0","100","39","61","3","2","1","3","2","1","9","6","3","-2"
"145637","University of Illinois at Urbana-Champaign","2018","Not on tenure/no tenure system, instructors","87","42","45","0","0","0","4","4","0","3","1","2","4","2","2","0","0","0","70","31","39","1","1","0","2","1","1","3","2","1","-2"
"145637","University of Illinois at Urbana-Champaign","2018","Not on tenure/no tenure system, lecturers","194","108","86","0","0","0","17","10","7","5","1","4","9","5","4","0","0","0","145","81","64","2","2","0","3","3","0","13","6","7","-2"
"145637","University of Illinois at Urbana-Champaign","2018","Not on tenure/no tenure system, no academic rank","32","21","11","0","0","0","1","0","1","0","0","0","2","2","0","0","0","0","29","19","10","0","0","0","0","0","0","0","0","0","-2"
"147703","Northern Illinois University","2018","Tenured total","462","267","195","2","0","2","42","27","15","16","9","7","10","4","6","0","0","0","313","186","127","3","2","1","4","3","1","72","36","36","-2"
"147703","Northern Illinois University","2018","Tenured, professors","203","138","65","0","0","0","22","16","6","8","5","3","3","0","3","0","0","0","144","99","45","2","1","1","2","2","0","22","15","7","-2"
"147703","Northern Illinois University","2018","Tenured, associate professors","255","127","128","2","0","2","20","11","9","7","4","3","7","4","3","0","0","0","166","85","81","1","1","0","2","1","1","50","21","29","-2"
"147703","Northern Illinois University","2018","Tenured, assistant professors","4","2","2","0","0","0","0","0","0","1","0","1","0","0","0","0","0","0","3","2","1","0","0","0","0","0","0","0","0","0","-2"
"147703","Northern Illinois University","2018","On-Tenure track total","136","66","70","0","0","0","10","6","4","2","0","2","6","2","4","0","0","0","85","37","48","0","0","0","1","0","1","32","21","11","-2"
"147703","Northern Illinois University","2018","On-tenure track, professors","1","1","0","0","0","0","0","0","0","0","0","0","0","0","0","0","0","0","1","1","0","0","0","0","0","0","0","0","0","0","-2"
"147703","Northern Illinois University","2018","On-tenure track, associate professors","6","4","2","0","0","0","0","0","0","0","0","0","0","0","0","0","0","0","6","4","2","0","0","0","0","0","0","0","0","0","-2"
"147703","Northern Illinois University","2018","On-tenure track, assistant professors","127","60","67","0","0","0","10","6","4","1","0","1","6","2","4","0","0","0","77","31","46","0","0","0","1","0","1","32","21","11","-2"
"147703","Northern Illinois University","2018","On-tenure track, instructors","2","1","1","0","0","0","0","0","0","1","0","1","0","0","0","0","0","0","1","1","0","0","0","0","0","0","0","0","0","0","-2"
"147703","Northern Illinois University","2018","Not on tenure track/No tenure system system total","232","94","138","0","0","0","6","2","4","5","2","3","4","3","1","0","0","0","192","76","116","2","1","1","2","0","2","21","10","11","-2"
"147703","Northern Illinois University","2018","Not on tenure/no tenure system, professors","5","3","2","0","0","0","0","0","0","0","0","0","0","0","0","0","0","0","5","3","2","0","0","0","0","0","0","0","0","0","-2"
"147703","Northern Illinois University","2018","Not on tenure/no tenure system, associate professors","1","1","0","0","0","0","0","0","0","0","0","0","0","0","0","0","0","0","1","1","0","0","0","0","0","0","0","0","0","0","-2"
"147703","Northern Illinois University","2018","Not on tenure/no tenure system, assistant professors","30","7","23","0","0","0","0","0","0","1","0","1","1","1","0","0","0","0","24","5","19","0","0","0","0","0","0","4","1","3","-2"
"147703","Northern Illinois University","2018","Not on tenure/no tenure system, instructors","163","63","100","0","0","0","5","2","3","3","2","1","3","2","1","0","0","0","143","56","87","2","1","1","2","0","2","5","0","5","-2"
"147703","Northern Illinois University","2018","Not on tenure/no tenure system, no academic rank","33","20","13","0","0","0","1","0","1","1","0","1","0","0","0","0","0","0","19","11","8","0","0","0","0","0","0","12","9","3","-2"
"147767","Northwestern University","2018","Tenured total","1038","745","293","1","0","1","132","102","30","39","23","16","48","31","17","0","0","0","793","571","222","7","3","4","15","12","3","3","3","0","-2"
"147767","Northwestern University","2018","Tenured, professors","740","556","184","1","0","1","91","74","17","19","9","10","28","19","9","0","0","0","589","444","145","1","0","1","10","9","1","1","1","0","-2"
"147767","Northwestern University","2018","Tenured, associate professors","298","189","109","0","0","0","41","28","13","20","14","6","20","12","8","0","0","0","204","127","77","6","3","3","5","3","2","2","2","0","-2"
"147767","Northwestern University","2018","On-Tenure track total","327","188","139","1","1","0","42","27","15","17","5","12","20","11","9","1","1","0","177","104","73","8","2","6","10","7","3","51","30","21","-2"
"147767","Northwestern University","2018","On-tenure track, associate professors","44","30","14","0","0","0","6","4","2","4","0","4","4","3","1","0","0","0","28","21","7","0","0","0","1","1","0","1","1","0","-2"
"147767","Northwestern University","2018","On-tenure track, assistant professors","283","158","125","1","1","0","36","23","13","13","5","8","16","8","8","1","1","0","149","83","66","8","2","6","9","6","3","50","29","21","-2"
"147767","Northwestern University","2018","Not on tenure track/No tenure system system total","917","443","474","0","0","0","113","49","64","34","14","20","30","11","19","0","0","0","683","340","343","8","1","7","20","12","8","29","16","13","-2"
"147767","Northwestern University","2018","Not on tenure/no tenure system, professors","194","128","66","0","0","0","26","16","10","6","4","2","6","2","4","0","0","0","153","103","50","0","0","0","1","1","0","2","2","0","-2"
"147767","Northwestern University","2018","Not on tenure/no tenure system, associate professors","174","83","91","0","0","0","32","12","20","6","2","4","5","2","3","0","0","0","129","66","63","0","0","0","1","0","1","1","1","0","-2"
"147767","Northwestern University","2018","Not on tenure/no tenure system, assistant professors","225","97","128","0","0","0","36","14","22","13","3","10","10","4","6","0","0","0","154","69","85","2","1","1","6","3","3","4","3","1","-2"
"147767","Northwestern University","2018","Not on tenure/no tenure system, instructors","15","7","8","0","0","0","2","2","0","1","1","0","1","0","1","0","0","0","11","4","7","0","0","0","0","0","0","0","0","0","-2"
"147767","Northwestern University","2018","Not on tenure/no tenure system, lecturers","309","128","181","0","0","0","17","5","12","8","4","4","8","3","5","0","0","0","236","98","138","6","0","6","12","8","4","22","10","12","-2"
"149772","Western Illinois University","2018","Tenured total","340","215","125","2","1","1","50","34","16","18","13","5","7","5","2","1","1","0","256","158","98","4","3","1","0","0","0","2","0","2","-2"
"149772","Western Illinois University","2018","Tenured, professors","196","132","64","2","1","1","22","20","2","12","8","4","3","2","1","0","0","0","154","99","55","3","2","1","0","0","0","0","0","0","-2"
"149772","Western Illinois University","2018","Tenured, associate professors","141","81","60","0","0","0","28","14","14","6","5","1","4","3","1","1","1","0","99","57","42","1","1","0","0","0","0","2","0","2","-2"
"149772","Western Illinois University","2018","Tenured, assistant professors","2","1","1","0","0","0","0","0","0","0","0","0","0","0","0","0","0","0","2","1","1","0","0","0","0","0","0","0","0","0","-2"
"149772","Western Illinois University","2018","Tenured, instructors","1","1","0","0","0","0","0","0","0","0","0","0","0","0","0","0","0","0","1","1","0","0","0","0","0","0","0","0","0","0","-2"
"149772","Western Illinois University","2018","On-Tenure track total","84","40","44","0","0","0","4","4","0","5","2","3","5","3","2","0","0","0","54","25","29","0","0","0","4","3","1","12","3","9","-2"
"149772","Western Illinois University","2018","On-tenure track, associate professors","1","1","0","0","0","0","0","0","0","0","0","0","0","0","0","0","0","0","1","1","0","0","0","0","0","0","0","0","0","0","-2"
"149772","Western Illinois University","2018","On-tenure track, assistant professors","82","39","43","0","0","0","4","4","0","5","2","3","5","3","2","0","0","0","53","24","29","0","0","0","4","3","1","11","3","8","-2"
"149772","Western Illinois University","2018","On-tenure track, instructors","1","0","1","0","0","0","0","0","0","0","0","0","0","0","0","0","0","0","0","0","0","0","0","0","0","0","0","1","0","1","-2"
"149772","Western Illinois University","2018","Not on tenure track/No tenure system system total","103","30","73","0","0","0","5","1","4","3","2","1","1","0","1","0","0","0","93","26","67","0","0","0","1","1","0","0","0","0","-2"
"149772","Western Illinois University","2018","Not on tenure/no tenure system, professors","3","1","2","0","0","0","0","0","0","0","0","0","0","0","0","0","0","0","3","1","2","0","0","0","0","0","0","0","0","0","-2"
"149772","Western Illinois University","2018","Not on tenure/no tenure system, associate professors","1","0","1","0","0","0","0","0","0","0","0","0","0","0","0","0","0","0","1","0","1","0","0","0","0","0","0","0","0","0","-2"
"149772","Western Illinois University","2018","Not on tenure/no tenure system, assistant professors","14","5","9","0","0","0","1","1","0","0","0","0","0","0","0","0","0","0","13","4","9","0","0","0","0","0","0","0","0","0","-2"
"149772","Western Illinois University","2018","Not on tenure/no tenure system, instructors","83","24","59","0","0","0","4","0","4","3","2","1","1","0","1","0","0","0","74","21","53","0","0","0","1","1","0","0","0","0","-2"
"149772","Western Illinois University","2018","Not on tenure/no tenure system, lecturers","2","0","2","0","0","0","0","0","0","0","0","0","0","0","0","0","0","0","2","0","2","0","0","0","0","0","0","0","0","0","-2"
"150136","Ball State University","2018","Tenured total","439","264","175","0","0","0","10","7","3","9","4","5","7","5","2","0","0","0","344","211","133","3","2","1","1","0","1","65","35","30","-2"
"150136","Ball State University","2018","Tenured, professors","217","145","72","0","0","0","6","4","2","3","2","1","3","3","0","0","0","0","170","118","52","3","2","1","0","0","0","32","16","16","-2"
"150136","Ball State University","2018","Tenured, associate professors","203","110","93","0","0","0","3","3","0","6","2","4","4","2","2","0","0","0","156","84","72","0","0","0","1","0","1","33","19","14","-2"
"150136","Ball State University","2018","Tenured, assistant professors","19","9","10","0","0","0","1","0","1","0","0","0","0","0","0","0","0","0","18","9","9","0","0","0","0","0","0","0","0","0","-2"
"150136","Ball State University","2018","On-Tenure track total","228","118","110","1","0","1","12","5","7","8","3","5","8","3","5","0","0","0","165","89","76","0","0","0","0","0","0","34","18","16","-2"
"150136","Ball State University","2018","On-tenure track, associate professors","14","5","9","0","0","0","0","0","0","0","0","0","0","0","0","0","0","0","13","5","8","0","0","0","0","0","0","1","0","1","-2"
"150136","Ball State University","2018","On-tenure track, assistant professors","214","113","101","1","0","1","12","5","7","8","3","5","8","3","5","0","0","0","152","84","68","0","0","0","0","0","0","33","18","15","-2"
"150136","Ball State University","2018","Not on tenure track/No tenure system system total","379","150","229","0","0","0","9","2","7","13","5","8","13","6","7","0","0","0","330","131","199","2","1","1","2","2","0","10","3","7","-2"
"150136","Ball State University","2018","Not on tenure/no tenure system, professors","7","4","3","0","0","0","0","0","0","0","0","0","0","0","0","0","0","0","6","3","3","0","0","0","0","0","0","1","1","0","-2"
"150136","Ball State University","2018","Not on tenure/no tenure system, associate professors","8","4","4","0","0","0","0","0","0","1","0","1","0","0","0","0","0","0","7","4","3","0","0","0","0","0","0","0","0","0","-2"
"150136","Ball State University","2018","Not on tenure/no tenure system, assistant professors","160","75","85","0","0","0","5","1","4","5","2","3","6","3","3","0","0","0","135","66","69","1","1","0","1","1","0","7","1","6","-2"
"150136","Ball State University","2018","Not on tenure/no tenure system, instructors","18","6","12","0","0","0","0","0","0","1","1","0","0","0","0","0","0","0","14","3","11","0","0","0","1","1","0","2","1","1","-2"
"150136","Ball State University","2018","Not on tenure/no tenure system, lecturers","180","59","121","0","0","0","4","1","3","6","2","4","5","2","3","0","0","0","164","54","110","1","0","1","0","0","0","0","0","0","-2"
"150136","Ball State University","2018","Not on tenure/no tenure system, no academic rank","6","2","4","0","0","0","0","0","0","0","0","0","2","1","1","0","0","0","4","1","3","0","0","0","0","0","0","0","0","0","-2"
"151351","Indiana University-Bloomington","2018","Tenured total","1021","685","336","1","1","0","100","57","43","41","26","15","40","26","14","1","1","0","826","564","262","11","9","2","1","1","0","0","0","0","-2"
"151351","Indiana University-Bloomington","2018","Tenured, professors","624","459","165","1","1","0","53","34","19","15","8","7","16","13","3","0","0","0","532","396","136","7","7","0","0","0","0","0","0","0","-2"
"151351","Indiana University-Bloomington","2018","Tenured, associate professors","397","226","171","0","0","0","47","23","24","26","18","8","24","13","11","1","1","0","294","168","126","4","2","2","1","1","0","0","0","0","-2"
"151351","Indiana University-Bloomington","2018","On-Tenure track total","351","215","136","0","0","0","79","51","28","18","10","8","33","25","8","0","0","0","217","127","90","1","0","1","2","1","1","1","1","0","-2"
"151351","Indiana University-Bloomington","2018","On-tenure track, professors","5","4","1","0","0","0","0","0","0","1","1","0","0","0","0","0","0","0","4","3","1","0","0","0","0","0","0","0","0","0","-2"
"151351","Indiana University-Bloomington","2018","On-tenure track, associate professors","60","35","25","0","0","0","6","5","1","5","2","3","5","4","1","0","0","0","44","24","20","0","0","0","0","0","0","0","0","0","-2"
"151351","Indiana University-Bloomington","2018","On-tenure track, assistant professors","286","176","110","0","0","0","73","46","27","12","7","5","28","21","7","0","0","0","169","100","69","1","0","1","2","1","1","1","1","0","-2"
"151351","Indiana University-Bloomington","2018","Not on tenure track/No tenure system system total","707","343","364","2","2","0","57","23","34","28","17","11","40","21","19","0","0","0","575","278","297","2","1","1","1","1","0","2","0","2","-2"
"151351","Indiana University-Bloomington","2018","Not on tenure/no tenure system, professors","68","44","24","0","0","0","6","3","3","7","6","1","3","3","0","0","0","0","52","32","20","0","0","0","0","0","0","0","0","0","-2"
"151351","Indiana University-Bloomington","2018","Not on tenure/no tenure system, associate professors","56","25","31","0","0","0","1","1","0","2","1","1","0","0","0","0","0","0","52","22","30","1","1","0","0","0","0","0","0","0","-2"
"151351","Indiana University-Bloomington","2018","Not on tenure/no tenure system, assistant professors","126","60","66","0","0","0","16","10","6","4","2","2","9","3","6","0","0","0","97","45","52","0","0","0","0","0","0","0","0","0","-2"
"151351","Indiana University-Bloomington","2018","Not on tenure/no tenure system, lecturers","457","214","243","2","2","0","34","9","25","15","8","7","28","15","13","0","0","0","374","179","195","1","0","1","1","1","0","2","0","2","-2"
"152600","Valparaiso University","2018","Tenured total","148","87","61","1","1","0","8","5","3","2","2","0","3","2","1","0","0","0","104","62","42","0","0","0","27","13","14","3","2","1","-2"
"152600","Valparaiso University","2018","Tenured, professors","57","41","16","1","1","0","4","3","1","0","0","0","1","1","0","0","0","0","48","34","14","0","0","0","3","2","1","0","0","0","-2"
"152600","Valparaiso University","2018","Tenured, associate professors","90","45","45","0","0","0","4","2","2","2","2","0","2","1","1","0","0","0","55","27","28","0","0","0","24","11","13","3","2","1","-2"
"152600","Valparaiso University","2018","Tenured, assistant professors","1","1","0","0","0","0","0","0","0","0","0","0","0","0","0","0","0","0","1","1","0","0","0","0","0","0","0","0","0","0","-2"
"152600","Valparaiso University","2018","On-Tenure track total","83","49","34","0","0","0","10","4","6","0","0","0","1","1","0","0","0","0","20","12","8","0","0","0","49","30","19","3","2","1","-2"
"152600","Valparaiso University","2018","On-tenure track, professors","1","1","0","0","0","0","0","0","0","0","0","0","0","0","0","0","0","0","0","0","0","0","0","0","1","1","0","0","0","0","-2"
"152600","Valparaiso University","2018","On-tenure track, associate professors","10","7","3","0","0","0","3","2","1","0","0","0","0","0","0","0","0","0","2","1","1","0","0","0","5","4","1","0","0","0","-2"
"152600","Valparaiso University","2018","On-tenure track, assistant professors","69","41","28","0","0","0","7","2","5","0","0","0","1","1","0","0","0","0","17","11","6","0","0","0","42","25","17","2","2","0","-2"
"152600","Valparaiso University","2018","On-tenure track, instructors","3","0","3","0","0","0","0","0","0","0","0","0","0","0","0","0","0","0","1","0","1","0","0","0","1","0","1","1","0","1","-2"
"152600","Valparaiso University","2018","Not on tenure track/No tenure system system total","81","32","49","0","0","0","4","2","2","2","2","0","2","1","1","0","0","0","38","13","25","0","0","0","34","13","21","1","1","0","-2"
"152600","Valparaiso University","2018","Not on tenure/no tenure system, professors","3","3","0","0","0","0","0","0","0","0","0","0","0","0","0","0","0","0","3","3","0","0","0","0","0","0","0","0","0","0","-2"
"152600","Valparaiso University","2018","Not on tenure/no tenure system, associate professors","4","1","3","0","0","0","0","0","0","0","0","0","1","1","0","0","0","0","2","0","2","0","0","0","1","0","1","0","0","0","-2"
"152600","Valparaiso University","2018","Not on tenure/no tenure system, assistant professors","17","6","11","0","0","0","2","1","1","0","0","0","0","0","0","0","0","0","4","1","3","0","0","0","11","4","7","0","0","0","-2"
"152600","Valparaiso University","2018","Not on tenure/no tenure system, instructors","6","3","3","0","0","0","1","1","0","0","0","0","0","0","0","0","0","0","3","1","2","0","0","0","2","1","1","0","0","0","-2"
"152600","Valparaiso University","2018","Not on tenure/no tenure system, lecturers","51","19","32","0","0","0","1","0","1","2","2","0","1","0","1","0","0","0","26","8","18","0","0","0","20","8","12","1","1","0","-2"
"153603","Iowa State University","2018","Tenured total","893","635","258","2","2","0","167","138","29","23","14","9","25","14","11","1","1","0","667","462","205","1","0","1","0","0","0","7","4","3","-2"
"153603","Iowa State University","2018","Tenured, professors","506","396","110","1","1","0","90","78","12","10","7","3","17","11","6","0","0","0","387","299","88","0","0","0","0","0","0","1","0","1","-2"
"153603","Iowa State University","2018","Tenured, associate professors","386","239","147","1","1","0","77","60","17","13","7","6","8","3","5","1","1","0","279","163","116","1","0","1","0","0","0","6","4","2","-2"
"153603","Iowa State University","2018","Tenured, assistant professors","1","0","1","0","0","0","0","0","0","0","0","0","0","0","0","0","0","0","1","0","1","0","0","0","0","0","0","0","0","0","-2"
"153603","Iowa State University","2018","On-Tenure track total","368","222","146","1","1","0","66","39","27","7","5","2","18","12","6","0","0","0","214","124","90","5","3","2","0","0","0","57","38","19","-2"
"153603","Iowa State University","2018","On-tenure track, associate professors","10","8","2","0","0","0","2","2","0","0","0","0","0","0","0","0","0","0","7","5","2","0","0","0","0","0","0","1","1","0","-2"
"153603","Iowa State University","2018","On-tenure track, assistant professors","358","214","144","1","1","0","64","37","27","7","5","2","18","12","6","0","0","0","207","119","88","5","3","2","0","0","0","56","37","19","-2"
"153603","Iowa State University","2018","Not on tenure track/No tenure system system total","300","138","162","3","0","3","14","8","6","10","7","3","13","6","7","0","0","0","237","102","135","2","0","2","0","0","0","21","15","6","-2"
"153603","Iowa State University","2018","Not on tenure/no tenure system, professors","7","6","1","0","0","0","0","0","0","0","0","0","1","1","0","0","0","0","6","5","1","0","0","0","0","0","0","0","0","0","-2"
"153603","Iowa State University","2018","Not on tenure/no tenure system, associate professors","17","8","9","0","0","0","1","1","0","0","0","0","0","0","0","0","0","0","15","7","8","0","0","0","0","0","0","1","0","1","-2"
"153603","Iowa State University","2018","Not on tenure/no tenure system, assistant professors","57","20","37","0","0","0","8","2","6","2","1","1","6","4","2","0","0","0","35","10","25","1","0","1","0","0","0","5","3","2","-2"
"153603","Iowa State University","2018","Not on tenure/no tenure system, lecturers","219","104","115","3","0","3","5","5","0","8","6","2","6","1","5","0","0","0","181","80","101","1","0","1","0","0","0","15","12","3","-2"
"153658","University of Iowa","2018","Tenured total","1019","708","311","2","1","1","133","104","29","22","13","9","44","27","17","0","0","0","796","549","247","4","1","3","17","12","5","1","1","0","-2"
"153658","University of Iowa","2018","Tenured, professors","605","463","142","1","1","0","72","63","9","9","7","2","22","12","10","0","0","0","488","371","117","3","1","2","10","8","2","0","0","0","-2"
"153658","University of Iowa","2018","Tenured, associate professors","414","245","169","1","0","1","61","41","20","13","6","7","22","15","7","0","0","0","308","178","130","1","0","1","7","4","3","1","1","0","-2"
"153658","University of Iowa","2018","On-Tenure track total","314","181","133","0","0","0","46","29","17","7","1","6","15","10","5","0","0","0","195","104","91","6","4","2","5","5","0","40","28","12","-2"
"153658","University of Iowa","2018","On-tenure track, professors","1","0","1","0","0","0","0","0","0","0","0","0","0","0","0","0","0","0","1","0","1","0","0","0","0","0","0","0","0","0","-2"
"153658","University of Iowa","2018","On-tenure track, associate professors","23","18","5","0","0","0","6","3","3","1","1","0","0","0","0","0","0","0","15","13","2","0","0","0","0","0","0","1","1","0","-2"
"153658","University of Iowa","2018","On-tenure track, assistant professors","290","163","127","0","0","0","40","26","14","6","0","6","15","10","5","0","0","0","179","91","88","6","4","2","5","5","0","39","27","12","-2"
"153658","University of Iowa","2018","Not on tenure track/No tenure system system total","1104","565","539","4","1","3","112","59","53","24","10","14","52","28","24","1","0","1","758","374","384","7","3","4","53","26","27","93","64","29","-2"
"153658","University of Iowa","2018","Not on tenure/no tenure system, professors","154","103","51","1","1","0","10","8","2","2","1","1","3","3","0","0","0","0","130","86","44","2","0","2","5","3","2","1","1","0","-2"
"153658","University of Iowa","2018","Not on tenure/no tenure system, associate professors","258","130","128","1","0","1","34","19","15","5","4","1","13","7","6","0","0","0","186","85","101","1","1","0","12","9","3","6","5","1","-2"
"153658","University of Iowa","2018","Not on tenure/no tenure system, assistant professors","409","198","211","0","0","0","53","26","27","11","3","8","23","11","12","1","0","1","242","111","131","2","1","1","25","10","15","52","36","16","-2"
"153658","University of Iowa","2018","Not on tenure/no tenure system, instructors","9","4","5","0","0","0","1","0","1","0","0","0","0","0","0","0","0","0","6","3","3","1","1","0","0","0","0","1","0","1","-2"
"153658","University of Iowa","2018","Not on tenure/no tenure system, lecturers","193","82","111","2","0","2","7","3","4","5","2","3","10","4","6","0","0","0","149","65","84","1","0","1","9","2","7","10","6","4","-2"
"153658","University of Iowa","2018","Not on tenure/no tenure system, no academic rank","81","48","33","0","0","0","7","3","4","1","0","1","3","3","0","0","0","0","45","24","21","0","0","0","2","2","0","23","16","7","-2"
"155317","University of Kansas","2018","Tenured total","948","637","311","5","4","1","131","91","40","25","14","11","36","21","15","0","0","0","735","501","234","14","5","9","2","1","1","0","0","0","-2"
"155317","University of Kansas","2018","Tenured, professors","539","407","132","4","3","1","71","61","10","10","6","4","14","9","5","0","0","0","436","327","109","4","1","3","0","0","0","0","0","0","-2"
"155317","University of Kansas","2018","Tenured, associate professors","408","230","178","1","1","0","60","30","30","15","8","7","22","12","10","0","0","0","298","174","124","10","4","6","2","1","1","0","0","0","-2"
"155317","University of Kansas","2018","Tenured, assistant professors","1","0","1","0","0","0","0","0","0","0","0","0","0","0","0","0","0","0","1","0","1","0","0","0","0","0","0","0","0","0","-2"
"155317","University of Kansas","2018","On-Tenure track total","269","161","108","1","1","0","47","27","20","16","3","13","10","9","1","0","0","0","163","99","64","4","1","3","1","0","1","27","21","6","-2"
"155317","University of Kansas","2018","On-tenure track, professors","1","0","1","0","0","0","0","0","0","1","0","1","0","0","0","0","0","0","0","0","0","0","0","0","0","0","0","0","0","0","-2"
"155317","University of Kansas","2018","On-tenure track, associate professors","8","4","4","0","0","0","2","1","1","2","1","1","0","0","0","0","0","0","4","2","2","0","0","0","0","0","0","0","0","0","-2"
"155317","University of Kansas","2018","On-tenure track, assistant professors","260","157","103","1","1","0","45","26","19","13","2","11","10","9","1","0","0","0","159","97","62","4","1","3","1","0","1","27","21","6","-2"
"155317","University of Kansas","2018","Not on tenure track/No tenure system system total","1164","592","572","4","3","1","133","68","65","35","16","19","26","12","14","0","0","0","858","428","430","26","11","15","6","3","3","76","51","25","-2"
"155317","University of Kansas","2018","Not on tenure/no tenure system, professors","70","43","27","0","0","0","6","5","1","2","1","1","3","1","2","0","0","0","59","36","23","0","0","0","0","0","0","0","0","0","-2"
"155317","University of Kansas","2018","Not on tenure/no tenure system, associate professors","239","128","111","1","1","0","34","20","14","6","4","2","4","1","3","0","0","0","184","95","89","4","2","2","1","1","0","5","4","1","-2"
"155317","University of Kansas","2018","Not on tenure/no tenure system, assistant professors","627","318","309","1","0","1","79","37","42","17","5","12","11","6","5","0","0","0","449","229","220","15","6","9","4","1","3","51","34","17","-2"
"155317","University of Kansas","2018","Not on tenure/no tenure system, instructors","72","36","36","2","2","0","8","5","3","6","3","3","3","2","1","0","0","0","41","14","27","2","1","1","1","1","0","9","8","1","-2"
"155317","University of Kansas","2018","Not on tenure/no tenure system, lecturers","156","67","89","0","0","0","6","1","5","4","3","1","5","2","3","0","0","0","125","54","71","5","2","3","0","0","0","11","5","6","-2"
"157447","Northern Kentucky University","2018","Tenured total","264","143","121","1","1","0","18","7","11","13","11","2","5","5","0","0","0","0","222","116","106","3","1","2","0","0","0","2","2","0","-2"
"157447","Northern Kentucky University","2018","Tenured, professors","119","75","44","0","0","0","10","4","6","5","4","1","3","3","0","0","0","0","99","63","36","1","0","1","0","0","0","1","1","0","-2"
"157447","Northern Kentucky University","2018","Tenured, associate professors","145","68","77","1","1","0","8","3","5","8","7","1","2","2","0","0","0","0","123","53","70","2","1","1","0","0","0","1","1","0","-2"
"157447","Northern Kentucky University","2018","On-Tenure track total","83","33","50","0","0","0","5","3","2","5","2","3","3","1","2","0","0","0","58","23","35","1","0","1","0","0","0","11","4","7","-2"
"157447","Northern Kentucky University","2018","On-tenure track, assistant professors","82","33","49","0","0","0","5","3","2","5","2","3","3","1","2","0","0","0","57","23","34","1","0","1","0","0","0","11","4","7","-2"
"157447","Northern Kentucky University","2018","On-tenure track, lecturers","1","0","1","0","0","0","0","0","0","0","0","0","0","0","0","0","0","0","1","0","1","0","0","0","0","0","0","0","0","0","-2"
"157447","Northern Kentucky University","2018","Not on tenure track/No tenure system system total","213","89","124","0","0","0","7","3","4","8","4","4","4","0","4","1","1","0","191","79","112","0","0","0","1","1","0","1","1","0","-2"
"157447","Northern Kentucky University","2018","Not on tenure/no tenure system, associate professors","2","1","1","0","0","0","0","0","0","1","1","0","0","0","0","0","0","0","1","0","1","0","0","0","0","0","0","0","0","0","-2"
"157447","Northern Kentucky University","2018","Not on tenure/no tenure system, assistant professors","13","8","5","0","0","0","0","0","0","1","1","0","0","0","0","0","0","0","12","7","5","0","0","0","0","0","0","0","0","0","-2"
"157447","Northern Kentucky University","2018","Not on tenure/no tenure system, lecturers","198","80","118","0","0","0","7","3","4","6","2","4","4","0","4","1","1","0","178","72","106","0","0","0","1","1","0","1","1","0","-2"
"157951","Western Kentucky University","2018","Tenured total","411","231","180","5","4","1","35","20","15","21","9","12","6","3","3","0","0","0","334","188","146","8","6","2","1","1","0","1","0","1","-2"
"157951","Western Kentucky University","2018","Tenured, professors","186","121","65","3","3","0","14","12","2","9","4","5","1","0","1","0","0","0","154","99","55","3","2","1","1","1","0","1","0","1","-2"
"157951","Western Kentucky University","2018","Tenured, associate professors","217","105","112","2","1","1","21","8","13","11","4","7","5","3","2","0","0","0","173","85","88","5","4","1","0","0","0","0","0","0","-2"
"157951","Western Kentucky University","2018","Tenured, assistant professors","8","5","3","0","0","0","0","0","0","1","1","0","0","0","0","0","0","0","7","4","3","0","0","0","0","0","0","0","0","0","-2"
"157951","Western Kentucky University","2018","On-Tenure track total","143","63","80","1","0","1","17","5","12","9","3","6","3","3","0","0","0","0","112","51","61","0","0","0","0","0","0","1","1","0","-2"
"157951","Western Kentucky University","2018","On-tenure track, professors","1","1","0","0","0","0","1","1","0","0","0","0","0","0","0","0","0","0","0","0","0","0","0","0","0","0","0","0","0","0","-2"
"157951","Western Kentucky University","2018","On-tenure track, associate professors","7","2","5","0","0","0","1","0","1","0","0","0","0","0","0","0","0","0","6","2","4","0","0","0","0","0","0","0","0","0","-2"
"157951","Western Kentucky University","2018","On-tenure track, assistant professors","135","60","75","1","0","1","15","4","11","9","3","6","3","3","0","0","0","0","106","49","57","0","0","0","0","0","0","1","1","0","-2"
"157951","Western Kentucky University","2018","Not on tenure track/No tenure system system total","154","58","96","0","0","0","8","2","6","5","2","3","3","1","2","0","0","0","134","51","83","3","1","2","1","1","0","0","0","0","-2"
"157951","Western Kentucky University","2018","Not on tenure/no tenure system, professors","1","1","0","0","0","0","0","0","0","0","0","0","0","0","0","0","0","0","1","1","0","0","0","0","0","0","0","0","0","0","-2"
"157951","Western Kentucky University","2018","Not on tenure/no tenure system, associate professors","5","1","4","0","0","0","0","0","0","0","0","0","1","0","1","0","0","0","4","1","3","0","0","0","0","0","0","0","0","0","-2"
"157951","Western Kentucky University","2018","Not on tenure/no tenure system, assistant professors","6","3","3","0","0","0","2","0","2","0","0","0","0","0","0","0","0","0","3","2","1","1","1","0","0","0","0","0","0","0","-2"
"157951","Western Kentucky University","2018","Not on tenure/no tenure system, instructors","116","38","78","0","0","0","6","2","4","5","2","3","2","1","1","0","0","0","102","33","69","1","0","1","0","0","0","0","0","0","-2"
"157951","Western Kentucky University","2018","Not on tenure/no tenure system, no academic rank","26","15","11","0","0","0","0","0","0","0","0","0","0","0","0","0","0","0","24","14","10","1","0","1","1","1","0","0","0","0","-2"
"159993","University of Louisiana at Monroe","2018","Tenured total","146","73","73","0","0","0","7","6","1","7","2","5","4","1","3","0","0","0","126","63","63","2","1","1","0","0","0","0","0","0","-2"
"159993","University of Louisiana at Monroe","2018","Tenured, professors","55","34","21","0","0","0","4","4","0","1","0","1","1","0","1","0","0","0","47","29","18","2","1","1","0","0","0","0","0","0","-2"
"159993","University of Louisiana at Monroe","2018","Tenured, associate professors","75","38","37","0","0","0","3","2","1","5","2","3","3","1","2","0","0","0","64","33","31","0","0","0","0","0","0","0","0","0","-2"
"159993","University of Louisiana at Monroe","2018","Tenured, assistant professors","16","1","15","0","0","0","0","0","0","1","0","1","0","0","0","0","0","0","15","1","14","0","0","0","0","0","0","0","0","0","-2"
"159993","University of Louisiana at Monroe","2018","On-Tenure track total","86","32","54","0","0","0","4","3","1","9","4","5","0","0","0","0","0","0","73","25","48","0","0","0","0","0","0","0","0","0","-2"
"159993","University of Louisiana at Monroe","2018","On-tenure track, assistant professors","86","32","54","0","0","0","4","3","1","9","4","5","0","0","0","0","0","0","73","25","48","0","0","0","0","0","0","0","0","0","-2"
"159993","University of Louisiana at Monroe","2018","Not on tenure track/No tenure system system total","91","27","64","2","1","1","2","0","2","4","3","1","2","0","2","0","0","0","81","23","58","0","0","0","0","0","0","0","0","0","-2"
"159993","University of Louisiana at Monroe","2018","Not on tenure/no tenure system, professors","2","1","1","0","0","0","0","0","0","0","0","0","0","0","0","0","0","0","2","1","1","0","0","0","0","0","0","0","0","0","-2"
"159993","University of Louisiana at Monroe","2018","Not on tenure/no tenure system, associate professors","9","1","8","0","0","0","0","0","0","0","0","0","0","0","0","0","0","0","9","1","8","0","0","0","0","0","0","0","0","0","-2"
"159993","University of Louisiana at Monroe","2018","Not on tenure/no tenure system, assistant professors","14","4","10","0","0","0","0","0","0","1","1","0","0","0","0","0","0","0","13","3","10","0","0","0","0","0","0","0","0","0","-2"
"159993","University of Louisiana at Monroe","2018","Not on tenure/no tenure system, instructors","66","21","45","2","1","1","2","0","2","3","2","1","2","0","2","0","0","0","57","18","39","0","0","0","0","0","0","0","0","0","-2"
"160755","Tulane University of Louisiana","2018","Tenured total","450","311","139","2","2","0","51","41","10","13","4","9","20","14","6","0","0","0","351","240","111","5","2","3","2","2","0","6","6","0","-2"
"160755","Tulane University of Louisiana","2018","Tenured, professors","268","202","66","2","2","0","25","21","4","8","4","4","9","8","1","0","0","0","214","159","55","4","2","2","2","2","0","4","4","0","-2"
"160755","Tulane University of Louisiana","2018","Tenured, associate professors","182","109","73","0","0","0","26","20","6","5","0","5","11","6","5","0","0","0","137","81","56","1","0","1","0","0","0","2","2","0","-2"
"160755","Tulane University of Louisiana","2018","On-Tenure track total","174","91","83","1","1","0","25","16","9","12","3","9","6","3","3","0","0","0","93","47","46","4","1","3","5","2","3","28","18","10","-2"
"160755","Tulane University of Louisiana","2018","On-tenure track, professors","3","3","0","0","0","0","0","0","0","0","0","0","0","0","0","0","0","0","3","3","0","0","0","0","0","0","0","0","0","0","-2"
"160755","Tulane University of Louisiana","2018","On-tenure track, associate professors","10","2","8","0","0","0","3","2","1","2","0","2","0","0","0","0","0","0","4","0","4","1","0","1","0","0","0","0","0","0","-2"
"160755","Tulane University of Louisiana","2018","On-tenure track, assistant professors","161","86","75","1","1","0","22","14","8","10","3","7","6","3","3","0","0","0","86","44","42","3","1","2","5","2","3","28","18","10","-2"
"160755","Tulane University of Louisiana","2018","Not on tenure track/No tenure system system total","636","313","323","4","1","3","61","33","28","28","8","20","33","15","18","0","0","0","451","217","234","9","4","5","12","10","2","38","25","13","-2"
"160755","Tulane University of Louisiana","2018","Not on tenure/no tenure system, professors","35","32","3","0","0","0","5","4","1","1","0","1","2","2","0","0","0","0","26","25","1","0","0","0","1","1","0","0","0","0","-2"
"160755","Tulane University of Louisiana","2018","Not on tenure/no tenure system, associate professors","85","41","44","0","0","0","14","9","5","3","0","3","8","3","5","0","0","0","57","28","29","2","0","2","0","0","0","1","1","0","-2"
"160755","Tulane University of Louisiana","2018","Not on tenure/no tenure system, assistant professors","262","134","128","2","1","1","31","17","14","14","6","8","10","5","5","0","0","0","170","82","88","4","2","2","7","6","1","24","15","9","-2"
"160755","Tulane University of Louisiana","2018","Not on tenure/no tenure system, instructors","58","16","42","1","0","1","3","2","1","4","0","4","3","1","2","0","0","0","45","11","34","0","0","0","0","0","0","2","2","0","-2"
"160755","Tulane University of Louisiana","2018","Not on tenure/no tenure system, lecturers","193","87","106","1","0","1","8","1","7","6","2","4","10","4","6","0","0","0","151","69","82","3","2","1","4","3","1","10","6","4","-2"
"160755","Tulane University of Louisiana","2018","Not on tenure/no tenure system, no academic rank","3","3","0","0","0","0","0","0","0","0","0","0","0","0","0","0","0","0","2","2","0","0","0","0","0","0","0","1","1","0","-2"
"162928","Johns Hopkins University","2018","Tenured total","1143","852","291","1","1","0","154","113","41","27","16","11","34","29","5","0","0","0","915","685","230","5","2","3","0","0","0","7","6","1","-2"
"162928","Johns Hopkins University","2018","Tenured, professors","1053","793","260","1","1","0","139","106","33","21","13","8","27","24","3","0","0","0","853","641","212","5","2","3","0","0","0","7","6","1","-2"
"162928","Johns Hopkins University","2018","Tenured, associate professors","90","59","31","0","0","0","15","7","8","6","3","3","7","5","2","0","0","0","62","44","18","0","0","0","0","0","0","0","0","0","-2"
"162928","Johns Hopkins University","2018","On-Tenure track total","1956","1021","935","4","2","2","451","251","200","119","39","80","78","45","33","1","0","1","1168","596","572","22","9","13","3","3","0","110","76","34","-2"
"162928","Johns Hopkins University","2018","On-tenure track, professors","9","6","3","0","0","0","0","0","0","0","0","0","1","1","0","0","0","0","8","5","3","0","0","0","0","0","0","0","0","0","-2"
"162928","Johns Hopkins University","2018","On-tenure track, associate professors","658","390","268","0","0","0","151","102","49","27","10","17","25","16","9","1","0","1","434","247","187","6","3","3","0","0","0","14","12","2","-2"
"162928","Johns Hopkins University","2018","On-tenure track, assistant professors","1289","625","664","4","2","2","300","149","151","92","29","63","52","28","24","0","0","0","726","344","382","16","6","10","3","3","0","96","64","32","-2"
"162928","Johns Hopkins University","2018","Not on tenure track/No tenure system system total","810","365","445","1","1","0","127","60","67","63","22","41","23","6","17","0","0","0","542","245","297","4","1","3","1","1","0","49","29","20","-2"
"162928","Johns Hopkins University","2018","Not on tenure/no tenure system, professors","41","25","16","0","0","0","4","3","1","3","1","2","2","1","1","0","0","0","31","19","12","0","0","0","0","0","0","1","1","0","-2"
"162928","Johns Hopkins University","2018","Not on tenure/no tenure system, associate professors","56","28","28","0","0","0","9","6","3","6","1","5","1","0","1","0","0","0","39","21","18","0","0","0","0","0","0","1","0","1","-2"
"162928","Johns Hopkins University","2018","Not on tenure/no tenure system, assistant professors","74","20","54","0","0","0","8","4","4","6","2","4","3","0","3","0","0","0","54","13","41","1","0","1","0","0","0","2","1","1","-2"
"162928","Johns Hopkins University","2018","Not on tenure/no tenure system, instructors","216","104","112","1","1","0","61","28","33","22","9","13","2","1","1","0","0","0","108","50","58","0","0","0","0","0","0","22","15","7","-2"
"162928","Johns Hopkins University","2018","Not on tenure/no tenure system, lecturers","259","92","167","0","0","0","24","12","12","22","5","17","13","2","11","0","0","0","184","65","119","3","1","2","1","1","0","12","6","6","-2"
"162928","Johns Hopkins University","2018","Not on tenure/no tenure system, no academic rank","164","96","68","0","0","0","21","7","14","4","4","0","2","2","0","0","0","0","126","77","49","0","0","0","0","0","0","11","6","5","-2"
"163268","University of Maryland-Baltimore County","2018","Tenured total","287","172","115","0","0","0","52","33","19","17","9","8","10","5","5","0","0","0","206","125","81","1","0","1","0","0","0","1","0","1","-2"
"163268","University of Maryland-Baltimore County","2018","Tenured, professors","143","101","42","0","0","0","24","20","4","5","3","2","2","2","0","0","0","0","112","76","36","0","0","0","0","0","0","0","0","0","-2"
"163268","University of Maryland-Baltimore County","2018","Tenured, associate professors","143","70","73","0","0","0","28","13","15","11","5","6","8","3","5","0","0","0","94","49","45","1","0","1","0","0","0","1","0","1","-2"
"163268","University of Maryland-Baltimore County","2018","Tenured, assistant professors","1","1","0","0","0","0","0","0","0","1","1","0","0","0","0","0","0","0","0","0","0","0","0","0","0","0","0","0","0","0","-2"
"163268","University of Maryland-Baltimore County","2018","On-Tenure track total","108","52","56","0","0","0","22","11","11","9","2","7","5","3","2","0","0","0","57","29","28","4","0","4","0","0","0","11","7","4","-2"
"163268","University of Maryland-Baltimore County","2018","On-tenure track, associate professors","7","2","5","0","0","0","4","2","2","0","0","0","0","0","0","0","0","0","3","0","3","0","0","0","0","0","0","0","0","0","-2"
"163268","University of Maryland-Baltimore County","2018","On-tenure track, assistant professors","101","50","51","0","0","0","18","9","9","9","2","7","5","3","2","0","0","0","54","29","25","4","0","4","0","0","0","11","7","4","-2"
"163268","University of Maryland-Baltimore County","2018","Not on tenure track/No tenure system system total","145","57","88","0","0","0","11","5","6","6","3","3","9","3","6","0","0","0","115","44","71","0","0","0","0","0","0","4","2","2","-2"
"163268","University of Maryland-Baltimore County","2018","Not on tenure/no tenure system, professors","10","8","2","0","0","0","1","1","0","0","0","0","1","0","1","0","0","0","8","7","1","0","0","0","0","0","0","0","0","0","-2"
"163268","University of Maryland-Baltimore County","2018","Not on tenure/no tenure system, associate professors","5","1","4","0","0","0","0","0","0","0","0","0","0","0","0","0","0","0","5","1","4","0","0","0","0","0","0","0","0","0","-2"
"163268","University of Maryland-Baltimore County","2018","Not on tenure/no tenure system, assistant professors","8","1","7","0","0","0","0","0","0","1","1","0","0","0","0","0","0","0","5","0","5","0","0","0","0","0","0","2","0","2","-2"
"163268","University of Maryland-Baltimore County","2018","Not on tenure/no tenure system, instructors","13","2","11","0","0","0","0","0","0","0","0","0","0","0","0","0","0","0","13","2","11","0","0","0","0","0","0","0","0","0","-2"
"163268","University of Maryland-Baltimore County","2018","Not on tenure/no tenure system, lecturers","109","45","64","0","0","0","10","4","6","5","2","3","8","3","5","0","0","0","84","34","50","0","0","0","0","0","0","2","2","0","-2"
"163286","University of Maryland-College Park","2018","Tenured total","1095","769","326","1","1","0","185","131","54","42","22","20","55","31","24","1","0","1","748","540","208","7","5","2","51","35","16","5","4","1","-2"
"163286","University of Maryland-College Park","2018","Tenured, professors","696","527","169","0","0","0","116","88","28","15","9","6","29","19","10","0","0","0","510","391","119","2","2","0","21","15","6","3","3","0","-2"
"163286","University of Maryland-College Park","2018","Tenured, associate professors","398","241","157","1","1","0","69","43","26","27","13","14","26","12","14","1","0","1","237","148","89","5","3","2","30","20","10","2","1","1","-2"
"163286","University of Maryland-College Park","2018","Tenured, assistant professors","1","1","0","0","0","0","0","0","0","0","0","0","0","0","0","0","0","0","1","1","0","0","0","0","0","0","0","0","0","0","-2"
"163286","University of Maryland-College Park","2018","On-Tenure track total","285","149","136","2","1","1","39","20","19","24","10","14","18","9","9","1","1","0","116","60","56","4","1","3","43","23","20","38","24","14","-2"
"163286","University of Maryland-College Park","2018","On-tenure track, associate professors","4","4","0","0","0","0","1","1","0","0","0","0","0","0","0","0","0","0","3","3","0","0","0","0","0","0","0","0","0","0","-2"
"163286","University of Maryland-College Park","2018","On-tenure track, assistant professors","281","145","136","2","1","1","38","19","19","24","10","14","18","9","9","1","1","0","113","57","56","4","1","3","43","23","20","38","24","14","-2"
"163286","University of Maryland-College Park","2018","Not on tenure track/No tenure system system total","463","214","249","1","1","0","29","12","17","42","18","24","32","16","16","0","0","0","294","144","150","6","0","6","48","19","29","11","4","7","-2"
"163286","University of Maryland-College Park","2018","Not on tenure/no tenure system, professors","28","19","9","0","0","0","1","1","0","2","2","0","3","3","0","0","0","0","21","13","8","0","0","0","1","0","1","0","0","0","-2"
"163286","University of Maryland-College Park","2018","Not on tenure/no tenure system, associate professors","32","11","21","0","0","0","0","0","0","3","0","3","2","1","1","0","0","0","24","10","14","0","0","0","3","0","3","0","0","0","-2"
"163286","University of Maryland-College Park","2018","Not on tenure/no tenure system, assistant professors","39","6","33","0","0","0","2","0","2","6","0","6","6","1","5","0","0","0","16","4","12","1","0","1","6","1","5","2","0","2","-2"
"163286","University of Maryland-College Park","2018","Not on tenure/no tenure system, instructors","8","4","4","0","0","0","1","0","1","3","2","1","0","0","0","0","0","0","4","2","2","0","0","0","0","0","0","0","0","0","-2"
"163286","University of Maryland-College Park","2018","Not on tenure/no tenure system, lecturers","356","174","182","1","1","0","25","11","14","28","14","14","21","11","10","0","0","0","229","115","114","5","0","5","38","18","20","9","4","5","-2"
"163338","University of Maryland Eastern Shore","2018","Tenured total","108","74","34","0","0","0","24","15","9","39","29","10","3","3","0","1","1","0","37","24","13","1","1","0","1","0","1","2","1","1","-2"
"163338","University of Maryland Eastern Shore","2018","Tenured, professors","39","24","15","0","0","0","10","5","5","16","10","6","0","0","0","0","0","0","12","8","4","1","1","0","0","0","0","0","0","0","-2"
"163338","University of Maryland Eastern Shore","2018","Tenured, associate professors","62","44","18","0","0","0","13","9","4","21","18","3","2","2","0","1","1","0","22","13","9","0","0","0","1","0","1","2","1","1","-2"
"163338","University of Maryland Eastern Shore","2018","Tenured, assistant professors","7","6","1","0","0","0","1","1","0","2","1","1","1","1","0","0","0","0","3","3","0","0","0","0","0","0","0","0","0","0","-2"
"163338","University of Maryland Eastern Shore","2018","On-Tenure track total","42","21","21","0","0","0","10","6","4","15","6","9","1","1","0","1","1","0","9","4","5","3","1","2","0","0","0","3","2","1","-2"
"163338","University of Maryland Eastern Shore","2018","On-tenure track, associate professors","5","2","3","0","0","0","2","1","1","3","1","2","0","0","0","0","0","0","0","0","0","0","0","0","0","0","0","0","0","0","-2"
"163338","University of Maryland Eastern Shore","2018","On-tenure track, assistant professors","35","18","17","0","0","0","8","5","3","10","4","6","1","1","0","1","1","0","9","4","5","3","1","2","0","0","0","3","2","1","-2"
"163338","University of Maryland Eastern Shore","2018","On-tenure track, instructors","2","1","1","0","0","0","0","0","0","2","1","1","0","0","0","0","0","0","0","0","0","0","0","0","0","0","0","0","0","0","-2"
"163338","University of Maryland Eastern Shore","2018","Not on tenure track/No tenure system system total","54","22","32","0","0","0","7","5","2","19","5","14","3","0","3","0","0","0","24","11","13","0","0","0","0","0","0","1","1","0","-2"
"163338","University of Maryland Eastern Shore","2018","Not on tenure/no tenure system, professors","2","1","1","0","0","0","0","0","0","0","0","0","0","0","0","0","0","0","2","1","1","0","0","0","0","0","0","0","0","0","-2"
"163338","University of Maryland Eastern Shore","2018","Not on tenure/no tenure system, associate professors","3","2","1","0","0","0","1","0","1","0","0","0","0","0","0","0","0","0","1","1","0","0","0","0","0","0","0","1","1","0","-2"
"163338","University of Maryland Eastern Shore","2018","Not on tenure/no tenure system, assistant professors","10","3","7","0","0","0","2","2","0","4","0","4","1","0","1","0","0","0","3","1","2","0","0","0","0","0","0","0","0","0","-2"
"163338","University of Maryland Eastern Shore","2018","Not on tenure/no tenure system, lecturers","39","16","23","0","0","0","4","3","1","15","5","10","2","0","2","0","0","0","18","8","10","0","0","0","0","0","0","0","0","0","-2"
"163851","Salisbury University","2018","Tenured total","234","136","98","0","0","0","22","13","9","17","11","6","1","0","1","0","0","0","192","110","82","0","0","0","0","0","0","2","2","0","-2"
"163851","Salisbury University","2018","Tenured, professors","99","64","35","0","0","0","12","7","5","2","2","0","0","0","0","0","0","0","85","55","30","0","0","0","0","0","0","0","0","0","-2"
"163851","Salisbury University","2018","Tenured, associate professors","125","67","58","0","0","0","8","5","3","15","9","6","1","0","1","0","0","0","99","51","48","0","0","0","0","0","0","2","2","0","-2"
"163851","Salisbury University","2018","Tenured, assistant professors","10","5","5","0","0","0","2","1","1","0","0","0","0","0","0","0","0","0","8","4","4","0","0","0","0","0","0","0","0","0","-2"
"163851","Salisbury University","2018","On-Tenure track total","112","57","55","0","0","0","11","6","5","7","4","3","7","5","2","0","0","0","79","40","39","1","0","1","1","1","0","6","1","5","-2"
"163851","Salisbury University","2018","On-tenure track, professors","1","1","0","0","0","0","0","0","0","1","1","0","0","0","0","0","0","0","0","0","0","0","0","0","0","0","0","0","0","0","-2"
"163851","Salisbury University","2018","On-tenure track, associate professors","1","0","1","0","0","0","0","0","0","0","0","0","0","0","0","0","0","0","1","0","1","0","0","0","0","0","0","0","0","0","-2"
"163851","Salisbury University","2018","On-tenure track, assistant professors","102","55","47","0","0","0","11","6","5","5","3","2","7","5","2","0","0","0","71","39","32","1","0","1","1","1","0","6","1","5","-2"
"163851","Salisbury University","2018","On-tenure track, instructors","8","1","7","0","0","0","0","0","0","1","0","1","0","0","0","0","0","0","7","1","6","0","0","0","0","0","0","0","0","0","-2"
"163851","Salisbury University","2018","Not on tenure track/No tenure system system total","98","26","72","1","0","1","6","0","6","1","0","1","2","1","1","0","0","0","88","25","63","0","0","0","0","0","0","0","0","0","-2"
"163851","Salisbury University","2018","Not on tenure/no tenure system, lecturers","98","26","72","1","0","1","6","0","6","1","0","1","2","1","1","0","0","0","88","25","63","0","0","0","0","0","0","0","0","0","-2"
"164155","United States Naval Academy","2018","Tenured total","206","147","59","1","0","1","18","13","5","6","3","3","8","3","5","1","0","1","172","128","44","0","0","0","0","0","0","0","0","0","-2"
"164155","United States Naval Academy","2018","Tenured, professors","118","83","35","1","0","1","5","3","2","2","1","1","3","1","2","1","0","1","106","78","28","0","0","0","0","0","0","0","0","0","-2"
"164155","United States Naval Academy","2018","Tenured, associate professors","88","64","24","0","0","0","13","10","3","4","2","2","5","2","3","0","0","0","66","50","16","0","0","0","0","0","0","0","0","0","-2"
"164155","United States Naval Academy","2018","On-Tenure track total","80","44","36","1","1","0","3","0","3","4","3","1","3","1","2","0","0","0","68","39","29","1","0","1","0","0","0","0","0","0","-2"
"164155","United States Naval Academy","2018","On-tenure track, assistant professors","80","44","36","1","1","0","3","0","3","4","3","1","3","1","2","0","0","0","68","39","29","1","0","1","0","0","0","0","0","0","-2"
"164155","United States Naval Academy","2018","Not on tenure track/No tenure system system total","25","20","5","0","0","0","0","0","0","1","1","0","1","1","0","0","0","0","23","18","5","0","0","0","0","0","0","0","0","0","-2"
"164155","United States Naval Academy","2018","Not on tenure/no tenure system, instructors","4","2","2","0","0","0","0","0","0","0","0","0","0","0","0","0","0","0","4","2","2","0","0","0","0","0","0","0","0","0","-2"
"164155","United States Naval Academy","2018","Not on tenure/no tenure system, no academic rank","21","18","3","0","0","0","0","0","0","1","1","0","1","1","0","0","0","0","19","16","3","0","0","0","0","0","0","0","0","0","-2"
"166027","Harvard University","2018","Tenured total","1100","819","281","1","1","0","112","85","27","42","27","15","29","17","12","0","0","0","879","658","221","6","5","1","0","0","0","31","26","5","-2"
"166027","Harvard University","2018","Tenured, professors","1100","819","281","1","1","0","112","85","27","42","27","15","29","17","12","0","0","0","879","658","221","6","5","1","0","0","0","31","26","5","-2"
"166027","Harvard University","2018","On-Tenure track total","393","233","160","1","0","1","60","33","27","23","14","9","19","12","7","0","0","0","216","128","88","9","6","3","0","0","0","65","40","25","-2"
"166027","Harvard University","2018","On-tenure track, associate professors","164","99","65","0","0","0","26","16","10","5","2","3","11","6","5","0","0","0","98","59","39","4","4","0","0","0","0","20","12","8","-2"
"166027","Harvard University","2018","On-tenure track, assistant professors","229","134","95","1","0","1","34","17","17","18","12","6","8","6","2","0","0","0","118","69","49","5","2","3","0","0","0","45","28","17","-2"
"166027","Harvard University","2018","Not on tenure track/No tenure system system total","663","356","307","1","0","1","72","39","33","37","19","18","25","15","10","1","0","1","401","220","181","15","5","10","0","0","0","111","58","53","-2"
"166027","Harvard University","2018","Not on tenure/no tenure system, professors","124","76","48","1","0","1","9","4","5","13","6","7","3","1","2","0","0","0","75","49","26","4","3","1","0","0","0","19","13","6","-2"
"166027","Harvard University","2018","Not on tenure/no tenure system, associate professors","14","7","7","0","0","0","5","2","3","0","0","0","2","2","0","0","0","0","5","2","3","0","0","0","0","0","0","2","1","1","-2"
"166027","Harvard University","2018","Not on tenure/no tenure system, assistant professors","35","19","16","0","0","0","6","4","2","1","1","0","0","0","0","0","0","0","20","8","12","0","0","0","0","0","0","8","6","2","-2"
"166027","Harvard University","2018","Not on tenure/no tenure system, instructors","210","102","108","0","0","0","29","15","14","6","3","3","14","7","7","0","0","0","104","55","49","5","2","3","0","0","0","52","20","32","-2"
"166027","Harvard University","2018","Not on tenure/no tenure system, lecturers","280","152","128","0","0","0","23","14","9","17","9","8","6","5","1","1","0","1","197","106","91","6","0","6","0","0","0","30","18","12","-2"
"166513","University of Massachusetts-Lowell","2018","Tenured total","284","171","113","0","0","0","72","48","24","6","5","1","11","8","3","0","0","0","191","107","84","2","1","1","1","1","0","1","1","0","-2"
"166513","University of Massachusetts-Lowell","2018","Tenured, professors","146","105","41","0","0","0","40","31","9","2","2","0","3","3","0","0","0","0","99","67","32","0","0","0","1","1","0","1","1","0","-2"
"166513","University of Massachusetts-Lowell","2018","Tenured, associate professors","138","66","72","0","0","0","32","17","15","4","3","1","8","5","3","0","0","0","92","40","52","2","1","1","0","0","0","0","0","0","-2"
"166513","University of Massachusetts-Lowell","2018","On-Tenure track total","155","94","61","0","0","0","33","18","15","4","1","3","4","3","1","0","0","0","81","50","31","5","3","2","1","0","1","27","19","8","-2"
"166513","University of Massachusetts-Lowell","2018","On-tenure track, professors","2","1","1","0","0","0","0","0","0","0","0","0","0","0","0","0","0","0","1","1","0","0","0","0","1","0","1","0","0","0","-2"
"166513","University of Massachusetts-Lowell","2018","On-tenure track, associate professors","7","5","2","0","0","0","3","3","0","0","0","0","1","1","0","0","0","0","2","0","2","0","0","0","0","0","0","1","1","0","-2"
"166513","University of Massachusetts-Lowell","2018","On-tenure track, assistant professors","146","88","58","0","0","0","30","15","15","4","1","3","3","2","1","0","0","0","78","49","29","5","3","2","0","0","0","26","18","8","-2"
"166513","University of Massachusetts-Lowell","2018","Not on tenure track/No tenure system system total","198","86","112","0","0","0","20","11","9","4","2","2","3","3","0","0","0","0","160","64","96","1","1","0","0","0","0","10","5","5","-2"
"166513","University of Massachusetts-Lowell","2018","Not on tenure/no tenure system, professors","1","0","1","0","0","0","0","0","0","0","0","0","0","0","0","0","0","0","1","0","1","0","0","0","0","0","0","0","0","0","-2"
"166513","University of Massachusetts-Lowell","2018","Not on tenure/no tenure system, associate professors","7","3","4","0","0","0","0","0","0","0","0","0","1","1","0","0","0","0","6","2","4","0","0","0","0","0","0","0","0","0","-2"
"166513","University of Massachusetts-Lowell","2018","Not on tenure/no tenure system, assistant professors","6","0","6","0","0","0","1","0","1","0","0","0","0","0","0","0","0","0","5","0","5","0","0","0","0","0","0","0","0","0","-2"
"166513","University of Massachusetts-Lowell","2018","Not on tenure/no tenure system, instructors","2","0","2","0","0","0","0","0","0","0","0","0","0","0","0","0","0","0","2","0","2","0","0","0","0","0","0","0","0","0","-2"
"166513","University of Massachusetts-Lowell","2018","Not on tenure/no tenure system, lecturers","105","45","60","0","0","0","9","5","4","3","1","2","2","2","0","0","0","0","87","34","53","1","1","0","0","0","0","3","2","1","-2"
"166513","University of Massachusetts-Lowell","2018","Not on tenure/no tenure system, no academic rank","77","38","39","0","0","0","10","6","4","1","1","0","0","0","0","0","0","0","59","28","31","0","0","0","0","0","0","7","3","4","-2"
"166629","University of Massachusetts-Amherst","2018","Tenured total","783","487","296","3","2","1","110","74","36","33","19","14","34","19","15","0","0","0","569","354","215","9","4","5","20","10","10","5","5","0","-2"
"166629","University of Massachusetts-Amherst","2018","Tenured, professors","454","321","133","1","1","0","57","48","9","13","7","6","14","6","8","0","0","0","353","248","105","6","4","2","8","5","3","2","2","0","-2"
"166629","University of Massachusetts-Amherst","2018","Tenured, associate professors","328","165","163","2","1","1","52","25","27","20","12","8","20","13","7","0","0","0","216","106","110","3","0","3","12","5","7","3","3","0","-2"
"166629","University of Massachusetts-Amherst","2018","Tenured, assistant professors","1","1","0","0","0","0","1","1","0","0","0","0","0","0","0","0","0","0","0","0","0","0","0","0","0","0","0","0","0","0","-2"
"166629","University of Massachusetts-Amherst","2018","On-Tenure track total","292","148","144","1","1","0","49","28","21","20","6","14","4","1","3","0","0","0","159","74","85","6","5","1","13","10","3","40","23","17","-2"
"166629","University of Massachusetts-Amherst","2018","On-tenure track, professors","2","2","0","0","0","0","0","0","0","0","0","0","0","0","0","0","0","0","1","1","0","0","0","0","0","0","0","1","1","0","-2"
"166629","University of Massachusetts-Amherst","2018","On-tenure track, associate professors","4","1","3","0","0","0","1","0","1","0","0","0","0","0","0","0","0","0","1","0","1","1","1","0","0","0","0","1","0","1","-2"
"166629","University of Massachusetts-Amherst","2018","On-tenure track, assistant professors","286","145","141","1","1","0","48","28","20","20","6","14","4","1","3","0","0","0","157","73","84","5","4","1","13","10","3","38","22","16","-2"
"166629","University of Massachusetts-Amherst","2018","Not on tenure track/No tenure system system total","342","137","205","2","0","2","22","7","15","12","5","7","8","1","7","0","0","0","262","106","156","4","1","3","8","3","5","24","14","10","-2"
"166629","University of Massachusetts-Amherst","2018","Not on tenure/no tenure system, professors","3","2","1","0","0","0","0","0","0","0","0","0","1","0","1","0","0","0","1","1","0","0","0","0","0","0","0","1","1","0","-2"
"166629","University of Massachusetts-Amherst","2018","Not on tenure/no tenure system, associate professors","6","3","3","0","0","0","0","0","0","1","1","0","0","0","0","0","0","0","5","2","3","0","0","0","0","0","0","0","0","0","-2"
"166629","University of Massachusetts-Amherst","2018","Not on tenure/no tenure system, assistant professors","22","1","21","0","0","0","0","0","0","1","0","1","1","0","1","0","0","0","20","1","19","0","0","0","0","0","0","0","0","0","-2"
"166629","University of Massachusetts-Amherst","2018","Not on tenure/no tenure system, instructors","5","1","4","0","0","0","0","0","0","0","0","0","0","0","0","0","0","0","3","1","2","0","0","0","0","0","0","2","0","2","-2"
"166629","University of Massachusetts-Amherst","2018","Not on tenure/no tenure system, lecturers","306","130","176","2","0","2","22","7","15","10","4","6","6","1","5","0","0","0","233","101","132","4","1","3","8","3","5","21","13","8","-2"
"166683","Massachusetts Institute of Technology","2018","Tenured total","766","610","156","0","0","0","96","76","20","23","17","6","25","23","2","0","0","0","554","442","112","10","7","3","53","40","13","5","5","0","-2"
"166683","Massachusetts Institute of Technology","2018","Tenured, professors","636","517","119","0","0","0","69","58","11","18","14","4","20","19","1","0","0","0","487","392","95","5","4","1","32","25","7","5","5","0","-2"
"166683","Massachusetts Institute of Technology","2018","Tenured, associate professors","130","93","37","0","0","0","27","18","9","5","3","2","5","4","1","0","0","0","67","50","17","5","3","2","21","15","6","0","0","0","-2"
"166683","Massachusetts Institute of Technology","2018","On-Tenure track total","248","167","81","0","0","0","22","17","5","5","2","3","19","13","6","0","0","0","120","81","39","4","2","2","52","33","19","26","19","7","-2"
"166683","Massachusetts Institute of Technology","2018","On-tenure track, associate professors","84","59","25","0","0","0","13","11","2","0","0","0","6","4","2","0","0","0","39","28","11","3","2","1","20","12","8","3","2","1","-2"
"166683","Massachusetts Institute of Technology","2018","On-tenure track, assistant professors","164","108","56","0","0","0","9","6","3","5","2","3","13","9","4","0","0","0","81","53","28","1","0","1","32","21","11","23","17","6","-2"
"166683","Massachusetts Institute of Technology","2018","Not on tenure track/No tenure system system total","9","6","3","0","0","0","1","0","1","1","1","0","0","0","0","0","0","0","6","4","2","0","0","0","1","1","0","0","0","0","-2"
"166683","Massachusetts Institute of Technology","2018","Not on tenure/no tenure system, professors","1","0","1","0","0","0","0","0","0","0","0","0","0","0","0","0","0","0","1","0","1","0","0","0","0","0","0","0","0","0","-2"
"166683","Massachusetts Institute of Technology","2018","Not on tenure/no tenure system, associate professors","7","5","2","0","0","0","1","0","1","1","1","0","0","0","0","0","0","0","5","4","1","0","0","0","0","0","0","0","0","0","-2"
"166683","Massachusetts Institute of Technology","2018","Not on tenure/no tenure system, assistant professors","1","1","0","0","0","0","0","0","0","0","0","0","0","0","0","0","0","0","0","0","0","0","0","0","1","1","0","0","0","0","-2"
"169248","Central Michigan University","2018","Tenured total","458","272","186","1","1","0","59","35","24","17","9","8","19","11","8","0","0","0","353","209","144","5","4","1","0","0","0","4","3","1","-2"
"169248","Central Michigan University","2018","Tenured, professors","302","192","110","1","1","0","33","23","10","13","8","5","11","6","5","0","0","0","241","151","90","2","2","0","0","0","0","1","1","0","-2"
"169248","Central Michigan University","2018","Tenured, associate professors","146","75","71","0","0","0","26","12","14","4","1","3","8","5","3","0","0","0","103","54","49","3","2","1","0","0","0","2","1","1","-2"
"169248","Central Michigan University","2018","Tenured, assistant professors","10","5","5","0","0","0","0","0","0","0","0","0","0","0","0","0","0","0","9","4","5","0","0","0","0","0","0","1","1","0","-2"
"169248","Central Michigan University","2018","On-Tenure track total","120","60","60","0","0","0","20","14","6","2","2","0","0","0","0","0","0","0","78","36","42","0","0","0","3","0","3","17","8","9","-2"
"169248","Central Michigan University","2018","On-tenure track, professors","1","1","0","0","0","0","0","0","0","0","0","0","0","0","0","0","0","0","1","1","0","0","0","0","0","0","0","0","0","0","-2"
"169248","Central Michigan University","2018","On-tenure track, associate professors","20","13","7","0","0","0","6","5","1","0","0","0","0","0","0","0","0","0","12","7","5","0","0","0","1","0","1","1","1","0","-2"
"169248","Central Michigan University","2018","On-tenure track, assistant professors","99","46","53","0","0","0","14","9","5","2","2","0","0","0","0","0","0","0","65","28","37","0","0","0","2","0","2","16","7","9","-2"
"169248","Central Michigan University","2018","Not on tenure track/No tenure system system total","244","135","109","1","1","0","7","5","2","4","3","1","4","1","3","0","0","0","216","117","99","1","0","1","1","1","0","10","7","3","-2"
"169248","Central Michigan University","2018","Not on tenure/no tenure system, professors","5","3","2","0","0","0","2","1","1","0","0","0","0","0","0","0","0","0","3","2","1","0","0","0","0","0","0","0","0","0","-2"
"169248","Central Michigan University","2018","Not on tenure/no tenure system, associate professors","2","1","1","0","0","0","0","0","0","0","0","0","0","0","0","0","0","0","2","1","1","0","0","0","0","0","0","0","0","0","-2"
"169248","Central Michigan University","2018","Not on tenure/no tenure system, assistant professors","8","4","4","0","0","0","1","1","0","0","0","0","0","0","0","0","0","0","6","3","3","1","0","1","0","0","0","0","0","0","-2"
"169248","Central Michigan University","2018","Not on tenure/no tenure system, instructors","7","4","3","0","0","0","0","0","0","1","1","0","0","0","0","0","0","0","6","3","3","0","0","0","0","0","0","0","0","0","-2"
"169248","Central Michigan University","2018","Not on tenure/no tenure system, lecturers","218","121","97","1","1","0","4","3","1","2","2","0","4","1","3","0","0","0","196","106","90","0","0","0","1","1","0","10","7","3","-2"
"169248","Central Michigan University","2018","Not on tenure/no tenure system, no academic rank","4","2","2","0","0","0","0","0","0","1","0","1","0","0","0","0","0","0","3","2","1","0","0","0","0","0","0","0","0","0","-2"
"170976","University of Michigan-Ann Arbor","2018","Tenured total","2164","1492","672","7","4","3","326","240","86","85","54","31","89","54","35","2","0","2","1605","1103","502","24","17","7","17","13","4","9","7","2","-2"
"170976","University of Michigan-Ann Arbor","2018","Tenured, professors","1489","1090","399","4","2","2","202","157","45","50","30","20","54","33","21","2","0","2","1148","846","302","12","9","3","11","9","2","6","4","2","-2"
"170976","University of Michigan-Ann Arbor","2018","Tenured, associate professors","675","402","273","3","2","1","124","83","41","35","24","11","35","21","14","0","0","0","457","257","200","12","8","4","6","4","2","3","3","0","-2"
"170976","University of Michigan-Ann Arbor","2018","On-Tenure track total","647","345","302","2","1","1","114","62","52","36","14","22","21","13","8","0","0","0","383","208","175","16","8","8","15","7","8","60","32","28","-2"
"170976","University of Michigan-Ann Arbor","2018","On-tenure track, professors","2","2","0","0","0","0","1","1","0","0","0","0","0","0","0","0","0","0","1","1","0","0","0","0","0","0","0","0","0","0","-2"
"170976","University of Michigan-Ann Arbor","2018","On-tenure track, associate professors","22","13","9","0","0","0","8","6","2","0","0","0","1","1","0","0","0","0","11","6","5","0","0","0","1","0","1","1","0","1","-2"
"170976","University of Michigan-Ann Arbor","2018","On-tenure track, assistant professors","623","330","293","2","1","1","105","55","50","36","14","22","20","12","8","0","0","0","371","201","170","16","8","8","14","7","7","59","32","27","-2"
"170976","University of Michigan-Ann Arbor","2018","Not on tenure track/No tenure system system total","3895","2148","1747","8","4","4","550","301","249","110","50","60","129","51","78","0","0","0","2079","1079","1000","44","21","23","57","30","27","918","612","306","-2"
"170976","University of Michigan-Ann Arbor","2018","Not on tenure/no tenure system, professors","236","162","74","1","1","0","36","24","12","4","2","2","5","3","2","0","0","0","186","130","56","1","1","0","1","0","1","2","1","1","-2"
"170976","University of Michigan-Ann Arbor","2018","Not on tenure/no tenure system, associate professors","340","182","158","0","0","0","67","36","31","12","6","6","11","5","6","0","0","0","232","125","107","5","2","3","6","3","3","7","5","2","-2"
"170976","University of Michigan-Ann Arbor","2018","Not on tenure/no tenure system, assistant professors","794","412","382","1","0","1","141","81","60","35","16","19","20","11","9","0","0","0","506","246","260","15","7","8","16","10","6","60","41","19","-2"
"170976","University of Michigan-Ann Arbor","2018","Not on tenure/no tenure system, instructors","171","68","103","1","1","0","25","10","15","9","6","3","6","0","6","0","0","0","121","46","75","1","1","0","4","1","3","4","3","1","-2"
"170976","University of Michigan-Ann Arbor","2018","Not on tenure/no tenure system, lecturers","750","341","409","3","1","2","84","36","48","22","9","13","41","9","32","0","0","0","526","246","280","11","4","7","16","8","8","47","28","19","-2"
"170976","University of Michigan-Ann Arbor","2018","Not on tenure/no tenure system, no academic rank","1604","983","621","2","1","1","197","114","83","28","11","17","46","23","23","0","0","0","508","286","222","11","6","5","14","8","6","798","534","264","-2"
"171100","Michigan State University","2018","Tenured total","1423","953","470","13","10","3","200","132","68","60","37","23","58","41","17","2","2","0","1077","723","354","7","2","5","0","0","0","6","6","0","-2"
"171100","Michigan State University","2018","Tenured, professors","832","610","222","7","6","1","109","82","27","30","21","9","19","13","6","1","1","0","660","482","178","3","2","1","0","0","0","3","3","0","-2"
"171100","Michigan State University","2018","Tenured, associate professors","591","343","248","6","4","2","91","50","41","30","16","14","39","28","11","1","1","0","417","241","176","4","0","4","0","0","0","3","3","0","-2"
"171100","Michigan State University","2018","On-Tenure track total","449","236","213","1","0","1","75","49","26","17","8","9","32","13","19","1","0","1","257","128","129","3","0","3","0","0","0","63","38","25","-2"
"171100","Michigan State University","2018","On-tenure track, associate professors","20","11","9","0","0","0","6","4","2","0","0","0","1","1","0","0","0","0","10","4","6","0","0","0","0","0","0","3","2","1","-2"
"171100","Michigan State University","2018","On-tenure track, assistant professors","429","225","204","1","0","1","69","45","24","17","8","9","31","12","19","1","0","1","247","124","123","3","0","3","0","0","0","60","36","24","-2"
"171100","Michigan State University","2018","Not on tenure track/No tenure system system total","896","440","456","1","1","0","102","54","48","53","29","24","27","15","12","0","0","0","648","305","343","3","0","3","0","0","0","62","36","26","-2"
"171100","Michigan State University","2018","Not on tenure/no tenure system, professors","75","54","21","0","0","0","10","9","1","8","5","3","1","1","0","0","0","0","52","36","16","0","0","0","0","0","0","4","3","1","-2"
"171100","Michigan State University","2018","Not on tenure/no tenure system, associate professors","110","71","39","0","0","0","20","13","7","8","6","2","1","0","1","0","0","0","78","49","29","0","0","0","0","0","0","3","3","0","-2"
"171100","Michigan State University","2018","Not on tenure/no tenure system, assistant professors","503","239","264","1","1","0","64","29","35","30","15","15","21","12","9","0","0","0","341","154","187","2","0","2","0","0","0","44","28","16","-2"
"171100","Michigan State University","2018","Not on tenure/no tenure system, instructors","202","73","129","0","0","0","7","3","4","7","3","4","4","2","2","0","0","0","172","63","109","1","0","1","0","0","0","11","2","9","-2"
"171100","Michigan State University","2018","Not on tenure/no tenure system, lecturers","6","3","3","0","0","0","1","0","1","0","0","0","0","0","0","0","0","0","5","3","2","0","0","0","0","0","0","0","0","0","-2"
"171128","Michigan Technological University","2018","Tenured total","233","175","58","0","0","0","48","41","7","4","2","2","5","3","2","0","0","0","150","107","43","1","1","0","24","20","4","1","1","0","-2"
"171128","Michigan Technological University","2018","Tenured, professors","121","95","26","0","0","0","23","21","2","2","1","1","3","2","1","0","0","0","80","60","20","0","0","0","13","11","2","0","0","0","-2"
"171128","Michigan Technological University","2018","Tenured, associate professors","112","80","32","0","0","0","25","20","5","2","1","1","2","1","1","0","0","0","70","47","23","1","1","0","11","9","2","1","1","0","-2"
"171128","Michigan Technological University","2018","On-Tenure track total","90","57","33","0","0","0","17","10","7","1","1","0","5","4","1","0","0","0","45","27","18","0","0","0","8","4","4","14","11","3","-2"
"171128","Michigan Technological University","2018","On-tenure track, professors","1","1","0","0","0","0","0","0","0","1","1","0","0","0","0","0","0","0","0","0","0","0","0","0","0","0","0","0","0","0","-2"
"171128","Michigan Technological University","2018","On-tenure track, associate professors","5","4","1","0","0","0","2","2","0","0","0","0","0","0","0","0","0","0","1","0","1","0","0","0","0","0","0","2","2","0","-2"
"171128","Michigan Technological University","2018","On-tenure track, assistant professors","84","52","32","0","0","0","15","8","7","0","0","0","5","4","1","0","0","0","44","27","17","0","0","0","8","4","4","12","9","3","-2"
"171128","Michigan Technological University","2018","Not on tenure track/No tenure system system total","87","52","35","0","0","0","5","4","1","1","0","1","1","0","1","0","0","0","73","42","31","0","0","0","1","1","0","6","5","1","-2"
"171128","Michigan Technological University","2018","Not on tenure/no tenure system, instructors","25","18","7","0","0","0","1","1","0","0","0","0","0","0","0","0","0","0","21","15","6","0","0","0","1","1","0","2","1","1","-2"
"171128","Michigan Technological University","2018","Not on tenure/no tenure system, lecturers","62","34","28","0","0","0","4","3","1","1","0","1","1","0","1","0","0","0","52","27","25","0","0","0","0","0","0","4","4","0","-2"
"174066","University of Minnesota-Twin Cities","2018","Tenured total","1651","1112","539","9","4","5","229","167","62","39","22","17","43","25","18","1","1","0","1291","867","424","19","11","8","4","4","0","16","11","5","-2"
"174066","University of Minnesota-Twin Cities","2018","Tenured, professors","1081","776","305","4","2","2","136","107","29","15","11","4","22","15","7","0","0","0","891","633","258","8","4","4","1","1","0","4","3","1","-2"
"174066","University of Minnesota-Twin Cities","2018","Tenured, associate professors","567","333","234","5","2","3","93","60","33","24","11","13","21","10","11","1","1","0","397","231","166","11","7","4","3","3","0","12","8","4","-2"
"174066","University of Minnesota-Twin Cities","2018","Tenured, assistant professors","1","1","0","0","0","0","0","0","0","0","0","0","0","0","0","0","0","0","1","1","0","0","0","0","0","0","0","0","0","0","-2"
"174066","University of Minnesota-Twin Cities","2018","Tenured, instructors","1","1","0","0","0","0","0","0","0","0","0","0","0","0","0","0","0","0","1","1","0","0","0","0","0","0","0","0","0","0","-2"
"174066","University of Minnesota-Twin Cities","2018","Tenured, no academic rank","1","1","0","0","0","0","0","0","0","0","0","0","0","0","0","0","0","0","1","1","0","0","0","0","0","0","0","0","0","0","-2"
"174066","University of Minnesota-Twin Cities","2018","On-Tenure track total","526","289","237","2","1","1","56","32","24","21","8","13","20","12","8","1","0","1","289","148","141","14","8","6","28","18","10","95","62","33","-2"
"174066","University of Minnesota-Twin Cities","2018","On-tenure track, associate professors","43","25","18","0","0","0","6","3","3","1","0","1","1","1","0","0","0","0","29","17","12","1","1","0","2","1","1","3","2","1","-2"
"174066","University of Minnesota-Twin Cities","2018","On-tenure track, assistant professors","483","264","219","2","1","1","50","29","21","20","8","12","19","11","8","1","0","1","260","131","129","13","7","6","26","17","9","92","60","32","-2"
"174066","University of Minnesota-Twin Cities","2018","Not on tenure track/No tenure system system total","1084","562","522","4","1","3","146","87","59","21","12","9","33","18","15","2","2","0","779","377","402","15","7","8","23","19","4","61","39","22","-2"
"174066","University of Minnesota-Twin Cities","2018","Not on tenure/no tenure system, professors","100","73","27","0","0","0","14","12","2","1","1","0","3","2","1","0","0","0","76","53","23","1","1","0","1","1","0","4","3","1","-2"
"174066","University of Minnesota-Twin Cities","2018","Not on tenure/no tenure system, associate professors","215","111","104","0","0","0","30","15","15","4","3","1","6","3","3","1","1","0","165","83","82","0","0","0","3","3","0","6","3","3","-2"
"174066","University of Minnesota-Twin Cities","2018","Not on tenure/no tenure system, assistant professors","720","352","368","3","1","2","96","56","40","16","8","8","24","13","11","1","1","0","500","223","277","14","6","8","16","12","4","50","32","18","-2"
"174066","University of Minnesota-Twin Cities","2018","Not on tenure/no tenure system, instructors","44","22","22","0","0","0","5","3","2","0","0","0","0","0","0","0","0","0","35","15","20","0","0","0","3","3","0","1","1","0","-2"
"174066","University of Minnesota-Twin Cities","2018","Not on tenure/no tenure system, no academic rank","5","4","1","1","0","1","1","1","0","0","0","0","0","0","0","0","0","0","3","3","0","0","0","0","0","0","0","0","0","0","-2"
"174783","Saint Cloud State University","2018","Tenured total","302","182","120","4","1","3","47","29","18","15","12","3","15","9","6","0","0","0","214","127","87","0","0","0","6","3","3","1","1","0","-2"
"174783","Saint Cloud State University","2018","Tenured, professors","209","127","82","2","1","1","31","19","12","11","9","2","11","7","4","0","0","0","149","88","61","0","0","0","4","2","2","1","1","0","-2"
"174783","Saint Cloud State University","2018","Tenured, associate professors","86","50","36","2","0","2","16","10","6","4","3","1","4","2","2","0","0","0","58","34","24","0","0","0","2","1","1","0","0","0","-2"
"174783","Saint Cloud State University","2018","Tenured, assistant professors","7","5","2","0","0","0","0","0","0","0","0","0","0","0","0","0","0","0","7","5","2","0","0","0","0","0","0","0","0","0","-2"
"174783","Saint Cloud State University","2018","On-Tenure track total","51","25","26","0","0","0","7","3","4","3","1","2","0","0","0","1","0","1","39","20","19","0","0","0","0","0","0","1","1","0","-2"
"174783","Saint Cloud State University","2018","On-tenure track, associate professors","12","8","4","0","0","0","1","1","0","0","0","0","0","0","0","0","0","0","11","7","4","0","0","0","0","0","0","0","0","0","-2"
"174783","Saint Cloud State University","2018","On-tenure track, assistant professors","39","17","22","0","0","0","6","2","4","3","1","2","0","0","0","1","0","1","28","13","15","0","0","0","0","0","0","1","1","0","-2"
"174783","Saint Cloud State University","2018","Not on tenure track/No tenure system system total","60","30","30","0","0","0","5","4","1","2","2","0","1","1","0","0","0","0","50","21","29","0","0","0","0","0","0","2","2","0","-2"
"174783","Saint Cloud State University","2018","Not on tenure/no tenure system, associate professors","4","1","3","0","0","0","0","0","0","0","0","0","0","0","0","0","0","0","4","1","3","0","0","0","0","0","0","0","0","0","-2"
"174783","Saint Cloud State University","2018","Not on tenure/no tenure system, assistant professors","41","22","19","0","0","0","4","3","1","2","2","0","0","0","0","0","0","0","34","16","18","0","0","0","0","0","0","1","1","0","-2"
"174783","Saint Cloud State University","2018","Not on tenure/no tenure system, instructors","15","7","8","0","0","0","1","1","0","0","0","0","1","1","0","0","0","0","12","4","8","0","0","0","0","0","0","1","1","0","-2"
"175856","Jackson State University","2018","Tenured total","172","107","65","1","1","0","31","28","3","98","46","52","1","1","0","0","0","0","33","24","9","0","0","0","0","0","0","8","7","1","-2"
"175856","Jackson State University","2018","Tenured, professors","85","58","27","1","1","0","17","15","2","44","24","20","1","1","0","0","0","0","19","14","5","0","0","0","0","0","0","3","3","0","-2"
"175856","Jackson State University","2018","Tenured, associate professors","81","45","36","0","0","0","14","13","1","49","19","30","0","0","0","0","0","0","14","10","4","0","0","0","0","0","0","4","3","1","-2"
"175856","Jackson State University","2018","Tenured, assistant professors","6","4","2","0","0","0","0","0","0","5","3","2","0","0","0","0","0","0","0","0","0","0","0","0","0","0","0","1","1","0","-2"
"175856","Jackson State University","2018","On-Tenure track total","55","25","30","0","0","0","4","3","1","30","8","22","2","2","0","0","0","0","8","4","4","1","1","0","0","0","0","10","7","3","-2"
"175856","Jackson State University","2018","On-tenure track, professors","1","1","0","0","0","0","0","0","0","0","0","0","0","0","0","0","0","0","1","1","0","0","0","0","0","0","0","0","0","0","-2"
"175856","Jackson State University","2018","On-tenure track, associate professors","5","3","2","0","0","0","0","0","0","2","1","1","1","1","0","0","0","0","1","0","1","0","0","0","0","0","0","1","1","0","-2"
"175856","Jackson State University","2018","On-tenure track, assistant professors","49","21","28","0","0","0","4","3","1","28","7","21","1","1","0","0","0","0","6","3","3","1","1","0","0","0","0","9","6","3","-2"
"175856","Jackson State University","2018","Not on tenure track/No tenure system system total","120","51","69","0","0","0","9","4","5","91","38","53","1","0","1","0","0","0","14","7","7","0","0","0","0","0","0","5","2","3","-2"
"175856","Jackson State University","2018","Not on tenure/no tenure system, professors","2","1","1","0","0","0","0","0","0","1","0","1","0","0","0","0","0","0","1","1","0","0","0","0","0","0","0","0","0","0","-2"
"175856","Jackson State University","2018","Not on tenure/no tenure system, associate professors","6","5","1","0","0","0","0","0","0","6","5","1","0","0","0","0","0","0","0","0","0","0","0","0","0","0","0","0","0","0","-2"
"175856","Jackson State University","2018","Not on tenure/no tenure system, assistant professors","32","15","17","0","0","0","5","4","1","21","8","13","0","0","0","0","0","0","4","2","2","0","0","0","0","0","0","2","1","1","-2"
"175856","Jackson State University","2018","Not on tenure/no tenure system, instructors","67","25","42","0","0","0","4","0","4","53","21","32","1","0","1","0","0","0","8","3","5","0","0","0","0","0","0","1","1","0","-2"
"175856","Jackson State University","2018","Not on tenure/no tenure system, lecturers","13","5","8","0","0","0","0","0","0","10","4","6","0","0","0","0","0","0","1","1","0","0","0","0","0","0","0","2","0","2","-2"
"176017","University of Mississippi","2018","Tenured total","633","419","214","2","1","1","51","39","12","45","22","23","10","8","2","1","0","1","500","330","170","19","16","3","0","0","0","5","3","2","-2"
"176017","University of Mississippi","2018","Tenured, professors","347","238","109","1","1","0","31","25","6","25","12","13","4","3","1","0","0","0","273","185","88","13","12","1","0","0","0","0","0","0","-2"
"176017","University of Mississippi","2018","Tenured, associate professors","279","179","100","1","0","1","18","12","6","20","10","10","6","5","1","1","0","1","222","145","77","6","4","2","0","0","0","5","3","2","-2"
"176017","University of Mississippi","2018","Tenured, assistant professors","7","2","5","0","0","0","2","2","0","0","0","0","0","0","0","0","0","0","5","0","5","0","0","0","0","0","0","0","0","0","-2"
"176017","University of Mississippi","2018","On-Tenure track total","300","173","127","1","1","0","32","20","12","20","7","13","10","4","6","0","0","0","183","104","79","2","2","0","0","0","0","52","35","17","-2"
"176017","University of Mississippi","2018","On-tenure track, professors","19","14","5","0","0","0","4","3","1","0","0","0","1","0","1","0","0","0","11","8","3","0","0","0","0","0","0","3","3","0","-2"
"176017","University of Mississippi","2018","On-tenure track, associate professors","37","20","17","0","0","0","6","2","4","3","1","2","0","0","0","0","0","0","24","13","11","0","0","0","0","0","0","4","4","0","-2"
"176017","University of Mississippi","2018","On-tenure track, assistant professors","244","139","105","1","1","0","22","15","7","17","6","11","9","4","5","0","0","0","148","83","65","2","2","0","0","0","0","45","28","17","-2"
"176017","University of Mississippi","2018","Not on tenure track/No tenure system system total","895","409","486","2","2","0","60","30","30","66","21","45","33","9","24","0","0","0","647","296","351","6","3","3","1","1","0","80","47","33","-2"
"176017","University of Mississippi","2018","Not on tenure/no tenure system, professors","90","63","27","1","1","0","10","7","3","2","1","1","2","1","1","0","0","0","74","52","22","1","1","0","0","0","0","0","0","0","-2"
"176017","University of Mississippi","2018","Not on tenure/no tenure system, associate professors","151","81","70","0","0","0","15","10","5","15","5","10","6","1","5","0","0","0","112","63","49","0","0","0","0","0","0","3","2","1","-2"
"176017","University of Mississippi","2018","Not on tenure/no tenure system, assistant professors","365","170","195","0","0","0","22","7","15","29","9","20","10","4","6","0","0","0","240","107","133","1","1","0","1","1","0","62","41","21","-2"
"176017","University of Mississippi","2018","Not on tenure/no tenure system, instructors","249","81","168","1","1","0","13","6","7","19","6","13","11","2","9","0","0","0","187","61","126","3","1","2","0","0","0","15","4","11","-2"
"176017","University of Mississippi","2018","Not on tenure/no tenure system, lecturers","40","14","26","0","0","0","0","0","0","1","0","1","4","1","3","0","0","0","34","13","21","1","0","1","0","0","0","0","0","0","-2"
"176044","Mississippi Valley State University","2018","Tenured total","54","30","24","0","0","0","9","8","1","31","15","16","0","0","0","0","0","0","12","7","5","0","0","0","2","0","2","0","0","0","-2"
"176044","Mississippi Valley State University","2018","Tenured, professors","17","12","5","0","0","0","6","5","1","7","5","2","0","0","0","0","0","0","3","2","1","0","0","0","1","0","1","0","0","0","-2"
"176044","Mississippi Valley State University","2018","Tenured, associate professors","21","12","9","0","0","0","2","2","0","9","5","4","0","0","0","0","0","0","9","5","4","0","0","0","1","0","1","0","0","0","-2"
"176044","Mississippi Valley State University","2018","Tenured, assistant professors","16","6","10","0","0","0","1","1","0","15","5","10","0","0","0","0","0","0","0","0","0","0","0","0","0","0","0","0","0","0","-2"
"176044","Mississippi Valley State University","2018","On-Tenure track total","27","11","16","0","0","0","2","1","1","19","5","14","0","0","0","0","0","0","5","4","1","0","0","0","1","1","0","0","0","0","-2"
"176044","Mississippi Valley State University","2018","On-tenure track, associate professors","4","3","1","0","0","0","1","1","0","2","1","1","0","0","0","0","0","0","1","1","0","0","0","0","0","0","0","0","0","0","-2"
"176044","Mississippi Valley State University","2018","On-tenure track, assistant professors","23","8","15","0","0","0","1","0","1","17","4","13","0","0","0","0","0","0","4","3","1","0","0","0","1","1","0","0","0","0","-2"
"176044","Mississippi Valley State University","2018","Not on tenure track/No tenure system system total","29","12","17","0","0","0","1","1","0","27","11","16","0","0","0","0","0","0","1","0","1","0","0","0","0","0","0","0","0","0","-2"
"176044","Mississippi Valley State University","2018","Not on tenure/no tenure system, instructors","29","12","17","0","0","0","1","1","0","27","11","16","0","0","0","0","0","0","1","0","1","0","0","0","0","0","0","0","0","0","-2"
"176080","Mississippi State University","2018","Tenured total","410","303","107","0","0","0","39","35","4","13","4","9","12","6","6","0","0","0","341","257","84","4","0","4","0","0","0","1","1","0","-2"
"176080","Mississippi State University","2018","Tenured, professors","223","175","48","0","0","0","23","23","0","5","0","5","9","4","5","0","0","0","185","148","37","1","0","1","0","0","0","0","0","0","-2"
"176080","Mississippi State University","2018","Tenured, associate professors","187","128","59","0","0","0","16","12","4","8","4","4","3","2","1","0","0","0","156","109","47","3","0","3","0","0","0","1","1","0","-2"
"176080","Mississippi State University","2018","On-Tenure track total","312","187","125","2","1","1","45","39","6","19","6","13","12","3","9","0","0","0","180","106","74","3","2","1","0","0","0","51","30","21","-2"
"176080","Mississippi State University","2018","On-tenure track, professors","4","3","1","0","0","0","0","0","0","0","0","0","0","0","0","0","0","0","4","3","1","0","0","0","0","0","0","0","0","0","-2"
"176080","Mississippi State University","2018","On-tenure track, associate professors","46","37","9","0","0","0","12","12","0","1","1","0","3","0","3","0","0","0","26","20","6","1","1","0","0","0","0","3","3","0","-2"
"176080","Mississippi State University","2018","On-tenure track, assistant professors","262","147","115","2","1","1","33","27","6","18","5","13","9","3","6","0","0","0","150","83","67","2","1","1","0","0","0","48","27","21","-2"
"176080","Mississippi State University","2018","Not on tenure track/No tenure system system total","225","81","144","1","1","0","5","2","3","17","5","12","6","2","4","0","0","0","186","64","122","1","1","0","0","0","0","9","6","3","-2"
"176080","Mississippi State University","2018","Not on tenure/no tenure system, professors","1","0","1","0","0","0","0","0","0","0","0","0","0","0","0","0","0","0","1","0","1","0","0","0","0","0","0","0","0","0","-2"
"176080","Mississippi State University","2018","Not on tenure/no tenure system, associate professors","2","1","1","0","0","0","0","0","0","1","0","1","0","0","0","0","0","0","1","1","0","0","0","0","0","0","0","0","0","0","-2"
"176080","Mississippi State University","2018","Not on tenure/no tenure system, assistant professors","12","8","4","0","0","0","1","1","0","2","1","1","0","0","0","0","0","0","5","3","2","0","0","0","0","0","0","4","3","1","-2"
"176080","Mississippi State University","2018","Not on tenure/no tenure system, instructors","144","46","98","1","1","0","3","1","2","11","4","7","2","0","2","0","0","0","127","40","87","0","0","0","0","0","0","0","0","0","-2"
"176080","Mississippi State University","2018","Not on tenure/no tenure system, lecturers","66","26","40","0","0","0","1","0","1","3","0","3","4","2","2","0","0","0","52","20","32","1","1","0","0","0","0","5","3","2","-2"
"178396","University of Missouri-Columbia","2018","Tenured total","725","504","221","2","2","0","120","96","24","14","11","3","30","16","14","1","1","0","543","367","176","5","5","0","8","4","4","2","2","0","-2"
"178396","University of Missouri-Columbia","2018","Tenured, professors","396","295","101","0","0","0","78","70","8","7","5","2","11","7","4","0","0","0","290","205","85","5","5","0","5","3","2","0","0","0","-2"
"178396","University of Missouri-Columbia","2018","Tenured, associate professors","329","209","120","2","2","0","42","26","16","7","6","1","19","9","10","1","1","0","253","162","91","0","0","0","3","1","2","2","2","0","-2"
"178396","University of Missouri-Columbia","2018","On-Tenure track total","248","133","115","1","0","1","28","18","10","27","15","12","15","6","9","0","0","0","129","65","64","2","0","2","7","6","1","39","23","16","-2"
"178396","University of Missouri-Columbia","2018","On-tenure track, professors","1","0","1","0","0","0","0","0","0","0","0","0","0","0","0","0","0","0","0","0","0","0","0","0","1","0","1","0","0","0","-2"
"178396","University of Missouri-Columbia","2018","On-tenure track, associate professors","9","5","4","0","0","0","0","0","0","0","0","0","2","1","1","0","0","0","7","4","3","0","0","0","0","0","0","0","0","0","-2"
"178396","University of Missouri-Columbia","2018","On-tenure track, assistant professors","238","128","110","1","0","1","28","18","10","27","15","12","13","5","8","0","0","0","122","61","61","2","0","2","6","6","0","39","23","16","-2"
"178396","University of Missouri-Columbia","2018","Not on tenure track/No tenure system system total","901","455","446","2","0","2","92","60","32","31","13","18","33","16","17","2","0","2","617","288","329","9","7","2","28","13","15","87","58","29","-2"
"178396","University of Missouri-Columbia","2018","Not on tenure/no tenure system, professors","68","35","33","0","0","0","5","4","1","1","1","0","3","1","2","0","0","0","58","29","29","1","0","1","0","0","0","0","0","0","-2"
"178396","University of Missouri-Columbia","2018","Not on tenure/no tenure system, associate professors","213","108","105","1","0","1","25","14","11","6","4","2","5","1","4","1","0","1","170","85","85","2","2","0","2","1","1","1","1","0","-2"
"178396","University of Missouri-Columbia","2018","Not on tenure/no tenure system, assistant professors","429","222","207","0","0","0","46","32","14","17","6","11","14","6","8","0","0","0","283","134","149","5","4","1","14","7","7","50","33","17","-2"
"178396","University of Missouri-Columbia","2018","Not on tenure/no tenure system, instructors","88","32","56","1","0","1","7","4","3","2","0","2","4","2","2","1","0","1","64","20","44","0","0","0","5","3","2","4","3","1","-2"
"178396","University of Missouri-Columbia","2018","Not on tenure/no tenure system, lecturers","9","3","6","0","0","0","0","0","0","0","0","0","1","1","0","0","0","0","7","2","5","0","0","0","1","0","1","0","0","0","-2"
"178396","University of Missouri-Columbia","2018","Not on tenure/no tenure system, no academic rank","94","55","39","0","0","0","9","6","3","5","2","3","6","5","1","0","0","0","35","18","17","1","1","0","6","2","4","32","21","11","-2"
"178411","Missouri University of Science and Technology","2018","Tenured total","223","175","48","0","0","0","52","43","9","7","5","2","4","4","0","0","0","0","149","115","34","2","2","0","0","0","0","9","6","3","-2"
"178411","Missouri University of Science and Technology","2018","Tenured, professors","129","108","21","0","0","0","29","26","3","4","3","1","1","1","0","0","0","0","92","75","17","0","0","0","0","0","0","3","3","0","-2"
"178411","Missouri University of Science and Technology","2018","Tenured, associate professors","94","67","27","0","0","0","23","17","6","3","2","1","3","3","0","0","0","0","57","40","17","2","2","0","0","0","0","6","3","3","-2"
"178411","Missouri University of Science and Technology","2018","On-Tenure track total","85","65","20","0","0","0","14","10","4","1","1","0","0","0","0","0","0","0","36","25","11","0","0","0","4","2","2","30","27","3","-2"
"178411","Missouri University of Science and Technology","2018","On-tenure track, associate professors","1","1","0","0","0","0","0","0","0","0","0","0","0","0","0","0","0","0","1","1","0","0","0","0","0","0","0","0","0","0","-2"
"178411","Missouri University of Science and Technology","2018","On-tenure track, assistant professors","84","64","20","0","0","0","14","10","4","1","1","0","0","0","0","0","0","0","35","24","11","0","0","0","4","2","2","30","27","3","-2"
"178411","Missouri University of Science and Technology","2018","Not on tenure track/No tenure system system total","74","42","32","2","0","2","4","2","2","1","0","1","2","2","0","0","0","0","54","28","26","0","0","0","1","1","0","10","9","1","-2"
"178411","Missouri University of Science and Technology","2018","Not on tenure/no tenure system, professors","7","4","3","0","0","0","0","0","0","0","0","0","0","0","0","0","0","0","7","4","3","0","0","0","0","0","0","0","0","0","-2"
"178411","Missouri University of Science and Technology","2018","Not on tenure/no tenure system, associate professors","22","13","9","0","0","0","3","2","1","0","0","0","0","0","0","0","0","0","18","10","8","0","0","0","0","0","0","1","1","0","-2"
"178411","Missouri University of Science and Technology","2018","Not on tenure/no tenure system, assistant professors","29","13","16","1","0","1","1","0","1","1","0","1","1","1","0","0","0","0","20","8","12","0","0","0","1","1","0","4","3","1","-2"
"178411","Missouri University of Science and Technology","2018","Not on tenure/no tenure system, lecturers","10","6","4","1","0","1","0","0","0","0","0","0","0","0","0","0","0","0","9","6","3","0","0","0","0","0","0","0","0","0","-2"
"178411","Missouri University of Science and Technology","2018","Not on tenure/no tenure system, no academic rank","6","6","0","0","0","0","0","0","0","0","0","0","1","1","0","0","0","0","0","0","0","0","0","0","0","0","0","5","5","0","-2"
"179159","Saint Louis University","2018","Tenured total","498","324","174","3","1","2","54","39","15","21","11","10","21","10","11","0","0","0","383","250","133","0","0","0","3","3","0","13","10","3","-2"
"179159","Saint Louis University","2018","Tenured, professors","268","196","72","2","1","1","28","22","6","7","4","3","9","6","3","0","0","0","217","158","59","0","0","0","2","2","0","3","3","0","-2"
"179159","Saint Louis University","2018","Tenured, associate professors","229","128","101","1","0","1","26","17","9","14","7","7","12","4","8","0","0","0","165","92","73","0","0","0","1","1","0","10","7","3","-2"
"179159","Saint Louis University","2018","Tenured, assistant professors","1","0","1","0","0","0","0","0","0","0","0","0","0","0","0","0","0","0","1","0","1","0","0","0","0","0","0","0","0","0","-2"
"179159","Saint Louis University","2018","On-Tenure track total","151","74","77","0","0","0","18","10","8","8","3","5","3","0","3","1","0","1","104","49","55","0","0","0","2","1","1","15","11","4","-2"
"179159","Saint Louis University","2018","On-tenure track, professors","1","1","0","0","0","0","0","0","0","0","0","0","0","0","0","0","0","0","1","1","0","0","0","0","0","0","0","0","0","0","-2"
"179159","Saint Louis University","2018","On-tenure track, associate professors","18","8","10","0","0","0","2","2","0","2","0","2","1","0","1","0","0","0","12","5","7","0","0","0","0","0","0","1","1","0","-2"
"179159","Saint Louis University","2018","On-tenure track, assistant professors","129","64","65","0","0","0","16","8","8","6","3","3","2","0","2","1","0","1","88","42","46","0","0","0","2","1","1","14","10","4","-2"
"179159","Saint Louis University","2018","On-tenure track, instructors","3","1","2","0","0","0","0","0","0","0","0","0","0","0","0","0","0","0","3","1","2","0","0","0","0","0","0","0","0","0","-2"
"179159","Saint Louis University","2018","Not on tenure track/No tenure system system total","658","318","340","5","2","3","102","46","56","22","9","13","16","10","6","0","0","0","464","225","239","0","0","0","11","6","5","38","20","18","-2"
"179159","Saint Louis University","2018","Not on tenure/no tenure system, professors","88","53","35","0","0","0","14","7","7","1","0","1","0","0","0","0","0","0","70","44","26","0","0","0","1","0","1","2","2","0","-2"
"179159","Saint Louis University","2018","Not on tenure/no tenure system, associate professors","155","79","76","1","0","1","26","11","15","5","3","2","4","2","2","0","0","0","112","58","54","0","0","0","3","2","1","4","3","1","-2"
"179159","Saint Louis University","2018","Not on tenure/no tenure system, assistant professors","348","156","192","3","1","2","52","23","29","13","5","8","10","7","3","0","0","0","236","106","130","0","0","0","6","3","3","28","11","17","-2"
"179159","Saint Louis University","2018","Not on tenure/no tenure system, instructors","67","30","37","1","1","0","10","5","5","3","1","2","2","1","1","0","0","0","46","17","29","0","0","0","1","1","0","4","4","0","-2"
"179867","Washington University in St Louis","2018","Tenured total","964","728","236","1","1","0","124","96","28","37","18","19","24","19","5","0","0","0","773","589","184","5","5","0","0","0","0","0","0","0","-2"
"179867","Washington University in St Louis","2018","Tenured, professors","679","539","140","0","0","0","75","60","15","16","7","9","13","10","3","0","0","0","571","458","113","4","4","0","0","0","0","0","0","0","-2"
"179867","Washington University in St Louis","2018","Tenured, associate professors","285","189","96","1","1","0","49","36","13","21","11","10","11","9","2","0","0","0","202","131","71","1","1","0","0","0","0","0","0","0","-2"
"179867","Washington University in St Louis","2018","On-Tenure track total","366","220","146","0","0","0","95","63","32","18","7","11","18","11","7","1","0","1","229","137","92","5","2","3","0","0","0","0","0","0","-2"
"179867","Washington University in St Louis","2018","On-tenure track, professors","4","3","1","0","0","0","2","2","0","0","0","0","0","0","0","0","0","0","2","1","1","0","0","0","0","0","0","0","0","0","-2"
"179867","Washington University in St Louis","2018","On-tenure track, associate professors","18","13","5","0","0","0","3","3","0","1","1","0","1","0","1","0","0","0","13","9","4","0","0","0","0","0","0","0","0","0","-2"
"179867","Washington University in St Louis","2018","On-tenure track, assistant professors","344","204","140","0","0","0","90","58","32","17","6","11","17","11","6","1","0","1","214","127","87","5","2","3","0","0","0","0","0","0","-2"
"179867","Washington University in St Louis","2018","Not on tenure track/No tenure system system total","314","155","159","0","0","0","41","15","26","7","3","4","12","3","9","0","0","0","244","128","116","5","2","3","0","0","0","5","4","1","-2"
"179867","Washington University in St Louis","2018","Not on tenure/no tenure system, professors","1","1","0","0","0","0","0","0","0","0","0","0","0","0","0","0","0","0","1","1","0","0","0","0","0","0","0","0","0","0","-2"
"179867","Washington University in St Louis","2018","Not on tenure/no tenure system, associate professors","3","3","0","0","0","0","0","0","0","0","0","0","0","0","0","0","0","0","3","3","0","0","0","0","0","0","0","0","0","0","-2"
"179867","Washington University in St Louis","2018","Not on tenure/no tenure system, assistant professors","1","1","0","0","0","0","1","1","0","0","0","0","0","0","0","0","0","0","0","0","0","0","0","0","0","0","0","0","0","0","-2"
"179867","Washington University in St Louis","2018","Not on tenure/no tenure system, instructors","105","57","48","0","0","0","17","9","8","4","2","2","2","0","2","0","0","0","76","42","34","2","1","1","0","0","0","4","3","1","-2"
"179867","Washington University in St Louis","2018","Not on tenure/no tenure system, lecturers","199","91","108","0","0","0","23","5","18","3","1","2","10","3","7","0","0","0","159","80","79","3","1","2","0","0","0","1","1","0","-2"
"179867","Washington University in St Louis","2018","Not on tenure/no tenure system, no academic rank","5","2","3","0","0","0","0","0","0","0","0","0","0","0","0","0","0","0","5","2","3","0","0","0","0","0","0","0","0","0","-2"
"180461","Montana State University","2018","Tenured total","339","228","111","1","1","0","13","7","6","0","0","0","4","3","1","0","0","0","307","206","101","2","2","0","12","9","3","0","0","0","-2"
"180461","Montana State University","2018","Tenured, professors","184","143","41","1","1","0","3","3","0","0","0","0","0","0","0","0","0","0","171","132","39","2","2","0","7","5","2","0","0","0","-2"
"180461","Montana State University","2018","Tenured, associate professors","149","82","67","0","0","0","10","4","6","0","0","0","4","3","1","0","0","0","131","72","59","0","0","0","4","3","1","0","0","0","-2"
"180461","Montana State University","2018","Tenured, assistant professors","2","1","1","0","0","0","0","0","0","0","0","0","0","0","0","0","0","0","1","0","1","0","0","0","1","1","0","0","0","0","-2"
"180461","Montana State University","2018","Tenured, instructors","4","2","2","0","0","0","0","0","0","0","0","0","0","0","0","0","0","0","4","2","2","0","0","0","0","0","0","0","0","0","-2"
"180461","Montana State University","2018","On-Tenure track total","167","74","93","2","1","1","7","1","6","1","1","0","2","1","1","0","0","0","133","62","71","2","1","1","4","2","2","16","5","11","-2"
"180461","Montana State University","2018","On-tenure track, professors","7","5","2","0","0","0","0","0","0","0","0","0","0","0","0","0","0","0","7","5","2","0","0","0","0","0","0","0","0","0","-2"
"180461","Montana State University","2018","On-tenure track, assistant professors","148","63","85","2","1","1","7","1","6","1","1","0","2","1","1","0","0","0","114","51","63","2","1","1","4","2","2","16","5","11","-2"
"180461","Montana State University","2018","On-tenure track, instructors","12","6","6","0","0","0","0","0","0","0","0","0","0","0","0","0","0","0","12","6","6","0","0","0","0","0","0","0","0","0","-2"
"180461","Montana State University","2018","Not on tenure track/No tenure system system total","83","34","49","0","0","0","0","0","0","0","0","0","1","1","0","0","0","0","78","31","47","1","1","0","1","0","1","2","1","1","-2"
"180461","Montana State University","2018","Not on tenure/no tenure system, professors","1","1","0","0","0","0","0","0","0","0","0","0","0","0","0","0","0","0","1","1","0","0","0","0","0","0","0","0","0","0","-2"
"180461","Montana State University","2018","Not on tenure/no tenure system, instructors","16","6","10","0","0","0","0","0","0","0","0","0","0","0","0","0","0","0","16","6","10","0","0","0","0","0","0","0","0","0","-2"
"180461","Montana State University","2018","Not on tenure/no tenure system, no academic rank","66","27","39","0","0","0","0","0","0","0","0","0","1","1","0","0","0","0","61","24","37","1","1","0","1","0","1","2","1","1","-2"
"181002","Creighton University","2018","Tenured total","342","221","121","1","0","1","27","23","4","8","3","5","12","5","7","0","0","0","288","186","102","2","1","1","2","1","1","2","2","0","-2"
"181002","Creighton University","2018","Tenured, professors","173","122","51","0","0","0","20","18","2","4","0","4","4","1","3","0","0","0","142","102","40","2","1","1","1","0","1","0","0","0","-2"
"181002","Creighton University","2018","Tenured, associate professors","144","84","60","1","0","1","7","5","2","3","2","1","7","3","4","0","0","0","123","71","52","0","0","0","1","1","0","2","2","0","-2"
"181002","Creighton University","2018","Tenured, assistant professors","25","15","10","0","0","0","0","0","0","1","1","0","1","1","0","0","0","0","23","13","10","0","0","0","0","0","0","0","0","0","-2"
"181002","Creighton University","2018","On-Tenure track total","132","65","67","1","1","0","4","3","1","7","3","4","1","1","0","0","0","0","107","51","56","1","1","0","7","2","5","4","3","1","-2"
"181002","Creighton University","2018","On-tenure track, professors","2","1","1","0","0","0","1","1","0","0","0","0","0","0","0","0","0","0","1","0","1","0","0","0","0","0","0","0","0","0","-2"
"181002","Creighton University","2018","On-tenure track, associate professors","10","5","5","1","1","0","0","0","0","1","0","1","0","0","0","0","0","0","7","3","4","0","0","0","1","1","0","0","0","0","-2"
"181002","Creighton University","2018","On-tenure track, assistant professors","120","59","61","0","0","0","3","2","1","6","3","3","1","1","0","0","0","0","99","48","51","1","1","0","6","1","5","4","3","1","-2"
"181002","Creighton University","2018","Not on tenure track/No tenure system system total","192","77","115","2","2","0","11","5","6","5","3","2","4","1","3","0","0","0","165","63","102","2","1","1","0","0","0","3","2","1","-2"
"181002","Creighton University","2018","Not on tenure/no tenure system, professors","2","2","0","0","0","0","0","0","0","0","0","0","0","0","0","0","0","0","2","2","0","0","0","0","0","0","0","0","0","0","-2"
"181002","Creighton University","2018","Not on tenure/no tenure system, associate professors","33","13","20","0","0","0","1","0","1","0","0","0","2","1","1","0","0","0","30","12","18","0","0","0","0","0","0","0","0","0","-2"
"181002","Creighton University","2018","Not on tenure/no tenure system, assistant professors","115","47","68","0","0","0","8","5","3","4","3","1","2","0","2","0","0","0","97","37","60","2","1","1","0","0","0","2","1","1","-2"
"181002","Creighton University","2018","Not on tenure/no tenure system, instructors","42","15","27","2","2","0","2","0","2","1","0","1","0","0","0","0","0","0","36","12","24","0","0","0","0","0","0","1","1","0","-2"
"181464","University of Nebraska-Lincoln","2018","Tenured total","734","534","200","4","2","2","98","74","24","16","7","9","32","25","7","0","0","0","578","423","155","4","1","3","0","0","0","2","2","0","-2"
"181464","University of Nebraska-Lincoln","2018","Tenured, professors","434","341","93","2","1","1","47","39","8","6","4","2","15","13","2","0","0","0","364","284","80","0","0","0","0","0","0","0","0","0","-2"
"181464","University of Nebraska-Lincoln","2018","Tenured, associate professors","300","193","107","2","1","1","51","35","16","10","3","7","17","12","5","0","0","0","214","139","75","4","1","3","0","0","0","2","2","0","-2"
"181464","University of Nebraska-Lincoln","2018","On-Tenure track total","315","184","131","0","0","0","55","33","22","7","5","2","15","7","8","0","0","0","189","106","83","1","0","1","1","1","0","47","32","15","-2"
"181464","University of Nebraska-Lincoln","2018","On-tenure track, professors","1","1","0","0","0","0","1","1","0","0","0","0","0","0","0","0","0","0","0","0","0","0","0","0","0","0","0","0","0","0","-2"
"181464","University of Nebraska-Lincoln","2018","On-tenure track, associate professors","30","19","11","0","0","0","9","5","4","1","1","0","1","1","0","0","0","0","18","11","7","0","0","0","0","0","0","1","1","0","-2"
"181464","University of Nebraska-Lincoln","2018","On-tenure track, assistant professors","284","164","120","0","0","0","45","27","18","6","4","2","14","6","8","0","0","0","171","95","76","1","0","1","1","1","0","46","31","15","-2"
"181464","University of Nebraska-Lincoln","2018","Not on tenure track/No tenure system system total","252","107","145","1","0","1","19","9","10","3","1","2","8","5","3","0","0","0","210","89","121","0","0","0","0","0","0","11","3","8","-2"
"181464","University of Nebraska-Lincoln","2018","Not on tenure/no tenure system, professors","4","2","2","0","0","0","0","0","0","0","0","0","0","0","0","0","0","0","4","2","2","0","0","0","0","0","0","0","0","0","-2"
"181464","University of Nebraska-Lincoln","2018","Not on tenure/no tenure system, associate professors","1","0","1","0","0","0","0","0","0","0","0","0","0","0","0","0","0","0","1","0","1","0","0","0","0","0","0","0","0","0","-2"
"181464","University of Nebraska-Lincoln","2018","Not on tenure/no tenure system, assistant professors","2","2","0","0","0","0","0","0","0","0","0","0","0","0","0","0","0","0","1","1","0","0","0","0","0","0","0","1","1","0","-2"
"181464","University of Nebraska-Lincoln","2018","Not on tenure/no tenure system, lecturers","245","103","142","1","0","1","19","9","10","3","1","2","8","5","3","0","0","0","204","86","118","0","0","0","0","0","0","10","2","8","-2"
"182281","University of Nevada-Las Vegas","2018","Tenured total","507","350","157","2","2","0","95","76","19","19","12","7","26","14","12","1","0","1","360","245","115","4","1","3","0","0","0","0","0","0","-2"
"182281","University of Nevada-Las Vegas","2018","Tenured, professors","297","223","74","2","2","0","52","44","8","12","7","5","13","9","4","0","0","0","217","161","56","1","0","1","0","0","0","0","0","0","-2"
"182281","University of Nevada-Las Vegas","2018","Tenured, associate professors","197","120","77","0","0","0","42","31","11","7","5","2","12","5","7","1","0","1","132","78","54","3","1","2","0","0","0","0","0","0","-2"
"182281","University of Nevada-Las Vegas","2018","Tenured, assistant professors","4","3","1","0","0","0","1","1","0","0","0","0","0","0","0","0","0","0","3","2","1","0","0","0","0","0","0","0","0","0","-2"
"182281","University of Nevada-Las Vegas","2018","Tenured, no academic rank","9","4","5","0","0","0","0","0","0","0","0","0","1","0","1","0","0","0","8","4","4","0","0","0","0","0","0","0","0","0","-2"
"182281","University of Nevada-Las Vegas","2018","On-Tenure track total","199","102","97","1","1","0","55","30","25","9","4","5","14","7","7","1","1","0","110","56","54","5","1","4","1","1","0","3","1","2","-2"
"182281","University of Nevada-Las Vegas","2018","On-tenure track, associate professors","18","7","11","0","0","0","4","1","3","0","0","0","0","0","0","1","1","0","12","5","7","1","0","1","0","0","0","0","0","0","-2"
"182281","University of Nevada-Las Vegas","2018","On-tenure track, assistant professors","176","91","85","1","1","0","50","28","22","9","4","5","14","7","7","0","0","0","94","48","46","4","1","3","1","1","0","3","1","2","-2"
"182281","University of Nevada-Las Vegas","2018","On-tenure track, no academic rank","5","4","1","0","0","0","1","1","0","0","0","0","0","0","0","0","0","0","4","3","1","0","0","0","0","0","0","0","0","0","-2"
"182281","University of Nevada-Las Vegas","2018","Not on tenure track/No tenure system system total","413","217","196","2","2","0","54","31","23","24","8","16","26","14","12","1","1","0","284","152","132","10","5","5","8","2","6","4","2","2","-2"
"182281","University of Nevada-Las Vegas","2018","Not on tenure/no tenure system, instructors","1","1","0","0","0","0","0","0","0","0","0","0","0","0","0","0","0","0","1","1","0","0","0","0","0","0","0","0","0","0","-2"
"182281","University of Nevada-Las Vegas","2018","Not on tenure/no tenure system, lecturers","78","34","44","1","1","0","5","2","3","2","0","2","8","2","6","0","0","0","60","28","32","2","1","1","0","0","0","0","0","0","-2"
"182281","University of Nevada-Las Vegas","2018","Not on tenure/no tenure system, no academic rank","334","182","152","1","1","0","49","29","20","22","8","14","18","12","6","1","1","0","223","123","100","8","4","4","8","2","6","4","2","2","-2"
"182290","University of Nevada-Reno","2018","Tenured total","366","241","125","1","1","0","48","34","14","4","4","0","16","12","4","0","0","0","293","188","105","3","2","1","0","0","0","1","0","1","-2"
"182290","University of Nevada-Reno","2018","Tenured, professors","194","142","52","1","1","0","23","20","3","1","1","0","3","3","0","0","0","0","163","115","48","3","2","1","0","0","0","0","0","0","-2"
"182290","University of Nevada-Reno","2018","Tenured, associate professors","171","99","72","0","0","0","25","14","11","3","3","0","13","9","4","0","0","0","129","73","56","0","0","0","0","0","0","1","0","1","-2"
"182290","University of Nevada-Reno","2018","Tenured, assistant professors","1","0","1","0","0","0","0","0","0","0","0","0","0","0","0","0","0","0","1","0","1","0","0","0","0","0","0","0","0","0","-2"
"182290","University of Nevada-Reno","2018","On-Tenure track total","287","174","113","2","1","1","36","24","12","4","4","0","26","12","14","2","2","0","164","97","67","4","3","1","0","0","0","49","31","18","-2"
"182290","University of Nevada-Reno","2018","On-tenure track, associate professors","11","7","4","0","0","0","1","0","1","0","0","0","1","0","1","0","0","0","8","7","1","0","0","0","0","0","0","1","0","1","-2"
"182290","University of Nevada-Reno","2018","On-tenure track, assistant professors","276","167","109","2","1","1","35","24","11","4","4","0","25","12","13","2","2","0","156","90","66","4","3","1","0","0","0","48","31","17","-2"
"182290","University of Nevada-Reno","2018","Not on tenure track/No tenure system system total","251","106","145","2","0","2","21","10","11","9","3","6","7","3","4","0","0","0","198","84","114","6","2","4","0","0","0","8","4","4","-2"
"182290","University of Nevada-Reno","2018","Not on tenure/no tenure system, instructors","3","1","2","0","0","0","0","0","0","0","0","0","0","0","0","0","0","0","3","1","2","0","0","0","0","0","0","0","0","0","-2"
"182290","University of Nevada-Reno","2018","Not on tenure/no tenure system, lecturers","156","61","95","2","0","2","11","4","7","3","0","3","5","2","3","0","0","0","124","51","73","4","1","3","0","0","0","7","3","4","-2"
"182290","University of Nevada-Reno","2018","Not on tenure/no tenure system, no academic rank","92","44","48","0","0","0","10","6","4","6","3","3","2","1","1","0","0","0","71","32","39","2","1","1","0","0","0","1","1","0","-2"
"182670","Dartmouth College","2018","Tenured total","433","297","136","3","2","1","31","22","9","13","5","8","20","11","9","0","0","0","354","249","105","10","6","4","0","0","0","2","2","0","-2"
"182670","Dartmouth College","2018","Tenured, professors","288","213","75","1","1","0","21","16","5","2","2","0","10","5","5","0","0","0","248","185","63","6","4","2","0","0","0","0","0","0","-2"
"182670","Dartmouth College","2018","Tenured, associate professors","143","83","60","2","1","1","10","6","4","11","3","8","10","6","4","0","0","0","105","64","41","4","2","2","0","0","0","1","1","0","-2"
"182670","Dartmouth College","2018","Tenured, assistant professors","2","1","1","0","0","0","0","0","0","0","0","0","0","0","0","0","0","0","1","0","1","0","0","0","0","0","0","1","1","0","-2"
"182670","Dartmouth College","2018","On-Tenure track total","164","100","64","1","1","0","20","12","8","3","2","1","8","3","5","1","0","1","115","72","43","4","1","3","0","0","0","12","9","3","-2"
"182670","Dartmouth College","2018","On-tenure track, professors","4","4","0","0","0","0","0","0","0","0","0","0","0","0","0","0","0","0","4","4","0","0","0","0","0","0","0","0","0","0","-2"
"182670","Dartmouth College","2018","On-tenure track, associate professors","37","20","17","0","0","0","5","2","3","0","0","0","5","2","3","1","0","1","24","15","9","1","0","1","0","0","0","1","1","0","-2"
"182670","Dartmouth College","2018","On-tenure track, assistant professors","123","76","47","1","1","0","15","10","5","3","2","1","3","1","2","0","0","0","87","53","34","3","1","2","0","0","0","11","8","3","-2"
"182670","Dartmouth College","2018","Not on tenure track/No tenure system system total","114","59","55","3","1","2","4","2","2","3","1","2","9","2","7","0","0","0","85","47","38","0","0","0","0","0","0","10","6","4","-2"
"182670","Dartmouth College","2018","Not on tenure/no tenure system, professors","25","18","7","0","0","0","1","1","0","1","0","1","2","1","1","0","0","0","19","14","5","0","0","0","0","0","0","2","2","0","-2"
"182670","Dartmouth College","2018","Not on tenure/no tenure system, associate professors","6","3","3","1","1","0","0","0","0","1","1","0","0","0","0","0","0","0","4","1","3","0","0","0","0","0","0","0","0","0","-2"
"182670","Dartmouth College","2018","Not on tenure/no tenure system, assistant professors","7","6","1","0","0","0","0","0","0","0","0","0","0","0","0","0","0","0","7","6","1","0","0","0","0","0","0","0","0","0","-2"
"182670","Dartmouth College","2018","Not on tenure/no tenure system, instructors","12","4","8","1","0","1","0","0","0","1","0","1","1","0","1","0","0","0","9","4","5","0","0","0","0","0","0","0","0","0","-2"
"182670","Dartmouth College","2018","Not on tenure/no tenure system, lecturers","59","25","34","1","0","1","3","1","2","0","0","0","6","1","5","0","0","0","44","21","23","0","0","0","0","0","0","5","2","3","-2"
"182670","Dartmouth College","2018","Not on tenure/no tenure system, no academic rank","5","3","2","0","0","0","0","0","0","0","0","0","0","0","0","0","0","0","2","1","1","0","0","0","0","0","0","3","2","1","-2"
"183044","University of New Hampshire-Main Campus","2018","Tenured total","373","224","149","0","0","0","31","14","17","5","5","0","10","7","3","0","0","0","301","183","118","3","2","1","23","13","10","0","0","0","-2"
"183044","University of New Hampshire-Main Campus","2018","Tenured, professors","184","127","57","0","0","0","10","7","3","0","0","0","3","2","1","0","0","0","159","110","49","2","1","1","10","7","3","0","0","0","-2"
"183044","University of New Hampshire-Main Campus","2018","Tenured, associate professors","189","97","92","0","0","0","21","7","14","5","5","0","7","5","2","0","0","0","142","73","69","1","1","0","13","6","7","0","0","0","-2"
"183044","University of New Hampshire-Main Campus","2018","On-Tenure track total","160","74","86","2","2","0","31","15","16","5","0","5","5","4","1","1","1","0","94","42","52","3","1","2","14","8","6","5","1","4","-2"
"183044","University of New Hampshire-Main Campus","2018","On-tenure track, professors","3","2","1","0","0","0","0","0","0","0","0","0","0","0","0","0","0","0","3","2","1","0","0","0","0","0","0","0","0","0","-2"
"183044","University of New Hampshire-Main Campus","2018","On-tenure track, associate professors","13","8","5","0","0","0","2","1","1","0","0","0","0","0","0","0","0","0","10","6","4","0","0","0","1","1","0","0","0","0","-2"
"183044","University of New Hampshire-Main Campus","2018","On-tenure track, assistant professors","144","64","80","2","2","0","29","14","15","5","0","5","5","4","1","1","1","0","81","34","47","3","1","2","13","7","6","5","1","4","-2"
"183044","University of New Hampshire-Main Campus","2018","Not on tenure track/No tenure system system total","97","35","62","1","1","0","2","2","0","0","0","0","1","1","0","0","0","0","85","28","57","0","0","0","8","3","5","0","0","0","-2"
"183044","University of New Hampshire-Main Campus","2018","Not on tenure/no tenure system, professors","2","1","1","0","0","0","0","0","0","0","0","0","0","0","0","0","0","0","2","1","1","0","0","0","0","0","0","0","0","0","-2"
"183044","University of New Hampshire-Main Campus","2018","Not on tenure/no tenure system, associate professors","19","3","16","0","0","0","0","0","0","0","0","0","0","0","0","0","0","0","17","3","14","0","0","0","2","0","2","0","0","0","-2"
"183044","University of New Hampshire-Main Campus","2018","Not on tenure/no tenure system, assistant professors","39","11","28","0","0","0","1","1","0","0","0","0","1","1","0","0","0","0","34","8","26","0","0","0","3","1","2","0","0","0","-2"
"183044","University of New Hampshire-Main Campus","2018","Not on tenure/no tenure system, lecturers","37","20","17","1","1","0","1","1","0","0","0","0","0","0","0","0","0","0","32","16","16","0","0","0","3","2","1","0","0","0","-2"
"183080","Plymouth State University","2018","Tenured total","113","59","54","0","0","0","8","8","0","1","1","0","3","0","3","0","0","0","96","48","48","0","0","0","5","2","3","0","0","0","-2"
"183080","Plymouth State University","2018","Tenured, professors","71","38","33","0","0","0","3","3","0","1","1","0","2","0","2","0","0","0","60","32","28","0","0","0","5","2","3","0","0","0","-2"
"183080","Plymouth State University","2018","Tenured, associate professors","40","21","19","0","0","0","5","5","0","0","0","0","1","0","1","0","0","0","34","16","18","0","0","0","0","0","0","0","0","0","-2"
"183080","Plymouth State University","2018","Tenured, no academic rank","2","0","2","0","0","0","0","0","0","0","0","0","0","0","0","0","0","0","2","0","2","0","0","0","0","0","0","0","0","0","-2"
"183080","Plymouth State University","2018","On-Tenure track total","45","20","25","0","0","0","6","5","1","0","0","0","0","0","0","0","0","0","35","13","22","0","0","0","4","2","2","0","0","0","-2"
"183080","Plymouth State University","2018","On-tenure track, associate professors","9","4","5","0","0","0","1","1","0","0","0","0","0","0","0","0","0","0","7","2","5","0","0","0","1","1","0","0","0","0","-2"
"183080","Plymouth State University","2018","On-tenure track, assistant professors","33","15","18","0","0","0","5","4","1","0","0","0","0","0","0","0","0","0","25","10","15","0","0","0","3","1","2","0","0","0","-2"
"183080","Plymouth State University","2018","On-tenure track, instructors","3","1","2","0","0","0","0","0","0","0","0","0","0","0","0","0","0","0","3","1","2","0","0","0","0","0","0","0","0","0","-2"
"183080","Plymouth State University","2018","Not on tenure track/No tenure system system total","41","16","25","0","0","0","3","0","3","0","0","0","2","2","0","0","0","0","34","13","21","0","0","0","2","1","1","0","0","0","-2"
"183080","Plymouth State University","2018","Not on tenure/no tenure system, associate professors","3","0","3","0","0","0","0","0","0","0","0","0","0","0","0","0","0","0","3","0","3","0","0","0","0","0","0","0","0","0","-2"
"183080","Plymouth State University","2018","Not on tenure/no tenure system, assistant professors","6","0","6","0","0","0","0","0","0","0","0","0","0","0","0","0","0","0","5","0","5","0","0","0","1","0","1","0","0","0","-2"
"183080","Plymouth State University","2018","Not on tenure/no tenure system, lecturers","32","16","16","0","0","0","3","0","3","0","0","0","2","2","0","0","0","0","26","13","13","0","0","0","1","1","0","0","0","0","-2"
"185262","Kean University","2018","Tenured total","185","86","99","0","0","0","30","11","19","19","9","10","12","6","6","0","0","0","124","60","64","0","0","0","0","0","0","0","0","0","-2"
"185262","Kean University","2018","Tenured, professors","59","29","30","0","0","0","5","4","1","7","4","3","4","1","3","0","0","0","43","20","23","0","0","0","0","0","0","0","0","0","-2"
"185262","Kean University","2018","Tenured, associate professors","68","32","36","0","0","0","14","4","10","6","2","4","4","4","0","0","0","0","44","22","22","0","0","0","0","0","0","0","0","0","-2"
"185262","Kean University","2018","Tenured, assistant professors","58","25","33","0","0","0","11","3","8","6","3","3","4","1","3","0","0","0","37","18","19","0","0","0","0","0","0","0","0","0","-2"
"185262","Kean University","2018","On-Tenure track total","37","19","18","0","0","0","8","6","2","1","0","1","0","0","0","0","0","0","19","7","12","0","0","0","0","0","0","9","6","3","-2"
"185262","Kean University","2018","On-tenure track, professors","1","0","1","0","0","0","0","0","0","0","0","0","0","0","0","0","0","0","1","0","1","0","0","0","0","0","0","0","0","0","-2"
"185262","Kean University","2018","On-tenure track, associate professors","2","0","2","0","0","0","0","0","0","0","0","0","0","0","0","0","0","0","2","0","2","0","0","0","0","0","0","0","0","0","-2"
"185262","Kean University","2018","On-tenure track, assistant professors","34","19","15","0","0","0","8","6","2","1","0","1","0","0","0","0","0","0","16","7","9","0","0","0","0","0","0","9","6","3","-2"
"185262","Kean University","2018","Not on tenure track/No tenure system system total","135","54","81","1","1","0","9","2","7","19","12","7","7","2","5","0","0","0","95","34","61","2","2","0","0","0","0","2","1","1","-2"
"185262","Kean University","2018","Not on tenure/no tenure system, lecturers","133","53","80","1","1","0","9","2","7","18","11","7","7","2","5","0","0","0","94","34","60","2","2","0","0","0","0","2","1","1","-2"
"185262","Kean University","2018","Not on tenure/no tenure system, no academic rank","2","1","1","0","0","0","0","0","0","1","1","0","0","0","0","0","0","0","1","0","1","0","0","0","0","0","0","0","0","0","-2"
"186131","Princeton University","2018","Tenured total","598","429","169","0","0","0","57","43","14","22","14","8","16","10","6","0","0","0","482","352","130","2","1","1","10","4","6","9","5","4","-2"
"186131","Princeton University","2018","Tenured, professors","488","366","122","0","0","0","46","38","8","18","11","7","9","6","3","0","0","0","395","301","94","2","1","1","10","4","6","8","5","3","-2"
"186131","Princeton University","2018","Tenured, associate professors","110","63","47","0","0","0","11","5","6","4","3","1","7","4","3","0","0","0","87","51","36","0","0","0","0","0","0","1","0","1","-2"
"186131","Princeton University","2018","On-Tenure track total","195","118","77","0","0","0","21","8","13","9","3","6","12","7","5","0","0","0","97","66","31","3","2","1","15","7","8","38","25","13","-2"
"186131","Princeton University","2018","On-tenure track, assistant professors","195","118","77","0","0","0","21","8","13","9","3","6","12","7","5","0","0","0","97","66","31","3","2","1","15","7","8","38","25","13","-2"
"186131","Princeton University","2018","Not on tenure track/No tenure system system total","186","90","96","0","0","0","21","8","13","4","3","1","16","5","11","0","0","0","92","45","47","1","1","0","11","6","5","41","22","19","-2"
"186131","Princeton University","2018","Not on tenure/no tenure system, instructors","18","16","2","0","0","0","0","0","0","0","0","0","0","0","0","0","0","0","3","3","0","1","1","0","0","0","0","14","12","2","-2"
"186131","Princeton University","2018","Not on tenure/no tenure system, lecturers","168","74","94","0","0","0","21","8","13","4","3","1","16","5","11","0","0","0","89","42","47","0","0","0","11","6","5","27","10","17","-2"
"186380","Rutgers University-New Brunswick","2018","Tenured total","1323","866","457","1","1","0","160","118","42","41","14","27","50","33","17","0","0","0","922","617","305","6","4","2","76","37","39","67","42","25","-2"
"186380","Rutgers University-New Brunswick","2018","Tenured, professors","906","657","249","0","0","0","114","90","24","24","12","12","25","21","4","0","0","0","693","499","194","2","2","0","27","17","10","21","16","5","-2"
"186380","Rutgers University-New Brunswick","2018","Tenured, associate professors","417","209","208","1","1","0","46","28","18","17","2","15","25","12","13","0","0","0","229","118","111","4","2","2","49","20","29","46","26","20","-2"
"186380","Rutgers University-New Brunswick","2018","On-Tenure track total","366","204","162","1","1","0","34","20","14","11","6","5","15","8","7","0","0","0","99","48","51","5","2","3","125","65","60","76","54","22","-2"
"186380","Rutgers University-New Brunswick","2018","On-tenure track, professors","36","22","14","0","0","0","0","0","0","0","0","0","0","0","0","0","0","0","19","12","7","2","1","1","14","8","6","1","1","0","-2"
"186380","Rutgers University-New Brunswick","2018","On-tenure track, associate professors","60","34","26","0","0","0","9","5","4","2","1","1","2","1","1","0","0","0","25","13","12","0","0","0","17","10","7","5","4","1","-2"
"186380","Rutgers University-New Brunswick","2018","On-tenure track, assistant professors","270","148","122","1","1","0","25","15","10","9","5","4","13","7","6","0","0","0","55","23","32","3","1","2","94","47","47","70","49","21","-2"
"186380","Rutgers University-New Brunswick","2018","Not on tenure track/No tenure system system total","1672","764","908","0","0","0","263","123","140","75","26","49","67","18","49","0","0","0","731","347","384","14","6","8","413","181","232","109","63","46","-2"
"186380","Rutgers University-New Brunswick","2018","Not on tenure/no tenure system, professors","171","114","57","0","0","0","33","22","11","5","3","2","5","3","2","0","0","0","91","60","31","0","0","0","29","21","8","8","5","3","-2"
"186380","Rutgers University-New Brunswick","2018","Not on tenure/no tenure system, associate professors","326","172","154","0","0","0","67","36","31","20","9","11","10","2","8","0","0","0","169","84","85","2","1","1","36","24","12","22","16","6","-2"
"186380","Rutgers University-New Brunswick","2018","Not on tenure/no tenure system, assistant professors","816","347","469","0","0","0","131","54","77","38","14","24","34","9","25","0","0","0","330","151","179","4","2","2","225","89","136","54","28","26","-2"
"186380","Rutgers University-New Brunswick","2018","Not on tenure/no tenure system, instructors","303","116","187","0","0","0","31","11","20","11","0","11","15","4","11","0","0","0","116","46","70","6","3","3","105","39","66","19","13","6","-2"
"186380","Rutgers University-New Brunswick","2018","Not on tenure/no tenure system, lecturers","56","15","41","0","0","0","1","0","1","1","0","1","3","0","3","0","0","0","25","6","19","2","0","2","18","8","10","6","1","5","-2"
"187967","New Mexico Institute of Mining and Technology","2018","Tenured total","68","58","10","0","0","0","12","12","0","0","0","0","3","3","0","0","0","0","52","42","10","0","0","0","0","0","0","1","1","0","-2"
"187967","New Mexico Institute of Mining and Technology","2018","Tenured, professors","38","31","7","0","0","0","5","5","0","0","0","0","2","2","0","0","0","0","30","23","7","0","0","0","0","0","0","1","1","0","-2"
"187967","New Mexico Institute of Mining and Technology","2018","Tenured, associate professors","30","27","3","0","0","0","7","7","0","0","0","0","1","1","0","0","0","0","22","19","3","0","0","0","0","0","0","0","0","0","-2"
"187967","New Mexico Institute of Mining and Technology","2018","On-Tenure track total","44","30","14","0","0","0","14","10","4","0","0","0","3","3","0","0","0","0","25","15","10","0","0","0","0","0","0","2","2","0","-2"
"187967","New Mexico Institute of Mining and Technology","2018","On-tenure track, associate professors","7","5","2","0","0","0","0","0","0","0","0","0","1","1","0","0","0","0","5","3","2","0","0","0","0","0","0","1","1","0","-2"
"187967","New Mexico Institute of Mining and Technology","2018","On-tenure track, assistant professors","37","25","12","0","0","0","14","10","4","0","0","0","2","2","0","0","0","0","20","12","8","0","0","0","0","0","0","1","1","0","-2"
"187967","New Mexico Institute of Mining and Technology","2018","Not on tenure track/No tenure system system total","18","12","6","0","0","0","3","2","1","0","0","0","2","2","0","0","0","0","13","8","5","0","0","0","0","0","0","0","0","0","-2"
"187967","New Mexico Institute of Mining and Technology","2018","Not on tenure/no tenure system, professors","1","0","1","0","0","0","0","0","0","0","0","0","0","0","0","0","0","0","1","0","1","0","0","0","0","0","0","0","0","0","-2"
"187967","New Mexico Institute of Mining and Technology","2018","Not on tenure/no tenure system, associate professors","1","1","0","0","0","0","0","0","0","0","0","0","0","0","0","0","0","0","1","1","0","0","0","0","0","0","0","0","0","0","-2"
"187967","New Mexico Institute of Mining and Technology","2018","Not on tenure/no tenure system, assistant professors","7","6","1","0","0","0","2","2","0","0","0","0","1","1","0","0","0","0","4","3","1","0","0","0","0","0","0","0","0","0","-2"
"187967","New Mexico Institute of Mining and Technology","2018","Not on tenure/no tenure system, instructors","8","4","4","0","0","0","1","0","1","0","0","0","1","1","0","0","0","0","6","3","3","0","0","0","0","0","0","0","0","0","-2"
"187967","New Mexico Institute of Mining and Technology","2018","Not on tenure/no tenure system, lecturers","1","1","0","0","0","0","0","0","0","0","0","0","0","0","0","0","0","0","1","1","0","0","0","0","0","0","0","0","0","0","-2"
"190150","Columbia University in the City of New York","2018","Tenured total","1146","825","321","2","1","1","166","119","47","43","25","18","28","20","8","0","0","0","862","623","239","5","3","2","27","21","6","13","13","0","-2"
"190150","Columbia University in the City of New York","2018","Tenured, professors","958","711","247","2","1","1","122","92","30","32","19","13","22","17","5","0","0","0","739","547","192","4","3","1","25","20","5","12","12","0","-2"
"190150","Columbia University in the City of New York","2018","Tenured, associate professors","188","114","74","0","0","0","44","27","17","11","6","5","6","3","3","0","0","0","123","76","47","1","0","1","2","1","1","1","1","0","-2"
"190150","Columbia University in the City of New York","2018","On-Tenure track total","562","355","207","0","0","0","101","65","36","23","10","13","27","13","14","0","0","0","278","177","101","8","3","5","21","14","7","104","73","31","-2"
"190150","Columbia University in the City of New York","2018","On-tenure track, professors","44","36","8","0","0","0","10","8","2","0","0","0","1","0","1","0","0","0","21","17","4","1","1","0","1","1","0","10","9","1","-2"
"190150","Columbia University in the City of New York","2018","On-tenure track, associate professors","105","77","28","0","0","0","15","12","3","6","4","2","3","2","1","0","0","0","70","53","17","2","2","0","4","3","1","5","1","4","-2"
"190150","Columbia University in the City of New York","2018","On-tenure track, assistant professors","399","235","164","0","0","0","72","42","30","15","6","9","21","10","11","0","0","0","183","105","78","5","0","5","16","10","6","87","62","25","-2"
"190150","Columbia University in the City of New York","2018","On-tenure track, instructors","2","2","0","0","0","0","1","1","0","0","0","0","0","0","0","0","0","0","0","0","0","0","0","0","0","0","0","1","1","0","-2"
"190150","Columbia University in the City of New York","2018","On-tenure track, lecturers","12","5","7","0","0","0","3","2","1","2","0","2","2","1","1","0","0","0","4","2","2","0","0","0","0","0","0","1","0","1","-2"
"190150","Columbia University in the City of New York","2018","Not on tenure track/No tenure system system total","2425","1145","1280","1","0","1","426","192","234","104","48","56","131","53","78","1","1","0","1565","765","800","20","6","14","76","36","40","101","44","57","-2"
"190150","Columbia University in the City of New York","2018","Not on tenure/no tenure system, professors","395","253","142","0","0","0","34","21","13","18","10","8","18","12","6","0","0","0","309","204","105","3","1","2","9","4","5","4","1","3","-2"
"190150","Columbia University in the City of New York","2018","Not on tenure/no tenure system, associate professors","386","212","174","0","0","0","75","45","30","11","8","3","15","4","11","0","0","0","267","143","124","0","0","0","10","7","3","8","5","3","-2"
"190150","Columbia University in the City of New York","2018","Not on tenure/no tenure system, assistant professors","1106","455","651","0","0","0","239","90","149","54","20","34","70","24","46","1","1","0","665","288","377","13","4","9","40","17","23","24","11","13","-2"
"190150","Columbia University in the City of New York","2018","Not on tenure/no tenure system, instructors","154","55","99","0","0","0","29","11","18","13","4","9","15","5","10","0","0","0","79","26","53","1","1","0","5","2","3","12","6","6","-2"
"190150","Columbia University in the City of New York","2018","Not on tenure/no tenure system, lecturers","384","170","214","1","0","1","49","25","24","8","6","2","13","8","5","0","0","0","245","104","141","3","0","3","12","6","6","53","21","32","-2"
"190415","Cornell University","2018","Tenured total","1072","744","328","4","3","1","115","81","34","42","22","20","41","22","19","0","0","0","852","606","246","2","0","2","3","2","1","13","8","5","-2"
"190415","Cornell University","2018","Tenured, professors","700","524","176","2","2","0","71","53","18","22","13","9","17","10","7","0","0","0","577","438","139","1","0","1","2","2","0","8","6","2","-2"
"190415","Cornell University","2018","Tenured, associate professors","372","220","152","2","1","1","44","28","16","20","9","11","24","12","12","0","0","0","275","168","107","1","0","1","1","0","1","5","2","3","-2"
"190415","Cornell University","2018","On-Tenure track total","338","206","132","0","0","0","41","21","20","14","3","11","17","8","9","0","0","0","189","122","67","4","2","2","1","0","1","72","50","22","-2"
"190415","Cornell University","2018","On-tenure track, professors","3","2","1","0","0","0","0","0","0","0","0","0","1","1","0","0","0","0","2","1","1","0","0","0","0","0","0","0","0","0","-2"
"190415","Cornell University","2018","On-tenure track, associate professors","24","15","9","0","0","0","5","3","2","1","0","1","1","0","1","0","0","0","16","11","5","0","0","0","0","0","0","1","1","0","-2"
"190415","Cornell University","2018","On-tenure track, assistant professors","311","189","122","0","0","0","36","18","18","13","3","10","15","7","8","0","0","0","171","110","61","4","2","2","1","0","1","71","49","22","-2"
"190415","Cornell University","2018","Not on tenure track/No tenure system system total","411","193","218","1","0","1","38","11","27","12","5","7","13","8","5","0","0","0","285","139","146","6","2","4","2","1","1","54","27","27","-2"
"190415","Cornell University","2018","Not on tenure/no tenure system, professors","38","18","20","0","0","0","6","1","5","0","0","0","1","1","0","0","0","0","29","14","15","0","0","0","0","0","0","2","2","0","-2"
"190415","Cornell University","2018","Not on tenure/no tenure system, associate professors","21","7","14","0","0","0","1","0","1","2","1","1","0","0","0","0","0","0","13","4","9","0","0","0","0","0","0","5","2","3","-2"
"190415","Cornell University","2018","Not on tenure/no tenure system, assistant professors","43","22","21","0","0","0","4","2","2","0","0","0","1","1","0","0","0","0","28","12","16","0","0","0","1","1","0","9","6","3","-2"
"190415","Cornell University","2018","Not on tenure/no tenure system, instructors","20","8","12","0","0","0","4","2","2","0","0","0","1","1","0","0","0","0","8","3","5","1","0","1","0","0","0","6","2","4","-2"
"190415","Cornell University","2018","Not on tenure/no tenure system, lecturers","289","138","151","1","0","1","23","6","17","10","4","6","10","5","5","0","0","0","207","106","101","5","2","3","1","0","1","32","15","17","-2"
"190567","CUNY City College","2018","Tenured total","433","278","155","0","0","0","68","48","20","32","17","15","38","19","19","0","0","0","283","186","97","0","0","0","0","0","0","12","8","4","-2"
"190567","CUNY City College","2018","Tenured, professors","240","173","67","0","0","0","37","29","8","15","9","6","17","9","8","0","0","0","169","124","45","0","0","0","0","0","0","2","2","0","-2"
"190567","CUNY City College","2018","Tenured, associate professors","143","81","62","0","0","0","25","16","9","9","5","4","16","7","9","0","0","0","85","48","37","0","0","0","0","0","0","8","5","3","-2"
"190567","CUNY City College","2018","Tenured, assistant professors","11","5","6","0","0","0","2","1","1","1","0","1","2","1","1","0","0","0","6","3","3","0","0","0","0","0","0","0","0","0","-2"
"190567","CUNY City College","2018","Tenured, lecturers","39","19","20","0","0","0","4","2","2","7","3","4","3","2","1","0","0","0","23","11","12","0","0","0","0","0","0","2","1","1","-2"
"190567","CUNY City College","2018","On-Tenure track total","110","61","49","0","0","0","16","12","4","14","8","6","10","1","9","0","0","0","63","35","28","0","0","0","0","0","0","7","5","2","-2"
"190567","CUNY City College","2018","On-tenure track, professors","1","0","1","0","0","0","1","0","1","0","0","0","0","0","0","0","0","0","0","0","0","0","0","0","0","0","0","0","0","0","-2"
"190567","CUNY City College","2018","On-tenure track, associate professors","11","7","4","0","0","0","1","1","0","2","2","0","1","0","1","0","0","0","7","4","3","0","0","0","0","0","0","0","0","0","-2"
"190567","CUNY City College","2018","On-tenure track, assistant professors","89","48","41","0","0","0","14","11","3","9","3","6","9","1","8","0","0","0","50","28","22","0","0","0","0","0","0","7","5","2","-2"
"190567","CUNY City College","2018","On-tenure track, lecturers","9","6","3","0","0","0","0","0","0","3","3","0","0","0","0","0","0","0","6","3","3","0","0","0","0","0","0","0","0","0","-2"
"190567","CUNY City College","2018","Not on tenure track/No tenure system system total","32","14","18","0","0","0","2","0","2","3","0","3","4","1","3","0","0","0","22","12","10","0","0","0","0","0","0","1","1","0","-2"
"190567","CUNY City College","2018","Not on tenure/no tenure system, professors","20","9","11","0","0","0","1","0","1","3","0","3","1","1","0","0","0","0","14","7","7","0","0","0","0","0","0","1","1","0","-2"
"190567","CUNY City College","2018","Not on tenure/no tenure system, associate professors","1","1","0","0","0","0","0","0","0","0","0","0","0","0","0","0","0","0","1","1","0","0","0","0","0","0","0","0","0","0","-2"
"190567","CUNY City College","2018","Not on tenure/no tenure system, assistant professors","2","1","1","0","0","0","0","0","0","0","0","0","0","0","0","0","0","0","2","1","1","0","0","0","0","0","0","0","0","0","-2"
"190567","CUNY City College","2018","Not on tenure/no tenure system, lecturers","9","3","6","0","0","0","1","0","1","0","0","0","3","0","3","0","0","0","5","3","2","0","0","0","0","0","0","0","0","0","-2"
"190576","CUNY Graduate School and University Center","2018","Tenured total","153","87","66","1","0","1","9","6","3","7","4","3","9","3","6","0","0","0","123","71","52","0","0","0","0","0","0","4","3","1","-2"
"190576","CUNY Graduate School and University Center","2018","Tenured, professors","126","75","51","1","0","1","6","5","1","5","4","1","8","3","5","0","0","0","103","61","42","0","0","0","0","0","0","3","2","1","-2"
"190576","CUNY Graduate School and University Center","2018","Tenured, associate professors","25","11","14","0","0","0","3","1","2","2","0","2","1","0","1","0","0","0","18","9","9","0","0","0","0","0","0","1","1","0","-2"
"190576","CUNY Graduate School and University Center","2018","Tenured, assistant professors","2","1","1","0","0","0","0","0","0","0","0","0","0","0","0","0","0","0","2","1","1","0","0","0","0","0","0","0","0","0","-2"
"190576","CUNY Graduate School and University Center","2018","On-Tenure track total","34","17","17","0","0","0","5","2","3","3","2","1","2","1","1","0","0","0","23","11","12","0","0","0","0","0","0","1","1","0","-2"
"190576","CUNY Graduate School and University Center","2018","On-tenure track, professors","2","1","1","0","0","0","0","0","0","0","0","0","0","0","0","0","0","0","2","1","1","0","0","0","0","0","0","0","0","0","-2"
"190576","CUNY Graduate School and University Center","2018","On-tenure track, associate professors","10","4","6","0","0","0","2","0","2","1","0","1","0","0","0","0","0","0","7","4","3","0","0","0","0","0","0","0","0","0","-2"
"190576","CUNY Graduate School and University Center","2018","On-tenure track, assistant professors","20","11","9","0","0","0","3","2","1","2","2","0","2","1","1","0","0","0","12","5","7","0","0","0","0","0","0","1","1","0","-2"
"190576","CUNY Graduate School and University Center","2018","On-tenure track, lecturers","2","1","1","0","0","0","0","0","0","0","0","0","0","0","0","0","0","0","2","1","1","0","0","0","0","0","0","0","0","0","-2"
"190576","CUNY Graduate School and University Center","2018","Not on tenure track/No tenure system system total","39","22","17","0","0","0","2","1","1","3","2","1","4","1","3","0","0","0","28","17","11","0","0","0","0","0","0","2","1","1","-2"
"190576","CUNY Graduate School and University Center","2018","Not on tenure/no tenure system, professors","33","19","14","0","0","0","2","1","1","3","2","1","3","1","2","0","0","0","25","15","10","0","0","0","0","0","0","0","0","0","-2"
"190576","CUNY Graduate School and University Center","2018","Not on tenure/no tenure system, associate professors","3","2","1","0","0","0","0","0","0","0","0","0","1","0","1","0","0","0","1","1","0","0","0","0","0","0","0","1","1","0","-2"
"190576","CUNY Graduate School and University Center","2018","Not on tenure/no tenure system, assistant professors","2","0","2","0","0","0","0","0","0","0","0","0","0","0","0","0","0","0","1","0","1","0","0","0","0","0","0","1","0","1","-2"
"190576","CUNY Graduate School and University Center","2018","Not on tenure/no tenure system, lecturers","1","1","0","0","0","0","0","0","0","0","0","0","0","0","0","0","0","0","1","1","0","0","0","0","0","0","0","0","0","0","-2"
"191630","Hobart William Smith Colleges","2018","Tenured total","139","75","64","0","0","0","11","6","5","3","1","2","4","3","1","0","0","0","117","65","52","2","0","2","1","0","1","1","0","1","-2"
"191630","Hobart William Smith Colleges","2018","Tenured, professors","52","36","16","0","0","0","3","2","1","0","0","0","0","0","0","0","0","0","47","34","13","1","0","1","1","0","1","0","0","0","-2"
"191630","Hobart William Smith Colleges","2018","Tenured, associate professors","87","39","48","0","0","0","8","4","4","3","1","2","4","3","1","0","0","0","70","31","39","1","0","1","0","0","0","1","0","1","-2"
"191630","Hobart William Smith Colleges","2018","On-Tenure track total","41","16","25","1","0","1","3","2","1","2","1","1","0","0","0","0","0","0","33","12","21","1","0","1","0","0","0","1","1","0","-2"
"191630","Hobart William Smith Colleges","2018","On-tenure track, assistant professors","40","15","25","1","0","1","3","2","1","2","1","1","0","0","0","0","0","0","33","12","21","1","0","1","0","0","0","0","0","0","-2"
"191630","Hobart William Smith Colleges","2018","On-tenure track, instructors","1","1","0","0","0","0","0","0","0","0","0","0","0","0","0","0","0","0","0","0","0","0","0","0","0","0","0","1","1","0","-2"
"191630","Hobart William Smith Colleges","2018","Not on tenure track/No tenure system system total","32","17","15","0","0","0","3","2","1","0","0","0","2","2","0","0","0","0","24","12","12","0","0","0","0","0","0","3","1","2","-2"
"191630","Hobart William Smith Colleges","2018","Not on tenure/no tenure system, associate professors","2","1","1","0","0","0","0","0","0","0","0","0","0","0","0","0","0","0","2","1","1","0","0","0","0","0","0","0","0","0","-2"
"191630","Hobart William Smith Colleges","2018","Not on tenure/no tenure system, assistant professors","22","13","9","0","0","0","1","1","0","0","0","0","2","2","0","0","0","0","16","9","7","0","0","0","0","0","0","3","1","2","-2"
"191630","Hobart William Smith Colleges","2018","Not on tenure/no tenure system, instructors","6","2","4","0","0","0","1","1","0","0","0","0","0","0","0","0","0","0","5","1","4","0","0","0","0","0","0","0","0","0","-2"
"191630","Hobart William Smith Colleges","2018","Not on tenure/no tenure system, lecturers","1","0","1","0","0","0","1","0","1","0","0","0","0","0","0","0","0","0","0","0","0","0","0","0","0","0","0","0","0","0","-2"
"191630","Hobart William Smith Colleges","2018","Not on tenure/no tenure system, no academic rank","1","1","0","0","0","0","0","0","0","0","0","0","0","0","0","0","0","0","1","1","0","0","0","0","0","0","0","0","0","0","-2"
"193900","New York University","2018","Tenured total","1463","976","487","0","0","0","168","110","58","64","40","24","65","38","27","0","0","0","1129","765","364","2","1","1","2","1","1","33","21","12","-2"
"193900","New York University","2018","Tenured, professors","992","708","284","0","0","0","101","76","25","32","22","10","42","29","13","0","0","0","801","570","231","2","1","1","1","1","0","13","9","4","-2"
"193900","New York University","2018","Tenured, associate professors","439","253","186","0","0","0","67","34","33","29","17","12","22","9","13","0","0","0","301","182","119","0","0","0","1","0","1","19","11","8","-2"
"193900","New York University","2018","Tenured, assistant professors","1","1","0","0","0","0","0","0","0","0","0","0","0","0","0","0","0","0","0","0","0","0","0","0","0","0","0","1","1","0","-2"
"193900","New York University","2018","Tenured, no academic rank","31","14","17","0","0","0","0","0","0","3","1","2","1","0","1","0","0","0","27","13","14","0","0","0","0","0","0","0","0","0","-2"
"193900","New York University","2018","On-Tenure track total","459","237","222","1","0","1","64","27","37","25","8","17","25","14","11","1","1","0","230","121","109","6","4","2","6","3","3","101","59","42","-2"
"193900","New York University","2018","On-tenure track, professors","17","10","7","0","0","0","3","1","2","1","1","0","2","1","1","0","0","0","11","7","4","0","0","0","0","0","0","0","0","0","-2"
"193900","New York University","2018","On-tenure track, associate professors","88","55","33","0","0","0","19","8","11","5","1","4","5","4","1","0","0","0","48","33","15","0","0","0","1","0","1","10","9","1","-2"
"193900","New York University","2018","On-tenure track, assistant professors","327","162","165","1","0","1","39","16","23","18","6","12","15","9","6","1","1","0","152","74","78","6","4","2","5","3","2","90","49","41","-2"
"193900","New York University","2018","On-tenure track, no academic rank","27","10","17","0","0","0","3","2","1","1","0","1","3","0","3","0","0","0","19","7","12","0","0","0","0","0","0","1","1","0","-2"
"193900","New York University","2018","Not on tenure track/No tenure system system total","3801","2016","1785","1","1","0","615","267","348","161","66","95","167","73","94","4","4","0","2542","1428","1114","16","10","6","23","10","13","272","157","115","-2"
"193900","New York University","2018","Not on tenure/no tenure system, professors","272","205","67","0","0","0","26","18","8","2","1","1","5","3","2","0","0","0","230","174","56","1","1","0","0","0","0","8","8","0","-2"
"193900","New York University","2018","Not on tenure/no tenure system, associate professors","531","322","209","0","0","0","98","53","45","22","9","13","23","13","10","2","2","0","361","230","131","1","1","0","0","0","0","24","14","10","-2"
"193900","New York University","2018","Not on tenure/no tenure system, assistant professors","1398","692","706","1","1","0","295","121","174","66","28","38","60","26","34","1","1","0","845","442","403","4","2","2","7","2","5","119","69","50","-2"
"193900","New York University","2018","Not on tenure/no tenure system, instructors","406","211","195","0","0","0","83","33","50","18","6","12","24","13","11","0","0","0","269","155","114","2","1","1","0","0","0","10","3","7","-2"
"193900","New York University","2018","Not on tenure/no tenure system, lecturers","226","97","129","0","0","0","26","7","19","1","0","1","15","8","7","0","0","0","159","70","89","1","1","0","1","0","1","23","11","12","-2"
"193900","New York University","2018","Not on tenure/no tenure system, no academic rank","968","489","479","0","0","0","87","35","52","52","22","30","40","10","30","1","1","0","678","357","321","7","4","3","15","8","7","88","52","36","-2"
"196060","SUNY at Albany","2018","Tenured total","376","242","134","3","0","3","68","45","23","16","7","9","18","10","8","0","0","0","270","180","90","0","0","0","0","0","0","1","0","1","-2"
"196060","SUNY at Albany","2018","Tenured, professors","165","119","46","1","0","1","19","15","4","8","3","5","5","3","2","0","0","0","132","98","34","0","0","0","0","0","0","0","0","0","-2"
"196060","SUNY at Albany","2018","Tenured, associate professors","211","123","88","2","0","2","49","30","19","8","4","4","13","7","6","0","0","0","138","82","56","0","0","0","0","0","0","1","0","1","-2"
"196060","SUNY at Albany","2018","On-Tenure track total","195","104","91","0","0","0","39","23","16","8","1","7","12","4","8","0","0","0","110","58","52","0","0","0","0","0","0","26","18","8","-2"
"196060","SUNY at Albany","2018","On-tenure track, associate professors","3","2","1","0","0","0","0","0","0","0","0","0","0","0","0","0","0","0","3","2","1","0","0","0","0","0","0","0","0","0","-2"
"196060","SUNY at Albany","2018","On-tenure track, assistant professors","192","102","90","0","0","0","39","23","16","8","1","7","12","4","8","0","0","0","107","56","51","0","0","0","0","0","0","26","18","8","-2"
"196060","SUNY at Albany","2018","Not on tenure track/No tenure system system total","107","53","54","0","0","0","7","0","7","2","0","2","4","2","2","0","0","0","89","47","42","1","0","1","0","0","0","4","4","0","-2"
"196060","SUNY at Albany","2018","Not on tenure/no tenure system, professors","3","3","0","0","0","0","0","0","0","0","0","0","0","0","0","0","0","0","3","3","0","0","0","0","0","0","0","0","0","0","-2"
"196060","SUNY at Albany","2018","Not on tenure/no tenure system, associate professors","2","2","0","0","0","0","0","0","0","0","0","0","0","0","0","0","0","0","2","2","0","0","0","0","0","0","0","0","0","0","-2"
"196060","SUNY at Albany","2018","Not on tenure/no tenure system, assistant professors","17","8","9","0","0","0","2","0","2","0","0","0","0","0","0","0","0","0","15","8","7","0","0","0","0","0","0","0","0","0","-2"
"196060","SUNY at Albany","2018","Not on tenure/no tenure system, lecturers","85","40","45","0","0","0","5","0","5","2","0","2","4","2","2","0","0","0","69","34","35","1","0","1","0","0","0","4","4","0","-2"
"196097","Stony Brook University","2018","Tenured total","716","509","207","0","0","0","98","72","26","20","11","9","25","16","9","0","0","0","528","381","147","2","2","0","20","11","9","23","16","7","-2"
"196097","Stony Brook University","2018","Tenured, professors","456","346","110","0","0","0","62","46","16","12","8","4","11","6","5","0","0","0","349","269","80","1","1","0","10","6","4","11","10","1","-2"
"196097","Stony Brook University","2018","Tenured, associate professors","259","163","96","0","0","0","36","26","10","8","3","5","14","10","4","0","0","0","178","112","66","1","1","0","10","5","5","12","6","6","-2"
"196097","Stony Brook University","2018","Tenured, assistant professors","1","0","1","0","0","0","0","0","0","0","0","0","0","0","0","0","0","0","1","0","1","0","0","0","0","0","0","0","0","0","-2"
"196097","Stony Brook University","2018","On-Tenure track total","270","171","99","1","1","0","51","30","21","10","4","6","10","7","3","0","0","0","122","77","45","3","3","0","26","19","7","47","30","17","-2"
"196097","Stony Brook University","2018","On-tenure track, professors","15","10","5","0","0","0","1","1","0","1","1","0","1","1","0","0","0","0","9","4","5","0","0","0","2","2","0","1","1","0","-2"
"196097","Stony Brook University","2018","On-tenure track, associate professors","17","10","7","0","0","0","0","0","0","1","0","1","2","2","0","0","0","0","6","3","3","0","0","0","3","3","0","5","2","3","-2"
"196097","Stony Brook University","2018","On-tenure track, assistant professors","238","151","87","1","1","0","50","29","21","8","3","5","7","4","3","0","0","0","107","70","37","3","3","0","21","14","7","41","27","14","-2"
"196097","Stony Brook University","2018","Not on tenure track/No tenure system system total","872","390","482","1","1","0","157","71","86","41","14","27","31","5","26","1","1","0","585","266","319","5","3","2","31","15","16","20","14","6","-2"
"196097","Stony Brook University","2018","Not on tenure/no tenure system, professors","40","19","21","0","0","0","10","5","5","0","0","0","0","0","0","0","0","0","29","14","15","0","0","0","1","0","1","0","0","0","-2"
"196097","Stony Brook University","2018","Not on tenure/no tenure system, associate professors","170","101","69","0","0","0","24","15","9","5","2","3","4","2","2","1","1","0","128","73","55","1","1","0","1","1","0","6","6","0","-2"
"196097","Stony Brook University","2018","Not on tenure/no tenure system, assistant professors","440","193","247","0","0","0","98","45","53","27","8","19","20","3","17","0","0","0","270","127","143","4","2","2","15","6","9","6","2","4","-2"
"196097","Stony Brook University","2018","Not on tenure/no tenure system, instructors","101","23","78","0","0","0","12","3","9","6","2","4","2","0","2","0","0","0","75","14","61","0","0","0","6","4","2","0","0","0","-2"
"196097","Stony Brook University","2018","Not on tenure/no tenure system, lecturers","121","54","67","1","1","0","13","3","10","3","2","1","5","0","5","0","0","0","83","38","45","0","0","0","8","4","4","8","6","2","-2"
"196121","SUNY College at Brockport","2018","Tenured total","187","100","87","1","0","1","23","18","5","5","4","1","4","3","1","0","0","0","153","74","79","1","1","0","0","0","0","0","0","0","-2"
"196121","SUNY College at Brockport","2018","Tenured, professors","58","37","21","1","0","1","11","10","1","2","1","1","2","1","1","0","0","0","42","25","17","0","0","0","0","0","0","0","0","0","-2"
"196121","SUNY College at Brockport","2018","Tenured, associate professors","127","63","64","0","0","0","12","8","4","3","3","0","2","2","0","0","0","0","109","49","60","1","1","0","0","0","0","0","0","0","-2"
"196121","SUNY College at Brockport","2018","Tenured, assistant professors","2","0","2","0","0","0","0","0","0","0","0","0","0","0","0","0","0","0","2","0","2","0","0","0","0","0","0","0","0","0","-2"
"196121","SUNY College at Brockport","2018","On-Tenure track total","105","43","62","0","0","0","3","2","1","9","3","6","3","2","1","0","0","0","68","26","42","1","0","1","0","0","0","21","10","11","-2"
"196121","SUNY College at Brockport","2018","On-tenure track, associate professors","15","7","8","0","0","0","1","1","0","2","1","1","1","0","1","0","0","0","9","4","5","0","0","0","0","0","0","2","1","1","-2"
"196121","SUNY College at Brockport","2018","On-tenure track, assistant professors","80","35","45","0","0","0","2","1","1","7","2","5","2","2","0","0","0","0","49","21","28","1","0","1","0","0","0","19","9","10","-2"
"196121","SUNY College at Brockport","2018","On-tenure track, instructors","10","1","9","0","0","0","0","0","0","0","0","0","0","0","0","0","0","0","10","1","9","0","0","0","0","0","0","0","0","0","-2"
"196121","SUNY College at Brockport","2018","Not on tenure track/No tenure system system total","50","18","32","0","0","0","1","0","1","0","0","0","2","0","2","0","0","0","44","17","27","0","0","0","0","0","0","3","1","2","-2"
"196121","SUNY College at Brockport","2018","Not on tenure/no tenure system, associate professors","1","0","1","0","0","0","0","0","0","0","0","0","0","0","0","0","0","0","1","0","1","0","0","0","0","0","0","0","0","0","-2"
"196121","SUNY College at Brockport","2018","Not on tenure/no tenure system, assistant professors","11","4","7","0","0","0","0","0","0","0","0","0","0","0","0","0","0","0","9","3","6","0","0","0","0","0","0","2","1","1","-2"
"196121","SUNY College at Brockport","2018","Not on tenure/no tenure system, instructors","1","0","1","0","0","0","0","0","0","0","0","0","0","0","0","0","0","0","1","0","1","0","0","0","0","0","0","0","0","0","-2"
"196121","SUNY College at Brockport","2018","Not on tenure/no tenure system, lecturers","37","14","23","0","0","0","1","0","1","0","0","0","2","0","2","0","0","0","33","14","19","0","0","0","0","0","0","1","0","1","-2"
"196130","SUNY Buffalo State","2018","Tenured total","240","132","108","1","1","0","26","14","12","11","9","2","11","4","7","0","0","0","186","102","84","0","0","0","0","0","0","5","2","3","-2"
"196130","SUNY Buffalo State","2018","Tenured, professors","93","60","33","0","0","0","10","7","3","4","3","1","4","1","3","0","0","0","73","47","26","0","0","0","0","0","0","2","2","0","-2"
"196130","SUNY Buffalo State","2018","Tenured, associate professors","145","71","74","1","1","0","15","7","8","7","6","1","7","3","4","0","0","0","112","54","58","0","0","0","0","0","0","3","0","3","-2"
"196130","SUNY Buffalo State","2018","Tenured, assistant professors","2","1","1","0","0","0","1","0","1","0","0","0","0","0","0","0","0","0","1","1","0","0","0","0","0","0","0","0","0","0","-2"
"196130","SUNY Buffalo State","2018","On-Tenure track total","66","28","38","1","1","0","9","7","2","2","0","2","5","3","2","0","0","0","41","13","28","1","0","1","0","0","0","7","4","3","-2"
"196130","SUNY Buffalo State","2018","On-tenure track, associate professors","12","5","7","0","0","0","3","2","1","0","0","0","1","0","1","0","0","0","8","3","5","0","0","0","0","0","0","0","0","0","-2"
"196130","SUNY Buffalo State","2018","On-tenure track, assistant professors","54","23","31","1","1","0","6","5","1","2","0","2","4","3","1","0","0","0","33","10","23","1","0","1","0","0","0","7","4","3","-2"
"196130","SUNY Buffalo State","2018","Not on tenure track/No tenure system system total","52","23","29","0","0","0","3","0","3","6","4","2","0","0","0","0","0","0","43","19","24","0","0","0","0","0","0","0","0","0","-2"
"196130","SUNY Buffalo State","2018","Not on tenure/no tenure system, professors","1","1","0","0","0","0","0","0","0","0","0","0","0","0","0","0","0","0","1","1","0","0","0","0","0","0","0","0","0","0","-2"
"196130","SUNY Buffalo State","2018","Not on tenure/no tenure system, assistant professors","4","2","2","0","0","0","1","0","1","2","2","0","0","0","0","0","0","0","1","0","1","0","0","0","0","0","0","0","0","0","-2"
"196130","SUNY Buffalo State","2018","Not on tenure/no tenure system, lecturers","47","20","27","0","0","0","2","0","2","4","2","2","0","0","0","0","0","0","41","18","23","0","0","0","0","0","0","0","0","0","-2"
"196185","SUNY Oneonta","2018","Tenured total","153","85","68","0","0","0","24","13","11","6","0","6","3","2","1","0","0","0","120","70","50","0","0","0","0","0","0","0","0","0","-2"
"196185","SUNY Oneonta","2018","Tenured, professors","56","36","20","0","0","0","11","8","3","3","0","3","1","1","0","0","0","0","41","27","14","0","0","0","0","0","0","0","0","0","-2"
"196185","SUNY Oneonta","2018","Tenured, associate professors","87","44","43","0","0","0","12","5","7","3","0","3","2","1","1","0","0","0","70","38","32","0","0","0","0","0","0","0","0","0","-2"
"196185","SUNY Oneonta","2018","Tenured, assistant professors","10","5","5","0","0","0","1","0","1","0","0","0","0","0","0","0","0","0","9","5","4","0","0","0","0","0","0","0","0","0","-2"
"196185","SUNY Oneonta","2018","On-Tenure track total","84","41","43","0","0","0","10","4","6","5","3","2","5","1","4","0","0","0","50","24","26","0","0","0","0","0","0","14","9","5","-2"
"196185","SUNY Oneonta","2018","On-tenure track, associate professors","8","6","2","0","0","0","0","0","0","1","0","1","0","0","0","0","0","0","6","5","1","0","0","0","0","0","0","1","1","0","-2"
"196185","SUNY Oneonta","2018","On-tenure track, assistant professors","76","35","41","0","0","0","10","4","6","4","3","1","5","1","4","0","0","0","44","19","25","0","0","0","0","0","0","13","8","5","-2"
"196185","SUNY Oneonta","2018","Not on tenure track/No tenure system system total","50","24","26","0","0","0","2","1","1","2","2","0","2","1","1","0","0","0","39","19","20","1","1","0","0","0","0","4","0","4","-2"
"196185","SUNY Oneonta","2018","Not on tenure/no tenure system, professors","1","1","0","0","0","0","0","0","0","0","0","0","0","0","0","0","0","0","1","1","0","0","0","0","0","0","0","0","0","0","-2"
"196185","SUNY Oneonta","2018","Not on tenure/no tenure system, assistant professors","4","2","2","0","0","0","0","0","0","0","0","0","0","0","0","0","0","0","2","2","0","0","0","0","0","0","0","2","0","2","-2"
"196185","SUNY Oneonta","2018","Not on tenure/no tenure system, lecturers","45","21","24","0","0","0","2","1","1","2","2","0","2","1","1","0","0","0","36","16","20","1","1","0","0","0","0","2","0","2","-2"
"196194","SUNY College at Oswego","2018","Tenured total","166","99","67","1","1","0","16","13","3","9","4","5","7","5","2","0","0","0","131","76","55","2","0","2","0","0","0","0","0","0","-2"
"196194","SUNY College at Oswego","2018","Tenured, professors","77","52","25","0","0","0","11","10","1","3","2","1","2","1","1","0","0","0","60","39","21","1","0","1","0","0","0","0","0","0","-2"
"196194","SUNY College at Oswego","2018","Tenured, associate professors","80","41","39","1","1","0","4","2","2","6","2","4","4","4","0","0","0","0","64","32","32","1","0","1","0","0","0","0","0","0","-2"
"196194","SUNY College at Oswego","2018","Tenured, assistant professors","9","6","3","0","0","0","1","1","0","0","0","0","1","0","1","0","0","0","7","5","2","0","0","0","0","0","0","0","0","0","-2"
"196194","SUNY College at Oswego","2018","On-Tenure track total","121","56","65","0","0","0","13","4","9","3","1","2","7","4","3","0","0","0","76","33","43","0","0","0","0","0","0","22","14","8","-2"
"196194","SUNY College at Oswego","2018","On-tenure track, professors","1","0","1","0","0","0","0","0","0","0","0","0","0","0","0","0","0","0","1","0","1","0","0","0","0","0","0","0","0","0","-2"
"196194","SUNY College at Oswego","2018","On-tenure track, associate professors","19","10","9","0","0","0","2","1","1","1","1","0","0","0","0","0","0","0","15","7","8","0","0","0","0","0","0","1","1","0","-2"
"196194","SUNY College at Oswego","2018","On-tenure track, assistant professors","100","46","54","0","0","0","10","3","7","2","0","2","7","4","3","0","0","0","60","26","34","0","0","0","0","0","0","21","13","8","-2"
"196194","SUNY College at Oswego","2018","On-tenure track, instructors","1","0","1","0","0","0","1","0","1","0","0","0","0","0","0","0","0","0","0","0","0","0","0","0","0","0","0","0","0","0","-2"
"196194","SUNY College at Oswego","2018","Not on tenure track/No tenure system system total","84","46","38","0","0","0","2","1","1","1","1","0","2","1","1","0","0","0","74","39","35","1","1","0","0","0","0","4","3","1","-2"
"196194","SUNY College at Oswego","2018","Not on tenure/no tenure system, assistant professors","66","34","32","0","0","0","2","1","1","1","1","0","2","1","1","0","0","0","56","27","29","1","1","0","0","0","0","4","3","1","-2"
"196194","SUNY College at Oswego","2018","Not on tenure/no tenure system, instructors","10","7","3","0","0","0","0","0","0","0","0","0","0","0","0","0","0","0","10","7","3","0","0","0","0","0","0","0","0","0","-2"
"196194","SUNY College at Oswego","2018","Not on tenure/no tenure system, lecturers","8","5","3","0","0","0","0","0","0","0","0","0","0","0","0","0","0","0","8","5","3","0","0","0","0","0","0","0","0","0","-2"
"196291","SUNY Maritime College","2018","Tenured total","41","31","10","0","0","0","2","2","0","0","0","0","0","0","0","0","0","0","39","29","10","0","0","0","0","0","0","0","0","0","-2"
"196291","SUNY Maritime College","2018","Tenured, professors","22","17","5","0","0","0","0","0","0","0","0","0","0","0","0","0","0","0","22","17","5","0","0","0","0","0","0","0","0","0","-2"
"196291","SUNY Maritime College","2018","Tenured, associate professors","17","12","5","0","0","0","2","2","0","0","0","0","0","0","0","0","0","0","15","10","5","0","0","0","0","0","0","0","0","0","-2"
"196291","SUNY Maritime College","2018","Tenured, assistant professors","2","2","0","0","0","0","0","0","0","0","0","0","0","0","0","0","0","0","2","2","0","0","0","0","0","0","0","0","0","0","-2"
"196291","SUNY Maritime College","2018","On-Tenure track total","18","10","8","0","0","0","1","1","0","1","0","1","0","0","0","0","0","0","15","8","7","0","0","0","0","0","0","1","1","0","-2"
"196291","SUNY Maritime College","2018","On-tenure track, associate professors","3","3","0","0","0","0","0","0","0","0","0","0","0","0","0","0","0","0","3","3","0","0","0","0","0","0","0","0","0","0","-2"
"196291","SUNY Maritime College","2018","On-tenure track, assistant professors","15","7","8","0","0","0","1","1","0","1","0","1","0","0","0","0","0","0","12","5","7","0","0","0","0","0","0","1","1","0","-2"
"196291","SUNY Maritime College","2018","Not on tenure track/No tenure system system total","33","31","2","0","0","0","2","2","0","3","2","1","1","1","0","0","0","0","26","25","1","0","0","0","0","0","0","1","1","0","-2"
"196291","SUNY Maritime College","2018","Not on tenure/no tenure system, professors","1","1","0","0","0","0","1","1","0","0","0","0","0","0","0","0","0","0","0","0","0","0","0","0","0","0","0","0","0","0","-2"
"196291","SUNY Maritime College","2018","Not on tenure/no tenure system, instructors","1","1","0","0","0","0","0","0","0","0","0","0","0","0","0","0","0","0","1","1","0","0","0","0","0","0","0","0","0","0","-2"
"196291","SUNY Maritime College","2018","Not on tenure/no tenure system, lecturers","31","29","2","0","0","0","1","1","0","3","2","1","1","1","0","0","0","0","25","24","1","0","0","0","0","0","0","1","1","0","-2"
"197869","Appalachian State University","2018","Tenured total","532","295","237","1","0","1","15","10","5","7","7","0","6","2","4","0","0","0","476","258","218","5","2","3","7","6","1","15","10","5","-2"
"197869","Appalachian State University","2018","Tenured, professors","315","185","130","1","0","1","7","5","2","3","3","0","4","1","3","0","0","0","289","166","123","0","0","0","4","4","0","7","6","1","-2"
"197869","Appalachian State University","2018","Tenured, associate professors","217","110","107","0","0","0","8","5","3","4","4","0","2","1","1","0","0","0","187","92","95","5","2","3","3","2","1","8","4","4","-2"
"197869","Appalachian State University","2018","On-Tenure track total","208","103","105","0","0","0","11","8","3","10","3","7","1","0","1","0","0","0","158","83","75","8","2","6","3","0","3","17","7","10","-2"
"197869","Appalachian State University","2018","On-tenure track, associate professors","8","6","2","0","0","0","0","0","0","0","0","0","0","0","0","0","0","0","5","4","1","0","0","0","0","0","0","3","2","1","-2"
"197869","Appalachian State University","2018","On-tenure track, assistant professors","200","97","103","0","0","0","11","8","3","10","3","7","1","0","1","0","0","0","153","79","74","8","2","6","3","0","3","14","5","9","-2"
"197869","Appalachian State University","2018","Not on tenure track/No tenure system system total","270","120","150","0","0","0","4","0","4","0","0","0","2","0","2","0","0","0","255","117","138","1","0","1","4","0","4","4","3","1","-2"
"197869","Appalachian State University","2018","Not on tenure/no tenure system, professors","3","2","1","0","0","0","0","0","0","0","0","0","0","0","0","0","0","0","3","2","1","0","0","0","0","0","0","0","0","0","-2"
"197869","Appalachian State University","2018","Not on tenure/no tenure system, associate professors","1","0","1","0","0","0","0","0","0","0","0","0","0","0","0","0","0","0","1","0","1","0","0","0","0","0","0","0","0","0","-2"
"197869","Appalachian State University","2018","Not on tenure/no tenure system, instructors","7","4","3","0","0","0","0","0","0","0","0","0","0","0","0","0","0","0","6","3","3","0","0","0","0","0","0","1","1","0","-2"
"197869","Appalachian State University","2018","Not on tenure/no tenure system, lecturers","196","82","114","0","0","0","4","0","4","0","0","0","2","0","2","0","0","0","186","81","105","1","0","1","2","0","2","1","1","0","-2"
"197869","Appalachian State University","2018","Not on tenure/no tenure system, no academic rank","63","32","31","0","0","0","0","0","0","0","0","0","0","0","0","0","0","0","59","31","28","0","0","0","2","0","2","2","1","1","-2"
"198419","Duke University","2018","Tenured total","1326","979","347","0","0","0","177","128","49","47","27","20","24","17","7","1","1","0","1074","803","271","3","3","0","0","0","0","0","0","0","-2"
"198419","Duke University","2018","Tenured, professors","992","771","221","0","0","0","120","94","26","31","22","9","14","10","4","1","1","0","824","642","182","2","2","0","0","0","0","0","0","0","-2"
"198419","Duke University","2018","Tenured, associate professors","334","208","126","0","0","0","57","34","23","16","5","11","10","7","3","0","0","0","250","161","89","1","1","0","0","0","0","0","0","0","-2"
"198419","Duke University","2018","On-Tenure track total","342","206","136","0","0","0","63","42","21","22","12","10","3","1","2","1","0","1","246","146","100","7","5","2","0","0","0","0","0","0","-2"
"198419","Duke University","2018","On-tenure track, associate professors","121","68","53","0","0","0","25","15","10","5","3","2","1","0","1","1","0","1","88","50","38","1","0","1","0","0","0","0","0","0","-2"
"198419","Duke University","2018","On-tenure track, assistant professors","221","138","83","0","0","0","38","27","11","17","9","8","2","1","1","0","0","0","158","96","62","6","5","1","0","0","0","0","0","0","-2"
"198419","Duke University","2018","Not on tenure track/No tenure system system total","2290","1160","1130","2","1","1","367","192","175","115","48","67","34","16","18","6","3","3","1747","894","853","19","6","13","0","0","0","0","0","0","-2"
"198419","Duke University","2018","Not on tenure/no tenure system, professors","290","185","105","0","0","0","34","23","11","8","7","1","5","4","1","1","1","0","242","150","92","0","0","0","0","0","0","0","0","0","-2"
"198419","Duke University","2018","Not on tenure/no tenure system, associate professors","445","248","197","0","0","0","75","46","29","20","8","12","7","4","3","0","0","0","341","189","152","2","1","1","0","0","0","0","0","0","-2"
"198419","Duke University","2018","Not on tenure/no tenure system, assistant professors","1002","493","509","2","1","1","179","96","83","65","27","38","14","6","8","2","0","2","727","361","366","13","2","11","0","0","0","0","0","0","-2"
"198419","Duke University","2018","Not on tenure/no tenure system, instructors","408","181","227","0","0","0","63","23","40","16","2","14","2","0","2","3","2","1","320","151","169","4","3","1","0","0","0","0","0","0","-2"
"198419","Duke University","2018","Not on tenure/no tenure system, lecturers","145","53","92","0","0","0","16","4","12","6","4","2","6","2","4","0","0","0","117","43","74","0","0","0","0","0","0","0","0","0","-2"
"199102","North Carolina A & T State University","2018","Tenured total","254","165","89","1","0","1","51","40","11","123","68","55","5","4","1","0","0","0","67","46","21","1","1","0","1","1","0","5","5","0","-2"
"199102","North Carolina A & T State University","2018","Tenured, professors","98","74","24","1","0","1","26","22","4","43","31","12","3","2","1","0","0","0","23","17","6","1","1","0","1","1","0","0","0","0","-2"
"199102","North Carolina A & T State University","2018","Tenured, associate professors","155","91","64","0","0","0","25","18","7","79","37","42","2","2","0","0","0","0","44","29","15","0","0","0","0","0","0","5","5","0","-2"
"199102","North Carolina A & T State University","2018","Tenured, assistant professors","1","0","1","0","0","0","0","0","0","1","0","1","0","0","0","0","0","0","0","0","0","0","0","0","0","0","0","0","0","0","-2"
"199102","North Carolina A & T State University","2018","On-Tenure track total","115","54","61","0","0","0","20","14","6","47","13","34","0","0","0","0","0","0","20","13","7","0","0","0","21","10","11","7","4","3","-2"
"199102","North Carolina A & T State University","2018","On-tenure track, professors","6","6","0","0","0","0","2","2","0","2","2","0","0","0","0","0","0","0","2","2","0","0","0","0","0","0","0","0","0","0","-2"
"199102","North Carolina A & T State University","2018","On-tenure track, associate professors","25","9","16","0","0","0","3","2","1","10","3","7","0","0","0","0","0","0","6","3","3","0","0","0","5","1","4","1","0","1","-2"
"199102","North Carolina A & T State University","2018","On-tenure track, assistant professors","82","39","43","0","0","0","15","10","5","33","8","25","0","0","0","0","0","0","12","8","4","0","0","0","16","9","7","6","4","2","-2"
"199102","North Carolina A & T State University","2018","On-tenure track, no academic rank","2","0","2","0","0","0","0","0","0","2","0","2","0","0","0","0","0","0","0","0","0","0","0","0","0","0","0","0","0","0","-2"
"199102","North Carolina A & T State University","2018","Not on tenure track/No tenure system system total","79","37","42","1","0","1","2","1","1","47","20","27","2","1","1","0","0","0","21","12","9","0","0","0","2","0","2","4","3","1","-2"
"199102","North Carolina A & T State University","2018","Not on tenure/no tenure system, assistant professors","8","4","4","0","0","0","0","0","0","5","2","3","0","0","0","0","0","0","2","1","1","0","0","0","0","0","0","1","1","0","-2"
"199102","North Carolina A & T State University","2018","Not on tenure/no tenure system, instructors","2","2","0","0","0","0","0","0","0","1","1","0","0","0","0","0","0","0","1","1","0","0","0","0","0","0","0","0","0","0","-2"
"199102","North Carolina A & T State University","2018","Not on tenure/no tenure system, lecturers","17","9","8","0","0","0","1","1","0","10","4","6","1","1","0","0","0","0","3","1","2","0","0","0","0","0","0","2","2","0","-2"
"199102","North Carolina A & T State University","2018","Not on tenure/no tenure system, no academic rank","52","22","30","1","0","1","1","0","1","31","13","18","1","0","1","0","0","0","15","9","6","0","0","0","2","0","2","1","0","1","-2"
"199111","University of North Carolina at Asheville","2018","Tenured total","113","61","52","0","0","0","8","3","5","4","2","2","4","1","3","1","0","1","94","55","39","1","0","1","0","0","0","1","0","1","-2"
"199111","University of North Carolina at Asheville","2018","Tenured, professors","65","45","20","0","0","0","4","2","2","0","0","0","1","1","0","0","0","0","60","42","18","0","0","0","0","0","0","0","0","0","-2"
"199111","University of North Carolina at Asheville","2018","Tenured, associate professors","47","15","32","0","0","0","4","1","3","3","1","2","3","0","3","1","0","1","34","13","21","1","0","1","0","0","0","1","0","1","-2"
"199111","University of North Carolina at Asheville","2018","Tenured, assistant professors","1","1","0","0","0","0","0","0","0","1","1","0","0","0","0","0","0","0","0","0","0","0","0","0","0","0","0","0","0","0","-2"
"199111","University of North Carolina at Asheville","2018","On-Tenure track total","56","32","24","1","1","0","2","0","2","3","3","0","5","1","4","0","0","0","40","25","15","0","0","0","1","0","1","4","2","2","-2"
"199111","University of North Carolina at Asheville","2018","On-tenure track, professors","1","1","0","0","0","0","0","0","0","0","0","0","0","0","0","0","0","0","1","1","0","0","0","0","0","0","0","0","0","0","-2"
"199111","University of North Carolina at Asheville","2018","On-tenure track, associate professors","3","3","0","0","0","0","0","0","0","0","0","0","0","0","0","0","0","0","3","3","0","0","0","0","0","0","0","0","0","0","-2"
"199111","University of North Carolina at Asheville","2018","On-tenure track, assistant professors","52","28","24","1","1","0","2","0","2","3","3","0","5","1","4","0","0","0","36","21","15","0","0","0","1","0","1","4","2","2","-2"
"199111","University of North Carolina at Asheville","2018","Not on tenure track/No tenure system system total","52","22","30","0","0","0","0","0","0","1","1","0","0","0","0","0","0","0","48","20","28","0","0","0","0","0","0","3","1","2","-2"
"199111","University of North Carolina at Asheville","2018","Not on tenure/no tenure system, assistant professors","1","0","1","0","0","0","0","0","0","0","0","0","0","0","0","0","0","0","1","0","1","0","0","0","0","0","0","0","0","0","-2"
"199111","University of North Carolina at Asheville","2018","Not on tenure/no tenure system, instructors","1","0","1","0","0","0","0","0","0","0","0","0","0","0","0","0","0","0","1","0","1","0","0","0","0","0","0","0","0","0","-2"
"199111","University of North Carolina at Asheville","2018","Not on tenure/no tenure system, lecturers","47","19","28","0","0","0","0","0","0","1","1","0","0","0","0","0","0","0","44","18","26","0","0","0","0","0","0","2","0","2","-2"
"199111","University of North Carolina at Asheville","2018","Not on tenure/no tenure system, no academic rank","3","3","0","0","0","0","0","0","0","0","0","0","0","0","0","0","0","0","2","2","0","0","0","0","0","0","0","1","1","0","-2"
"199120","University of North Carolina at Chapel Hill","2018","Tenured total","1020","644","376","6","3","3","102","68","34","53","22","31","42","24","18","0","0","0","794","513","281","6","3","3","13","8","5","4","3","1","-2"
"199120","University of North Carolina at Chapel Hill","2018","Tenured, professors","628","426","202","2","2","0","53","42","11","17","9","8","15","7","8","0","0","0","531","359","172","2","2","0","6","3","3","2","2","0","-2"
"199120","University of North Carolina at Chapel Hill","2018","Tenured, associate professors","392","218","174","4","1","3","49","26","23","36","13","23","27","17","10","0","0","0","263","154","109","4","1","3","7","5","2","2","1","1","-2"
"199120","University of North Carolina at Chapel Hill","2018","On-Tenure track total","283","148","135","2","2","0","22","8","14","25","12","13","21","10","11","1","0","1","131","70","61","4","2","2","34","15","19","43","29","14","-2"
"199120","University of North Carolina at Chapel Hill","2018","On-tenure track, associate professors","10","5","5","0","0","0","0","0","0","0","0","0","2","1","1","0","0","0","5","3","2","0","0","0","2","1","1","1","0","1","-2"
"199120","University of North Carolina at Chapel Hill","2018","On-tenure track, assistant professors","269","141","128","2","2","0","21","8","13","25","12","13","18","8","10","1","0","1","125","66","59","4","2","2","31","14","17","42","29","13","-2"
"199120","University of North Carolina at Chapel Hill","2018","On-tenure track, instructors","4","2","2","0","0","0","1","0","1","0","0","0","1","1","0","0","0","0","1","1","0","0","0","0","1","0","1","0","0","0","-2"
"199120","University of North Carolina at Chapel Hill","2018","Not on tenure track/No tenure system system total","605","222","383","6","4","2","31","11","20","29","10","19","32","16","16","0","0","0","450","155","295","3","0","3","27","13","14","27","13","14","-2"
"199120","University of North Carolina at Chapel Hill","2018","Not on tenure/no tenure system, professors","9","4","5","0","0","0","2","2","0","0","0","0","0","0","0","0","0","0","7","2","5","0","0","0","0","0","0","0","0","0","-2"
"199120","University of North Carolina at Chapel Hill","2018","Not on tenure/no tenure system, associate professors","17","10","7","0","0","0","0","0","0","0","0","0","2","1","1","0","0","0","14","9","5","0","0","0","0","0","0","1","0","1","-2"
"199120","University of North Carolina at Chapel Hill","2018","Not on tenure/no tenure system, assistant professors","16","6","10","0","0","0","2","0","2","1","0","1","1","1","0","0","0","0","8","3","5","0","0","0","2","1","1","2","1","1","-2"
"199120","University of North Carolina at Chapel Hill","2018","Not on tenure/no tenure system, instructors","10","5","5","0","0","0","1","1","0","0","0","0","0","0","0","0","0","0","5","1","4","0","0","0","0","0","0","4","3","1","-2"
"199120","University of North Carolina at Chapel Hill","2018","Not on tenure/no tenure system, lecturers","189","81","108","1","1","0","13","4","9","8","5","3","17","7","10","0","0","0","127","54","73","1","0","1","7","6","1","15","4","11","-2"
"199120","University of North Carolina at Chapel Hill","2018","Not on tenure/no tenure system, no academic rank","364","116","248","5","3","2","13","4","9","20","5","15","12","7","5","0","0","0","289","86","203","2","0","2","18","6","12","5","5","0","-2"
"199139","University of North Carolina at Charlotte","2018","Tenured total","517","324","193","0","0","0","80","59","21","33","15","18","18","10","8","0","0","0","363","226","137","1","0","1","0","0","0","22","14","8","-2"
"199139","University of North Carolina at Charlotte","2018","Tenured, professors","231","169","62","0","0","0","44","36","8","7","6","1","8","4","4","0","0","0","170","121","49","0","0","0","0","0","0","2","2","0","-2"
"199139","University of North Carolina at Charlotte","2018","Tenured, associate professors","285","155","130","0","0","0","36","23","13","26","9","17","10","6","4","0","0","0","192","105","87","1","0","1","0","0","0","20","12","8","-2"
"199139","University of North Carolina at Charlotte","2018","Tenured, assistant professors","1","0","1","0","0","0","0","0","0","0","0","0","0","0","0","0","0","0","1","0","1","0","0","0","0","0","0","0","0","0","-2"
"199139","University of North Carolina at Charlotte","2018","On-Tenure track total","215","101","114","0","0","0","28","18","10","20","7","13","8","3","5","0","0","0","112","51","61","2","1","1","4","0","4","41","21","20","-2"
"199139","University of North Carolina at Charlotte","2018","On-tenure track, associate professors","2","1","1","0","0","0","1","1","0","0","0","0","0","0","0","0","0","0","1","0","1","0","0","0","0","0","0","0","0","0","-2"
"199139","University of North Carolina at Charlotte","2018","On-tenure track, assistant professors","213","100","113","0","0","0","27","17","10","20","7","13","8","3","5","0","0","0","111","51","60","2","1","1","4","0","4","41","21","20","-2"
"199139","University of North Carolina at Charlotte","2018","Not on tenure track/No tenure system system total","355","131","224","0","0","0","20","8","12","29","7","22","17","5","12","0","0","0","261","101","160","0","0","0","5","1","4","23","9","14","-2"
"199139","University of North Carolina at Charlotte","2018","Not on tenure/no tenure system, professors","2","2","0","0","0","0","0","0","0","0","0","0","0","0","0","0","0","0","2","2","0","0","0","0","0","0","0","0","0","0","-2"
"199139","University of North Carolina at Charlotte","2018","Not on tenure/no tenure system, associate professors","2","1","1","0","0","0","1","1","0","0","0","0","1","0","1","0","0","0","0","0","0","0","0","0","0","0","0","0","0","0","-2"
"199139","University of North Carolina at Charlotte","2018","Not on tenure/no tenure system, assistant professors","8","4","4","0","0","0","2","0","2","0","0","0","0","0","0","0","0","0","4","2","2","0","0","0","0","0","0","2","2","0","-2"
"199139","University of North Carolina at Charlotte","2018","Not on tenure/no tenure system, lecturers","235","85","150","0","0","0","13","4","9","16","5","11","12","2","10","0","0","0","181","72","109","0","0","0","3","0","3","10","2","8","-2"
"199139","University of North Carolina at Charlotte","2018","Not on tenure/no tenure system, no academic rank","108","39","69","0","0","0","4","3","1","13","2","11","4","3","1","0","0","0","74","25","49","0","0","0","2","1","1","11","5","6","-2"
"199157","North Carolina Central University","2018","Tenured total","188","106","82","0","0","0","23","13","10","104","57","47","3","2","1","0","0","0","47","26","21","1","0","1","2","1","1","8","7","1","-2"
"199157","North Carolina Central University","2018","Tenured, professors","77","47","30","0","0","0","12","7","5","37","20","17","2","1","1","0","0","0","24","17","7","0","0","0","0","0","0","2","2","0","-2"
"199157","North Carolina Central University","2018","Tenured, associate professors","105","57","48","0","0","0","11","6","5","61","35","26","1","1","0","0","0","0","23","9","14","1","0","1","2","1","1","6","5","1","-2"
"199157","North Carolina Central University","2018","Tenured, assistant professors","6","2","4","0","0","0","0","0","0","6","2","4","0","0","0","0","0","0","0","0","0","0","0","0","0","0","0","0","0","0","-2"
"199157","North Carolina Central University","2018","On-Tenure track total","76","32","44","1","1","0","6","4","2","41","13","28","2","2","0","0","0","0","16","11","5","1","0","1","9","1","8","0","0","0","-2"
"199157","North Carolina Central University","2018","On-tenure track, professors","2","2","0","0","0","0","1","1","0","0","0","0","0","0","0","0","0","0","1","1","0","0","0","0","0","0","0","0","0","0","-2"
"199157","North Carolina Central University","2018","On-tenure track, associate professors","9","2","7","0","0","0","1","1","0","5","0","5","0","0","0","0","0","0","1","1","0","0","0","0","2","0","2","0","0","0","-2"
"199157","North Carolina Central University","2018","On-tenure track, assistant professors","60","27","33","1","1","0","4","2","2","33","13","20","2","2","0","0","0","0","13","8","5","1","0","1","6","1","5","0","0","0","-2"
"199157","North Carolina Central University","2018","On-tenure track, no academic rank","5","1","4","0","0","0","0","0","0","3","0","3","0","0","0","0","0","0","1","1","0","0","0","0","1","0","1","0","0","0","-2"
"199157","North Carolina Central University","2018","Not on tenure track/No tenure system system total","120","40","80","0","0","0","6","2","4","68","24","44","1","0","1","0","0","0","33","9","24","1","0","1","8","2","6","3","3","0","-2"
"199157","North Carolina Central University","2018","Not on tenure/no tenure system, associate professors","3","2","1","0","0","0","1","0","1","0","0","0","0","0","0","0","0","0","2","2","0","0","0","0","0","0","0","0","0","0","-2"
"199157","North Carolina Central University","2018","Not on tenure/no tenure system, assistant professors","13","5","8","0","0","0","1","0","1","6","3","3","0","0","0","0","0","0","3","0","3","0","0","0","2","1","1","1","1","0","-2"
"199157","North Carolina Central University","2018","Not on tenure/no tenure system, instructors","7","5","2","0","0","0","2","2","0","2","2","0","0","0","0","0","0","0","2","0","2","0","0","0","0","0","0","1","1","0","-2"
"199157","North Carolina Central University","2018","Not on tenure/no tenure system, lecturers","45","14","31","0","0","0","1","0","1","25","8","17","1","0","1","0","0","0","15","5","10","0","0","0","2","0","2","1","1","0","-2"
"199157","North Carolina Central University","2018","Not on tenure/no tenure system, no academic rank","52","14","38","0","0","0","1","0","1","35","11","24","0","0","0","0","0","0","11","2","9","1","0","1","4","1","3","0","0","0","-2"
"199193","North Carolina State University at Raleigh","2018","Tenured total","1022","735","287","1","1","0","126","101","25","40","23","17","43","21","22","1","1","0","776","567","209","6","5","1","25","12","13","4","4","0","-2"
"199193","North Carolina State University at Raleigh","2018","Tenured, professors","634","484","150","0","0","0","85","73","12","15","7","8","25","13","12","1","1","0","496","381","115","5","4","1","7","5","2","0","0","0","-2"
"199193","North Carolina State University at Raleigh","2018","Tenured, associate professors","388","251","137","1","1","0","41","28","13","25","16","9","18","8","10","0","0","0","280","186","94","1","1","0","18","7","11","4","4","0","-2"
"199193","North Carolina State University at Raleigh","2018","On-Tenure track total","355","193","162","0","0","0","43","28","15","23","8","15","22","13","9","0","0","0","176","95","81","4","2","2","28","11","17","59","36","23","-2"
"199193","North Carolina State University at Raleigh","2018","On-tenure track, associate professors","22","14","8","0","0","0","6","4","2","0","0","0","0","0","0","0","0","0","12","8","4","1","0","1","1","0","1","2","2","0","-2"
"199193","North Carolina State University at Raleigh","2018","On-tenure track, assistant professors","333","179","154","0","0","0","37","24","13","23","8","15","22","13","9","0","0","0","164","87","77","3","2","1","27","11","16","57","34","23","-2"
"199193","North Carolina State University at Raleigh","2018","Not on tenure track/No tenure system system total","367","155","212","0","0","0","22","6","16","23","10","13","17","9","8","0","0","0","280","118","162","2","0","2","17","9","8","6","3","3","-2"
"199193","North Carolina State University at Raleigh","2018","Not on tenure/no tenure system, professors","17","10","7","0","0","0","0","0","0","0","0","0","1","1","0","0","0","0","16","9","7","0","0","0","0","0","0","0","0","0","-2"
"199193","North Carolina State University at Raleigh","2018","Not on tenure/no tenure system, associate professors","58","26","32","0","0","0","6","2","4","2","1","1","3","1","2","0","0","0","46","21","25","0","0","0","1","1","0","0","0","0","-2"
"199193","North Carolina State University at Raleigh","2018","Not on tenure/no tenure system, assistant professors","99","37","62","0","0","0","6","1","5","7","3","4","3","2","1","0","0","0","74","27","47","0","0","0","6","2","4","3","2","1","-2"
"199193","North Carolina State University at Raleigh","2018","Not on tenure/no tenure system, lecturers","182","77","105","0","0","0","10","3","7","12","5","7","9","4","5","0","0","0","138","60","78","2","0","2","9","5","4","2","0","2","-2"
"199193","North Carolina State University at Raleigh","2018","Not on tenure/no tenure system, no academic rank","11","5","6","0","0","0","0","0","0","2","1","1","1","1","0","0","0","0","6","1","5","0","0","0","1","1","0","1","1","0","-2"
"199847","Wake Forest University","2018","Tenured total","529","344","185","2","2","0","40","30","10","21","15","6","27","15","12","1","1","0","429","274","155","0","0","0","5","5","0","4","2","2","-2"
"199847","Wake Forest University","2018","Tenured, professors","315","214","101","0","0","0","22","17","5","12","8","4","13","9","4","0","0","0","263","177","86","0","0","0","2","2","0","3","1","2","-2"
"199847","Wake Forest University","2018","Tenured, associate professors","185","107","78","2","2","0","17","12","5","7","5","2","14","6","8","1","1","0","141","78","63","0","0","0","2","2","0","1","1","0","-2"
"199847","Wake Forest University","2018","Tenured, assistant professors","2","2","0","0","0","0","0","0","0","0","0","0","0","0","0","0","0","0","2","2","0","0","0","0","0","0","0","0","0","0","-2"
"199847","Wake Forest University","2018","Tenured, instructors","3","1","2","0","0","0","0","0","0","0","0","0","0","0","0","0","0","0","2","0","2","0","0","0","1","1","0","0","0","0","-2"
"199847","Wake Forest University","2018","Tenured, no academic rank","24","20","4","0","0","0","1","1","0","2","2","0","0","0","0","0","0","0","21","17","4","0","0","0","0","0","0","0","0","0","-2"
"199847","Wake Forest University","2018","On-Tenure track total","173","84","89","0","0","0","20","17","3","14","2","12","6","4","2","1","1","0","110","50","60","2","1","1","5","2","3","15","7","8","-2"
"199847","Wake Forest University","2018","On-tenure track, professors","3","1","2","0","0","0","1","1","0","0","0","0","0","0","0","0","0","0","2","0","2","0","0","0","0","0","0","0","0","0","-2"
"199847","Wake Forest University","2018","On-tenure track, associate professors","20","14","6","0","0","0","6","6","0","0","0","0","1","1","0","0","0","0","11","5","6","1","1","0","0","0","0","1","1","0","-2"
"199847","Wake Forest University","2018","On-tenure track, assistant professors","144","66","78","0","0","0","12","10","2","13","2","11","5","3","2","1","1","0","94","42","52","1","0","1","4","2","2","14","6","8","-2"
"199847","Wake Forest University","2018","On-tenure track, instructors","6","3","3","0","0","0","1","0","1","1","0","1","0","0","0","0","0","0","3","3","0","0","0","0","1","0","1","0","0","0","-2"
"199847","Wake Forest University","2018","Not on tenure track/No tenure system system total","1173","685","488","6","4","2","142","84","58","52","16","36","40","16","24","2","0","2","882","536","346","10","4","6","4","2","2","35","23","12","-2"
"199847","Wake Forest University","2018","Not on tenure/no tenure system, professors","131","101","30","0","0","0","12","10","2","1","1","0","4","1","3","0","0","0","111","86","25","0","0","0","0","0","0","3","3","0","-2"
"199847","Wake Forest University","2018","Not on tenure/no tenure system, associate professors","226","150","76","2","1","1","24","16","8","10","3","7","5","3","2","0","0","0","182","126","56","1","0","1","0","0","0","2","1","1","-2"
"199847","Wake Forest University","2018","Not on tenure/no tenure system, assistant professors","523","276","247","2","2","0","86","49","37","24","8","16","20","9","11","2","0","2","370","197","173","9","4","5","0","0","0","10","7","3","-2"
"199847","Wake Forest University","2018","Not on tenure/no tenure system, instructors","225","113","112","1","1","0","13","5","8","15","4","11","11","3","8","0","0","0","163","88","75","0","0","0","4","2","2","18","10","8","-2"
"199847","Wake Forest University","2018","Not on tenure/no tenure system, lecturers","36","22","14","0","0","0","5","2","3","0","0","0","0","0","0","0","0","0","29","18","11","0","0","0","0","0","0","2","2","0","-2"
"199847","Wake Forest University","2018","Not on tenure/no tenure system, no academic rank","32","23","9","1","0","1","2","2","0","2","0","2","0","0","0","0","0","0","27","21","6","0","0","0","0","0","0","0","0","0","-2"
"200280","University of North Dakota","2018","Tenured total","323","219","104","3","2","1","14","11","3","3","3","0","2","1","1","0","0","0","236","155","81","4","1","3","4","4","0","57","42","15","-2"
"200280","University of North Dakota","2018","Tenured, professors","164","114","50","2","2","0","10","9","1","2","2","0","0","0","0","0","0","0","126","84","42","2","1","1","2","2","0","20","14","6","-2"
"200280","University of North Dakota","2018","Tenured, associate professors","153","100","53","1","0","1","4","2","2","1","1","0","1","0","1","0","0","0","106","68","38","2","0","2","2","2","0","36","27","9","-2"
"200280","University of North Dakota","2018","Tenured, assistant professors","6","5","1","0","0","0","0","0","0","0","0","0","1","1","0","0","0","0","4","3","1","0","0","0","0","0","0","1","1","0","-2"
"200280","University of North Dakota","2018","On-Tenure track total","75","50","25","0","0","0","7","6","1","0","0","0","0","0","0","0","0","0","41","26","15","1","0","1","1","1","0","25","17","8","-2"
"200280","University of North Dakota","2018","On-tenure track, associate professors","4","3","1","0","0","0","0","0","0","0","0","0","0","0","0","0","0","0","3","2","1","0","0","0","0","0","0","1","1","0","-2"
"200280","University of North Dakota","2018","On-tenure track, assistant professors","71","47","24","0","0","0","7","6","1","0","0","0","0","0","0","0","0","0","38","24","14","1","0","1","1","1","0","24","16","8","-2"
"200280","University of North Dakota","2018","Not on tenure track/No tenure system system total","274","136","138","3","1","2","9","2","7","4","3","1","1","0","1","0","0","0","217","103","114","4","1","3","2","2","0","34","24","10","-2"
"200280","University of North Dakota","2018","Not on tenure/no tenure system, professors","7","3","4","0","0","0","0","0","0","0","0","0","0","0","0","0","0","0","6","3","3","1","0","1","0","0","0","0","0","0","-2"
"200280","University of North Dakota","2018","Not on tenure/no tenure system, associate professors","38","17","21","1","0","1","0","0","0","0","0","0","0","0","0","0","0","0","35","15","20","0","0","0","1","1","0","1","1","0","-2"
"200280","University of North Dakota","2018","Not on tenure/no tenure system, assistant professors","91","38","53","2","1","1","6","2","4","3","3","0","1","0","1","0","0","0","67","24","43","2","1","1","1","1","0","9","6","3","-2"
"200280","University of North Dakota","2018","Not on tenure/no tenure system, instructors","62","29","33","0","0","0","2","0","2","1","0","1","0","0","0","0","0","0","55","27","28","0","0","0","0","0","0","4","2","2","-2"
"200280","University of North Dakota","2018","Not on tenure/no tenure system, lecturers","48","34","14","0","0","0","0","0","0","0","0","0","0","0","0","0","0","0","43","32","11","1","0","1","0","0","0","4","2","2","-2"
"200280","University of North Dakota","2018","Not on tenure/no tenure system, no academic rank","28","15","13","0","0","0","1","0","1","0","0","0","0","0","0","0","0","0","11","2","9","0","0","0","0","0","0","16","13","3","-2"
"201885","University of Cincinnati-Main Campus","2018","Tenured total","768","500","268","1","1","0","127","89","38","30","14","16","19","9","10","1","0","1","574","375","199","1","1","0","2","1","1","13","10","3","-2"
"201885","University of Cincinnati-Main Campus","2018","Tenured, professors","432","315","117","0","0","0","78","62","16","11","8","3","7","5","2","0","0","0","334","239","95","0","0","0","0","0","0","2","1","1","-2"
"201885","University of Cincinnati-Main Campus","2018","Tenured, associate professors","332","184","148","1","1","0","49","27","22","19","6","13","12","4","8","1","0","1","236","135","101","1","1","0","2","1","1","11","9","2","-2"
"201885","University of Cincinnati-Main Campus","2018","Tenured, assistant professors","4","1","3","0","0","0","0","0","0","0","0","0","0","0","0","0","0","0","4","1","3","0","0","0","0","0","0","0","0","0","-2"
"201885","University of Cincinnati-Main Campus","2018","On-Tenure track total","245","145","100","0","0","0","34","24","10","24","10","14","13","8","5","0","0","0","133","73","60","1","0","1","2","0","2","38","30","8","-2"
"201885","University of Cincinnati-Main Campus","2018","On-tenure track, professors","3","2","1","0","0","0","0","0","0","0","0","0","0","0","0","0","0","0","3","2","1","0","0","0","0","0","0","0","0","0","-2"
"201885","University of Cincinnati-Main Campus","2018","On-tenure track, associate professors","18","7","11","0","0","0","4","3","1","0","0","0","2","0","2","0","0","0","11","4","7","0","0","0","1","0","1","0","0","0","-2"
"201885","University of Cincinnati-Main Campus","2018","On-tenure track, assistant professors","224","136","88","0","0","0","30","21","9","24","10","14","11","8","3","0","0","0","119","67","52","1","0","1","1","0","1","38","30","8","-2"
"201885","University of Cincinnati-Main Campus","2018","Not on tenure track/No tenure system system total","1200","601","599","1","1","0","131","66","65","51","26","25","30","12","18","0","0","0","888","436","452","12","7","5","18","12","6","69","41","28","-2"
"201885","University of Cincinnati-Main Campus","2018","Not on tenure/no tenure system, professors","141","82","59","0","0","0","18","12","6","6","5","1","3","1","2","0","0","0","111","62","49","0","0","0","0","0","0","3","2","1","-2"
"201885","University of Cincinnati-Main Campus","2018","Not on tenure/no tenure system, associate professors","284","156","128","1","1","0","33","17","16","12","5","7","8","4","4","0","0","0","222","124","98","1","1","0","1","0","1","6","4","2","-2"
"201885","University of Cincinnati-Main Campus","2018","Not on tenure/no tenure system, assistant professors","610","297","313","0","0","0","72","34","38","28","13","15","14","5","9","0","0","0","417","199","218","6","3","3","15","10","5","58","33","25","-2"
"201885","University of Cincinnati-Main Campus","2018","Not on tenure/no tenure system, instructors","159","60","99","0","0","0","7","2","5","5","3","2","5","2","3","0","0","0","133","46","87","5","3","2","2","2","0","2","2","0","-2"
"201885","University of Cincinnati-Main Campus","2018","Not on tenure/no tenure system, no academic rank","6","6","0","0","0","0","1","1","0","0","0","0","0","0","0","0","0","0","5","5","0","0","0","0","0","0","0","0","0","0","-2"
"204796","Ohio State University-Main Campus","2018","Tenured total","1833","1194","639","2","1","1","260","189","71","64","36","28","63","40","23","0","0","0","1317","845","472","14","9","5","60","41","19","53","33","20","-2"
"204796","Ohio State University-Main Campus","2018","Tenured, professors","1049","761","288","1","0","1","143","120","23","23","15","8","32","23","9","0","0","0","769","546","223","10","7","3","35","26","9","36","24","12","-2"
"204796","Ohio State University-Main Campus","2018","Tenured, associate professors","767","425","342","1","1","0","117","69","48","39","21","18","31","17","14","0","0","0","533","291","242","4","2","2","25","15","10","17","9","8","-2"
"204796","Ohio State University-Main Campus","2018","Tenured, assistant professors","16","8","8","0","0","0","0","0","0","2","0","2","0","0","0","0","0","0","14","8","6","0","0","0","0","0","0","0","0","0","-2"
"204796","Ohio State University-Main Campus","2018","Tenured, instructors","1","0","1","0","0","0","0","0","0","0","0","0","0","0","0","0","0","0","1","0","1","0","0","0","0","0","0","0","0","0","-2"
"204796","Ohio State University-Main Campus","2018","On-Tenure track total","646","356","290","1","0","1","100","68","32","38","21","17","35","15","20","1","1","0","338","181","157","13","6","7","53","19","34","67","45","22","-2"
"204796","Ohio State University-Main Campus","2018","On-tenure track, professors","4","3","1","0","0","0","1","1","0","0","0","0","0","0","0","0","0","0","2","1","1","0","0","0","0","0","0","1","1","0","-2"
"204796","Ohio State University-Main Campus","2018","On-tenure track, associate professors","27","19","8","0","0","0","6","5","1","1","1","0","2","0","2","0","0","0","12","8","4","1","1","0","1","0","1","4","4","0","-2"
"204796","Ohio State University-Main Campus","2018","On-tenure track, assistant professors","605","329","276","1","0","1","93","62","31","37","20","17","31","14","17","1","1","0","318","169","149","12","5","7","51","19","32","61","39","22","-2"
"204796","Ohio State University-Main Campus","2018","On-tenure track, instructors","10","5","5","0","0","0","0","0","0","0","0","0","2","1","1","0","0","0","6","3","3","0","0","0","1","0","1","1","1","0","-2"
"204796","Ohio State University-Main Campus","2018","Not on tenure track/No tenure system system total","1557","792","765","1","0","1","233","99","134","57","25","32","57","29","28","1","1","0","1042","540","502","8","3","5","79","48","31","79","47","32","-2"
"204796","Ohio State University-Main Campus","2018","Not on tenure/no tenure system, professors","188","121","67","0","0","0","18","9","9","6","2","4","5","4","1","1","1","0","146","94","52","0","0","0","7","6","1","5","5","0","-2"
"204796","Ohio State University-Main Campus","2018","Not on tenure/no tenure system, associate professors","346","192","154","1","0","1","37","23","14","14","6","8","15","9","6","0","0","0","246","129","117","1","0","1","21","18","3","11","7","4","-2"
"204796","Ohio State University-Main Campus","2018","Not on tenure/no tenure system, assistant professors","1023","479","544","0","0","0","178","67","111","37","17","20","37","16","21","0","0","0","650","317","333","7","3","4","51","24","27","63","35","28","-2"
"204857","Ohio University-Main Campus","2018","Tenured total","535","351","184","3","2","1","56","42","14","27","17","10","25","15","10","0","0","0","404","263","141","4","1","3","14","9","5","2","2","0","-2"
"204857","Ohio University-Main Campus","2018","Tenured, professors","254","177","77","1","1","0","25","22","3","9","6","3","14","8","6","0","0","0","199","136","63","2","1","1","4","3","1","0","0","0","-2"
"204857","Ohio University-Main Campus","2018","Tenured, associate professors","279","172","107","2","1","1","31","20","11","18","11","7","11","7","4","0","0","0","203","125","78","2","0","2","10","6","4","2","2","0","-2"
"204857","Ohio University-Main Campus","2018","Tenured, assistant professors","2","2","0","0","0","0","0","0","0","0","0","0","0","0","0","0","0","0","2","2","0","0","0","0","0","0","0","0","0","0","-2"
"204857","Ohio University-Main Campus","2018","On-Tenure track total","193","111","82","1","0","1","23","14","9","7","2","5","6","5","1","0","0","0","113","67","46","3","1","2","12","8","4","28","14","14","-2"
"204857","Ohio University-Main Campus","2018","On-tenure track, associate professors","13","11","2","0","0","0","3","2","1","0","0","0","0","0","0","0","0","0","10","9","1","0","0","0","0","0","0","0","0","0","-2"
"204857","Ohio University-Main Campus","2018","On-tenure track, assistant professors","180","100","80","1","0","1","20","12","8","7","2","5","6","5","1","0","0","0","103","58","45","3","1","2","12","8","4","28","14","14","-2"
"204857","Ohio University-Main Campus","2018","Not on tenure track/No tenure system system total","335","144","191","0","0","0","17","8","9","10","6","4","8","3","5","0","0","0","267","109","158","3","2","1","10","4","6","20","12","8","-2"
"204857","Ohio University-Main Campus","2018","Not on tenure/no tenure system, instructors","7","4","3","0","0","0","1","0","1","0","0","0","0","0","0","0","0","0","6","4","2","0","0","0","0","0","0","0","0","0","-2"
"204857","Ohio University-Main Campus","2018","Not on tenure/no tenure system, lecturers","220","95","125","0","0","0","11","5","6","7","5","2","5","1","4","0","0","0","164","66","98","3","2","1","10","4","6","20","12","8","-2"
"204857","Ohio University-Main Campus","2018","Not on tenure/no tenure system, no academic rank","108","45","63","0","0","0","5","3","2","3","1","2","3","2","1","0","0","0","97","39","58","0","0","0","0","0","0","0","0","0","-2"
"207500","University of Oklahoma-Norman Campus","2018","Tenured total","687","476","211","11","7","4","67","50","17","16","8","8","16","12","4","0","0","0","515","355","160","7","4","3","19","14","5","36","26","10","-2"
"207500","University of Oklahoma-Norman Campus","2018","Tenured, professors","383","285","98","5","3","2","50","41","9","5","2","3","8","6","2","0","0","0","289","213","76","3","1","2","6","6","0","17","13","4","-2"
"207500","University of Oklahoma-Norman Campus","2018","Tenured, associate professors","304","191","113","6","4","2","17","9","8","11","6","5","8","6","2","0","0","0","226","142","84","4","3","1","13","8","5","19","13","6","-2"
"207500","University of Oklahoma-Norman Campus","2018","On-Tenure track total","252","144","108","4","3","1","38","23","15","3","2","1","9","5","4","0","0","0","147","77","70","6","2","4","8","4","4","37","28","9","-2"
"207500","University of Oklahoma-Norman Campus","2018","On-tenure track, associate professors","15","6","9","1","0","1","5","2","3","1","0","1","0","0","0","0","0","0","8","4","4","0","0","0","0","0","0","0","0","0","-2"
"207500","University of Oklahoma-Norman Campus","2018","On-tenure track, assistant professors","237","138","99","3","3","0","33","21","12","2","2","0","9","5","4","0","0","0","139","73","66","6","2","4","8","4","4","37","28","9","-2"
"207500","University of Oklahoma-Norman Campus","2018","Not on tenure track/No tenure system system total","337","161","176","13","7","6","8","2","6","9","5","4","12","1","11","1","0","1","253","122","131","8","4","4","6","4","2","27","16","11","-2"
"207500","University of Oklahoma-Norman Campus","2018","Not on tenure/no tenure system, professors","11","7","4","0","0","0","1","1","0","0","0","0","0","0","0","0","0","0","8","6","2","0","0","0","0","0","0","2","0","2","-2"
"207500","University of Oklahoma-Norman Campus","2018","Not on tenure/no tenure system, associate professors","23","12","11","0","0","0","1","0","1","0","0","0","0","0","0","1","0","1","20","11","9","0","0","0","0","0","0","1","1","0","-2"
"207500","University of Oklahoma-Norman Campus","2018","Not on tenure/no tenure system, assistant professors","72","40","32","3","2","1","3","1","2","2","1","1","1","0","1","0","0","0","58","34","24","1","0","1","2","1","1","2","1","1","-2"
"207500","University of Oklahoma-Norman Campus","2018","Not on tenure/no tenure system, instructors","130","47","83","8","4","4","3","0","3","7","4","3","11","1","10","0","0","0","85","31","54","4","1","3","2","1","1","10","5","5","-2"
"207500","University of Oklahoma-Norman Campus","2018","Not on tenure/no tenure system, lecturers","101","55","46","2","1","1","0","0","0","0","0","0","0","0","0","0","0","0","82","40","42","3","3","0","2","2","0","12","9","3","-2"
"207971","University of Tulsa","2018","Tenured total","188","149","39","4","3","1","13","13","0","2","1","1","3","3","0","0","0","0","156","121","35","0","0","0","0","0","0","10","8","2","-2"
"207971","University of Tulsa","2018","Tenured, professors","110","90","20","2","2","0","9","9","0","2","1","1","2","2","0","0","0","0","94","75","19","0","0","0","0","0","0","1","1","0","-2"
"207971","University of Tulsa","2018","Tenured, associate professors","78","59","19","2","1","1","4","4","0","0","0","0","1","1","0","0","0","0","62","46","16","0","0","0","0","0","0","9","7","2","-2"
"207971","University of Tulsa","2018","On-Tenure track total","72","37","35","1","0","1","13","5","8","3","1","2","2","1","1","0","0","0","48","28","20","2","1","1","1","0","1","2","1","1","-2"
"207971","University of Tulsa","2018","On-tenure track, associate professors","2","2","0","0","0","0","0","0","0","0","0","0","0","0","0","0","0","0","2","2","0","0","0","0","0","0","0","0","0","0","-2"
"207971","University of Tulsa","2018","On-tenure track, assistant professors","70","35","35","1","0","1","13","5","8","3","1","2","2","1","1","0","0","0","46","26","20","2","1","1","1","0","1","2","1","1","-2"
"207971","University of Tulsa","2018","Not on tenure track/No tenure system system total","96","40","56","7","2","5","4","2","2","1","0","1","4","0","4","1","0","1","74","34","40","4","1","3","0","0","0","1","1","0","-2"
"207971","University of Tulsa","2018","Not on tenure/no tenure system, professors","8","3","5","1","0","1","0","0","0","0","0","0","1","0","1","1","0","1","5","3","2","0","0","0","0","0","0","0","0","0","-2"
"207971","University of Tulsa","2018","Not on tenure/no tenure system, associate professors","19","8","11","2","0","2","0","0","0","0","0","0","0","0","0","0","0","0","17","8","9","0","0","0","0","0","0","0","0","0","-2"
"207971","University of Tulsa","2018","Not on tenure/no tenure system, assistant professors","48","20","28","2","2","0","3","1","2","1","0","1","0","0","0","0","0","0","39","16","23","2","0","2","0","0","0","1","1","0","-2"
"207971","University of Tulsa","2018","Not on tenure/no tenure system, instructors","21","9","12","2","0","2","1","1","0","0","0","0","3","0","3","0","0","0","13","7","6","2","1","1","0","0","0","0","0","0","-2"
"209542","Oregon State University","2018","Tenured total","626","426","200","2","2","0","84","60","24","6","4","2","38","26","12","1","1","0","449","300","149","6","4","2","30","21","9","10","8","2","209542"
"209542","Oregon State University","2018","Tenured, professors","351","259","92","0","0","0","41","34","7","4","2","2","14","11","3","1","1","0","269","197","72","2","1","1","17","11","6","3","2","1","209542"
"209542","Oregon State University","2018","Tenured, associate professors","271","165","106","2","2","0","43","26","17","2","2","0","22","14","8","0","0","0","178","102","76","4","3","1","13","10","3","7","6","1","209542"
"209542","Oregon State University","2018","Tenured, assistant professors","1","1","0","0","0","0","0","0","0","0","0","0","1","1","0","0","0","0","0","0","0","0","0","0","0","0","0","0","0","0","209542"
"209542","Oregon State University","2018","Tenured, instructors","3","1","2","0","0","0","0","0","0","0","0","0","1","0","1","0","0","0","2","1","1","0","0","0","0","0","0","0","0","0","209542"
"209542","Oregon State University","2018","On-Tenure track total","272","158","114","1","1","0","23","18","5","3","2","1","9","5","4","0","0","0","142","72","70","3","2","1","43","27","16","48","31","17","209542"
"209542","Oregon State University","2018","On-tenure track, professors","1","1","0","0","0","0","0","0","0","0","0","0","0","0","0","0","0","0","1","1","0","0","0","0","0","0","0","0","0","0","209542"
"209542","Oregon State University","2018","On-tenure track, associate professors","9","5","4","0","0","0","0","0","0","0","0","0","0","0","0","0","0","0","8","4","4","0","0","0","0","0","0","1","1","0","209542"
"209542","Oregon State University","2018","On-tenure track, assistant professors","262","152","110","1","1","0","23","18","5","3","2","1","9","5","4","0","0","0","133","67","66","3","2","1","43","27","16","47","30","17","209542"
"209542","Oregon State University","2018","Not on tenure track/No tenure system system total","514","250","264","4","2","2","20","8","12","5","2","3","28","15","13","2","1","1","398","192","206","12","2","10","24","12","12","21","16","5","209542"
"209542","Oregon State University","2018","Not on tenure/no tenure system, professors","7","5","2","0","0","0","0","0","0","1","0","1","0","0","0","0","0","0","5","4","1","0","0","0","1","1","0","0","0","0","209542"
"209542","Oregon State University","2018","Not on tenure/no tenure system, associate professors","29","14","15","0","0","0","4","1","3","0","0","0","2","1","1","0","0","0","22","11","11","0","0","0","0","0","0","1","1","0","209542"
"209542","Oregon State University","2018","Not on tenure/no tenure system, assistant professors","49","23","26","0","0","0","2","2","0","1","1","0","4","2","2","0","0","0","30","12","18","2","0","2","5","3","2","5","3","2","209542"
"209542","Oregon State University","2018","Not on tenure/no tenure system, instructors","428","208","220","4","2","2","14","5","9","3","1","2","22","12","10","2","1","1","340","165","175","10","2","8","18","8","10","15","12","3","209542"
"209542","Oregon State University","2018","Not on tenure/no tenure system, lecturers","1","0","1","0","0","0","0","0","0","0","0","0","0","0","0","0","0","0","1","0","1","0","0","0","0","0","0","0","0","0","209542"
"211361","California University of Pennsylvania","2018","Tenured total","187","98","89","0","0","0","9","5","4","11","5","6","2","2","0","0","0","0","164","86","78","1","0","1","0","0","0","0","0","0","-2"
"211361","California University of Pennsylvania","2018","Tenured, professors","97","52","45","0","0","0","4","4","0","5","2","3","0","0","0","0","0","0","87","46","41","1","0","1","0","0","0","0","0","0","-2"
"211361","California University of Pennsylvania","2018","Tenured, associate professors","63","32","31","0","0","0","5","1","4","4","2","2","1","1","0","0","0","0","53","28","25","0","0","0","0","0","0","0","0","0","-2"
"211361","California University of Pennsylvania","2018","Tenured, assistant professors","26","14","12","0","0","0","0","0","0","2","1","1","1","1","0","0","0","0","23","12","11","0","0","0","0","0","0","0","0","0","-2"
"211361","California University of Pennsylvania","2018","Tenured, instructors","1","0","1","0","0","0","0","0","0","0","0","0","0","0","0","0","0","0","1","0","1","0","0","0","0","0","0","0","0","0","-2"
"211361","California University of Pennsylvania","2018","On-Tenure track total","51","21","30","0","0","0","4","1","3","8","3","5","2","1","1","0","0","0","33","12","21","0","0","0","0","0","0","4","4","0","-2"
"211361","California University of Pennsylvania","2018","On-tenure track, associate professors","8","5","3","0","0","0","1","1","0","1","0","1","0","0","0","0","0","0","5","3","2","0","0","0","0","0","0","1","1","0","-2"
"211361","California University of Pennsylvania","2018","On-tenure track, assistant professors","42","16","26","0","0","0","3","0","3","7","3","4","2","1","1","0","0","0","27","9","18","0","0","0","0","0","0","3","3","0","-2"
"211361","California University of Pennsylvania","2018","On-tenure track, instructors","1","0","1","0","0","0","0","0","0","0","0","0","0","0","0","0","0","0","1","0","1","0","0","0","0","0","0","0","0","0","-2"
"211361","California University of Pennsylvania","2018","Not on tenure track/No tenure system system total","36","12","24","0","0","0","0","0","0","2","0","2","0","0","0","0","0","0","34","12","22","0","0","0","0","0","0","0","0","0","-2"
"211361","California University of Pennsylvania","2018","Not on tenure/no tenure system, associate professors","1","0","1","0","0","0","0","0","0","0","0","0","0","0","0","0","0","0","1","0","1","0","0","0","0","0","0","0","0","0","-2"
"211361","California University of Pennsylvania","2018","Not on tenure/no tenure system, assistant professors","10","4","6","0","0","0","0","0","0","1","0","1","0","0","0","0","0","0","9","4","5","0","0","0","0","0","0","0","0","0","-2"
"211361","California University of Pennsylvania","2018","Not on tenure/no tenure system, instructors","25","8","17","0","0","0","0","0","0","1","0","1","0","0","0","0","0","0","24","8","16","0","0","0","0","0","0","0","0","0","-2"
"212054","Drexel University","2018","Tenured total","473","297","176","1","1","0","80","56","24","21","15","6","11","6","5","0","0","0","330","203","127","4","2","2","16","11","5","10","3","7","-2"
"212054","Drexel University","2018","Tenured, professors","263","196","67","0","0","0","46","41","5","13","10","3","5","3","2","0","0","0","186","132","54","1","1","0","9","8","1","3","1","2","-2"
"212054","Drexel University","2018","Tenured, associate professors","208","100","108","1","1","0","34","15","19","8","5","3","6","3","3","0","0","0","142","70","72","3","1","2","7","3","4","7","2","5","-2"
"212054","Drexel University","2018","Tenured, assistant professors","2","1","1","0","0","0","0","0","0","0","0","0","0","0","0","0","0","0","2","1","1","0","0","0","0","0","0","0","0","0","-2"
"212054","Drexel University","2018","On-Tenure track total","195","116","79","0","0","0","18","13","5","10","6","4","9","7","2","1","0","1","119","68","51","4","0","4","7","2","5","27","20","7","-2"
"212054","Drexel University","2018","On-tenure track, professors","21","17","4","0","0","0","2","2","0","0","0","0","1","1","0","0","0","0","18","14","4","0","0","0","0","0","0","0","0","0","-2"
"212054","Drexel University","2018","On-tenure track, associate professors","27","15","12","0","0","0","1","1","0","0","0","0","2","1","1","0","0","0","24","13","11","0","0","0","0","0","0","0","0","0","-2"
"212054","Drexel University","2018","On-tenure track, assistant professors","147","84","63","0","0","0","15","10","5","10","6","4","6","5","1","1","0","1","77","41","36","4","0","4","7","2","5","27","20","7","-2"
"212054","Drexel University","2018","Not on tenure track/No tenure system system total","746","338","408","1","0","1","69","29","40","37","14","23","21","12","9","1","1","0","557","246","311","6","3","3","13","9","4","41","24","17","-2"
"212054","Drexel University","2018","Not on tenure/no tenure system, instructors","746","338","408","1","0","1","69","29","40","37","14","23","21","12","9","1","1","0","557","246","311","6","3","3","13","9","4","41","24","17","-2"
"213598","Lincoln University","2018","Tenured total","50","35","15","6","6","0","0","0","0","27","19","8","0","0","0","0","0","0","17","10","7","0","0","0","0","0","0","0","0","0","-2"
"213598","Lincoln University","2018","Tenured, professors","26","20","6","1","1","0","0","0","0","17","14","3","0","0","0","0","0","0","8","5","3","0","0","0","0","0","0","0","0","0","-2"
"213598","Lincoln University","2018","Tenured, associate professors","23","14","9","5","5","0","0","0","0","10","5","5","0","0","0","0","0","0","8","4","4","0","0","0","0","0","0","0","0","0","-2"
"213598","Lincoln University","2018","Tenured, assistant professors","1","1","0","0","0","0","0","0","0","0","0","0","0","0","0","0","0","0","1","1","0","0","0","0","0","0","0","0","0","0","-2"
"213598","Lincoln University","2018","On-Tenure track total","40","19","21","0","0","0","2","2","0","15","6","9","0","0","0","0","0","0","12","4","8","2","1","1","9","6","3","0","0","0","-2"
"213598","Lincoln University","2018","On-tenure track, professors","1","0","1","0","0","0","0","0","0","0","0","0","0","0","0","0","0","0","1","0","1","0","0","0","0","0","0","0","0","0","-2"
"213598","Lincoln University","2018","On-tenure track, associate professors","2","2","0","0","0","0","1","1","0","0","0","0","0","0","0","0","0","0","1","1","0","0","0","0","0","0","0","0","0","0","-2"
"213598","Lincoln University","2018","On-tenure track, assistant professors","30","13","17","0","0","0","1","1","0","12","5","7","0","0","0","0","0","0","10","3","7","0","0","0","7","4","3","0","0","0","-2"
"213598","Lincoln University","2018","On-tenure track, instructors","1","1","0","0","0","0","0","0","0","0","0","0","0","0","0","0","0","0","0","0","0","1","1","0","0","0","0","0","0","0","-2"
"213598","Lincoln University","2018","On-tenure track, lecturers","6","3","3","0","0","0","0","0","0","3","1","2","0","0","0","0","0","0","0","0","0","1","0","1","2","2","0","0","0","0","-2"
"213598","Lincoln University","2018","Not on tenure track/No tenure system system total","7","4","3","0","0","0","0","0","0","2","1","1","0","0","0","0","0","0","2","1","1","0","0","0","3","2","1","0","0","0","-2"
"213598","Lincoln University","2018","Not on tenure/no tenure system, assistant professors","6","4","2","0","0","0","0","0","0","2","1","1","0","0","0","0","0","0","1","1","0","0","0","0","3","2","1","0","0","0","-2"
"213598","Lincoln University","2018","Not on tenure/no tenure system, lecturers","1","0","1","0","0","0","0","0","0","0","0","0","0","0","0","0","0","0","1","0","1","0","0","0","0","0","0","0","0","0","-2"
"214041","Millersville University of Pennsylvania","2018","Tenured total","228","123","105","0","0","0","19","11","8","11","8","3","14","5","9","0","0","0","182","97","85","1","1","0","1","1","0","0","0","0","-2"
"214041","Millersville University of Pennsylvania","2018","Tenured, professors","90","52","38","0","0","0","8","6","2","5","3","2","3","0","3","0","0","0","74","43","31","0","0","0","0","0","0","0","0","0","-2"
"214041","Millersville University of Pennsylvania","2018","Tenured, associate professors","110","58","52","0","0","0","10","5","5","4","3","1","8","3","5","0","0","0","87","46","41","1","1","0","0","0","0","0","0","0","-2"
"214041","Millersville University of Pennsylvania","2018","Tenured, assistant professors","28","13","15","0","0","0","1","0","1","2","2","0","3","2","1","0","0","0","21","8","13","0","0","0","1","1","0","0","0","0","-2"
"214041","Millersville University of Pennsylvania","2018","On-Tenure track total","54","23","31","1","1","0","2","1","1","3","0","3","3","1","2","0","0","0","39","17","22","0","0","0","3","1","2","3","2","1","-2"
"214041","Millersville University of Pennsylvania","2018","On-tenure track, associate professors","2","1","1","0","0","0","0","0","0","0","0","0","0","0","0","0","0","0","2","1","1","0","0","0","0","0","0","0","0","0","-2"
"214041","Millersville University of Pennsylvania","2018","On-tenure track, assistant professors","50","22","28","1","1","0","2","1","1","3","0","3","3","1","2","0","0","0","35","16","19","0","0","0","3","1","2","3","2","1","-2"
"214041","Millersville University of Pennsylvania","2018","On-tenure track, instructors","2","0","2","0","0","0","0","0","0","0","0","0","0","0","0","0","0","0","2","0","2","0","0","0","0","0","0","0","0","0","-2"
"214041","Millersville University of Pennsylvania","2018","Not on tenure track/No tenure system system total","7","1","6","0","0","0","1","0","1","0","0","0","1","0","1","0","0","0","2","1","1","0","0","0","3","0","3","0","0","0","-2"
"214041","Millersville University of Pennsylvania","2018","Not on tenure/no tenure system, assistant professors","4","0","4","0","0","0","1","0","1","0","0","0","1","0","1","0","0","0","1","0","1","0","0","0","1","0","1","0","0","0","-2"
"214041","Millersville University of Pennsylvania","2018","Not on tenure/no tenure system, instructors","3","1","2","0","0","0","0","0","0","0","0","0","0","0","0","0","0","0","1","1","0","0","0","0","2","0","2","0","0","0","-2"
"214777","Pennsylvania State University-Main Campus","2018","Tenured total","1344","938","406","5","5","0","183","145","38","52","28","24","52","34","18","0","0","0","945","649","296","7","4","3","83","57","26","17","16","1","-2"
"214777","Pennsylvania State University-Main Campus","2018","Tenured, professors","848","642","206","3","3","0","121","102","19","23","17","6","24","18","6","0","0","0","623","460","163","4","3","1","44","33","11","6","6","0","-2"
"214777","Pennsylvania State University-Main Campus","2018","Tenured, associate professors","496","296","200","2","2","0","62","43","19","29","11","18","28","16","12","0","0","0","322","189","133","3","1","2","39","24","15","11","10","1","-2"
"214777","Pennsylvania State University-Main Campus","2018","On-Tenure track total","502","267","235","3","3","0","52","25","27","16","6","10","14","7","7","0","0","0","234","117","117","3","2","1","89","48","41","91","59","32","-2"
"214777","Pennsylvania State University-Main Campus","2018","On-tenure track, professors","1","1","0","0","0","0","0","0","0","0","0","0","0","0","0","0","0","0","0","0","0","0","0","0","1","1","0","0","0","0","-2"
"214777","Pennsylvania State University-Main Campus","2018","On-tenure track, associate professors","33","22","11","0","0","0","6","4","2","1","1","0","0","0","0","0","0","0","20","13","7","0","0","0","5","3","2","1","1","0","-2"
"214777","Pennsylvania State University-Main Campus","2018","On-tenure track, assistant professors","468","244","224","3","3","0","46","21","25","15","5","10","14","7","7","0","0","0","214","104","110","3","2","1","83","44","39","90","58","32","-2"
"214777","Pennsylvania State University-Main Campus","2018","Not on tenure track/No tenure system system total","1028","492","536","0","0","0","47","19","28","32","13","19","37","15","22","0","0","0","778","384","394","11","7","4","80","39","41","43","15","28","-2"
"214777","Pennsylvania State University-Main Campus","2018","Not on tenure/no tenure system, professors","87","58","29","0","0","0","2","1","1","2","2","0","0","0","0","0","0","0","76","49","27","1","1","0","5","5","0","1","0","1","-2"
"214777","Pennsylvania State University-Main Campus","2018","Not on tenure/no tenure system, associate professors","197","91","106","0","0","0","11","6","5","5","4","1","3","1","2","0","0","0","161","72","89","4","3","1","10","4","6","3","1","2","-2"
"214777","Pennsylvania State University-Main Campus","2018","Not on tenure/no tenure system, assistant professors","399","186","213","0","0","0","18","6","12","16","3","13","10","7","3","0","0","0","295","145","150","1","1","0","37","14","23","22","10","12","-2"
"214777","Pennsylvania State University-Main Campus","2018","Not on tenure/no tenure system, instructors","133","60","73","0","0","0","3","1","2","5","3","2","3","0","3","0","0","0","104","49","55","2","1","1","13","5","8","3","1","2","-2"
"214777","Pennsylvania State University-Main Campus","2018","Not on tenure/no tenure system, lecturers","212","97","115","0","0","0","13","5","8","4","1","3","21","7","14","0","0","0","142","69","73","3","1","2","15","11","4","14","3","11","-2"
"217156","Brown University","2018","Tenured total","536","385","151","0","0","0","60","41","19","23","17","6","17","13","4","0","0","0","415","296","119","5","3","2","4","4","0","12","11","1","-2"
"217156","Brown University","2018","Tenured, professors","398","299","99","0","0","0","38","33","5","14","12","2","14","10","4","0","0","0","317","232","85","4","2","2","2","2","0","9","8","1","-2"
"217156","Brown University","2018","Tenured, associate professors","138","86","52","0","0","0","22","8","14","9","5","4","3","3","0","0","0","0","98","64","34","1","1","0","2","2","0","3","3","0","-2"
"217156","Brown University","2018","On-Tenure track total","147","94","53","1","0","1","15","10","5","14","6","8","16","9","7","0","0","0","72","50","22","5","2","3","7","4","3","17","13","4","-2"
"217156","Brown University","2018","On-tenure track, associate professors","2","2","0","0","0","0","0","0","0","0","0","0","0","0","0","0","0","0","1","1","0","0","0","0","0","0","0","1","1","0","-2"
"217156","Brown University","2018","On-tenure track, assistant professors","145","92","53","1","0","1","15","10","5","14","6","8","16","9","7","0","0","0","71","49","22","5","2","3","7","4","3","16","12","4","-2"
"217156","Brown University","2018","Not on tenure track/No tenure system system total","193","88","105","0","0","0","15","3","12","5","3","2","9","1","8","0","0","0","120","56","64","2","1","1","16","10","6","26","14","12","-2"
"217156","Brown University","2018","Not on tenure/no tenure system, professors","9","6","3","0","0","0","0","0","0","0","0","0","0","0","0","0","0","0","9","6","3","0","0","0","0","0","0","0","0","0","-2"
"217156","Brown University","2018","Not on tenure/no tenure system, associate professors","2","1","1","0","0","0","0","0","0","0","0","0","0","0","0","0","0","0","2","1","1","0","0","0","0","0","0","0","0","0","-2"
"217156","Brown University","2018","Not on tenure/no tenure system, assistant professors","11","4","7","0","0","0","1","0","1","0","0","0","0","0","0","0","0","0","9","3","6","1","1","0","0","0","0","0","0","0","-2"
"217156","Brown University","2018","Not on tenure/no tenure system, lecturers","73","28","45","0","0","0","8","3","5","2","1","1","3","0","3","0","0","0","53","20","33","1","0","1","4","3","1","2","1","1","-2"
"217156","Brown University","2018","Not on tenure/no tenure system, no academic rank","98","49","49","0","0","0","6","0","6","3","2","1","6","1","5","0","0","0","47","26","21","0","0","0","12","7","5","24","13","11","-2"
"217484","University of Rhode Island","2018","Tenured total","390","232","158","2","1","1","46","34","12","10","5","5","15","7","8","0","0","0","317","185","132","0","0","0","0","0","0","0","0","0","-2"
"217484","University of Rhode Island","2018","Tenured, professors","268","174","94","1","1","0","34","26","8","5","4","1","7","5","2","0","0","0","221","138","83","0","0","0","0","0","0","0","0","0","-2"
"217484","University of Rhode Island","2018","Tenured, associate professors","122","58","64","1","0","1","12","8","4","5","1","4","8","2","6","0","0","0","96","47","49","0","0","0","0","0","0","0","0","0","-2"
"217484","University of Rhode Island","2018","On-Tenure track total","174","80","94","1","0","1","28","13","15","10","7","3","5","2","3","0","0","0","104","44","60","0","0","0","0","0","0","26","14","12","-2"
"217484","University of Rhode Island","2018","On-tenure track, associate professors","15","9","6","0","0","0","3","2","1","1","1","0","0","0","0","0","0","0","11","6","5","0","0","0","0","0","0","0","0","0","-2"
"217484","University of Rhode Island","2018","On-tenure track, assistant professors","159","71","88","1","0","1","25","11","14","9","6","3","5","2","3","0","0","0","93","38","55","0","0","0","0","0","0","26","14","12","-2"
"217484","University of Rhode Island","2018","Not on tenure track/No tenure system system total","197","70","127","0","0","0","12","1","11","5","5","0","5","3","2","0","0","0","163","57","106","0","0","0","0","0","0","12","4","8","-2"
"217484","University of Rhode Island","2018","Not on tenure/no tenure system, professors","12","4","8","0","0","0","0","0","0","0","0","0","0","0","0","0","0","0","12","4","8","0","0","0","0","0","0","0","0","0","-2"
"217484","University of Rhode Island","2018","Not on tenure/no tenure system, associate professors","18","4","14","0","0","0","0","0","0","0","0","0","1","0","1","0","0","0","16","3","13","0","0","0","0","0","0","1","1","0","-2"
"217484","University of Rhode Island","2018","Not on tenure/no tenure system, assistant professors","21","6","15","0","0","0","0","0","0","2","2","0","0","0","0","0","0","0","19","4","15","0","0","0","0","0","0","0","0","0","-2"
"217484","University of Rhode Island","2018","Not on tenure/no tenure system, lecturers","146","56","90","0","0","0","12","1","11","3","3","0","4","3","1","0","0","0","116","46","70","0","0","0","0","0","0","11","3","8","-2"
"217819","College of Charleston","2018","Tenured total","320","189","131","0","0","0","15","12","3","12","5","7","17","7","10","0","0","0","258","149","109","4","4","0","14","12","2","0","0","0","-2"
"217819","College of Charleston","2018","Tenured, professors","144","91","53","0","0","0","4","4","0","3","1","2","7","3","4","0","0","0","118","72","46","2","2","0","10","9","1","0","0","0","-2"
"217819","College of Charleston","2018","Tenured, associate professors","175","98","77","0","0","0","11","8","3","9","4","5","10","4","6","0","0","0","139","77","62","2","2","0","4","3","1","0","0","0","-2"
"217819","College of Charleston","2018","Tenured, assistant professors","1","0","1","0","0","0","0","0","0","0","0","0","0","0","0","0","0","0","1","0","1","0","0","0","0","0","0","0","0","0","-2"
"217819","College of Charleston","2018","On-Tenure track total","117","60","57","0","0","0","2","1","1","7","2","5","8","5","3","0","0","0","88","43","45","5","3","2","1","0","1","6","6","0","-2"
"217819","College of Charleston","2018","On-tenure track, professors","3","1","2","0","0","0","1","0","1","0","0","0","0","0","0","0","0","0","2","1","1","0","0","0","0","0","0","0","0","0","-2"
"217819","College of Charleston","2018","On-tenure track, assistant professors","113","58","55","0","0","0","1","1","0","7","2","5","8","5","3","0","0","0","85","41","44","5","3","2","1","0","1","6","6","0","-2"
"217819","College of Charleston","2018","On-tenure track, instructors","1","1","0","0","0","0","0","0","0","0","0","0","0","0","0","0","0","0","1","1","0","0","0","0","0","0","0","0","0","0","-2"
"217819","College of Charleston","2018","Not on tenure track/No tenure system system total","97","37","60","0","0","0","4","3","1","3","1","2","4","1","3","1","1","0","78","30","48","1","0","1","0","0","0","6","1","5","-2"
"217819","College of Charleston","2018","Not on tenure/no tenure system, associate professors","5","2","3","0","0","0","0","0","0","1","0","1","0","0","0","0","0","0","4","2","2","0","0","0","0","0","0","0","0","0","-2"
"217819","College of Charleston","2018","Not on tenure/no tenure system, assistant professors","33","15","18","0","0","0","1","1","0","0","0","0","0","0","0","0","0","0","27","13","14","0","0","0","0","0","0","5","1","4","-2"
"217819","College of Charleston","2018","Not on tenure/no tenure system, instructors","59","20","39","0","0","0","3","2","1","2","1","1","4","1","3","1","1","0","47","15","32","1","0","1","0","0","0","1","0","1","-2"
"217873","Claflin University","2018","Tenured total","30","19","11","0","0","0","14","12","2","10","4","6","0","0","0","0","0","0","6","3","3","0","0","0","0","0","0","0","0","0","-2"
"217873","Claflin University","2018","Tenured, professors","15","9","6","0","0","0","8","7","1","6","2","4","0","0","0","0","0","0","1","0","1","0","0","0","0","0","0","0","0","0","-2"
"217873","Claflin University","2018","Tenured, associate professors","11","8","3","0","0","0","6","5","1","1","0","1","0","0","0","0","0","0","4","3","1","0","0","0","0","0","0","0","0","0","-2"
"217873","Claflin University","2018","Tenured, assistant professors","4","2","2","0","0","0","0","0","0","3","2","1","0","0","0","0","0","0","1","0","1","0","0","0","0","0","0","0","0","0","-2"
"217873","Claflin University","2018","On-Tenure track total","60","32","28","0","0","0","9","6","3","26","10","16","2","2","0","0","0","0","18","11","7","0","0","0","1","1","0","4","2","2","-2"
"217873","Claflin University","2018","On-tenure track, professors","1","0","1","0","0","0","0","0","0","0","0","0","0","0","0","0","0","0","1","0","1","0","0","0","0","0","0","0","0","0","-2"
"217873","Claflin University","2018","On-tenure track, associate professors","24","14","10","0","0","0","5","3","2","8","3","5","2","2","0","0","0","0","6","4","2","0","0","0","1","1","0","2","1","1","-2"
"217873","Claflin University","2018","On-tenure track, assistant professors","35","18","17","0","0","0","4","3","1","18","7","11","0","0","0","0","0","0","11","7","4","0","0","0","0","0","0","2","1","1","-2"
"217873","Claflin University","2018","Not on tenure track/No tenure system system total","22","12","10","0","0","0","1","1","0","17","10","7","0","0","0","0","0","0","4","1","3","0","0","0","0","0","0","0","0","0","-2"
"217873","Claflin University","2018","Not on tenure/no tenure system, associate professors","1","1","0","0","0","0","0","0","0","1","1","0","0","0","0","0","0","0","0","0","0","0","0","0","0","0","0","0","0","0","-2"
"217873","Claflin University","2018","Not on tenure/no tenure system, assistant professors","3","3","0","0","0","0","0","0","0","2","2","0","0","0","0","0","0","0","1","1","0","0","0","0","0","0","0","0","0","0","-2"
"217873","Claflin University","2018","Not on tenure/no tenure system, instructors","17","8","9","0","0","0","1","1","0","13","7","6","0","0","0","0","0","0","3","0","3","0","0","0","0","0","0","0","0","0","-2"
"217873","Claflin University","2018","Not on tenure/no tenure system, lecturers","1","0","1","0","0","0","0","0","0","1","0","1","0","0","0","0","0","0","0","0","0","0","0","0","0","0","0","0","0","0","-2"
"217882","Clemson University","2018","Tenured total","615","433","182","0","0","0","86","66","20","17","11","6","9","5","4","1","1","0","497","347","150","1","0","1","4","3","1","0","0","0","-2"
"217882","Clemson University","2018","Tenured, professors","335","263","72","0","0","0","51","44","7","9","7","2","3","2","1","0","0","0","267","207","60","1","0","1","4","3","1","0","0","0","-2"
"217882","Clemson University","2018","Tenured, associate professors","279","170","109","0","0","0","35","22","13","7","4","3","6","3","3","1","1","0","230","140","90","0","0","0","0","0","0","0","0","0","-2"
"217882","Clemson University","2018","Tenured, assistant professors","1","0","1","0","0","0","0","0","0","1","0","1","0","0","0","0","0","0","0","0","0","0","0","0","0","0","0","0","0","0","-2"
"217882","Clemson University","2018","On-Tenure track total","305","175","130","0","0","0","58","38","20","19","9","10","20","12","8","1","0","1","190","108","82","0","0","0","16","7","9","1","1","0","-2"
"217882","Clemson University","2018","On-tenure track, professors","1","1","0","0","0","0","0","0","0","0","0","0","0","0","0","0","0","0","1","1","0","0","0","0","0","0","0","0","0","0","-2"
"217882","Clemson University","2018","On-tenure track, associate professors","22","13","9","0","0","0","5","2","3","2","1","1","0","0","0","0","0","0","14","9","5","0","0","0","1","1","0","0","0","0","-2"
"217882","Clemson University","2018","On-tenure track, assistant professors","282","161","121","0","0","0","53","36","17","17","8","9","20","12","8","1","0","1","175","98","77","0","0","0","15","6","9","1","1","0","-2"
"217882","Clemson University","2018","Not on tenure track/No tenure system system total","380","173","207","0","0","0","18","8","10","21","4","17","15","3","12","0","0","0","308","149","159","1","0","1","15","8","7","2","1","1","-2"
"217882","Clemson University","2018","Not on tenure/no tenure system, professors","1","1","0","0","0","0","0","0","0","0","0","0","0","0","0","0","0","0","1","1","0","0","0","0","0","0","0","0","0","0","-2"
"217882","Clemson University","2018","Not on tenure/no tenure system, associate professors","1","0","1","0","0","0","0","0","0","0","0","0","0","0","0","0","0","0","1","0","1","0","0","0","0","0","0","0","0","0","-2"
"217882","Clemson University","2018","Not on tenure/no tenure system, instructors","4","1","3","0","0","0","1","0","1","0","0","0","0","0","0","0","0","0","3","1","2","0","0","0","0","0","0","0","0","0","-2"
"217882","Clemson University","2018","Not on tenure/no tenure system, lecturers","334","147","187","0","0","0","14","6","8","16","2","14","15","3","12","0","0","0","274","129","145","1","0","1","13","6","7","1","1","0","-2"
"217882","Clemson University","2018","Not on tenure/no tenure system, no academic rank","40","24","16","0","0","0","3","2","1","5","2","3","0","0","0","0","0","0","29","18","11","0","0","0","2","2","0","1","0","1","-2"
"218724","Coastal Carolina University","2018","Tenured total","210","133","77","0","0","0","11","7","4","11","6","5","5","4","1","0","0","0","183","116","67","0","0","0","0","0","0","0","0","0","-2"
"218724","Coastal Carolina University","2018","Tenured, professors","99","69","30","0","0","0","5","4","1","4","2","2","2","2","0","0","0","0","88","61","27","0","0","0","0","0","0","0","0","0","-2"
"218724","Coastal Carolina University","2018","Tenured, associate professors","110","64","46","0","0","0","6","3","3","7","4","3","3","2","1","0","0","0","94","55","39","0","0","0","0","0","0","0","0","0","-2"
"218724","Coastal Carolina University","2018","Tenured, assistant professors","1","0","1","0","0","0","0","0","0","0","0","0","0","0","0","0","0","0","1","0","1","0","0","0","0","0","0","0","0","0","-2"
"218724","Coastal Carolina University","2018","On-Tenure track total","119","61","58","0","0","0","9","8","1","8","1","7","1","1","0","0","0","0","100","50","50","0","0","0","1","1","0","0","0","0","-2"
"218724","Coastal Carolina University","2018","On-tenure track, associate professors","8","5","3","0","0","0","1","1","0","0","0","0","0","0","0","0","0","0","7","4","3","0","0","0","0","0","0","0","0","0","-2"
"218724","Coastal Carolina University","2018","On-tenure track, assistant professors","111","56","55","0","0","0","8","7","1","8","1","7","1","1","0","0","0","0","93","46","47","0","0","0","1","1","0","0","0","0","-2"
"218724","Coastal Carolina University","2018","Not on tenure track/No tenure system system total","161","79","82","0","0","0","2","2","0","5","1","4","3","1","2","0","0","0","150","75","75","1","0","1","0","0","0","0","0","0","-2"
"218724","Coastal Carolina University","2018","Not on tenure/no tenure system, assistant professors","3","3","0","0","0","0","1","1","0","0","0","0","0","0","0","0","0","0","2","2","0","0","0","0","0","0","0","0","0","0","-2"
"218724","Coastal Carolina University","2018","Not on tenure/no tenure system, instructors","8","5","3","0","0","0","0","0","0","0","0","0","1","1","0","0","0","0","7","4","3","0","0","0","0","0","0","0","0","0","-2"
"218724","Coastal Carolina University","2018","Not on tenure/no tenure system, lecturers","150","71","79","0","0","0","1","1","0","5","1","4","2","0","2","0","0","0","141","69","72","1","0","1","0","0","0","0","0","0","-2"
"219347","South Dakota School of Mines and Technology","2018","Tenured total","72","63","9","1","1","0","7","7","0","0","0","0","2","2","0","0","0","0","59","50","9","0","0","0","0","0","0","3","3","0","-2"
"219347","South Dakota School of Mines and Technology","2018","Tenured, professors","34","31","3","0","0","0","2","2","0","0","0","0","1","1","0","0","0","0","30","27","3","0","0","0","0","0","0","1","1","0","-2"
"219347","South Dakota School of Mines and Technology","2018","Tenured, associate professors","38","32","6","1","1","0","5","5","0","0","0","0","1","1","0","0","0","0","29","23","6","0","0","0","0","0","0","2","2","0","-2"
"219347","South Dakota School of Mines and Technology","2018","On-Tenure track total","42","31","11","0","0","0","3","3","0","1","1","0","0","0","0","0","0","0","29","19","10","0","0","0","0","0","0","9","8","1","-2"
"219347","South Dakota School of Mines and Technology","2018","On-tenure track, associate professors","2","1","1","0","0","0","0","0","0","0","0","0","0","0","0","0","0","0","2","1","1","0","0","0","0","0","0","0","0","0","-2"
"219347","South Dakota School of Mines and Technology","2018","On-tenure track, assistant professors","40","30","10","0","0","0","3","3","0","1","1","0","0","0","0","0","0","0","27","18","9","0","0","0","0","0","0","9","8","1","-2"
"219347","South Dakota School of Mines and Technology","2018","Not on tenure track/No tenure system system total","36","20","16","1","1","0","0","0","0","0","0","0","0","0","0","0","0","0","34","19","15","0","0","0","0","0","0","1","0","1","-2"
"219347","South Dakota School of Mines and Technology","2018","Not on tenure/no tenure system, professors","2","2","0","0","0","0","0","0","0","0","0","0","0","0","0","0","0","0","2","2","0","0","0","0","0","0","0","0","0","0","-2"
"219347","South Dakota School of Mines and Technology","2018","Not on tenure/no tenure system, associate professors","1","1","0","0","0","0","0","0","0","0","0","0","0","0","0","0","0","0","1","1","0","0","0","0","0","0","0","0","0","0","-2"
"219347","South Dakota School of Mines and Technology","2018","Not on tenure/no tenure system, assistant professors","4","2","2","0","0","0","0","0","0","0","0","0","0","0","0","0","0","0","4","2","2","0","0","0","0","0","0","0","0","0","-2"
"219347","South Dakota School of Mines and Technology","2018","Not on tenure/no tenure system, instructors","10","5","5","1","1","0","0","0","0","0","0","0","0","0","0","0","0","0","8","4","4","0","0","0","0","0","0","1","0","1","-2"
"219347","South Dakota School of Mines and Technology","2018","Not on tenure/no tenure system, lecturers","19","10","9","0","0","0","0","0","0","0","0","0","0","0","0","0","0","0","19","10","9","0","0","0","0","0","0","0","0","0","-2"
"221759","The University of Tennessee-Knoxville","2018","Tenured total","826","553","273","3","1","2","100","78","22","23","15","8","27","20","7","0","0","0","668","438","230","3","0","3","0","0","0","2","1","1","-2"
"221759","The University of Tennessee-Knoxville","2018","Tenured, professors","492","349","143","2","1","1","56","46","10","6","4","2","12","9","3","0","0","0","414","289","125","2","0","2","0","0","0","0","0","0","-2"
"221759","The University of Tennessee-Knoxville","2018","Tenured, associate professors","334","204","130","1","0","1","44","32","12","17","11","6","15","11","4","0","0","0","254","149","105","1","0","1","0","0","0","2","1","1","-2"
"221759","The University of Tennessee-Knoxville","2018","On-Tenure track total","303","162","141","1","1","0","23","12","11","26","11","15","16","9","7","0","0","0","194","102","92","4","1","3","0","0","0","39","26","13","-2"
"221759","The University of Tennessee-Knoxville","2018","On-tenure track, professors","9","6","3","0","0","0","1","1","0","2","0","2","0","0","0","0","0","0","6","5","1","0","0","0","0","0","0","0","0","0","-2"
"221759","The University of Tennessee-Knoxville","2018","On-tenure track, associate professors","22","9","13","0","0","0","4","3","1","2","0","2","1","0","1","0","0","0","14","5","9","0","0","0","0","0","0","1","1","0","-2"
"221759","The University of Tennessee-Knoxville","2018","On-tenure track, assistant professors","272","147","125","1","1","0","18","8","10","22","11","11","15","9","6","0","0","0","174","92","82","4","1","3","0","0","0","38","25","13","-2"
"221759","The University of Tennessee-Knoxville","2018","Not on tenure track/No tenure system system total","466","170","296","0","0","0","19","9","10","11","4","7","19","5","14","0","0","0","399","143","256","3","0","3","1","0","1","14","9","5","-2"
"221759","The University of Tennessee-Knoxville","2018","Not on tenure/no tenure system, professors","13","5","8","0","0","0","1","1","0","0","0","0","0","0","0","0","0","0","12","4","8","0","0","0","0","0","0","0","0","0","-2"
"221759","The University of Tennessee-Knoxville","2018","Not on tenure/no tenure system, associate professors","26","3","23","0","0","0","0","0","0","1","0","1","1","0","1","0","0","0","24","3","21","0","0","0","0","0","0","0","0","0","-2"
"221759","The University of Tennessee-Knoxville","2018","Not on tenure/no tenure system, assistant professors","71","17","54","0","0","0","4","3","1","3","0","3","2","2","0","0","0","0","59","12","47","0","0","0","0","0","0","3","0","3","-2"
"221759","The University of Tennessee-Knoxville","2018","Not on tenure/no tenure system, instructors","33","5","28","0","0","0","1","1","0","1","0","1","2","0","2","0","0","0","26","3","23","1","0","1","1","0","1","1","1","0","-2"
"221759","The University of Tennessee-Knoxville","2018","Not on tenure/no tenure system, lecturers","321","139","182","0","0","0","13","4","9","6","4","2","14","3","11","0","0","0","276","120","156","2","0","2","0","0","0","10","8","2","-2"
"221759","The University of Tennessee-Knoxville","2018","Not on tenure/no tenure system, no academic rank","2","1","1","0","0","0","0","0","0","0","0","0","0","0","0","0","0","0","2","1","1","0","0","0","0","0","0","0","0","0","-2"
"221768","The University of Tennessee-Martin","2018","Tenured total","153","98","55","0","0","0","3","2","1","7","4","3","2","1","1","0","0","0","141","91","50","0","0","0","0","0","0","0","0","0","-2"
"221768","The University of Tennessee-Martin","2018","Tenured, professors","85","60","25","0","0","0","1","0","1","4","2","2","1","1","0","0","0","0","79","57","22","0","0","0","0","0","0","0","0","0","-2"
"221768","The University of Tennessee-Martin","2018","Tenured, associate professors","56","32","24","0","0","0","1","1","0","3","2","1","1","0","1","0","0","0","51","29","22","0","0","0","0","0","0","0","0","0","-2"
"221768","The University of Tennessee-Martin","2018","Tenured, assistant professors","6","1","5","0","0","0","1","1","0","0","0","0","0","0","0","0","0","0","5","0","5","0","0","0","0","0","0","0","0","0","-2"
"221768","The University of Tennessee-Martin","2018","Tenured, instructors","6","5","1","0","0","0","0","0","0","0","0","0","0","0","0","0","0","0","6","5","1","0","0","0","0","0","0","0","0","0","-2"
"221768","The University of Tennessee-Martin","2018","On-Tenure track total","59","31","28","0","0","0","8","3","5","1","0","1","3","2","1","0","0","0","45","24","21","0","0","0","0","0","0","2","2","0","-2"
"221768","The University of Tennessee-Martin","2018","On-tenure track, associate professors","16","8","8","0","0","0","3","1","2","0","0","0","2","2","0","0","0","0","11","5","6","0","0","0","0","0","0","0","0","0","-2"
"221768","The University of Tennessee-Martin","2018","On-tenure track, assistant professors","42","22","20","0","0","0","5","2","3","1","0","1","1","0","1","0","0","0","33","18","15","0","0","0","0","0","0","2","2","0","-2"
"221768","The University of Tennessee-Martin","2018","On-tenure track, instructors","1","1","0","0","0","0","0","0","0","0","0","0","0","0","0","0","0","0","1","1","0","0","0","0","0","0","0","0","0","0","-2"
"221768","The University of Tennessee-Martin","2018","Not on tenure track/No tenure system system total","73","27","46","0","0","0","1","0","1","3","0","3","1","1","0","0","0","0","65","26","39","0","0","0","0","0","0","3","0","3","-2"
"221768","The University of Tennessee-Martin","2018","Not on tenure/no tenure system, assistant professors","1","1","0","0","0","0","0","0","0","0","0","0","0","0","0","0","0","0","1","1","0","0","0","0","0","0","0","0","0","0","-2"
"221768","The University of Tennessee-Martin","2018","Not on tenure/no tenure system, lecturers","72","26","46","0","0","0","1","0","1","3","0","3","1","1","0","0","0","0","64","25","39","0","0","0","0","0","0","3","0","3","-2"
"221838","Tennessee State University","2018","Tenured total","216","129","87","1","0","1","29","23","6","89","41","48","4","2","2","0","0","0","73","46","27","2","2","0","1","1","0","17","14","3","-2"
"221838","Tennessee State University","2018","Tenured, professors","105","71","34","0","0","0","20","17","3","41","22","19","3","1","2","0","0","0","32","22","10","2","2","0","0","0","0","7","7","0","-2"
"221838","Tennessee State University","2018","Tenured, associate professors","86","45","41","1","0","1","7","5","2","33","14","19","1","1","0","0","0","0","34","18","16","0","0","0","1","1","0","9","6","3","-2"
"221838","Tennessee State University","2018","Tenured, assistant professors","22","11","11","0","0","0","2","1","1","12","3","9","0","0","0","0","0","0","7","6","1","0","0","0","0","0","0","1","1","0","-2"
"221838","Tennessee State University","2018","Tenured, instructors","2","2","0","0","0","0","0","0","0","2","2","0","0","0","0","0","0","0","0","0","0","0","0","0","0","0","0","0","0","0","-2"
"221838","Tennessee State University","2018","Tenured, no academic rank","1","0","1","0","0","0","0","0","0","1","0","1","0","0","0","0","0","0","0","0","0","0","0","0","0","0","0","0","0","0","-2"
"221838","Tennessee State University","2018","On-Tenure track total","103","48","55","0","0","0","4","4","0","40","16","24","0","0","0","1","0","1","36","16","20","4","1","3","1","0","1","17","11","6","-2"
"221838","Tennessee State University","2018","On-tenure track, professors","2","0","2","0","0","0","0","0","0","2","0","2","0","0","0","0","0","0","0","0","0","0","0","0","0","0","0","0","0","0","-2"
"221838","Tennessee State University","2018","On-tenure track, associate professors","18","7","11","0","0","0","2","2","0","6","1","5","0","0","0","0","0","0","6","2","4","2","1","1","0","0","0","2","1","1","-2"
"221838","Tennessee State University","2018","On-tenure track, assistant professors","79","38","41","0","0","0","2","2","0","31","14","17","0","0","0","1","0","1","28","12","16","2","0","2","1","0","1","14","10","4","-2"
"221838","Tennessee State University","2018","On-tenure track, instructors","2","2","0","0","0","0","0","0","0","1","1","0","0","0","0","0","0","0","1","1","0","0","0","0","0","0","0","0","0","0","-2"
"221838","Tennessee State University","2018","On-tenure track, no academic rank","2","1","1","0","0","0","0","0","0","0","0","0","0","0","0","0","0","0","1","1","0","0","0","0","0","0","0","1","0","1","-2"
"221838","Tennessee State University","2018","Not on tenure track/No tenure system system total","25","10","15","0","0","0","1","0","1","11","5","6","0","0","0","0","0","0","12","5","7","1","0","1","0","0","0","0","0","0","-2"
"221838","Tennessee State University","2018","Not on tenure/no tenure system, instructors","3","2","1","0","0","0","0","0","0","2","1","1","0","0","0","0","0","0","1","1","0","0","0","0","0","0","0","0","0","0","-2"
"221838","Tennessee State University","2018","Not on tenure/no tenure system, no academic rank","22","8","14","0","0","0","1","0","1","9","4","5","0","0","0","0","0","0","11","4","7","1","0","1","0","0","0","0","0","0","-2"
"221999","Vanderbilt University","2018","Tenured total","625","443","182","2","1","1","43","32","11","31","18","13","18","13","5","0","0","0","490","353","137","1","1","0","37","24","13","3","1","2","-2"
"221999","Vanderbilt University","2018","Tenured, professors","419","320","99","0","0","0","27","23","4","21","14","7","11","8","3","0","0","0","341","261","80","0","0","0","18","14","4","1","0","1","-2"
"221999","Vanderbilt University","2018","Tenured, associate professors","206","123","83","2","1","1","16","9","7","10","4","6","7","5","2","0","0","0","149","92","57","1","1","0","19","10","9","2","1","1","-2"
"221999","Vanderbilt University","2018","On-Tenure track total","181","94","87","1","1","0","14","8","6","8","2","6","17","11","6","1","1","0","85","46","39","1","1","0","45","18","27","9","6","3","-2"
"221999","Vanderbilt University","2018","On-tenure track, associate professors","6","4","2","0","0","0","0","0","0","1","0","1","1","1","0","0","0","0","4","3","1","0","0","0","0","0","0","0","0","0","-2"
"221999","Vanderbilt University","2018","On-tenure track, assistant professors","175","90","85","1","1","0","14","8","6","7","2","5","16","10","6","1","1","0","81","43","38","1","1","0","45","18","27","9","6","3","-2"
"221999","Vanderbilt University","2018","Not on tenure track/No tenure system system total","497","180","317","1","0","1","18","6","12","25","8","17","17","2","15","0","0","0","356","124","232","3","1","2","57","26","31","20","13","7","-2"
"221999","Vanderbilt University","2018","Not on tenure/no tenure system, professors","54","27","27","0","0","0","3","3","0","2","1","1","1","0","1","0","0","0","45","22","23","0","0","0","3","1","2","0","0","0","-2"
"221999","Vanderbilt University","2018","Not on tenure/no tenure system, associate professors","64","34","30","1","0","1","3","0","3","5","4","1","1","0","1","0","0","0","47","27","20","0","0","0","6","2","4","1","1","0","-2"
"221999","Vanderbilt University","2018","Not on tenure/no tenure system, assistant professors","119","40","79","0","0","0","2","1","1","4","0","4","4","0","4","0","0","0","84","21","63","2","1","1","11","8","3","12","9","3","-2"
"221999","Vanderbilt University","2018","Not on tenure/no tenure system, instructors","56","7","49","0","0","0","1","0","1","7","0","7","0","0","0","0","0","0","45","6","39","0","0","0","3","1","2","0","0","0","-2"
"221999","Vanderbilt University","2018","Not on tenure/no tenure system, lecturers","192","71","121","0","0","0","7","2","5","6","3","3","11","2","9","0","0","0","129","48","81","1","0","1","31","13","18","7","3","4","-2"
"221999","Vanderbilt University","2018","Not on tenure/no tenure system, no academic rank","12","1","11","0","0","0","2","0","2","1","0","1","0","0","0","0","0","0","6","0","6","0","0","0","3","1","2","0","0","0","-2"
"224147","Texas A & M University-Corpus Christi","2018","Tenured total","161","102","59","1","1","0","18","13","5","4","4","0","25","13","12","0","0","0","108","69","39","2","1","1","2","0","2","1","1","0","-2"
"224147","Texas A & M University-Corpus Christi","2018","Tenured, professors","83","59","24","1","1","0","10","8","2","2","2","0","9","5","4","0","0","0","59","42","17","1","1","0","1","0","1","0","0","0","-2"
"224147","Texas A & M University-Corpus Christi","2018","Tenured, associate professors","76","43","33","0","0","0","8","5","3","2","2","0","15","8","7","0","0","0","48","27","21","1","0","1","1","0","1","1","1","0","-2"
"224147","Texas A & M University-Corpus Christi","2018","Tenured, assistant professors","2","0","2","0","0","0","0","0","0","0","0","0","1","0","1","0","0","0","1","0","1","0","0","0","0","0","0","0","0","0","-2"
"224147","Texas A & M University-Corpus Christi","2018","On-Tenure track total","126","60","66","0","0","0","17","10","7","3","2","1","11","5","6","0","0","0","65","24","41","4","2","2","6","2","4","20","15","5","-2"
"224147","Texas A & M University-Corpus Christi","2018","On-tenure track, professors","1","1","0","0","0","0","0","0","0","0","0","0","0","0","0","0","0","0","1","1","0","0","0","0","0","0","0","0","0","0","-2"
"224147","Texas A & M University-Corpus Christi","2018","On-tenure track, associate professors","12","8","4","0","0","0","4","4","0","0","0","0","0","0","0","0","0","0","7","3","4","0","0","0","0","0","0","1","1","0","-2"
"224147","Texas A & M University-Corpus Christi","2018","On-tenure track, assistant professors","113","51","62","0","0","0","13","6","7","3","2","1","11","5","6","0","0","0","57","20","37","4","2","2","6","2","4","19","14","5","-2"
"224147","Texas A & M University-Corpus Christi","2018","Not on tenure track/No tenure system system total","120","36","84","0","0","0","7","3","4","1","0","1","22","5","17","0","0","0","79","23","56","1","0","1","1","0","1","9","5","4","-2"
"224147","Texas A & M University-Corpus Christi","2018","Not on tenure/no tenure system, professors","60","22","38","0","0","0","6","3","3","0","0","0","7","1","6","0","0","0","40","15","25","0","0","0","1","0","1","6","3","3","-2"
"224147","Texas A & M University-Corpus Christi","2018","Not on tenure/no tenure system, associate professors","2","1","1","0","0","0","0","0","0","0","0","0","0","0","0","0","0","0","2","1","1","0","0","0","0","0","0","0","0","0","-2"
"224147","Texas A & M University-Corpus Christi","2018","Not on tenure/no tenure system, assistant professors","35","6","29","0","0","0","0","0","0","1","0","1","9","2","7","0","0","0","24","4","20","1","0","1","0","0","0","0","0","0","-2"
"224147","Texas A & M University-Corpus Christi","2018","Not on tenure/no tenure system, instructors","9","3","6","0","0","0","1","0","1","0","0","0","0","0","0","0","0","0","5","1","4","0","0","0","0","0","0","3","2","1","-2"
"224147","Texas A & M University-Corpus Christi","2018","Not on tenure/no tenure system, lecturers","14","4","10","0","0","0","0","0","0","0","0","0","6","2","4","0","0","0","8","2","6","0","0","0","0","0","0","0","0","0","-2"
"225511","University of Houston","2018","Tenured total","778","539","239","1","1","0","175","123","52","31","19","12","65","35","30","0","0","0","499","356","143","6","4","2","0","0","0","1","1","0","-2"
"225511","University of Houston","2018","Tenured, professors","428","338","90","0","0","0","94","74","20","12","12","0","28","14","14","0","0","0","290","234","56","3","3","0","0","0","0","1","1","0","-2"
"225511","University of Houston","2018","Tenured, associate professors","350","201","149","1","1","0","81","49","32","19","7","12","37","21","16","0","0","0","209","122","87","3","1","2","0","0","0","0","0","0","-2"
"225511","University of Houston","2018","On-Tenure track total","249","146","103","0","0","0","53","36","17","10","3","7","22","11","11","0","0","0","105","57","48","0","0","0","2","1","1","57","38","19","-2"
"225511","University of Houston","2018","On-tenure track, professors","3","2","1","0","0","0","0","0","0","0","0","0","0","0","0","0","0","0","2","1","1","0","0","0","0","0","0","1","1","0","-2"
"225511","University of Houston","2018","On-tenure track, associate professors","9","4","5","0","0","0","2","1","1","0","0","0","1","0","1","0","0","0","4","2","2","0","0","0","0","0","0","2","1","1","-2"
"225511","University of Houston","2018","On-tenure track, assistant professors","237","140","97","0","0","0","51","35","16","10","3","7","21","11","10","0","0","0","99","54","45","0","0","0","2","1","1","54","36","18","-2"
"225511","University of Houston","2018","Not on tenure track/No tenure system system total","289","143","146","1","1","0","27","11","16","13","5","8","25","11","14","0","0","0","203","105","98","4","2","2","4","2","2","12","6","6","-2"
"225511","University of Houston","2018","Not on tenure/no tenure system, lecturers","73","38","35","1","1","0","7","1","6","1","1","0","13","6","7","0","0","0","48","28","20","0","0","0","1","1","0","2","0","2","-2"
"225511","University of Houston","2018","Not on tenure/no tenure system, no academic rank","216","105","111","0","0","0","20","10","10","12","4","8","12","5","7","0","0","0","155","77","78","4","2","2","3","1","2","10","6","4","-2"
"225627","University of the Incarnate Word","2018","Tenured total","144","66","78","1","0","1","8","5","3","5","2","3","28","14","14","0","0","0","100","45","55","0","0","0","0","0","0","2","0","2","-2"
"225627","University of the Incarnate Word","2018","Tenured, professors","66","32","34","0","0","0","4","3","1","0","0","0","13","5","8","0","0","0","48","24","24","0","0","0","0","0","0","1","0","1","-2"
"225627","University of the Incarnate Word","2018","Tenured, associate professors","76","34","42","1","0","1","4","2","2","5","2","3","15","9","6","0","0","0","50","21","29","0","0","0","0","0","0","1","0","1","-2"
"225627","University of the Incarnate Word","2018","Tenured, assistant professors","2","0","2","0","0","0","0","0","0","0","0","0","0","0","0","0","0","0","2","0","2","0","0","0","0","0","0","0","0","0","-2"
"225627","University of the Incarnate Word","2018","On-Tenure track total","104","49","55","0","0","0","9","3","6","7","3","4","21","9","12","0","0","0","65","32","33","0","0","0","0","0","0","2","2","0","-2"
"225627","University of the Incarnate Word","2018","On-tenure track, professors","1","1","0","0","0","0","0","0","0","0","0","0","0","0","0","0","0","0","1","1","0","0","0","0","0","0","0","0","0","0","-2"
"225627","University of the Incarnate Word","2018","On-tenure track, associate professors","10","8","2","0","0","0","3","2","1","1","1","0","3","3","0","0","0","0","3","2","1","0","0","0","0","0","0","0","0","0","-2"
"225627","University of the Incarnate Word","2018","On-tenure track, assistant professors","93","40","53","0","0","0","6","1","5","6","2","4","18","6","12","0","0","0","61","29","32","0","0","0","0","0","0","2","2","0","-2"
"225627","University of the Incarnate Word","2018","Not on tenure track/No tenure system system total","99","46","53","1","1","0","10","5","5","4","2","2","28","10","18","0","0","0","55","28","27","0","0","0","0","0","0","1","0","1","-2"
"225627","University of the Incarnate Word","2018","Not on tenure/no tenure system, professors","10","7","3","0","0","0","0","0","0","0","0","0","1","0","1","0","0","0","9","7","2","0","0","0","0","0","0","0","0","0","-2"
"225627","University of the Incarnate Word","2018","Not on tenure/no tenure system, associate professors","10","6","4","0","0","0","2","1","1","0","0","0","3","1","2","0","0","0","5","4","1","0","0","0","0","0","0","0","0","0","-2"
"225627","University of the Incarnate Word","2018","Not on tenure/no tenure system, assistant professors","41","22","19","1","1","0","7","4","3","3","1","2","10","6","4","0","0","0","20","10","10","0","0","0","0","0","0","0","0","0","-2"
"225627","University of the Incarnate Word","2018","Not on tenure/no tenure system, instructors","38","11","27","0","0","0","1","0","1","1","1","0","14","3","11","0","0","0","21","7","14","0","0","0","0","0","0","1","0","1","-2"
"227757","Rice University","2018","Tenured total","418","310","108","0","0","0","54","36","18","10","7","3","25","22","3","0","0","0","326","244","82","1","0","1","0","0","0","2","1","1","-2"
"227757","Rice University","2018","Tenured, professors","309","241","68","0","0","0","38","28","10","6","5","1","15","13","2","0","0","0","249","194","55","0","0","0","0","0","0","1","1","0","-2"
"227757","Rice University","2018","Tenured, associate professors","109","69","40","0","0","0","16","8","8","4","2","2","10","9","1","0","0","0","77","50","27","1","0","1","0","0","0","1","0","1","-2"
"227757","Rice University","2018","On-Tenure track total","113","70","43","0","0","0","16","11","5","4","2","2","10","6","4","0","0","0","59","34","25","5","2","3","0","0","0","19","15","4","-2"
"227757","Rice University","2018","On-tenure track, assistant professors","113","70","43","0","0","0","16","11","5","4","2","2","10","6","4","0","0","0","59","34","25","5","2","3","0","0","0","19","15","4","-2"
"227757","Rice University","2018","Not on tenure track/No tenure system system total","152","73","79","0","0","0","12","6","6","6","2","4","8","2","6","0","0","0","109","59","50","1","0","1","0","0","0","16","4","12","-2"
"227757","Rice University","2018","Not on tenure/no tenure system, associate professors","1","0","1","0","0","0","0","0","0","0","0","0","0","0","0","0","0","0","1","0","1","0","0","0","0","0","0","0","0","0","-2"
"227757","Rice University","2018","Not on tenure/no tenure system, instructors","18","11","7","0","0","0","1","1","0","0","0","0","0","0","0","0","0","0","13","7","6","0","0","0","0","0","0","4","3","1","-2"
"227757","Rice University","2018","Not on tenure/no tenure system, lecturers","128","59","69","0","0","0","10","4","6","5","2","3","8","2","6","0","0","0","92","50","42","1","0","1","0","0","0","12","1","11","-2"
"227757","Rice University","2018","Not on tenure/no tenure system, no academic rank","5","3","2","0","0","0","1","1","0","1","0","1","0","0","0","0","0","0","3","2","1","0","0","0","0","0","0","0","0","0","-2"
"228459","Texas State University","2018","Tenured total","527","308","219","0","0","0","10","6","4","10","6","4","109","72","37","0","0","0","396","222","174","0","0","0","0","0","0","2","2","0","-2"
"228459","Texas State University","2018","Tenured, professors","259","163","96","0","0","0","4","3","1","2","2","0","38","33","5","0","0","0","215","125","90","0","0","0","0","0","0","0","0","0","-2"
"228459","Texas State University","2018","Tenured, associate professors","263","142","121","0","0","0","5","3","2","8","4","4","71","39","32","0","0","0","177","94","83","0","0","0","0","0","0","2","2","0","-2"
"228459","Texas State University","2018","Tenured, assistant professors","5","3","2","0","0","0","1","0","1","0","0","0","0","0","0","0","0","0","4","3","1","0","0","0","0","0","0","0","0","0","-2"
"228459","Texas State University","2018","On-Tenure track total","217","94","123","0","0","0","2","0","2","3","3","0","43","15","28","0","0","0","133","60","73","1","1","0","1","0","1","34","15","19","-2"
"228459","Texas State University","2018","On-tenure track, professors","2","1","1","0","0","0","0","0","0","0","0","0","1","1","0","0","0","0","1","0","1","0","0","0","0","0","0","0","0","0","-2"
"228459","Texas State University","2018","On-tenure track, associate professors","7","3","4","0","0","0","0","0","0","0","0","0","3","1","2","0","0","0","4","2","2","0","0","0","0","0","0","0","0","0","-2"
"228459","Texas State University","2018","On-tenure track, assistant professors","208","90","118","0","0","0","2","0","2","3","3","0","39","13","26","0","0","0","128","58","70","1","1","0","1","0","1","34","15","19","-2"
"228459","Texas State University","2018","Not on tenure track/No tenure system system total","595","265","330","0","0","0","2","1","1","14","4","10","101","42","59","0","0","0","447","201","246","7","4","3","3","2","1","21","11","10","-2"
"228459","Texas State University","2018","Not on tenure/no tenure system, lecturers","581","257","324","0","0","0","2","1","1","13","4","9","99","40","59","0","0","0","437","196","241","7","4","3","3","2","1","20","10","10","-2"
"228459","Texas State University","2018","Not on tenure/no tenure system, no academic rank","14","8","6","0","0","0","0","0","0","1","0","1","2","2","0","0","0","0","10","5","5","0","0","0","0","0","0","1","1","0","-2"
"228723","Texas A & M University-College Station","2018","Tenured total","1598","1183","415","4","2","2","305","236","69","53","33","20","109","76","33","0","0","0","1068","791","277","7","5","2","32","25","7","20","15","5","-2"
"228723","Texas A & M University-College Station","2018","Tenured, professors","1006","803","203","1","0","1","171","144","27","25","22","3","53","40","13","0","0","0","723","570","153","5","4","1","20","15","5","8","8","0","-2"
"228723","Texas A & M University-College Station","2018","Tenured, associate professors","586","379","207","3","2","1","133","92","41","28","11","17","54","36","18","0","0","0","343","221","122","2","1","1","12","10","2","11","6","5","-2"
"228723","Texas A & M University-College Station","2018","Tenured, assistant professors","6","1","5","0","0","0","1","0","1","0","0","0","2","0","2","0","0","0","2","0","2","0","0","0","0","0","0","1","1","0","-2"
"228723","Texas A & M University-College Station","2018","On-Tenure track total","462","273","189","0","0","0","72","53","19","17","8","9","19","9","10","0","0","0","245","133","112","10","4","6","17","10","7","82","56","26","-2"
"228723","Texas A & M University-College Station","2018","On-tenure track, professors","6","6","0","0","0","0","2","2","0","0","0","0","0","0","0","0","0","0","4","4","0","0","0","0","0","0","0","0","0","0","-2"
"228723","Texas A & M University-College Station","2018","On-tenure track, associate professors","33","22","11","0","0","0","5","4","1","2","1","1","4","2","2","0","0","0","16","11","5","0","0","0","3","2","1","3","2","1","-2"
"228723","Texas A & M University-College Station","2018","On-tenure track, assistant professors","422","244","178","0","0","0","65","47","18","15","7","8","15","7","8","0","0","0","225","118","107","10","4","6","14","8","6","78","53","25","-2"
"228723","Texas A & M University-College Station","2018","On-tenure track, instructors","1","1","0","0","0","0","0","0","0","0","0","0","0","0","0","0","0","0","0","0","0","0","0","0","0","0","0","1","1","0","-2"
"228723","Texas A & M University-College Station","2018","Not on tenure track/No tenure system system total","1145","598","547","3","1","2","73","31","42","36","13","23","76","41","35","6","5","1","812","411","401","11","4","7","42","27","15","86","65","21","-2"
"228723","Texas A & M University-College Station","2018","Not on tenure/no tenure system, professors","148","121","27","1","0","1","13","12","1","6","4","2","9","8","1","1","1","0","94","72","22","0","0","0","6","6","0","18","18","0","-2"
"228723","Texas A & M University-College Station","2018","Not on tenure/no tenure system, associate professors","106","52","54","0","0","0","1","0","1","3","0","3","6","2","4","0","0","0","84","40","44","1","1","0","1","0","1","10","9","1","-2"
"228723","Texas A & M University-College Station","2018","Not on tenure/no tenure system, assistant professors","230","102","128","1","1","0","24","8","16","5","2","3","17","8","9","2","2","0","149","58","91","1","1","0","8","4","4","23","18","5","-2"
"228723","Texas A & M University-College Station","2018","Not on tenure/no tenure system, instructors","404","198","206","1","0","1","22","7","15","12","5","7","28","14","14","1","0","1","301","152","149","5","1","4","13","7","6","21","12","9","-2"
"228723","Texas A & M University-College Station","2018","Not on tenure/no tenure system, lecturers","257","125","132","0","0","0","13","4","9","10","2","8","16","9","7","2","2","0","184","89","95","4","1","3","14","10","4","14","8","6","-2"
"228769","The University of Texas at Arlington","2018","Tenured total","442","321","121","1","0","1","129","103","26","13","7","6","19","13","6","0","0","0","266","189","77","3","3","0","6","4","2","5","2","3","-2"
"228769","The University of Texas at Arlington","2018","Tenured, professors","218","176","42","0","0","0","73","61","12","3","2","1","6","6","0","0","0","0","130","103","27","1","1","0","3","2","1","2","1","1","-2"
"228769","The University of Texas at Arlington","2018","Tenured, associate professors","224","145","79","1","0","1","56","42","14","10","5","5","13","7","6","0","0","0","136","86","50","2","2","0","3","2","1","3","1","2","-2"
"228769","The University of Texas at Arlington","2018","On-Tenure track total","119","59","60","0","0","0","33","15","18","5","1","4","7","3","4","0","0","0","44","24","20","1","1","0","21","10","11","8","5","3","-2"
"228769","The University of Texas at Arlington","2018","On-tenure track, assistant professors","119","59","60","0","0","0","33","15","18","5","1","4","7","3","4","0","0","0","44","24","20","1","1","0","21","10","11","8","5","3","-2"
"228769","The University of Texas at Arlington","2018","Not on tenure track/No tenure system system total","443","188","255","1","0","1","50","35","15","32","6","26","25","16","9","0","0","0","288","107","181","3","3","0","34","12","22","10","9","1","-2"
"228769","The University of Texas at Arlington","2018","Not on tenure/no tenure system, lecturers","177","89","88","0","0","0","13","7","6","6","2","4","15","10","5","0","0","0","126","57","69","2","2","0","10","6","4","5","5","0","-2"
"228769","The University of Texas at Arlington","2018","Not on tenure/no tenure system, no academic rank","266","99","167","1","0","1","37","28","9","26","4","22","10","6","4","0","0","0","162","50","112","1","1","0","24","6","18","5","4","1","-2"
"228778","The University of Texas at Austin","2018","Tenured total","1529","1043","486","4","1","3","154","116","38","66","36","30","96","59","37","0","0","0","1177","812","365","14","6","8","0","0","0","18","13","5","-2"
"228778","The University of Texas at Austin","2018","Tenured, professors","1021","750","271","4","1","3","98","77","21","34","20","14","56","39","17","0","0","0","817","605","212","6","2","4","0","0","0","6","6","0","-2"
"228778","The University of Texas at Austin","2018","Tenured, associate professors","508","293","215","0","0","0","56","39","17","32","16","16","40","20","20","0","0","0","360","207","153","8","4","4","0","0","0","12","7","5","-2"
"228778","The University of Texas at Austin","2018","On-Tenure track total","354","193","161","0","0","0","41","24","17","24","12","12","39","15","24","0","0","0","191","107","84","4","2","2","0","0","0","55","33","22","-2"
"228778","The University of Texas at Austin","2018","On-tenure track, professors","1","1","0","0","0","0","1","1","0","0","0","0","0","0","0","0","0","0","0","0","0","0","0","0","0","0","0","0","0","0","-2"
"228778","The University of Texas at Austin","2018","On-tenure track, associate professors","9","3","6","0","0","0","0","0","0","1","1","0","3","1","2","0","0","0","5","1","4","0","0","0","0","0","0","0","0","0","-2"
"228778","The University of Texas at Austin","2018","On-tenure track, assistant professors","344","189","155","0","0","0","40","23","17","23","11","12","36","14","22","0","0","0","186","106","80","4","2","2","0","0","0","55","33","22","-2"
"228778","The University of Texas at Austin","2018","Not on tenure track/No tenure system system total","1023","451","572","0","0","0","81","33","48","37","16","21","91","30","61","0","0","0","738","332","406","20","7","13","0","0","0","56","33","23","-2"
"228778","The University of Texas at Austin","2018","Not on tenure/no tenure system, instructors","43","12","31","0","0","0","2","0","2","4","0","4","5","0","5","0","0","0","23","7","16","2","0","2","0","0","0","7","5","2","-2"
"228778","The University of Texas at Austin","2018","Not on tenure/no tenure system, lecturers","980","439","541","0","0","0","79","33","46","33","16","17","86","30","56","0","0","0","715","325","390","18","7","11","0","0","0","49","28","21","-2"
"228796","The University of Texas at El Paso","2018","Tenured total","351","249","102","0","0","0","53","39","14","5","5","0","101","63","38","0","0","0","185","138","47","4","3","1","0","0","0","3","1","2","-2"
"228796","The University of Texas at El Paso","2018","Tenured, professors","165","127","38","0","0","0","24","18","6","3","3","0","39","24","15","0","0","0","97","80","17","2","2","0","0","0","0","0","0","0","-2"
"228796","The University of Texas at El Paso","2018","Tenured, associate professors","186","122","64","0","0","0","29","21","8","2","2","0","62","39","23","0","0","0","88","58","30","2","1","1","0","0","0","3","1","2","-2"
"228796","The University of Texas at El Paso","2018","On-Tenure track total","156","87","69","0","0","0","25","15","10","6","3","3","38","23","15","0","0","0","60","32","28","2","2","0","1","1","0","24","11","13","-2"
"228796","The University of Texas at El Paso","2018","On-tenure track, associate professors","11","10","1","0","0","0","2","2","0","0","0","0","4","4","0","0","0","0","5","4","1","0","0","0","0","0","0","0","0","0","-2"
"228796","The University of Texas at El Paso","2018","On-tenure track, assistant professors","145","77","68","0","0","0","23","13","10","6","3","3","34","19","15","0","0","0","55","28","27","2","2","0","1","1","0","24","11","13","-2"
"228796","The University of Texas at El Paso","2018","Not on tenure track/No tenure system system total","273","107","166","1","0","1","6","1","5","6","4","2","127","49","78","1","0","1","115","42","73","1","1","0","1","1","0","15","9","6","-2"
"228796","The University of Texas at El Paso","2018","Not on tenure/no tenure system, lecturers","273","107","166","1","0","1","6","1","5","6","4","2","127","49","78","1","0","1","115","42","73","1","1","0","1","1","0","15","9","6","-2"
"229063","Texas Southern University","2018","Tenured total","226","130","96","0","0","0","34","20","14","137","74","63","6","4","2","0","0","0","32","20","12","0","0","0","0","0","0","17","12","5","-2"
"229063","Texas Southern University","2018","Tenured, professors","135","84","51","0","0","0","25","14","11","74","45","29","4","4","0","0","0","0","19","13","6","0","0","0","0","0","0","13","8","5","-2"
"229063","Texas Southern University","2018","Tenured, associate professors","87","43","44","0","0","0","9","6","3","61","27","34","2","0","2","0","0","0","12","7","5","0","0","0","0","0","0","3","3","0","-2"
"229063","Texas Southern University","2018","Tenured, assistant professors","4","3","1","0","0","0","0","0","0","2","2","0","0","0","0","0","0","0","1","0","1","0","0","0","0","0","0","1","1","0","-2"
"229063","Texas Southern University","2018","On-Tenure track total","17","6","11","0","0","0","5","3","2","11","2","9","0","0","0","0","0","0","1","1","0","0","0","0","0","0","0","0","0","0","-2"
"229063","Texas Southern University","2018","On-tenure track, assistant professors","17","6","11","0","0","0","5","3","2","11","2","9","0","0","0","0","0","0","1","1","0","0","0","0","0","0","0","0","0","0","-2"
"229063","Texas Southern University","2018","Not on tenure track/No tenure system system total","187","87","100","1","1","0","14","8","6","138","55","83","13","9","4","0","0","0","19","13","6","0","0","0","0","0","0","2","1","1","-2"
"229063","Texas Southern University","2018","Not on tenure/no tenure system, no academic rank","187","87","100","1","1","0","14","8","6","138","55","83","13","9","4","0","0","0","19","13","6","0","0","0","0","0","0","2","1","1","-2"
"229115","Texas Tech University","2018","Tenured total","745","525","220","4","3","1","110","84","26","21","13","8","44","28","16","1","1","0","559","391","168","2","2","0","0","0","0","4","3","1","-2"
"229115","Texas Tech University","2018","Tenured, professors","384","292","92","3","2","1","56","47","9","14","9","5","16","10","6","1","1","0","290","220","70","2","2","0","0","0","0","2","1","1","-2"
"229115","Texas Tech University","2018","Tenured, associate professors","324","214","110","1","1","0","51","34","17","5","2","3","27","17","10","0","0","0","238","158","80","0","0","0","0","0","0","2","2","0","-2"
"229115","Texas Tech University","2018","Tenured, assistant professors","4","4","0","0","0","0","2","2","0","1","1","0","0","0","0","0","0","0","1","1","0","0","0","0","0","0","0","0","0","0","-2"
"229115","Texas Tech University","2018","Tenured, no academic rank","33","15","18","0","0","0","1","1","0","1","1","0","1","1","0","0","0","0","30","12","18","0","0","0","0","0","0","0","0","0","-2"
"229115","Texas Tech University","2018","On-Tenure track total","350","204","146","0","0","0","44","30","14","7","3","4","28","13","15","0","0","0","220","126","94","4","2","2","0","0","0","47","30","17","-2"
"229115","Texas Tech University","2018","On-tenure track, professors","1","1","0","0","0","0","0","0","0","0","0","0","0","0","0","0","0","0","1","1","0","0","0","0","0","0","0","0","0","0","-2"
"229115","Texas Tech University","2018","On-tenure track, associate professors","17","13","4","0","0","0","4","3","1","0","0","0","1","1","0","0","0","0","11","8","3","0","0","0","0","0","0","1","1","0","-2"
"229115","Texas Tech University","2018","On-tenure track, assistant professors","321","185","136","0","0","0","40","27","13","6","3","3","25","12","13","0","0","0","201","112","89","4","2","2","0","0","0","45","29","16","-2"
"229115","Texas Tech University","2018","On-tenure track, no academic rank","11","5","6","0","0","0","0","0","0","1","0","1","2","0","2","0","0","0","7","5","2","0","0","0","0","0","0","1","0","1","-2"
"229115","Texas Tech University","2018","Not on tenure track/No tenure system system total","474","200","274","2","0","2","30","15","15","10","6","4","48","19","29","0","0","0","330","125","205","2","1","1","0","0","0","52","34","18","-2"
"229115","Texas Tech University","2018","Not on tenure/no tenure system, professors","18","11","7","1","0","1","2","2","0","0","0","0","0","0","0","0","0","0","14","9","5","0","0","0","0","0","0","1","0","1","-2"
"229115","Texas Tech University","2018","Not on tenure/no tenure system, associate professors","21","13","8","0","0","0","3","2","1","0","0","0","1","1","0","0","0","0","14","7","7","1","1","0","0","0","0","2","2","0","-2"
"229115","Texas Tech University","2018","Not on tenure/no tenure system, assistant professors","96","43","53","0","0","0","10","5","5","2","1","1","8","3","5","0","0","0","55","22","33","1","0","1","0","0","0","20","12","8","-2"
"229115","Texas Tech University","2018","Not on tenure/no tenure system, instructors","307","114","193","1","0","1","13","4","9","8","5","3","37","14","23","0","0","0","229","79","150","0","0","0","0","0","0","19","12","7","-2"
"229115","Texas Tech University","2018","Not on tenure/no tenure system, lecturers","1","1","0","0","0","0","0","0","0","0","0","0","0","0","0","0","0","0","1","1","0","0","0","0","0","0","0","0","0","0","-2"
"229115","Texas Tech University","2018","Not on tenure/no tenure system, no academic rank","31","18","13","0","0","0","2","2","0","0","0","0","2","1","1","0","0","0","17","7","10","0","0","0","0","0","0","10","8","2","-2"
"230728","Utah State University","2018","Tenured total","484","350","134","0","0","0","31","23","8","2","1","1","21","11","10","0","0","0","419","309","110","4","1","3","7","5","2","0","0","0","-2"
"230728","Utah State University","2018","Tenured, professors","244","181","63","0","0","0","14","11","3","1","1","0","10","4","6","0","0","0","212","162","50","3","1","2","4","2","2","0","0","0","-2"
"230728","Utah State University","2018","Tenured, associate professors","238","167","71","0","0","0","17","12","5","1","0","1","11","7","4","0","0","0","205","145","60","1","0","1","3","3","0","0","0","0","-2"
"230728","Utah State University","2018","Tenured, assistant professors","1","1","0","0","0","0","0","0","0","0","0","0","0","0","0","0","0","0","1","1","0","0","0","0","0","0","0","0","0","0","-2"
"230728","Utah State University","2018","Tenured, instructors","1","1","0","0","0","0","0","0","0","0","0","0","0","0","0","0","0","0","1","1","0","0","0","0","0","0","0","0","0","0","-2"
"230728","Utah State University","2018","On-Tenure track total","236","132","104","1","0","1","15","7","8","0","0","0","17","10","7","1","1","0","144","81","63","4","2","2","54","31","23","0","0","0","-2"
"230728","Utah State University","2018","On-tenure track, associate professors","1","0","1","0","0","0","0","0","0","0","0","0","0","0","0","0","0","0","0","0","0","0","0","0","1","0","1","0","0","0","-2"
"230728","Utah State University","2018","On-tenure track, assistant professors","233","130","103","1","0","1","15","7","8","0","0","0","17","10","7","1","1","0","142","79","63","4","2","2","53","31","22","0","0","0","-2"
"230728","Utah State University","2018","On-tenure track, instructors","2","2","0","0","0","0","0","0","0","0","0","0","0","0","0","0","0","0","2","2","0","0","0","0","0","0","0","0","0","0","-2"
"230728","Utah State University","2018","Not on tenure track/No tenure system system total","287","137","150","2","1","1","4","2","2","0","0","0","6","3","3","0","0","0","252","122","130","2","1","1","21","8","13","0","0","0","-2"
"230728","Utah State University","2018","Not on tenure/no tenure system, professors","8","6","2","0","0","0","0","0","0","0","0","0","0","0","0","0","0","0","6","4","2","0","0","0","2","2","0","0","0","0","-2"
"230728","Utah State University","2018","Not on tenure/no tenure system, associate professors","24","12","12","0","0","0","0","0","0","0","0","0","0","0","0","0","0","0","24","12","12","0","0","0","0","0","0","0","0","0","-2"
"230728","Utah State University","2018","Not on tenure/no tenure system, assistant professors","98","41","57","0","0","0","2","2","0","0","0","0","2","1","1","0","0","0","82","34","48","1","1","0","11","3","8","0","0","0","-2"
"230728","Utah State University","2018","Not on tenure/no tenure system, instructors","27","10","17","1","1","0","0","0","0","0","0","0","1","1","0","0","0","0","22","7","15","0","0","0","3","1","2","0","0","0","-2"
"230728","Utah State University","2018","Not on tenure/no tenure system, lecturers","130","68","62","1","0","1","2","0","2","0","0","0","3","1","2","0","0","0","118","65","53","1","0","1","5","2","3","0","0","0","-2"
"230764","University of Utah","2018","Tenured total","1036","719","317","1","1","0","101","77","24","5","5","0","31","18","13","0","0","0","730","503","227","8","5","3","49","35","14","111","75","36","-2"
"230764","University of Utah","2018","Tenured, professors","684","507","177","1","1","0","62","51","11","3","3","0","14","10","4","0","0","0","496","363","133","3","2","1","25","19","6","80","58","22","-2"
"230764","University of Utah","2018","Tenured, associate professors","351","212","139","0","0","0","39","26","13","2","2","0","17","8","9","0","0","0","233","140","93","5","3","2","24","16","8","31","17","14","-2"
"230764","University of Utah","2018","Tenured, assistant professors","1","0","1","0","0","0","0","0","0","0","0","0","0","0","0","0","0","0","1","0","1","0","0","0","0","0","0","0","0","0","-2"
"230764","University of Utah","2018","On-Tenure track total","518","311","207","3","1","2","75","39","36","6","5","1","31","20","11","2","0","2","297","187","110","11","5","6","44","28","16","49","26","23","-2"
"230764","University of Utah","2018","On-tenure track, professors","22","12","10","0","0","0","2","2","0","0","0","0","2","2","0","0","0","0","15","7","8","1","0","1","2","1","1","0","0","0","-2"
"230764","University of Utah","2018","On-tenure track, associate professors","60","34","26","0","0","0","5","3","2","1","1","0","4","2","2","0","0","0","39","23","16","1","0","1","6","4","2","4","1","3","-2"
"230764","University of Utah","2018","On-tenure track, assistant professors","425","256","169","3","1","2","66","33","33","5","4","1","24","15","9","2","0","2","236","151","85","9","5","4","36","23","13","44","24","20","-2"
"230764","University of Utah","2018","On-tenure track, instructors","11","9","2","0","0","0","2","1","1","0","0","0","1","1","0","0","0","0","7","6","1","0","0","0","0","0","0","1","1","0","-2"
"230764","University of Utah","2018","Not on tenure track/No tenure system system total","456","233","223","3","1","2","13","5","8","4","2","2","16","6","10","1","0","1","352","182","170","4","1","3","26","14","12","37","22","15","-2"
"230764","University of Utah","2018","Not on tenure/no tenure system, professors","38","19","19","0","0","0","2","1","1","0","0","0","1","0","1","0","0","0","24","10","14","0","0","0","0","0","0","11","8","3","-2"
"230764","University of Utah","2018","Not on tenure/no tenure system, associate professors","37","16","21","0","0","0","1","0","1","0","0","0","0","0","0","0","0","0","28","11","17","1","0","1","2","2","0","5","3","2","-2"
"230764","University of Utah","2018","Not on tenure/no tenure system, assistant professors","84","30","54","0","0","0","3","1","2","1","0","1","4","2","2","0","0","0","66","25","41","0","0","0","8","2","6","2","0","2","-2"
"230764","University of Utah","2018","Not on tenure/no tenure system, instructors","19","6","13","0","0","0","0","0","0","1","1","0","1","0","1","0","0","0","15","4","11","0","0","0","1","0","1","1","1","0","-2"
"230764","University of Utah","2018","Not on tenure/no tenure system, lecturers","278","162","116","3","1","2","7","3","4","2","1","1","10","4","6","1","0","1","219","132","87","3","1","2","15","10","5","18","10","8","-2"
"230913","Northern Vermont University","2018","Tenured total","50","28","22","0","0","0","0","0","0","0","0","0","0","0","0","0","0","0","49","28","21","1","0","1","0","0","0","0","0","0","-2"
"230913","Northern Vermont University","2018","Tenured, professors","34","19","15","0","0","0","0","0","0","0","0","0","0","0","0","0","0","0","33","19","14","1","0","1","0","0","0","0","0","0","-2"
"230913","Northern Vermont University","2018","Tenured, associate professors","15","9","6","0","0","0","0","0","0","0","0","0","0","0","0","0","0","0","15","9","6","0","0","0","0","0","0","0","0","0","-2"
"230913","Northern Vermont University","2018","Tenured, assistant professors","1","0","1","0","0","0","0","0","0","0","0","0","0","0","0","0","0","0","1","0","1","0","0","0","0","0","0","0","0","0","-2"
"230913","Northern Vermont University","2018","On-Tenure track total","23","15","8","0","0","0","0","0","0","0","0","0","0","0","0","0","0","0","9","5","4","1","1","0","13","9","4","0","0","0","-2"
"230913","Northern Vermont University","2018","On-tenure track, associate professors","6","3","3","0","0","0","0","0","0","0","0","0","0","0","0","0","0","0","2","1","1","0","0","0","4","2","2","0","0","0","-2"
"230913","Northern Vermont University","2018","On-tenure track, assistant professors","17","12","5","0","0","0","0","0","0","0","0","0","0","0","0","0","0","0","7","4","3","1","1","0","9","7","2","0","0","0","-2"
"230913","Northern Vermont University","2018","Not on tenure track/No tenure system system total","5","2","3","0","0","0","0","0","0","0","0","0","0","0","0","0","0","0","5","2","3","0","0","0","0","0","0","0","0","0","-2"
"230913","Northern Vermont University","2018","Not on tenure/no tenure system, professors","1","0","1","0","0","0","0","0","0","0","0","0","0","0","0","0","0","0","1","0","1","0","0","0","0","0","0","0","0","0","-2"
"230913","Northern Vermont University","2018","Not on tenure/no tenure system, associate professors","1","1","0","0","0","0","0","0","0","0","0","0","0","0","0","0","0","0","1","1","0","0","0","0","0","0","0","0","0","0","-2"
"230913","Northern Vermont University","2018","Not on tenure/no tenure system, assistant professors","3","1","2","0","0","0","0","0","0","0","0","0","0","0","0","0","0","0","3","1","2","0","0","0","0","0","0","0","0","0","-2"
"232186","George Mason University","2018","Tenured total","669","433","236","1","1","0","92","67","25","26","13","13","22","14","8","0","0","0","472","298","174","8","4","4","45","33","12","3","3","0","-2"
"232186","George Mason University","2018","Tenured, professors","329","241","88","1","1","0","40","33","7","9","4","5","11","9","2","0","0","0","243","175","68","2","1","1","21","16","5","2","2","0","-2"
"232186","George Mason University","2018","Tenured, associate professors","340","192","148","0","0","0","52","34","18","17","9","8","11","5","6","0","0","0","229","123","106","6","3","3","24","17","7","1","1","0","-2"
"232186","George Mason University","2018","On-Tenure track total","228","130","98","1","1","0","35","19","16","10","6","4","8","3","5","0","0","0","111","62","49","8","5","3","20","12","8","35","22","13","-2"
"232186","George Mason University","2018","On-tenure track, professors","1","1","0","0","0","0","0","0","0","0","0","0","0","0","0","0","0","0","1","1","0","0","0","0","0","0","0","0","0","0","-2"
"232186","George Mason University","2018","On-tenure track, associate professors","11","7","4","0","0","0","3","0","3","1","1","0","0","0","0","0","0","0","5","5","0","0","0","0","2","1","1","0","0","0","-2"
"232186","George Mason University","2018","On-tenure track, assistant professors","216","122","94","1","1","0","32","19","13","9","5","4","8","3","5","0","0","0","105","56","49","8","5","3","18","11","7","35","22","13","-2"
"232186","George Mason University","2018","Not on tenure track/No tenure system system total","448","191","257","1","1","0","36","17","19","23","9","14","14","4","10","0","0","0","327","139","188","6","3","3","28","14","14","13","4","9","-2"
"232186","George Mason University","2018","Not on tenure/no tenure system, professors","31","15","16","0","0","0","1","1","0","1","1","0","0","0","0","0","0","0","27","12","15","0","0","0","2","1","1","0","0","0","-2"
"232186","George Mason University","2018","Not on tenure/no tenure system, associate professors","106","51","55","0","0","0","8","2","6","8","3","5","2","2","0","0","0","0","77","37","40","3","1","2","8","6","2","0","0","0","-2"
"232186","George Mason University","2018","Not on tenure/no tenure system, assistant professors","210","79","131","1","1","0","19","10","9","10","3","7","8","1","7","0","0","0","144","54","90","3","2","1","13","4","9","12","4","8","-2"
"232186","George Mason University","2018","Not on tenure/no tenure system, instructors","101","46","55","0","0","0","8","4","4","4","2","2","4","1","3","0","0","0","79","36","43","0","0","0","5","3","2","1","0","1","-2"
"232265","Hampton University","2018","Tenured total","57","32","25","0","0","0","10","8","2","31","11","20","3","2","1","0","0","0","13","11","2","0","0","0","0","0","0","0","0","0","-2"
"232265","Hampton University","2018","Tenured, professors","35","21","14","0","0","0","7","6","1","19","7","12","3","2","1","0","0","0","6","6","0","0","0","0","0","0","0","0","0","0","-2"
"232265","Hampton University","2018","Tenured, associate professors","18","7","11","0","0","0","3","2","1","11","3","8","0","0","0","0","0","0","4","2","2","0","0","0","0","0","0","0","0","0","-2"
"232265","Hampton University","2018","Tenured, assistant professors","4","4","0","0","0","0","0","0","0","1","1","0","0","0","0","0","0","0","3","3","0","0","0","0","0","0","0","0","0","0","-2"
"232265","Hampton University","2018","On-Tenure track total","27","11","16","1","0","1","2","2","0","18","5","13","0","0","0","0","0","0","6","4","2","0","0","0","0","0","0","0","0","0","-2"
"232265","Hampton University","2018","On-tenure track, professors","1","1","0","0","0","0","1","1","0","0","0","0","0","0","0","0","0","0","0","0","0","0","0","0","0","0","0","0","0","0","-2"
"232265","Hampton University","2018","On-tenure track, associate professors","7","1","6","0","0","0","0","0","0","7","1","6","0","0","0","0","0","0","0","0","0","0","0","0","0","0","0","0","0","0","-2"
"232265","Hampton University","2018","On-tenure track, assistant professors","19","9","10","1","0","1","1","1","0","11","4","7","0","0","0","0","0","0","6","4","2","0","0","0","0","0","0","0","0","0","-2"
"232265","Hampton University","2018","Not on tenure track/No tenure system system total","183","89","94","3","0","3","22","12","10","108","43","65","5","3","2","0","0","0","45","31","14","0","0","0","0","0","0","0","0","0","-2"
"232265","Hampton University","2018","Not on tenure/no tenure system, professors","6","6","0","0","0","0","0","0","0","2","2","0","0","0","0","0","0","0","4","4","0","0","0","0","0","0","0","0","0","0","-2"
"232265","Hampton University","2018","Not on tenure/no tenure system, associate professors","31","20","11","0","0","0","3","2","1","19","11","8","0","0","0","0","0","0","9","7","2","0","0","0","0","0","0","0","0","0","-2"
"232265","Hampton University","2018","Not on tenure/no tenure system, assistant professors","107","48","59","0","0","0","16","8","8","61","22","39","3","2","1","0","0","0","27","16","11","0","0","0","0","0","0","0","0","0","-2"
"232265","Hampton University","2018","Not on tenure/no tenure system, instructors","16","8","8","1","0","1","0","0","0","11","5","6","2","1","1","0","0","0","2","2","0","0","0","0","0","0","0","0","0","0","-2"
"232265","Hampton University","2018","Not on tenure/no tenure system, lecturers","3","2","1","0","0","0","1","1","0","0","0","0","0","0","0","0","0","0","2","1","1","0","0","0","0","0","0","0","0","0","-2"
"232265","Hampton University","2018","Not on tenure/no tenure system, no academic rank","20","5","15","2","0","2","2","1","1","15","3","12","0","0","0","0","0","0","1","1","0","0","0","0","0","0","0","0","0","0","-2"
"232982","Old Dominion University","2018","Tenured total","419","285","134","2","1","1","68","48","20","26","17","9","13","9","4","0","0","0","251","168","83","2","1","1","46","34","12","11","7","4","-2"
"232982","Old Dominion University","2018","Tenured, professors","216","163","53","1","0","1","34","27","7","13","9","4","6","5","1","0","0","0","123","92","31","0","0","0","32","25","7","7","5","2","-2"
"232982","Old Dominion University","2018","Tenured, associate professors","203","122","81","1","1","0","34","21","13","13","8","5","7","4","3","0","0","0","128","76","52","2","1","1","14","9","5","4","2","2","-2"
"232982","Old Dominion University","2018","On-Tenure track total","173","88","85","0","0","0","28","22","6","9","3","6","6","4","2","0","0","0","102","46","56","0","0","0","1","0","1","27","13","14","-2"
"232982","Old Dominion University","2018","On-tenure track, professors","2","2","0","0","0","0","0","0","0","1","1","0","0","0","0","0","0","0","1","1","0","0","0","0","0","0","0","0","0","0","-2"
"232982","Old Dominion University","2018","On-tenure track, associate professors","10","6","4","0","0","0","2","2","0","1","0","1","0","0","0","0","0","0","5","3","2","0","0","0","0","0","0","2","1","1","-2"
"232982","Old Dominion University","2018","On-tenure track, assistant professors","160","80","80","0","0","0","26","20","6","7","2","5","6","4","2","0","0","0","96","42","54","0","0","0","1","0","1","24","12","12","-2"
"232982","Old Dominion University","2018","On-tenure track, instructors","1","0","1","0","0","0","0","0","0","0","0","0","0","0","0","0","0","0","0","0","0","0","0","0","0","0","0","1","0","1","-2"
"232982","Old Dominion University","2018","Not on tenure track/No tenure system system total","259","90","169","1","0","1","12","6","6","14","0","14","15","5","10","0","0","0","188","61","127","4","3","1","16","8","8","9","7","2","-2"
"232982","Old Dominion University","2018","Not on tenure/no tenure system, professors","2","1","1","0","0","0","0","0","0","0","0","0","0","0","0","0","0","0","1","0","1","0","0","0","0","0","0","1","1","0","-2"
"232982","Old Dominion University","2018","Not on tenure/no tenure system, associate professors","2","2","0","0","0","0","0","0","0","0","0","0","0","0","0","0","0","0","1","1","0","0","0","0","0","0","0","1","1","0","-2"
"232982","Old Dominion University","2018","Not on tenure/no tenure system, assistant professors","19","10","9","0","0","0","2","2","0","0","0","0","3","1","2","0","0","0","11","4","7","0","0","0","1","1","0","2","2","0","-2"
"232982","Old Dominion University","2018","Not on tenure/no tenure system, instructors","6","2","4","0","0","0","0","0","0","0","0","0","0","0","0","0","0","0","5","1","4","0","0","0","1","1","0","0","0","0","-2"
"232982","Old Dominion University","2018","Not on tenure/no tenure system, lecturers","229","74","155","1","0","1","10","4","6","14","0","14","12","4","8","0","0","0","170","55","115","4","3","1","14","6","8","4","2","2","-2"
"232982","Old Dominion University","2018","Not on tenure/no tenure system, no academic rank","1","1","0","0","0","0","0","0","0","0","0","0","0","0","0","0","0","0","0","0","0","0","0","0","0","0","0","1","1","0","-2"
"233921","Virginia Polytechnic Institute and State University","2018","Tenured total","1057","771","286","5","3","2","140","106","34","30","20","10","38","28","10","1","1","0","831","606","225","5","2","3","0","0","0","7","5","2","-2"
"233921","Virginia Polytechnic Institute and State University","2018","Tenured, professors","577","473","104","1","0","1","82","72","10","15","10","5","18","15","3","0","0","0","456","373","83","2","1","1","0","0","0","3","2","1","-2"
"233921","Virginia Polytechnic Institute and State University","2018","Tenured, associate professors","480","298","182","4","3","1","58","34","24","15","10","5","20","13","7","1","1","0","375","233","142","3","1","2","0","0","0","4","3","1","-2"
"233921","Virginia Polytechnic Institute and State University","2018","On-Tenure track total","439","265","174","1","1","0","74","48","26","18","8","10","13","12","1","1","0","1","257","143","114","2","2","0","0","0","0","73","51","22","-2"
"233921","Virginia Polytechnic Institute and State University","2018","On-tenure track, associate professors","20","16","4","0","0","0","5","3","2","1","1","0","1","1","0","0","0","0","12","10","2","0","0","0","0","0","0","1","1","0","-2"
"233921","Virginia Polytechnic Institute and State University","2018","On-tenure track, assistant professors","419","249","170","1","1","0","69","45","24","17","7","10","12","11","1","1","0","1","245","133","112","2","2","0","0","0","0","72","50","22","-2"
"233921","Virginia Polytechnic Institute and State University","2018","Not on tenure track/No tenure system system total","442","225","217","1","1","0","26","14","12","17","9","8","15","3","12","0","0","0","354","175","179","3","2","1","0","0","0","26","21","5","-2"
"233921","Virginia Polytechnic Institute and State University","2018","Not on tenure/no tenure system, professors","17","15","2","0","0","0","1","1","0","1","1","0","0","0","0","0","0","0","13","11","2","0","0","0","0","0","0","2","2","0","-2"
"233921","Virginia Polytechnic Institute and State University","2018","Not on tenure/no tenure system, associate professors","42","23","19","0","0","0","1","1","0","1","1","0","0","0","0","0","0","0","39","20","19","0","0","0","0","0","0","1","1","0","-2"
"233921","Virginia Polytechnic Institute and State University","2018","Not on tenure/no tenure system, assistant professors","131","67","64","0","0","0","12","8","4","6","1","5","6","2","4","0","0","0","95","47","48","0","0","0","0","0","0","12","9","3","-2"
"233921","Virginia Polytechnic Institute and State University","2018","Not on tenure/no tenure system, instructors","249","118","131","1","1","0","12","4","8","9","6","3","9","1","8","0","0","0","204","95","109","3","2","1","0","0","0","11","9","2","-2"
"233921","Virginia Polytechnic Institute and State University","2018","Not on tenure/no tenure system, lecturers","3","2","1","0","0","0","0","0","0","0","0","0","0","0","0","0","0","0","3","2","1","0","0","0","0","0","0","0","0","0","-2"
"234076","University of Virginia-Main Campus","2018","Tenured total","1034","747","287","0","0","0","88","64","24","47","29","18","28","18","10","0","0","0","846","621","225","10","4","6","3","2","1","12","9","3","-2"
"234076","University of Virginia-Main Campus","2018","Tenured, professors","693","536","157","0","0","0","54","46","8","20","16","4","15","11","4","0","0","0","591","456","135","5","2","3","3","2","1","5","3","2","-2"
"234076","University of Virginia-Main Campus","2018","Tenured, associate professors","341","211","130","0","0","0","34","18","16","27","13","14","13","7","6","0","0","0","255","165","90","5","2","3","0","0","0","7","6","1","-2"
"234076","University of Virginia-Main Campus","2018","On-Tenure track total","419","264","155","0","0","0","60","38","22","24","13","11","14","9","5","1","1","0","265","162","103","1","1","0","2","2","0","52","38","14","-2"
"234076","University of Virginia-Main Campus","2018","On-tenure track, professors","3","3","0","0","0","0","1","1","0","0","0","0","0","0","0","0","0","0","2","2","0","0","0","0","0","0","0","0","0","0","-2"
"234076","University of Virginia-Main Campus","2018","On-tenure track, associate professors","76","53","23","0","0","0","15","13","2","3","1","2","2","1","1","0","0","0","52","36","16","1","1","0","1","1","0","2","0","2","-2"
"234076","University of Virginia-Main Campus","2018","On-tenure track, assistant professors","340","208","132","0","0","0","44","24","20","21","12","9","12","8","4","1","1","0","211","124","87","0","0","0","1","1","0","50","38","12","-2"
"234076","University of Virginia-Main Campus","2018","Not on tenure track/No tenure system system total","852","426","426","1","1","0","78","39","39","31","11","20","24","10","14","0","0","0","647","327","320","9","4","5","1","0","1","61","34","27","-2"
"234076","University of Virginia-Main Campus","2018","Not on tenure/no tenure system, professors","89","56","33","0","0","0","4","1","3","3","1","2","2","2","0","0","0","0","80","52","28","0","0","0","0","0","0","0","0","0","-2"
"234076","University of Virginia-Main Campus","2018","Not on tenure/no tenure system, associate professors","234","127","107","0","0","0","14","9","5","11","5","6","5","2","3","0","0","0","199","109","90","2","1","1","1","0","1","2","1","1","-2"
"234076","University of Virginia-Main Campus","2018","Not on tenure/no tenure system, assistant professors","401","181","220","1","1","0","45","21","24","14","4","10","12","2","10","0","0","0","289","131","158","6","3","3","0","0","0","34","19","15","-2"
"234076","University of Virginia-Main Campus","2018","Not on tenure/no tenure system, instructors","38","26","12","0","0","0","9","7","2","1","1","0","1","0","1","0","0","0","22","13","9","0","0","0","0","0","0","5","5","0","-2"
"234076","University of Virginia-Main Campus","2018","Not on tenure/no tenure system, lecturers","90","36","54","0","0","0","6","1","5","2","0","2","4","4","0","0","0","0","57","22","35","1","0","1","0","0","0","20","9","11","-2"
"236939","Washington State University","2018","Tenured total","619","419","200","4","3","1","82","66","16","7","5","2","19","11","8","3","2","1","374","237","137","8","4","4","120","90","30","2","1","1","-2"
"236939","Washington State University","2018","Tenured, professors","335","243","92","2","2","0","43","38","5","1","1","0","11","7","4","3","2","1","218","153","65","7","3","4","49","36","13","1","1","0","-2"
"236939","Washington State University","2018","Tenured, associate professors","284","176","108","2","1","1","39","28","11","6","4","2","8","4","4","0","0","0","156","84","72","1","1","0","71","54","17","1","0","1","-2"
"236939","Washington State University","2018","On-Tenure track total","233","126","107","1","0","1","13","5","8","0","0","0","7","2","5","0","0","0","65","23","42","3","0","3","111","74","37","33","22","11","-2"
"236939","Washington State University","2018","On-tenure track, professors","2","1","1","0","0","0","0","0","0","0","0","0","0","0","0","0","0","0","1","0","1","0","0","0","1","1","0","0","0","0","-2"
"236939","Washington State University","2018","On-tenure track, associate professors","9","6","3","0","0","0","0","0","0","0","0","0","0","0","0","0","0","0","5","2","3","0","0","0","4","4","0","0","0","0","-2"
"236939","Washington State University","2018","On-tenure track, assistant professors","222","119","103","1","0","1","13","5","8","0","0","0","7","2","5","0","0","0","59","21","38","3","0","3","106","69","37","33","22","11","-2"
"236939","Washington State University","2018","Not on tenure track/No tenure system system total","501","212","289","1","0","1","19","5","14","4","2","2","24","8","16","0","0","0","298","118","180","3","1","2","131","67","64","21","11","10","-2"
"236939","Washington State University","2018","Not on tenure/no tenure system, instructors","191","66","125","0","0","0","7","1","6","0","0","0","10","2","8","0","0","0","108","34","74","1","0","1","55","25","30","10","4","6","-2"
"236939","Washington State University","2018","Not on tenure/no tenure system, lecturers","6","1","5","0","0","0","0","0","0","0","0","0","0","0","0","0","0","0","1","0","1","0","0","0","4","1","3","1","0","1","-2"
"236939","Washington State University","2018","Not on tenure/no tenure system, no academic rank","304","145","159","1","0","1","12","4","8","4","2","2","14","6","8","0","0","0","189","84","105","2","1","1","72","41","31","10","7","3","-2"
"236948","University of Washington-Seattle Campus","2018","Tenured total","2244","1437","807","9","4","5","330","218","112","36","18","18","88","53","35","1","1","0","1640","1054","586","36","16","20","96","67","29","8","6","2","-2"
"236948","University of Washington-Seattle Campus","2018","Tenured, professors","1376","947","429","5","3","2","174","131","43","17","9","8","39","28","11","1","1","0","1078","730","348","13","10","3","45","31","14","4","4","0","-2"
"236948","University of Washington-Seattle Campus","2018","Tenured, associate professors","868","490","378","4","1","3","156","87","69","19","9","10","49","25","24","0","0","0","562","324","238","23","6","17","51","36","15","4","2","2","-2"
"236948","University of Washington-Seattle Campus","2018","On-Tenure track total","652","308","344","5","0","5","116","52","64","17","5","12","24","8","16","1","0","1","339","164","175","8","3","5","80","44","36","62","32","30","-2"
"236948","University of Washington-Seattle Campus","2018","On-tenure track, professors","1","0","1","0","0","0","1","0","1","0","0","0","0","0","0","0","0","0","0","0","0","0","0","0","0","0","0","0","0","0","-2"
"236948","University of Washington-Seattle Campus","2018","On-tenure track, associate professors","8","5","3","0","0","0","0","0","0","0","0","0","0","0","0","0","0","0","5","4","1","1","0","1","2","1","1","0","0","0","-2"
"236948","University of Washington-Seattle Campus","2018","On-tenure track, assistant professors","643","303","340","5","0","5","115","52","63","17","5","12","24","8","16","1","0","1","334","160","174","7","3","4","78","43","35","62","32","30","-2"
"236948","University of Washington-Seattle Campus","2018","Not on tenure track/No tenure system system total","1357","609","748","2","1","1","212","92","120","22","8","14","65","34","31","3","3","0","806","348","458","30","7","23","131","59","72","86","57","29","-2"
"236948","University of Washington-Seattle Campus","2018","Not on tenure/no tenure system, professors","89","50","39","0","0","0","9","4","5","0","0","0","4","3","1","0","0","0","71","40","31","0","0","0","5","3","2","0","0","0","-2"
"236948","University of Washington-Seattle Campus","2018","Not on tenure/no tenure system, associate professors","152","86","66","1","0","1","32","19","13","1","1","0","9","6","3","0","0","0","100","55","45","1","0","1","5","4","1","3","1","2","-2"
"236948","University of Washington-Seattle Campus","2018","Not on tenure/no tenure system, assistant professors","357","179","178","0","0","0","83","42","41","6","0","6","18","9","9","1","1","0","170","82","88","8","4","4","34","15","19","37","26","11","-2"
"236948","University of Washington-Seattle Campus","2018","Not on tenure/no tenure system, instructors","153","86","67","0","0","0","23","10","13","2","0","2","7","5","2","1","1","0","62","29","33","4","0","4","27","19","8","27","22","5","-2"
"236948","University of Washington-Seattle Campus","2018","Not on tenure/no tenure system, lecturers","606","208","398","1","1","0","65","17","48","13","7","6","27","11","16","1","1","0","403","142","261","17","3","14","60","18","42","19","8","11","-2"
"237057","Whitman College","2018","Tenured total","89","53","36","0","0","0","8","3","5","2","1","1","2","2","0","0","0","0","71","46","25","0","0","0","0","0","0","6","1","5","-2"
"237057","Whitman College","2018","Tenured, professors","38","28","10","0","0","0","1","0","1","0","0","0","0","0","0","0","0","0","36","28","8","0","0","0","0","0","0","1","0","1","-2"
"237057","Whitman College","2018","Tenured, associate professors","50","24","26","0","0","0","6","2","4","2","1","1","2","2","0","0","0","0","35","18","17","0","0","0","0","0","0","5","1","4","-2"
"237057","Whitman College","2018","Tenured, assistant professors","1","1","0","0","0","0","1","1","0","0","0","0","0","0","0","0","0","0","0","0","0","0","0","0","0","0","0","0","0","0","-2"
"237057","Whitman College","2018","On-Tenure track total","40","20","20","0","0","0","0","0","0","0","0","0","4","4","0","0","0","0","29","12","17","0","0","0","2","2","0","5","2","3","-2"
"237057","Whitman College","2018","On-tenure track, associate professors","1","0","1","0","0","0","0","0","0","0","0","0","0","0","0","0","0","0","0","0","0","0","0","0","0","0","0","1","0","1","-2"
"237057","Whitman College","2018","On-tenure track, assistant professors","39","20","19","0","0","0","0","0","0","0","0","0","4","4","0","0","0","0","29","12","17","0","0","0","2","2","0","4","2","2","-2"
"237057","Whitman College","2018","Not on tenure track/No tenure system system total","52","25","27","0","0","0","3","2","1","2","1","1","1","1","0","4","4","0","37","14","23","1","0","1","3","2","1","1","1","0","-2"
"237057","Whitman College","2018","Not on tenure/no tenure system, professors","1","1","0","0","0","0","0","0","0","0","0","0","0","0","0","0","0","0","1","1","0","0","0","0","0","0","0","0","0","0","-2"
"237057","Whitman College","2018","Not on tenure/no tenure system, associate professors","2","0","2","0","0","0","0","0","0","0","0","0","0","0","0","0","0","0","1","0","1","0","0","0","1","0","1","0","0","0","-2"
"237057","Whitman College","2018","Not on tenure/no tenure system, assistant professors","18","7","11","0","0","0","0","0","0","1","1","0","0","0","0","4","4","0","11","1","10","1","0","1","1","1","0","0","0","0","-2"
"237057","Whitman College","2018","Not on tenure/no tenure system, instructors","7","2","5","0","0","0","3","2","1","1","0","1","0","0","0","0","0","0","3","0","3","0","0","0","0","0","0","0","0","0","-2"
"237057","Whitman College","2018","Not on tenure/no tenure system, lecturers","24","15","9","0","0","0","0","0","0","0","0","0","1","1","0","0","0","0","21","12","9","0","0","0","1","1","0","1","1","0","-2"
"237525","Marshall University","2018","Tenured total","393","236","157","1","0","1","43","31","12","9","7","2","7","4","3","0","0","0","323","191","132","0","0","0","3","2","1","7","1","6","-2"
"237525","Marshall University","2018","Tenured, professors","233","150","83","1","0","1","25","19","6","7","6","1","6","3","3","0","0","0","188","119","69","0","0","0","2","2","0","4","1","3","-2"
"237525","Marshall University","2018","Tenured, associate professors","157","86","71","0","0","0","18","12","6","2","1","1","1","1","0","0","0","0","132","72","60","0","0","0","1","0","1","3","0","3","-2"
"237525","Marshall University","2018","Tenured, assistant professors","3","0","3","0","0","0","0","0","0","0","0","0","0","0","0","0","0","0","3","0","3","0","0","0","0","0","0","0","0","0","-2"
"237525","Marshall University","2018","On-Tenure track total","166","88","78","1","0","1","22","17","5","11","7","4","4","2","2","0","0","0","120","56","64","0","0","0","7","5","2","1","1","0","-2"
"237525","Marshall University","2018","On-tenure track, professors","4","4","0","0","0","0","0","0","0","0","0","0","0","0","0","0","0","0","3","3","0","0","0","0","1","1","0","0","0","0","-2"
"237525","Marshall University","2018","On-tenure track, associate professors","17","9","8","0","0","0","4","3","1","1","1","0","0","0","0","0","0","0","12","5","7","0","0","0","0","0","0","0","0","0","-2"
"237525","Marshall University","2018","On-tenure track, assistant professors","145","75","70","1","0","1","18","14","4","10","6","4","4","2","2","0","0","0","105","48","57","0","0","0","6","4","2","1","1","0","-2"
"237525","Marshall University","2018","Not on tenure track/No tenure system system total","251","135","116","1","1","0","27","13","14","9","4","5","3","0","3","0","0","0","189","106","83","0","0","0","17","7","10","5","4","1","-2"
"237525","Marshall University","2018","Not on tenure/no tenure system, professors","8","4","4","0","0","0","1","0","1","0","0","0","0","0","0","0","0","0","6","3","3","0","0","0","1","1","0","0","0","0","-2"
"237525","Marshall University","2018","Not on tenure/no tenure system, associate professors","27","23","4","1","1","0","1","1","0","3","2","1","1","0","1","0","0","0","19","17","2","0","0","0","1","1","0","1","1","0","-2"
"237525","Marshall University","2018","Not on tenure/no tenure system, assistant professors","136","80","56","0","0","0","20","12","8","5","2","3","1","0","1","0","0","0","98","60","38","0","0","0","10","4","6","2","2","0","-2"
"237525","Marshall University","2018","Not on tenure/no tenure system, instructors","80","28","52","0","0","0","5","0","5","1","0","1","1","0","1","0","0","0","66","26","40","0","0","0","5","1","4","2","1","1","-2"
"239512","Northland College","2018","Tenured total","23","15","8","0","0","0","1","1","0","0","0","0","0","0","0","0","0","0","22","14","8","0","0","0","0","0","0","0","0","0","-2"
"239512","Northland College","2018","Tenured, professors","13","10","3","0","0","0","1","1","0","0","0","0","0","0","0","0","0","0","12","9","3","0","0","0","0","0","0","0","0","0","-2"
"239512","Northland College","2018","Tenured, associate professors","10","5","5","0","0","0","0","0","0","0","0","0","0","0","0","0","0","0","10","5","5","0","0","0","0","0","0","0","0","0","-2"
"239512","Northland College","2018","On-Tenure track total","20","14","6","0","0","0","0","0","0","1","1","0","0","0","0","0","0","0","19","13","6","0","0","0","0","0","0","0","0","0","-2"
"239512","Northland College","2018","On-tenure track, assistant professors","20","14","6","0","0","0","0","0","0","1","1","0","0","0","0","0","0","0","19","13","6","0","0","0","0","0","0","0","0","0","-2"
"239512","Northland College","2018","Not on tenure track/No tenure system system total","6","0","6","0","0","0","0","0","0","0","0","0","0","0","0","0","0","0","6","0","6","0","0","0","0","0","0","0","0","0","-2"
"239512","Northland College","2018","Not on tenure/no tenure system, assistant professors","2","0","2","0","0","0","0","0","0","0","0","0","0","0","0","0","0","0","2","0","2","0","0","0","0","0","0","0","0","0","-2"
"239512","Northland College","2018","Not on tenure/no tenure system, instructors","4","0","4","0","0","0","0","0","0","0","0","0","0","0","0","0","0","0","4","0","4","0","0","0","0","0","0","0","0","0","-2"
"240444","University of Wisconsin-Madison","2018","Tenured total","1508","1005","503","4","2","2","174","120","54","25","12","13","50","31","19","2","0","2","1205","812","393","16","8","8","25","17","8","7","3","4","-2"
"240444","University of Wisconsin-Madison","2018","Tenured, professors","1120","786","334","4","2","2","133","96","37","17","8","9","31","21","10","2","0","2","911","645","266","8","5","3","12","8","4","2","1","1","-2"
"240444","University of Wisconsin-Madison","2018","Tenured, associate professors","388","219","169","0","0","0","41","24","17","8","4","4","19","10","9","0","0","0","294","167","127","8","3","5","13","9","4","5","2","3","-2"
"240444","University of Wisconsin-Madison","2018","On-Tenure track total","422","232","190","1","1","0","67","33","34","25","7","18","14","8","6","1","0","1","216","122","94","10","5","5","32","18","14","56","38","18","-2"
"240444","University of Wisconsin-Madison","2018","On-tenure track, assistant professors","422","232","190","1","1","0","67","33","34","25","7","18","14","8","6","1","0","1","216","122","94","10","5","5","32","18","14","56","38","18","-2"
"240444","University of Wisconsin-Madison","2018","Not on tenure track/No tenure system system total","1573","866","707","4","3","1","127","74","53","27","12","15","40","22","18","1","0","1","1197","635","562","13","5","8","120","84","36","44","31","13","-2"
"240444","University of Wisconsin-Madison","2018","Not on tenure/no tenure system, professors","385","224","161","1","0","1","22","10","12","5","3","2","6","3","3","0","0","0","332","190","142","0","0","0","16","15","1","3","3","0","-2"
"240444","University of Wisconsin-Madison","2018","Not on tenure/no tenure system, associate professors","384","223","161","1","1","0","28","19","9","8","4","4","10","5","5","0","0","0","315","180","135","1","0","1","18","11","7","3","3","0","-2"
"240444","University of Wisconsin-Madison","2018","Not on tenure/no tenure system, assistant professors","534","289","245","2","2","0","48","26","22","11","3","8","16","10","6","1","0","1","344","174","170","9","3","6","75","50","25","28","21","7","-2"
"240444","University of Wisconsin-Madison","2018","Not on tenure/no tenure system, instructors","169","78","91","0","0","0","19","13","6","1","1","0","5","2","3","0","0","0","128","53","75","1","0","1","10","7","3","5","2","3","-2"
"240444","University of Wisconsin-Madison","2018","Not on tenure/no tenure system, lecturers","101","52","49","0","0","0","10","6","4","2","1","1","3","2","1","0","0","0","78","38","40","2","2","0","1","1","0","5","2","3","-2"
"240453","University of Wisconsin-Milwaukee","2018","Tenured total","579","359","220","2","2","0","108","72","36","27","17","10","28","17","11","0","0","0","406","246","160","4","2","2","0","0","0","4","3","1","240453"
"240453","University of Wisconsin-Milwaukee","2018","Tenured, professors","235","161","74","0","0","0","38","29","9","11","8","3","12","9","3","0","0","0","171","113","58","2","1","1","0","0","0","1","1","0","240453"
"240453","University of Wisconsin-Milwaukee","2018","Tenured, associate professors","341","195","146","2","2","0","70","43","27","16","9","7","16","8","8","0","0","0","232","130","102","2","1","1","0","0","0","3","2","1","240453"
"240453","University of Wisconsin-Milwaukee","2018","Tenured, assistant professors","3","3","0","0","0","0","0","0","0","0","0","0","0","0","0","0","0","0","3","3","0","0","0","0","0","0","0","0","0","0","240453"
"240453","University of Wisconsin-Milwaukee","2018","On-Tenure track total","125","60","65","0","0","0","13","7","6","3","0","3","8","3","5","0","0","0","78","36","42","0","0","0","0","0","0","23","14","9","240453"
"240453","University of Wisconsin-Milwaukee","2018","On-tenure track, associate professors","2","0","2","0","0","0","0","0","0","0","0","0","1","0","1","0","0","0","1","0","1","0","0","0","0","0","0","0","0","0","240453"
"240453","University of Wisconsin-Milwaukee","2018","On-tenure track, assistant professors","123","60","63","0","0","0","13","7","6","3","0","3","7","3","4","0","0","0","77","36","41","0","0","0","0","0","0","23","14","9","240453"
"240453","University of Wisconsin-Milwaukee","2018","Not on tenure track/No tenure system system total","364","129","235","1","0","1","19","8","11","12","2","10","10","2","8","0","0","0","306","108","198","4","2","2","0","0","0","12","7","5","240453"
"240453","University of Wisconsin-Milwaukee","2018","Not on tenure/no tenure system, professors","18","8","10","0","0","0","2","2","0","1","0","1","0","0","0","0","0","0","15","6","9","0","0","0","0","0","0","0","0","0","240453"
"240453","University of Wisconsin-Milwaukee","2018","Not on tenure/no tenure system, associate professors","28","6","22","0","0","0","2","2","0","3","1","2","1","0","1","0","0","0","21","2","19","0","0","0","0","0","0","1","1","0","240453"
"240453","University of Wisconsin-Milwaukee","2018","Not on tenure/no tenure system, assistant professors","67","14","53","1","0","1","3","1","2","6","0","6","1","0","1","0","0","0","47","6","41","3","2","1","0","0","0","6","5","1","240453"
"240453","University of Wisconsin-Milwaukee","2018","Not on tenure/no tenure system, instructors","34","4","30","0","0","0","1","1","0","1","0","1","2","0","2","0","0","0","30","3","27","0","0","0","0","0","0","0","0","0","240453"
"240453","University of Wisconsin-Milwaukee","2018","Not on tenure/no tenure system, lecturers","217","97","120","0","0","0","11","2","9","1","1","0","6","2","4","0","0","0","193","91","102","1","0","1","0","0","0","5","1","4","240453"
"240727","University of Wyoming","2018","Tenured total","379","253","126","3","2","1","24","17","7","9","4","5","9","4","5","1","1","0","258","180","78","0","0","0","48","23","25","27","22","5","-2"
"240727","University of Wyoming","2018","Tenured, professors","186","139","47","0","0","0","10","9","1","5","2","3","6","4","2","1","1","0","137","101","36","0","0","0","17","13","4","10","9","1","-2"
"240727","University of Wyoming","2018","Tenured, associate professors","193","114","79","3","2","1","14","8","6","4","2","2","3","0","3","0","0","0","121","79","42","0","0","0","31","10","21","17","13","4","-2"
"240727","University of Wyoming","2018","On-Tenure track total","155","88","67","0","0","0","10","5","5","0","0","0","1","0","1","0","0","0","63","32","31","1","0","1","57","33","24","23","18","5","-2"
"240727","University of Wyoming","2018","On-tenure track, associate professors","7","3","4","0","0","0","0","0","0","0","0","0","0","0","0","0","0","0","4","3","1","0","0","0","3","0","3","0","0","0","-2"
"240727","University of Wyoming","2018","On-tenure track, assistant professors","148","85","63","0","0","0","10","5","5","0","0","0","1","0","1","0","0","0","59","29","30","1","0","1","54","33","21","23","18","5","-2"
"240727","University of Wyoming","2018","Not on tenure track/No tenure system system total","196","86","110","0","0","0","4","1","3","1","1","0","2","0","2","0","0","0","131","53","78","1","0","1","48","26","22","9","5","4","-2"
"240727","University of Wyoming","2018","Not on tenure/no tenure system, professors","3","1","2","0","0","0","0","0","0","0","0","0","0","0","0","0","0","0","2","0","2","0","0","0","1","1","0","0","0","0","-2"
"240727","University of Wyoming","2018","Not on tenure/no tenure system, associate professors","5","1","4","0","0","0","0","0","0","0","0","0","0","0","0","0","0","0","5","1","4","0","0","0","0","0","0","0","0","0","-2"
"240727","University of Wyoming","2018","Not on tenure/no tenure system, assistant professors","10","2","8","0","0","0","1","0","1","0","0","0","0","0","0","0","0","0","5","0","5","0","0","0","4","2","2","0","0","0","-2"
"240727","University of Wyoming","2018","Not on tenure/no tenure system, instructors","20","14","6","0","0","0","1","0","1","1","1","0","0","0","0","0","0","0","11","9","2","1","0","1","5","3","2","1","1","0","-2"
"240727","University of Wyoming","2018","Not on tenure/no tenure system, lecturers","157","67","90","0","0","0","2","1","1","0","0","0","2","0","2","0","0","0","107","42","65","0","0","0","38","20","18","8","4","4","-2"
"240727","University of Wyoming","2018","Not on tenure/no tenure system, no academic rank","1","1","0","0","0","0","0","0","0","0","0","0","0","0","0","0","0","0","1","1","0","0","0","0","0","0","0","0","0","0","-2"
"243665","University of the Virgin Islands","2018","Tenured total","36","26","10","0","0","0","1","1","0","12","10","2","0","0","0","0","0","0","22","15","7","0","0","0","1","0","1","0","0","0","-2"
"243665","University of the Virgin Islands","2018","Tenured, professors","16","12","4","0","0","0","0","0","0","4","4","0","0","0","0","0","0","0","12","8","4","0","0","0","0","0","0","0","0","0","-2"
"243665","University of the Virgin Islands","2018","Tenured, associate professors","15","11","4","0","0","0","1","1","0","7","5","2","0","0","0","0","0","0","7","5","2","0","0","0","0","0","0","0","0","0","-2"
"243665","University of the Virgin Islands","2018","Tenured, assistant professors","5","3","2","0","0","0","0","0","0","1","1","0","0","0","0","0","0","0","3","2","1","0","0","0","1","0","1","0","0","0","-2"
"243665","University of the Virgin Islands","2018","On-Tenure track total","16","8","8","0","0","0","1","1","0","7","3","4","0","0","0","0","0","0","8","4","4","0","0","0","0","0","0","0","0","0","-2"
"243665","University of the Virgin Islands","2018","On-tenure track, associate professors","5","3","2","0","0","0","1","1","0","2","1","1","0","0","0","0","0","0","2","1","1","0","0","0","0","0","0","0","0","0","-2"
"243665","University of the Virgin Islands","2018","On-tenure track, assistant professors","11","5","6","0","0","0","0","0","0","5","2","3","0","0","0","0","0","0","6","3","3","0","0","0","0","0","0","0","0","0","-2"
"243665","University of the Virgin Islands","2018","Not on tenure track/No tenure system system total","36","11","25","0","0","0","1","0","1","18","5","13","3","1","2","0","0","0","12","4","8","0","0","0","2","1","1","0","0","0","-2"
"243665","University of the Virgin Islands","2018","Not on tenure/no tenure system, professors","1","0","1","0","0","0","0","0","0","0","0","0","0","0","0","0","0","0","1","0","1","0","0","0","0","0","0","0","0","0","-2"
"243665","University of the Virgin Islands","2018","Not on tenure/no tenure system, associate professors","4","2","2","0","0","0","0","0","0","3","1","2","1","1","0","0","0","0","0","0","0","0","0","0","0","0","0","0","0","0","-2"
"243665","University of the Virgin Islands","2018","Not on tenure/no tenure system, assistant professors","22","6","16","0","0","0","1","0","1","12","3","9","1","0","1","0","0","0","6","2","4","0","0","0","2","1","1","0","0","0","-2"
"243665","University of the Virgin Islands","2018","Not on tenure/no tenure system, instructors","8","2","6","0","0","0","0","0","0","2","0","2","1","0","1","0","0","0","5","2","3","0","0","0","0","0","0","0","0","0","-2"
"243665","University of the Virgin Islands","2018","Not on tenure/no tenure system, no academic rank","1","1","0","0","0","0","0","0","0","1","1","0","0","0","0","0","0","0","0","0","0","0","0","0","0","0","0","0","0","0","-2"
"243744","Stanford University","2018","Tenured total","1132","869","263","1","1","0","135","104","31","22","14","8","37","25","12","0","0","0","778","606","172","10","3","7","52","42","10","97","74","23","-2"
"243744","Stanford University","2018","Tenured, professors","907","716","191","1","1","0","97","77","20","18","13","5","26","19","7","0","0","0","645","512","133","6","1","5","41","35","6","73","58","15","-2"
"243744","Stanford University","2018","Tenured, associate professors","225","153","72","0","0","0","38","27","11","4","1","3","11","6","5","0","0","0","133","94","39","4","2","2","11","7","4","24","16","8","-2"
"243744","Stanford University","2018","On-Tenure track total","348","213","135","1","0","1","52","31","21","7","3","4","21","12","9","0","0","0","168","100","68","7","3","4","37","29","8","55","35","20","-2"
"243744","Stanford University","2018","On-tenure track, professors","8","5","3","0","0","0","1","1","0","0","0","0","1","1","0","0","0","0","6","3","3","0","0","0","0","0","0","0","0","0","-2"
"243744","Stanford University","2018","On-tenure track, associate professors","28","20","8","0","0","0","4","2","2","0","0","0","2","2","0","0","0","0","17","11","6","0","0","0","2","2","0","3","3","0","-2"
"243744","Stanford University","2018","On-tenure track, assistant professors","312","188","124","1","0","1","47","28","19","7","3","4","18","9","9","0","0","0","145","86","59","7","3","4","35","27","8","52","32","20","-2"
"243744","Stanford University","2018","Not on tenure track/No tenure system system total","593","390","203","1","1","0","146","86","60","12","4","8","23","19","4","0","0","0","354","242","112","4","2","2","26","19","7","27","17","10","-2"
"243744","Stanford University","2018","Not on tenure/no tenure system, professors","304","218","86","0","0","0","59","37","22","4","1","3","10","10","0","0","0","0","209","152","57","1","1","0","9","8","1","12","9","3","-2"
"243744","Stanford University","2018","Not on tenure/no tenure system, associate professors","159","101","58","0","0","0","41","24","17","5","2","3","8","6","2","0","0","0","88","60","28","1","0","1","9","6","3","7","3","4","-2"
"243744","Stanford University","2018","Not on tenure/no tenure system, assistant professors","130","71","59","1","1","0","46","25","21","3","1","2","5","3","2","0","0","0","57","30","27","2","1","1","8","5","3","8","5","3","-2"
"243780","Purdue University-Main Campus","2018","Tenured total","1236","918","318","1","1","0","252","198","54","36","22","14","52","39","13","1","1","0","878","647","231","11","6","5","1","0","1","4","4","0","-2"
"243780","Purdue University-Main Campus","2018","Tenured, professors","771","613","158","1","1","0","165","140","25","15","15","0","28","21","7","0","0","0","555","433","122","5","2","3","1","0","1","1","1","0","-2"
"243780","Purdue University-Main Campus","2018","Tenured, associate professors","464","304","160","0","0","0","87","58","29","21","7","14","24","18","6","1","1","0","322","213","109","6","4","2","0","0","0","3","3","0","-2"
"243780","Purdue University-Main Campus","2018","Tenured, assistant professors","1","1","0","0","0","0","0","0","0","0","0","0","0","0","0","0","0","0","1","1","0","0","0","0","0","0","0","0","0","0","-2"
"243780","Purdue University-Main Campus","2018","On-Tenure track total","479","287","192","1","0","1","85","50","35","14","10","4","14","10","4","0","0","0","247","136","111","7","3","4","2","0","2","109","78","31","-2"
"243780","Purdue University-Main Campus","2018","On-tenure track, professors","5","4","1","0","0","0","0","0","0","0","0","0","0","0","0","0","0","0","2","2","0","0","0","0","0","0","0","3","2","1","-2"
"243780","Purdue University-Main Campus","2018","On-tenure track, associate professors","10","9","1","0","0","0","0","0","0","1","1","0","0","0","0","0","0","0","4","3","1","0","0","0","0","0","0","5","5","0","-2"
"243780","Purdue University-Main Campus","2018","On-tenure track, assistant professors","464","274","190","1","0","1","85","50","35","13","9","4","14","10","4","0","0","0","241","131","110","7","3","4","2","0","2","101","71","30","-2"
"243780","Purdue University-Main Campus","2018","Not on tenure track/No tenure system system total","94","57","37","1","1","0","3","2","1","1","0","1","3","2","1","0","0","0","35","18","17","0","0","0","15","9","6","36","25","11","-2"
"243780","Purdue University-Main Campus","2018","Not on tenure/no tenure system, professors","5","5","0","0","0","0","0","0","0","0","0","0","0","0","0","0","0","0","3","3","0","0","0","0","0","0","0","2","2","0","-2"
"243780","Purdue University-Main Campus","2018","Not on tenure/no tenure system, associate professors","3","2","1","0","0","0","0","0","0","0","0","0","0","0","0","0","0","0","1","0","1","0","0","0","0","0","0","2","2","0","-2"
"243780","Purdue University-Main Campus","2018","Not on tenure/no tenure system, assistant professors","58","35","23","1","1","0","1","1","0","0","0","0","0","0","0","0","0","0","14","6","8","0","0","0","11","6","5","31","21","10","-2"
"243780","Purdue University-Main Campus","2018","Not on tenure/no tenure system, instructors","13","7","6","0","0","0","0","0","0","0","0","0","2","1","1","0","0","0","6","3","3","0","0","0","4","3","1","1","0","1","-2"
"243780","Purdue University-Main Campus","2018","Not on tenure/no tenure system, lecturers","15","8","7","0","0","0","2","1","1","1","0","1","1","1","0","0","0","0","11","6","5","0","0","0","0","0","0","0","0","0","-2"
"409698","California State University-Monterey Bay","2018","Tenured total","89","44","45","1","1","0","18","8","10","2","1","1","18","11","7","1","0","1","43","21","22","1","0","1","5","2","3","0","0","0","-2"
"409698","California State University-Monterey Bay","2018","Tenured, professors","61","32","29","1","1","0","14","7","7","1","0","1","10","7","3","1","0","1","30","16","14","1","0","1","3","1","2","0","0","0","-2"
"409698","California State University-Monterey Bay","2018","Tenured, associate professors","28","12","16","0","0","0","4","1","3","1","1","0","8","4","4","0","0","0","13","5","8","0","0","0","2","1","1","0","0","0","-2"
"409698","California State University-Monterey Bay","2018","On-Tenure track total","72","32","40","1","1","0","7","3","4","2","1","1","8","4","4","0","0","0","44","18","26","1","1","0","3","1","2","6","3","3","-2"
"409698","California State University-Monterey Bay","2018","On-tenure track, associate professors","5","4","1","0","0","0","0","0","0","0","0","0","0","0","0","0","0","0","4","3","1","0","0","0","0","0","0","1","1","0","-2"
"409698","California State University-Monterey Bay","2018","On-tenure track, assistant professors","67","28","39","1","1","0","7","3","4","2","1","1","8","4","4","0","0","0","40","15","25","1","1","0","3","1","2","5","2","3","-2"
"409698","California State University-Monterey Bay","2018","Not on tenure track/No tenure system system total","56","21","35","0","0","0","4","2","2","1","0","1","14","6","8","0","0","0","29","8","21","2","2","0","6","3","3","0","0","0","-2"
"409698","California State University-Monterey Bay","2018","Not on tenure/no tenure system, lecturers","56","21","35","0","0","0","4","2","2","1","0","1","14","6","8","0","0","0","29","8","21","2","2","0","6","3","3","0","0","0","-2"
"445188","University of California-Merced","2018","Tenured total","140","86","54","1","0","1","21","14","7","2","1","1","18","15","3","0","0","0","94","54","40","1","1","0","3","1","2","0","0","0","-2"
"445188","University of California-Merced","2018","Tenured, professors","70","48","22","0","0","0","12","10","2","0","0","0","8","7","1","0","0","0","48","31","17","0","0","0","2","0","2","0","0","0","-2"
"445188","University of California-Merced","2018","Tenured, associate professors","60","34","26","1","0","1","8","4","4","2","1","1","8","7","1","0","0","0","40","21","19","1","1","0","0","0","0","0","0","0","-2"
"445188","University of California-Merced","2018","Tenured, lecturers","10","4","6","0","0","0","1","0","1","0","0","0","2","1","1","0","0","0","6","2","4","0","0","0","1","1","0","0","0","0","-2"
"445188","University of California-Merced","2018","On-Tenure track total","126","70","56","0","0","0","23","13","10","2","1","1","17","5","12","0","0","0","43","28","15","5","1","4","12","5","7","24","17","7","-2"
"445188","University of California-Merced","2018","On-tenure track, associate professors","3","1","2","0","0","0","0","0","0","0","0","0","3","1","2","0","0","0","0","0","0","0","0","0","0","0","0","0","0","0","-2"
"445188","University of California-Merced","2018","On-tenure track, assistant professors","115","63","52","0","0","0","23","13","10","2","1","1","12","2","10","0","0","0","38","25","13","5","1","4","12","5","7","23","16","7","-2"
"445188","University of California-Merced","2018","On-tenure track, lecturers","8","6","2","0","0","0","0","0","0","0","0","0","2","2","0","0","0","0","5","3","2","0","0","0","0","0","0","1","1","0","-2"
"445188","University of California-Merced","2018","Not on tenure track/No tenure system system total","109","55","54","0","0","0","11","5","6","1","1","0","15","7","8","0","0","0","70","33","37","1","1","0","5","2","3","6","6","0","-2"
"445188","University of California-Merced","2018","Not on tenure/no tenure system, assistant professors","1","1","0","0","0","0","0","0","0","0","0","0","0","0","0","0","0","0","1","1","0","0","0","0","0","0","0","0","0","0","-2"
"445188","University of California-Merced","2018","Not on tenure/no tenure system, lecturers","108","54","54","0","0","0","11","5","6","1","1","0","15","7","8","0","0","0","69","32","37","1","1","0","5","2","3","6","6","0","-2"
