"unitid","institution name","year","S2019_IS.Instructional staff category","S2019_IS.Grand total","S2019_IS.Grand total men","S2019_IS.Grand total women","S2019_IS.American Indian or Alaska Native total","S2019_IS.American Indian or Alaska Native men","S2019_IS.American Indian or Alaska Native women","S2019_IS.Asian total","S2019_IS.Asian men","S2019_IS.Asian women","S2019_IS.Black or African American total","S2019_IS.Black or African American men","S2019_IS.Black or African American women","S2019_IS.Hispanic or Latino total","S2019_IS.Hispanic or Latino men","S2019_IS.Hispanic or Latino women","S2019_IS.Native Hawaiian or Other Pacific Islander total","S2019_IS.Native Hawaiian or Other Pacific Islander men","S2019_IS.Native Hawaiian or Other Pacific Islander women","S2019_IS.White total","S2019_IS.White men","S2019_IS.White women","S2019_IS.Two or more races total","S2019_IS.Two or more races men","S2019_IS.Two or more races women","S2019_IS.Race/ethnicity unknown total","S2019_IS.Race/ethnicity unknown men","S2019_IS.Race/ethnicity unknown women","S2019_IS.Nonresident alien total","S2019_IS.Nonresident alien men","S2019_IS.Nonresident alien women","IDX_HR"
"100654","Alabama A & M University","2019","Tenured total","99","68","31","0","0","0","13","8","5","75","54","21","0","0","0","0","0","0","6","2","4","1","0","1","0","0","0","4","4","0","-2"
"100654","Alabama A & M University","2019","Tenured, professors","49","37","12","0","0","0","8","6","2","35","27","8","0","0","0","0","0","0","3","2","1","1","0","1","0","0","0","2","2","0","-2"
"100654","Alabama A & M University","2019","Tenured, associate professors","32","22","10","0","0","0","5","2","3","24","18","6","0","0","0","0","0","0","1","0","1","0","0","0","0","0","0","2","2","0","-2"
"100654","Alabama A & M University","2019","Tenured, assistant professors","18","9","9","0","0","0","0","0","0","16","9","7","0","0","0","0","0","0","2","0","2","0","0","0","0","0","0","0","0","0","-2"
"100654","Alabama A & M University","2019","On-Tenure track total","39","16","23","0","0","0","8","5","3","19","5","14","0","0","0","0","0","0","6","4","2","0","0","0","0","0","0","6","2","4","-2"
"100654","Alabama A & M University","2019","On-tenure track, associate professors","9","5","4","0","0","0","5","4","1","1","1","0","0","0","0","0","0","0","1","0","1","0","0","0","0","0","0","2","0","2","-2"
"100654","Alabama A & M University","2019","On-tenure track, assistant professors","30","11","19","0","0","0","3","1","2","18","4","14","0","0","0","0","0","0","5","4","1","0","0","0","0","0","0","4","2","2","-2"
"100654","Alabama A & M University","2019","Not on tenure track/No tenure system system total","104","47","57","1","0","1","4","2","2","68","28","40","0","0","0","0","0","0","22","10","12","1","0","1","0","0","0","8","7","1","-2"
"100654","Alabama A & M University","2019","Not on tenure/no tenure system, associate professors","9","7","2","0","0","0","1","0","1","6","5","1","0","0","0","0","0","0","2","2","0","0","0","0","0","0","0","0","0","0","-2"
"100654","Alabama A & M University","2019","Not on tenure/no tenure system, assistant professors","50","26","24","0","0","0","2","2","0","31","14","17","0","0","0","0","0","0","12","7","5","1","0","1","0","0","0","4","3","1","-2"
"100654","Alabama A & M University","2019","Not on tenure/no tenure system, instructors","38","11","27","1","0","1","1","0","1","24","6","18","0","0","0","0","0","0","8","1","7","0","0","0","0","0","0","4","4","0","-2"
"100654","Alabama A & M University","2019","Not on tenure/no tenure system, lecturers","7","3","4","0","0","0","0","0","0","7","3","4","0","0","0","0","0","0","0","0","0","0","0","0","0","0","0","0","0","0","-2"
"100706","University of Alabama in Huntsville","2019","Tenured total","164","125","39","0","0","0","42","39","3","7","4","3","4","3","1","0","0","0","109","78","31","1","0","1","0","0","0","1","1","0","-2"
"100706","University of Alabama in Huntsville","2019","Tenured, professors","74","60","14","0","0","0","18","17","1","2","2","0","1","1","0","0","0","0","52","39","13","0","0","0","0","0","0","1","1","0","-2"
"100706","University of Alabama in Huntsville","2019","Tenured, associate professors","89","65","24","0","0","0","24","22","2","5","2","3","2","2","0","0","0","0","57","39","18","1","0","1","0","0","0","0","0","0","-2"
"100706","University of Alabama in Huntsville","2019","Tenured, assistant professors","1","0","1","0","0","0","0","0","0","0","0","0","1","0","1","0","0","0","0","0","0","0","0","0","0","0","0","0","0","0","-2"
"100706","University of Alabama in Huntsville","2019","On-Tenure track total","72","39","33","0","0","0","13","7","6","6","3","3","1","1","0","0","0","0","36","19","17","0","0","0","0","0","0","16","9","7","-2"
"100706","University of Alabama in Huntsville","2019","On-tenure track, associate professors","6","4","2","0","0","0","2","2","0","1","1","0","0","0","0","0","0","0","3","1","2","0","0","0","0","0","0","0","0","0","-2"
"100706","University of Alabama in Huntsville","2019","On-tenure track, assistant professors","66","35","31","0","0","0","11","5","6","5","2","3","1","1","0","0","0","0","33","18","15","0","0","0","0","0","0","16","9","7","-2"
"100706","University of Alabama in Huntsville","2019","Not on tenure track/No tenure system system total","127","32","95","1","1","0","7","1","6","7","1","6","3","1","2","0","0","0","108","28","80","0","0","0","0","0","0","1","0","1","-2"
"100706","University of Alabama in Huntsville","2019","Not on tenure/no tenure system, professors","1","0","1","0","0","0","0","0","0","0","0","0","0","0","0","0","0","0","1","0","1","0","0","0","0","0","0","0","0","0","-2"
"100706","University of Alabama in Huntsville","2019","Not on tenure/no tenure system, associate professors","6","1","5","0","0","0","0","0","0","0","0","0","1","0","1","0","0","0","5","1","4","0","0","0","0","0","0","0","0","0","-2"
"100706","University of Alabama in Huntsville","2019","Not on tenure/no tenure system, assistant professors","30","5","25","0","0","0","0","0","0","2","0","2","0","0","0","0","0","0","28","5","23","0","0","0","0","0","0","0","0","0","-2"
"100706","University of Alabama in Huntsville","2019","Not on tenure/no tenure system, instructors","16","1","15","0","0","0","0","0","0","2","0","2","0","0","0","0","0","0","14","1","13","0","0","0","0","0","0","0","0","0","-2"
"100706","University of Alabama in Huntsville","2019","Not on tenure/no tenure system, lecturers","74","25","49","1","1","0","7","1","6","3","1","2","2","1","1","0","0","0","60","21","39","0","0","0","0","0","0","1","0","1","-2"
"100751","The University of Alabama","2019","Tenured total","597","393","204","0","0","0","68","52","16","37","16","21","18","10","8","1","1","0","468","311","157","1","0","1","1","1","0","3","2","1","-2"
"100751","The University of Alabama","2019","Tenured, professors","287","214","73","0","0","0","32","27","5","15","9","6","8","6","2","1","1","0","231","171","60","0","0","0","0","0","0","0","0","0","-2"
"100751","The University of Alabama","2019","Tenured, associate professors","305","177","128","0","0","0","36","25","11","22","7","15","9","3","6","0","0","0","233","139","94","1","0","1","1","1","0","3","2","1","-2"
"100751","The University of Alabama","2019","Tenured, assistant professors","5","2","3","0","0","0","0","0","0","0","0","0","1","1","0","0","0","0","4","1","3","0","0","0","0","0","0","0","0","0","-2"
"100751","The University of Alabama","2019","On-Tenure track total","408","231","177","4","2","2","50","32","18","26","12","14","7","5","2","2","1","1","272","150","122","0","0","0","1","0","1","46","29","17","-2"
"100751","The University of Alabama","2019","On-tenure track, professors","20","11","9","0","0","0","3","3","0","1","0","1","1","1","0","0","0","0","14","7","7","0","0","0","1","0","1","0","0","0","-2"
"100751","The University of Alabama","2019","On-tenure track, associate professors","19","13","6","0","0","0","4","4","0","2","2","0","0","0","0","0","0","0","13","7","6","0","0","0","0","0","0","0","0","0","-2"
"100751","The University of Alabama","2019","On-tenure track, assistant professors","369","207","162","4","2","2","43","25","18","23","10","13","6","4","2","2","1","1","245","136","109","0","0","0","0","0","0","46","29","17","-2"
"100751","The University of Alabama","2019","Not on tenure track/No tenure system system total","523","210","313","0","0","0","19","7","12","31","6","25","16","9","7","0","0","0","436","179","257","5","1","4","4","2","2","12","6","6","-2"
"100751","The University of Alabama","2019","Not on tenure/no tenure system, professors","12","6","6","0","0","0","1","1","0","1","0","1","1","1","0","0","0","0","9","4","5","0","0","0","0","0","0","0","0","0","-2"
"100751","The University of Alabama","2019","Not on tenure/no tenure system, associate professors","39","12","27","0","0","0","1","0","1","0","0","0","0","0","0","0","0","0","38","12","26","0","0","0","0","0","0","0","0","0","-2"
"100751","The University of Alabama","2019","Not on tenure/no tenure system, assistant professors","128","44","84","0","0","0","9","4","5","12","3","9","1","1","0","0","0","0","101","35","66","2","0","2","2","1","1","1","0","1","-2"
"100751","The University of Alabama","2019","Not on tenure/no tenure system, instructors","328","136","192","0","0","0","7","1","6","17","3","14","13","6","7","0","0","0","275","118","157","3","1","2","2","1","1","11","6","5","-2"
"100751","The University of Alabama","2019","Not on tenure/no tenure system, lecturers","16","12","4","0","0","0","1","1","0","1","0","1","1","1","0","0","0","0","13","10","3","0","0","0","0","0","0","0","0","0","-2"
"101675","Miles College","2019","Tenured total","7","6","1","0","0","0","3","2","1","4","4","0","0","0","0","0","0","0","0","0","0","0","0","0","0","0","0","0","0","0","-2"
"101675","Miles College","2019","Tenured, professors","7","6","1","0","0","0","3","2","1","4","4","0","0","0","0","0","0","0","0","0","0","0","0","0","0","0","0","0","0","0","-2"
"101675","Miles College","2019","On-Tenure track total","70","26","44","0","0","0","1","0","1","56","18","38","0","0","0","0","0","0","12","7","5","0","0","0","1","1","0","0","0","0","-2"
"101675","Miles College","2019","On-tenure track, associate professors","7","5","2","0","0","0","0","0","0","4","2","2","0","0","0","0","0","0","2","2","0","0","0","0","1","1","0","0","0","0","-2"
"101675","Miles College","2019","On-tenure track, assistant professors","17","3","14","0","0","0","1","0","1","14","3","11","0","0","0","0","0","0","2","0","2","0","0","0","0","0","0","0","0","0","-2"
"101675","Miles College","2019","On-tenure track, instructors","46","18","28","0","0","0","0","0","0","38","13","25","0","0","0","0","0","0","8","5","3","0","0","0","0","0","0","0","0","0","-2"
"102094","University of South Alabama","2019","Tenured total","247","164","83","0","0","0","27","19","8","6","4","2","1","1","0","0","0","0","211","139","72","2","1","1","0","0","0","0","0","0","-2"
"102094","University of South Alabama","2019","Tenured, professors","130","99","31","0","0","0","9","8","1","2","2","0","0","0","0","0","0","0","119","89","30","0","0","0","0","0","0","0","0","0","-2"
"102094","University of South Alabama","2019","Tenured, associate professors","113","63","50","0","0","0","18","11","7","3","1","2","1","1","0","0","0","0","89","49","40","2","1","1","0","0","0","0","0","0","-2"
"102094","University of South Alabama","2019","Tenured, assistant professors","4","2","2","0","0","0","0","0","0","1","1","0","0","0","0","0","0","0","3","1","2","0","0","0","0","0","0","0","0","0","-2"
"102094","University of South Alabama","2019","On-Tenure track total","134","82","52","0","0","0","25","15","10","4","3","1","2","2","0","0","0","0","99","60","39","4","2","2","0","0","0","0","0","0","-2"
"102094","University of South Alabama","2019","On-tenure track, professors","1","1","0","0","0","0","0","0","0","1","1","0","0","0","0","0","0","0","0","0","0","0","0","0","0","0","0","0","0","0","-2"
"102094","University of South Alabama","2019","On-tenure track, associate professors","12","7","5","0","0","0","2","1","1","0","0","0","0","0","0","0","0","0","10","6","4","0","0","0","0","0","0","0","0","0","-2"
"102094","University of South Alabama","2019","On-tenure track, assistant professors","121","74","47","0","0","0","23","14","9","3","2","1","2","2","0","0","0","0","89","54","35","4","2","2","0","0","0","0","0","0","-2"
"102094","University of South Alabama","2019","Not on tenure track/No tenure system system total","430","185","245","0","0","0","41","26","15","32","4","28","4","3","1","1","0","1","347","149","198","2","1","1","3","2","1","0","0","0","-2"
"102094","University of South Alabama","2019","Not on tenure/no tenure system, professors","32","24","8","0","0","0","5","5","0","1","0","1","2","1","1","0","0","0","24","18","6","0","0","0","0","0","0","0","0","0","-2"
"102094","University of South Alabama","2019","Not on tenure/no tenure system, associate professors","51","27","24","0","0","0","5","4","1","0","0","0","2","2","0","0","0","0","44","21","23","0","0","0","0","0","0","0","0","0","-2"
"102094","University of South Alabama","2019","Not on tenure/no tenure system, assistant professors","217","96","121","0","0","0","26","17","9","25","4","21","0","0","0","0","0","0","163","73","90","1","0","1","2","2","0","0","0","0","-2"
"102094","University of South Alabama","2019","Not on tenure/no tenure system, instructors","129","38","91","0","0","0","5","0","5","6","0","6","0","0","0","1","0","1","115","37","78","1","1","0","1","0","1","0","0","0","-2"
"102094","University of South Alabama","2019","Not on tenure/no tenure system, lecturers","1","0","1","0","0","0","0","0","0","0","0","0","0","0","0","0","0","0","1","0","1","0","0","0","0","0","0","0","0","0","-2"
"102377","Tuskegee University","2019","Tenured total","107","68","39","0","0","0","33","26","7","51","28","23","0","0","0","0","0","0","14","9","5","0","0","0","9","5","4","0","0","0","-2"
"102377","Tuskegee University","2019","Tenured, professors","48","36","12","0","0","0","18","17","1","22","13","9","0","0","0","0","0","0","6","4","2","0","0","0","2","2","0","0","0","0","-2"
"102377","Tuskegee University","2019","Tenured, associate professors","53","29","24","0","0","0","14","8","6","25","13","12","0","0","0","0","0","0","8","5","3","0","0","0","6","3","3","0","0","0","-2"
"102377","Tuskegee University","2019","Tenured, assistant professors","6","3","3","0","0","0","1","1","0","4","2","2","0","0","0","0","0","0","0","0","0","0","0","0","1","0","1","0","0","0","-2"
"102377","Tuskegee University","2019","On-Tenure track total","69","39","30","0","0","0","20","15","5","24","10","14","0","0","0","0","0","0","16","8","8","0","0","0","9","6","3","0","0","0","-2"
"102377","Tuskegee University","2019","On-tenure track, professors","2","2","0","0","0","0","2","2","0","0","0","0","0","0","0","0","0","0","0","0","0","0","0","0","0","0","0","0","0","0","-2"
"102377","Tuskegee University","2019","On-tenure track, associate professors","13","8","5","0","0","0","2","2","0","5","2","3","0","0","0","0","0","0","3","1","2","0","0","0","3","3","0","0","0","0","-2"
"102377","Tuskegee University","2019","On-tenure track, assistant professors","53","29","24","0","0","0","16","11","5","18","8","10","0","0","0","0","0","0","13","7","6","0","0","0","6","3","3","0","0","0","-2"
"102377","Tuskegee University","2019","On-tenure track, instructors","1","0","1","0","0","0","0","0","0","1","0","1","0","0","0","0","0","0","0","0","0","0","0","0","0","0","0","0","0","0","-2"
"102377","Tuskegee University","2019","Not on tenure track/No tenure system system total","60","25","35","0","0","0","4","3","1","35","15","20","0","0","0","0","0","0","11","6","5","0","0","0","10","1","9","0","0","0","-2"
"102377","Tuskegee University","2019","Not on tenure/no tenure system, professors","2","2","0","0","0","0","1","1","0","1","1","0","0","0","0","0","0","0","0","0","0","0","0","0","0","0","0","0","0","0","-2"
"102377","Tuskegee University","2019","Not on tenure/no tenure system, associate professors","17","7","10","0","0","0","1","1","0","9","3","6","0","0","0","0","0","0","5","3","2","0","0","0","2","0","2","0","0","0","-2"
"102377","Tuskegee University","2019","Not on tenure/no tenure system, assistant professors","27","10","17","0","0","0","2","1","1","14","6","8","0","0","0","0","0","0","4","2","2","0","0","0","7","1","6","0","0","0","-2"
"102377","Tuskegee University","2019","Not on tenure/no tenure system, instructors","12","5","7","0","0","0","0","0","0","9","4","5","0","0","0","0","0","0","2","1","1","0","0","0","1","0","1","0","0","0","-2"
"102377","Tuskegee University","2019","Not on tenure/no tenure system, lecturers","2","1","1","0","0","0","0","0","0","2","1","1","0","0","0","0","0","0","0","0","0","0","0","0","0","0","0","0","0","0","-2"
"102614","University of Alaska Fairbanks","2019","Tenured total","184","115","69","3","2","1","22","18","4","1","0","1","3","1","2","0","0","0","145","88","57","4","3","1","6","3","3","0","0","0","-2"
"102614","University of Alaska Fairbanks","2019","Tenured, professors","91","62","29","0","0","0","10","9","1","1","0","1","0","0","0","0","0","0","74","50","24","2","1","1","4","2","2","0","0","0","-2"
"102614","University of Alaska Fairbanks","2019","Tenured, associate professors","92","53","39","3","2","1","12","9","3","0","0","0","3","1","2","0","0","0","70","38","32","2","2","0","2","1","1","0","0","0","-2"
"102614","University of Alaska Fairbanks","2019","Tenured, assistant professors","1","0","1","0","0","0","0","0","0","0","0","0","0","0","0","0","0","0","1","0","1","0","0","0","0","0","0","0","0","0","-2"
"102614","University of Alaska Fairbanks","2019","On-Tenure track total","52","25","27","6","0","6","3","2","1","0","0","0","1","1","0","0","0","0","32","16","16","3","0","3","1","1","0","6","5","1","-2"
"102614","University of Alaska Fairbanks","2019","On-tenure track, associate professors","5","3","2","0","0","0","0","0","0","0","0","0","0","0","0","0","0","0","4","3","1","0","0","0","0","0","0","1","0","1","-2"
"102614","University of Alaska Fairbanks","2019","On-tenure track, assistant professors","47","22","25","6","0","6","3","2","1","0","0","0","1","1","0","0","0","0","28","13","15","3","0","3","1","1","0","5","5","0","-2"
"102614","University of Alaska Fairbanks","2019","Not on tenure track/No tenure system system total","79","35","44","7","2","5","3","2","1","2","1","1","3","0","3","1","0","1","54","25","29","1","0","1","7","4","3","1","1","0","-2"
"102614","University of Alaska Fairbanks","2019","Not on tenure/no tenure system, associate professors","8","1","7","1","0","1","0","0","0","0","0","0","0","0","0","1","0","1","6","1","5","0","0","0","0","0","0","0","0","0","-2"
"102614","University of Alaska Fairbanks","2019","Not on tenure/no tenure system, assistant professors","40","19","21","5","1","4","1","1","0","1","1","0","1","0","1","0","0","0","26","12","14","0","0","0","6","4","2","0","0","0","-2"
"102614","University of Alaska Fairbanks","2019","Not on tenure/no tenure system, instructors","25","13","12","1","1","0","1","0","1","1","0","1","2","0","2","0","0","0","18","12","6","1","0","1","1","0","1","0","0","0","-2"
"102614","University of Alaska Fairbanks","2019","Not on tenure/no tenure system, no academic rank","6","2","4","0","0","0","1","1","0","0","0","0","0","0","0","0","0","0","4","0","4","0","0","0","0","0","0","1","1","0","-2"
"104151","Arizona State University-Tempe","2019","Tenured total","1017","686","331","12","5","7","150","109","41","22","13","9","86","53","33","0","0","0","695","478","217","10","2","8","28","17","11","14","9","5","-2"
"104151","Arizona State University-Tempe","2019","Tenured, professors","573","414","159","3","3","0","79","62","17","10","6","4","42","26","16","0","0","0","413","302","111","6","2","4","12","7","5","8","6","2","-2"
"104151","Arizona State University-Tempe","2019","Tenured, associate professors","444","272","172","9","2","7","71","47","24","12","7","5","44","27","17","0","0","0","282","176","106","4","0","4","16","10","6","6","3","3","-2"
"104151","Arizona State University-Tempe","2019","On-Tenure track total","366","206","160","8","4","4","67","36","31","10","7","3","18","7","11","0","0","0","160","91","69","6","2","4","43","21","22","54","38","16","-2"
"104151","Arizona State University-Tempe","2019","On-tenure track, professors","1","1","0","0","0","0","0","0","0","0","0","0","0","0","0","0","0","0","1","1","0","0","0","0","0","0","0","0","0","0","-2"
"104151","Arizona State University-Tempe","2019","On-tenure track, associate professors","14","11","3","0","0","0","1","1","0","2","2","0","0","0","0","0","0","0","8","5","3","0","0","0","1","1","0","2","2","0","-2"
"104151","Arizona State University-Tempe","2019","On-tenure track, assistant professors","351","194","157","8","4","4","66","35","31","8","5","3","18","7","11","0","0","0","151","85","66","6","2","4","42","20","22","52","36","16","-2"
"104151","Arizona State University-Tempe","2019","Not on tenure track/No tenure system system total","812","412","400","5","3","2","64","31","33","13","9","4","60","32","28","0","0","0","569","279","290","9","5","4","48","25","23","44","28","16","-2"
"104151","Arizona State University-Tempe","2019","Not on tenure/no tenure system, professors","61","43","18","1","1","0","2","1","1","4","4","0","4","4","0","0","0","0","38","27","11","3","2","1","8","3","5","1","1","0","-2"
"104151","Arizona State University-Tempe","2019","Not on tenure/no tenure system, associate professors","59","40","19","2","1","1","5","4","1","1","1","0","5","4","1","0","0","0","42","27","15","0","0","0","4","3","1","0","0","0","-2"
"104151","Arizona State University-Tempe","2019","Not on tenure/no tenure system, assistant professors","136","65","71","0","0","0","10","6","4","3","0","3","9","4","5","0","0","0","89","43","46","2","0","2","11","3","8","12","9","3","-2"
"104151","Arizona State University-Tempe","2019","Not on tenure/no tenure system, instructors","219","95","124","1","0","1","11","3","8","2","2","0","19","6","13","0","0","0","165","71","94","2","2","0","12","6","6","7","5","2","-2"
"104151","Arizona State University-Tempe","2019","Not on tenure/no tenure system, lecturers","332","165","167","1","1","0","36","17","19","3","2","1","23","14","9","0","0","0","234","110","124","2","1","1","12","9","3","21","11","10","-2"
"104151","Arizona State University-Tempe","2019","Not on tenure/no tenure system, no academic rank","5","4","1","0","0","0","0","0","0","0","0","0","0","0","0","0","0","0","1","1","0","0","0","0","1","1","0","3","2","1","-2"
"104179","University of Arizona","2019","Tenured total","1141","752","389","6","2","4","128","91","37","17","10","7","104","59","45","0","0","0","788","529","259","4","1","3","88","55","33","6","5","1","-2"
"104179","University of Arizona","2019","Tenured, professors","725","503","222","3","1","2","68","50","18","8","5","3","58","35","23","0","0","0","546","380","166","2","1","1","37","28","9","3","3","0","-2"
"104179","University of Arizona","2019","Tenured, associate professors","416","249","167","3","1","2","60","41","19","9","5","4","46","24","22","0","0","0","242","149","93","2","0","2","51","27","24","3","2","1","-2"
"104179","University of Arizona","2019","On-Tenure track total","406","238","168","5","2","3","49","29","20","12","7","5","54","30","24","0","0","0","194","114","80","8","3","5","35","23","12","49","30","19","-2"
"104179","University of Arizona","2019","On-tenure track, professors","2","2","0","0","0","0","0","0","0","0","0","0","0","0","0","0","0","0","2","2","0","0","0","0","0","0","0","0","0","0","-2"
"104179","University of Arizona","2019","On-tenure track, associate professors","27","18","9","0","0","0","7","5","2","1","0","1","7","5","2","0","0","0","8","5","3","0","0","0","1","1","0","3","2","1","-2"
"104179","University of Arizona","2019","On-tenure track, assistant professors","377","218","159","5","2","3","42","24","18","11","7","4","47","25","22","0","0","0","184","107","77","8","3","5","34","22","12","46","28","18","-2"
"104179","University of Arizona","2019","Not on tenure track/No tenure system system total","543","240","303","3","2","1","24","11","13","13","7","6","88","40","48","0","0","0","334","145","189","9","4","5","38","19","19","34","12","22","-2"
"104179","University of Arizona","2019","Not on tenure/no tenure system, professors","53","32","21","0","0","0","5","4","1","0","0","0","6","4","2","0","0","0","34","20","14","0","0","0","6","3","3","2","1","1","-2"
"104179","University of Arizona","2019","Not on tenure/no tenure system, associate professors","63","22","41","0","0","0","1","0","1","2","1","1","8","2","6","0","0","0","45","15","30","0","0","0","5","2","3","2","2","0","-2"
"104179","University of Arizona","2019","Not on tenure/no tenure system, assistant professors","163","54","109","1","0","1","3","2","1","5","1","4","23","9","14","0","0","0","101","33","68","5","2","3","11","4","7","14","3","11","-2"
"104179","University of Arizona","2019","Not on tenure/no tenure system, instructors","76","38","38","1","1","0","5","1","4","0","0","0","24","12","12","0","0","0","31","18","13","0","0","0","5","3","2","10","3","7","-2"
"104179","University of Arizona","2019","Not on tenure/no tenure system, lecturers","188","94","94","1","1","0","10","4","6","6","5","1","27","13","14","0","0","0","123","59","64","4","2","2","11","7","4","6","3","3","-2"
"104586","Embry-Riddle Aeronautical University-Prescott","2019","Tenured total","48","37","11","0","0","0","6","3","3","0","0","0","2","2","0","0","0","0","39","31","8","1","1","0","0","0","0","0","0","0","-2"
"104586","Embry-Riddle Aeronautical University-Prescott","2019","Tenured, professors","22","17","5","0","0","0","4","2","2","0","0","0","0","0","0","0","0","0","17","14","3","1","1","0","0","0","0","0","0","0","-2"
"104586","Embry-Riddle Aeronautical University-Prescott","2019","Tenured, associate professors","23","17","6","0","0","0","2","1","1","0","0","0","2","2","0","0","0","0","19","14","5","0","0","0","0","0","0","0","0","0","-2"
"104586","Embry-Riddle Aeronautical University-Prescott","2019","Tenured, assistant professors","3","3","0","0","0","0","0","0","0","0","0","0","0","0","0","0","0","0","3","3","0","0","0","0","0","0","0","0","0","0","-2"
"104586","Embry-Riddle Aeronautical University-Prescott","2019","On-Tenure track total","51","36","15","0","0","0","8","6","2","2","2","0","1","1","0","0","0","0","39","27","12","1","0","1","0","0","0","0","0","0","-2"
"104586","Embry-Riddle Aeronautical University-Prescott","2019","On-tenure track, associate professors","4","3","1","0","0","0","1","1","0","1","1","0","0","0","0","0","0","0","2","1","1","0","0","0","0","0","0","0","0","0","-2"
"104586","Embry-Riddle Aeronautical University-Prescott","2019","On-tenure track, assistant professors","47","33","14","0","0","0","7","5","2","1","1","0","1","1","0","0","0","0","37","26","11","1","0","1","0","0","0","0","0","0","-2"
"104586","Embry-Riddle Aeronautical University-Prescott","2019","Not on tenure track/No tenure system system total","38","27","11","0","0","0","0","0","0","0","0","0","0","0","0","0","0","0","38","27","11","0","0","0","0","0","0","0","0","0","-2"
"104586","Embry-Riddle Aeronautical University-Prescott","2019","Not on tenure/no tenure system, associate professors","4","4","0","0","0","0","0","0","0","0","0","0","0","0","0","0","0","0","4","4","0","0","0","0","0","0","0","0","0","0","-2"
"104586","Embry-Riddle Aeronautical University-Prescott","2019","Not on tenure/no tenure system, assistant professors","18","13","5","0","0","0","0","0","0","0","0","0","0","0","0","0","0","0","18","13","5","0","0","0","0","0","0","0","0","0","-2"
"104586","Embry-Riddle Aeronautical University-Prescott","2019","Not on tenure/no tenure system, instructors","16","10","6","0","0","0","0","0","0","0","0","0","0","0","0","0","0","0","16","10","6","0","0","0","0","0","0","0","0","0","-2"
"105330","Northern Arizona University","2019","Tenured total","411","242","169","12","5","7","25","13","12","6","4","2","25","12","13","1","1","0","318","193","125","2","0","2","18","12","6","4","2","2","-2"
"105330","Northern Arizona University","2019","Tenured, professors","272","167","105","5","2","3","15","7","8","4","3","1","15","6","9","1","1","0","216","138","78","1","0","1","11","8","3","4","2","2","-2"
"105330","Northern Arizona University","2019","Tenured, associate professors","139","75","64","7","3","4","10","6","4","2","1","1","10","6","4","0","0","0","102","55","47","1","0","1","7","4","3","0","0","0","-2"
"105330","Northern Arizona University","2019","On-Tenure track total","134","74","60","8","6","2","11","5","6","0","0","0","7","2","5","0","0","0","86","48","38","5","3","2","4","2","2","13","8","5","-2"
"105330","Northern Arizona University","2019","On-tenure track, associate professors","7","6","1","0","0","0","0","0","0","0","0","0","0","0","0","0","0","0","6","5","1","0","0","0","0","0","0","1","1","0","-2"
"105330","Northern Arizona University","2019","On-tenure track, assistant professors","127","68","59","8","6","2","11","5","6","0","0","0","7","2","5","0","0","0","80","43","37","5","3","2","4","2","2","12","7","5","-2"
"105330","Northern Arizona University","2019","Not on tenure track/No tenure system system total","606","238","368","7","3","4","25","7","18","14","5","9","39","11","28","1","0","1","477","186","291","8","2","6","20","13","7","15","11","4","-2"
"105330","Northern Arizona University","2019","Not on tenure/no tenure system, professors","19","5","14","0","0","0","0","0","0","0","0","0","3","1","2","0","0","0","16","4","12","0","0","0","0","0","0","0","0","0","-2"
"105330","Northern Arizona University","2019","Not on tenure/no tenure system, associate professors","59","23","36","0","0","0","2","1","1","2","0","2","5","2","3","0","0","0","49","20","29","1","0","1","0","0","0","0","0","0","-2"
"105330","Northern Arizona University","2019","Not on tenure/no tenure system, assistant professors","161","51","110","1","0","1","8","4","4","6","3","3","9","1","8","0","0","0","124","39","85","4","1","3","4","1","3","5","2","3","-2"
"105330","Northern Arizona University","2019","Not on tenure/no tenure system, instructors","50","26","24","0","0","0","0","0","0","0","0","0","2","0","2","0","0","0","45","23","22","0","0","0","1","1","0","2","2","0","-2"
"105330","Northern Arizona University","2019","Not on tenure/no tenure system, lecturers","317","133","184","6","3","3","15","2","13","6","2","4","20","7","13","1","0","1","243","100","143","3","1","2","15","11","4","8","7","1","-2"
"110404","California Institute of Technology","2019","Tenured total","255","205","50","0","0","0","35","29","6","3","3","0","9","9","0","0","0","0","203","161","42","0","0","0","1","1","0","4","2","2","-2"
"110404","California Institute of Technology","2019","Tenured, professors","255","205","50","0","0","0","35","29","6","3","3","0","9","9","0","0","0","0","203","161","42","0","0","0","1","1","0","4","2","2","-2"
"110404","California Institute of Technology","2019","On-Tenure track total","46","31","15","0","0","0","7","4","3","2","1","1","2","0","2","0","0","0","29","22","7","0","0","0","0","0","0","6","4","2","-2"
"110404","California Institute of Technology","2019","On-tenure track, associate professors","2","1","1","0","0","0","1","0","1","0","0","0","0","0","0","0","0","0","1","1","0","0","0","0","0","0","0","0","0","0","-2"
"110404","California Institute of Technology","2019","On-tenure track, assistant professors","44","30","14","0","0","0","6","4","2","2","1","1","2","0","2","0","0","0","28","21","7","0","0","0","0","0","0","6","4","2","-2"
"110404","California Institute of Technology","2019","Not on tenure track/No tenure system system total","37","26","11","0","0","0","3","0","3","0","0","0","3","2","1","0","0","0","20","16","4","0","0","0","1","1","0","10","7","3","-2"
"110404","California Institute of Technology","2019","Not on tenure/no tenure system, instructors","15","10","5","0","0","0","0","0","0","0","0","0","0","0","0","0","0","0","4","2","2","0","0","0","1","1","0","10","7","3","-2"
"110404","California Institute of Technology","2019","Not on tenure/no tenure system, lecturers","18","12","6","0","0","0","3","0","3","0","0","0","3","2","1","0","0","0","12","10","2","0","0","0","0","0","0","0","0","0","-2"
"110404","California Institute of Technology","2019","Not on tenure/no tenure system, no academic rank","4","4","0","0","0","0","0","0","0","0","0","0","0","0","0","0","0","0","4","4","0","0","0","0","0","0","0","0","0","0","-2"
"110538","California State University-Chico","2019","Tenured total","265","150","115","1","1","0","29","16","13","4","1","3","8","6","2","0","0","0","207","116","91","3","2","1","12","8","4","1","0","1","-2"
"110538","California State University-Chico","2019","Tenured, professors","188","114","74","1","1","0","18","11","7","3","1","2","7","5","2","0","0","0","151","90","61","2","2","0","6","4","2","0","0","0","-2"
"110538","California State University-Chico","2019","Tenured, associate professors","76","36","40","0","0","0","11","5","6","1","0","1","1","1","0","0","0","0","55","26","29","1","0","1","6","4","2","1","0","1","-2"
"110538","California State University-Chico","2019","Tenured, assistant professors","1","0","1","0","0","0","0","0","0","0","0","0","0","0","0","0","0","0","1","0","1","0","0","0","0","0","0","0","0","0","-2"
"110538","California State University-Chico","2019","On-Tenure track total","158","72","86","2","1","1","16","7","9","4","1","3","6","2","4","0","0","0","92","42","50","4","1","3","17","10","7","17","8","9","-2"
"110538","California State University-Chico","2019","On-tenure track, associate professors","7","4","3","0","0","0","0","0","0","1","0","1","0","0","0","0","0","0","6","4","2","0","0","0","0","0","0","0","0","0","-2"
"110538","California State University-Chico","2019","On-tenure track, assistant professors","151","68","83","2","1","1","16","7","9","3","1","2","6","2","4","0","0","0","86","38","48","4","1","3","17","10","7","17","8","9","-2"
"110538","California State University-Chico","2019","Not on tenure track/No tenure system system total","107","47","60","2","0","2","3","1","2","0","0","0","9","4","5","0","0","0","78","35","43","3","1","2","12","6","6","0","0","0","-2"
"110538","California State University-Chico","2019","Not on tenure/no tenure system, lecturers","107","47","60","2","0","2","3","1","2","0","0","0","9","4","5","0","0","0","78","35","43","3","1","2","12","6","6","0","0","0","-2"
"110635","University of California-Berkeley","2019","Tenured total","1153","792","361","2","0","2","160","104","56","40","25","15","66","44","22","0","0","0","844","588","256","0","0","0","32","24","8","9","7","2","-2"
"110635","University of California-Berkeley","2019","Tenured, professors","833","609","224","1","0","1","111","75","36","27","20","7","39","28","11","0","0","0","633","467","166","0","0","0","17","14","3","5","5","0","-2"
"110635","University of California-Berkeley","2019","Tenured, associate professors","298","170","128","1","0","1","47","28","19","13","5","8","26","15","11","0","0","0","192","110","82","0","0","0","15","10","5","4","2","2","-2"
"110635","University of California-Berkeley","2019","Tenured, lecturers","22","13","9","0","0","0","2","1","1","0","0","0","1","1","0","0","0","0","19","11","8","0","0","0","0","0","0","0","0","0","-2"
"110635","University of California-Berkeley","2019","On-Tenure track total","249","140","109","0","0","0","34","13","21","17","8","9","10","7","3","0","0","0","118","68","50","0","0","0","30","17","13","40","27","13","-2"
"110635","University of California-Berkeley","2019","On-tenure track, professors","10","3","7","0","0","0","3","1","2","1","0","1","0","0","0","0","0","0","5","2","3","0","0","0","1","0","1","0","0","0","-2"
"110635","University of California-Berkeley","2019","On-tenure track, associate professors","1","1","0","0","0","0","0","0","0","0","0","0","0","0","0","0","0","0","1","1","0","0","0","0","0","0","0","0","0","0","-2"
"110635","University of California-Berkeley","2019","On-tenure track, assistant professors","235","135","100","0","0","0","30","12","18","16","8","8","10","7","3","0","0","0","111","64","47","0","0","0","28","17","11","40","27","13","-2"
"110635","University of California-Berkeley","2019","On-tenure track, lecturers","3","1","2","0","0","0","1","0","1","0","0","0","0","0","0","0","0","0","1","1","0","0","0","0","1","0","1","0","0","0","-2"
"110635","University of California-Berkeley","2019","Not on tenure track/No tenure system system total","417","179","238","0","0","0","74","22","52","10","3","7","24","10","14","0","0","0","233","107","126","0","0","0","34","13","21","42","24","18","-2"
"110635","University of California-Berkeley","2019","Not on tenure/no tenure system, professors","39","23","16","0","0","0","3","1","2","1","0","1","1","0","1","0","0","0","28","17","11","0","0","0","2","2","0","4","3","1","-2"
"110635","University of California-Berkeley","2019","Not on tenure/no tenure system, associate professors","20","9","11","0","0","0","4","2","2","0","0","0","1","1","0","0","0","0","12","5","7","0","0","0","2","0","2","1","1","0","-2"
"110635","University of California-Berkeley","2019","Not on tenure/no tenure system, assistant professors","54","26","28","0","0","0","15","5","10","1","0","1","2","2","0","0","0","0","19","8","11","0","0","0","7","3","4","10","8","2","-2"
"110635","University of California-Berkeley","2019","Not on tenure/no tenure system, instructors","3","2","1","0","0","0","0","0","0","1","1","0","0","0","0","0","0","0","1","0","1","0","0","0","1","1","0","0","0","0","-2"
"110635","University of California-Berkeley","2019","Not on tenure/no tenure system, lecturers","292","117","175","0","0","0","50","13","37","7","2","5","19","7","12","0","0","0","170","77","93","0","0","0","20","6","14","26","12","14","-2"
"110635","University of California-Berkeley","2019","Not on tenure/no tenure system, no academic rank","9","2","7","0","0","0","2","1","1","0","0","0","1","0","1","0","0","0","3","0","3","0","0","0","2","1","1","1","0","1","-2"
"110644","University of California-Davis","2019","Tenured total","1259","806","453","5","1","4","210","127","83","24","10","14","70","41","29","0","0","0","871","575","296","0","0","0","62","42","20","17","10","7","-2"
"110644","University of California-Davis","2019","Tenured, professors","935","630","305","5","1","4","149","97","52","13","6","7","42","25","17","0","0","0","683","472","211","0","0","0","35","26","9","8","3","5","-2"
"110644","University of California-Davis","2019","Tenured, associate professors","310","170","140","0","0","0","60","30","30","11","4","7","27","16","11","0","0","0","177","97","80","0","0","0","26","16","10","9","7","2","-2"
"110644","University of California-Davis","2019","Tenured, lecturers","14","6","8","0","0","0","1","0","1","0","0","0","1","0","1","0","0","0","11","6","5","0","0","0","1","0","1","0","0","0","-2"
"110644","University of California-Davis","2019","On-Tenure track total","339","179","160","1","0","1","41","25","16","15","5","10","36","15","21","0","0","0","171","89","82","0","0","0","27","14","13","48","31","17","-2"
"110644","University of California-Davis","2019","On-tenure track, professors","6","4","2","0","0","0","3","3","0","1","0","1","1","0","1","0","0","0","1","1","0","0","0","0","0","0","0","0","0","0","-2"
"110644","University of California-Davis","2019","On-tenure track, associate professors","2","2","0","0","0","0","0","0","0","0","0","0","0","0","0","0","0","0","1","1","0","0","0","0","0","0","0","1","1","0","-2"
"110644","University of California-Davis","2019","On-tenure track, assistant professors","301","161","140","1","0","1","38","22","16","11","4","7","34","15","19","0","0","0","149","79","70","0","0","0","24","12","12","44","29","15","-2"
"110644","University of California-Davis","2019","On-tenure track, lecturers","30","12","18","0","0","0","0","0","0","3","1","2","1","0","1","0","0","0","20","8","12","0","0","0","3","2","1","3","1","2","-2"
"110644","University of California-Davis","2019","Not on tenure track/No tenure system system total","982","514","468","1","0","1","235","117","118","15","4","11","48","22","26","0","0","0","584","314","270","0","0","0","45","25","20","54","32","22","-2"
"110644","University of California-Davis","2019","Not on tenure/no tenure system, professors","272","177","95","1","0","1","72","51","21","1","0","1","12","10","2","0","0","0","181","113","68","0","0","0","4","2","2","1","1","0","-2"
"110644","University of California-Davis","2019","Not on tenure/no tenure system, associate professors","184","97","87","0","0","0","63","29","34","4","1","3","11","5","6","0","0","0","95","55","40","0","0","0","7","3","4","4","4","0","-2"
"110644","University of California-Davis","2019","Not on tenure/no tenure system, assistant professors","307","142","165","0","0","0","83","33","50","8","2","6","13","4","9","0","0","0","151","68","83","0","0","0","18","11","7","34","24","10","-2"
"110644","University of California-Davis","2019","Not on tenure/no tenure system, lecturers","219","98","121","0","0","0","17","4","13","2","1","1","12","3","9","0","0","0","157","78","79","0","0","0","16","9","7","15","3","12","-2"
"110653","University of California-Irvine","2019","Tenured total","1050","685","365","5","3","2","209","135","74","26","17","9","51","32","19","1","1","0","724","481","243","0","0","0","26","10","16","8","6","2","-2"
"110653","University of California-Irvine","2019","Tenured, professors","731","521","210","2","1","1","142","98","44","17","14","3","34","25","9","1","1","0","520","373","147","0","0","0","12","6","6","3","3","0","-2"
"110653","University of California-Irvine","2019","Tenured, associate professors","262","140","122","3","2","1","62","34","28","7","2","5","15","7","8","0","0","0","156","88","68","0","0","0","14","4","10","5","3","2","-2"
"110653","University of California-Irvine","2019","Tenured, lecturers","57","24","33","0","0","0","5","3","2","2","1","1","2","0","2","0","0","0","48","20","28","0","0","0","0","0","0","0","0","0","-2"
"110653","University of California-Irvine","2019","On-Tenure track total","283","143","140","0","0","0","45","19","26","18","9","9","24","10","14","1","1","0","125","65","60","0","0","0","17","8","9","53","31","22","-2"
"110653","University of California-Irvine","2019","On-tenure track, professors","4","1","3","0","0","0","2","1","1","0","0","0","0","0","0","0","0","0","1","0","1","0","0","0","0","0","0","1","0","1","-2"
"110653","University of California-Irvine","2019","On-tenure track, associate professors","1","0","1","0","0","0","0","0","0","0","0","0","0","0","0","0","0","0","0","0","0","0","0","0","0","0","0","1","0","1","-2"
"110653","University of California-Irvine","2019","On-tenure track, assistant professors","239","122","117","0","0","0","40","17","23","17","9","8","20","8","12","1","1","0","100","50","50","0","0","0","15","8","7","46","29","17","-2"
"110653","University of California-Irvine","2019","On-tenure track, lecturers","39","20","19","0","0","0","3","1","2","1","0","1","4","2","2","0","0","0","24","15","9","0","0","0","2","0","2","5","2","3","-2"
"110653","University of California-Irvine","2019","Not on tenure track/No tenure system system total","741","397","344","2","0","2","254","131","123","19","8","11","35","16","19","1","1","0","348","194","154","0","0","0","43","21","22","39","26","13","-2"
"110653","University of California-Irvine","2019","Not on tenure/no tenure system, professors","177","114","63","0","0","0","71","47","24","4","2","2","11","6","5","0","0","0","85","55","30","0","0","0","5","4","1","1","0","1","-2"
"110653","University of California-Irvine","2019","Not on tenure/no tenure system, associate professors","125","69","56","0","0","0","47","24","23","8","4","4","0","0","0","1","1","0","61","36","25","0","0","0","6","3","3","2","1","1","-2"
"110653","University of California-Irvine","2019","Not on tenure/no tenure system, assistant professors","205","104","101","0","0","0","79","36","43","4","1","3","13","5","8","0","0","0","68","38","30","0","0","0","20","8","12","21","16","5","-2"
"110653","University of California-Irvine","2019","Not on tenure/no tenure system, instructors","50","28","22","0","0","0","19","9","10","1","1","0","1","0","1","0","0","0","18","11","7","0","0","0","7","5","2","4","2","2","-2"
"110653","University of California-Irvine","2019","Not on tenure/no tenure system, lecturers","184","82","102","2","0","2","38","15","23","2","0","2","10","5","5","0","0","0","116","54","62","0","0","0","5","1","4","11","7","4","-2"
"110662","University of California-Los Angeles","2019","Tenured total","1499","1007","492","9","2","7","288","199","89","66","38","28","109","75","34","2","1","1","972","658","314","0","0","0","32","21","11","21","13","8","-2"
"110662","University of California-Los Angeles","2019","Tenured, professors","1226","858","368","8","2","6","229","172","57","39","25","14","89","62","27","1","0","1","823","571","252","0","0","0","24","18","6","13","8","5","-2"
"110662","University of California-Los Angeles","2019","Tenured, associate professors","265","145","120","1","0","1","57","27","30","27","13","14","20","13","7","1","1","0","144","84","60","0","0","0","7","2","5","8","5","3","-2"
"110662","University of California-Los Angeles","2019","Tenured, lecturers","8","4","4","0","0","0","2","0","2","0","0","0","0","0","0","0","0","0","5","3","2","0","0","0","1","1","0","0","0","0","-2"
"110662","University of California-Los Angeles","2019","On-Tenure track total","275","146","129","1","0","1","35","16","19","13","3","10","28","15","13","2","0","2","97","51","46","0","0","0","23","15","8","76","46","30","-2"
"110662","University of California-Los Angeles","2019","On-tenure track, professors","4","1","3","0","0","0","1","0","1","1","0","1","0","0","0","0","0","0","2","1","1","0","0","0","0","0","0","0","0","0","-2"
"110662","University of California-Los Angeles","2019","On-tenure track, assistant professors","267","142","125","1","0","1","34","16","18","12","3","9","28","15","13","2","0","2","92","47","45","0","0","0","23","15","8","75","46","29","-2"
"110662","University of California-Los Angeles","2019","On-tenure track, lecturers","4","3","1","0","0","0","0","0","0","0","0","0","0","0","0","0","0","0","3","3","0","0","0","0","0","0","0","1","0","1","-2"
"110662","University of California-Los Angeles","2019","Not on tenure track/No tenure system system total","2235","1238","997","0","0","0","592","303","289","51","15","36","118","61","57","2","1","1","1105","653","452","0","0","0","159","80","79","208","125","83","-2"
"110662","University of California-Los Angeles","2019","Not on tenure/no tenure system, professors","491","330","161","0","0","0","109","74","35","8","4","4","22","13","9","0","0","0","328","221","107","0","0","0","15","12","3","9","6","3","-2"
"110662","University of California-Los Angeles","2019","Not on tenure/no tenure system, associate professors","327","181","146","0","0","0","103","56","47","7","1","6","19","12","7","0","0","0","177","102","75","0","0","0","14","7","7","7","3","4","-2"
"110662","University of California-Los Angeles","2019","Not on tenure/no tenure system, assistant professors","716","390","326","0","0","0","212","106","106","15","3","12","39","19","20","0","0","0","304","175","129","0","0","0","58","30","28","88","57","31","-2"
"110662","University of California-Los Angeles","2019","Not on tenure/no tenure system, instructors","411","213","198","0","0","0","128","54","74","12","5","7","11","5","6","2","1","1","150","87","63","0","0","0","36","17","19","72","44","28","-2"
"110662","University of California-Los Angeles","2019","Not on tenure/no tenure system, lecturers","284","120","164","0","0","0","40","13","27","7","1","6","25","10","15","0","0","0","145","68","77","0","0","0","35","13","22","32","15","17","-2"
"110662","University of California-Los Angeles","2019","Not on tenure/no tenure system, no academic rank","6","4","2","0","0","0","0","0","0","2","1","1","2","2","0","0","0","0","1","0","1","0","0","0","1","1","0","0","0","0","-2"
"110680","University of California-San Diego","2019","Tenured total","1118","827","291","2","2","0","204","156","48","25","10","15","69","47","22","0","0","0","794","589","205","0","0","0","9","8","1","15","15","0","-2"
"110680","University of California-San Diego","2019","Tenured, professors","835","657","178","1","1","0","152","125","27","9","5","4","46","35","11","0","0","0","612","476","136","0","0","0","2","2","0","13","13","0","-2"
"110680","University of California-San Diego","2019","Tenured, associate professors","233","141","92","1","1","0","50","31","19","14","4","10","21","11","10","0","0","0","140","88","52","0","0","0","6","5","1","1","1","0","-2"
"110680","University of California-San Diego","2019","Tenured, lecturers","50","29","21","0","0","0","2","0","2","2","1","1","2","1","1","0","0","0","42","25","17","0","0","0","1","1","0","1","1","0","-2"
"110680","University of California-San Diego","2019","On-Tenure track total","316","177","139","1","0","1","57","33","24","13","4","9","29","15","14","1","1","0","166","92","74","0","0","0","12","5","7","37","27","10","-2"
"110680","University of California-San Diego","2019","On-tenure track, associate professors","1","1","0","0","0","0","0","0","0","1","1","0","0","0","0","0","0","0","0","0","0","0","0","0","0","0","0","0","0","0","-2"
"110680","University of California-San Diego","2019","On-tenure track, assistant professors","274","152","122","1","0","1","51","31","20","11","2","9","29","15","14","1","1","0","133","72","61","0","0","0","12","5","7","36","26","10","-2"
"110680","University of California-San Diego","2019","On-tenure track, lecturers","41","24","17","0","0","0","6","2","4","1","1","0","0","0","0","0","0","0","33","20","13","0","0","0","0","0","0","1","1","0","-2"
"110680","University of California-San Diego","2019","Not on tenure track/No tenure system system total","1287","663","624","6","4","2","282","134","148","16","10","6","88","49","39","1","1","0","791","410","381","0","0","0","41","18","23","62","37","25","-2"
"110680","University of California-San Diego","2019","Not on tenure/no tenure system, professors","398","241","157","1","1","0","71","36","35","5","5","0","26","17","9","0","0","0","289","176","113","0","0","0","0","0","0","6","6","0","-2"
"110680","University of California-San Diego","2019","Not on tenure/no tenure system, associate professors","293","154","139","3","2","1","82","45","37","4","1","3","18","9","9","1","1","0","168","85","83","0","0","0","7","3","4","10","8","2","-2"
"110680","University of California-San Diego","2019","Not on tenure/no tenure system, assistant professors","426","198","228","2","1","1","106","47","59","4","1","3","34","18","16","0","0","0","219","101","118","0","0","0","27","13","14","34","17","17","-2"
"110680","University of California-San Diego","2019","Not on tenure/no tenure system, lecturers","170","70","100","0","0","0","23","6","17","3","3","0","10","5","5","0","0","0","115","48","67","0","0","0","7","2","5","12","6","6","-2"
"115755","Humboldt State University","2019","Tenured total","159","83","76","1","0","1","10","6","4","3","1","2","6","1","5","0","0","0","127","72","55","1","0","1","10","3","7","1","0","1","-2"
"115755","Humboldt State University","2019","Tenured, professors","104","62","42","0","0","0","5","5","0","1","1","0","2","1","1","0","0","0","92","54","38","1","0","1","3","1","2","0","0","0","-2"
"115755","Humboldt State University","2019","Tenured, associate professors","54","20","34","1","0","1","5","1","4","2","0","2","4","0","4","0","0","0","34","17","17","0","0","0","7","2","5","1","0","1","-2"
"115755","Humboldt State University","2019","Tenured, assistant professors","1","1","0","0","0","0","0","0","0","0","0","0","0","0","0","0","0","0","1","1","0","0","0","0","0","0","0","0","0","0","-2"
"115755","Humboldt State University","2019","On-Tenure track total","79","32","47","5","0","5","3","1","2","2","2","0","8","3","5","0","0","0","45","18","27","1","1","0","10","4","6","5","3","2","-2"
"115755","Humboldt State University","2019","On-tenure track, associate professors","4","2","2","0","0","0","0","0","0","0","0","0","0","0","0","0","0","0","4","2","2","0","0","0","0","0","0","0","0","0","-2"
"115755","Humboldt State University","2019","On-tenure track, assistant professors","75","30","45","5","0","5","3","1","2","2","2","0","8","3","5","0","0","0","41","16","25","1","1","0","10","4","6","5","3","2","-2"
"115755","Humboldt State University","2019","Not on tenure track/No tenure system system total","54","23","31","1","0","1","0","0","0","2","1","1","4","2","2","0","0","0","41","16","25","1","1","0","4","2","2","1","1","0","-2"
"115755","Humboldt State University","2019","Not on tenure/no tenure system, lecturers","54","23","31","1","0","1","0","0","0","2","1","1","4","2","2","0","0","0","41","16","25","1","1","0","4","2","2","1","1","0","-2"
"119678","Naval Postgraduate School","2019","Tenured total","134","107","27","0","0","0","12","8","4","0","0","0","7","5","2","2","2","0","113","92","21","0","0","0","0","0","0","0","0","0","-2"
"119678","Naval Postgraduate School","2019","Tenured, professors","68","57","11","0","0","0","9","7","2","0","0","0","5","4","1","1","1","0","53","45","8","0","0","0","0","0","0","0","0","0","-2"
"119678","Naval Postgraduate School","2019","Tenured, associate professors","66","50","16","0","0","0","3","1","2","0","0","0","2","1","1","1","1","0","60","47","13","0","0","0","0","0","0","0","0","0","-2"
"119678","Naval Postgraduate School","2019","On-Tenure track total","52","41","11","0","0","0","2","2","0","0","0","0","2","2","0","0","0","0","43","33","10","5","4","1","0","0","0","0","0","0","-2"
"119678","Naval Postgraduate School","2019","On-tenure track, associate professors","8","8","0","0","0","0","0","0","0","0","0","0","1","1","0","0","0","0","7","7","0","0","0","0","0","0","0","0","0","0","-2"
"119678","Naval Postgraduate School","2019","On-tenure track, assistant professors","44","33","11","0","0","0","2","2","0","0","0","0","1","1","0","0","0","0","36","26","10","5","4","1","0","0","0","0","0","0","-2"
"119678","Naval Postgraduate School","2019","Not on tenure track/No tenure system system total","98","82","16","1","0","1","3","1","2","2","2","0","3","2","1","0","0","0","83","72","11","6","5","1","0","0","0","0","0","0","-2"
"119678","Naval Postgraduate School","2019","Not on tenure/no tenure system, professors","15","13","2","0","0","0","1","0","1","1","1","0","0","0","0","0","0","0","11","10","1","2","2","0","0","0","0","0","0","0","-2"
"119678","Naval Postgraduate School","2019","Not on tenure/no tenure system, lecturers","83","69","14","1","0","1","2","1","1","1","1","0","3","2","1","0","0","0","72","62","10","4","3","1","0","0","0","0","0","0","-2"
"122409","San Diego State University","2019","Tenured total","543","326","217","3","3","0","86","47","39","18","13","5","47","27","20","0","0","0","366","221","145","3","2","1","15","9","6","5","4","1","-2"
"122409","San Diego State University","2019","Tenured, professors","324","201","123","2","2","0","48","25","23","9","7","2","26","15","11","0","0","0","228","144","84","1","0","1","7","5","2","3","3","0","-2"
"122409","San Diego State University","2019","Tenured, associate professors","219","125","94","1","1","0","38","22","16","9","6","3","21","12","9","0","0","0","138","77","61","2","2","0","8","4","4","2","1","1","-2"
"122409","San Diego State University","2019","On-Tenure track total","221","114","107","3","1","2","31","18","13","8","2","6","22","12","10","0","0","0","91","49","42","6","2","4","23","10","13","37","20","17","-2"
"122409","San Diego State University","2019","On-tenure track, professors","1","1","0","0","0","0","0","0","0","0","0","0","0","0","0","0","0","0","1","1","0","0","0","0","0","0","0","0","0","0","-2"
"122409","San Diego State University","2019","On-tenure track, associate professors","7","4","3","0","0","0","1","0","1","0","0","0","0","0","0","0","0","0","4","3","1","0","0","0","2","1","1","0","0","0","-2"
"122409","San Diego State University","2019","On-tenure track, assistant professors","213","109","104","3","1","2","30","18","12","8","2","6","22","12","10","0","0","0","86","45","41","6","2","4","21","9","12","37","20","17","-2"
"122409","San Diego State University","2019","Not on tenure track/No tenure system system total","199","79","120","1","1","0","10","0","10","6","2","4","24","7","17","2","0","2","144","63","81","7","4","3","4","2","2","1","0","1","-2"
"122409","San Diego State University","2019","Not on tenure/no tenure system, lecturers","199","79","120","1","1","0","10","0","10","6","2","4","24","7","17","2","0","2","144","63","81","7","4","3","4","2","2","1","0","1","-2"
"122597","San Francisco State University","2019","Tenured total","516","261","255","7","4","3","138","61","77","18","9","9","34","16","18","0","0","0","278","157","121","10","5","5","26","9","17","5","0","5","-2"
"122597","San Francisco State University","2019","Tenured, professors","347","188","159","3","1","2","92","45","47","14","7","7","26","14","12","0","0","0","187","110","77","6","3","3","18","8","10","1","0","1","-2"
"122597","San Francisco State University","2019","Tenured, associate professors","164","71","93","4","3","1","46","16","30","4","2","2","7","2","5","0","0","0","88","45","43","4","2","2","7","1","6","4","0","4","-2"
"122597","San Francisco State University","2019","Tenured, assistant professors","3","1","2","0","0","0","0","0","0","0","0","0","1","0","1","0","0","0","1","1","0","0","0","0","1","0","1","0","0","0","-2"
"122597","San Francisco State University","2019","Tenured, no academic rank","2","1","1","0","0","0","0","0","0","0","0","0","0","0","0","0","0","0","2","1","1","0","0","0","0","0","0","0","0","0","-2"
"122597","San Francisco State University","2019","On-Tenure track total","202","67","135","4","0","4","44","16","28","10","5","5","12","3","9","0","0","0","98","33","65","2","0","2","7","2","5","25","8","17","-2"
"122597","San Francisco State University","2019","On-tenure track, professors","1","0","1","0","0","0","0","0","0","0","0","0","0","0","0","0","0","0","1","0","1","0","0","0","0","0","0","0","0","0","-2"
"122597","San Francisco State University","2019","On-tenure track, associate professors","5","2","3","0","0","0","2","1","1","0","0","0","0","0","0","0","0","0","2","1","1","1","0","1","0","0","0","0","0","0","-2"
"122597","San Francisco State University","2019","On-tenure track, assistant professors","196","65","131","4","0","4","42","15","27","10","5","5","12","3","9","0","0","0","95","32","63","1","0","1","7","2","5","25","8","17","-2"
"122597","San Francisco State University","2019","Not on tenure track/No tenure system system total","152","86","66","1","1","0","29","15","14","7","4","3","21","12","9","0","0","0","87","50","37","1","1","0","5","3","2","1","0","1","-2"
"122597","San Francisco State University","2019","Not on tenure/no tenure system, lecturers","152","86","66","1","1","0","29","15","14","7","4","3","21","12","9","0","0","0","87","50","37","1","1","0","5","3","2","1","0","1","-2"
"122755","San Jose State University","2019","Tenured total","426","217","209","2","2","0","113","57","56","11","6","5","29","18","11","1","0","1","229","113","116","3","1","2","35","19","16","3","1","2","-2"
"122755","San Jose State University","2019","Tenured, professors","292","163","129","1","1","0","83","51","32","4","2","2","19","13","6","0","0","0","161","85","76","3","1","2","21","10","11","0","0","0","-2"
"122755","San Jose State University","2019","Tenured, associate professors","128","50","78","1","1","0","29","5","24","7","4","3","9","4","5","1","0","1","65","27","38","0","0","0","13","8","5","3","1","2","-2"
"122755","San Jose State University","2019","Tenured, assistant professors","3","3","0","0","0","0","1","1","0","0","0","0","1","1","0","0","0","0","1","1","0","0","0","0","0","0","0","0","0","0","-2"
"122755","San Jose State University","2019","Tenured, no academic rank","3","1","2","0","0","0","0","0","0","0","0","0","0","0","0","0","0","0","2","0","2","0","0","0","1","1","0","0","0","0","-2"
"122755","San Jose State University","2019","On-Tenure track total","255","112","143","1","1","0","42","15","27","12","3","9","18","9","9","0","0","0","121","55","66","10","6","4","21","8","13","30","15","15","-2"
"122755","San Jose State University","2019","On-tenure track, associate professors","7","1","6","0","0","0","4","1","3","0","0","0","1","0","1","0","0","0","1","0","1","0","0","0","0","0","0","1","0","1","-2"
"122755","San Jose State University","2019","On-tenure track, assistant professors","248","111","137","1","1","0","38","14","24","12","3","9","17","9","8","0","0","0","120","55","65","10","6","4","21","8","13","29","15","14","-2"
"122755","San Jose State University","2019","Not on tenure track/No tenure system system total","171","70","101","2","1","1","26","6","20","4","2","2","13","3","10","0","0","0","100","46","54","6","3","3","19","8","11","1","1","0","-2"
"122755","San Jose State University","2019","Not on tenure/no tenure system, lecturers","171","70","101","2","1","1","26","6","20","4","2","2","13","3","10","0","0","0","100","46","54","6","3","3","19","8","11","1","1","0","-2"
"123961","University of Southern California","2019","Tenured total","1179","846","333","2","2","0","195","142","53","33","20","13","55","35","20","0","0","0","846","617","229","21","16","5","27","14","13","0","0","0","-2"
"123961","University of Southern California","2019","Tenured, professors","825","625","200","2","2","0","125","98","27","16","14","2","29","20","9","0","0","0","629","475","154","11","9","2","13","7","6","0","0","0","-2"
"123961","University of Southern California","2019","Tenured, associate professors","354","221","133","0","0","0","70","44","26","17","6","11","26","15","11","0","0","0","217","142","75","10","7","3","14","7","7","0","0","0","-2"
"123961","University of Southern California","2019","On-Tenure track total","315","182","133","1","0","1","57","37","20","13","6","7","18","8","10","0","0","0","117","59","58","5","2","3","55","34","21","49","36","13","-2"
"123961","University of Southern California","2019","On-tenure track, professors","1","0","1","0","0","0","0","0","0","0","0","0","0","0","0","0","0","0","1","0","1","0","0","0","0","0","0","0","0","0","-2"
"123961","University of Southern California","2019","On-tenure track, associate professors","5","2","3","0","0","0","0","0","0","0","0","0","0","0","0","0","0","0","4","2","2","0","0","0","0","0","0","1","0","1","-2"
"123961","University of Southern California","2019","On-tenure track, assistant professors","308","179","129","1","0","1","57","37","20","13","6","7","18","8","10","0","0","0","111","56","55","5","2","3","55","34","21","48","36","12","-2"
"123961","University of Southern California","2019","On-tenure track, instructors","1","1","0","0","0","0","0","0","0","0","0","0","0","0","0","0","0","0","1","1","0","0","0","0","0","0","0","0","0","0","-2"
"123961","University of Southern California","2019","Not on tenure track/No tenure system system total","987","465","522","4","2","2","89","37","52","51","16","35","82","34","48","0","0","0","639","318","321","26","9","17","63","31","32","33","18","15","-2"
"123961","University of Southern California","2019","Not on tenure/no tenure system, professors","208","108","100","0","0","0","17","7","10","11","6","5","15","8","7","0","0","0","151","79","72","5","3","2","8","5","3","1","0","1","-2"
"123961","University of Southern California","2019","Not on tenure/no tenure system, associate professors","307","136","171","1","1","0","21","12","9","19","4","15","18","6","12","0","0","0","225","104","121","11","2","9","8","5","3","4","2","2","-2"
"123961","University of Southern California","2019","Not on tenure/no tenure system, assistant professors","230","107","123","2","0","2","16","5","11","12","5","7","16","8","8","0","0","0","143","67","76","4","1","3","24","12","12","13","9","4","-2"
"123961","University of Southern California","2019","Not on tenure/no tenure system, instructors","6","2","4","0","0","0","1","0","1","1","0","1","2","0","2","0","0","0","1","1","0","1","1","0","0","0","0","0","0","0","-2"
"123961","University of Southern California","2019","Not on tenure/no tenure system, lecturers","236","112","124","1","1","0","34","13","21","8","1","7","31","12","19","0","0","0","119","67","52","5","2","3","23","9","14","15","7","8","-2"
"126614","University of Colorado Boulder","2019","Tenured total","870","573","297","5","2","3","102","56","46","16","11","5","48","35","13","1","1","0","640","433","207","6","1","5","49","33","16","3","1","2","-2"
"126614","University of Colorado Boulder","2019","Tenured, professors","514","377","137","3","1","2","56","35","21","10","7","3","26","24","2","1","1","0","394","291","103","2","1","1","21","17","4","1","0","1","-2"
"126614","University of Colorado Boulder","2019","Tenured, associate professors","355","196","159","2","1","1","46","21","25","6","4","2","22","11","11","0","0","0","246","142","104","4","0","4","27","16","11","2","1","1","-2"
"126614","University of Colorado Boulder","2019","Tenured, assistant professors","1","0","1","0","0","0","0","0","0","0","0","0","0","0","0","0","0","0","0","0","0","0","0","0","1","0","1","0","0","0","-2"
"126614","University of Colorado Boulder","2019","On-Tenure track total","342","200","142","0","0","0","32","22","10","5","3","2","27","15","12","3","1","2","169","104","65","5","1","4","73","40","33","28","14","14","-2"
"126614","University of Colorado Boulder","2019","On-tenure track, associate professors","23","13","10","0","0","0","4","3","1","0","0","0","1","0","1","0","0","0","15","8","7","0","0","0","2","1","1","1","1","0","-2"
"126614","University of Colorado Boulder","2019","On-tenure track, assistant professors","319","187","132","0","0","0","28","19","9","5","3","2","26","15","11","3","1","2","154","96","58","5","1","4","71","39","32","27","13","14","-2"
"126614","University of Colorado Boulder","2019","Not on tenure track/No tenure system system total","458","226","232","1","1","0","29","6","23","7","5","2","14","6","8","0","0","0","343","176","167","3","1","2","49","24","25","12","7","5","-2"
"126614","University of Colorado Boulder","2019","Not on tenure/no tenure system, instructors","458","226","232","1","1","0","29","6","23","7","5","2","14","6","8","0","0","0","343","176","167","3","1","2","49","24","25","12","7","5","-2"
"126818","Colorado State University-Fort Collins","2019","Tenured total","761","493","268","2","1","1","63","43","20","4","3","1","40","22","18","0","0","0","628","407","221","11","7","4","1","1","0","12","9","3","-2"
"126818","Colorado State University-Fort Collins","2019","Tenured, professors","462","322","140","1","0","1","39","34","5","1","1","0","21","12","9","0","0","0","395","271","124","2","2","0","1","1","0","2","1","1","-2"
"126818","Colorado State University-Fort Collins","2019","Tenured, associate professors","299","171","128","1","1","0","24","9","15","3","2","1","19","10","9","0","0","0","233","136","97","9","5","4","0","0","0","10","8","2","-2"
"126818","Colorado State University-Fort Collins","2019","On-Tenure track total","318","166","152","2","0","2","27","14","13","9","4","5","15","5","10","0","0","0","200","111","89","9","3","6","16","6","10","40","23","17","-2"
"126818","Colorado State University-Fort Collins","2019","On-tenure track, professors","8","4","4","1","0","1","0","0","0","1","0","1","2","1","1","0","0","0","3","3","0","0","0","0","1","0","1","0","0","0","-2"
"126818","Colorado State University-Fort Collins","2019","On-tenure track, associate professors","22","10","12","0","0","0","0","0","0","2","1","1","1","0","1","0","0","0","17","8","9","0","0","0","1","0","1","1","1","0","-2"
"126818","Colorado State University-Fort Collins","2019","On-tenure track, assistant professors","288","152","136","1","0","1","27","14","13","6","3","3","12","4","8","0","0","0","180","100","80","9","3","6","14","6","8","39","22","17","-2"
"126818","Colorado State University-Fort Collins","2019","Not on tenure track/No tenure system system total","374","145","229","1","0","1","8","3","5","1","1","0","21","3","18","0","0","0","312","124","188","4","1","3","13","5","8","14","8","6","-2"
"126818","Colorado State University-Fort Collins","2019","Not on tenure/no tenure system, professors","7","3","4","0","0","0","0","0","0","0","0","0","1","0","1","0","0","0","5","3","2","0","0","0","1","0","1","0","0","0","-2"
"126818","Colorado State University-Fort Collins","2019","Not on tenure/no tenure system, associate professors","31","10","21","0","0","0","1","1","0","0","0","0","1","0","1","0","0","0","28","9","19","0","0","0","0","0","0","1","0","1","-2"
"126818","Colorado State University-Fort Collins","2019","Not on tenure/no tenure system, assistant professors","123","41","82","0","0","0","3","1","2","0","0","0","9","1","8","0","0","0","97","33","64","2","0","2","5","1","4","7","5","2","-2"
"126818","Colorado State University-Fort Collins","2019","Not on tenure/no tenure system, instructors","213","91","122","1","0","1","4","1","3","1","1","0","10","2","8","0","0","0","182","79","103","2","1","1","7","4","3","6","3","3","-2"
"127060","University of Denver","2019","Tenured total","350","205","145","0","0","0","30","18","12","9","3","6","20","13","7","0","0","0","246","143","103","5","3","2","39","24","15","1","1","0","-2"
"127060","University of Denver","2019","Tenured, professors","170","111","59","0","0","0","11","8","3","2","1","1","9","4","5","0","0","0","125","82","43","4","3","1","19","13","6","0","0","0","-2"
"127060","University of Denver","2019","Tenured, associate professors","180","94","86","0","0","0","19","10","9","7","2","5","11","9","2","0","0","0","121","61","60","1","0","1","20","11","9","1","1","0","-2"
"127060","University of Denver","2019","On-Tenure track total","127","65","62","3","0","3","11","5","6","7","4","3","8","4","4","0","0","0","70","36","34","5","2","3","13","8","5","10","6","4","-2"
"127060","University of Denver","2019","On-tenure track, assistant professors","127","65","62","3","0","3","11","5","6","7","4","3","8","4","4","0","0","0","70","36","34","5","2","3","13","8","5","10","6","4","-2"
"127060","University of Denver","2019","Not on tenure track/No tenure system system total","274","114","160","2","1","1","14","3","11","8","4","4","21","9","12","1","1","0","188","79","109","8","2","6","24","10","14","8","5","3","-2"
"127060","University of Denver","2019","Not on tenure/no tenure system, professors","25","16","9","0","0","0","1","0","1","0","0","0","0","0","0","0","0","0","23","15","8","0","0","0","1","1","0","0","0","0","-2"
"127060","University of Denver","2019","Not on tenure/no tenure system, associate professors","29","9","20","1","0","1","1","1","0","0","0","0","2","2","0","0","0","0","20","5","15","2","0","2","3","1","2","0","0","0","-2"
"127060","University of Denver","2019","Not on tenure/no tenure system, assistant professors","26","7","19","0","0","0","1","0","1","3","0","3","4","2","2","0","0","0","14","4","10","0","0","0","4","1","3","0","0","0","-2"
"127060","University of Denver","2019","Not on tenure/no tenure system, lecturers","194","82","112","1","1","0","11","2","9","5","4","1","15","5","10","1","1","0","131","55","76","6","2","4","16","7","9","8","5","3","-2"
"127565","Metropolitan State University of Denver","2019","Tenured total","356","191","165","2","1","1","27","18","9","17","11","6","32","17","15","0","0","0","275","141","134","3","3","0","0","0","0","0","0","0","-2"
"127565","Metropolitan State University of Denver","2019","Tenured, professors","199","115","84","1","0","1","16","11","5","5","3","2","14","11","3","0","0","0","160","87","73","3","3","0","0","0","0","0","0","0","-2"
"127565","Metropolitan State University of Denver","2019","Tenured, associate professors","155","76","79","1","1","0","11","7","4","12","8","4","18","6","12","0","0","0","113","54","59","0","0","0","0","0","0","0","0","0","-2"
"127565","Metropolitan State University of Denver","2019","Tenured, assistant professors","2","0","2","0","0","0","0","0","0","0","0","0","0","0","0","0","0","0","2","0","2","0","0","0","0","0","0","0","0","0","-2"
"127565","Metropolitan State University of Denver","2019","On-Tenure track total","99","39","60","1","0","1","11","3","8","6","2","4","15","10","5","1","1","0","56","20","36","4","1","3","5","2","3","0","0","0","-2"
"127565","Metropolitan State University of Denver","2019","On-tenure track, associate professors","1","1","0","0","0","0","0","0","0","0","0","0","0","0","0","0","0","0","1","1","0","0","0","0","0","0","0","0","0","0","-2"
"127565","Metropolitan State University of Denver","2019","On-tenure track, assistant professors","98","38","60","1","0","1","11","3","8","6","2","4","15","10","5","1","1","0","55","19","36","4","1","3","5","2","3","0","0","0","-2"
"127565","Metropolitan State University of Denver","2019","Not on tenure track/No tenure system system total","135","58","77","0","0","0","9","2","7","8","6","2","12","7","5","0","0","0","99","42","57","2","0","2","5","1","4","0","0","0","-2"
"127565","Metropolitan State University of Denver","2019","Not on tenure/no tenure system, professors","1","0","1","0","0","0","0","0","0","0","0","0","0","0","0","0","0","0","1","0","1","0","0","0","0","0","0","0","0","0","-2"
"127565","Metropolitan State University of Denver","2019","Not on tenure/no tenure system, assistant professors","2","1","1","0","0","0","0","0","0","0","0","0","1","1","0","0","0","0","1","0","1","0","0","0","0","0","0","0","0","0","-2"
"127565","Metropolitan State University of Denver","2019","Not on tenure/no tenure system, lecturers","132","57","75","0","0","0","9","2","7","8","6","2","11","6","5","0","0","0","97","42","55","2","0","2","5","1","4","0","0","0","-2"
"127741","University of Northern Colorado","2019","Tenured total","281","155","126","3","2","1","11","8","3","6","5","1","14","6","8","0","0","0","238","127","111","1","1","0","0","0","0","8","6","2","-2"
"127741","University of Northern Colorado","2019","Tenured, professors","186","106","80","3","2","1","9","7","2","4","3","1","11","5","6","0","0","0","155","85","70","1","1","0","0","0","0","3","3","0","-2"
"127741","University of Northern Colorado","2019","Tenured, associate professors","95","49","46","0","0","0","2","1","1","2","2","0","3","1","2","0","0","0","83","42","41","0","0","0","0","0","0","5","3","2","-2"
"127741","University of Northern Colorado","2019","On-Tenure track total","88","42","46","0","0","0","5","1","4","2","2","0","6","4","2","1","0","1","59","26","33","2","1","1","3","2","1","10","6","4","-2"
"127741","University of Northern Colorado","2019","On-tenure track, professors","1","1","0","0","0","0","0","0","0","0","0","0","0","0","0","0","0","0","1","1","0","0","0","0","0","0","0","0","0","0","-2"
"127741","University of Northern Colorado","2019","On-tenure track, associate professors","5","2","3","0","0","0","1","0","1","0","0","0","1","0","1","0","0","0","3","2","1","0","0","0","0","0","0","0","0","0","-2"
"127741","University of Northern Colorado","2019","On-tenure track, assistant professors","81","38","43","0","0","0","4","1","3","2","2","0","5","4","1","1","0","1","54","22","32","2","1","1","3","2","1","10","6","4","-2"
"127741","University of Northern Colorado","2019","On-tenure track, lecturers","1","1","0","0","0","0","0","0","0","0","0","0","0","0","0","0","0","0","1","1","0","0","0","0","0","0","0","0","0","0","-2"
"127741","University of Northern Colorado","2019","Not on tenure track/No tenure system system total","113","33","80","0","0","0","3","0","3","1","1","0","5","1","4","1","0","1","98","30","68","3","1","2","0","0","0","2","0","2","-2"
"127741","University of Northern Colorado","2019","Not on tenure/no tenure system, professors","1","1","0","0","0","0","0","0","0","0","0","0","0","0","0","0","0","0","1","1","0","0","0","0","0","0","0","0","0","0","-2"
"127741","University of Northern Colorado","2019","Not on tenure/no tenure system, associate professors","10","3","7","0","0","0","0","0","0","1","1","0","0","0","0","0","0","0","9","2","7","0","0","0","0","0","0","0","0","0","-2"
"127741","University of Northern Colorado","2019","Not on tenure/no tenure system, assistant professors","39","11","28","0","0","0","1","0","1","0","0","0","1","1","0","0","0","0","34","10","24","1","0","1","0","0","0","2","0","2","-2"
"127741","University of Northern Colorado","2019","Not on tenure/no tenure system, instructors","8","3","5","0","0","0","1","0","1","0","0","0","0","0","0","0","0","0","6","2","4","1","1","0","0","0","0","0","0","0","-2"
"127741","University of Northern Colorado","2019","Not on tenure/no tenure system, lecturers","55","15","40","0","0","0","1","0","1","0","0","0","4","0","4","1","0","1","48","15","33","1","0","1","0","0","0","0","0","0","-2"
"128328","United States Air Force Academy","2019","Not on tenure track/No tenure system system total","207","143","64","0","0","0","9","5","4","3","2","1","3","3","0","0","0","0","189","132","57","2","1","1","1","0","1","0","0","0","-2"
"128328","United States Air Force Academy","2019","Not on tenure/no tenure system, professors","57","46","11","0","0","0","3","2","1","0","0","0","1","1","0","0","0","0","53","43","10","0","0","0","0","0","0","0","0","0","-2"
"128328","United States Air Force Academy","2019","Not on tenure/no tenure system, associate professors","40","29","11","0","0","0","0","0","0","0","0","0","0","0","0","0","0","0","40","29","11","0","0","0","0","0","0","0","0","0","-2"
"128328","United States Air Force Academy","2019","Not on tenure/no tenure system, assistant professors","95","58","37","0","0","0","6","3","3","3","2","1","2","2","0","0","0","0","82","50","32","2","1","1","0","0","0","0","0","0","-2"
"128328","United States Air Force Academy","2019","Not on tenure/no tenure system, instructors","15","10","5","0","0","0","0","0","0","0","0","0","0","0","0","0","0","0","14","10","4","0","0","0","1","0","1","0","0","0","-2"
"130776","Western Connecticut State University","2019","Tenured total","154","76","78","0","0","0","19","10","9","8","5","3","7","4","3","0","0","0","112","52","60","0","0","0","8","5","3","0","0","0","-2"
"130776","Western Connecticut State University","2019","Tenured, professors","102","56","46","0","0","0","7","4","3","4","2","2","6","4","2","0","0","0","80","43","37","0","0","0","5","3","2","0","0","0","-2"
"130776","Western Connecticut State University","2019","Tenured, associate professors","48","20","28","0","0","0","12","6","6","4","3","1","1","0","1","0","0","0","28","9","19","0","0","0","3","2","1","0","0","0","-2"
"130776","Western Connecticut State University","2019","Tenured, assistant professors","4","0","4","0","0","0","0","0","0","0","0","0","0","0","0","0","0","0","4","0","4","0","0","0","0","0","0","0","0","0","-2"
"130776","Western Connecticut State University","2019","On-Tenure track total","62","31","31","0","0","0","4","4","0","1","0","1","4","0","4","0","0","0","51","25","26","0","0","0","2","2","0","0","0","0","-2"
"130776","Western Connecticut State University","2019","On-tenure track, associate professors","8","7","1","0","0","0","0","0","0","0","0","0","0","0","0","0","0","0","7","6","1","0","0","0","1","1","0","0","0","0","-2"
"130776","Western Connecticut State University","2019","On-tenure track, assistant professors","53","24","29","0","0","0","4","4","0","1","0","1","4","0","4","0","0","0","43","19","24","0","0","0","1","1","0","0","0","0","-2"
"130776","Western Connecticut State University","2019","On-tenure track, instructors","1","0","1","0","0","0","0","0","0","0","0","0","0","0","0","0","0","0","1","0","1","0","0","0","0","0","0","0","0","0","-2"
"130776","Western Connecticut State University","2019","Not on tenure track/No tenure system system total","8","3","5","0","0","0","0","0","0","0","0","0","0","0","0","0","0","0","8","3","5","0","0","0","0","0","0","0","0","0","-2"
"130776","Western Connecticut State University","2019","Not on tenure/no tenure system, assistant professors","5","3","2","0","0","0","0","0","0","0","0","0","0","0","0","0","0","0","5","3","2","0","0","0","0","0","0","0","0","0","-2"
"130776","Western Connecticut State University","2019","Not on tenure/no tenure system, instructors","3","0","3","0","0","0","0","0","0","0","0","0","0","0","0","0","0","0","3","0","3","0","0","0","0","0","0","0","0","0","-2"
"130794","Yale University","2019","Tenured total","1065","780","285","1","1","0","120","79","41","32","20","12","38","25","13","1","1","0","815","621","194","3","1","2","38","20","18","17","12","5","-2"
"130794","Yale University","2019","Tenured, professors","955","711","244","1","1","0","95","62","33","28","18","10","32","24","8","1","1","0","748","576","172","3","1","2","33","18","15","14","10","4","-2"
"130794","Yale University","2019","Tenured, associate professors","110","69","41","0","0","0","25","17","8","4","2","2","6","1","5","0","0","0","67","45","22","0","0","0","5","2","3","3","2","1","-2"
"130794","Yale University","2019","On-Tenure track total","1080","571","509","1","1","0","176","95","81","40","16","24","49","23","26","3","1","2","567","298","269","7","4","3","136","73","63","101","60","41","-2"
"130794","Yale University","2019","On-tenure track, associate professors","404","232","172","0","0","0","82","50","32","16","6","10","13","6","7","1","1","0","255","145","110","1","1","0","25","18","7","11","5","6","-2"
"130794","Yale University","2019","On-tenure track, assistant professors","676","339","337","1","1","0","94","45","49","24","10","14","36","17","19","2","0","2","312","153","159","6","3","3","111","55","56","90","55","35","-2"
"130794","Yale University","2019","Not on tenure track/No tenure system system total","575","291","284","1","1","0","61","29","32","23","8","15","24","5","19","0","0","0","300","155","145","4","2","2","90","46","44","72","45","27","-2"
"130794","Yale University","2019","Not on tenure/no tenure system, professors","69","46","23","0","0","0","6","5","1","2","1","1","0","0","0","0","0","0","53","34","19","0","0","0","5","3","2","3","3","0","-2"
"130794","Yale University","2019","Not on tenure/no tenure system, associate professors","13","9","4","0","0","0","2","2","0","0","0","0","0","0","0","0","0","0","11","7","4","0","0","0","0","0","0","0","0","0","-2"
"130794","Yale University","2019","Not on tenure/no tenure system, assistant professors","19","7","12","0","0","0","3","3","0","3","1","2","3","1","2","0","0","0","8","2","6","0","0","0","1","0","1","1","0","1","-2"
"130794","Yale University","2019","Not on tenure/no tenure system, lecturers","474","229","245","1","1","0","50","19","31","18","6","12","21","4","17","0","0","0","228","112","116","4","2","2","84","43","41","68","42","26","-2"
"130934","Delaware State University","2019","Tenured total","124","75","49","2","2","0","31","21","10","42","22","20","3","3","0","0","0","0","44","27","17","2","0","2","0","0","0","0","0","0","-2"
"130934","Delaware State University","2019","Tenured, professors","49","34","15","2","2","0","14","10","4","12","9","3","1","1","0","0","0","0","20","12","8","0","0","0","0","0","0","0","0","0","-2"
"130934","Delaware State University","2019","Tenured, associate professors","75","41","34","0","0","0","17","11","6","30","13","17","2","2","0","0","0","0","24","15","9","2","0","2","0","0","0","0","0","0","-2"
"130934","Delaware State University","2019","On-Tenure track total","48","20","28","0","0","0","9","6","3","22","8","14","0","0","0","0","0","0","17","6","11","0","0","0","0","0","0","0","0","0","-2"
"130934","Delaware State University","2019","On-tenure track, associate professors","13","5","8","0","0","0","2","2","0","6","1","5","0","0","0","0","0","0","5","2","3","0","0","0","0","0","0","0","0","0","-2"
"130934","Delaware State University","2019","On-tenure track, assistant professors","35","15","20","0","0","0","7","4","3","16","7","9","0","0","0","0","0","0","12","4","8","0","0","0","0","0","0","0","0","0","-2"
"130934","Delaware State University","2019","Not on tenure track/No tenure system system total","42","16","26","0","0","0","5","1","4","20","9","11","3","1","2","0","0","0","14","5","9","0","0","0","0","0","0","0","0","0","-2"
"130934","Delaware State University","2019","Not on tenure/no tenure system, assistant professors","15","6","9","0","0","0","2","0","2","8","4","4","2","1","1","0","0","0","3","1","2","0","0","0","0","0","0","0","0","0","-2"
"130934","Delaware State University","2019","Not on tenure/no tenure system, instructors","3","3","0","0","0","0","0","0","0","1","1","0","0","0","0","0","0","0","2","2","0","0","0","0","0","0","0","0","0","0","-2"
"130934","Delaware State University","2019","Not on tenure/no tenure system, lecturers","24","7","17","0","0","0","3","1","2","11","4","7","1","0","1","0","0","0","9","2","7","0","0","0","0","0","0","0","0","0","-2"
"130943","University of Delaware","2019","Tenured total","670","432","238","0","0","0","111","76","35","31","16","15","23","15","8","0","0","0","500","322","178","0","0","0","2","1","1","3","2","1","-2"
"130943","University of Delaware","2019","Tenured, professors","374","267","107","0","0","0","61","47","14","15","9","6","10","9","1","0","0","0","288","202","86","0","0","0","0","0","0","0","0","0","-2"
"130943","University of Delaware","2019","Tenured, associate professors","296","165","131","0","0","0","50","29","21","16","7","9","13","6","7","0","0","0","212","120","92","0","0","0","2","1","1","3","2","1","-2"
"130943","University of Delaware","2019","On-Tenure track total","232","115","117","0","0","0","41","20","21","10","5","5","11","5","6","0","0","0","136","63","73","5","3","2","0","0","0","29","19","10","-2"
"130943","University of Delaware","2019","On-tenure track, professors","3","2","1","0","0","0","0","0","0","0","0","0","0","0","0","0","0","0","3","2","1","0","0","0","0","0","0","0","0","0","-2"
"130943","University of Delaware","2019","On-tenure track, associate professors","11","6","5","0","0","0","1","1","0","0","0","0","1","0","1","0","0","0","9","5","4","0","0","0","0","0","0","0","0","0","-2"
"130943","University of Delaware","2019","On-tenure track, assistant professors","216","106","110","0","0","0","40","19","21","10","5","5","10","5","5","0","0","0","122","55","67","5","3","2","0","0","0","29","19","10","-2"
"130943","University of Delaware","2019","On-tenure track, instructors","2","1","1","0","0","0","0","0","0","0","0","0","0","0","0","0","0","0","2","1","1","0","0","0","0","0","0","0","0","0","-2"
"130943","University of Delaware","2019","Not on tenure track/No tenure system system total","363","151","212","1","0","1","21","9","12","23","9","14","10","3","7","0","0","0","288","121","167","3","0","3","0","0","0","17","9","8","-2"
"130943","University of Delaware","2019","Not on tenure/no tenure system, professors","23","15","8","0","0","0","4","3","1","1","1","0","0","0","0","0","0","0","18","11","7","0","0","0","0","0","0","0","0","0","-2"
"130943","University of Delaware","2019","Not on tenure/no tenure system, associate professors","68","34","34","1","0","1","5","3","2","3","2","1","3","1","2","0","0","0","56","28","28","0","0","0","0","0","0","0","0","0","-2"
"130943","University of Delaware","2019","Not on tenure/no tenure system, assistant professors","178","78","100","0","0","0","10","3","7","12","5","7","3","2","1","0","0","0","133","59","74","3","0","3","0","0","0","17","9","8","-2"
"130943","University of Delaware","2019","Not on tenure/no tenure system, instructors","94","24","70","0","0","0","2","0","2","7","1","6","4","0","4","0","0","0","81","23","58","0","0","0","0","0","0","0","0","0","-2"
"131520","Howard University","2019","Tenured total","475","286","189","1","0","1","63","46","17","303","176","127","13","2","11","0","0","0","82","51","31","5","3","2","8","8","0","0","0","0","-2"
"131520","Howard University","2019","Tenured, professors","225","151","74","1","0","1","30","25","5","142","90","52","6","1","5","0","0","0","39","29","10","4","3","1","3","3","0","0","0","0","-2"
"131520","Howard University","2019","Tenured, associate professors","244","131","113","0","0","0","32","20","12","159","85","74","6","1","5","0","0","0","42","21","21","1","0","1","4","4","0","0","0","0","-2"
"131520","Howard University","2019","Tenured, assistant professors","6","4","2","0","0","0","1","1","0","2","1","1","1","0","1","0","0","0","1","1","0","0","0","0","1","1","0","0","0","0","-2"
"131520","Howard University","2019","On-Tenure track total","176","82","94","1","1","0","25","18","7","107","46","61","5","5","0","0","0","0","32","11","21","4","0","4","2","1","1","0","0","0","-2"
"131520","Howard University","2019","On-tenure track, professors","4","3","1","0","0","0","0","0","0","2","2","0","0","0","0","0","0","0","2","1","1","0","0","0","0","0","0","0","0","0","-2"
"131520","Howard University","2019","On-tenure track, associate professors","16","7","9","0","0","0","1","1","0","10","3","7","1","1","0","0","0","0","4","2","2","0","0","0","0","0","0","0","0","0","-2"
"131520","Howard University","2019","On-tenure track, assistant professors","154","71","83","1","1","0","24","17","7","93","40","53","4","4","0","0","0","0","26","8","18","4","0","4","2","1","1","0","0","0","-2"
"131520","Howard University","2019","On-tenure track, instructors","2","1","1","0","0","0","0","0","0","2","1","1","0","0","0","0","0","0","0","0","0","0","0","0","0","0","0","0","0","0","-2"
"131520","Howard University","2019","Not on tenure track/No tenure system system total","299","133","166","1","0","1","36","15","21","194","85","109","10","5","5","0","0","0","43","19","24","4","3","1","10","5","5","1","1","0","-2"
"131520","Howard University","2019","Not on tenure/no tenure system, professors","6","3","3","0","0","0","2","0","2","2","1","1","0","0","0","0","0","0","2","2","0","0","0","0","0","0","0","0","0","0","-2"
"131520","Howard University","2019","Not on tenure/no tenure system, associate professors","46","25","21","0","0","0","4","2","2","37","20","17","0","0","0","0","0","0","4","2","2","0","0","0","1","1","0","0","0","0","-2"
"131520","Howard University","2019","Not on tenure/no tenure system, assistant professors","94","37","57","1","0","1","20","10","10","56","17","39","0","0","0","0","0","0","10","5","5","3","3","0","4","2","2","0","0","0","-2"
"131520","Howard University","2019","Not on tenure/no tenure system, instructors","56","22","34","0","0","0","5","1","4","34","13","21","5","2","3","0","0","0","12","6","6","0","0","0","0","0","0","0","0","0","-2"
"131520","Howard University","2019","Not on tenure/no tenure system, lecturers","93","45","48","0","0","0","3","1","2","65","34","31","5","3","2","0","0","0","13","4","9","1","0","1","5","2","3","1","1","0","-2"
"131520","Howard University","2019","Not on tenure/no tenure system, no academic rank","4","1","3","0","0","0","2","1","1","0","0","0","0","0","0","0","0","0","2","0","2","0","0","0","0","0","0","0","0","0","-2"
"133553","Embry-Riddle Aeronautical University-Daytona Beach","2019","Tenured total","147","113","34","0","0","0","20","14","6","1","0","1","3","2","1","0","0","0","121","96","25","0","0","0","0","0","0","2","1","1","-2"
"133553","Embry-Riddle Aeronautical University-Daytona Beach","2019","Tenured, professors","85","70","15","0","0","0","13","9","4","0","0","0","2","1","1","0","0","0","70","60","10","0","0","0","0","0","0","0","0","0","-2"
"133553","Embry-Riddle Aeronautical University-Daytona Beach","2019","Tenured, associate professors","62","43","19","0","0","0","7","5","2","1","0","1","1","1","0","0","0","0","51","36","15","0","0","0","0","0","0","2","1","1","-2"
"133553","Embry-Riddle Aeronautical University-Daytona Beach","2019","On-Tenure track total","63","41","22","0","0","0","10","8","2","2","2","0","4","3","1","0","0","0","39","24","15","1","0","1","0","0","0","7","4","3","-2"
"133553","Embry-Riddle Aeronautical University-Daytona Beach","2019","On-tenure track, professors","1","1","0","0","0","0","0","0","0","0","0","0","0","0","0","0","0","0","1","1","0","0","0","0","0","0","0","0","0","0","-2"
"133553","Embry-Riddle Aeronautical University-Daytona Beach","2019","On-tenure track, associate professors","4","3","1","0","0","0","0","0","0","0","0","0","1","0","1","0","0","0","3","3","0","0","0","0","0","0","0","0","0","0","-2"
"133553","Embry-Riddle Aeronautical University-Daytona Beach","2019","On-tenure track, assistant professors","58","37","21","0","0","0","10","8","2","2","2","0","3","3","0","0","0","0","35","20","15","1","0","1","0","0","0","7","4","3","-2"
"133553","Embry-Riddle Aeronautical University-Daytona Beach","2019","Not on tenure track/No tenure system system total","125","84","41","0","0","0","7","3","4","3","2","1","9","7","2","1","1","0","94","66","28","2","0","2","0","0","0","9","5","4","-2"
"133553","Embry-Riddle Aeronautical University-Daytona Beach","2019","Not on tenure/no tenure system, professors","5","3","2","0","0","0","1","1","0","0","0","0","0","0","0","0","0","0","4","2","2","0","0","0","0","0","0","0","0","0","-2"
"133553","Embry-Riddle Aeronautical University-Daytona Beach","2019","Not on tenure/no tenure system, associate professors","36","34","2","0","0","0","2","1","1","2","2","0","4","4","0","1","1","0","26","25","1","0","0","0","0","0","0","1","1","0","-2"
"133553","Embry-Riddle Aeronautical University-Daytona Beach","2019","Not on tenure/no tenure system, assistant professors","58","33","25","0","0","0","4","1","3","1","0","1","2","2","0","0","0","0","41","26","15","2","0","2","0","0","0","8","4","4","-2"
"133553","Embry-Riddle Aeronautical University-Daytona Beach","2019","Not on tenure/no tenure system, instructors","26","14","12","0","0","0","0","0","0","0","0","0","3","1","2","0","0","0","23","13","10","0","0","0","0","0","0","0","0","0","-2"
"133650","Florida Agricultural and Mechanical University","2019","Tenured total","300","182","118","0","0","0","16","13","3","199","111","88","8","3","5","0","0","0","53","36","17","4","4","0","0","0","0","20","15","5","-2"
"133650","Florida Agricultural and Mechanical University","2019","Tenured, professors","150","106","44","0","0","0","12","11","1","92","61","31","2","1","1","0","0","0","31","22","9","1","1","0","0","0","0","12","10","2","-2"
"133650","Florida Agricultural and Mechanical University","2019","Tenured, associate professors","139","70","69","0","0","0","4","2","2","98","46","52","6","2","4","0","0","0","21","13","8","2","2","0","0","0","0","8","5","3","-2"
"133650","Florida Agricultural and Mechanical University","2019","Tenured, assistant professors","11","6","5","0","0","0","0","0","0","9","4","5","0","0","0","0","0","0","1","1","0","1","1","0","0","0","0","0","0","0","-2"
"133650","Florida Agricultural and Mechanical University","2019","On-Tenure track total","114","58","56","0","0","0","8","5","3","63","26","37","4","3","1","0","0","0","21","12","9","2","2","0","0","0","0","16","10","6","-2"
"133650","Florida Agricultural and Mechanical University","2019","On-tenure track, professors","1","0","1","0","0","0","1","0","1","0","0","0","0","0","0","0","0","0","0","0","0","0","0","0","0","0","0","0","0","0","-2"
"133650","Florida Agricultural and Mechanical University","2019","On-tenure track, associate professors","17","11","6","0","0","0","0","0","0","7","4","3","0","0","0","0","0","0","6","4","2","2","2","0","0","0","0","2","1","1","-2"
"133650","Florida Agricultural and Mechanical University","2019","On-tenure track, assistant professors","95","46","49","0","0","0","7","5","2","55","21","34","4","3","1","0","0","0","15","8","7","0","0","0","0","0","0","14","9","5","-2"
"133650","Florida Agricultural and Mechanical University","2019","On-tenure track, instructors","1","1","0","0","0","0","0","0","0","1","1","0","0","0","0","0","0","0","0","0","0","0","0","0","0","0","0","0","0","0","-2"
"133650","Florida Agricultural and Mechanical University","2019","Not on tenure track/No tenure system system total","133","51","82","0","0","0","2","1","1","84","24","60","3","1","2","0","0","0","22","14","8","4","1","3","0","0","0","18","10","8","-2"
"133650","Florida Agricultural and Mechanical University","2019","Not on tenure/no tenure system, professors","8","3","5","0","0","0","0","0","0","5","2","3","0","0","0","0","0","0","1","1","0","1","0","1","0","0","0","1","0","1","-2"
"133650","Florida Agricultural and Mechanical University","2019","Not on tenure/no tenure system, associate professors","3","0","3","0","0","0","0","0","0","1","0","1","0","0","0","0","0","0","1","0","1","1","0","1","0","0","0","0","0","0","-2"
"133650","Florida Agricultural and Mechanical University","2019","Not on tenure/no tenure system, assistant professors","40","14","26","0","0","0","0","0","0","27","6","21","0","0","0","0","0","0","7","4","3","1","0","1","0","0","0","5","4","1","-2"
"133650","Florida Agricultural and Mechanical University","2019","Not on tenure/no tenure system, instructors","82","34","48","0","0","0","2","1","1","51","16","35","3","1","2","0","0","0","13","9","4","1","1","0","0","0","0","12","6","6","-2"
"133881","Florida Institute of Technology","2019","Tenured total","44","35","9","1","1","0","3","2","1","0","0","0","0","0","0","4","4","0","34","26","8","0","0","0","1","1","0","1","1","0","-2"
"133881","Florida Institute of Technology","2019","Tenured, professors","43","35","8","1","1","0","3","2","1","0","0","0","0","0","0","4","4","0","33","26","7","0","0","0","1","1","0","1","1","0","-2"
"133881","Florida Institute of Technology","2019","Tenured, associate professors","1","0","1","0","0","0","0","0","0","0","0","0","0","0","0","0","0","0","1","0","1","0","0","0","0","0","0","0","0","0","-2"
"133881","Florida Institute of Technology","2019","On-Tenure track total","20","15","5","0","0","0","3","3","0","0","0","0","0","0","0","1","1","0","10","6","4","0","0","0","0","0","0","6","5","1","-2"
"133881","Florida Institute of Technology","2019","On-tenure track, professors","4","4","0","0","0","0","2","2","0","0","0","0","0","0","0","1","1","0","1","1","0","0","0","0","0","0","0","0","0","0","-2"
"133881","Florida Institute of Technology","2019","On-tenure track, associate professors","3","2","1","0","0","0","0","0","0","0","0","0","0","0","0","0","0","0","2","1","1","0","0","0","0","0","0","1","1","0","-2"
"133881","Florida Institute of Technology","2019","On-tenure track, assistant professors","11","8","3","0","0","0","1","1","0","0","0","0","0","0","0","0","0","0","5","3","2","0","0","0","0","0","0","5","4","1","-2"
"133881","Florida Institute of Technology","2019","On-tenure track, instructors","2","1","1","0","0","0","0","0","0","0","0","0","0","0","0","0","0","0","2","1","1","0","0","0","0","0","0","0","0","0","-2"
"133881","Florida Institute of Technology","2019","Not on tenure track/No tenure system system total","224","161","63","4","4","0","22","18","4","5","2","3","16","7","9","9","9","0","149","105","44","3","2","1","2","1","1","14","13","1","-2"
"133881","Florida Institute of Technology","2019","Not on tenure/no tenure system, professors","30","24","6","0","0","0","3","2","1","0","0","0","1","1","0","4","4","0","20","15","5","0","0","0","0","0","0","2","2","0","-2"
"133881","Florida Institute of Technology","2019","Not on tenure/no tenure system, associate professors","84","71","13","2","2","0","12","11","1","1","1","0","5","5","0","4","4","0","54","43","11","3","2","1","0","0","0","3","3","0","-2"
"133881","Florida Institute of Technology","2019","Not on tenure/no tenure system, assistant professors","88","57","31","2","2","0","7","5","2","2","1","1","9","1","8","1","1","0","57","39","18","0","0","0","2","1","1","8","7","1","-2"
"133881","Florida Institute of Technology","2019","Not on tenure/no tenure system, instructors","22","9","13","0","0","0","0","0","0","2","0","2","1","0","1","0","0","0","18","8","10","0","0","0","0","0","0","1","1","0","-2"
"133951","Florida International University","2019","Tenured total","532","361","171","1","0","1","120","94","26","25","14","11","68","51","17","1","1","0","308","198","110","0","0","0","0","0","0","9","3","6","-2"
"133951","Florida International University","2019","Tenured, professors","256","190","66","1","0","1","56","47","9","10","8","2","43","35","8","0","0","0","145","99","46","0","0","0","0","0","0","1","1","0","-2"
"133951","Florida International University","2019","Tenured, associate professors","276","171","105","0","0","0","64","47","17","15","6","9","25","16","9","1","1","0","163","99","64","0","0","0","0","0","0","8","2","6","-2"
"133951","Florida International University","2019","On-Tenure track total","177","99","78","2","2","0","26","16","10","11","3","8","16","10","6","0","0","0","89","48","41","0","0","0","0","0","0","33","20","13","-2"
"133951","Florida International University","2019","On-tenure track, professors","1","1","0","0","0","0","1","1","0","0","0","0","0","0","0","0","0","0","0","0","0","0","0","0","0","0","0","0","0","0","-2"
"133951","Florida International University","2019","On-tenure track, associate professors","19","13","6","1","1","0","6","4","2","2","0","2","1","1","0","0","0","0","9","7","2","0","0","0","0","0","0","0","0","0","-2"
"133951","Florida International University","2019","On-tenure track, assistant professors","157","85","72","1","1","0","19","11","8","9","3","6","15","9","6","0","0","0","80","41","39","0","0","0","0","0","0","33","20","13","-2"
"133951","Florida International University","2019","Not on tenure track/No tenure system system total","647","312","335","3","2","1","42","23","19","49","11","38","203","86","117","0","0","0","294","148","146","9","4","5","0","0","0","47","38","9","-2"
"133951","Florida International University","2019","Not on tenure/no tenure system, professors","26","17","9","0","0","0","3","2","1","1","0","1","6","5","1","0","0","0","14","8","6","0","0","0","0","0","0","2","2","0","-2"
"133951","Florida International University","2019","Not on tenure/no tenure system, associate professors","46","20","26","0","0","0","2","1","1","6","1","5","11","6","5","0","0","0","23","8","15","2","2","0","0","0","0","2","2","0","-2"
"133951","Florida International University","2019","Not on tenure/no tenure system, assistant professors","136","52","84","0","0","0","13","9","4","16","2","14","54","21","33","0","0","0","47","16","31","2","0","2","0","0","0","4","4","0","-2"
"133951","Florida International University","2019","Not on tenure/no tenure system, instructors","388","197","191","2","1","1","20","9","11","23","7","16","116","49","67","0","0","0","186","100","86","4","2","2","0","0","0","37","29","8","-2"
"133951","Florida International University","2019","Not on tenure/no tenure system, lecturers","34","17","17","1","1","0","3","1","2","3","1","2","8","3","5","0","0","0","17","10","7","1","0","1","0","0","0","1","1","0","-2"
"133951","Florida International University","2019","Not on tenure/no tenure system, no academic rank","17","9","8","0","0","0","1","1","0","0","0","0","8","2","6","0","0","0","7","6","1","0","0","0","0","0","0","1","0","1","-2"
"133979","Florida Memorial University","2019","Tenured total","26","16","10","3","3","0","2","2","0","11","5","6","2","2","0","4","0","4","4","4","0","0","0","0","0","0","0","0","0","0","-2"
"133979","Florida Memorial University","2019","Tenured, professors","7","4","3","3","3","0","0","0","0","2","0","2","0","0","0","1","0","1","1","1","0","0","0","0","0","0","0","0","0","0","-2"
"133979","Florida Memorial University","2019","Tenured, associate professors","19","12","7","0","0","0","2","2","0","9","5","4","2","2","0","3","0","3","3","3","0","0","0","0","0","0","0","0","0","0","-2"
"133979","Florida Memorial University","2019","On-Tenure track total","34","19","15","0","0","0","3","2","1","23","13","10","3","1","2","0","0","0","4","3","1","1","0","1","0","0","0","0","0","0","-2"
"133979","Florida Memorial University","2019","On-tenure track, associate professors","13","8","5","0","0","0","0","0","0","10","6","4","2","1","1","0","0","0","1","1","0","0","0","0","0","0","0","0","0","0","-2"
"133979","Florida Memorial University","2019","On-tenure track, assistant professors","21","11","10","0","0","0","3","2","1","13","7","6","1","0","1","0","0","0","3","2","1","1","0","1","0","0","0","0","0","0","-2"
"133979","Florida Memorial University","2019","Not on tenure track/No tenure system system total","8","6","2","0","0","0","1","1","0","4","3","1","2","1","1","0","0","0","1","1","0","0","0","0","0","0","0","0","0","0","-2"
"133979","Florida Memorial University","2019","Not on tenure/no tenure system, instructors","8","6","2","0","0","0","1","1","0","4","3","1","2","1","1","0","0","0","1","1","0","0","0","0","0","0","0","0","0","0","-2"
"134097","Florida State University","2019","Tenured total","821","553","268","3","3","0","118","87","31","34","17","17","33","23","10","0","0","0","621","417","204","8","3","5","1","1","0","3","2","1","-2"
"134097","Florida State University","2019","Tenured, professors","501","362","139","2","2","0","66","51","15","22","11","11","18","13","5","0","0","0","388","282","106","4","2","2","0","0","0","1","1","0","-2"
"134097","Florida State University","2019","Tenured, associate professors","320","191","129","1","1","0","52","36","16","12","6","6","15","10","5","0","0","0","233","135","98","4","1","3","1","1","0","2","1","1","-2"
"134097","Florida State University","2019","On-Tenure track total","351","187","164","1","1","0","49","26","23","17","6","11","21","10","11","0","0","0","201","103","98","9","4","5","1","1","0","52","36","16","-2"
"134097","Florida State University","2019","On-tenure track, professors","2","1","1","0","0","0","0","0","0","0","0","0","0","0","0","0","0","0","2","1","1","0","0","0","0","0","0","0","0","0","-2"
"134097","Florida State University","2019","On-tenure track, associate professors","18","11","7","0","0","0","3","2","1","2","1","1","2","1","1","0","0","0","9","5","4","0","0","0","0","0","0","2","2","0","-2"
"134097","Florida State University","2019","On-tenure track, assistant professors","331","175","156","1","1","0","46","24","22","15","5","10","19","9","10","0","0","0","190","97","93","9","4","5","1","1","0","50","34","16","-2"
"134097","Florida State University","2019","Not on tenure track/No tenure system system total","450","192","258","1","1","0","19","7","12","32","11","21","32","11","21","0","0","0","339","153","186","9","2","7","3","0","3","15","7","8","-2"
"134097","Florida State University","2019","Not on tenure/no tenure system, professors","13","5","8","0","0","0","0","0","0","1","1","0","2","0","2","0","0","0","9","4","5","1","0","1","0","0","0","0","0","0","-2"
"134097","Florida State University","2019","Not on tenure/no tenure system, associate professors","17","10","7","0","0","0","1","0","1","1","1","0","2","2","0","0","0","0","13","7","6","0","0","0","0","0","0","0","0","0","-2"
"134097","Florida State University","2019","Not on tenure/no tenure system, assistant professors","37","12","25","0","0","0","1","1","0","6","3","3","4","1","3","0","0","0","22","6","16","3","1","2","0","0","0","1","0","1","-2"
"134097","Florida State University","2019","Not on tenure/no tenure system, no academic rank","383","165","218","1","1","0","17","6","11","24","6","18","24","8","16","0","0","0","295","136","159","5","1","4","3","0","3","14","7","7","-2"
"135726","University of Miami","2019","Tenured total","825","595","230","2","2","0","115","86","29","23","15","8","93","60","33","0","0","0","575","421","154","4","2","2","6","5","1","7","4","3","-2"
"135726","University of Miami","2019","Tenured, professors","558","427","131","2","2","0","67","51","16","13","8","5","70","49","21","0","0","0","398","311","87","3","2","1","4","4","0","1","0","1","-2"
"135726","University of Miami","2019","Tenured, associate professors","267","168","99","0","0","0","48","35","13","10","7","3","23","11","12","0","0","0","177","110","67","1","0","1","2","1","1","6","4","2","-2"
"135726","University of Miami","2019","On-Tenure track total","193","114","79","1","1","0","29","19","10","11","6","5","18","14","4","0","0","0","91","48","43","1","0","1","5","4","1","37","22","15","-2"
"135726","University of Miami","2019","On-tenure track, professors","8","6","2","0","0","0","0","0","0","0","0","0","0","0","0","0","0","0","4","3","1","0","0","0","2","1","1","2","2","0","-2"
"135726","University of Miami","2019","On-tenure track, associate professors","28","18","10","0","0","0","11","8","3","1","1","0","2","2","0","0","0","0","13","6","7","0","0","0","1","1","0","0","0","0","-2"
"135726","University of Miami","2019","On-tenure track, assistant professors","157","90","67","1","1","0","18","11","7","10","5","5","16","12","4","0","0","0","74","39","35","1","0","1","2","2","0","35","20","15","-2"
"135726","University of Miami","2019","Not on tenure track/No tenure system system total","468","233","235","0","0","0","21","5","16","29","8","21","132","60","72","0","0","0","248","134","114","5","3","2","10","8","2","23","15","8","-2"
"135726","University of Miami","2019","Not on tenure/no tenure system, professors","23","18","5","0","0","0","1","0","1","1","0","1","3","3","0","0","0","0","16","13","3","0","0","0","1","1","0","1","1","0","-2"
"135726","University of Miami","2019","Not on tenure/no tenure system, associate professors","50","27","23","0","0","0","2","1","1","5","2","3","12","6","6","0","0","0","29","16","13","1","1","0","1","1","0","0","0","0","-2"
"135726","University of Miami","2019","Not on tenure/no tenure system, assistant professors","86","39","47","0","0","0","5","2","3","10","2","8","31","13","18","0","0","0","32","18","14","0","0","0","3","2","1","5","2","3","-2"
"135726","University of Miami","2019","Not on tenure/no tenure system, lecturers","309","149","160","0","0","0","13","2","11","13","4","9","86","38","48","0","0","0","171","87","84","4","2","2","5","4","1","17","12","5","-2"
"137351","University of South Florida-Main Campus","2019","Tenured total","702","458","244","1","0","1","113","87","26","28","13","15","26","13","13","0","0","0","495","323","172","16","6","10","7","7","0","16","9","7","-2"
"137351","University of South Florida-Main Campus","2019","Tenured, professors","379","278","101","1","0","1","62","58","4","8","5","3","15","9","6","0","0","0","277","194","83","9","6","3","4","4","0","3","2","1","-2"
"137351","University of South Florida-Main Campus","2019","Tenured, associate professors","321","179","142","0","0","0","51","29","22","20","8","12","11","4","7","0","0","0","216","128","88","7","0","7","3","3","0","13","7","6","-2"
"137351","University of South Florida-Main Campus","2019","Tenured, assistant professors","1","1","0","0","0","0","0","0","0","0","0","0","0","0","0","0","0","0","1","1","0","0","0","0","0","0","0","0","0","0","-2"
"137351","University of South Florida-Main Campus","2019","Tenured, instructors","1","0","1","0","0","0","0","0","0","0","0","0","0","0","0","0","0","0","1","0","1","0","0","0","0","0","0","0","0","0","-2"
"137351","University of South Florida-Main Campus","2019","On-Tenure track total","258","145","113","0","0","0","48","29","19","17","7","10","10","4","6","0","0","0","125","73","52","8","3","5","8","4","4","42","25","17","-2"
"137351","University of South Florida-Main Campus","2019","On-tenure track, professors","18","15","3","0","0","0","3","3","0","0","0","0","1","0","1","0","0","0","13","12","1","1","0","1","0","0","0","0","0","0","-2"
"137351","University of South Florida-Main Campus","2019","On-tenure track, associate professors","55","33","22","0","0","0","13","11","2","3","1","2","1","0","1","0","0","0","30","17","13","0","0","0","2","1","1","6","3","3","-2"
"137351","University of South Florida-Main Campus","2019","On-tenure track, assistant professors","181","94","87","0","0","0","30","14","16","14","6","8","8","4","4","0","0","0","80","42","38","7","3","4","6","3","3","36","22","14","-2"
"137351","University of South Florida-Main Campus","2019","On-tenure track, instructors","4","3","1","0","0","0","2","1","1","0","0","0","0","0","0","0","0","0","2","2","0","0","0","0","0","0","0","0","0","0","-2"
"137351","University of South Florida-Main Campus","2019","Not on tenure track/No tenure system system total","902","405","497","1","1","0","98","48","50","46","18","28","69","37","32","1","0","1","579","251","328","30","7","23","43","20","23","35","23","12","-2"
"137351","University of South Florida-Main Campus","2019","Not on tenure/no tenure system, professors","48","34","14","0","0","0","5","3","2","1","0","1","5","3","2","0","0","0","34","26","8","1","0","1","1","1","0","1","1","0","-2"
"137351","University of South Florida-Main Campus","2019","Not on tenure/no tenure system, associate professors","104","54","50","1","1","0","14","8","6","7","4","3","12","9","3","0","0","0","61","28","33","5","2","3","2","1","1","2","1","1","-2"
"137351","University of South Florida-Main Campus","2019","Not on tenure/no tenure system, assistant professors","294","129","165","0","0","0","35","19","16","14","3","11","28","15","13","1","0","1","162","65","97","10","2","8","29","14","15","15","11","4","-2"
"137351","University of South Florida-Main Campus","2019","Not on tenure/no tenure system, instructors","394","158","236","0","0","0","25","9","16","23","11","12","20","7","13","0","0","0","295","119","176","11","2","9","4","1","3","16","9","7","-2"
"137351","University of South Florida-Main Campus","2019","Not on tenure/no tenure system, no academic rank","62","30","32","0","0","0","19","9","10","1","0","1","4","3","1","0","0","0","27","13","14","3","1","2","7","3","4","1","1","0","-2"
"139755","Georgia Institute of Technology-Main Campus","2019","Tenured total","665","524","141","0","0","0","75","63","12","20","13","7","20","13","7","0","0","0","348","275","73","2","2","0","1","1","0","199","157","42","-2"
"139755","Georgia Institute of Technology-Main Campus","2019","Tenured, professors","418","344","74","0","0","0","55","49","6","9","6","3","9","7","2","0","0","0","231","188","43","0","0","0","1","1","0","113","93","20","-2"
"139755","Georgia Institute of Technology-Main Campus","2019","Tenured, associate professors","246","180","66","0","0","0","20","14","6","11","7","4","11","6","5","0","0","0","116","87","29","2","2","0","0","0","0","86","64","22","-2"
"139755","Georgia Institute of Technology-Main Campus","2019","Tenured, no academic rank","1","0","1","0","0","0","0","0","0","0","0","0","0","0","0","0","0","0","1","0","1","0","0","0","0","0","0","0","0","0","-2"
"139755","Georgia Institute of Technology-Main Campus","2019","On-Tenure track total","187","123","64","0","0","0","16","9","7","5","3","2","4","4","0","1","0","1","72","48","24","0","0","0","5","4","1","84","55","29","-2"
"139755","Georgia Institute of Technology-Main Campus","2019","On-tenure track, professors","2","2","0","0","0","0","0","0","0","0","0","0","0","0","0","0","0","0","2","2","0","0","0","0","0","0","0","0","0","0","-2"
"139755","Georgia Institute of Technology-Main Campus","2019","On-tenure track, associate professors","11","9","2","0","0","0","3","2","1","2","2","0","0","0","0","0","0","0","1","1","0","0","0","0","0","0","0","5","4","1","-2"
"139755","Georgia Institute of Technology-Main Campus","2019","On-tenure track, assistant professors","173","111","62","0","0","0","13","7","6","3","1","2","4","4","0","1","0","1","68","44","24","0","0","0","5","4","1","79","51","28","-2"
"139755","Georgia Institute of Technology-Main Campus","2019","On-tenure track, lecturers","1","1","0","0","0","0","0","0","0","0","0","0","0","0","0","0","0","0","1","1","0","0","0","0","0","0","0","0","0","0","-2"
"139755","Georgia Institute of Technology-Main Campus","2019","Not on tenure track/No tenure system system total","196","101","95","0","0","0","16","9","7","6","5","1","3","2","1","0","0","0","129","62","67","1","1","0","1","0","1","40","22","18","-2"
"139755","Georgia Institute of Technology-Main Campus","2019","Not on tenure/no tenure system, assistant professors","17","8","9","0","0","0","1","0","1","0","0","0","1","1","0","0","0","0","6","2","4","0","0","0","0","0","0","9","5","4","-2"
"139755","Georgia Institute of Technology-Main Campus","2019","Not on tenure/no tenure system, instructors","3","0","3","0","0","0","0","0","0","0","0","0","0","0","0","0","0","0","3","0","3","0","0","0","0","0","0","0","0","0","-2"
"139755","Georgia Institute of Technology-Main Campus","2019","Not on tenure/no tenure system, lecturers","111","55","56","0","0","0","9","3","6","5","4","1","2","1","1","0","0","0","72","33","39","1","1","0","1","0","1","21","13","8","-2"
"139755","Georgia Institute of Technology-Main Campus","2019","Not on tenure/no tenure system, no academic rank","65","38","27","0","0","0","6","6","0","1","1","0","0","0","0","0","0","0","48","27","21","0","0","0","0","0","0","10","4","6","-2"
"139959","University of Georgia","2019","Tenured total","1236","820","416","5","3","2","138","100","38","66","34","32","22","14","8","0","0","0","918","613","305","3","2","1","72","43","29","12","11","1","-2"
"139959","University of Georgia","2019","Tenured, professors","715","516","199","4","2","2","79","59","20","39","23","16","12","8","4","0","0","0","540","396","144","0","0","0","36","23","13","5","5","0","-2"
"139959","University of Georgia","2019","Tenured, associate professors","520","303","217","1","1","0","59","41","18","27","11","16","10","6","4","0","0","0","377","216","161","3","2","1","36","20","16","7","6","1","-2"
"139959","University of Georgia","2019","Tenured, assistant professors","1","1","0","0","0","0","0","0","0","0","0","0","0","0","0","0","0","0","1","1","0","0","0","0","0","0","0","0","0","0","-2"
"139959","University of Georgia","2019","On-Tenure track total","411","212","199","1","1","0","44","22","22","20","8","12","5","2","3","0","0","0","217","107","110","1","0","1","74","43","31","49","29","20","-2"
"139959","University of Georgia","2019","On-tenure track, professors","2","1","1","0","0","0","0","0","0","0","0","0","0","0","0","0","0","0","2","1","1","0","0","0","0","0","0","0","0","0","-2"
"139959","University of Georgia","2019","On-tenure track, associate professors","19","9","10","0","0","0","4","1","3","2","1","1","0","0","0","0","0","0","8","3","5","0","0","0","5","4","1","0","0","0","-2"
"139959","University of Georgia","2019","On-tenure track, assistant professors","389","202","187","1","1","0","40","21","19","18","7","11","5","2","3","0","0","0","207","103","104","1","0","1","69","39","30","48","29","19","-2"
"139959","University of Georgia","2019","On-tenure track, no academic rank","1","0","1","0","0","0","0","0","0","0","0","0","0","0","0","0","0","0","0","0","0","0","0","0","0","0","0","1","0","1","-2"
"139959","University of Georgia","2019","Not on tenure track/No tenure system system total","497","233","264","1","0","1","17","6","11","19","5","14","5","3","2","0","0","0","368","172","196","3","1","2","48","19","29","36","27","9","-2"
"139959","University of Georgia","2019","Not on tenure/no tenure system, professors","5","3","2","0","0","0","0","0","0","0","0","0","1","1","0","0","0","0","3","1","2","0","0","0","0","0","0","1","1","0","-2"
"139959","University of Georgia","2019","Not on tenure/no tenure system, assistant professors","21","12","9","0","0","0","3","1","2","1","0","1","0","0","0","0","0","0","5","2","3","1","0","1","0","0","0","11","9","2","-2"
"139959","University of Georgia","2019","Not on tenure/no tenure system, instructors","72","37","35","1","0","1","3","1","2","1","1","0","3","1","2","0","0","0","49","27","22","0","0","0","10","5","5","5","2","3","-2"
"139959","University of Georgia","2019","Not on tenure/no tenure system, lecturers","257","125","132","0","0","0","9","4","5","11","3","8","0","0","0","0","0","0","205","99","106","1","1","0","19","8","11","12","10","2","-2"
"139959","University of Georgia","2019","Not on tenure/no tenure system, no academic rank","142","56","86","0","0","0","2","0","2","6","1","5","1","1","0","0","0","0","106","43","63","1","0","1","19","6","13","7","5","2","-2"
"140720","Paine College","2019","Tenured total","3","3","0","0","0","0","1","1","0","1","1","0","0","0","0","0","0","0","1","1","0","0","0","0","0","0","0","0","0","0","-2"
"140720","Paine College","2019","Tenured, professors","3","3","0","0","0","0","1","1","0","1","1","0","0","0","0","0","0","0","1","1","0","0","0","0","0","0","0","0","0","0","-2"
"140720","Paine College","2019","On-Tenure track total","22","15","7","0","0","0","4","4","0","11","5","6","0","0","0","0","0","0","5","4","1","0","0","0","0","0","0","2","2","0","-2"
"140720","Paine College","2019","On-tenure track, associate professors","4","4","0","0","0","0","1","1","0","2","2","0","0","0","0","0","0","0","0","0","0","0","0","0","0","0","0","1","1","0","-2"
"140720","Paine College","2019","On-tenure track, assistant professors","18","11","7","0","0","0","3","3","0","9","3","6","0","0","0","0","0","0","5","4","1","0","0","0","0","0","0","1","1","0","-2"
"140720","Paine College","2019","Not on tenure track/No tenure system system total","8","5","3","0","0","0","0","0","0","7","5","2","0","0","0","0","0","0","1","0","1","0","0","0","0","0","0","0","0","0","-2"
"140720","Paine College","2019","Not on tenure/no tenure system, assistant professors","2","2","0","0","0","0","0","0","0","2","2","0","0","0","0","0","0","0","0","0","0","0","0","0","0","0","0","0","0","0","-2"
"140720","Paine College","2019","Not on tenure/no tenure system, instructors","6","3","3","0","0","0","0","0","0","5","3","2","0","0","0","0","0","0","1","0","1","0","0","0","0","0","0","0","0","0","-2"
"140960","Savannah State University","2019","Tenured total","71","45","26","0","0","0","18","14","4","28","19","9","1","1","0","0","0","0","15","8","7","0","0","0","2","0","2","7","3","4","-2"
"140960","Savannah State University","2019","Tenured, professors","29","23","6","0","0","0","11","10","1","12","10","2","0","0","0","0","0","0","6","3","3","0","0","0","0","0","0","0","0","0","-2"
"140960","Savannah State University","2019","Tenured, associate professors","37","20","17","0","0","0","7","4","3","13","8","5","1","1","0","0","0","0","8","4","4","0","0","0","1","0","1","7","3","4","-2"
"140960","Savannah State University","2019","Tenured, assistant professors","5","2","3","0","0","0","0","0","0","3","1","2","0","0","0","0","0","0","1","1","0","0","0","0","1","0","1","0","0","0","-2"
"140960","Savannah State University","2019","On-Tenure track total","55","27","28","0","0","0","5","3","2","23","9","14","3","2","1","1","0","1","18","10","8","0","0","0","1","0","1","4","3","1","-2"
"140960","Savannah State University","2019","On-tenure track, associate professors","4","1","3","0","0","0","1","0","1","0","0","0","0","0","0","0","0","0","3","1","2","0","0","0","0","0","0","0","0","0","-2"
"140960","Savannah State University","2019","On-tenure track, assistant professors","50","26","24","0","0","0","4","3","1","22","9","13","3","2","1","1","0","1","15","9","6","0","0","0","1","0","1","4","3","1","-2"
"140960","Savannah State University","2019","On-tenure track, instructors","1","0","1","0","0","0","0","0","0","1","0","1","0","0","0","0","0","0","0","0","0","0","0","0","0","0","0","0","0","0","-2"
"140960","Savannah State University","2019","Not on tenure track/No tenure system system total","43","23","20","0","0","0","3","2","1","19","6","13","1","1","0","0","0","0","16","12","4","0","0","0","3","1","2","1","1","0","-2"
"140960","Savannah State University","2019","Not on tenure/no tenure system, assistant professors","5","1","4","0","0","0","0","0","0","3","0","3","0","0","0","0","0","0","2","1","1","0","0","0","0","0","0","0","0","0","-2"
"140960","Savannah State University","2019","Not on tenure/no tenure system, instructors","22","13","9","0","0","0","2","1","1","9","4","5","1","1","0","0","0","0","7","6","1","0","0","0","2","0","2","1","1","0","-2"
"140960","Savannah State University","2019","Not on tenure/no tenure system, lecturers","10","5","5","0","0","0","1","1","0","3","0","3","0","0","0","0","0","0","5","3","2","0","0","0","1","1","0","0","0","0","-2"
"140960","Savannah State University","2019","Not on tenure/no tenure system, no academic rank","6","4","2","0","0","0","0","0","0","4","2","2","0","0","0","0","0","0","2","2","0","0","0","0","0","0","0","0","0","0","-2"
"141060","Spelman College","2019","Tenured total","88","24","64","2","1","1","9","3","6","59","12","47","2","1","1","0","0","0","12","6","6","4","1","3","0","0","0","0","0","0","-2"
"141060","Spelman College","2019","Tenured, professors","20","7","13","0","0","0","5","2","3","11","1","10","0","0","0","0","0","0","4","4","0","0","0","0","0","0","0","0","0","0","-2"
"141060","Spelman College","2019","Tenured, associate professors","68","17","51","2","1","1","4","1","3","48","11","37","2","1","1","0","0","0","8","2","6","4","1","3","0","0","0","0","0","0","-2"
"141060","Spelman College","2019","On-Tenure track total","43","8","35","0","0","0","7","4","3","27","2","25","2","1","1","0","0","0","7","1","6","0","0","0","0","0","0","0","0","0","-2"
"141060","Spelman College","2019","On-tenure track, assistant professors","43","8","35","0","0","0","7","4","3","27","2","25","2","1","1","0","0","0","7","1","6","0","0","0","0","0","0","0","0","0","-2"
"141060","Spelman College","2019","Not on tenure track/No tenure system system total","52","10","42","0","0","0","5","0","5","33","5","28","5","2","3","0","0","0","7","2","5","1","1","0","1","0","1","0","0","0","-2"
"141060","Spelman College","2019","Not on tenure/no tenure system, instructors","17","3","14","0","0","0","0","0","0","16","3","13","0","0","0","0","0","0","1","0","1","0","0","0","0","0","0","0","0","0","-2"
"141060","Spelman College","2019","Not on tenure/no tenure system, lecturers","35","7","28","0","0","0","5","0","5","17","2","15","5","2","3","0","0","0","6","2","4","1","1","0","1","0","1","0","0","0","-2"
"141574","University of Hawaii at Manoa","2019","Tenured total","733","433","300","1","1","0","216","128","88","6","3","3","9","6","3","41","12","29","411","261","150","11","3","8","0","0","0","38","19","19","-2"
"141574","University of Hawaii at Manoa","2019","Tenured, professors","428","283","145","1","1","0","129","88","41","3","1","2","6","3","3","16","4","12","259","178","81","2","0","2","0","0","0","12","8","4","-2"
"141574","University of Hawaii at Manoa","2019","Tenured, associate professors","304","150","154","0","0","0","86","40","46","3","2","1","3","3","0","25","8","17","152","83","69","9","3","6","0","0","0","26","11","15","-2"
"141574","University of Hawaii at Manoa","2019","Tenured, assistant professors","1","0","1","0","0","0","1","0","1","0","0","0","0","0","0","0","0","0","0","0","0","0","0","0","0","0","0","0","0","0","-2"
"141574","University of Hawaii at Manoa","2019","On-Tenure track total","194","103","91","0","0","0","54","34","20","4","1","3","4","1","3","12","4","8","91","51","40","16","5","11","0","0","0","13","7","6","-2"
"141574","University of Hawaii at Manoa","2019","On-tenure track, associate professors","4","1","3","0","0","0","3","1","2","0","0","0","0","0","0","0","0","0","1","0","1","0","0","0","0","0","0","0","0","0","-2"
"141574","University of Hawaii at Manoa","2019","On-tenure track, assistant professors","190","102","88","0","0","0","51","33","18","4","1","3","4","1","3","12","4","8","90","51","39","16","5","11","0","0","0","13","7","6","-2"
"141574","University of Hawaii at Manoa","2019","Not on tenure track/No tenure system system total","226","84","142","0","0","0","72","19","53","4","0","4","9","4","5","26","11","15","88","39","49","16","4","12","0","0","0","11","7","4","-2"
"141574","University of Hawaii at Manoa","2019","Not on tenure/no tenure system, professors","10","7","3","0","0","0","5","4","1","0","0","0","0","0","0","0","0","0","4","2","2","0","0","0","0","0","0","1","1","0","-2"
"141574","University of Hawaii at Manoa","2019","Not on tenure/no tenure system, associate professors","23","9","14","0","0","0","12","3","9","0","0","0","1","0","1","2","0","2","6","4","2","1","1","0","0","0","0","1","1","0","-2"
"141574","University of Hawaii at Manoa","2019","Not on tenure/no tenure system, assistant professors","68","28","40","0","0","0","16","4","12","2","0","2","4","2","2","2","2","0","32","15","17","6","1","5","0","0","0","6","4","2","-2"
"141574","University of Hawaii at Manoa","2019","Not on tenure/no tenure system, instructors","125","40","85","0","0","0","39","8","31","2","0","2","4","2","2","22","9","13","46","18","28","9","2","7","0","0","0","3","1","2","-2"
"141644","Hawaii Pacific University","2019","Tenured total","1","1","0","0","0","0","0","0","0","0","0","0","0","0","0","0","0","0","1","1","0","0","0","0","0","0","0","0","0","0","-2"
"141644","Hawaii Pacific University","2019","Tenured, professors","1","1","0","0","0","0","0","0","0","0","0","0","0","0","0","0","0","0","1","1","0","0","0","0","0","0","0","0","0","0","-2"
"141644","Hawaii Pacific University","2019","Not on tenure track/No tenure system system total","144","76","68","3","1","2","34","18","16","1","1","0","5","0","5","4","2","2","90","52","38","7","2","5","0","0","0","0","0","0","-2"
"141644","Hawaii Pacific University","2019","Not on tenure/no tenure system, professors","24","13","11","1","0","1","4","3","1","0","0","0","0","0","0","1","0","1","17","10","7","1","0","1","0","0","0","0","0","0","-2"
"141644","Hawaii Pacific University","2019","Not on tenure/no tenure system, associate professors","44","24","20","2","1","1","12","6","6","0","0","0","1","0","1","2","2","0","25","14","11","2","1","1","0","0","0","0","0","0","-2"
"141644","Hawaii Pacific University","2019","Not on tenure/no tenure system, assistant professors","47","25","22","0","0","0","11","6","5","0","0","0","3","0","3","0","0","0","29","18","11","4","1","3","0","0","0","0","0","0","-2"
"141644","Hawaii Pacific University","2019","Not on tenure/no tenure system, instructors","14","7","7","0","0","0","2","1","1","0","0","0","1","0","1","1","0","1","10","6","4","0","0","0","0","0","0","0","0","0","-2"
"141644","Hawaii Pacific University","2019","Not on tenure/no tenure system, lecturers","15","7","8","0","0","0","5","2","3","1","1","0","0","0","0","0","0","0","9","4","5","0","0","0","0","0","0","0","0","0","-2"
"142115","Boise State University","2019","Tenured total","356","201","155","2","1","1","28","19","9","2","2","0","12","5","7","0","0","0","306","169","137","3","3","0","0","0","0","3","2","1","-2"
"142115","Boise State University","2019","Tenured, professors","175","106","69","2","1","1","8","6","2","0","0","0","7","3","4","0","0","0","156","94","62","1","1","0","0","0","0","1","1","0","-2"
"142115","Boise State University","2019","Tenured, associate professors","177","93","84","0","0","0","20","13","7","2","2","0","5","2","3","0","0","0","146","73","73","2","2","0","0","0","0","2","1","1","-2"
"142115","Boise State University","2019","Tenured, assistant professors","4","2","2","0","0","0","0","0","0","0","0","0","0","0","0","0","0","0","4","2","2","0","0","0","0","0","0","0","0","0","-2"
"142115","Boise State University","2019","On-Tenure track total","174","94","80","0","0","0","10","4","6","0","0","0","5","1","4","0","0","0","133","73","60","1","1","0","1","1","0","24","14","10","-2"
"142115","Boise State University","2019","On-tenure track, associate professors","29","17","12","0","0","0","2","1","1","0","0","0","2","1","1","0","0","0","25","15","10","0","0","0","0","0","0","0","0","0","-2"
"142115","Boise State University","2019","On-tenure track, assistant professors","145","77","68","0","0","0","8","3","5","0","0","0","3","0","3","0","0","0","108","58","50","1","1","0","1","1","0","24","14","10","-2"
"142115","Boise State University","2019","Not on tenure track/No tenure system system total","260","105","155","0","0","0","10","4","6","0","0","0","10","2","8","1","1","0","231","94","137","2","0","2","1","0","1","5","4","1","-2"
"142115","Boise State University","2019","Not on tenure/no tenure system, professors","1","1","0","0","0","0","0","0","0","0","0","0","0","0","0","0","0","0","1","1","0","0","0","0","0","0","0","0","0","0","-2"
"142115","Boise State University","2019","Not on tenure/no tenure system, associate professors","20","7","13","0","0","0","0","0","0","0","0","0","1","0","1","1","1","0","18","6","12","0","0","0","0","0","0","0","0","0","-2"
"142115","Boise State University","2019","Not on tenure/no tenure system, assistant professors","55","17","38","0","0","0","2","1","1","0","0","0","2","0","2","0","0","0","51","16","35","0","0","0","0","0","0","0","0","0","-2"
"142115","Boise State University","2019","Not on tenure/no tenure system, instructors","13","9","4","0","0","0","0","0","0","0","0","0","1","0","1","0","0","0","11","9","2","1","0","1","0","0","0","0","0","0","-2"
"142115","Boise State University","2019","Not on tenure/no tenure system, lecturers","148","64","84","0","0","0","8","3","5","0","0","0","5","2","3","0","0","0","130","56","74","1","0","1","1","0","1","3","3","0","-2"
"142115","Boise State University","2019","Not on tenure/no tenure system, no academic rank","23","7","16","0","0","0","0","0","0","0","0","0","1","0","1","0","0","0","20","6","14","0","0","0","0","0","0","2","1","1","-2"
"142294","The College of Idaho","2019","Tenured total","42","25","17","0","0","0","2","0","2","0","0","0","0","0","0","0","0","0","38","25","13","1","0","1","0","0","0","1","0","1","-2"
"142294","The College of Idaho","2019","Tenured, professors","24","16","8","0","0","0","2","0","2","0","0","0","0","0","0","0","0","0","21","16","5","0","0","0","0","0","0","1","0","1","-2"
"142294","The College of Idaho","2019","Tenured, associate professors","18","9","9","0","0","0","0","0","0","0","0","0","0","0","0","0","0","0","17","9","8","1","0","1","0","0","0","0","0","0","-2"
"142294","The College of Idaho","2019","On-Tenure track total","12","5","7","0","0","0","1","1","0","0","0","0","0","0","0","0","0","0","11","4","7","0","0","0","0","0","0","0","0","0","-2"
"142294","The College of Idaho","2019","On-tenure track, assistant professors","12","5","7","0","0","0","1","1","0","0","0","0","0","0","0","0","0","0","11","4","7","0","0","0","0","0","0","0","0","0","-2"
"142294","The College of Idaho","2019","Not on tenure track/No tenure system system total","18","11","7","0","0","0","0","0","0","0","0","0","0","0","0","0","0","0","18","11","7","0","0","0","0","0","0","0","0","0","-2"
"142294","The College of Idaho","2019","Not on tenure/no tenure system, assistant professors","3","1","2","0","0","0","0","0","0","0","0","0","0","0","0","0","0","0","3","1","2","0","0","0","0","0","0","0","0","0","-2"
"142294","The College of Idaho","2019","Not on tenure/no tenure system, instructors","13","8","5","0","0","0","0","0","0","0","0","0","0","0","0","0","0","0","13","8","5","0","0","0","0","0","0","0","0","0","-2"
"142294","The College of Idaho","2019","Not on tenure/no tenure system, no academic rank","2","2","0","0","0","0","0","0","0","0","0","0","0","0","0","0","0","0","2","2","0","0","0","0","0","0","0","0","0","0","-2"
"144050","University of Chicago","2019","Tenured total","862","631","231","1","1","0","120","96","24","25","14","11","26","21","5","0","0","0","656","472","184","8","7","1","21","16","5","5","4","1","-2"
"144050","University of Chicago","2019","Tenured, professors","655","501","154","0","0","0","90","77","13","13","7","6","20","17","3","0","0","0","510","380","130","5","5","0","14","13","1","3","2","1","-2"
"144050","University of Chicago","2019","Tenured, associate professors","207","130","77","1","1","0","30","19","11","12","7","5","6","4","2","0","0","0","146","92","54","3","2","1","7","3","4","2","2","0","-2"
"144050","University of Chicago","2019","On-Tenure track total","297","192","105","0","0","0","34","24","10","12","4","8","19","13","6","0","0","0","141","92","49","5","0","5","30","22","8","56","37","19","-2"
"144050","University of Chicago","2019","On-tenure track, professors","3","3","0","0","0","0","0","0","0","0","0","0","0","0","0","0","0","0","2","2","0","0","0","0","0","0","0","1","1","0","-2"
"144050","University of Chicago","2019","On-tenure track, associate professors","29","21","8","0","0","0","4","3","1","1","1","0","0","0","0","0","0","0","20","14","6","1","0","1","2","2","0","1","1","0","-2"
"144050","University of Chicago","2019","On-tenure track, assistant professors","265","168","97","0","0","0","30","21","9","11","3","8","19","13","6","0","0","0","119","76","43","4","0","4","28","20","8","54","35","19","-2"
"144050","University of Chicago","2019","Not on tenure track/No tenure system system total","1212","650","562","1","0","1","232","131","101","56","19","37","47","20","27","1","1","0","673","376","297","13","4","9","91","43","48","98","56","42","-2"
"144050","University of Chicago","2019","Not on tenure/no tenure system, professors","211","154","57","0","0","0","39","26","13","5","3","2","2","0","2","0","0","0","155","117","38","1","1","0","3","3","0","6","4","2","-2"
"144050","University of Chicago","2019","Not on tenure/no tenure system, associate professors","219","122","97","0","0","0","57","38","19","13","4","9","5","2","3","0","0","0","133","70","63","1","0","1","9","7","2","1","1","0","-2"
"144050","University of Chicago","2019","Not on tenure/no tenure system, assistant professors","357","169","188","0","0","0","80","41","39","22","9","13","16","8","8","0","0","0","168","77","91","6","3","3","39","15","24","26","16","10","-2"
"144050","University of Chicago","2019","Not on tenure/no tenure system, instructors","104","49","55","0","0","0","6","3","3","7","1","6","10","3","7","0","0","0","32","19","13","3","0","3","12","3","9","34","20","14","-2"
"144050","University of Chicago","2019","Not on tenure/no tenure system, lecturers","229","105","124","1","0","1","23","9","14","4","1","3","4","1","3","0","0","0","148","72","76","2","0","2","19","10","9","28","12","16","-2"
"144050","University of Chicago","2019","Not on tenure/no tenure system, no academic rank","92","51","41","0","0","0","27","14","13","5","1","4","10","6","4","1","1","0","37","21","16","0","0","0","9","5","4","3","3","0","-2"
"144865","College of DuPage","2019","Tenured total","271","132","139","2","1","1","26","9","17","11","6","5","9","5","4","0","0","0","218","108","110","0","0","0","5","3","2","0","0","0","-2"
"144865","College of DuPage","2019","Tenured, professors","112","63","49","1","1","0","15","6","9","3","2","1","3","2","1","0","0","0","88","51","37","0","0","0","2","1","1","0","0","0","-2"
"144865","College of DuPage","2019","Tenured, associate professors","68","37","31","0","0","0","5","3","2","3","3","0","4","2","2","0","0","0","56","29","27","0","0","0","0","0","0","0","0","0","-2"
"144865","College of DuPage","2019","Tenured, assistant professors","71","27","44","1","0","1","4","0","4","5","1","4","2","1","1","0","0","0","56","23","33","0","0","0","3","2","1","0","0","0","-2"
"144865","College of DuPage","2019","Tenured, instructors","20","5","15","0","0","0","2","0","2","0","0","0","0","0","0","0","0","0","18","5","13","0","0","0","0","0","0","0","0","0","-2"
"144865","College of DuPage","2019","Not on tenure track/No tenure system system total","5","3","2","0","0","0","0","0","0","0","0","0","1","1","0","0","0","0","4","2","2","0","0","0","0","0","0","0","0","0","-2"
"144865","College of DuPage","2019","Not on tenure/no tenure system, assistant professors","3","2","1","0","0","0","0","0","0","0","0","0","1","1","0","0","0","0","2","1","1","0","0","0","0","0","0","0","0","0","-2"
"144865","College of DuPage","2019","Not on tenure/no tenure system, instructors","2","1","1","0","0","0","0","0","0","0","0","0","0","0","0","0","0","0","2","1","1","0","0","0","0","0","0","0","0","0","-2"
"145637","University of Illinois at Urbana-Champaign","2019","Tenured total","1266","863","403","3","0","3","224","162","62","57","30","27","77","48","29","0","0","0","873","600","273","12","8","4","16","12","4","4","3","1","-2"
"145637","University of Illinois at Urbana-Champaign","2019","Tenured, professors","819","602","217","2","0","2","130","106","24","29","19","10","44","28","16","0","0","0","597","435","162","5","3","2","10","9","1","2","2","0","-2"
"145637","University of Illinois at Urbana-Champaign","2019","Tenured, associate professors","446","261","185","1","0","1","94","56","38","28","11","17","33","20","13","0","0","0","275","165","110","7","5","2","6","3","3","2","1","1","-2"
"145637","University of Illinois at Urbana-Champaign","2019","Tenured, assistant professors","1","0","1","0","0","0","0","0","0","0","0","0","0","0","0","0","0","0","1","0","1","0","0","0","0","0","0","0","0","0","-2"
"145637","University of Illinois at Urbana-Champaign","2019","On-Tenure track total","511","287","224","2","1","1","78","38","40","22","8","14","36","21","15","0","0","0","249","139","110","12","7","5","14","10","4","98","63","35","-2"
"145637","University of Illinois at Urbana-Champaign","2019","On-tenure track, professors","1","1","0","0","0","0","0","0","0","1","1","0","0","0","0","0","0","0","0","0","0","0","0","0","0","0","0","0","0","0","-2"
"145637","University of Illinois at Urbana-Champaign","2019","On-tenure track, associate professors","5","3","2","0","0","0","1","0","1","0","0","0","0","0","0","0","0","0","4","3","1","0","0","0","0","0","0","0","0","0","-2"
"145637","University of Illinois at Urbana-Champaign","2019","On-tenure track, assistant professors","505","283","222","2","1","1","77","38","39","21","7","14","36","21","15","0","0","0","245","136","109","12","7","5","14","10","4","98","63","35","-2"
"145637","University of Illinois at Urbana-Champaign","2019","Not on tenure track/No tenure system system total","584","286","298","0","0","0","53","29","24","22","10","12","29","15","14","0","0","0","437","208","229","6","4","2","6","4","2","31","16","15","-2"
"145637","University of Illinois at Urbana-Champaign","2019","Not on tenure/no tenure system, professors","27","12","15","0","0","0","1","1","0","1","0","1","1","1","0","0","0","0","24","10","14","0","0","0","0","0","0","0","0","0","-2"
"145637","University of Illinois at Urbana-Champaign","2019","Not on tenure/no tenure system, associate professors","64","35","29","0","0","0","4","2","2","4","2","2","2","2","0","0","0","0","52","28","24","1","1","0","0","0","0","1","0","1","-2"
"145637","University of Illinois at Urbana-Champaign","2019","Not on tenure/no tenure system, assistant professors","186","84","102","0","0","0","26","13","13","10","6","4","11","4","7","0","0","0","120","49","71","3","2","1","3","1","2","13","9","4","-2"
"145637","University of Illinois at Urbana-Champaign","2019","Not on tenure/no tenure system, instructors","97","46","51","0","0","0","7","5","2","3","2","1","5","3","2","0","0","0","77","33","44","0","0","0","1","1","0","4","2","2","-2"
"145637","University of Illinois at Urbana-Champaign","2019","Not on tenure/no tenure system, lecturers","179","91","88","0","0","0","14","8","6","4","0","4","9","4","5","0","0","0","135","71","64","2","1","1","2","2","0","13","5","8","-2"
"145637","University of Illinois at Urbana-Champaign","2019","Not on tenure/no tenure system, no academic rank","31","18","13","0","0","0","1","0","1","0","0","0","1","1","0","0","0","0","29","17","12","0","0","0","0","0","0","0","0","0","-2"
"147703","Northern Illinois University","2019","Tenured total","446","253","193","0","0","0","44","28","16","14","8","6","10","3","7","0","0","0","303","177","126","3","2","1","2","1","1","70","34","36","-2"
"147703","Northern Illinois University","2019","Tenured, professors","213","143","70","0","0","0","25","17","8","6","4","2","4","1","3","0","0","0","147","104","43","2","1","1","1","1","0","28","15","13","-2"
"147703","Northern Illinois University","2019","Tenured, associate professors","231","109","122","0","0","0","19","11","8","7","4","3","6","2","4","0","0","0","155","72","83","1","1","0","1","0","1","42","19","23","-2"
"147703","Northern Illinois University","2019","Tenured, assistant professors","2","1","1","0","0","0","0","0","0","1","0","1","0","0","0","0","0","0","1","1","0","0","0","0","0","0","0","0","0","0","-2"
"147703","Northern Illinois University","2019","On-Tenure track total","137","65","72","0","0","0","12","5","7","4","1","3","9","2","7","0","0","0","83","38","45","0","0","0","0","0","0","29","19","10","-2"
"147703","Northern Illinois University","2019","On-tenure track, associate professors","5","3","2","0","0","0","0","0","0","0","0","0","0","0","0","0","0","0","5","3","2","0","0","0","0","0","0","0","0","0","-2"
"147703","Northern Illinois University","2019","On-tenure track, assistant professors","132","62","70","0","0","0","12","5","7","4","1","3","9","2","7","0","0","0","78","35","43","0","0","0","0","0","0","29","19","10","-2"
"147703","Northern Illinois University","2019","Not on tenure track/No tenure system system total","217","77","140","0","0","0","8","3","5","5","2","3","6","4","2","0","0","0","185","64","121","1","1","0","1","0","1","11","3","8","-2"
"147703","Northern Illinois University","2019","Not on tenure/no tenure system, professors","4","3","1","0","0","0","0","0","0","0","0","0","1","1","0","0","0","0","3","2","1","0","0","0","0","0","0","0","0","0","-2"
"147703","Northern Illinois University","2019","Not on tenure/no tenure system, associate professors","4","3","1","0","0","0","0","0","0","0","0","0","0","0","0","0","0","0","3","2","1","0","0","0","0","0","0","1","1","0","-2"
"147703","Northern Illinois University","2019","Not on tenure/no tenure system, assistant professors","26","6","20","0","0","0","0","0","0","1","0","1","1","1","0","0","0","0","21","5","16","0","0","0","0","0","0","3","0","3","-2"
"147703","Northern Illinois University","2019","Not on tenure/no tenure system, instructors","175","64","111","0","0","0","8","3","5","3","2","1","4","2","2","0","0","0","151","54","97","1","1","0","1","0","1","7","2","5","-2"
"147703","Northern Illinois University","2019","Not on tenure/no tenure system, no academic rank","8","1","7","0","0","0","0","0","0","1","0","1","0","0","0","0","0","0","7","1","6","0","0","0","0","0","0","0","0","0","-2"
"147767","Northwestern University","2019","Tenured total","1061","763","298","1","0","1","137","105","32","43","26","17","52","33","19","0","0","0","797","577","220","9","5","4","16","14","2","6","3","3","-2"
"147767","Northwestern University","2019","Tenured, professors","750","568","182","1","0","1","93","76","17","21","12","9","32","22","10","0","0","0","588","446","142","3","2","1","10","9","1","2","1","1","-2"
"147767","Northwestern University","2019","Tenured, associate professors","311","195","116","0","0","0","44","29","15","22","14","8","20","11","9","0","0","0","209","131","78","6","3","3","6","5","1","4","2","2","-2"
"147767","Northwestern University","2019","On-Tenure track total","306","166","140","1","1","0","41","27","14","20","6","14","21","11","10","1","1","0","157","81","76","8","1","7","10","6","4","47","32","15","-2"
"147767","Northwestern University","2019","On-tenure track, associate professors","45","30","15","0","0","0","6","5","1","3","0","3","5","3","2","0","0","0","25","18","7","0","0","0","2","2","0","4","2","2","-2"
"147767","Northwestern University","2019","On-tenure track, assistant professors","261","136","125","1","1","0","35","22","13","17","6","11","16","8","8","1","1","0","132","63","69","8","1","7","8","4","4","43","30","13","-2"
"147767","Northwestern University","2019","Not on tenure track/No tenure system system total","929","437","492","0","0","0","122","52","70","41","18","23","33","11","22","0","0","0","669","324","345","8","1","7","21","12","9","35","19","16","-2"
"147767","Northwestern University","2019","Not on tenure/no tenure system, professors","230","138","92","0","0","0","33","19","14","6","4","2","7","2","5","0","0","0","180","109","71","0","0","0","1","1","0","3","3","0","-2"
"147767","Northwestern University","2019","Not on tenure/no tenure system, associate professors","240","104","136","0","0","0","39","12","27","10","4","6","11","4","7","0","0","0","170","78","92","1","0","1","7","4","3","2","2","0","-2"
"147767","Northwestern University","2019","Not on tenure/no tenure system, assistant professors","271","110","161","0","0","0","47","19","28","15","3","12","12","4","8","0","0","0","178","73","105","2","1","1","8","6","2","9","4","5","-2"
"147767","Northwestern University","2019","Not on tenure/no tenure system, instructors","16","8","8","0","0","0","0","0","0","2","2","0","0","0","0","0","0","0","11","5","6","1","0","1","0","0","0","2","1","1","-2"
"147767","Northwestern University","2019","Not on tenure/no tenure system, lecturers","172","77","95","0","0","0","3","2","1","8","5","3","3","1","2","0","0","0","130","59","71","4","0","4","5","1","4","19","9","10","-2"
"149772","Western Illinois University","2019","Tenured total","307","193","114","1","0","1","45","30","15","13","10","3","7","4","3","1","1","0","235","145","90","4","3","1","0","0","0","1","0","1","-2"
"149772","Western Illinois University","2019","Tenured, professors","192","129","63","1","0","1","24","20","4","9","7","2","3","2","1","0","0","0","151","98","53","3","2","1","0","0","0","1","0","1","-2"
"149772","Western Illinois University","2019","Tenured, associate professors","115","64","51","0","0","0","21","10","11","4","3","1","4","2","2","1","1","0","84","47","37","1","1","0","0","0","0","0","0","0","-2"
"149772","Western Illinois University","2019","On-Tenure track total","77","40","37","0","0","0","7","6","1","3","1","2","3","3","0","0","0","0","48","23","25","0","0","0","3","2","1","13","5","8","-2"
"149772","Western Illinois University","2019","On-tenure track, associate professors","3","3","0","0","0","0","2","2","0","0","0","0","0","0","0","0","0","0","1","1","0","0","0","0","0","0","0","0","0","0","-2"
"149772","Western Illinois University","2019","On-tenure track, assistant professors","74","37","37","0","0","0","5","4","1","3","1","2","3","3","0","0","0","0","47","22","25","0","0","0","3","2","1","13","5","8","-2"
"149772","Western Illinois University","2019","Not on tenure track/No tenure system system total","86","26","60","0","0","0","4","1","3","2","2","0","1","0","1","0","0","0","78","22","56","0","0","0","1","1","0","0","0","0","-2"
"149772","Western Illinois University","2019","Not on tenure/no tenure system, associate professors","1","0","1","0","0","0","0","0","0","0","0","0","0","0","0","0","0","0","1","0","1","0","0","0","0","0","0","0","0","0","-2"
"149772","Western Illinois University","2019","Not on tenure/no tenure system, instructors","85","26","59","0","0","0","4","1","3","2","2","0","1","0","1","0","0","0","77","22","55","0","0","0","1","1","0","0","0","0","-2"
"150136","Ball State University","2019","Tenured total","392","222","170","0","0","0","47","26","21","11","5","6","8","6","2","0","0","0","319","180","139","5","4","1","1","1","0","1","0","1","-2"
"150136","Ball State University","2019","Tenured, professors","180","112","68","0","0","0","25","15","10","4","2","2","4","4","0","0","0","0","143","88","55","4","3","1","0","0","0","0","0","0","-2"
"150136","Ball State University","2019","Tenured, associate professors","195","101","94","0","0","0","21","11","10","7","3","4","4","2","2","0","0","0","160","83","77","1","1","0","1","1","0","1","0","1","-2"
"150136","Ball State University","2019","Tenured, assistant professors","17","9","8","0","0","0","1","0","1","0","0","0","0","0","0","0","0","0","16","9","7","0","0","0","0","0","0","0","0","0","-2"
"150136","Ball State University","2019","On-Tenure track total","228","118","110","1","0","1","22","10","12","10","3","7","8","2","6","0","0","0","164","92","72","0","0","0","0","0","0","23","11","12","-2"
"150136","Ball State University","2019","On-tenure track, associate professors","16","7","9","0","0","0","1","0","1","0","0","0","0","0","0","0","0","0","15","7","8","0","0","0","0","0","0","0","0","0","-2"
"150136","Ball State University","2019","On-tenure track, assistant professors","211","111","100","1","0","1","21","10","11","10","3","7","8","2","6","0","0","0","148","85","63","0","0","0","0","0","0","23","11","12","-2"
"150136","Ball State University","2019","On-tenure track, no academic rank","1","0","1","0","0","0","0","0","0","0","0","0","0","0","0","0","0","0","1","0","1","0","0","0","0","0","0","0","0","0","-2"
"150136","Ball State University","2019","Not on tenure track/No tenure system system total","440","172","268","1","0","1","19","6","13","15","4","11","15","5","10","0","0","0","386","155","231","2","1","1","0","0","0","2","1","1","-2"
"150136","Ball State University","2019","Not on tenure/no tenure system, professors","1","1","0","0","0","0","0","0","0","0","0","0","0","0","0","0","0","0","1","1","0","0","0","0","0","0","0","0","0","0","-2"
"150136","Ball State University","2019","Not on tenure/no tenure system, assistant professors","24","14","10","0","0","0","1","0","1","0","0","0","3","2","1","0","0","0","20","12","8","0","0","0","0","0","0","0","0","0","-2"
"150136","Ball State University","2019","Not on tenure/no tenure system, instructors","73","24","49","0","0","0","5","2","3","1","1","0","3","0","3","0","0","0","63","21","42","0","0","0","0","0","0","1","0","1","-2"
"150136","Ball State University","2019","Not on tenure/no tenure system, lecturers","178","59","119","0","0","0","3","1","2","6","2","4","3","1","2","0","0","0","164","54","110","1","0","1","0","0","0","1","1","0","-2"
"150136","Ball State University","2019","Not on tenure/no tenure system, no academic rank","164","74","90","1","0","1","10","3","7","8","1","7","6","2","4","0","0","0","138","67","71","1","1","0","0","0","0","0","0","0","-2"
"151351","Indiana University-Bloomington","2019","Tenured total","1022","684","338","1","1","0","103","61","42","42","27","15","44","27","17","1","1","0","817","555","262","11","9","2","2","2","0","1","1","0","-2"
"151351","Indiana University-Bloomington","2019","Tenured, professors","639","460","179","1","1","0","56","35","21","17","10","7","20","14","6","0","0","0","536","391","145","7","7","0","1","1","0","1","1","0","-2"
"151351","Indiana University-Bloomington","2019","Tenured, associate professors","383","224","159","0","0","0","47","26","21","25","17","8","24","13","11","1","1","0","281","164","117","4","2","2","1","1","0","0","0","0","-2"
"151351","Indiana University-Bloomington","2019","On-Tenure track total","396","237","159","0","0","0","67","41","26","19","10","9","36","27","9","0","0","0","229","135","94","2","1","1","1","1","0","42","22","20","-2"
"151351","Indiana University-Bloomington","2019","On-tenure track, professors","2","1","1","0","0","0","0","0","0","0","0","0","0","0","0","0","0","0","1","1","0","0","0","0","0","0","0","1","0","1","-2"
"151351","Indiana University-Bloomington","2019","On-tenure track, associate professors","94","55","39","0","0","0","11","7","4","7","2","5","7","6","1","0","0","0","65","37","28","0","0","0","1","1","0","3","2","1","-2"
"151351","Indiana University-Bloomington","2019","On-tenure track, assistant professors","300","181","119","0","0","0","56","34","22","12","8","4","29","21","8","0","0","0","163","97","66","2","1","1","0","0","0","38","20","18","-2"
"151351","Indiana University-Bloomington","2019","Not on tenure track/No tenure system system total","724","356","368","1","1","0","37","11","26","33","18","15","36","21","15","0","0","0","563","279","284","2","2","0","2","2","0","50","22","28","-2"
"151351","Indiana University-Bloomington","2019","Not on tenure/no tenure system, professors","73","45","28","0","0","0","4","1","3","8","6","2","3","3","0","0","0","0","53","32","21","0","0","0","0","0","0","5","3","2","-2"
"151351","Indiana University-Bloomington","2019","Not on tenure/no tenure system, associate professors","61","28","33","0","0","0","1","0","1","3","2","1","0","0","0","0","0","0","55","24","31","1","1","0","0","0","0","1","1","0","-2"
"151351","Indiana University-Bloomington","2019","Not on tenure/no tenure system, assistant professors","124","61","63","0","0","0","6","3","3","5","1","4","7","3","4","0","0","0","82","40","42","0","0","0","0","0","0","24","14","10","-2"
"151351","Indiana University-Bloomington","2019","Not on tenure/no tenure system, lecturers","466","222","244","1","1","0","26","7","19","17","9","8","26","15","11","0","0","0","373","183","190","1","1","0","2","2","0","20","4","16","-2"
"152600","Valparaiso University","2019","Tenured total","143","80","63","0","0","0","15","10","5","0","0","0","3","1","2","0","0","0","112","60","52","0","0","0","12","8","4","1","1","0","-2"
"152600","Valparaiso University","2019","Tenured, professors","60","43","17","0","0","0","5","4","1","0","0","0","1","1","0","0","0","0","53","38","15","0","0","0","1","0","1","0","0","0","-2"
"152600","Valparaiso University","2019","Tenured, associate professors","82","36","46","0","0","0","10","6","4","0","0","0","2","0","2","0","0","0","58","21","37","0","0","0","11","8","3","1","1","0","-2"
"152600","Valparaiso University","2019","Tenured, assistant professors","1","1","0","0","0","0","0","0","0","0","0","0","0","0","0","0","0","0","1","1","0","0","0","0","0","0","0","0","0","0","-2"
"152600","Valparaiso University","2019","On-Tenure track total","83","46","37","0","0","0","13","6","7","1","1","0","3","2","1","0","0","0","32","19","13","0","0","0","33","18","15","1","0","1","-2"
"152600","Valparaiso University","2019","On-tenure track, associate professors","11","8","3","0","0","0","3","1","2","1","1","0","0","0","0","0","0","0","2","2","0","0","0","0","5","4","1","0","0","0","-2"
"152600","Valparaiso University","2019","On-tenure track, assistant professors","68","37","31","0","0","0","9","5","4","0","0","0","3","2","1","0","0","0","30","17","13","0","0","0","25","13","12","1","0","1","-2"
"152600","Valparaiso University","2019","On-tenure track, instructors","4","1","3","0","0","0","1","0","1","0","0","0","0","0","0","0","0","0","0","0","0","0","0","0","3","1","2","0","0","0","-2"
"152600","Valparaiso University","2019","Not on tenure track/No tenure system system total","67","34","33","0","0","0","4","2","2","3","3","0","4","3","1","0","0","0","37","18","19","0","0","0","19","8","11","0","0","0","-2"
"152600","Valparaiso University","2019","Not on tenure/no tenure system, professors","4","4","0","0","0","0","0","0","0","0","0","0","1","1","0","0","0","0","3","3","0","0","0","0","0","0","0","0","0","0","-2"
"152600","Valparaiso University","2019","Not on tenure/no tenure system, associate professors","1","1","0","0","0","0","0","0","0","1","1","0","0","0","0","0","0","0","0","0","0","0","0","0","0","0","0","0","0","0","-2"
"152600","Valparaiso University","2019","Not on tenure/no tenure system, assistant professors","9","4","5","0","0","0","2","1","1","0","0","0","0","0","0","0","0","0","5","2","3","0","0","0","2","1","1","0","0","0","-2"
"152600","Valparaiso University","2019","Not on tenure/no tenure system, instructors","3","3","0","0","0","0","0","0","0","1","1","0","1","1","0","0","0","0","0","0","0","0","0","0","1","1","0","0","0","0","-2"
"152600","Valparaiso University","2019","Not on tenure/no tenure system, lecturers","50","22","28","0","0","0","2","1","1","1","1","0","2","1","1","0","0","0","29","13","16","0","0","0","16","6","10","0","0","0","-2"
"153603","Iowa State University","2019","Tenured total","881","624","257","2","2","0","173","140","33","22","13","9","24","15","9","1","1","0","644","444","200","2","0","2","5","3","2","8","6","2","-2"
"153603","Iowa State University","2019","Tenured, professors","507","396","111","1","1","0","90","80","10","9","6","3","16","12","4","0","0","0","385","294","91","1","0","1","4","2","2","1","1","0","-2"
"153603","Iowa State University","2019","Tenured, associate professors","373","228","145","1","1","0","83","60","23","13","7","6","8","3","5","1","1","0","258","150","108","1","0","1","1","1","0","7","5","2","-2"
"153603","Iowa State University","2019","Tenured, assistant professors","1","0","1","0","0","0","0","0","0","0","0","0","0","0","0","0","0","0","1","0","1","0","0","0","0","0","0","0","0","0","-2"
"153603","Iowa State University","2019","On-Tenure track total","343","199","144","1","0","1","61","33","28","5","3","2","14","10","4","0","0","0","200","113","87","6","4","2","0","0","0","56","36","20","-2"
"153603","Iowa State University","2019","On-tenure track, associate professors","10","9","1","0","0","0","2","2","0","0","0","0","1","1","0","0","0","0","7","6","1","0","0","0","0","0","0","0","0","0","-2"
"153603","Iowa State University","2019","On-tenure track, assistant professors","332","190","142","1","0","1","59","31","28","5","3","2","13","9","4","0","0","0","192","107","85","6","4","2","0","0","0","56","36","20","-2"
"153603","Iowa State University","2019","On-tenure track, lecturers","1","0","1","0","0","0","0","0","0","0","0","0","0","0","0","0","0","0","1","0","1","0","0","0","0","0","0","0","0","0","-2"
"153603","Iowa State University","2019","Not on tenure track/No tenure system system total","314","143","171","0","0","0","23","10","13","14","8","6","11","6","5","0","0","0","237","102","135","4","1","3","0","0","0","25","16","9","-2"
"153603","Iowa State University","2019","Not on tenure/no tenure system, professors","29","19","10","0","0","0","4","2","2","1","1","0","0","0","0","0","0","0","23","16","7","1","0","1","0","0","0","0","0","0","-2"
"153603","Iowa State University","2019","Not on tenure/no tenure system, associate professors","108","40","68","0","0","0","4","3","1","5","2","3","4","1","3","0","0","0","93","34","59","0","0","0","0","0","0","2","0","2","-2"
"153603","Iowa State University","2019","Not on tenure/no tenure system, assistant professors","155","72","83","0","0","0","13","5","8","8","5","3","7","5","2","0","0","0","108","46","62","3","1","2","0","0","0","16","10","6","-2"
"153603","Iowa State University","2019","Not on tenure/no tenure system, lecturers","22","12","10","0","0","0","2","0","2","0","0","0","0","0","0","0","0","0","13","6","7","0","0","0","0","0","0","7","6","1","-2"
"153658","University of Iowa","2019","Tenured total","999","695","304","2","1","1","129","100","29","20","12","8","42","27","15","0","0","0","780","537","243","5","1","4","16","12","4","5","5","0","-2"
"153658","University of Iowa","2019","Tenured, professors","594","449","145","1","1","0","73","62","11","8","6","2","25","16","9","0","0","0","474","355","119","3","1","2","9","7","2","1","1","0","-2"
"153658","University of Iowa","2019","Tenured, associate professors","405","246","159","1","0","1","56","38","18","12","6","6","17","11","6","0","0","0","306","182","124","2","0","2","7","5","2","4","4","0","-2"
"153658","University of Iowa","2019","On-Tenure track total","327","181","146","0","0","0","48","28","20","8","1","7","16","10","6","0","0","0","204","108","96","7","6","1","6","5","1","38","23","15","-2"
"153658","University of Iowa","2019","On-tenure track, professors","2","1","1","0","0","0","0","0","0","0","0","0","0","0","0","0","0","0","2","1","1","0","0","0","0","0","0","0","0","0","-2"
"153658","University of Iowa","2019","On-tenure track, associate professors","23","17","6","0","0","0","6","4","2","1","1","0","1","0","1","0","0","0","14","11","3","0","0","0","0","0","0","1","1","0","-2"
"153658","University of Iowa","2019","On-tenure track, assistant professors","302","163","139","0","0","0","42","24","18","7","0","7","15","10","5","0","0","0","188","96","92","7","6","1","6","5","1","37","22","15","-2"
"153658","University of Iowa","2019","Not on tenure track/No tenure system system total","1160","585","575","5","1","4","111","56","55","29","12","17","54","28","26","1","0","1","792","385","407","6","2","4","50","25","25","112","76","36","-2"
"153658","University of Iowa","2019","Not on tenure/no tenure system, professors","165","111","54","1","1","0","11","8","3","3","2","1","4","3","1","0","0","0","138","94","44","2","0","2","4","1","3","2","2","0","-2"
"153658","University of Iowa","2019","Not on tenure/no tenure system, associate professors","285","147","138","1","0","1","35","22","13","4","3","1","15","7","8","1","0","1","202","94","108","1","1","0","17","12","5","9","8","1","-2"
"153658","University of Iowa","2019","Not on tenure/no tenure system, assistant professors","429","206","223","0","0","0","47","22","25","15","4","11","25","15","10","0","0","0","260","111","149","1","1","0","20","10","10","61","43","18","-2"
"153658","University of Iowa","2019","Not on tenure/no tenure system, instructors","2","1","1","0","0","0","0","0","0","0","0","0","0","0","0","0","0","0","2","1","1","0","0","0","0","0","0","0","0","0","-2"
"153658","University of Iowa","2019","Not on tenure/no tenure system, lecturers","195","75","120","2","0","2","6","1","5","5","2","3","9","2","7","0","0","0","150","63","87","1","0","1","8","1","7","14","6","8","-2"
"153658","University of Iowa","2019","Not on tenure/no tenure system, no academic rank","84","45","39","1","0","1","12","3","9","2","1","1","1","1","0","0","0","0","40","22","18","1","0","1","1","1","0","26","17","9","-2"
"155317","University of Kansas","2019","Tenured total","922","627","295","6","5","1","134","93","41","26","14","12","37","23","14","0","0","0","701","483","218","13","5","8","5","4","1","0","0","0","-2"
"155317","University of Kansas","2019","Tenured, professors","539","405","134","4","3","1","70","59","11","11","7","4","18","11","7","0","0","0","429","321","108","4","1","3","3","3","0","0","0","0","-2"
"155317","University of Kansas","2019","Tenured, associate professors","383","222","161","2","2","0","64","34","30","15","7","8","19","12","7","0","0","0","272","162","110","9","4","5","2","1","1","0","0","0","-2"
"155317","University of Kansas","2019","On-Tenure track total","258","156","102","0","0","0","34","19","15","16","5","11","9","9","0","1","0","1","164","100","64","6","3","3","1","0","1","27","20","7","-2"
"155317","University of Kansas","2019","On-tenure track, professors","1","0","1","0","0","0","0","0","0","1","0","1","0","0","0","0","0","0","0","0","0","0","0","0","0","0","0","0","0","0","-2"
"155317","University of Kansas","2019","On-tenure track, associate professors","8","4","4","0","0","0","1","1","0","1","1","0","0","0","0","1","0","1","5","2","3","0","0","0","0","0","0","0","0","0","-2"
"155317","University of Kansas","2019","On-tenure track, assistant professors","249","152","97","0","0","0","33","18","15","14","4","10","9","9","0","0","0","0","159","98","61","6","3","3","1","0","1","27","20","7","-2"
"155317","University of Kansas","2019","Not on tenure track/No tenure system system total","1212","619","593","5","4","1","143","74","69","36","18","18","36","16","20","0","0","0","887","447","440","27","11","16","6","3","3","72","46","26","-2"
"155317","University of Kansas","2019","Not on tenure/no tenure system, professors","75","46","29","0","0","0","10","7","3","3","2","1","3","1","2","0","0","0","59","36","23","0","0","0","0","0","0","0","0","0","-2"
"155317","University of Kansas","2019","Not on tenure/no tenure system, associate professors","257","140","117","1","1","0","34","20","14","6","4","2","6","3","3","0","0","0","198","104","94","4","2","2","1","1","0","7","5","2","-2"
"155317","University of Kansas","2019","Not on tenure/no tenure system, assistant professors","659","341","318","2","1","1","88","45","43","19","7","12","18","10","8","0","0","0","463","239","224","14","5","9","5","2","3","50","32","18","-2"
"155317","University of Kansas","2019","Not on tenure/no tenure system, instructors","63","28","35","2","2","0","3","1","2","4","2","2","1","0","1","0","0","0","46","17","29","1","1","0","0","0","0","6","5","1","-2"
"155317","University of Kansas","2019","Not on tenure/no tenure system, lecturers","158","64","94","0","0","0","8","1","7","4","3","1","8","2","6","0","0","0","121","51","70","8","3","5","0","0","0","9","4","5","-2"
"157447","Northern Kentucky University","2019","Tenured total","264","142","122","1","1","0","19","8","11","14","12","2","7","6","1","0","0","0","218","112","106","3","1","2","0","0","0","2","2","0","-2"
"157447","Northern Kentucky University","2019","Tenured, professors","123","77","46","0","0","0","12","5","7","5","4","1","3","3","0","0","0","0","100","63","37","1","0","1","0","0","0","2","2","0","-2"
"157447","Northern Kentucky University","2019","Tenured, associate professors","141","65","76","1","1","0","7","3","4","9","8","1","4","3","1","0","0","0","118","49","69","2","1","1","0","0","0","0","0","0","-2"
"157447","Northern Kentucky University","2019","On-Tenure track total","91","33","58","0","0","0","5","3","2","10","5","5","1","0","1","0","0","0","59","18","41","2","1","1","0","0","0","14","6","8","-2"
"157447","Northern Kentucky University","2019","On-tenure track, assistant professors","91","33","58","0","0","0","5","3","2","10","5","5","1","0","1","0","0","0","59","18","41","2","1","1","0","0","0","14","6","8","-2"
"157447","Northern Kentucky University","2019","Not on tenure track/No tenure system system total","247","100","147","0","0","0","8","4","4","9","3","6","5","1","4","1","1","0","217","87","130","0","0","0","1","1","0","6","3","3","-2"
"157447","Northern Kentucky University","2019","Not on tenure/no tenure system, assistant professors","5","4","1","0","0","0","0","0","0","0","0","0","0","0","0","0","0","0","5","4","1","0","0","0","0","0","0","0","0","0","-2"
"157447","Northern Kentucky University","2019","Not on tenure/no tenure system, lecturers","242","96","146","0","0","0","8","4","4","9","3","6","5","1","4","1","1","0","212","83","129","0","0","0","1","1","0","6","3","3","-2"
"157951","Western Kentucky University","2019","Tenured total","405","222","183","5","4","1","37","19","18","20","7","13","6","3","3","0","0","0","329","184","145","7","5","2","0","0","0","1","0","1","-2"
"157951","Western Kentucky University","2019","Tenured, professors","193","121","72","3","3","0","16","13","3","10","4","6","1","0","1","0","0","0","159","99","60","3","2","1","0","0","0","1","0","1","-2"
"157951","Western Kentucky University","2019","Tenured, associate professors","205","98","107","2","1","1","21","6","15","9","2","7","5","3","2","0","0","0","164","83","81","4","3","1","0","0","0","0","0","0","-2"
"157951","Western Kentucky University","2019","Tenured, assistant professors","7","3","4","0","0","0","0","0","0","1","1","0","0","0","0","0","0","0","6","2","4","0","0","0","0","0","0","0","0","0","-2"
"157951","Western Kentucky University","2019","On-Tenure track total","126","55","71","1","0","1","12","4","8","7","3","4","3","3","0","0","0","0","102","45","57","0","0","0","1","0","1","0","0","0","-2"
"157951","Western Kentucky University","2019","On-tenure track, associate professors","4","0","4","0","0","0","0","0","0","0","0","0","0","0","0","0","0","0","4","0","4","0","0","0","0","0","0","0","0","0","-2"
"157951","Western Kentucky University","2019","On-tenure track, assistant professors","122","55","67","1","0","1","12","4","8","7","3","4","3","3","0","0","0","0","98","45","53","0","0","0","1","0","1","0","0","0","-2"
"157951","Western Kentucky University","2019","Not on tenure track/No tenure system system total","150","55","95","0","0","0","7","2","5","6","3","3","3","1","2","0","0","0","130","48","82","3","1","2","1","0","1","0","0","0","-2"
"157951","Western Kentucky University","2019","Not on tenure/no tenure system, associate professors","7","1","6","0","0","0","0","0","0","0","0","0","1","0","1","0","0","0","6","1","5","0","0","0","0","0","0","0","0","0","-2"
"157951","Western Kentucky University","2019","Not on tenure/no tenure system, assistant professors","5","4","1","0","0","0","0","0","0","0","0","0","0","0","0","0","0","0","4","3","1","1","1","0","0","0","0","0","0","0","-2"
"157951","Western Kentucky University","2019","Not on tenure/no tenure system, instructors","121","40","81","0","0","0","7","2","5","5","2","3","2","1","1","0","0","0","105","35","70","2","0","2","0","0","0","0","0","0","-2"
"157951","Western Kentucky University","2019","Not on tenure/no tenure system, lecturers","1","1","0","0","0","0","0","0","0","1","1","0","0","0","0","0","0","0","0","0","0","0","0","0","0","0","0","0","0","0","-2"
"157951","Western Kentucky University","2019","Not on tenure/no tenure system, no academic rank","16","9","7","0","0","0","0","0","0","0","0","0","0","0","0","0","0","0","15","9","6","0","0","0","1","0","1","0","0","0","-2"
"159993","University of Louisiana at Monroe","2019","Tenured total","144","72","72","0","0","0","7","6","1","6","2","4","4","1","3","0","0","0","125","62","63","2","1","1","0","0","0","0","0","0","-2"
"159993","University of Louisiana at Monroe","2019","Tenured, professors","59","38","21","0","0","0","5","5","0","1","0","1","1","0","1","0","0","0","50","32","18","2","1","1","0","0","0","0","0","0","-2"
"159993","University of Louisiana at Monroe","2019","Tenured, associate professors","71","33","38","0","0","0","2","1","1","4","2","2","2","1","1","0","0","0","63","29","34","0","0","0","0","0","0","0","0","0","-2"
"159993","University of Louisiana at Monroe","2019","Tenured, assistant professors","14","1","13","0","0","0","0","0","0","1","0","1","1","0","1","0","0","0","12","1","11","0","0","0","0","0","0","0","0","0","-2"
"159993","University of Louisiana at Monroe","2019","On-Tenure track total","86","33","53","0","0","0","4","2","2","8","2","6","0","0","0","0","0","0","72","28","44","0","0","0","2","1","1","0","0","0","-2"
"159993","University of Louisiana at Monroe","2019","On-tenure track, associate professors","2","1","1","0","0","0","0","0","0","1","0","1","0","0","0","0","0","0","1","1","0","0","0","0","0","0","0","0","0","0","-2"
"159993","University of Louisiana at Monroe","2019","On-tenure track, assistant professors","84","32","52","0","0","0","4","2","2","7","2","5","0","0","0","0","0","0","71","27","44","0","0","0","2","1","1","0","0","0","-2"
"159993","University of Louisiana at Monroe","2019","Not on tenure track/No tenure system system total","91","28","63","2","1","1","2","0","2","5","2","3","3","0","3","0","0","0","79","25","54","0","0","0","0","0","0","0","0","0","-2"
"159993","University of Louisiana at Monroe","2019","Not on tenure/no tenure system, professors","7","2","5","0","0","0","0","0","0","0","0","0","0","0","0","0","0","0","7","2","5","0","0","0","0","0","0","0","0","0","-2"
"159993","University of Louisiana at Monroe","2019","Not on tenure/no tenure system, associate professors","4","0","4","0","0","0","0","0","0","0","0","0","0","0","0","0","0","0","4","0","4","0","0","0","0","0","0","0","0","0","-2"
"159993","University of Louisiana at Monroe","2019","Not on tenure/no tenure system, assistant professors","15","5","10","0","0","0","0","0","0","2","1","1","0","0","0","0","0","0","13","4","9","0","0","0","0","0","0","0","0","0","-2"
"159993","University of Louisiana at Monroe","2019","Not on tenure/no tenure system, instructors","65","21","44","2","1","1","2","0","2","3","1","2","3","0","3","0","0","0","55","19","36","0","0","0","0","0","0","0","0","0","-2"
"160755","Tulane University of Louisiana","2019","Tenured total","467","318","149","2","2","0","53","42","11","15","4","11","21","14","7","0","0","0","363","247","116","8","4","4","0","0","0","5","5","0","-2"
"160755","Tulane University of Louisiana","2019","Tenured, professors","273","205","68","2","2","0","26","22","4","8","4","4","10","9","1","0","0","0","221","164","57","4","2","2","0","0","0","2","2","0","-2"
"160755","Tulane University of Louisiana","2019","Tenured, associate professors","194","113","81","0","0","0","27","20","7","7","0","7","11","5","6","0","0","0","142","83","59","4","2","2","0","0","0","3","3","0","-2"
"160755","Tulane University of Louisiana","2019","On-Tenure track total","168","93","75","1","1","0","33","20","13","7","2","5","10","5","5","0","0","0","90","47","43","4","2","2","1","1","0","22","15","7","-2"
"160755","Tulane University of Louisiana","2019","On-tenure track, professors","6","5","1","0","0","0","2","2","0","1","1","0","1","1","0","0","0","0","1","0","1","1","1","0","0","0","0","0","0","0","-2"
"160755","Tulane University of Louisiana","2019","On-tenure track, associate professors","8","4","4","0","0","0","6","4","2","0","0","0","0","0","0","0","0","0","2","0","2","0","0","0","0","0","0","0","0","0","-2"
"160755","Tulane University of Louisiana","2019","On-tenure track, assistant professors","154","84","70","1","1","0","25","14","11","6","1","5","9","4","5","0","0","0","87","47","40","3","1","2","1","1","0","22","15","7","-2"
"160755","Tulane University of Louisiana","2019","Not on tenure track/No tenure system system total","688","328","360","2","2","0","72","38","34","38","10","28","33","15","18","0","0","0","477","225","252","17","7","10","9","8","1","40","23","17","-2"
"160755","Tulane University of Louisiana","2019","Not on tenure/no tenure system, professors","33","29","4","0","0","0","4","3","1","0","0","0","1","1","0","0","0","0","28","25","3","0","0","0","0","0","0","0","0","0","-2"
"160755","Tulane University of Louisiana","2019","Not on tenure/no tenure system, associate professors","82","41","41","0","0","0","13","9","4","3","0","3","7","2","5","0","0","0","55","27","28","2","1","1","1","1","0","1","1","0","-2"
"160755","Tulane University of Louisiana","2019","Not on tenure/no tenure system, assistant professors","312","154","158","1","1","0","41","21","20","18","8","10","12","8","4","0","0","0","195","91","104","11","3","8","7","6","1","27","16","11","-2"
"160755","Tulane University of Louisiana","2019","Not on tenure/no tenure system, instructors","65","18","47","0","0","0","6","4","2","7","0","7","3","1","2","0","0","0","46","10","36","1","1","0","0","0","0","2","2","0","-2"
"160755","Tulane University of Louisiana","2019","Not on tenure/no tenure system, lecturers","196","86","110","1","1","0","8","1","7","10","2","8","10","3","7","0","0","0","153","72","81","3","2","1","1","1","0","10","4","6","-2"
"162928","Johns Hopkins University","2019","Tenured total","1146","843","303","1","1","0","167","120","47","28","17","11","36","30","6","0","0","0","902","667","235","5","1","4","0","0","0","7","7","0","-2"
"162928","Johns Hopkins University","2019","Tenured, professors","1041","777","264","1","1","0","148","111","37","23","14","9","31","27","4","0","0","0","828","617","211","4","1","3","0","0","0","6","6","0","-2"
"162928","Johns Hopkins University","2019","Tenured, associate professors","105","66","39","0","0","0","19","9","10","5","3","2","5","3","2","0","0","0","74","50","24","1","0","1","0","0","0","1","1","0","-2"
"162928","Johns Hopkins University","2019","On-Tenure track total","1990","1030","960","4","2","2","453","251","202","130","46","84","79","41","38","1","0","1","1193","608","585","22","8","14","0","0","0","108","74","34","-2"
"162928","Johns Hopkins University","2019","On-tenure track, professors","4","2","2","0","0","0","0","0","0","0","0","0","1","1","0","0","0","0","3","1","2","0","0","0","0","0","0","0","0","0","-2"
"162928","Johns Hopkins University","2019","On-tenure track, associate professors","689","408","281","0","0","0","170","112","58","30","12","18","28","18","10","1","0","1","437","249","188","8","4","4","0","0","0","15","13","2","-2"
"162928","Johns Hopkins University","2019","On-tenure track, assistant professors","1297","620","677","4","2","2","283","139","144","100","34","66","50","22","28","0","0","0","753","358","395","14","4","10","0","0","0","93","61","32","-2"
"162928","Johns Hopkins University","2019","Not on tenure track/No tenure system system total","770","346","424","1","0","1","116","58","58","62","21","41","27","6","21","0","0","0","516","237","279","9","3","6","0","0","0","39","21","18","-2"
"162928","Johns Hopkins University","2019","Not on tenure/no tenure system, professors","70","45","25","0","0","0","7","2","5","4","2","2","2","2","0","0","0","0","56","38","18","0","0","0","0","0","0","1","1","0","-2"
"162928","Johns Hopkins University","2019","Not on tenure/no tenure system, associate professors","64","29","35","0","0","0","10","6","4","6","1","5","1","0","1","0","0","0","46","22","24","0","0","0","0","0","0","1","0","1","-2"
"162928","Johns Hopkins University","2019","Not on tenure/no tenure system, assistant professors","87","30","57","0","0","0","5","2","3","13","7","6","3","0","3","0","0","0","62","19","43","1","0","1","0","0","0","3","2","1","-2"
"162928","Johns Hopkins University","2019","Not on tenure/no tenure system, instructors","224","111","113","1","0","1","65","34","31","19","7","12","4","2","2","0","0","0","118","59","59","2","0","2","0","0","0","15","9","6","-2"
"162928","Johns Hopkins University","2019","Not on tenure/no tenure system, lecturers","255","94","161","0","0","0","23","9","14","16","4","12","15","2","13","0","0","0","182","70","112","6","3","3","0","0","0","13","6","7","-2"
"162928","Johns Hopkins University","2019","Not on tenure/no tenure system, no academic rank","70","37","33","0","0","0","6","5","1","4","0","4","2","0","2","0","0","0","52","29","23","0","0","0","0","0","0","6","3","3","-2"
"163268","University of Maryland-Baltimore County","2019","Tenured total","284","171","113","0","0","0","51","34","17","21","10","11","11","6","5","0","0","0","199","121","78","1","0","1","0","0","0","1","0","1","-2"
"163268","University of Maryland-Baltimore County","2019","Tenured, professors","142","101","41","0","0","0","27","21","6","6","4","2","3","2","1","0","0","0","106","74","32","0","0","0","0","0","0","0","0","0","-2"
"163268","University of Maryland-Baltimore County","2019","Tenured, associate professors","141","69","72","0","0","0","24","13","11","14","5","9","8","4","4","0","0","0","93","47","46","1","0","1","0","0","0","1","0","1","-2"
"163268","University of Maryland-Baltimore County","2019","Tenured, assistant professors","1","1","0","0","0","0","0","0","0","1","1","0","0","0","0","0","0","0","0","0","0","0","0","0","0","0","0","0","0","0","-2"
"163268","University of Maryland-Baltimore County","2019","On-Tenure track total","122","56","66","0","0","0","21","11","10","9","2","7","10","4","6","0","0","0","58","27","31","2","1","1","0","0","0","22","11","11","-2"
"163268","University of Maryland-Baltimore County","2019","On-tenure track, professors","1","1","0","0","0","0","1","1","0","0","0","0","0","0","0","0","0","0","0","0","0","0","0","0","0","0","0","0","0","0","-2"
"163268","University of Maryland-Baltimore County","2019","On-tenure track, associate professors","11","5","6","0","0","0","5","2","3","0","0","0","2","1","1","0","0","0","4","2","2","0","0","0","0","0","0","0","0","0","-2"
"163268","University of Maryland-Baltimore County","2019","On-tenure track, assistant professors","110","50","60","0","0","0","15","8","7","9","2","7","8","3","5","0","0","0","54","25","29","2","1","1","0","0","0","22","11","11","-2"
"163268","University of Maryland-Baltimore County","2019","Not on tenure track/No tenure system system total","150","60","90","0","0","0","11","5","6","8","4","4","8","2","6","0","0","0","116","44","72","2","0","2","0","0","0","5","5","0","-2"
"163268","University of Maryland-Baltimore County","2019","Not on tenure/no tenure system, professors","14","10","4","0","0","0","2","2","0","0","0","0","1","0","1","0","0","0","10","8","2","1","0","1","0","0","0","0","0","0","-2"
"163268","University of Maryland-Baltimore County","2019","Not on tenure/no tenure system, associate professors","7","1","6","0","0","0","0","0","0","0","0","0","0","0","0","0","0","0","6","1","5","1","0","1","0","0","0","0","0","0","-2"
"163268","University of Maryland-Baltimore County","2019","Not on tenure/no tenure system, assistant professors","11","3","8","0","0","0","0","0","0","1","1","0","0","0","0","0","0","0","9","1","8","0","0","0","0","0","0","1","1","0","-2"
"163268","University of Maryland-Baltimore County","2019","Not on tenure/no tenure system, instructors","10","2","8","0","0","0","0","0","0","1","0","1","0","0","0","0","0","0","9","2","7","0","0","0","0","0","0","0","0","0","-2"
"163268","University of Maryland-Baltimore County","2019","Not on tenure/no tenure system, lecturers","108","44","64","0","0","0","9","3","6","6","3","3","7","2","5","0","0","0","82","32","50","0","0","0","0","0","0","4","4","0","-2"
"163286","University of Maryland-College Park","2019","Tenured total","1104","765","339","1","1","0","184","130","54","42","22","20","58","32","26","1","0","1","740","525","215","7","4","3","62","44","18","9","7","2","-2"
"163286","University of Maryland-College Park","2019","Tenured, professors","690","518","172","0","0","0","121","91","30","12","8","4","28","18","10","0","0","0","498","377","121","3","2","1","24","18","6","4","4","0","-2"
"163286","University of Maryland-College Park","2019","Tenured, associate professors","414","247","167","1","1","0","63","39","24","30","14","16","30","14","16","1","0","1","242","148","94","4","2","2","38","26","12","5","3","2","-2"
"163286","University of Maryland-College Park","2019","On-Tenure track total","268","132","136","3","1","2","33","17","16","25","8","17","18","9","9","1","1","0","112","52","60","2","1","1","35","17","18","39","26","13","-2"
"163286","University of Maryland-College Park","2019","On-tenure track, associate professors","1","0","1","0","0","0","0","0","0","0","0","0","0","0","0","0","0","0","1","0","1","0","0","0","0","0","0","0","0","0","-2"
"163286","University of Maryland-College Park","2019","On-tenure track, assistant professors","267","132","135","3","1","2","33","17","16","25","8","17","18","9","9","1","1","0","111","52","59","2","1","1","35","17","18","39","26","13","-2"
"163286","University of Maryland-College Park","2019","Not on tenure track/No tenure system system total","498","231","267","1","1","0","32","13","19","49","23","26","32","14","18","0","0","0","315","157","158","7","0","7","50","18","32","12","5","7","-2"
"163286","University of Maryland-College Park","2019","Not on tenure/no tenure system, professors","29","20","9","0","0","0","1","1","0","3","3","0","3","3","0","0","0","0","20","12","8","0","0","0","2","1","1","0","0","0","-2"
"163286","University of Maryland-College Park","2019","Not on tenure/no tenure system, associate professors","40","11","29","0","0","0","0","0","0","6","0","6","4","2","2","0","0","0","26","9","17","0","0","0","4","0","4","0","0","0","-2"
"163286","University of Maryland-College Park","2019","Not on tenure/no tenure system, assistant professors","48","8","40","0","0","0","3","0","3","7","2","5","7","1","6","0","0","0","21","4","17","2","0","2","6","1","5","2","0","2","-2"
"163286","University of Maryland-College Park","2019","Not on tenure/no tenure system, instructors","8","2","6","0","0","0","0","0","0","2","1","1","1","0","1","0","0","0","5","1","4","0","0","0","0","0","0","0","0","0","-2"
"163286","University of Maryland-College Park","2019","Not on tenure/no tenure system, lecturers","373","190","183","1","1","0","28","12","16","31","17","14","17","8","9","0","0","0","243","131","112","5","0","5","38","16","22","10","5","5","-2"
"163338","University of Maryland Eastern Shore","2019","Tenured total","111","73","38","0","0","0","25","16","9","39","27","12","3","3","0","1","1","0","37","22","15","2","2","0","1","0","1","3","2","1","-2"
"163338","University of Maryland Eastern Shore","2019","Tenured, professors","43","26","17","0","0","0","10","5","5","16","10","6","1","1","0","0","0","0","15","9","6","1","1","0","0","0","0","0","0","0","-2"
"163338","University of Maryland Eastern Shore","2019","Tenured, associate professors","62","42","20","0","0","0","14","10","4","22","17","5","1","1","0","1","1","0","19","10","9","1","1","0","1","0","1","3","2","1","-2"
"163338","University of Maryland Eastern Shore","2019","Tenured, assistant professors","6","5","1","0","0","0","1","1","0","1","0","1","1","1","0","0","0","0","3","3","0","0","0","0","0","0","0","0","0","0","-2"
"163338","University of Maryland Eastern Shore","2019","On-Tenure track total","40","19","21","0","0","0","8","5","3","13","5","8","1","1","0","1","1","0","12","6","6","2","0","2","0","0","0","3","1","2","-2"
"163338","University of Maryland Eastern Shore","2019","On-tenure track, associate professors","7","3","4","0","0","0","3","2","1","3","1","2","0","0","0","0","0","0","1","0","1","0","0","0","0","0","0","0","0","0","-2"
"163338","University of Maryland Eastern Shore","2019","On-tenure track, assistant professors","33","16","17","0","0","0","5","3","2","10","4","6","1","1","0","1","1","0","11","6","5","2","0","2","0","0","0","3","1","2","-2"
"163338","University of Maryland Eastern Shore","2019","Not on tenure track/No tenure system system total","54","21","33","0","0","0","5","3","2","22","6","16","2","0","2","0","0","0","24","11","13","0","0","0","0","0","0","1","1","0","-2"
"163338","University of Maryland Eastern Shore","2019","Not on tenure/no tenure system, associate professors","4","2","2","0","0","0","1","0","1","1","0","1","0","0","0","0","0","0","1","1","0","0","0","0","0","0","0","1","1","0","-2"
"163338","University of Maryland Eastern Shore","2019","Not on tenure/no tenure system, assistant professors","10","2","8","0","0","0","1","1","0","5","0","5","1","0","1","0","0","0","3","1","2","0","0","0","0","0","0","0","0","0","-2"
"163338","University of Maryland Eastern Shore","2019","Not on tenure/no tenure system, instructors","1","1","0","0","0","0","0","0","0","0","0","0","0","0","0","0","0","0","1","1","0","0","0","0","0","0","0","0","0","0","-2"
"163338","University of Maryland Eastern Shore","2019","Not on tenure/no tenure system, lecturers","39","16","23","0","0","0","3","2","1","16","6","10","1","0","1","0","0","0","19","8","11","0","0","0","0","0","0","0","0","0","-2"
"163851","Salisbury University","2019","Tenured total","239","139","100","0","0","0","22","13","9","16","10","6","2","1","1","0","0","0","192","111","81","1","0","1","3","2","1","3","2","1","-2"
"163851","Salisbury University","2019","Tenured, professors","109","73","36","0","0","0","13","8","5","2","2","0","0","0","0","0","0","0","92","62","30","0","0","0","2","1","1","0","0","0","-2"
"163851","Salisbury University","2019","Tenured, associate professors","121","61","60","0","0","0","9","5","4","14","8","6","2","1","1","0","0","0","91","44","47","1","0","1","1","1","0","3","2","1","-2"
"163851","Salisbury University","2019","Tenured, assistant professors","9","5","4","0","0","0","0","0","0","0","0","0","0","0","0","0","0","0","9","5","4","0","0","0","0","0","0","0","0","0","-2"
"163851","Salisbury University","2019","On-Tenure track total","112","53","59","0","0","0","15","8","7","6","4","2","6","4","2","0","0","0","80","36","44","0","0","0","0","0","0","5","1","4","-2"
"163851","Salisbury University","2019","On-tenure track, professors","1","1","0","0","0","0","0","0","0","1","1","0","0","0","0","0","0","0","0","0","0","0","0","0","0","0","0","0","0","0","-2"
"163851","Salisbury University","2019","On-tenure track, associate professors","2","0","2","0","0","0","0","0","0","0","0","0","0","0","0","0","0","0","2","0","2","0","0","0","0","0","0","0","0","0","-2"
"163851","Salisbury University","2019","On-tenure track, assistant professors","103","50","53","0","0","0","14","8","6","4","3","1","6","4","2","0","0","0","74","34","40","0","0","0","0","0","0","5","1","4","-2"
"163851","Salisbury University","2019","On-tenure track, instructors","6","2","4","0","0","0","1","0","1","1","0","1","0","0","0","0","0","0","4","2","2","0","0","0","0","0","0","0","0","0","-2"
"163851","Salisbury University","2019","Not on tenure track/No tenure system system total","95","24","71","0","0","0","3","0","3","2","1","1","3","1","2","0","0","0","87","22","65","0","0","0","0","0","0","0","0","0","-2"
"163851","Salisbury University","2019","Not on tenure/no tenure system, lecturers","95","24","71","0","0","0","3","0","3","2","1","1","3","1","2","0","0","0","87","22","65","0","0","0","0","0","0","0","0","0","-2"
"164155","United States Naval Academy","2019","Tenured total","217","156","61","0","0","0","17","12","5","6","4","2","8","3","5","1","0","1","184","136","48","0","0","0","1","1","0","0","0","0","-2"
"164155","United States Naval Academy","2019","Tenured, professors","122","87","35","0","0","0","5","3","2","1","1","0","4","1","3","1","0","1","110","81","29","0","0","0","1","1","0","0","0","0","-2"
"164155","United States Naval Academy","2019","Tenured, associate professors","95","69","26","0","0","0","12","9","3","5","3","2","4","2","2","0","0","0","74","55","19","0","0","0","0","0","0","0","0","0","-2"
"164155","United States Naval Academy","2019","On-Tenure track total","70","36","34","1","1","0","4","0","4","4","3","1","4","1","3","0","0","0","57","31","26","0","0","0","0","0","0","0","0","0","-2"
"164155","United States Naval Academy","2019","On-tenure track, assistant professors","70","36","34","1","1","0","4","0","4","4","3","1","4","1","3","0","0","0","57","31","26","0","0","0","0","0","0","0","0","0","-2"
"164155","United States Naval Academy","2019","Not on tenure track/No tenure system system total","37","32","5","0","0","0","1","1","0","0","0","0","1","1","0","0","0","0","34","29","5","0","0","0","1","1","0","0","0","0","-2"
"164155","United States Naval Academy","2019","Not on tenure/no tenure system, no academic rank","37","32","5","0","0","0","1","1","0","0","0","0","1","1","0","0","0","0","34","29","5","0","0","0","1","1","0","0","0","0","-2"
"166027","Harvard University","2019","Tenured total","1081","803","278","1","1","0","117","89","28","38","25","13","31","18","13","0","0","0","858","640","218","6","5","1","0","0","0","30","25","5","-2"
"166027","Harvard University","2019","Tenured, professors","1081","803","278","1","1","0","117","89","28","38","25","13","31","18","13","0","0","0","858","640","218","6","5","1","0","0","0","30","25","5","-2"
"166027","Harvard University","2019","On-Tenure track total","402","228","174","1","0","1","59","32","27","24","13","11","19","11","8","0","0","0","215","121","94","10","6","4","0","0","0","74","45","29","-2"
"166027","Harvard University","2019","On-tenure track, associate professors","170","99","71","0","0","0","30","18","12","4","0","4","11","5","6","0","0","0","98","58","40","4","4","0","0","0","0","23","14","9","-2"
"166027","Harvard University","2019","On-tenure track, assistant professors","232","129","103","1","0","1","29","14","15","20","13","7","8","6","2","0","0","0","117","63","54","6","2","4","0","0","0","51","31","20","-2"
"166027","Harvard University","2019","Not on tenure track/No tenure system system total","659","345","314","1","0","1","60","34","26","32","17","15","25","11","14","2","1","1","411","223","188","14","6","8","2","1","1","112","52","60","-2"
"166027","Harvard University","2019","Not on tenure/no tenure system, professors","124","79","45","1","0","1","9","4","5","14","7","7","4","1","3","0","0","0","78","55","23","3","3","0","0","0","0","15","9","6","-2"
"166027","Harvard University","2019","Not on tenure/no tenure system, associate professors","8","3","5","0","0","0","2","1","1","0","0","0","0","0","0","0","0","0","4","1","3","0","0","0","0","0","0","2","1","1","-2"
"166027","Harvard University","2019","Not on tenure/no tenure system, assistant professors","24","12","12","0","0","0","1","1","0","0","0","0","0","0","0","0","0","0","12","3","9","0","0","0","0","0","0","11","8","3","-2"
"166027","Harvard University","2019","Not on tenure/no tenure system, instructors","189","88","101","0","0","0","23","13","10","4","2","2","16","7","9","1","1","0","97","48","49","4","2","2","0","0","0","44","15","29","-2"
"166027","Harvard University","2019","Not on tenure/no tenure system, lecturers","314","163","151","0","0","0","25","15","10","14","8","6","5","3","2","1","0","1","220","116","104","7","1","6","2","1","1","40","19","21","-2"
"166513","University of Massachusetts-Lowell","2019","Tenured total","288","177","111","0","0","0","79","52","27","5","4","1","10","7","3","0","0","0","190","112","78","2","1","1","0","0","0","2","1","1","-2"
"166513","University of Massachusetts-Lowell","2019","Tenured, professors","148","109","39","0","0","0","46","36","10","1","1","0","4","4","0","0","0","0","96","67","29","0","0","0","0","0","0","1","1","0","-2"
"166513","University of Massachusetts-Lowell","2019","Tenured, associate professors","140","68","72","0","0","0","33","16","17","4","3","1","6","3","3","0","0","0","94","45","49","2","1","1","0","0","0","1","0","1","-2"
"166513","University of Massachusetts-Lowell","2019","On-Tenure track total","157","95","62","0","0","0","38","21","17","4","1","3","8","7","1","0","0","0","82","49","33","5","3","2","0","0","0","20","14","6","-2"
"166513","University of Massachusetts-Lowell","2019","On-tenure track, professors","1","1","0","0","0","0","0","0","0","0","0","0","0","0","0","0","0","0","1","1","0","0","0","0","0","0","0","0","0","0","-2"
"166513","University of Massachusetts-Lowell","2019","On-tenure track, associate professors","9","6","3","0","0","0","5","4","1","0","0","0","2","2","0","0","0","0","2","0","2","0","0","0","0","0","0","0","0","0","-2"
"166513","University of Massachusetts-Lowell","2019","On-tenure track, assistant professors","147","88","59","0","0","0","33","17","16","4","1","3","6","5","1","0","0","0","79","48","31","5","3","2","0","0","0","20","14","6","-2"
"166513","University of Massachusetts-Lowell","2019","Not on tenure track/No tenure system system total","198","83","115","0","0","0","17","8","9","4","2","2","4","3","1","0","0","0","162","65","97","1","1","0","1","0","1","9","4","5","-2"
"166513","University of Massachusetts-Lowell","2019","Not on tenure/no tenure system, professors","3","1","2","0","0","0","0","0","0","0","0","0","0","0","0","0","0","0","3","1","2","0","0","0","0","0","0","0","0","0","-2"
"166513","University of Massachusetts-Lowell","2019","Not on tenure/no tenure system, associate professors","5","2","3","0","0","0","0","0","0","0","0","0","1","1","0","0","0","0","4","1","3","0","0","0","0","0","0","0","0","0","-2"
"166513","University of Massachusetts-Lowell","2019","Not on tenure/no tenure system, assistant professors","7","0","7","0","0","0","1","0","1","0","0","0","0","0","0","0","0","0","6","0","6","0","0","0","0","0","0","0","0","0","-2"
"166513","University of Massachusetts-Lowell","2019","Not on tenure/no tenure system, instructors","7","0","7","0","0","0","0","0","0","0","0","0","0","0","0","0","0","0","7","0","7","0","0","0","0","0","0","0","0","0","-2"
"166513","University of Massachusetts-Lowell","2019","Not on tenure/no tenure system, lecturers","119","54","65","0","0","0","10","5","5","3","1","2","2","2","0","0","0","0","99","42","57","1","1","0","0","0","0","4","3","1","-2"
"166513","University of Massachusetts-Lowell","2019","Not on tenure/no tenure system, no academic rank","57","26","31","0","0","0","6","3","3","1","1","0","1","0","1","0","0","0","43","21","22","0","0","0","1","0","1","5","1","4","-2"
"166629","University of Massachusetts-Amherst","2019","Tenured total","783","489","294","2","1","1","115","76","39","34","20","14","33","19","14","0","0","0","556","348","208","10","5","5","24","13","11","9","7","2","-2"
"166629","University of Massachusetts-Amherst","2019","Tenured, professors","449","319","130","0","0","0","62","50","12","12","7","5","14","7","7","0","0","0","344","243","101","6","4","2","8","5","3","3","3","0","-2"
"166629","University of Massachusetts-Amherst","2019","Tenured, associate professors","333","169","164","2","1","1","52","25","27","22","13","9","19","12","7","0","0","0","212","105","107","4","1","3","16","8","8","6","4","2","-2"
"166629","University of Massachusetts-Amherst","2019","Tenured, assistant professors","1","1","0","0","0","0","1","1","0","0","0","0","0","0","0","0","0","0","0","0","0","0","0","0","0","0","0","0","0","0","-2"
"166629","University of Massachusetts-Amherst","2019","On-Tenure track total","300","150","150","1","1","0","50","29","21","18","7","11","3","0","3","0","0","0","157","76","81","8","4","4","8","6","2","55","27","28","-2"
"166629","University of Massachusetts-Amherst","2019","On-tenure track, associate professors","11","4","7","0","0","0","2","1","1","0","0","0","0","0","0","0","0","0","7","3","4","0","0","0","0","0","0","2","0","2","-2"
"166629","University of Massachusetts-Amherst","2019","On-tenure track, assistant professors","289","146","143","1","1","0","48","28","20","18","7","11","3","0","3","0","0","0","150","73","77","8","4","4","8","6","2","53","27","26","-2"
"166629","University of Massachusetts-Amherst","2019","Not on tenure track/No tenure system system total","378","158","220","2","0","2","26","7","19","12","5","7","7","1","6","0","0","0","289","124","165","4","1","3","6","3","3","32","17","15","-2"
"166629","University of Massachusetts-Amherst","2019","Not on tenure/no tenure system, professors","2","1","1","0","0","0","0","0","0","0","0","0","1","0","1","0","0","0","1","1","0","0","0","0","0","0","0","0","0","0","-2"
"166629","University of Massachusetts-Amherst","2019","Not on tenure/no tenure system, associate professors","8","3","5","0","0","0","0","0","0","2","1","1","0","0","0","0","0","0","6","2","4","0","0","0","0","0","0","0","0","0","-2"
"166629","University of Massachusetts-Amherst","2019","Not on tenure/no tenure system, assistant professors","16","1","15","0","0","0","0","0","0","2","0","2","0","0","0","0","0","0","14","1","13","0","0","0","0","0","0","0","0","0","-2"
"166629","University of Massachusetts-Amherst","2019","Not on tenure/no tenure system, instructors","3","0","3","0","0","0","0","0","0","0","0","0","0","0","0","0","0","0","1","0","1","2","0","2","0","0","0","0","0","0","-2"
"166629","University of Massachusetts-Amherst","2019","Not on tenure/no tenure system, lecturers","349","153","196","2","0","2","26","7","19","8","4","4","6","1","5","0","0","0","267","120","147","2","1","1","6","3","3","32","17","15","-2"
"166683","Massachusetts Institute of Technology","2019","Tenured total","790","622","168","0","0","0","99","80","19","25","18","7","29","25","4","0","0","0","560","441","119","10","7","3","62","46","16","5","5","0","-2"
"166683","Massachusetts Institute of Technology","2019","Tenured, professors","650","524","126","0","0","0","72","60","12","21","16","5","21","20","1","0","0","0","489","390","99","6","5","1","37","29","8","4","4","0","-2"
"166683","Massachusetts Institute of Technology","2019","Tenured, associate professors","140","98","42","0","0","0","27","20","7","4","2","2","8","5","3","0","0","0","71","51","20","4","2","2","25","17","8","1","1","0","-2"
"166683","Massachusetts Institute of Technology","2019","On-Tenure track total","227","146","81","0","0","0","20","13","7","6","4","2","16","12","4","0","0","0","116","72","44","4","2","2","40","26","14","25","17","8","-2"
"166683","Massachusetts Institute of Technology","2019","On-tenure track, associate professors","77","53","24","0","0","0","9","7","2","2","2","0","5","4","1","0","0","0","38","26","12","3","2","1","20","12","8","0","0","0","-2"
"166683","Massachusetts Institute of Technology","2019","On-tenure track, assistant professors","150","93","57","0","0","0","11","6","5","4","2","2","11","8","3","0","0","0","78","46","32","1","0","1","20","14","6","25","17","8","-2"
"166683","Massachusetts Institute of Technology","2019","Not on tenure track/No tenure system system total","11","7","4","0","0","0","2","0","2","1","1","0","0","0","0","0","0","0","7","5","2","0","0","0","1","1","0","0","0","0","-2"
"166683","Massachusetts Institute of Technology","2019","Not on tenure/no tenure system, associate professors","7","5","2","0","0","0","1","0","1","1","1","0","0","0","0","0","0","0","5","4","1","0","0","0","0","0","0","0","0","0","-2"
"166683","Massachusetts Institute of Technology","2019","Not on tenure/no tenure system, assistant professors","3","2","1","0","0","0","0","0","0","0","0","0","0","0","0","0","0","0","2","1","1","0","0","0","1","1","0","0","0","0","-2"
"166683","Massachusetts Institute of Technology","2019","Not on tenure/no tenure system, no academic rank","1","0","1","0","0","0","1","0","1","0","0","0","0","0","0","0","0","0","0","0","0","0","0","0","0","0","0","0","0","0","-2"
"169248","Central Michigan University","2019","Tenured total","460","265","195","1","1","0","60","33","27","16","9","7","17","10","7","0","0","0","357","205","152","5","4","1","0","0","0","4","3","1","-2"
"169248","Central Michigan University","2019","Tenured, professors","311","192","119","1","1","0","33","21","12","14","7","7","12","6","6","0","0","0","247","153","94","3","3","0","0","0","0","1","1","0","-2"
"169248","Central Michigan University","2019","Tenured, associate professors","145","71","74","0","0","0","27","12","15","2","2","0","5","4","1","0","0","0","106","50","56","2","1","1","0","0","0","3","2","1","-2"
"169248","Central Michigan University","2019","Tenured, assistant professors","4","2","2","0","0","0","0","0","0","0","0","0","0","0","0","0","0","0","4","2","2","0","0","0","0","0","0","0","0","0","-2"
"169248","Central Michigan University","2019","On-Tenure track total","108","58","50","0","0","0","13","11","2","4","3","1","0","0","0","0","0","0","73","36","37","0","0","0","3","1","2","15","7","8","-2"
"169248","Central Michigan University","2019","On-tenure track, professors","1","1","0","0","0","0","0","0","0","0","0","0","0","0","0","0","0","0","1","1","0","0","0","0","0","0","0","0","0","0","-2"
"169248","Central Michigan University","2019","On-tenure track, associate professors","22","13","9","0","0","0","4","4","0","2","1","1","0","0","0","0","0","0","15","8","7","0","0","0","1","0","1","0","0","0","-2"
"169248","Central Michigan University","2019","On-tenure track, assistant professors","85","44","41","0","0","0","9","7","2","2","2","0","0","0","0","0","0","0","57","27","30","0","0","0","2","1","1","15","7","8","-2"
"169248","Central Michigan University","2019","Not on tenure track/No tenure system system total","224","120","104","1","1","0","6","4","2","4","3","1","3","1","2","0","0","0","201","108","93","2","0","2","2","1","1","5","2","3","-2"
"169248","Central Michigan University","2019","Not on tenure/no tenure system, professors","6","4","2","0","0","0","2","1","1","0","0","0","0","0","0","0","0","0","4","3","1","0","0","0","0","0","0","0","0","0","-2"
"169248","Central Michigan University","2019","Not on tenure/no tenure system, associate professors","2","1","1","0","0","0","0","0","0","0","0","0","0","0","0","0","0","0","2","1","1","0","0","0","0","0","0","0","0","0","-2"
"169248","Central Michigan University","2019","Not on tenure/no tenure system, assistant professors","5","2","3","0","0","0","1","1","0","0","0","0","0","0","0","0","0","0","3","1","2","1","0","1","0","0","0","0","0","0","-2"
"169248","Central Michigan University","2019","Not on tenure/no tenure system, instructors","1","1","0","0","0","0","0","0","0","0","0","0","0","0","0","0","0","0","1","1","0","0","0","0","0","0","0","0","0","0","-2"
"169248","Central Michigan University","2019","Not on tenure/no tenure system, lecturers","200","107","93","1","1","0","3","2","1","2","2","0","3","1","2","0","0","0","183","98","85","1","0","1","2","1","1","5","2","3","-2"
"169248","Central Michigan University","2019","Not on tenure/no tenure system, no academic rank","10","5","5","0","0","0","0","0","0","2","1","1","0","0","0","0","0","0","8","4","4","0","0","0","0","0","0","0","0","0","-2"
"170976","University of Michigan-Ann Arbor","2019","Tenured total","2186","1480","706","7","4","3","350","253","97","90","57","33","84","50","34","2","0","2","1597","1077","520","27","16","11","20","16","4","9","7","2","-2"
"170976","University of Michigan-Ann Arbor","2019","Tenured, professors","1480","1074","406","5","2","3","213","164","49","50","29","21","55","34","21","2","0","2","1124","822","302","13","9","4","12","10","2","6","4","2","-2"
"170976","University of Michigan-Ann Arbor","2019","Tenured, associate professors","706","406","300","2","2","0","137","89","48","40","28","12","29","16","13","0","0","0","473","255","218","14","7","7","8","6","2","3","3","0","-2"
"170976","University of Michigan-Ann Arbor","2019","On-Tenure track total","641","349","292","3","2","1","113","67","46","34","11","23","25","16","9","0","0","0","368","202","166","16","8","8","16","5","11","66","38","28","-2"
"170976","University of Michigan-Ann Arbor","2019","On-tenure track, professors","1","1","0","0","0","0","0","0","0","0","0","0","0","0","0","0","0","0","1","1","0","0","0","0","0","0","0","0","0","0","-2"
"170976","University of Michigan-Ann Arbor","2019","On-tenure track, associate professors","19","12","7","0","0","0","7","6","1","0","0","0","1","1","0","0","0","0","9","5","4","0","0","0","1","0","1","1","0","1","-2"
"170976","University of Michigan-Ann Arbor","2019","On-tenure track, assistant professors","621","336","285","3","2","1","106","61","45","34","11","23","24","15","9","0","0","0","358","196","162","16","8","8","15","5","10","65","38","27","-2"
"170976","University of Michigan-Ann Arbor","2019","Not on tenure track/No tenure system system total","3960","2154","1806","8","3","5","538","286","252","108","53","55","124","49","75","0","0","0","2129","1088","1041","42","16","26","59","33","26","952","626","326","-2"
"170976","University of Michigan-Ann Arbor","2019","Not on tenure/no tenure system, professors","259","172","87","1","1","0","43","29","14","5","1","4","6","3","3","0","0","0","199","134","65","2","2","0","1","0","1","2","2","0","-2"
"170976","University of Michigan-Ann Arbor","2019","Not on tenure/no tenure system, associate professors","335","186","149","0","0","0","70","39","31","11","6","5","9","4","5","0","0","0","229","127","102","4","1","3","6","4","2","6","5","1","-2"
"170976","University of Michigan-Ann Arbor","2019","Not on tenure/no tenure system, assistant professors","831","418","413","1","0","1","147","78","69","29","13","16","20","11","9","0","0","0","538","258","280","17","5","12","17","9","8","62","44","18","-2"
"170976","University of Michigan-Ann Arbor","2019","Not on tenure/no tenure system, instructors","174","73","101","1","1","0","22","10","12","10","7","3","6","0","6","0","0","0","123","48","75","2","1","1","5","3","2","5","3","2","-2"
"170976","University of Michigan-Ann Arbor","2019","Not on tenure/no tenure system, lecturers","738","326","412","4","1","3","76","32","44","24","12","12","35","9","26","0","0","0","533","242","291","6","1","5","13","7","6","47","22","25","-2"
"170976","University of Michigan-Ann Arbor","2019","Not on tenure/no tenure system, no academic rank","1623","979","644","1","0","1","180","98","82","29","14","15","48","22","26","0","0","0","507","279","228","11","6","5","17","10","7","830","550","280","-2"
"171100","Michigan State University","2019","Tenured total","1385","914","471","10","8","2","199","130","69","60","35","25","63","43","20","3","2","1","1039","689","350","6","2","4","0","0","0","5","5","0","-2"
"171100","Michigan State University","2019","Tenured, professors","813","587","226","6","5","1","111","80","31","30","19","11","22","16","6","1","1","0","636","460","176","3","2","1","0","0","0","4","4","0","-2"
"171100","Michigan State University","2019","Tenured, associate professors","572","327","245","4","3","1","88","50","38","30","16","14","41","27","14","2","1","1","403","229","174","3","0","3","0","0","0","1","1","0","-2"
"171100","Michigan State University","2019","On-Tenure track total","466","244","222","1","0","1","86","53","33","19","9","10","32","12","20","0","0","0","259","128","131","3","0","3","0","0","0","66","42","24","-2"
"171100","Michigan State University","2019","On-tenure track, associate professors","15","9","6","0","0","0","5","3","2","2","2","0","0","0","0","0","0","0","7","3","4","0","0","0","0","0","0","1","1","0","-2"
"171100","Michigan State University","2019","On-tenure track, assistant professors","451","235","216","1","0","1","81","50","31","17","7","10","32","12","20","0","0","0","252","125","127","3","0","3","0","0","0","65","41","24","-2"
"171100","Michigan State University","2019","Not on tenure track/No tenure system system total","896","445","451","3","3","0","100","56","44","51","30","21","28","14","14","2","0","2","648","305","343","4","0","4","0","0","0","60","37","23","-2"
"171100","Michigan State University","2019","Not on tenure/no tenure system, professors","60","42","18","0","0","0","9","8","1","6","4","2","0","0","0","0","0","0","44","29","15","0","0","0","0","0","0","1","1","0","-2"
"171100","Michigan State University","2019","Not on tenure/no tenure system, associate professors","121","78","43","1","1","0","26","17","9","8","6","2","2","0","2","0","0","0","80","51","29","0","0","0","0","0","0","4","3","1","-2"
"171100","Michigan State University","2019","Not on tenure/no tenure system, assistant professors","495","237","258","2","2","0","60","29","31","28","17","11","19","11","8","2","0","2","335","149","186","3","0","3","0","0","0","46","29","17","-2"
"171100","Michigan State University","2019","Not on tenure/no tenure system, instructors","212","83","129","0","0","0","4","2","2","9","3","6","7","3","4","0","0","0","182","71","111","1","0","1","0","0","0","9","4","5","-2"
"171100","Michigan State University","2019","Not on tenure/no tenure system, lecturers","8","5","3","0","0","0","1","0","1","0","0","0","0","0","0","0","0","0","7","5","2","0","0","0","0","0","0","0","0","0","-2"
"171128","Michigan Technological University","2019","Tenured total","239","181","58","0","0","0","47","41","6","4","2","2","9","7","2","0","0","0","150","107","43","1","1","0","26","21","5","2","2","0","-2"
"171128","Michigan Technological University","2019","Tenured, professors","121","94","27","0","0","0","26","23","3","2","1","1","3","2","1","0","0","0","78","58","20","0","0","0","12","10","2","0","0","0","-2"
"171128","Michigan Technological University","2019","Tenured, associate professors","118","87","31","0","0","0","21","18","3","2","1","1","6","5","1","0","0","0","72","49","23","1","1","0","14","11","3","2","2","0","-2"
"171128","Michigan Technological University","2019","On-Tenure track total","82","50","32","0","0","0","17","11","6","0","0","0","1","1","0","0","0","0","43","24","19","0","0","0","3","2","1","18","12","6","-2"
"171128","Michigan Technological University","2019","On-tenure track, associate professors","6","4","2","0","0","0","1","1","0","0","0","0","0","0","0","0","0","0","3","1","2","0","0","0","0","0","0","2","2","0","-2"
"171128","Michigan Technological University","2019","On-tenure track, assistant professors","76","46","30","0","0","0","16","10","6","0","0","0","1","1","0","0","0","0","40","23","17","0","0","0","3","2","1","16","10","6","-2"
"171128","Michigan Technological University","2019","Not on tenure track/No tenure system system total","88","53","35","0","0","0","5","4","1","0","0","0","2","1","1","0","0","0","73","42","31","0","0","0","2","1","1","6","5","1","-2"
"171128","Michigan Technological University","2019","Not on tenure/no tenure system, instructors","26","19","7","0","0","0","2","2","0","0","0","0","1","1","0","0","0","0","21","15","6","0","0","0","1","0","1","1","1","0","-2"
"171128","Michigan Technological University","2019","Not on tenure/no tenure system, lecturers","62","34","28","0","0","0","3","2","1","0","0","0","1","0","1","0","0","0","52","27","25","0","0","0","1","1","0","5","4","1","-2"
"174066","University of Minnesota-Twin Cities","2019","Tenured total","1652","1111","541","8","3","5","232","169","63","38","21","17","44","25","19","1","1","0","1273","852","421","21","13","8","8","6","2","27","21","6","-2"
"174066","University of Minnesota-Twin Cities","2019","Tenured, professors","1085","774","311","4","1","3","137","110","27","18","13","5","21","14","7","0","0","0","882","620","262","10","6","4","5","4","1","8","6","2","-2"
"174066","University of Minnesota-Twin Cities","2019","Tenured, associate professors","565","335","230","4","2","2","95","59","36","20","8","12","23","11","12","1","1","0","389","230","159","11","7","4","3","2","1","19","15","4","-2"
"174066","University of Minnesota-Twin Cities","2019","Tenured, assistant professors","1","1","0","0","0","0","0","0","0","0","0","0","0","0","0","0","0","0","1","1","0","0","0","0","0","0","0","0","0","0","-2"
"174066","University of Minnesota-Twin Cities","2019","Tenured, instructors","1","1","0","0","0","0","0","0","0","0","0","0","0","0","0","0","0","0","1","1","0","0","0","0","0","0","0","0","0","0","-2"
"174066","University of Minnesota-Twin Cities","2019","On-Tenure track total","519","281","238","4","2","2","53","29","24","23","11","12","21","12","9","1","0","1","281","145","136","12","8","4","20","12","8","104","62","42","-2"
"174066","University of Minnesota-Twin Cities","2019","On-tenure track, professors","1","1","0","0","0","0","0","0","0","0","0","0","0","0","0","0","0","0","1","1","0","0","0","0","0","0","0","0","0","0","-2"
"174066","University of Minnesota-Twin Cities","2019","On-tenure track, associate professors","32","15","17","0","0","0","6","2","4","0","0","0","0","0","0","0","0","0","23","11","12","0","0","0","0","0","0","3","2","1","-2"
"174066","University of Minnesota-Twin Cities","2019","On-tenure track, assistant professors","486","265","221","4","2","2","47","27","20","23","11","12","21","12","9","1","0","1","257","133","124","12","8","4","20","12","8","101","60","41","-2"
"174066","University of Minnesota-Twin Cities","2019","Not on tenure track/No tenure system system total","1104","574","530","3","0","3","145","85","60","23","13","10","36","19","17","2","2","0","778","377","401","19","9","10","38","28","10","60","41","19","-2"
"174066","University of Minnesota-Twin Cities","2019","Not on tenure/no tenure system, professors","114","77","37","0","0","0","17","13","4","3","3","0","4","3","1","0","0","0","85","54","31","1","1","0","1","1","0","3","2","1","-2"
"174066","University of Minnesota-Twin Cities","2019","Not on tenure/no tenure system, associate professors","230","120","110","0","0","0","33","17","16","4","3","1","7","4","3","1","1","0","178","90","88","0","0","0","2","2","0","5","3","2","-2"
"174066","University of Minnesota-Twin Cities","2019","Not on tenure/no tenure system, assistant professors","718","353","365","2","0","2","92","53","39","15","6","9","24","11","13","1","1","0","490","220","270","18","8","10","24","18","6","52","36","16","-2"
"174066","University of Minnesota-Twin Cities","2019","Not on tenure/no tenure system, instructors","36","20","16","0","0","0","2","1","1","1","1","0","1","1","0","0","0","0","21","10","11","0","0","0","11","7","4","0","0","0","-2"
"174066","University of Minnesota-Twin Cities","2019","Not on tenure/no tenure system, no academic rank","6","4","2","1","0","1","1","1","0","0","0","0","0","0","0","0","0","0","4","3","1","0","0","0","0","0","0","0","0","0","-2"
"174783","Saint Cloud State University","2019","Tenured total","295","180","115","4","1","3","46","27","19","14","11","3","15","9","6","0","0","0","209","128","81","0","0","0","6","3","3","1","1","0","-2"
"174783","Saint Cloud State University","2019","Tenured, professors","212","128","84","2","1","1","31","17","14","12","10","2","12","7","5","0","0","0","150","90","60","0","0","0","4","2","2","1","1","0","-2"
"174783","Saint Cloud State University","2019","Tenured, associate professors","77","49","28","2","0","2","15","10","5","2","1","1","2","2","0","0","0","0","54","35","19","0","0","0","2","1","1","0","0","0","-2"
"174783","Saint Cloud State University","2019","Tenured, assistant professors","6","3","3","0","0","0","0","0","0","0","0","0","1","0","1","0","0","0","5","3","2","0","0","0","0","0","0","0","0","0","-2"
"174783","Saint Cloud State University","2019","On-Tenure track total","59","20","39","0","0","0","6","2","4","5","2","3","1","0","1","1","0","1","37","14","23","1","0","1","3","0","3","5","2","3","-2"
"174783","Saint Cloud State University","2019","On-tenure track, associate professors","5","3","2","0","0","0","1","1","0","0","0","0","0","0","0","0","0","0","4","2","2","0","0","0","0","0","0","0","0","0","-2"
"174783","Saint Cloud State University","2019","On-tenure track, assistant professors","54","17","37","0","0","0","5","1","4","5","2","3","1","0","1","1","0","1","33","12","21","1","0","1","3","0","3","5","2","3","-2"
"174783","Saint Cloud State University","2019","Not on tenure track/No tenure system system total","53","23","30","0","0","0","6","4","2","1","0","1","0","0","0","0","0","0","44","17","27","0","0","0","1","1","0","1","1","0","-2"
"174783","Saint Cloud State University","2019","Not on tenure/no tenure system, associate professors","3","0","3","0","0","0","0","0","0","0","0","0","0","0","0","0","0","0","3","0","3","0","0","0","0","0","0","0","0","0","-2"
"174783","Saint Cloud State University","2019","Not on tenure/no tenure system, assistant professors","35","16","19","0","0","0","4","3","1","1","0","1","0","0","0","0","0","0","29","12","17","0","0","0","1","1","0","0","0","0","-2"
"174783","Saint Cloud State University","2019","Not on tenure/no tenure system, instructors","15","7","8","0","0","0","2","1","1","0","0","0","0","0","0","0","0","0","12","5","7","0","0","0","0","0","0","1","1","0","-2"
"175856","Jackson State University","2019","Tenured total","157","96","61","1","1","0","27","24","3","90","42","48","1","1","0","0","0","0","30","21","9","0","0","0","0","0","0","8","7","1","-2"
"175856","Jackson State University","2019","Tenured, professors","84","57","27","1","1","0","17","14","3","44","25","19","1","1","0","0","0","0","17","12","5","0","0","0","0","0","0","4","4","0","-2"
"175856","Jackson State University","2019","Tenured, associate professors","67","35","32","0","0","0","10","10","0","41","14","27","0","0","0","0","0","0","12","8","4","0","0","0","0","0","0","4","3","1","-2"
"175856","Jackson State University","2019","Tenured, assistant professors","6","4","2","0","0","0","0","0","0","5","3","2","0","0","0","0","0","0","1","1","0","0","0","0","0","0","0","0","0","0","-2"
"175856","Jackson State University","2019","On-Tenure track total","54","24","30","0","0","0","5","3","2","29","8","21","2","2","0","0","0","0","6","3","3","1","1","0","0","0","0","11","7","4","-2"
"175856","Jackson State University","2019","On-tenure track, professors","1","1","0","0","0","0","0","0","0","0","0","0","0","0","0","0","0","0","1","1","0","0","0","0","0","0","0","0","0","0","-2"
"175856","Jackson State University","2019","On-tenure track, associate professors","7","4","3","0","0","0","0","0","0","3","1","2","1","1","0","0","0","0","1","0","1","0","0","0","0","0","0","2","2","0","-2"
"175856","Jackson State University","2019","On-tenure track, assistant professors","46","19","27","0","0","0","5","3","2","26","7","19","1","1","0","0","0","0","4","2","2","1","1","0","0","0","0","9","5","4","-2"
"175856","Jackson State University","2019","Not on tenure track/No tenure system system total","127","47","80","0","0","0","9","4","5","94","33","61","1","0","1","0","0","0","20","9","11","0","0","0","0","0","0","3","1","2","-2"
"175856","Jackson State University","2019","Not on tenure/no tenure system, professors","2","1","1","0","0","0","0","0","0","1","0","1","0","0","0","0","0","0","1","1","0","0","0","0","0","0","0","0","0","0","-2"
"175856","Jackson State University","2019","Not on tenure/no tenure system, associate professors","8","5","3","0","0","0","0","0","0","8","5","3","0","0","0","0","0","0","0","0","0","0","0","0","0","0","0","0","0","0","-2"
"175856","Jackson State University","2019","Not on tenure/no tenure system, assistant professors","41","16","25","0","0","0","5","4","1","27","9","18","0","0","0","0","0","0","8","3","5","0","0","0","0","0","0","1","0","1","-2"
"175856","Jackson State University","2019","Not on tenure/no tenure system, instructors","65","21","44","0","0","0","4","0","4","47","15","32","1","0","1","0","0","0","11","5","6","0","0","0","0","0","0","2","1","1","-2"
"175856","Jackson State University","2019","Not on tenure/no tenure system, lecturers","11","4","7","0","0","0","0","0","0","11","4","7","0","0","0","0","0","0","0","0","0","0","0","0","0","0","0","0","0","0","-2"
"176017","University of Mississippi","2019","Tenured total","632","417","215","2","1","1","56","42","14","45","22","23","9","8","1","1","0","1","494","324","170","19","16","3","0","0","0","6","4","2","-2"
"176017","University of Mississippi","2019","Tenured, professors","355","245","110","1","1","0","33","27","6","23","12","11","4","4","0","0","0","0","281","189","92","13","12","1","0","0","0","0","0","0","-2"
"176017","University of Mississippi","2019","Tenured, associate professors","274","171","103","1","0","1","22","14","8","22","10","12","5","4","1","1","0","1","211","135","76","6","4","2","0","0","0","6","4","2","-2"
"176017","University of Mississippi","2019","Tenured, assistant professors","3","1","2","0","0","0","1","1","0","0","0","0","0","0","0","0","0","0","2","0","2","0","0","0","0","0","0","0","0","0","-2"
"176017","University of Mississippi","2019","On-Tenure track total","308","185","123","0","0","0","37","25","12","19","7","12","14","7","7","0","0","0","181","109","72","5","3","2","3","3","0","49","31","18","-2"
"176017","University of Mississippi","2019","On-tenure track, professors","21","14","7","0","0","0","6","4","2","1","1","0","1","0","1","0","0","0","12","8","4","0","0","0","0","0","0","1","1","0","-2"
"176017","University of Mississippi","2019","On-tenure track, associate professors","48","27","21","0","0","0","6","3","3","3","1","2","4","2","2","0","0","0","33","19","14","0","0","0","0","0","0","2","2","0","-2"
"176017","University of Mississippi","2019","On-tenure track, assistant professors","238","143","95","0","0","0","25","18","7","15","5","10","9","5","4","0","0","0","136","82","54","5","3","2","3","3","0","45","27","18","-2"
"176017","University of Mississippi","2019","On-tenure track, instructors","1","1","0","0","0","0","0","0","0","0","0","0","0","0","0","0","0","0","0","0","0","0","0","0","0","0","0","1","1","0","-2"
"176017","University of Mississippi","2019","Not on tenure track/No tenure system system total","953","433","520","2","2","0","65","32","33","75","25","50","34","14","20","0","0","0","677","306","371","8","5","3","7","3","4","85","46","39","-2"
"176017","University of Mississippi","2019","Not on tenure/no tenure system, professors","100","67","33","1","1","0","11","8","3","5","3","2","2","1","1","0","0","0","80","53","27","1","1","0","0","0","0","0","0","0","-2"
"176017","University of Mississippi","2019","Not on tenure/no tenure system, associate professors","158","82","76","0","0","0","17","12","5","17","5","12","6","1","5","0","0","0","115","63","52","0","0","0","0","0","0","3","1","2","-2"
"176017","University of Mississippi","2019","Not on tenure/no tenure system, assistant professors","391","184","207","0","0","0","27","8","19","32","11","21","12","7","5","0","0","0","247","111","136","2","2","0","6","3","3","65","42","23","-2"
"176017","University of Mississippi","2019","Not on tenure/no tenure system, instructors","256","81","175","0","0","0","10","4","6","19","6","13","11","4","7","0","0","0","194","62","132","4","2","2","1","0","1","17","3","14","-2"
"176017","University of Mississippi","2019","Not on tenure/no tenure system, lecturers","48","19","29","1","1","0","0","0","0","2","0","2","3","1","2","0","0","0","41","17","24","1","0","1","0","0","0","0","0","0","-2"
"176044","Mississippi Valley State University","2019","Tenured total","51","26","25","0","0","0","9","8","1","31","14","17","0","0","0","0","0","0","9","4","5","0","0","0","2","0","2","0","0","0","-2"
"176044","Mississippi Valley State University","2019","Tenured, professors","21","13","8","0","0","0","7","6","1","8","5","3","0","0","0","0","0","0","5","2","3","0","0","0","1","0","1","0","0","0","-2"
"176044","Mississippi Valley State University","2019","Tenured, associate professors","16","8","8","0","0","0","1","1","0","10","5","5","0","0","0","0","0","0","4","2","2","0","0","0","1","0","1","0","0","0","-2"
"176044","Mississippi Valley State University","2019","Tenured, assistant professors","14","5","9","0","0","0","1","1","0","13","4","9","0","0","0","0","0","0","0","0","0","0","0","0","0","0","0","0","0","0","-2"
"176044","Mississippi Valley State University","2019","On-Tenure track total","28","10","18","0","0","0","2","1","1","20","5","15","0","0","0","0","0","0","5","3","2","0","0","0","1","1","0","0","0","0","-2"
"176044","Mississippi Valley State University","2019","On-tenure track, associate professors","3","2","1","0","0","0","1","1","0","2","1","1","0","0","0","0","0","0","0","0","0","0","0","0","0","0","0","0","0","0","-2"
"176044","Mississippi Valley State University","2019","On-tenure track, assistant professors","25","8","17","0","0","0","1","0","1","18","4","14","0","0","0","0","0","0","5","3","2","0","0","0","1","1","0","0","0","0","-2"
"176044","Mississippi Valley State University","2019","Not on tenure track/No tenure system system total","30","14","16","0","0","0","1","1","0","28","13","15","0","0","0","0","0","0","1","0","1","0","0","0","0","0","0","0","0","0","-2"
"176044","Mississippi Valley State University","2019","Not on tenure/no tenure system, instructors","30","14","16","0","0","0","1","1","0","28","13","15","0","0","0","0","0","0","1","0","1","0","0","0","0","0","0","0","0","0","-2"
"176080","Mississippi State University","2019","Tenured total","460","335","125","0","0","0","57","47","10","16","5","11","11","7","4","0","0","0","369","273","96","5","1","4","0","0","0","2","2","0","-2"
"176080","Mississippi State University","2019","Tenured, professors","227","176","51","0","0","0","30","25","5","5","0","5","4","4","0","0","0","0","186","147","39","2","0","2","0","0","0","0","0","0","-2"
"176080","Mississippi State University","2019","Tenured, associate professors","233","159","74","0","0","0","27","22","5","11","5","6","7","3","4","0","0","0","183","126","57","3","1","2","0","0","0","2","2","0","-2"
"176080","Mississippi State University","2019","On-Tenure track total","260","155","105","2","1","1","34","26","8","14","6","8","8","2","6","0","0","0","142","83","59","3","1","2","3","2","1","54","34","20","-2"
"176080","Mississippi State University","2019","On-tenure track, associate professors","11","8","3","0","0","0","1","1","0","0","0","0","0","0","0","0","0","0","6","3","3","0","0","0","1","1","0","3","3","0","-2"
"176080","Mississippi State University","2019","On-tenure track, assistant professors","249","147","102","2","1","1","33","25","8","14","6","8","8","2","6","0","0","0","136","80","56","3","1","2","2","1","1","51","31","20","-2"
"176080","Mississippi State University","2019","Not on tenure track/No tenure system system total","231","75","156","1","1","0","4","2","2","15","5","10","7","1","6","0","0","0","196","60","136","2","2","0","0","0","0","6","4","2","-2"
"176080","Mississippi State University","2019","Not on tenure/no tenure system, professors","1","0","1","0","0","0","0","0","0","0","0","0","0","0","0","0","0","0","1","0","1","0","0","0","0","0","0","0","0","0","-2"
"176080","Mississippi State University","2019","Not on tenure/no tenure system, associate professors","1","0","1","0","0","0","0","0","0","1","0","1","0","0","0","0","0","0","0","0","0","0","0","0","0","0","0","0","0","0","-2"
"176080","Mississippi State University","2019","Not on tenure/no tenure system, assistant professors","17","10","7","0","0","0","1","1","0","1","0","1","0","0","0","0","0","0","10","5","5","1","1","0","0","0","0","4","3","1","-2"
"176080","Mississippi State University","2019","Not on tenure/no tenure system, instructors","151","49","102","1","1","0","2","1","1","10","4","6","2","0","2","0","0","0","134","42","92","1","1","0","0","0","0","1","0","1","-2"
"176080","Mississippi State University","2019","Not on tenure/no tenure system, lecturers","61","16","45","0","0","0","1","0","1","3","1","2","5","1","4","0","0","0","51","13","38","0","0","0","0","0","0","1","1","0","-2"
"178396","University of Missouri-Columbia","2019","Tenured total","661","457","204","3","3","0","109","88","21","15","12","3","31","16","15","1","1","0","486","326","160","4","4","0","9","5","4","3","2","1","-2"
"178396","University of Missouri-Columbia","2019","Tenured, professors","339","257","82","1","1","0","69","62","7","7","5","2","11","7","4","0","0","0","243","176","67","4","4","0","4","2","2","0","0","0","-2"
"178396","University of Missouri-Columbia","2019","Tenured, associate professors","322","200","122","2","2","0","40","26","14","8","7","1","20","9","11","1","1","0","243","150","93","0","0","0","5","3","2","3","2","1","-2"
"178396","University of Missouri-Columbia","2019","On-Tenure track total","242","117","125","3","1","2","32","17","15","24","13","11","11","5","6","0","0","0","116","51","65","5","2","3","7","5","2","44","23","21","-2"
"178396","University of Missouri-Columbia","2019","On-tenure track, professors","1","0","1","0","0","0","0","0","0","0","0","0","0","0","0","0","0","0","0","0","0","0","0","0","1","0","1","0","0","0","-2"
"178396","University of Missouri-Columbia","2019","On-tenure track, associate professors","7","3","4","0","0","0","0","0","0","1","1","0","0","0","0","0","0","0","6","2","4","0","0","0","0","0","0","0","0","0","-2"
"178396","University of Missouri-Columbia","2019","On-tenure track, assistant professors","234","114","120","3","1","2","32","17","15","23","12","11","11","5","6","0","0","0","110","49","61","5","2","3","6","5","1","44","23","21","-2"
"178396","University of Missouri-Columbia","2019","Not on tenure track/No tenure system system total","969","493","476","3","0","3","94","58","36","29","14","15","40","19","21","2","0","2","652","311","341","8","5","3","40","18","22","101","68","33","-2"
"178396","University of Missouri-Columbia","2019","Not on tenure/no tenure system, professors","90","50","40","0","0","0","9","7","2","2","1","1","3","2","1","0","0","0","73","39","34","1","0","1","2","1","1","0","0","0","-2"
"178396","University of Missouri-Columbia","2019","Not on tenure/no tenure system, associate professors","218","119","99","1","0","1","21","12","9","5","4","1","6","3","3","1","0","1","174","92","82","2","2","0","4","2","2","4","4","0","-2"
"178396","University of Missouri-Columbia","2019","Not on tenure/no tenure system, assistant professors","420","211","209","0","0","0","43","27","16","15","6","9","16","6","10","1","0","1","269","126","143","5","3","2","19","10","9","52","33","19","-2"
"178396","University of Missouri-Columbia","2019","Not on tenure/no tenure system, instructors","103","41","62","1","0","1","5","3","2","2","1","1","6","3","3","0","0","0","78","28","50","0","0","0","6","2","4","5","4","1","-2"
"178396","University of Missouri-Columbia","2019","Not on tenure/no tenure system, lecturers","9","3","6","0","0","0","0","0","0","0","0","0","0","0","0","0","0","0","7","2","5","0","0","0","0","0","0","2","1","1","-2"
"178396","University of Missouri-Columbia","2019","Not on tenure/no tenure system, no academic rank","129","69","60","1","0","1","16","9","7","5","2","3","9","5","4","0","0","0","51","24","27","0","0","0","9","3","6","38","26","12","-2"
"178411","Missouri University of Science and Technology","2019","Tenured total","202","154","48","1","1","0","53","43","10","8","6","2","4","4","0","0","0","0","126","91","35","2","2","0","0","0","0","8","7","1","-2"
"178411","Missouri University of Science and Technology","2019","Tenured, professors","111","90","21","1","1","0","30","27","3","4","3","1","1","1","0","0","0","0","72","55","17","0","0","0","0","0","0","3","3","0","-2"
"178411","Missouri University of Science and Technology","2019","Tenured, associate professors","91","64","27","0","0","0","23","16","7","4","3","1","3","3","0","0","0","0","54","36","18","2","2","0","0","0","0","5","4","1","-2"
"178411","Missouri University of Science and Technology","2019","On-Tenure track total","77","55","22","0","0","0","20","14","6","2","2","0","1","1","0","0","0","0","30","19","11","0","0","0","3","1","2","21","18","3","-2"
"178411","Missouri University of Science and Technology","2019","On-tenure track, associate professors","2","2","0","0","0","0","0","0","0","0","0","0","0","0","0","0","0","0","1","1","0","0","0","0","0","0","0","1","1","0","-2"
"178411","Missouri University of Science and Technology","2019","On-tenure track, assistant professors","75","53","22","0","0","0","20","14","6","2","2","0","1","1","0","0","0","0","29","18","11","0","0","0","3","1","2","20","17","3","-2"
"178411","Missouri University of Science and Technology","2019","Not on tenure track/No tenure system system total","81","44","37","2","0","2","7","3","4","1","0","1","2","2","0","0","0","0","56","29","27","0","0","0","3","3","0","10","7","3","-2"
"178411","Missouri University of Science and Technology","2019","Not on tenure/no tenure system, professors","8","3","5","0","0","0","0","0","0","0","0","0","0","0","0","0","0","0","8","3","5","0","0","0","0","0","0","0","0","0","-2"
"178411","Missouri University of Science and Technology","2019","Not on tenure/no tenure system, associate professors","25","15","10","0","0","0","3","2","1","1","0","1","1","1","0","0","0","0","19","11","8","0","0","0","0","0","0","1","1","0","-2"
"178411","Missouri University of Science and Technology","2019","Not on tenure/no tenure system, assistant professors","30","15","15","1","0","1","4","1","3","0","0","0","1","1","0","0","0","0","21","10","11","0","0","0","2","2","0","1","1","0","-2"
"178411","Missouri University of Science and Technology","2019","Not on tenure/no tenure system, lecturers","6","4","2","1","0","1","0","0","0","0","0","0","0","0","0","0","0","0","4","3","1","0","0","0","0","0","0","1","1","0","-2"
"178411","Missouri University of Science and Technology","2019","Not on tenure/no tenure system, no academic rank","12","7","5","0","0","0","0","0","0","0","0","0","0","0","0","0","0","0","4","2","2","0","0","0","1","1","0","7","4","3","-2"
"179159","Saint Louis University","2019","Tenured total","499","318","181","0","0","0","47","35","12","21","10","11","18","9","9","0","0","0","387","246","141","9","6","3","3","3","0","14","9","5","-2"
"179159","Saint Louis University","2019","Tenured, professors","278","197","81","0","0","0","28","21","7","6","3","3","9","6","3","0","0","0","221","157","64","5","4","1","3","3","0","6","3","3","-2"
"179159","Saint Louis University","2019","Tenured, associate professors","221","121","100","0","0","0","19","14","5","15","7","8","9","3","6","0","0","0","166","89","77","4","2","2","0","0","0","8","6","2","-2"
"179159","Saint Louis University","2019","On-Tenure track total","142","72","70","0","0","0","14","7","7","6","4","2","3","0","3","0","0","0","92","43","49","4","1","3","1","0","1","22","17","5","-2"
"179159","Saint Louis University","2019","On-tenure track, professors","1","1","0","0","0","0","0","0","0","0","0","0","0","0","0","0","0","0","1","1","0","0","0","0","0","0","0","0","0","0","-2"
"179159","Saint Louis University","2019","On-tenure track, associate professors","16","9","7","0","0","0","2","2","0","0","0","0","1","0","1","0","0","0","12","6","6","0","0","0","0","0","0","1","1","0","-2"
"179159","Saint Louis University","2019","On-tenure track, assistant professors","125","62","63","0","0","0","12","5","7","6","4","2","2","0","2","0","0","0","79","36","43","4","1","3","1","0","1","21","16","5","-2"
"179159","Saint Louis University","2019","Not on tenure track/No tenure system system total","642","311","331","0","0","0","90","39","51","20","8","12","14","9","5","0","0","0","465","226","239","10","4","6","10","5","5","33","20","13","-2"
"179159","Saint Louis University","2019","Not on tenure/no tenure system, professors","94","55","39","0","0","0","12","6","6","2","1","1","0","0","0","0","0","0","76","45","31","0","0","0","1","0","1","3","3","0","-2"
"179159","Saint Louis University","2019","Not on tenure/no tenure system, associate professors","170","85","85","0","0","0","28","11","17","3","2","1","4","3","1","0","0","0","125","65","60","4","0","4","3","2","1","3","2","1","-2"
"179159","Saint Louis University","2019","Not on tenure/no tenure system, assistant professors","333","153","180","0","0","0","44","18","26","12","4","8","8","5","3","0","0","0","230","104","126","6","4","2","6","3","3","27","15","12","-2"
"179159","Saint Louis University","2019","Not on tenure/no tenure system, instructors","45","18","27","0","0","0","6","4","2","3","1","2","2","1","1","0","0","0","34","12","22","0","0","0","0","0","0","0","0","0","-2"
"179867","Washington University in St Louis","2019","Tenured total","960","722","238","1","1","0","132","102","30","41","20","21","27","19","8","0","0","0","755","576","179","4","4","0","0","0","0","0","0","0","-2"
"179867","Washington University in St Louis","2019","Tenured, professors","666","527","139","0","0","0","79","63","16","18","8","10","14","11","3","0","0","0","552","442","110","3","3","0","0","0","0","0","0","0","-2"
"179867","Washington University in St Louis","2019","Tenured, associate professors","294","195","99","1","1","0","53","39","14","23","12","11","13","8","5","0","0","0","203","134","69","1","1","0","0","0","0","0","0","0","-2"
"179867","Washington University in St Louis","2019","On-Tenure track total","378","217","161","0","0","0","90","57","33","20","7","13","16","10","6","1","0","1","243","139","104","6","3","3","0","0","0","2","1","1","-2"
"179867","Washington University in St Louis","2019","On-tenure track, professors","7","6","1","0","0","0","2","2","0","0","0","0","0","0","0","0","0","0","5","4","1","0","0","0","0","0","0","0","0","0","-2"
"179867","Washington University in St Louis","2019","On-tenure track, associate professors","16","9","7","0","0","0","2","1","1","2","2","0","0","0","0","0","0","0","12","6","6","0","0","0","0","0","0","0","0","0","-2"
"179867","Washington University in St Louis","2019","On-tenure track, assistant professors","355","202","153","0","0","0","86","54","32","18","5","13","16","10","6","1","0","1","226","129","97","6","3","3","0","0","0","2","1","1","-2"
"179867","Washington University in St Louis","2019","Not on tenure track/No tenure system system total","345","178","167","0","0","0","44","20","24","13","5","8","14","5","9","0","0","0","264","142","122","4","1","3","0","0","0","6","5","1","-2"
"179867","Washington University in St Louis","2019","Not on tenure/no tenure system, professors","1","1","0","0","0","0","0","0","0","0","0","0","0","0","0","0","0","0","1","1","0","0","0","0","0","0","0","0","0","0","-2"
"179867","Washington University in St Louis","2019","Not on tenure/no tenure system, associate professors","1","1","0","0","0","0","0","0","0","0","0","0","0","0","0","0","0","0","1","1","0","0","0","0","0","0","0","0","0","0","-2"
"179867","Washington University in St Louis","2019","Not on tenure/no tenure system, assistant professors","3","3","0","0","0","0","1","1","0","0","0","0","0","0","0","0","0","0","2","2","0","0","0","0","0","0","0","0","0","0","-2"
"179867","Washington University in St Louis","2019","Not on tenure/no tenure system, instructors","123","71","52","0","0","0","21","13","8","7","3","4","1","0","1","0","0","0","88","51","37","2","1","1","0","0","0","4","3","1","-2"
"179867","Washington University in St Louis","2019","Not on tenure/no tenure system, lecturers","209","98","111","0","0","0","22","6","16","6","2","4","13","5","8","0","0","0","164","83","81","2","0","2","0","0","0","2","2","0","-2"
"179867","Washington University in St Louis","2019","Not on tenure/no tenure system, no academic rank","8","4","4","0","0","0","0","0","0","0","0","0","0","0","0","0","0","0","8","4","4","0","0","0","0","0","0","0","0","0","-2"
"180461","Montana State University","2019","Tenured total","385","246","139","0","0","0","15","9","6","0","0","0","5","3","2","0","0","0","351","224","127","5","4","1","9","6","3","0","0","0","-2"
"180461","Montana State University","2019","Tenured, professors","200","148","52","0","0","0","6","5","1","0","0","0","1","1","0","0","0","0","184","135","49","3","3","0","6","4","2","0","0","0","-2"
"180461","Montana State University","2019","Tenured, associate professors","180","95","85","0","0","0","9","4","5","0","0","0","4","2","2","0","0","0","162","86","76","2","1","1","3","2","1","0","0","0","-2"
"180461","Montana State University","2019","Tenured, instructors","5","3","2","0","0","0","0","0","0","0","0","0","0","0","0","0","0","0","5","3","2","0","0","0","0","0","0","0","0","0","-2"
"180461","Montana State University","2019","On-Tenure track total","198","83","115","0","0","0","8","2","6","1","1","0","3","1","2","0","0","0","156","67","89","4","2","2","5","3","2","21","7","14","-2"
"180461","Montana State University","2019","On-tenure track, professors","5","5","0","0","0","0","1","1","0","0","0","0","0","0","0","0","0","0","4","4","0","0","0","0","0","0","0","0","0","0","-2"
"180461","Montana State University","2019","On-tenure track, associate professors","6","0","6","0","0","0","2","0","2","0","0","0","0","0","0","0","0","0","4","0","4","0","0","0","0","0","0","0","0","0","-2"
"180461","Montana State University","2019","On-tenure track, assistant professors","176","73","103","0","0","0","5","1","4","1","1","0","3","1","2","0","0","0","137","58","79","4","2","2","5","3","2","21","7","14","-2"
"180461","Montana State University","2019","On-tenure track, instructors","11","5","6","0","0","0","0","0","0","0","0","0","0","0","0","0","0","0","11","5","6","0","0","0","0","0","0","0","0","0","-2"
"180461","Montana State University","2019","Not on tenure track/No tenure system system total","168","56","112","1","0","1","1","0","1","0","0","0","3","1","2","0","0","0","156","52","104","1","1","0","3","1","2","3","1","2","-2"
"180461","Montana State University","2019","Not on tenure/no tenure system, instructors","27","9","18","1","0","1","0","0","0","0","0","0","0","0","0","0","0","0","25","8","17","1","1","0","0","0","0","0","0","0","-2"
"180461","Montana State University","2019","Not on tenure/no tenure system, no academic rank","141","47","94","0","0","0","1","0","1","0","0","0","3","1","2","0","0","0","131","44","87","0","0","0","3","1","2","3","1","2","-2"
"181002","Creighton University","2019","Tenured total","332","211","121","1","0","1","25","21","4","9","3","6","10","5","5","0","0","0","280","177","103","2","1","1","3","2","1","2","2","0","-2"
"181002","Creighton University","2019","Tenured, professors","171","118","53","0","0","0","20","17","3","5","1","4","5","2","3","0","0","0","138","97","41","2","1","1","1","0","1","0","0","0","-2"
"181002","Creighton University","2019","Tenured, associate professors","140","80","60","1","0","1","5","4","1","3","1","2","4","2","2","0","0","0","123","69","54","0","0","0","2","2","0","2","2","0","-2"
"181002","Creighton University","2019","Tenured, assistant professors","21","13","8","0","0","0","0","0","0","1","1","0","1","1","0","0","0","0","19","11","8","0","0","0","0","0","0","0","0","0","-2"
"181002","Creighton University","2019","On-Tenure track total","135","66","69","1","1","0","6","3","3","4","1","3","1","1","0","0","0","0","100","48","52","1","1","0","13","5","8","9","6","3","-2"
"181002","Creighton University","2019","On-tenure track, professors","4","2","2","0","0","0","0","0","0","0","0","0","0","0","0","0","0","0","4","2","2","0","0","0","0","0","0","0","0","0","-2"
"181002","Creighton University","2019","On-tenure track, associate professors","17","9","8","1","1","0","1","0","1","1","0","1","0","0","0","0","0","0","7","3","4","0","0","0","4","3","1","3","2","1","-2"
"181002","Creighton University","2019","On-tenure track, assistant professors","113","54","59","0","0","0","5","3","2","3","1","2","1","1","0","0","0","0","89","43","46","1","1","0","9","2","7","5","3","2","-2"
"181002","Creighton University","2019","On-tenure track, instructors","1","1","0","0","0","0","0","0","0","0","0","0","0","0","0","0","0","0","0","0","0","0","0","0","0","0","0","1","1","0","-2"
"181002","Creighton University","2019","Not on tenure track/No tenure system system total","202","77","125","1","1","0","10","5","5","5","2","3","2","0","2","0","0","0","165","59","106","3","1","2","12","6","6","4","3","1","-2"
"181002","Creighton University","2019","Not on tenure/no tenure system, professors","4","3","1","0","0","0","0","0","0","0","0","0","0","0","0","0","0","0","4","3","1","0","0","0","0","0","0","0","0","0","-2"
"181002","Creighton University","2019","Not on tenure/no tenure system, associate professors","30","12","18","0","0","0","0","0","0","0","0","0","1","0","1","0","0","0","28","12","16","0","0","0","1","0","1","0","0","0","-2"
"181002","Creighton University","2019","Not on tenure/no tenure system, assistant professors","116","47","69","0","0","0","6","4","2","4","2","2","1","0","1","0","0","0","92","32","60","2","1","1","8","6","2","3","2","1","-2"
"181002","Creighton University","2019","Not on tenure/no tenure system, instructors","52","15","37","1","1","0","4","1","3","1","0","1","0","0","0","0","0","0","41","12","29","1","0","1","3","0","3","1","1","0","-2"
"181464","University of Nebraska-Lincoln","2019","Tenured total","773","553","220","4","2","2","109","81","28","17","7","10","34","27","7","0","0","0","600","430","170","3","1","2","1","1","0","5","4","1","-2"
"181464","University of Nebraska-Lincoln","2019","Tenured, professors","444","347","97","2","1","1","46","40","6","4","3","1","16","14","2","0","0","0","375","288","87","0","0","0","1","1","0","0","0","0","-2"
"181464","University of Nebraska-Lincoln","2019","Tenured, associate professors","329","206","123","2","1","1","63","41","22","13","4","9","18","13","5","0","0","0","225","142","83","3","1","2","0","0","0","5","4","1","-2"
"181464","University of Nebraska-Lincoln","2019","On-Tenure track total","286","171","115","0","0","0","45","29","16","5","3","2","13","5","8","0","0","0","172","99","73","2","1","1","0","0","0","49","34","15","-2"
"181464","University of Nebraska-Lincoln","2019","On-tenure track, professors","1","0","1","0","0","0","0","0","0","0","0","0","0","0","0","0","0","0","1","0","1","0","0","0","0","0","0","0","0","0","-2"
"181464","University of Nebraska-Lincoln","2019","On-tenure track, associate professors","10","9","1","0","0","0","4","3","1","0","0","0","1","1","0","0","0","0","5","5","0","0","0","0","0","0","0","0","0","0","-2"
"181464","University of Nebraska-Lincoln","2019","On-tenure track, assistant professors","275","162","113","0","0","0","41","26","15","5","3","2","12","4","8","0","0","0","166","94","72","2","1","1","0","0","0","49","34","15","-2"
"181464","University of Nebraska-Lincoln","2019","Not on tenure track/No tenure system system total","282","118","164","1","0","1","18","9","9","5","2","3","10","4","6","0","0","0","232","95","137","1","0","1","0","0","0","15","8","7","-2"
"181464","University of Nebraska-Lincoln","2019","Not on tenure/no tenure system, professors","1","1","0","0","0","0","0","0","0","0","0","0","0","0","0","0","0","0","1","1","0","0","0","0","0","0","0","0","0","0","-2"
"181464","University of Nebraska-Lincoln","2019","Not on tenure/no tenure system, lecturers","275","112","163","1","0","1","18","9","9","5","2","3","10","4","6","0","0","0","228","92","136","1","0","1","0","0","0","12","5","7","-2"
"181464","University of Nebraska-Lincoln","2019","Not on tenure/no tenure system, no academic rank","6","5","1","0","0","0","0","0","0","0","0","0","0","0","0","0","0","0","3","2","1","0","0","0","0","0","0","3","3","0","-2"
"182281","University of Nevada-Las Vegas","2019","Tenured total","482","333","149","3","2","1","92","73","19","21","13","8","23","13","10","0","0","0","340","230","110","2","1","1","1","1","0","0","0","0","-2"
"182281","University of Nevada-Las Vegas","2019","Tenured, professors","289","217","72","2","2","0","50","42","8","14","8","6","13","9","4","0","0","0","209","155","54","0","0","0","1","1","0","0","0","0","-2"
"182281","University of Nevada-Las Vegas","2019","Tenured, associate professors","189","113","76","1","0","1","41","30","11","7","5","2","10","4","6","0","0","0","128","73","55","2","1","1","0","0","0","0","0","0","-2"
"182281","University of Nevada-Las Vegas","2019","Tenured, assistant professors","4","3","1","0","0","0","1","1","0","0","0","0","0","0","0","0","0","0","3","2","1","0","0","0","0","0","0","0","0","0","-2"
"182281","University of Nevada-Las Vegas","2019","On-Tenure track total","193","100","93","1","1","0","53","28","25","9","4","5","15","7","8","1","1","0","100","50","50","5","2","3","1","1","0","8","6","2","-2"
"182281","University of Nevada-Las Vegas","2019","On-tenure track, associate professors","16","5","11","0","0","0","4","1","3","0","0","0","0","0","0","1","1","0","10","3","7","1","0","1","0","0","0","0","0","0","-2"
"182281","University of Nevada-Las Vegas","2019","On-tenure track, assistant professors","177","95","82","1","1","0","49","27","22","9","4","5","15","7","8","0","0","0","90","47","43","4","2","2","1","1","0","8","6","2","-2"
"182281","University of Nevada-Las Vegas","2019","Not on tenure track/No tenure system system total","479","236","243","0","0","0","59","29","30","30","12","18","40","19","21","2","1","1","305","154","151","13","8","5","15","5","10","15","8","7","-2"
"182281","University of Nevada-Las Vegas","2019","Not on tenure/no tenure system, instructors","2","2","0","0","0","0","0","0","0","0","0","0","0","0","0","0","0","0","1","1","0","1","1","0","0","0","0","0","0","0","-2"
"182281","University of Nevada-Las Vegas","2019","Not on tenure/no tenure system, lecturers","73","31","42","0","0","0","4","2","2","2","0","2","8","2","6","0","0","0","57","26","31","2","1","1","0","0","0","0","0","0","-2"
"182281","University of Nevada-Las Vegas","2019","Not on tenure/no tenure system, no academic rank","404","203","201","0","0","0","55","27","28","28","12","16","32","17","15","2","1","1","247","127","120","10","6","4","15","5","10","15","8","7","-2"
"182290","University of Nevada-Reno","2019","Tenured total","380","252","128","1","1","0","51","37","14","4","4","0","17","11","6","0","0","0","301","195","106","4","2","2","0","0","0","2","2","0","-2"
"182290","University of Nevada-Reno","2019","Tenured, professors","201","147","54","1","1","0","26","22","4","1","1","0","3","2","1","0","0","0","166","118","48","3","2","1","0","0","0","1","1","0","-2"
"182290","University of Nevada-Reno","2019","Tenured, associate professors","178","105","73","0","0","0","25","15","10","3","3","0","14","9","5","0","0","0","134","77","57","1","0","1","0","0","0","1","1","0","-2"
"182290","University of Nevada-Reno","2019","Tenured, assistant professors","1","0","1","0","0","0","0","0","0","0","0","0","0","0","0","0","0","0","1","0","1","0","0","0","0","0","0","0","0","0","-2"
"182290","University of Nevada-Reno","2019","On-Tenure track total","296","182","114","2","1","1","43","29","14","7","5","2","24","12","12","2","2","0","171","102","69","4","3","1","0","0","0","43","28","15","-2"
"182290","University of Nevada-Reno","2019","On-tenure track, associate professors","13","11","2","0","0","0","1","1","0","1","1","0","0","0","0","0","0","0","10","9","1","0","0","0","0","0","0","1","0","1","-2"
"182290","University of Nevada-Reno","2019","On-tenure track, assistant professors","283","171","112","2","1","1","42","28","14","6","4","2","24","12","12","2","2","0","161","93","68","4","3","1","0","0","0","42","28","14","-2"
"182290","University of Nevada-Reno","2019","Not on tenure track/No tenure system system total","269","115","154","2","0","2","19","10","9","7","4","3","10","4","6","0","0","0","215","87","128","8","4","4","0","0","0","8","6","2","-2"
"182290","University of Nevada-Reno","2019","Not on tenure/no tenure system, instructors","1","1","0","0","0","0","0","0","0","0","0","0","0","0","0","0","0","0","1","1","0","0","0","0","0","0","0","0","0","0","-2"
"182290","University of Nevada-Reno","2019","Not on tenure/no tenure system, lecturers","166","70","96","2","0","2","10","5","5","4","1","3","8","3","5","0","0","0","129","53","76","6","3","3","0","0","0","7","5","2","-2"
"182290","University of Nevada-Reno","2019","Not on tenure/no tenure system, no academic rank","102","44","58","0","0","0","9","5","4","3","3","0","2","1","1","0","0","0","85","33","52","2","1","1","0","0","0","1","1","0","-2"
"182670","Dartmouth College","2019","Tenured total","427","295","132","2","1","1","32","24","8","12","4","8","19","10","9","0","0","0","352","249","103","9","6","3","0","0","0","1","1","0","-2"
"182670","Dartmouth College","2019","Tenured, professors","284","207","77","1","1","0","21","16","5","2","1","1","10","5","5","0","0","0","245","180","65","5","4","1","0","0","0","0","0","0","-2"
"182670","Dartmouth College","2019","Tenured, associate professors","143","88","55","1","0","1","11","8","3","10","3","7","9","5","4","0","0","0","107","69","38","4","2","2","0","0","0","1","1","0","-2"
"182670","Dartmouth College","2019","On-Tenure track total","160","91","69","1","1","0","16","8","8","3","2","1","8","3","5","1","0","1","113","63","50","4","1","3","0","0","0","14","13","1","-2"
"182670","Dartmouth College","2019","On-tenure track, professors","3","2","1","0","0","0","0","0","0","0","0","0","0","0","0","0","0","0","3","2","1","0","0","0","0","0","0","0","0","0","-2"
"182670","Dartmouth College","2019","On-tenure track, associate professors","35","17","18","0","0","0","5","1","4","0","0","0","6","3","3","1","0","1","22","13","9","1","0","1","0","0","0","0","0","0","-2"
"182670","Dartmouth College","2019","On-tenure track, assistant professors","122","72","50","1","1","0","11","7","4","3","2","1","2","0","2","0","0","0","88","48","40","3","1","2","0","0","0","14","13","1","-2"
"182670","Dartmouth College","2019","Not on tenure track/No tenure system system total","119","60","59","1","0","1","4","2","2","1","0","1","8","2","6","0","0","0","97","53","44","0","0","0","0","0","0","8","3","5","-2"
"182670","Dartmouth College","2019","Not on tenure/no tenure system, professors","22","15","7","0","0","0","1","1","0","1","0","1","2","1","1","0","0","0","18","13","5","0","0","0","0","0","0","0","0","0","-2"
"182670","Dartmouth College","2019","Not on tenure/no tenure system, associate professors","5","3","2","0","0","0","0","0","0","0","0","0","0","0","0","0","0","0","5","3","2","0","0","0","0","0","0","0","0","0","-2"
"182670","Dartmouth College","2019","Not on tenure/no tenure system, assistant professors","7","6","1","0","0","0","0","0","0","0","0","0","0","0","0","0","0","0","7","6","1","0","0","0","0","0","0","0","0","0","-2"
"182670","Dartmouth College","2019","Not on tenure/no tenure system, instructors","12","5","7","0","0","0","0","0","0","0","0","0","0","0","0","0","0","0","12","5","7","0","0","0","0","0","0","0","0","0","-2"
"182670","Dartmouth College","2019","Not on tenure/no tenure system, lecturers","66","27","39","1","0","1","3","1","2","0","0","0","6","1","5","0","0","0","51","23","28","0","0","0","0","0","0","5","2","3","-2"
"182670","Dartmouth College","2019","Not on tenure/no tenure system, no academic rank","7","4","3","0","0","0","0","0","0","0","0","0","0","0","0","0","0","0","4","3","1","0","0","0","0","0","0","3","1","2","-2"
"183044","University of New Hampshire-Main Campus","2019","Tenured total","361","212","149","1","1","0","35","17","18","4","4","0","9","6","3","0","0","0","285","169","116","4","2","2","23","13","10","0","0","0","-2"
"183044","University of New Hampshire-Main Campus","2019","Tenured, professors","182","125","57","0","0","0","11","8","3","0","0","0","3","2","1","0","0","0","154","105","49","2","1","1","12","9","3","0","0","0","-2"
"183044","University of New Hampshire-Main Campus","2019","Tenured, associate professors","179","87","92","1","1","0","24","9","15","4","4","0","6","4","2","0","0","0","131","64","67","2","1","1","11","4","7","0","0","0","-2"
"183044","University of New Hampshire-Main Campus","2019","On-Tenure track total","144","65","79","1","1","0","31","14","17","5","0","5","5","4","1","1","1","0","85","37","48","2","1","1","12","6","6","2","1","1","-2"
"183044","University of New Hampshire-Main Campus","2019","On-tenure track, professors","1","1","0","0","0","0","0","0","0","0","0","0","0","0","0","0","0","0","1","1","0","0","0","0","0","0","0","0","0","0","-2"
"183044","University of New Hampshire-Main Campus","2019","On-tenure track, associate professors","4","2","2","0","0","0","0","0","0","0","0","0","0","0","0","0","0","0","3","1","2","0","0","0","1","1","0","0","0","0","-2"
"183044","University of New Hampshire-Main Campus","2019","On-tenure track, assistant professors","139","62","77","1","1","0","31","14","17","5","0","5","5","4","1","1","1","0","81","35","46","2","1","1","11","5","6","2","1","1","-2"
"183044","University of New Hampshire-Main Campus","2019","Not on tenure track/No tenure system system total","241","89","152","1","1","0","4","4","0","1","1","0","7","5","2","0","0","0","199","67","132","2","0","2","25","9","16","2","2","0","-2"
"183044","University of New Hampshire-Main Campus","2019","Not on tenure/no tenure system, professors","4","2","2","0","0","0","0","0","0","0","0","0","0","0","0","0","0","0","4","2","2","0","0","0","0","0","0","0","0","0","-2"
"183044","University of New Hampshire-Main Campus","2019","Not on tenure/no tenure system, associate professors","22","3","19","0","0","0","0","0","0","0","0","0","0","0","0","0","0","0","20","3","17","0","0","0","2","0","2","0","0","0","-2"
"183044","University of New Hampshire-Main Campus","2019","Not on tenure/no tenure system, assistant professors","43","9","34","0","0","0","1","1","0","0","0","0","1","1","0","0","0","0","36","6","30","0","0","0","5","1","4","0","0","0","-2"
"183044","University of New Hampshire-Main Campus","2019","Not on tenure/no tenure system, lecturers","172","75","97","1","1","0","3","3","0","1","1","0","6","4","2","0","0","0","139","56","83","2","0","2","18","8","10","2","2","0","-2"
"183080","Plymouth State University","2019","Tenured total","114","61","53","0","0","0","8","8","0","1","1","0","2","0","2","0","0","0","97","49","48","0","0","0","6","3","3","0","0","0","-2"
"183080","Plymouth State University","2019","Tenured, professors","70","41","29","0","0","0","4","4","0","1","1","0","1","0","1","0","0","0","59","34","25","0","0","0","5","2","3","0","0","0","-2"
"183080","Plymouth State University","2019","Tenured, associate professors","44","20","24","0","0","0","4","4","0","0","0","0","1","0","1","0","0","0","38","15","23","0","0","0","1","1","0","0","0","0","-2"
"183080","Plymouth State University","2019","On-Tenure track total","35","17","18","1","1","0","5","4","1","0","0","0","0","0","0","0","0","0","26","10","16","0","0","0","3","2","1","0","0","0","-2"
"183080","Plymouth State University","2019","On-tenure track, associate professors","3","1","2","0","0","0","0","0","0","0","0","0","0","0","0","0","0","0","2","0","2","0","0","0","1","1","0","0","0","0","-2"
"183080","Plymouth State University","2019","On-tenure track, assistant professors","31","16","15","1","1","0","5","4","1","0","0","0","0","0","0","0","0","0","23","10","13","0","0","0","2","1","1","0","0","0","-2"
"183080","Plymouth State University","2019","On-tenure track, instructors","1","0","1","0","0","0","0","0","0","0","0","0","0","0","0","0","0","0","1","0","1","0","0","0","0","0","0","0","0","0","-2"
"183080","Plymouth State University","2019","Not on tenure track/No tenure system system total","44","18","26","0","0","0","3","0","3","0","0","0","2","2","0","0","0","0","38","16","22","0","0","0","1","0","1","0","0","0","-2"
"183080","Plymouth State University","2019","Not on tenure/no tenure system, associate professors","4","0","4","0","0","0","0","0","0","0","0","0","0","0","0","0","0","0","4","0","4","0","0","0","0","0","0","0","0","0","-2"
"183080","Plymouth State University","2019","Not on tenure/no tenure system, assistant professors","6","1","5","0","0","0","0","0","0","0","0","0","0","0","0","0","0","0","5","1","4","0","0","0","1","0","1","0","0","0","-2"
"183080","Plymouth State University","2019","Not on tenure/no tenure system, lecturers","34","17","17","0","0","0","3","0","3","0","0","0","2","2","0","0","0","0","29","15","14","0","0","0","0","0","0","0","0","0","-2"
"185262","Kean University","2019","Tenured total","177","81","96","0","0","0","30","11","19","18","8","10","12","6","6","0","0","0","117","56","61","0","0","0","0","0","0","0","0","0","-2"
"185262","Kean University","2019","Tenured, professors","54","25","29","0","0","0","5","4","1","6","3","3","4","1","3","0","0","0","39","17","22","0","0","0","0","0","0","0","0","0","-2"
"185262","Kean University","2019","Tenured, associate professors","67","33","34","0","0","0","14","4","10","6","2","4","4","4","0","0","0","0","43","23","20","0","0","0","0","0","0","0","0","0","-2"
"185262","Kean University","2019","Tenured, assistant professors","56","23","33","0","0","0","11","3","8","6","3","3","4","1","3","0","0","0","35","16","19","0","0","0","0","0","0","0","0","0","-2"
"185262","Kean University","2019","On-Tenure track total","44","24","20","0","0","0","10","8","2","1","0","1","3","3","0","0","0","0","21","9","12","0","0","0","0","0","0","9","4","5","-2"
"185262","Kean University","2019","On-tenure track, assistant professors","44","24","20","0","0","0","10","8","2","1","0","1","3","3","0","0","0","0","21","9","12","0","0","0","0","0","0","9","4","5","-2"
"185262","Kean University","2019","Not on tenure track/No tenure system system total","137","53","84","1","1","0","12","3","9","14","9","5","8","2","6","0","0","0","98","37","61","3","1","2","0","0","0","1","0","1","-2"
"185262","Kean University","2019","Not on tenure/no tenure system, lecturers","137","53","84","1","1","0","12","3","9","14","9","5","8","2","6","0","0","0","98","37","61","3","1","2","0","0","0","1","0","1","-2"
"186131","Princeton University","2019","Tenured total","607","431","176","0","0","0","60","44","16","22","13","9","19","13","6","0","0","0","479","348","131","2","1","1","14","5","9","11","7","4","-2"
"186131","Princeton University","2019","Tenured, professors","492","362","130","0","0","0","48","39","9","19","11","8","11","8","3","0","0","0","392","294","98","1","1","0","13","4","9","8","5","3","-2"
"186131","Princeton University","2019","Tenured, associate professors","115","69","46","0","0","0","12","5","7","3","2","1","8","5","3","0","0","0","87","54","33","1","0","1","1","1","0","3","2","1","-2"
"186131","Princeton University","2019","On-Tenure track total","184","107","77","0","0","0","21","10","11","6","1","5","10","6","4","0","0","0","92","57","35","2","2","0","18","8","10","35","23","12","-2"
"186131","Princeton University","2019","On-tenure track, assistant professors","184","107","77","0","0","0","21","10","11","6","1","5","10","6","4","0","0","0","92","57","35","2","2","0","18","8","10","35","23","12","-2"
"186131","Princeton University","2019","Not on tenure track/No tenure system system total","194","91","103","0","0","0","19","5","14","2","1","1","16","5","11","0","0","0","89","45","44","2","1","1","22","12","10","44","22","22","-2"
"186131","Princeton University","2019","Not on tenure/no tenure system, instructors","18","14","4","0","0","0","1","0","1","0","0","0","0","0","0","0","0","0","2","1","1","1","1","0","0","0","0","14","12","2","-2"
"186131","Princeton University","2019","Not on tenure/no tenure system, lecturers","176","77","99","0","0","0","18","5","13","2","1","1","16","5","11","0","0","0","87","44","43","1","0","1","22","12","10","30","10","20","-2"
"186380","Rutgers University-New Brunswick","2019","Tenured total","1261","825","436","1","1","0","155","114","41","37","11","26","50","34","16","0","0","0","876","584","292","6","4","2","73","39","34","63","38","25","-2"
"186380","Rutgers University-New Brunswick","2019","Tenured, professors","884","637","247","0","0","0","111","87","24","22","9","13","28","25","3","0","0","0","667","476","191","3","3","0","30","21","9","23","16","7","-2"
"186380","Rutgers University-New Brunswick","2019","Tenured, associate professors","377","188","189","1","1","0","44","27","17","15","2","13","22","9","13","0","0","0","209","108","101","3","1","2","43","18","25","40","22","18","-2"
"186380","Rutgers University-New Brunswick","2019","On-Tenure track total","426","234","192","1","1","0","40","21","19","20","9","11","13","6","7","0","0","0","119","66","53","4","1","3","130","63","67","99","67","32","-2"
"186380","Rutgers University-New Brunswick","2019","On-tenure track, professors","41","24","17","0","0","0","0","0","0","0","0","0","1","0","1","0","0","0","21","15","6","1","0","1","16","8","8","2","1","1","-2"
"186380","Rutgers University-New Brunswick","2019","On-tenure track, associate professors","76","40","36","0","0","0","12","6","6","4","3","1","2","2","0","0","0","0","27","12","15","0","0","0","20","10","10","11","7","4","-2"
"186380","Rutgers University-New Brunswick","2019","On-tenure track, assistant professors","309","170","139","1","1","0","28","15","13","16","6","10","10","4","6","0","0","0","71","39","32","3","1","2","94","45","49","86","59","27","-2"
"186380","Rutgers University-New Brunswick","2019","Not on tenure track/No tenure system system total","1761","810","951","1","0","1","310","140","170","81","25","56","70","22","48","1","0","1","783","380","403","15","8","7","380","168","212","120","67","53","-2"
"186380","Rutgers University-New Brunswick","2019","Not on tenure/no tenure system, professors","188","123","65","0","0","0","37","24","13","7","3","4","4","3","1","0","0","0","106","70","36","0","0","0","26","19","7","8","4","4","-2"
"186380","Rutgers University-New Brunswick","2019","Not on tenure/no tenure system, associate professors","365","195","170","0","0","0","74","39","35","21","9","12","13","5","8","1","0","1","190","98","92","2","2","0","40","25","15","24","17","7","-2"
"186380","Rutgers University-New Brunswick","2019","Not on tenure/no tenure system, assistant professors","889","380","509","1","0","1","156","63","93","39","13","26","41","13","28","0","0","0","369","174","195","5","2","3","214","83","131","64","32","32","-2"
"186380","Rutgers University-New Brunswick","2019","Not on tenure/no tenure system, instructors","258","96","162","0","0","0","39","13","26","9","0","9","10","1","9","0","0","0","90","30","60","7","4","3","83","35","48","20","13","7","-2"
"186380","Rutgers University-New Brunswick","2019","Not on tenure/no tenure system, lecturers","61","16","45","0","0","0","4","1","3","5","0","5","2","0","2","0","0","0","28","8","20","1","0","1","17","6","11","4","1","3","-2"
"187967","New Mexico Institute of Mining and Technology","2019","Tenured total","76","62","14","0","0","0","14","14","0","0","0","0","3","3","0","0","0","0","57","43","14","0","0","0","0","0","0","2","2","0","-2"
"187967","New Mexico Institute of Mining and Technology","2019","Tenured, professors","40","33","7","0","0","0","5","5","0","0","0","0","2","2","0","0","0","0","32","25","7","0","0","0","0","0","0","1","1","0","-2"
"187967","New Mexico Institute of Mining and Technology","2019","Tenured, associate professors","36","29","7","0","0","0","9","9","0","0","0","0","1","1","0","0","0","0","25","18","7","0","0","0","0","0","0","1","1","0","-2"
"187967","New Mexico Institute of Mining and Technology","2019","On-Tenure track total","37","31","6","0","0","0","14","11","3","0","0","0","3","3","0","0","0","0","18","15","3","0","0","0","0","0","0","2","2","0","-2"
"187967","New Mexico Institute of Mining and Technology","2019","On-tenure track, associate professors","1","1","0","0","0","0","0","0","0","0","0","0","1","1","0","0","0","0","0","0","0","0","0","0","0","0","0","0","0","0","-2"
"187967","New Mexico Institute of Mining and Technology","2019","On-tenure track, assistant professors","36","30","6","0","0","0","14","11","3","0","0","0","2","2","0","0","0","0","18","15","3","0","0","0","0","0","0","2","2","0","-2"
"187967","New Mexico Institute of Mining and Technology","2019","Not on tenure track/No tenure system system total","16","10","6","0","0","0","4","3","1","0","0","0","2","2","0","0","0","0","9","5","4","0","0","0","0","0","0","1","0","1","-2"
"187967","New Mexico Institute of Mining and Technology","2019","Not on tenure/no tenure system, professors","2","2","0","0","0","0","2","2","0","0","0","0","0","0","0","0","0","0","0","0","0","0","0","0","0","0","0","0","0","0","-2"
"187967","New Mexico Institute of Mining and Technology","2019","Not on tenure/no tenure system, associate professors","1","1","0","0","0","0","0","0","0","0","0","0","0","0","0","0","0","0","1","1","0","0","0","0","0","0","0","0","0","0","-2"
"187967","New Mexico Institute of Mining and Technology","2019","Not on tenure/no tenure system, assistant professors","3","3","0","0","0","0","1","1","0","0","0","0","1","1","0","0","0","0","1","1","0","0","0","0","0","0","0","0","0","0","-2"
"187967","New Mexico Institute of Mining and Technology","2019","Not on tenure/no tenure system, instructors","9","4","5","0","0","0","1","0","1","0","0","0","1","1","0","0","0","0","7","3","4","0","0","0","0","0","0","0","0","0","-2"
"187967","New Mexico Institute of Mining and Technology","2019","Not on tenure/no tenure system, lecturers","1","0","1","0","0","0","0","0","0","0","0","0","0","0","0","0","0","0","0","0","0","0","0","0","0","0","0","1","0","1","-2"
"190150","Columbia University in the City of New York","2019","Tenured total","1172","844","328","2","1","1","169","122","47","44","27","17","29","21","8","0","0","0","884","638","246","6","4","2","27","21","6","11","10","1","-2"
"190150","Columbia University in the City of New York","2019","Tenured, professors","981","722","259","2","1","1","128","96","32","32","20","12","22","17","5","0","0","0","759","556","203","4","3","1","25","20","5","9","9","0","-2"
"190150","Columbia University in the City of New York","2019","Tenured, associate professors","191","122","69","0","0","0","41","26","15","12","7","5","7","4","3","0","0","0","125","82","43","2","1","1","2","1","1","2","1","1","-2"
"190150","Columbia University in the City of New York","2019","On-Tenure track total","578","352","226","0","0","0","104","64","40","25","12","13","36","20","16","0","0","0","281","169","112","6","1","5","21","12","9","105","74","31","-2"
"190150","Columbia University in the City of New York","2019","On-tenure track, professors","41","30","11","0","0","0","10","8","2","0","0","0","0","0","0","0","0","0","20","14","6","0","0","0","1","0","1","10","8","2","-2"
"190150","Columbia University in the City of New York","2019","On-tenure track, associate professors","106","71","35","0","0","0","18","13","5","7","4","3","7","5","2","0","0","0","61","43","18","1","1","0","5","2","3","7","3","4","-2"
"190150","Columbia University in the City of New York","2019","On-tenure track, assistant professors","414","242","172","0","0","0","72","40","32","16","8","8","27","14","13","0","0","0","194","109","85","5","0","5","15","10","5","85","61","24","-2"
"190150","Columbia University in the City of New York","2019","On-tenure track, instructors","6","4","2","0","0","0","1","1","0","0","0","0","0","0","0","0","0","0","3","1","2","0","0","0","0","0","0","2","2","0","-2"
"190150","Columbia University in the City of New York","2019","On-tenure track, lecturers","11","5","6","0","0","0","3","2","1","2","0","2","2","1","1","0","0","0","3","2","1","0","0","0","0","0","0","1","0","1","-2"
"190150","Columbia University in the City of New York","2019","Not on tenure track/No tenure system system total","2602","1218","1384","1","0","1","476","204","272","112","49","63","143","57","86","4","4","0","1663","808","855","22","7","15","76","38","38","105","51","54","-2"
"190150","Columbia University in the City of New York","2019","Not on tenure/no tenure system, professors","408","262","146","0","0","0","43","27","16","20","11","9","17","12","5","0","0","0","313","207","106","3","1","2","7","3","4","5","1","4","-2"
"190150","Columbia University in the City of New York","2019","Not on tenure/no tenure system, associate professors","411","217","194","0","0","0","78","41","37","9","6","3","17","6","11","0","0","0","288","149","139","1","1","0","11","8","3","7","6","1","-2"
"190150","Columbia University in the City of New York","2019","Not on tenure/no tenure system, assistant professors","1200","471","729","0","0","0","262","89","173","62","22","40","81","25","56","2","2","0","706","296","410","13","4","9","41","19","22","33","14","19","-2"
"190150","Columbia University in the City of New York","2019","Not on tenure/no tenure system, instructors","144","58","86","0","0","0","26","11","15","11","2","9","8","2","6","2","2","0","78","33","45","2","1","1","3","1","2","14","6","8","-2"
"190150","Columbia University in the City of New York","2019","Not on tenure/no tenure system, lecturers","439","210","229","1","0","1","67","36","31","10","8","2","20","12","8","0","0","0","278","123","155","3","0","3","14","7","7","46","24","22","-2"
"190415","Cornell University","2019","Tenured total","1056","738","318","4","3","1","124","86","38","39","22","17","39","20","19","0","0","0","835","597","238","2","0","2","2","1","1","11","9","2","-2"
"190415","Cornell University","2019","Tenured, professors","703","528","175","2","2","0","83","61","22","22","13","9","18","9","9","0","0","0","571","437","134","1","0","1","1","1","0","5","5","0","-2"
"190415","Cornell University","2019","Tenured, associate professors","353","210","143","2","1","1","41","25","16","17","9","8","21","11","10","0","0","0","264","160","104","1","0","1","1","0","1","6","4","2","-2"
"190415","Cornell University","2019","On-Tenure track total","344","199","145","1","1","0","40","18","22","17","5","12","19","10","9","0","0","0","191","117","74","5","3","2","1","0","1","70","45","25","-2"
"190415","Cornell University","2019","On-tenure track, professors","8","4","4","0","0","0","0","0","0","0","0","0","1","1","0","0","0","0","7","3","4","0","0","0","0","0","0","0","0","0","-2"
"190415","Cornell University","2019","On-tenure track, associate professors","25","18","7","0","0","0","5","4","1","2","2","0","2","1","1","0","0","0","14","9","5","0","0","0","0","0","0","2","2","0","-2"
"190415","Cornell University","2019","On-tenure track, assistant professors","311","177","134","1","1","0","35","14","21","15","3","12","16","8","8","0","0","0","170","105","65","5","3","2","1","0","1","68","43","25","-2"
"190415","Cornell University","2019","Not on tenure track/No tenure system system total","427","199","228","1","0","1","41","9","32","12","4","8","14","8","6","0","0","0","303","147","156","6","2","4","1","1","0","49","28","21","-2"
"190415","Cornell University","2019","Not on tenure/no tenure system, professors","43","23","20","0","0","0","6","1","5","0","0","0","1","1","0","0","0","0","33","18","15","0","0","0","0","0","0","3","3","0","-2"
"190415","Cornell University","2019","Not on tenure/no tenure system, associate professors","20","6","14","0","0","0","1","0","1","1","0","1","0","0","0","0","0","0","13","4","9","0","0","0","0","0","0","5","2","3","-2"
"190415","Cornell University","2019","Not on tenure/no tenure system, assistant professors","43","21","22","0","0","0","4","2","2","0","0","0","1","1","0","0","0","0","31","11","20","1","1","0","1","1","0","5","5","0","-2"
"190415","Cornell University","2019","Not on tenure/no tenure system, instructors","26","13","13","0","0","0","4","0","4","1","0","1","2","2","0","0","0","0","11","6","5","0","0","0","0","0","0","8","5","3","-2"
"190415","Cornell University","2019","Not on tenure/no tenure system, lecturers","295","136","159","1","0","1","26","6","20","10","4","6","10","4","6","0","0","0","215","108","107","5","1","4","0","0","0","28","13","15","-2"
"190567","CUNY City College","2019","Tenured total","427","275","152","0","0","0","69","49","20","32","16","16","36","18","18","0","0","0","277","183","94","0","0","0","0","0","0","13","9","4","-2"
"190567","CUNY City College","2019","Tenured, professors","235","170","65","0","0","0","38","30","8","14","8","6","18","9","9","0","0","0","162","120","42","0","0","0","0","0","0","3","3","0","-2"
"190567","CUNY City College","2019","Tenured, associate professors","145","83","62","0","0","0","25","16","9","11","6","5","15","7","8","0","0","0","86","49","37","0","0","0","0","0","0","8","5","3","-2"
"190567","CUNY City College","2019","Tenured, assistant professors","10","5","5","0","0","0","2","1","1","1","0","1","1","1","0","0","0","0","6","3","3","0","0","0","0","0","0","0","0","0","-2"
"190567","CUNY City College","2019","Tenured, lecturers","37","17","20","0","0","0","4","2","2","6","2","4","2","1","1","0","0","0","23","11","12","0","0","0","0","0","0","2","1","1","-2"
"190567","CUNY City College","2019","On-Tenure track total","104","59","45","0","0","0","15","11","4","11","6","5","11","4","7","0","0","0","61","34","27","0","0","0","0","0","0","6","4","2","-2"
"190567","CUNY City College","2019","On-tenure track, professors","2","1","1","0","0","0","1","0","1","0","0","0","1","1","0","0","0","0","0","0","0","0","0","0","0","0","0","0","0","0","-2"
"190567","CUNY City College","2019","On-tenure track, associate professors","11","7","4","0","0","0","1","1","0","2","2","0","2","1","1","0","0","0","6","3","3","0","0","0","0","0","0","0","0","0","-2"
"190567","CUNY City College","2019","On-tenure track, assistant professors","84","45","39","0","0","0","13","10","3","7","2","5","8","2","6","0","0","0","50","27","23","0","0","0","0","0","0","6","4","2","-2"
"190567","CUNY City College","2019","On-tenure track, lecturers","7","6","1","0","0","0","0","0","0","2","2","0","0","0","0","0","0","0","5","4","1","0","0","0","0","0","0","0","0","0","-2"
"190567","CUNY City College","2019","Not on tenure track/No tenure system system total","38","16","22","0","0","0","2","0","2","8","2","6","5","2","3","0","0","0","23","12","11","0","0","0","0","0","0","0","0","0","-2"
"190567","CUNY City College","2019","Not on tenure/no tenure system, professors","24","9","15","0","0","0","1","0","1","5","0","5","1","1","0","0","0","0","17","8","9","0","0","0","0","0","0","0","0","0","-2"
"190567","CUNY City College","2019","Not on tenure/no tenure system, associate professors","2","2","0","0","0","0","0","0","0","1","1","0","0","0","0","0","0","0","1","1","0","0","0","0","0","0","0","0","0","0","-2"
"190567","CUNY City College","2019","Not on tenure/no tenure system, assistant professors","2","0","2","0","0","0","0","0","0","1","0","1","1","0","1","0","0","0","0","0","0","0","0","0","0","0","0","0","0","0","-2"
"190567","CUNY City College","2019","Not on tenure/no tenure system, lecturers","10","5","5","0","0","0","1","0","1","1","1","0","3","1","2","0","0","0","5","3","2","0","0","0","0","0","0","0","0","0","-2"
"190576","CUNY Graduate School and University Center","2019","Tenured total","156","88","68","1","0","1","11","7","4","9","5","4","8","3","5","0","0","0","123","70","53","0","0","0","0","0","0","4","3","1","-2"
"190576","CUNY Graduate School and University Center","2019","Tenured, professors","121","73","48","1","0","1","6","5","1","6","5","1","6","3","3","0","0","0","99","58","41","0","0","0","0","0","0","3","2","1","-2"
"190576","CUNY Graduate School and University Center","2019","Tenured, associate professors","32","13","19","0","0","0","5","2","3","3","0","3","2","0","2","0","0","0","21","10","11","0","0","0","0","0","0","1","1","0","-2"
"190576","CUNY Graduate School and University Center","2019","Tenured, assistant professors","2","1","1","0","0","0","0","0","0","0","0","0","0","0","0","0","0","0","2","1","1","0","0","0","0","0","0","0","0","0","-2"
"190576","CUNY Graduate School and University Center","2019","Tenured, lecturers","1","1","0","0","0","0","0","0","0","0","0","0","0","0","0","0","0","0","1","1","0","0","0","0","0","0","0","0","0","0","-2"
"190576","CUNY Graduate School and University Center","2019","On-Tenure track total","38","20","18","0","0","0","6","4","2","4","2","2","3","2","1","0","0","0","24","11","13","0","0","0","0","0","0","1","1","0","-2"
"190576","CUNY Graduate School and University Center","2019","On-tenure track, professors","3","2","1","0","0","0","1","1","0","0","0","0","0","0","0","0","0","0","2","1","1","0","0","0","0","0","0","0","0","0","-2"
"190576","CUNY Graduate School and University Center","2019","On-tenure track, associate professors","13","6","7","0","0","0","3","1","2","1","0","1","1","1","0","0","0","0","8","4","4","0","0","0","0","0","0","0","0","0","-2"
"190576","CUNY Graduate School and University Center","2019","On-tenure track, assistant professors","21","12","9","0","0","0","2","2","0","3","2","1","2","1","1","0","0","0","13","6","7","0","0","0","0","0","0","1","1","0","-2"
"190576","CUNY Graduate School and University Center","2019","On-tenure track, lecturers","1","0","1","0","0","0","0","0","0","0","0","0","0","0","0","0","0","0","1","0","1","0","0","0","0","0","0","0","0","0","-2"
"190576","CUNY Graduate School and University Center","2019","Not on tenure track/No tenure system system total","42","25","17","0","0","0","2","0","2","3","1","2","3","1","2","0","0","0","33","22","11","0","0","0","1","1","0","0","0","0","-2"
"190576","CUNY Graduate School and University Center","2019","Not on tenure/no tenure system, professors","37","23","14","0","0","0","1","0","1","2","1","1","3","1","2","0","0","0","30","20","10","0","0","0","1","1","0","0","0","0","-2"
"190576","CUNY Graduate School and University Center","2019","Not on tenure/no tenure system, associate professors","2","1","1","0","0","0","1","0","1","0","0","0","0","0","0","0","0","0","1","1","0","0","0","0","0","0","0","0","0","0","-2"
"190576","CUNY Graduate School and University Center","2019","Not on tenure/no tenure system, assistant professors","1","0","1","0","0","0","0","0","0","1","0","1","0","0","0","0","0","0","0","0","0","0","0","0","0","0","0","0","0","0","-2"
"190576","CUNY Graduate School and University Center","2019","Not on tenure/no tenure system, lecturers","2","1","1","0","0","0","0","0","0","0","0","0","0","0","0","0","0","0","2","1","1","0","0","0","0","0","0","0","0","0","-2"
"191630","Hobart William Smith Colleges","2019","Tenured total","143","77","66","0","0","0","13","7","6","6","3","3","4","3","1","0","0","0","117","64","53","2","0","2","1","0","1","0","0","0","-2"
"191630","Hobart William Smith Colleges","2019","Tenured, professors","51","34","17","0","0","0","3","2","1","0","0","0","0","0","0","0","0","0","46","32","14","1","0","1","1","0","1","0","0","0","-2"
"191630","Hobart William Smith Colleges","2019","Tenured, associate professors","92","43","49","0","0","0","10","5","5","6","3","3","4","3","1","0","0","0","71","32","39","1","0","1","0","0","0","0","0","0","-2"
"191630","Hobart William Smith Colleges","2019","On-Tenure track total","37","16","21","1","0","1","4","2","2","0","0","0","0","0","0","0","0","0","30","13","17","1","0","1","0","0","0","1","1","0","-2"
"191630","Hobart William Smith Colleges","2019","On-tenure track, assistant professors","37","16","21","1","0","1","4","2","2","0","0","0","0","0","0","0","0","0","30","13","17","1","0","1","0","0","0","1","1","0","-2"
"191630","Hobart William Smith Colleges","2019","Not on tenure track/No tenure system system total","21","12","9","0","0","0","1","1","0","1","1","0","2","2","0","0","0","0","14","7","7","0","0","0","0","0","0","3","1","2","-2"
"191630","Hobart William Smith Colleges","2019","Not on tenure/no tenure system, assistant professors","16","10","6","0","0","0","1","1","0","0","0","0","2","2","0","0","0","0","10","6","4","0","0","0","0","0","0","3","1","2","-2"
"191630","Hobart William Smith Colleges","2019","Not on tenure/no tenure system, instructors","5","2","3","0","0","0","0","0","0","1","1","0","0","0","0","0","0","0","4","1","3","0","0","0","0","0","0","0","0","0","-2"
"193900","New York University","2019","Tenured total","1534","1029","505","0","0","0","189","120","69","67","41","26","78","45","33","1","1","0","1161","794","367","3","2","1","2","1","1","33","25","8","-2"
"193900","New York University","2019","Tenured, professors","1030","736","294","0","0","0","113","83","30","35","24","11","47","32","15","0","0","0","819","584","235","2","1","1","1","1","0","13","11","2","-2"
"193900","New York University","2019","Tenured, associate professors","467","275","192","0","0","0","75","37","38","29","16","13","30","13","17","1","1","0","313","196","117","0","0","0","1","0","1","18","12","6","-2"
"193900","New York University","2019","Tenured, assistant professors","10","5","5","0","0","0","1","0","1","1","1","0","0","0","0","0","0","0","5","1","4","1","1","0","0","0","0","2","2","0","-2"
"193900","New York University","2019","Tenured, no academic rank","27","13","14","0","0","0","0","0","0","2","0","2","1","0","1","0","0","0","24","13","11","0","0","0","0","0","0","0","0","0","-2"
"193900","New York University","2019","On-Tenure track total","430","215","215","1","0","1","61","27","34","28","9","19","20","12","8","0","0","0","213","104","109","5","3","2","9","3","6","93","57","36","-2"
"193900","New York University","2019","On-tenure track, professors","12","6","6","0","0","0","2","2","0","1","1","0","1","1","0","0","0","0","8","2","6","0","0","0","0","0","0","0","0","0","-2"
"193900","New York University","2019","On-tenure track, associate professors","58","35","23","0","0","0","13","5","8","3","0","3","1","1","0","0","0","0","33","22","11","0","0","0","1","0","1","7","7","0","-2"
"193900","New York University","2019","On-tenure track, assistant professors","330","166","164","1","0","1","44","19","25","22","8","14","15","10","5","0","0","0","151","74","77","5","3","2","7","3","4","85","49","36","-2"
"193900","New York University","2019","On-tenure track, no academic rank","30","8","22","0","0","0","2","1","1","2","0","2","3","0","3","0","0","0","21","6","15","0","0","0","1","0","1","1","1","0","-2"
"193900","New York University","2019","Not on tenure track/No tenure system system total","3923","2093","1830","2","2","0","743","347","396","193","82","111","203","93","110","5","3","2","2515","1415","1100","19","11","8","28","16","12","215","124","91","-2"
"193900","New York University","2019","Not on tenure/no tenure system, professors","432","293","139","1","1","0","91","51","40","38","17","21","20","11","9","0","0","0","271","205","66","1","1","0","0","0","0","10","7","3","-2"
"193900","New York University","2019","Not on tenure/no tenure system, associate professors","543","329","214","0","0","0","108","58","50","23","10","13","22","12","10","2","2","0","373","236","137","2","2","0","0","0","0","13","9","4","-2"
"193900","New York University","2019","Not on tenure/no tenure system, assistant professors","1420","702","718","1","1","0","339","153","186","68","30","38","79","37","42","3","1","2","849","433","416","5","1","4","10","6","4","66","40","26","-2"
"193900","New York University","2019","Not on tenure/no tenure system, instructors","316","183","133","0","0","0","79","41","38","9","5","4","22","14","8","0","0","0","198","121","77","1","1","0","0","0","0","7","1","6","-2"
"193900","New York University","2019","Not on tenure/no tenure system, lecturers","226","95","131","0","0","0","27","5","22","3","1","2","15","8","7","0","0","0","152","67","85","2","2","0","3","1","2","24","11","13","-2"
"193900","New York University","2019","Not on tenure/no tenure system, no academic rank","986","491","495","0","0","0","99","39","60","52","19","33","45","11","34","0","0","0","672","353","319","8","4","4","15","9","6","95","56","39","-2"
"196060","SUNY at Albany","2019","Tenured total","384","243","141","1","0","1","73","49","24","16","7","9","19","10","9","0","0","0","274","177","97","0","0","0","0","0","0","1","0","1","-2"
"196060","SUNY at Albany","2019","Tenured, professors","166","117","49","0","0","0","22","16","6","7","3","4","5","4","1","0","0","0","132","94","38","0","0","0","0","0","0","0","0","0","-2"
"196060","SUNY at Albany","2019","Tenured, associate professors","218","126","92","1","0","1","51","33","18","9","4","5","14","6","8","0","0","0","142","83","59","0","0","0","0","0","0","1","0","1","-2"
"196060","SUNY at Albany","2019","On-Tenure track total","168","92","76","0","0","0","37","20","17","11","3","8","8","3","5","0","0","0","92","52","40","0","0","0","0","0","0","20","14","6","-2"
"196060","SUNY at Albany","2019","On-tenure track, associate professors","2","2","0","0","0","0","0","0","0","0","0","0","0","0","0","0","0","0","2","2","0","0","0","0","0","0","0","0","0","0","-2"
"196060","SUNY at Albany","2019","On-tenure track, assistant professors","166","90","76","0","0","0","37","20","17","11","3","8","8","3","5","0","0","0","90","50","40","0","0","0","0","0","0","20","14","6","-2"
"196060","SUNY at Albany","2019","Not on tenure track/No tenure system system total","115","58","57","0","0","0","6","2","4","4","1","3","6","4","2","1","1","0","92","47","45","2","0","2","0","0","0","4","3","1","-2"
"196060","SUNY at Albany","2019","Not on tenure/no tenure system, professors","1","1","0","0","0","0","0","0","0","0","0","0","0","0","0","0","0","0","1","1","0","0","0","0","0","0","0","0","0","0","-2"
"196060","SUNY at Albany","2019","Not on tenure/no tenure system, assistant professors","20","11","9","0","0","0","1","1","0","0","0","0","1","1","0","0","0","0","17","9","8","0","0","0","0","0","0","1","0","1","-2"
"196060","SUNY at Albany","2019","Not on tenure/no tenure system, lecturers","94","46","48","0","0","0","5","1","4","4","1","3","5","3","2","1","1","0","74","37","37","2","0","2","0","0","0","3","3","0","-2"
"196097","Stony Brook University","2019","Tenured total","728","516","212","1","1","0","104","74","30","19","9","10","30","21","9","0","0","0","513","367","146","4","4","0","25","16","9","32","24","8","-2"
"196097","Stony Brook University","2019","Tenured, professors","452","341","111","0","0","0","63","46","17","9","6","3","12","7","5","0","0","0","343","263","80","1","1","0","11","6","5","13","12","1","-2"
"196097","Stony Brook University","2019","Tenured, associate professors","275","175","100","1","1","0","41","28","13","10","3","7","18","14","4","0","0","0","169","104","65","3","3","0","14","10","4","19","12","7","-2"
"196097","Stony Brook University","2019","Tenured, assistant professors","1","0","1","0","0","0","0","0","0","0","0","0","0","0","0","0","0","0","1","0","1","0","0","0","0","0","0","0","0","0","-2"
"196097","Stony Brook University","2019","On-Tenure track total","213","142","71","0","0","0","44","29","15","7","3","4","5","3","2","0","0","0","89","62","27","2","1","1","28","19","9","38","25","13","-2"
"196097","Stony Brook University","2019","On-tenure track, professors","12","10","2","0","0","0","2","2","0","0","0","0","0","0","0","0","0","0","7","5","2","0","0","0","2","2","0","1","1","0","-2"
"196097","Stony Brook University","2019","On-tenure track, associate professors","15","11","4","0","0","0","3","2","1","0","0","0","0","0","0","0","0","0","3","2","1","0","0","0","3","3","0","6","4","2","-2"
"196097","Stony Brook University","2019","On-tenure track, assistant professors","186","121","65","0","0","0","39","25","14","7","3","4","5","3","2","0","0","0","79","55","24","2","1","1","23","14","9","31","20","11","-2"
"196097","Stony Brook University","2019","Not on tenure track/No tenure system system total","969","414","555","1","1","0","176","76","100","51","15","36","37","12","25","1","1","0","634","273","361","5","2","3","37","15","22","27","19","8","-2"
"196097","Stony Brook University","2019","Not on tenure/no tenure system, professors","40","22","18","0","0","0","9","5","4","1","1","0","0","0","0","0","0","0","28","14","14","0","0","0","2","2","0","0","0","0","-2"
"196097","Stony Brook University","2019","Not on tenure/no tenure system, associate professors","179","103","76","0","0","0","23","15","8","6","3","3","5","3","2","1","1","0","136","73","63","1","1","0","1","1","0","6","6","0","-2"
"196097","Stony Brook University","2019","Not on tenure/no tenure system, assistant professors","460","203","257","0","0","0","107","53","54","29","6","23","18","6","12","0","0","0","283","130","153","3","1","2","14","5","9","6","2","4","-2"
"196097","Stony Brook University","2019","Not on tenure/no tenure system, instructors","154","28","126","0","0","0","23","2","21","12","3","9","7","2","5","0","0","0","104","19","85","1","0","1","7","2","5","0","0","0","-2"
"196097","Stony Brook University","2019","Not on tenure/no tenure system, lecturers","136","58","78","1","1","0","14","1","13","3","2","1","7","1","6","0","0","0","83","37","46","0","0","0","13","5","8","15","11","4","-2"
"196121","SUNY College at Brockport","2019","Tenured total","182","94","88","1","0","1","20","15","5","6","4","2","5","3","2","0","0","0","147","70","77","1","1","0","0","0","0","2","1","1","-2"
"196121","SUNY College at Brockport","2019","Tenured, professors","61","36","25","1","0","1","9","6","3","2","1","1","2","1","1","0","0","0","47","28","19","0","0","0","0","0","0","0","0","0","-2"
"196121","SUNY College at Brockport","2019","Tenured, associate professors","119","58","61","0","0","0","11","9","2","4","3","1","3","2","1","0","0","0","98","42","56","1","1","0","0","0","0","2","1","1","-2"
"196121","SUNY College at Brockport","2019","Tenured, assistant professors","2","0","2","0","0","0","0","0","0","0","0","0","0","0","0","0","0","0","2","0","2","0","0","0","0","0","0","0","0","0","-2"
"196121","SUNY College at Brockport","2019","On-Tenure track total","108","48","60","0","0","0","3","2","1","10","5","5","1","1","0","0","0","0","71","27","44","1","0","1","0","0","0","22","13","9","-2"
"196121","SUNY College at Brockport","2019","On-tenure track, associate professors","11","5","6","0","0","0","0","0","0","1","1","0","1","1","0","0","0","0","9","3","6","0","0","0","0","0","0","0","0","0","-2"
"196121","SUNY College at Brockport","2019","On-tenure track, assistant professors","78","39","39","0","0","0","3","2","1","9","4","5","0","0","0","0","0","0","45","21","24","1","0","1","0","0","0","20","12","8","-2"
"196121","SUNY College at Brockport","2019","On-tenure track, instructors","19","4","15","0","0","0","0","0","0","0","0","0","0","0","0","0","0","0","17","3","14","0","0","0","0","0","0","2","1","1","-2"
"196121","SUNY College at Brockport","2019","Not on tenure track/No tenure system system total","51","21","30","0","0","0","2","0","2","1","1","0","1","0","1","0","0","0","46","20","26","0","0","0","0","0","0","1","0","1","-2"
"196121","SUNY College at Brockport","2019","Not on tenure/no tenure system, associate professors","1","0","1","0","0","0","0","0","0","0","0","0","0","0","0","0","0","0","1","0","1","0","0","0","0","0","0","0","0","0","-2"
"196121","SUNY College at Brockport","2019","Not on tenure/no tenure system, assistant professors","5","3","2","0","0","0","0","0","0","0","0","0","0","0","0","0","0","0","5","3","2","0","0","0","0","0","0","0","0","0","-2"
"196121","SUNY College at Brockport","2019","Not on tenure/no tenure system, instructors","1","0","1","0","0","0","0","0","0","0","0","0","0","0","0","0","0","0","1","0","1","0","0","0","0","0","0","0","0","0","-2"
"196121","SUNY College at Brockport","2019","Not on tenure/no tenure system, lecturers","44","18","26","0","0","0","2","0","2","1","1","0","1","0","1","0","0","0","39","17","22","0","0","0","0","0","0","1","0","1","-2"
"196130","SUNY Buffalo State","2019","Tenured total","235","130","105","1","1","0","29","16","13","11","9","2","11","4","7","0","0","0","178","98","80","0","0","0","0","0","0","5","2","3","-2"
"196130","SUNY Buffalo State","2019","Tenured, professors","91","61","30","0","0","0","10","8","2","5","4","1","5","2","3","0","0","0","68","45","23","0","0","0","0","0","0","3","2","1","-2"
"196130","SUNY Buffalo State","2019","Tenured, associate professors","142","68","74","1","1","0","18","8","10","6","5","1","6","2","4","0","0","0","109","52","57","0","0","0","0","0","0","2","0","2","-2"
"196130","SUNY Buffalo State","2019","Tenured, assistant professors","2","1","1","0","0","0","1","0","1","0","0","0","0","0","0","0","0","0","1","1","0","0","0","0","0","0","0","0","0","0","-2"
"196130","SUNY Buffalo State","2019","On-Tenure track total","74","35","39","1","1","0","10","7","3","5","3","2","5","4","1","0","0","0","44","15","29","2","1","1","0","0","0","7","4","3","-2"
"196130","SUNY Buffalo State","2019","On-tenure track, associate professors","12","5","7","0","0","0","1","0","1","1","0","1","0","0","0","0","0","0","10","5","5","0","0","0","0","0","0","0","0","0","-2"
"196130","SUNY Buffalo State","2019","On-tenure track, assistant professors","62","30","32","1","1","0","9","7","2","4","3","1","5","4","1","0","0","0","34","10","24","2","1","1","0","0","0","7","4","3","-2"
"196130","SUNY Buffalo State","2019","Not on tenure track/No tenure system system total","53","19","34","0","0","0","1","0","1","6","1","5","1","0","1","0","0","0","45","18","27","0","0","0","0","0","0","0","0","0","-2"
"196130","SUNY Buffalo State","2019","Not on tenure/no tenure system, professors","1","1","0","0","0","0","0","0","0","0","0","0","0","0","0","0","0","0","1","1","0","0","0","0","0","0","0","0","0","0","-2"
"196130","SUNY Buffalo State","2019","Not on tenure/no tenure system, assistant professors","1","0","1","0","0","0","0","0","0","1","0","1","0","0","0","0","0","0","0","0","0","0","0","0","0","0","0","0","0","0","-2"
"196130","SUNY Buffalo State","2019","Not on tenure/no tenure system, lecturers","51","18","33","0","0","0","1","0","1","5","1","4","1","0","1","0","0","0","44","17","27","0","0","0","0","0","0","0","0","0","-2"
"196185","SUNY Oneonta","2019","Tenured total","158","89","69","0","0","0","22","12","10","7","0","7","3","2","1","0","0","0","125","74","51","0","0","0","0","0","0","1","1","0","-2"
"196185","SUNY Oneonta","2019","Tenured, professors","56","35","21","0","0","0","10","7","3","3","0","3","1","1","0","0","0","0","42","27","15","0","0","0","0","0","0","0","0","0","-2"
"196185","SUNY Oneonta","2019","Tenured, associate professors","93","49","44","0","0","0","11","5","6","4","0","4","2","1","1","0","0","0","75","42","33","0","0","0","0","0","0","1","1","0","-2"
"196185","SUNY Oneonta","2019","Tenured, assistant professors","9","5","4","0","0","0","1","0","1","0","0","0","0","0","0","0","0","0","8","5","3","0","0","0","0","0","0","0","0","0","-2"
"196185","SUNY Oneonta","2019","On-Tenure track total","82","38","44","0","0","0","9","3","6","3","3","0","7","3","4","0","0","0","49","20","29","0","0","0","0","0","0","14","9","5","-2"
"196185","SUNY Oneonta","2019","On-tenure track, associate professors","9","6","3","0","0","0","0","0","0","0","0","0","1","0","1","0","0","0","7","6","1","0","0","0","0","0","0","1","0","1","-2"
"196185","SUNY Oneonta","2019","On-tenure track, assistant professors","73","32","41","0","0","0","9","3","6","3","3","0","6","3","3","0","0","0","42","14","28","0","0","0","0","0","0","13","9","4","-2"
"196185","SUNY Oneonta","2019","Not on tenure track/No tenure system system total","44","25","19","0","0","0","1","1","0","1","1","0","2","1","1","0","0","0","35","19","16","1","1","0","0","0","0","4","2","2","-2"
"196185","SUNY Oneonta","2019","Not on tenure/no tenure system, professors","1","1","0","0","0","0","0","0","0","0","0","0","0","0","0","0","0","0","1","1","0","0","0","0","0","0","0","0","0","0","-2"
"196185","SUNY Oneonta","2019","Not on tenure/no tenure system, assistant professors","5","2","3","0","0","0","0","0","0","0","0","0","0","0","0","0","0","0","1","0","1","0","0","0","0","0","0","4","2","2","-2"
"196185","SUNY Oneonta","2019","Not on tenure/no tenure system, lecturers","38","22","16","0","0","0","1","1","0","1","1","0","2","1","1","0","0","0","33","18","15","1","1","0","0","0","0","0","0","0","-2"
"196194","SUNY College at Oswego","2019","Tenured total","169","100","69","0","0","0","17","14","3","9","4","5","6","4","2","0","0","0","134","77","57","2","0","2","0","0","0","1","1","0","-2"
"196194","SUNY College at Oswego","2019","Tenured, professors","78","50","28","0","0","0","12","11","1","3","2","1","2","1","1","0","0","0","60","36","24","1","0","1","0","0","0","0","0","0","-2"
"196194","SUNY College at Oswego","2019","Tenured, associate professors","81","43","38","0","0","0","4","2","2","6","2","4","3","3","0","0","0","0","66","35","31","1","0","1","0","0","0","1","1","0","-2"
"196194","SUNY College at Oswego","2019","Tenured, assistant professors","10","7","3","0","0","0","1","1","0","0","0","0","1","0","1","0","0","0","8","6","2","0","0","0","0","0","0","0","0","0","-2"
"196194","SUNY College at Oswego","2019","On-Tenure track total","113","48","65","0","0","0","12","3","9","2","1","1","6","4","2","0","0","0","74","30","44","2","0","2","0","0","0","17","10","7","-2"
"196194","SUNY College at Oswego","2019","On-tenure track, professors","1","0","1","0","0","0","0","0","0","0","0","0","0","0","0","0","0","0","1","0","1","0","0","0","0","0","0","0","0","0","-2"
"196194","SUNY College at Oswego","2019","On-tenure track, associate professors","17","6","11","0","0","0","4","0","4","1","1","0","1","1","0","0","0","0","11","4","7","0","0","0","0","0","0","0","0","0","-2"
"196194","SUNY College at Oswego","2019","On-tenure track, assistant professors","92","41","51","0","0","0","8","3","5","1","0","1","5","3","2","0","0","0","59","25","34","2","0","2","0","0","0","17","10","7","-2"
"196194","SUNY College at Oswego","2019","On-tenure track, instructors","3","1","2","0","0","0","0","0","0","0","0","0","0","0","0","0","0","0","3","1","2","0","0","0","0","0","0","0","0","0","-2"
"196194","SUNY College at Oswego","2019","Not on tenure track/No tenure system system total","89","49","40","0","0","0","3","2","1","1","1","0","3","1","2","0","0","0","77","41","36","2","2","0","0","0","0","3","2","1","-2"
"196194","SUNY College at Oswego","2019","Not on tenure/no tenure system, assistant professors","66","36","30","0","0","0","3","2","1","1","1","0","2","1","1","0","0","0","56","28","28","2","2","0","0","0","0","2","2","0","-2"
"196194","SUNY College at Oswego","2019","Not on tenure/no tenure system, instructors","15","8","7","0","0","0","0","0","0","0","0","0","1","0","1","0","0","0","13","8","5","0","0","0","0","0","0","1","0","1","-2"
"196194","SUNY College at Oswego","2019","Not on tenure/no tenure system, lecturers","8","5","3","0","0","0","0","0","0","0","0","0","0","0","0","0","0","0","8","5","3","0","0","0","0","0","0","0","0","0","-2"
"196291","SUNY Maritime College","2019","Tenured total","42","31","11","0","0","0","1","1","0","0","0","0","0","0","0","0","0","0","40","29","11","0","0","0","0","0","0","1","1","0","-2"
"196291","SUNY Maritime College","2019","Tenured, professors","23","18","5","0","0","0","0","0","0","0","0","0","0","0","0","0","0","0","23","18","5","0","0","0","0","0","0","0","0","0","-2"
"196291","SUNY Maritime College","2019","Tenured, associate professors","16","10","6","0","0","0","1","1","0","0","0","0","0","0","0","0","0","0","14","8","6","0","0","0","0","0","0","1","1","0","-2"
"196291","SUNY Maritime College","2019","Tenured, assistant professors","3","3","0","0","0","0","0","0","0","0","0","0","0","0","0","0","0","0","3","3","0","0","0","0","0","0","0","0","0","0","-2"
"196291","SUNY Maritime College","2019","On-Tenure track total","16","10","6","0","0","0","1","1","0","0","0","0","0","0","0","0","0","0","14","8","6","0","0","0","0","0","0","1","1","0","-2"
"196291","SUNY Maritime College","2019","On-tenure track, associate professors","1","1","0","0","0","0","0","0","0","0","0","0","0","0","0","0","0","0","1","1","0","0","0","0","0","0","0","0","0","0","-2"
"196291","SUNY Maritime College","2019","On-tenure track, assistant professors","15","9","6","0","0","0","1","1","0","0","0","0","0","0","0","0","0","0","13","7","6","0","0","0","0","0","0","1","1","0","-2"
"196291","SUNY Maritime College","2019","Not on tenure track/No tenure system system total","34","31","3","0","0","0","2","2","0","4","2","2","1","1","0","0","0","0","26","25","1","1","1","0","0","0","0","0","0","0","-2"
"196291","SUNY Maritime College","2019","Not on tenure/no tenure system, professors","1","1","0","0","0","0","1","1","0","0","0","0","0","0","0","0","0","0","0","0","0","0","0","0","0","0","0","0","0","0","-2"
"196291","SUNY Maritime College","2019","Not on tenure/no tenure system, associate professors","1","1","0","0","0","0","0","0","0","0","0","0","0","0","0","0","0","0","1","1","0","0","0","0","0","0","0","0","0","0","-2"
"196291","SUNY Maritime College","2019","Not on tenure/no tenure system, instructors","1","1","0","0","0","0","0","0","0","0","0","0","0","0","0","0","0","0","1","1","0","0","0","0","0","0","0","0","0","0","-2"
"196291","SUNY Maritime College","2019","Not on tenure/no tenure system, lecturers","31","28","3","0","0","0","1","1","0","4","2","2","1","1","0","0","0","0","24","23","1","1","1","0","0","0","0","0","0","0","-2"
"197869","Appalachian State University","2019","Tenured total","535","297","238","1","0","1","15","10","5","7","7","0","6","2","4","0","0","0","477","261","216","6","2","4","7","6","1","16","9","7","-2"
"197869","Appalachian State University","2019","Tenured, professors","328","190","138","1","0","1","8","6","2","3","3","0","4","1","3","0","0","0","301","171","130","0","0","0","4","4","0","7","5","2","-2"
"197869","Appalachian State University","2019","Tenured, associate professors","207","107","100","0","0","0","7","4","3","4","4","0","2","1","1","0","0","0","176","90","86","6","2","4","3","2","1","9","4","5","-2"
"197869","Appalachian State University","2019","On-Tenure track total","211","106","105","0","0","0","15","11","4","9","3","6","1","0","1","0","0","0","163","85","78","7","2","5","4","0","4","12","5","7","-2"
"197869","Appalachian State University","2019","On-tenure track, associate professors","7","4","3","0","0","0","0","0","0","0","0","0","0","0","0","0","0","0","5","3","2","0","0","0","0","0","0","2","1","1","-2"
"197869","Appalachian State University","2019","On-tenure track, assistant professors","204","102","102","0","0","0","15","11","4","9","3","6","1","0","1","0","0","0","158","82","76","7","2","5","4","0","4","10","4","6","-2"
"197869","Appalachian State University","2019","Not on tenure track/No tenure system system total","268","123","145","0","0","0","5","1","4","2","2","0","2","0","2","0","0","0","248","113","135","1","0","1","4","1","3","6","6","0","-2"
"197869","Appalachian State University","2019","Not on tenure/no tenure system, professors","2","2","0","0","0","0","0","0","0","0","0","0","0","0","0","0","0","0","1","1","0","0","0","0","0","0","0","1","1","0","-2"
"197869","Appalachian State University","2019","Not on tenure/no tenure system, associate professors","1","1","0","0","0","0","0","0","0","0","0","0","0","0","0","0","0","0","1","1","0","0","0","0","0","0","0","0","0","0","-2"
"197869","Appalachian State University","2019","Not on tenure/no tenure system, assistant professors","25","10","15","0","0","0","0","0","0","0","0","0","0","0","0","0","0","0","22","9","13","0","0","0","2","0","2","1","1","0","-2"
"197869","Appalachian State University","2019","Not on tenure/no tenure system, instructors","12","5","7","0","0","0","0","0","0","0","0","0","0","0","0","0","0","0","12","5","7","0","0","0","0","0","0","0","0","0","-2"
"197869","Appalachian State University","2019","Not on tenure/no tenure system, lecturers","202","91","111","0","0","0","5","1","4","1","1","0","2","0","2","0","0","0","188","85","103","1","0","1","2","1","1","3","3","0","-2"
"197869","Appalachian State University","2019","Not on tenure/no tenure system, no academic rank","26","14","12","0","0","0","0","0","0","1","1","0","0","0","0","0","0","0","24","12","12","0","0","0","0","0","0","1","1","0","-2"
"198419","Duke University","2019","Tenured total","1353","999","354","0","0","0","186","136","50","48","28","20","41","28","13","0","0","0","1075","805","270","3","2","1","0","0","0","0","0","0","-2"
"198419","Duke University","2019","Tenured, professors","1007","778","229","0","0","0","128","98","30","28","20","8","26","20","6","0","0","0","824","639","185","1","1","0","0","0","0","0","0","0","-2"
"198419","Duke University","2019","Tenured, associate professors","346","221","125","0","0","0","58","38","20","20","8","12","15","8","7","0","0","0","251","166","85","2","1","1","0","0","0","0","0","0","-2"
"198419","Duke University","2019","On-Tenure track total","323","192","131","0","0","0","66","44","22","19","9","10","21","13","8","1","0","1","211","122","89","5","4","1","0","0","0","0","0","0","-2"
"198419","Duke University","2019","On-tenure track, associate professors","120","65","55","0","0","0","25","14","11","5","2","3","8","6","2","1","0","1","81","43","38","0","0","0","0","0","0","0","0","0","-2"
"198419","Duke University","2019","On-tenure track, assistant professors","203","127","76","0","0","0","41","30","11","14","7","7","13","7","6","0","0","0","130","79","51","5","4","1","0","0","0","0","0","0","-2"
"198419","Duke University","2019","Not on tenure track/No tenure system system total","2383","1203","1180","2","1","1","399","202","197","130","60","70","91","41","50","3","2","1","1736","891","845","22","6","16","0","0","0","0","0","0","-2"
"198419","Duke University","2019","Not on tenure/no tenure system, professors","328","199","129","0","0","0","41","27","14","9","7","2","11","9","2","0","0","0","267","156","111","0","0","0","0","0","0","0","0","0","-2"
"198419","Duke University","2019","Not on tenure/no tenure system, associate professors","466","260","206","0","0","0","75","46","29","25","12","13","12","7","5","0","0","0","351","193","158","3","2","1","0","0","0","0","0","0","-2"
"198419","Duke University","2019","Not on tenure/no tenure system, assistant professors","1054","518","536","2","1","1","197","102","95","68","31","37","38","17","21","1","0","1","731","365","366","17","2","15","0","0","0","0","0","0","-2"
"198419","Duke University","2019","Not on tenure/no tenure system, instructors","387","170","217","0","0","0","69","23","46","21","6","15","21","6","15","2","2","0","272","131","141","2","2","0","0","0","0","0","0","0","-2"
"198419","Duke University","2019","Not on tenure/no tenure system, lecturers","148","56","92","0","0","0","17","4","13","7","4","3","9","2","7","0","0","0","115","46","69","0","0","0","0","0","0","0","0","0","-2"
"199102","North Carolina A & T State University","2019","Tenured total","246","160","86","1","0","1","52","39","13","117","63","54","5","4","1","0","0","0","64","47","17","1","1","0","1","1","0","5","5","0","-2"
"199102","North Carolina A & T State University","2019","Tenured, professors","96","73","23","1","0","1","25","20","5","39","28","11","3","2","1","0","0","0","26","21","5","1","1","0","1","1","0","0","0","0","-2"
"199102","North Carolina A & T State University","2019","Tenured, associate professors","149","87","62","0","0","0","27","19","8","77","35","42","2","2","0","0","0","0","38","26","12","0","0","0","0","0","0","5","5","0","-2"
"199102","North Carolina A & T State University","2019","Tenured, assistant professors","1","0","1","0","0","0","0","0","0","1","0","1","0","0","0","0","0","0","0","0","0","0","0","0","0","0","0","0","0","0","-2"
"199102","North Carolina A & T State University","2019","On-Tenure track total","142","69","73","0","0","0","27","18","9","49","10","39","0","0","0","0","0","0","31","22","9","0","0","0","25","12","13","10","7","3","-2"
"199102","North Carolina A & T State University","2019","On-tenure track, professors","5","5","0","0","0","0","2","2","0","1","1","0","0","0","0","0","0","0","2","2","0","0","0","0","0","0","0","0","0","0","-2"
"199102","North Carolina A & T State University","2019","On-tenure track, associate professors","29","11","18","0","0","0","6","4","2","11","2","9","0","0","0","0","0","0","5","3","2","0","0","0","6","2","4","1","0","1","-2"
"199102","North Carolina A & T State University","2019","On-tenure track, assistant professors","102","48","54","0","0","0","19","12","7","35","6","29","0","0","0","0","0","0","22","15","7","0","0","0","18","9","9","8","6","2","-2"
"199102","North Carolina A & T State University","2019","On-tenure track, lecturers","5","4","1","0","0","0","0","0","0","2","1","1","0","0","0","0","0","0","2","2","0","0","0","0","0","0","0","1","1","0","-2"
"199102","North Carolina A & T State University","2019","On-tenure track, no academic rank","1","1","0","0","0","0","0","0","0","0","0","0","0","0","0","0","0","0","0","0","0","0","0","0","1","1","0","0","0","0","-2"
"199102","North Carolina A & T State University","2019","Not on tenure track/No tenure system system total","71","34","37","1","0","1","2","1","1","43","18","25","2","1","1","0","0","0","18","12","6","0","0","0","2","0","2","3","2","1","-2"
"199102","North Carolina A & T State University","2019","Not on tenure/no tenure system, assistant professors","13","5","8","0","0","0","0","0","0","8","2","6","0","0","0","0","0","0","4","2","2","0","0","0","0","0","0","1","1","0","-2"
"199102","North Carolina A & T State University","2019","Not on tenure/no tenure system, instructors","5","2","3","0","0","0","0","0","0","2","1","1","0","0","0","0","0","0","2","1","1","0","0","0","1","0","1","0","0","0","-2"
"199102","North Carolina A & T State University","2019","Not on tenure/no tenure system, lecturers","15","7","8","0","0","0","1","1","0","10","3","7","1","1","0","0","0","0","2","1","1","0","0","0","0","0","0","1","1","0","-2"
"199102","North Carolina A & T State University","2019","Not on tenure/no tenure system, no academic rank","38","20","18","1","0","1","1","0","1","23","12","11","1","0","1","0","0","0","10","8","2","0","0","0","1","0","1","1","0","1","-2"
"199111","University of North Carolina at Asheville","2019","Tenured total","119","69","50","0","0","0","7","3","4","5","3","2","4","1","3","1","0","1","99","61","38","2","1","1","0","0","0","1","0","1","-2"
"199111","University of North Carolina at Asheville","2019","Tenured, professors","66","42","24","0","0","0","4","2","2","0","0","0","1","1","0","0","0","0","61","39","22","0","0","0","0","0","0","0","0","0","-2"
"199111","University of North Carolina at Asheville","2019","Tenured, associate professors","52","26","26","0","0","0","3","1","2","4","2","2","3","0","3","1","0","1","38","22","16","2","1","1","0","0","0","1","0","1","-2"
"199111","University of North Carolina at Asheville","2019","Tenured, assistant professors","1","1","0","0","0","0","0","0","0","1","1","0","0","0","0","0","0","0","0","0","0","0","0","0","0","0","0","0","0","0","-2"
"199111","University of North Carolina at Asheville","2019","On-Tenure track total","50","24","26","0","0","0","2","0","2","2","2","0","4","1","3","0","0","0","33","17","16","0","0","0","3","1","2","6","3","3","-2"
"199111","University of North Carolina at Asheville","2019","On-tenure track, professors","1","1","0","0","0","0","0","0","0","0","0","0","0","0","0","0","0","0","1","1","0","0","0","0","0","0","0","0","0","0","-2"
"199111","University of North Carolina at Asheville","2019","On-tenure track, associate professors","2","2","0","0","0","0","0","0","0","0","0","0","0","0","0","0","0","0","2","2","0","0","0","0","0","0","0","0","0","0","-2"
"199111","University of North Carolina at Asheville","2019","On-tenure track, assistant professors","47","21","26","0","0","0","2","0","2","2","2","0","4","1","3","0","0","0","30","14","16","0","0","0","3","1","2","6","3","3","-2"
"199111","University of North Carolina at Asheville","2019","Not on tenure track/No tenure system system total","51","25","26","0","0","0","0","0","0","1","1","0","2","1","1","0","0","0","40","19","21","0","0","0","5","3","2","3","1","2","-2"
"199111","University of North Carolina at Asheville","2019","Not on tenure/no tenure system, professors","2","2","0","0","0","0","0","0","0","0","0","0","0","0","0","0","0","0","2","2","0","0","0","0","0","0","0","0","0","0","-2"
"199111","University of North Carolina at Asheville","2019","Not on tenure/no tenure system, assistant professors","2","1","1","0","0","0","0","0","0","0","0","0","0","0","0","0","0","0","0","0","0","0","0","0","2","1","1","0","0","0","-2"
"199111","University of North Carolina at Asheville","2019","Not on tenure/no tenure system, instructors","1","0","1","0","0","0","0","0","0","0","0","0","0","0","0","0","0","0","1","0","1","0","0","0","0","0","0","0","0","0","-2"
"199111","University of North Carolina at Asheville","2019","Not on tenure/no tenure system, lecturers","46","22","24","0","0","0","0","0","0","1","1","0","2","1","1","0","0","0","37","17","20","0","0","0","3","2","1","3","1","2","-2"
"199120","University of North Carolina at Chapel Hill","2019","Tenured total","998","622","376","6","3","3","96","65","31","53","22","31","41","24","17","0","0","0","764","485","279","7","3","4","22","13","9","9","7","2","-2"
"199120","University of North Carolina at Chapel Hill","2019","Tenured, professors","622","411","211","3","2","1","54","43","11","17","9","8","16","7","9","0","0","0","511","337","174","3","2","1","13","8","5","5","3","2","-2"
"199120","University of North Carolina at Chapel Hill","2019","Tenured, associate professors","376","211","165","3","1","2","42","22","20","36","13","23","25","17","8","0","0","0","253","148","105","4","1","3","9","5","4","4","4","0","-2"
"199120","University of North Carolina at Chapel Hill","2019","On-Tenure track total","280","147","133","4","3","1","19","8","11","24","9","15","25","11","14","1","0","1","138","74","64","6","3","3","22","11","11","41","28","13","-2"
"199120","University of North Carolina at Chapel Hill","2019","On-tenure track, associate professors","22","6","16","0","0","0","2","0","2","0","0","0","3","1","2","0","0","0","15","5","10","0","0","0","1","0","1","1","0","1","-2"
"199120","University of North Carolina at Chapel Hill","2019","On-tenure track, assistant professors","255","140","115","4","3","1","17","8","9","24","9","15","22","10","12","1","0","1","122","68","54","6","3","3","19","11","8","40","28","12","-2"
"199120","University of North Carolina at Chapel Hill","2019","On-tenure track, instructors","2","0","2","0","0","0","0","0","0","0","0","0","0","0","0","0","0","0","0","0","0","0","0","0","2","0","2","0","0","0","-2"
"199120","University of North Carolina at Chapel Hill","2019","On-tenure track, lecturers","1","1","0","0","0","0","0","0","0","0","0","0","0","0","0","0","0","0","1","1","0","0","0","0","0","0","0","0","0","0","-2"
"199120","University of North Carolina at Chapel Hill","2019","Not on tenure track/No tenure system system total","602","220","382","7","4","3","34","14","20","41","14","27","32","16","16","0","0","0","433","145","288","5","1","4","33","17","16","17","9","8","-2"
"199120","University of North Carolina at Chapel Hill","2019","Not on tenure/no tenure system, professors","80","41","39","1","1","0","3","3","0","4","3","1","3","2","1","0","0","0","61","28","33","1","0","1","5","2","3","2","2","0","-2"
"199120","University of North Carolina at Chapel Hill","2019","Not on tenure/no tenure system, associate professors","117","42","75","1","1","0","4","2","2","7","2","5","1","1","0","0","0","0","94","32","62","0","0","0","7","3","4","3","1","2","-2"
"199120","University of North Carolina at Chapel Hill","2019","Not on tenure/no tenure system, assistant professors","152","38","114","4","1","3","11","2","9","14","1","13","5","2","3","0","0","0","110","28","82","2","0","2","4","2","2","2","2","0","-2"
"199120","University of North Carolina at Chapel Hill","2019","Not on tenure/no tenure system, instructors","46","10","36","0","0","0","1","1","0","3","0","3","1","0","1","0","0","0","35","6","29","0","0","0","6","3","3","0","0","0","-2"
"199120","University of North Carolina at Chapel Hill","2019","Not on tenure/no tenure system, lecturers","202","86","116","1","1","0","14","5","9","12","8","4","22","11","11","0","0","0","131","50","81","2","1","1","11","7","4","9","3","6","-2"
"199120","University of North Carolina at Chapel Hill","2019","Not on tenure/no tenure system, no academic rank","5","3","2","0","0","0","1","1","0","1","0","1","0","0","0","0","0","0","2","1","1","0","0","0","0","0","0","1","1","0","-2"
"199139","University of North Carolina at Charlotte","2019","Tenured total","529","328","201","0","0","0","82","61","21","35","17","18","19","10","9","0","0","0","367","223","144","1","0","1","0","0","0","25","17","8","-2"
"199139","University of North Carolina at Charlotte","2019","Tenured, professors","247","174","73","0","0","0","45","35","10","10","8","2","9","5","4","0","0","0","181","124","57","0","0","0","0","0","0","2","2","0","-2"
"199139","University of North Carolina at Charlotte","2019","Tenured, associate professors","281","154","127","0","0","0","37","26","11","25","9","16","10","5","5","0","0","0","185","99","86","1","0","1","0","0","0","23","15","8","-2"
"199139","University of North Carolina at Charlotte","2019","Tenured, assistant professors","1","0","1","0","0","0","0","0","0","0","0","0","0","0","0","0","0","0","1","0","1","0","0","0","0","0","0","0","0","0","-2"
"199139","University of North Carolina at Charlotte","2019","On-Tenure track total","213","96","117","0","0","0","25","15","10","19","7","12","7","3","4","0","0","0","113","50","63","1","0","1","7","1","6","41","20","21","-2"
"199139","University of North Carolina at Charlotte","2019","On-tenure track, associate professors","2","1","1","0","0","0","1","1","0","0","0","0","0","0","0","0","0","0","1","0","1","0","0","0","0","0","0","0","0","0","-2"
"199139","University of North Carolina at Charlotte","2019","On-tenure track, assistant professors","211","95","116","0","0","0","24","14","10","19","7","12","7","3","4","0","0","0","112","50","62","1","0","1","7","1","6","41","20","21","-2"
"199139","University of North Carolina at Charlotte","2019","Not on tenure track/No tenure system system total","353","126","227","0","0","0","21","9","12","29","6","23","16","3","13","0","0","0","262","99","163","0","0","0","5","1","4","20","8","12","-2"
"199139","University of North Carolina at Charlotte","2019","Not on tenure/no tenure system, professors","30","14","16","0","0","0","0","0","0","2","1","1","0","0","0","0","0","0","26","11","15","0","0","0","0","0","0","2","2","0","-2"
"199139","University of North Carolina at Charlotte","2019","Not on tenure/no tenure system, associate professors","25","8","17","0","0","0","5","1","4","2","0","2","1","0","1","0","0","0","15","6","9","0","0","0","0","0","0","2","1","1","-2"
"199139","University of North Carolina at Charlotte","2019","Not on tenure/no tenure system, assistant professors","56","20","36","0","0","0","3","3","0","11","1","10","3","2","1","0","0","0","31","11","20","0","0","0","2","1","1","6","2","4","-2"
"199139","University of North Carolina at Charlotte","2019","Not on tenure/no tenure system, lecturers","242","84","158","0","0","0","13","5","8","14","4","10","12","1","11","0","0","0","190","71","119","0","0","0","3","0","3","10","3","7","-2"
"199157","North Carolina Central University","2019","Tenured total","180","102","78","0","0","0","22","13","9","98","53","45","3","2","1","0","0","0","47","26","21","1","0","1","2","1","1","7","7","0","-2"
"199157","North Carolina Central University","2019","Tenured, professors","78","46","32","0","0","0","12","7","5","38","19","19","2","1","1","0","0","0","24","17","7","0","0","0","0","0","0","2","2","0","-2"
"199157","North Carolina Central University","2019","Tenured, associate professors","98","55","43","0","0","0","10","6","4","56","33","23","1","1","0","0","0","0","23","9","14","1","0","1","2","1","1","5","5","0","-2"
"199157","North Carolina Central University","2019","Tenured, assistant professors","4","1","3","0","0","0","0","0","0","4","1","3","0","0","0","0","0","0","0","0","0","0","0","0","0","0","0","0","0","0","-2"
"199157","North Carolina Central University","2019","On-Tenure track total","75","31","44","1","1","0","9","4","5","43","14","29","2","2","0","0","0","0","19","10","9","1","0","1","0","0","0","0","0","0","-2"
"199157","North Carolina Central University","2019","On-tenure track, professors","2","1","1","0","0","0","1","1","0","1","0","1","0","0","0","0","0","0","0","0","0","0","0","0","0","0","0","0","0","0","-2"
"199157","North Carolina Central University","2019","On-tenure track, associate professors","9","1","8","0","0","0","1","0","1","6","0","6","0","0","0","0","0","0","2","1","1","0","0","0","0","0","0","0","0","0","-2"
"199157","North Carolina Central University","2019","On-tenure track, assistant professors","64","29","35","1","1","0","7","3","4","36","14","22","2","2","0","0","0","0","17","9","8","1","0","1","0","0","0","0","0","0","-2"
"199157","North Carolina Central University","2019","Not on tenure track/No tenure system system total","111","43","68","0","0","0","7","2","5","71","28","43","0","0","0","0","0","0","28","10","18","1","0","1","2","1","1","2","2","0","-2"
"199157","North Carolina Central University","2019","Not on tenure/no tenure system, professors","4","1","3","0","0","0","0","0","0","3","0","3","0","0","0","0","0","0","1","1","0","0","0","0","0","0","0","0","0","0","-2"
"199157","North Carolina Central University","2019","Not on tenure/no tenure system, associate professors","6","2","4","0","0","0","1","0","1","3","0","3","0","0","0","0","0","0","2","2","0","0","0","0","0","0","0","0","0","0","-2"
"199157","North Carolina Central University","2019","Not on tenure/no tenure system, assistant professors","15","6","9","0","0","0","2","0","2","8","4","4","0","0","0","0","0","0","4","1","3","0","0","0","0","0","0","1","1","0","-2"
"199157","North Carolina Central University","2019","Not on tenure/no tenure system, instructors","16","8","8","0","0","0","2","2","0","11","5","6","0","0","0","0","0","0","2","0","2","0","0","0","0","0","0","1","1","0","-2"
"199157","North Carolina Central University","2019","Not on tenure/no tenure system, lecturers","52","19","33","0","0","0","2","0","2","34","13","21","0","0","0","0","0","0","13","5","8","1","0","1","2","1","1","0","0","0","-2"
"199157","North Carolina Central University","2019","Not on tenure/no tenure system, no academic rank","18","7","11","0","0","0","0","0","0","12","6","6","0","0","0","0","0","0","6","1","5","0","0","0","0","0","0","0","0","0","-2"
"199193","North Carolina State University at Raleigh","2019","Tenured total","1016","719","297","1","1","0","131","103","28","41","22","19","44","23","21","1","1","0","756","547","209","6","5","1","32","14","18","4","3","1","-2"
"199193","North Carolina State University at Raleigh","2019","Tenured, professors","643","485","158","0","0","0","91","75","16","18","9","9","25","12","13","1","1","0","492","377","115","5","4","1","11","7","4","0","0","0","-2"
"199193","North Carolina State University at Raleigh","2019","Tenured, associate professors","373","234","139","1","1","0","40","28","12","23","13","10","19","11","8","0","0","0","264","170","94","1","1","0","21","7","14","4","3","1","-2"
"199193","North Carolina State University at Raleigh","2019","On-Tenure track total","361","197","164","0","0","0","48","33","15","19","6","13","21","11","10","0","0","0","181","98","83","3","1","2","24","10","14","65","38","27","-2"
"199193","North Carolina State University at Raleigh","2019","On-tenure track, associate professors","21","13","8","0","0","0","6","4","2","0","0","0","1","0","1","0","0","0","10","7","3","1","0","1","1","0","1","2","2","0","-2"
"199193","North Carolina State University at Raleigh","2019","On-tenure track, assistant professors","340","184","156","0","0","0","42","29","13","19","6","13","20","11","9","0","0","0","171","91","80","2","1","1","23","10","13","63","36","27","-2"
"199193","North Carolina State University at Raleigh","2019","Not on tenure track/No tenure system system total","380","158","222","0","0","0","24","9","15","23","11","12","19","8","11","0","0","0","283","117","166","2","0","2","20","9","11","9","4","5","-2"
"199193","North Carolina State University at Raleigh","2019","Not on tenure/no tenure system, professors","32","15","17","0","0","0","0","0","0","1","1","0","3","1","2","0","0","0","26","11","15","0","0","0","2","2","0","0","0","0","-2"
"199193","North Carolina State University at Raleigh","2019","Not on tenure/no tenure system, associate professors","58","25","33","0","0","0","6","2","4","3","1","2","2","2","0","0","0","0","46","19","27","0","0","0","1","1","0","0","0","0","-2"
"199193","North Carolina State University at Raleigh","2019","Not on tenure/no tenure system, assistant professors","109","42","67","0","0","0","11","3","8","10","4","6","4","1","3","0","0","0","70","28","42","0","0","0","7","2","5","7","4","3","-2"
"199193","North Carolina State University at Raleigh","2019","Not on tenure/no tenure system, instructors","1","1","0","0","0","0","0","0","0","0","0","0","0","0","0","0","0","0","1","1","0","0","0","0","0","0","0","0","0","0","-2"
"199193","North Carolina State University at Raleigh","2019","Not on tenure/no tenure system, lecturers","180","75","105","0","0","0","7","4","3","9","5","4","10","4","6","0","0","0","140","58","82","2","0","2","10","4","6","2","0","2","-2"
"199847","Wake Forest University","2019","Tenured total","527","345","182","2","2","0","45","34","11","18","13","5","26","14","12","2","2","0","427","274","153","0","0","0","6","5","1","1","1","0","-2"
"199847","Wake Forest University","2019","Tenured, professors","306","208","98","0","0","0","24","18","6","11","7","4","13","9","4","0","0","0","255","171","84","0","0","0","2","2","0","1","1","0","-2"
"199847","Wake Forest University","2019","Tenured, associate professors","189","110","79","2","2","0","20","15","5","5","4","1","13","5","8","2","2","0","144","80","64","0","0","0","3","2","1","0","0","0","-2"
"199847","Wake Forest University","2019","Tenured, assistant professors","2","2","0","0","0","0","0","0","0","1","1","0","0","0","0","0","0","0","1","1","0","0","0","0","0","0","0","0","0","0","-2"
"199847","Wake Forest University","2019","Tenured, instructors","4","2","2","0","0","0","0","0","0","0","0","0","0","0","0","0","0","0","3","1","2","0","0","0","1","1","0","0","0","0","-2"
"199847","Wake Forest University","2019","Tenured, no academic rank","26","23","3","0","0","0","1","1","0","1","1","0","0","0","0","0","0","0","24","21","3","0","0","0","0","0","0","0","0","0","-2"
"199847","Wake Forest University","2019","On-Tenure track total","183","84","99","0","0","0","28","21","7","15","2","13","11","7","4","1","1","0","109","49","60","2","1","1","4","2","2","13","1","12","-2"
"199847","Wake Forest University","2019","On-tenure track, professors","3","2","1","0","0","0","0","0","0","0","0","0","0","0","0","0","0","0","3","2","1","0","0","0","0","0","0","0","0","0","-2"
"199847","Wake Forest University","2019","On-tenure track, associate professors","16","11","5","0","0","0","6","6","0","0","0","0","2","2","0","0","0","0","7","2","5","1","1","0","0","0","0","0","0","0","-2"
"199847","Wake Forest University","2019","On-tenure track, assistant professors","160","69","91","0","0","0","21","15","6","15","2","13","9","5","4","1","1","0","97","43","54","1","0","1","3","2","1","13","1","12","-2"
"199847","Wake Forest University","2019","On-tenure track, instructors","4","2","2","0","0","0","1","0","1","0","0","0","0","0","0","0","0","0","2","2","0","0","0","0","1","0","1","0","0","0","-2"
"199847","Wake Forest University","2019","Not on tenure track/No tenure system system total","1235","715","520","6","4","2","145","89","56","55","22","33","44","17","27","1","0","1","946","564","382","11","4","7","7","4","3","20","11","9","-2"
"199847","Wake Forest University","2019","Not on tenure/no tenure system, professors","138","106","32","0","0","0","14","12","2","1","1","0","4","2","2","0","0","0","119","91","28","0","0","0","0","0","0","0","0","0","-2"
"199847","Wake Forest University","2019","Not on tenure/no tenure system, associate professors","225","150","75","2","1","1","23","16","7","11","2","9","5","3","2","0","0","0","182","128","54","2","0","2","0","0","0","0","0","0","-2"
"199847","Wake Forest University","2019","Not on tenure/no tenure system, assistant professors","556","289","267","2","2","0","88","48","40","26","11","15","23","9","14","1","0","1","408","214","194","7","4","3","0","0","0","1","1","0","-2"
"199847","Wake Forest University","2019","Not on tenure/no tenure system, instructors","242","126","116","1","1","0","13","7","6","14","7","7","11","3","8","0","0","0","176","95","81","2","0","2","7","4","3","18","9","9","-2"
"199847","Wake Forest University","2019","Not on tenure/no tenure system, lecturers","36","21","15","0","0","0","4","3","1","1","1","0","0","0","0","0","0","0","30","16","14","0","0","0","0","0","0","1","1","0","-2"
"199847","Wake Forest University","2019","Not on tenure/no tenure system, no academic rank","38","23","15","1","0","1","3","3","0","2","0","2","1","0","1","0","0","0","31","20","11","0","0","0","0","0","0","0","0","0","-2"
"200280","University of North Dakota","2019","Tenured total","299","204","95","3","2","1","12","8","4","2","2","0","2","1","1","0","0","0","217","146","71","4","1","3","5","4","1","54","40","14","-2"
"200280","University of North Dakota","2019","Tenured, professors","148","103","45","2","2","0","8","7","1","1","1","0","0","0","0","0","0","0","113","77","36","2","1","1","3","2","1","19","13","6","-2"
"200280","University of North Dakota","2019","Tenured, associate professors","147","98","49","1","0","1","4","1","3","1","1","0","1","0","1","0","0","0","101","67","34","2","0","2","2","2","0","35","27","8","-2"
"200280","University of North Dakota","2019","Tenured, assistant professors","4","3","1","0","0","0","0","0","0","0","0","0","1","1","0","0","0","0","3","2","1","0","0","0","0","0","0","0","0","0","-2"
"200280","University of North Dakota","2019","On-Tenure track total","81","49","32","3","0","3","9","8","1","1","1","0","0","0","0","0","0","0","37","22","15","1","0","1","4","1","3","26","17","9","-2"
"200280","University of North Dakota","2019","On-tenure track, associate professors","3","3","0","0","0","0","0","0","0","0","0","0","0","0","0","0","0","0","1","1","0","0","0","0","0","0","0","2","2","0","-2"
"200280","University of North Dakota","2019","On-tenure track, assistant professors","78","46","32","3","0","3","9","8","1","1","1","0","0","0","0","0","0","0","36","21","15","1","0","1","4","1","3","24","15","9","-2"
"200280","University of North Dakota","2019","Not on tenure track/No tenure system system total","276","134","142","5","1","4","8","1","7","5","3","2","3","1","2","0","0","0","215","105","110","4","1","3","5","3","2","31","19","12","-2"
"200280","University of North Dakota","2019","Not on tenure/no tenure system, professors","6","4","2","0","0","0","0","0","0","0","0","0","0","0","0","0","0","0","5","3","2","0","0","0","1","1","0","0","0","0","-2"
"200280","University of North Dakota","2019","Not on tenure/no tenure system, associate professors","39","17","22","1","0","1","1","0","1","0","0","0","0","0","0","0","0","0","35","16","19","1","0","1","0","0","0","1","1","0","-2"
"200280","University of North Dakota","2019","Not on tenure/no tenure system, assistant professors","100","41","59","3","1","2","5","1","4","3","2","1","1","0","1","0","0","0","75","29","46","2","1","1","3","2","1","8","5","3","-2"
"200280","University of North Dakota","2019","Not on tenure/no tenure system, instructors","69","33","36","1","0","1","2","0","2","2","1","1","2","1","1","0","0","0","55","29","26","0","0","0","1","0","1","6","2","4","-2"
"200280","University of North Dakota","2019","Not on tenure/no tenure system, lecturers","41","27","14","0","0","0","0","0","0","0","0","0","0","0","0","0","0","0","37","26","11","1","0","1","0","0","0","3","1","2","-2"
"200280","University of North Dakota","2019","Not on tenure/no tenure system, no academic rank","21","12","9","0","0","0","0","0","0","0","0","0","0","0","0","0","0","0","8","2","6","0","0","0","0","0","0","13","10","3","-2"
"201885","University of Cincinnati-Main Campus","2019","Tenured total","763","495","268","1","1","0","129","90","39","30","15","15","21","9","12","2","0","2","564","367","197","1","1","0","2","1","1","13","11","2","-2"
"201885","University of Cincinnati-Main Campus","2019","Tenured, professors","435","315","120","0","0","0","81","63","18","10","8","2","11","6","5","0","0","0","330","235","95","0","0","0","1","1","0","2","2","0","-2"
"201885","University of Cincinnati-Main Campus","2019","Tenured, associate professors","325","179","146","1","1","0","48","27","21","20","7","13","10","3","7","2","0","2","231","131","100","1","1","0","1","0","1","11","9","2","-2"
"201885","University of Cincinnati-Main Campus","2019","Tenured, assistant professors","3","1","2","0","0","0","0","0","0","0","0","0","0","0","0","0","0","0","3","1","2","0","0","0","0","0","0","0","0","0","-2"
"201885","University of Cincinnati-Main Campus","2019","On-Tenure track total","219","130","89","0","0","0","30","22","8","19","9","10","9","7","2","0","0","0","126","65","61","2","0","2","1","0","1","32","27","5","-2"
"201885","University of Cincinnati-Main Campus","2019","On-tenure track, professors","4","3","1","0","0","0","1","1","0","0","0","0","0","0","0","0","0","0","3","2","1","0","0","0","0","0","0","0","0","0","-2"
"201885","University of Cincinnati-Main Campus","2019","On-tenure track, associate professors","14","5","9","0","0","0","2","2","0","2","1","1","0","0","0","0","0","0","10","2","8","0","0","0","0","0","0","0","0","0","-2"
"201885","University of Cincinnati-Main Campus","2019","On-tenure track, assistant professors","201","122","79","0","0","0","27","19","8","17","8","9","9","7","2","0","0","0","113","61","52","2","0","2","1","0","1","32","27","5","-2"
"201885","University of Cincinnati-Main Campus","2019","Not on tenure track/No tenure system system total","1223","618","605","1","1","0","148","80","68","53","25","28","34","13","21","0","0","0","905","455","450","12","6","6","17","9","8","53","29","24","-2"
"201885","University of Cincinnati-Main Campus","2019","Not on tenure/no tenure system, professors","151","85","66","0","0","0","19","13","6","6","4","2","3","1","2","0","0","0","120","65","55","0","0","0","0","0","0","3","2","1","-2"
"201885","University of Cincinnati-Main Campus","2019","Not on tenure/no tenure system, associate professors","310","178","132","1","1","0","31","16","15","16","9","7","7","3","4","0","0","0","245","143","102","1","1","0","3","1","2","6","4","2","-2"
"201885","University of Cincinnati-Main Campus","2019","Not on tenure/no tenure system, assistant professors","612","288","324","0","0","0","92","47","45","29","12","17","19","7","12","0","0","0","411","191","220","8","3","5","10","6","4","43","22","21","-2"
"201885","University of Cincinnati-Main Campus","2019","Not on tenure/no tenure system, instructors","144","61","83","0","0","0","5","3","2","2","0","2","5","2","3","0","0","0","124","51","73","3","2","1","4","2","2","1","1","0","-2"
"201885","University of Cincinnati-Main Campus","2019","Not on tenure/no tenure system, no academic rank","6","6","0","0","0","0","1","1","0","0","0","0","0","0","0","0","0","0","5","5","0","0","0","0","0","0","0","0","0","0","-2"
"204796","Ohio State University-Main Campus","2019","Tenured total","1834","1195","639","2","1","1","270","193","77","66","39","27","64","41","23","1","1","0","1294","830","464","11","9","2","67","44","23","59","37","22","-2"
"204796","Ohio State University-Main Campus","2019","Tenured, professors","1053","759","294","1","0","1","151","123","28","24","15","9","37","26","11","0","0","0","757","535","222","8","7","1","38","27","11","37","26","11","-2"
"204796","Ohio State University-Main Campus","2019","Tenured, associate professors","766","430","336","1","1","0","119","70","49","40","24","16","27","15","12","1","1","0","524","289","235","3","2","1","29","17","12","22","11","11","-2"
"204796","Ohio State University-Main Campus","2019","Tenured, assistant professors","14","6","8","0","0","0","0","0","0","2","0","2","0","0","0","0","0","0","12","6","6","0","0","0","0","0","0","0","0","0","-2"
"204796","Ohio State University-Main Campus","2019","Tenured, instructors","1","0","1","0","0","0","0","0","0","0","0","0","0","0","0","0","0","0","1","0","1","0","0","0","0","0","0","0","0","0","-2"
"204796","Ohio State University-Main Campus","2019","On-Tenure track total","650","353","297","1","0","1","107","76","31","35","18","17","38","16","22","0","0","0","331","173","158","13","5","8","50","18","32","75","47","28","-2"
"204796","Ohio State University-Main Campus","2019","On-tenure track, professors","4","3","1","0","0","0","1","1","0","0","0","0","0","0","0","0","0","0","2","1","1","0","0","0","0","0","0","1","1","0","-2"
"204796","Ohio State University-Main Campus","2019","On-tenure track, associate professors","31","24","7","0","0","0","10","8","2","3","3","0","2","0","2","0","0","0","10","9","1","1","1","0","2","0","2","3","3","0","-2"
"204796","Ohio State University-Main Campus","2019","On-tenure track, assistant professors","602","321","281","1","0","1","96","67","29","32","15","17","35","16","19","0","0","0","314","161","153","12","4","8","47","18","29","65","40","25","-2"
"204796","Ohio State University-Main Campus","2019","On-tenure track, instructors","13","5","8","0","0","0","0","0","0","0","0","0","1","0","1","0","0","0","5","2","3","0","0","0","1","0","1","6","3","3","-2"
"204796","Ohio State University-Main Campus","2019","Not on tenure track/No tenure system system total","1777","869","908","1","0","1","282","122","160","73","25","48","59","32","27","2","1","1","1171","580","591","7","2","5","100","57","43","82","50","32","-2"
"204796","Ohio State University-Main Campus","2019","Not on tenure/no tenure system, professors","219","138","81","0","0","0","24","13","11","6","2","4","5","4","1","1","1","0","166","102","64","0","0","0","10","9","1","7","7","0","-2"
"204796","Ohio State University-Main Campus","2019","Not on tenure/no tenure system, associate professors","377","199","178","1","0","1","51","29","22","17","7","10","16","11","5","1","0","1","259","131","128","0","0","0","19","15","4","13","6","7","-2"
"204796","Ohio State University-Main Campus","2019","Not on tenure/no tenure system, assistant professors","1180","531","649","0","0","0","207","80","127","50","16","34","38","17","21","0","0","0","745","346","399","7","2","5","71","33","38","62","37","25","-2"
"204796","Ohio State University-Main Campus","2019","Not on tenure/no tenure system, instructors","1","1","0","0","0","0","0","0","0","0","0","0","0","0","0","0","0","0","1","1","0","0","0","0","0","0","0","0","0","0","-2"
"204857","Ohio University-Main Campus","2019","Tenured total","550","364","186","4","2","2","59","43","16","28","18","10","26","16","10","0","0","0","409","269","140","4","1","3","17","12","5","3","3","0","-2"
"204857","Ohio University-Main Campus","2019","Tenured, professors","272","188","84","1","1","0","31","26","5","9","6","3","13","8","5","0","0","0","211","143","68","2","1","1","5","3","2","0","0","0","-2"
"204857","Ohio University-Main Campus","2019","Tenured, associate professors","276","174","102","3","1","2","28","17","11","19","12","7","13","8","5","0","0","0","196","124","72","2","0","2","12","9","3","3","3","0","-2"
"204857","Ohio University-Main Campus","2019","Tenured, assistant professors","2","2","0","0","0","0","0","0","0","0","0","0","0","0","0","0","0","0","2","2","0","0","0","0","0","0","0","0","0","0","-2"
"204857","Ohio University-Main Campus","2019","On-Tenure track total","181","103","78","0","0","0","17","10","7","7","2","5","5","4","1","0","0","0","105","60","45","3","2","1","35","19","16","9","6","3","-2"
"204857","Ohio University-Main Campus","2019","On-tenure track, associate professors","11","9","2","0","0","0","2","1","1","1","0","1","0","0","0","0","0","0","5","5","0","0","0","0","3","3","0","0","0","0","-2"
"204857","Ohio University-Main Campus","2019","On-tenure track, assistant professors","170","94","76","0","0","0","15","9","6","6","2","4","5","4","1","0","0","0","100","55","45","3","2","1","32","16","16","9","6","3","-2"
"204857","Ohio University-Main Campus","2019","Not on tenure track/No tenure system system total","357","149","208","0","0","0","17","7","10","10","6","4","9","3","6","0","0","0","272","108","164","3","3","0","39","17","22","7","5","2","-2"
"204857","Ohio University-Main Campus","2019","Not on tenure/no tenure system, instructors","8","3","5","0","0","0","1","0","1","0","0","0","0","0","0","0","0","0","6","3","3","0","0","0","1","0","1","0","0","0","-2"
"204857","Ohio University-Main Campus","2019","Not on tenure/no tenure system, lecturers","314","134","180","0","0","0","15","7","8","7","5","2","9","3","6","0","0","0","236","95","141","3","3","0","37","16","21","7","5","2","-2"
"204857","Ohio University-Main Campus","2019","Not on tenure/no tenure system, no academic rank","35","12","23","0","0","0","1","0","1","3","1","2","0","0","0","0","0","0","30","10","20","0","0","0","1","1","0","0","0","0","-2"
"207500","University of Oklahoma-Norman Campus","2019","Tenured total","701","479","222","11","7","4","75","52","23","16","9","7","18","13","5","0","0","0","513","350","163","8","5","3","23","16","7","37","27","10","-2"
"207500","University of Oklahoma-Norman Campus","2019","Tenured, professors","390","284","106","5","3","2","51","40","11","5","2","3","10","7","3","0","0","0","289","209","80","4","2","2","9","7","2","17","14","3","-2"
"207500","University of Oklahoma-Norman Campus","2019","Tenured, associate professors","311","195","116","6","4","2","24","12","12","11","7","4","8","6","2","0","0","0","224","141","83","4","3","1","14","9","5","20","13","7","-2"
"207500","University of Oklahoma-Norman Campus","2019","On-Tenure track total","243","137","106","5","3","2","31","20","11","5","1","4","11","7","4","0","0","0","136","71","65","6","2","4","13","6","7","36","27","9","-2"
"207500","University of Oklahoma-Norman Campus","2019","On-tenure track, associate professors","15","8","7","0","0","0","4","3","1","2","0","2","0","0","0","0","0","0","8","4","4","0","0","0","0","0","0","1","1","0","-2"
"207500","University of Oklahoma-Norman Campus","2019","On-tenure track, assistant professors","228","129","99","5","3","2","27","17","10","3","1","2","11","7","4","0","0","0","128","67","61","6","2","4","13","6","7","35","26","9","-2"
"207500","University of Oklahoma-Norman Campus","2019","Not on tenure track/No tenure system system total","355","173","182","15","7","8","12","6","6","8","5","3","14","2","12","1","0","1","256","124","132","8","4","4","10","6","4","31","19","12","-2"
"207500","University of Oklahoma-Norman Campus","2019","Not on tenure/no tenure system, professors","13","8","5","0","0","0","1","1","0","0","0","0","0","0","0","0","0","0","11","7","4","0","0","0","0","0","0","1","0","1","-2"
"207500","University of Oklahoma-Norman Campus","2019","Not on tenure/no tenure system, associate professors","27","15","12","0","0","0","2","1","1","1","0","1","0","0","0","1","0","1","22","13","9","0","0","0","0","0","0","1","1","0","-2"
"207500","University of Oklahoma-Norman Campus","2019","Not on tenure/no tenure system, assistant professors","66","36","30","3","2","1","4","3","1","1","1","0","1","0","1","0","0","0","51","27","24","1","0","1","3","2","1","2","1","1","-2"
"207500","University of Oklahoma-Norman Campus","2019","Not on tenure/no tenure system, instructors","138","53","85","10","4","6","5","1","4","6","4","2","12","1","11","0","0","0","86","33","53","4","2","2","4","2","2","11","6","5","-2"
"207500","University of Oklahoma-Norman Campus","2019","Not on tenure/no tenure system, lecturers","111","61","50","2","1","1","0","0","0","0","0","0","1","1","0","0","0","0","86","44","42","3","2","1","3","2","1","16","11","5","-2"
"207971","University of Tulsa","2019","Tenured total","183","149","34","5","4","1","15","15","0","2","2","0","4","4","0","0","0","0","147","116","31","0","0","0","0","0","0","10","8","2","-2"
"207971","University of Tulsa","2019","Tenured, professors","103","86","17","3","3","0","9","9","0","1","1","0","2","2","0","0","0","0","86","69","17","0","0","0","0","0","0","2","2","0","-2"
"207971","University of Tulsa","2019","Tenured, associate professors","80","63","17","2","1","1","6","6","0","1","1","0","2","2","0","0","0","0","61","47","14","0","0","0","0","0","0","8","6","2","-2"
"207971","University of Tulsa","2019","On-Tenure track total","54","26","28","1","0","1","9","3","6","2","0","2","0","0","0","0","0","0","38","21","17","2","1","1","0","0","0","2","1","1","-2"
"207971","University of Tulsa","2019","On-tenure track, associate professors","3","3","0","0","0","0","0","0","0","0","0","0","0","0","0","0","0","0","3","3","0","0","0","0","0","0","0","0","0","0","-2"
"207971","University of Tulsa","2019","On-tenure track, assistant professors","51","23","28","1","0","1","9","3","6","2","0","2","0","0","0","0","0","0","35","18","17","2","1","1","0","0","0","2","1","1","-2"
"207971","University of Tulsa","2019","Not on tenure track/No tenure system system total","104","42","62","8","2","6","6","2","4","1","0","1","5","0","5","1","0","1","79","36","43","3","1","2","0","0","0","1","1","0","-2"
"207971","University of Tulsa","2019","Not on tenure/no tenure system, professors","13","4","9","1","0","1","0","0","0","0","0","0","1","0","1","1","0","1","10","4","6","0","0","0","0","0","0","0","0","0","-2"
"207971","University of Tulsa","2019","Not on tenure/no tenure system, associate professors","16","7","9","2","0","2","0","0","0","0","0","0","0","0","0","0","0","0","14","7","7","0","0","0","0","0","0","0","0","0","-2"
"207971","University of Tulsa","2019","Not on tenure/no tenure system, assistant professors","54","22","32","3","2","1","6","2","4","1","0","1","0","0","0","0","0","0","42","17","25","1","0","1","0","0","0","1","1","0","-2"
"207971","University of Tulsa","2019","Not on tenure/no tenure system, instructors","21","9","12","2","0","2","0","0","0","0","0","0","4","0","4","0","0","0","13","8","5","2","1","1","0","0","0","0","0","0","-2"
"209542","Oregon State University","2019","Tenured total","627","431","196","2","2","0","88","64","24","8","5","3","43","31","12","1","1","0","439","296","143","6","5","1","33","21","12","7","6","1","209542"
"209542","Oregon State University","2019","Tenured, professors","354","260","94","0","0","0","44","36","8","5","3","2","18","14","4","1","1","0","266","194","72","1","1","0","18","11","7","1","0","1","209542"
"209542","Oregon State University","2019","Tenured, associate professors","269","169","100","2","2","0","44","28","16","3","2","1","23","16","7","0","0","0","171","101","70","5","4","1","15","10","5","6","6","0","209542"
"209542","Oregon State University","2019","Tenured, assistant professors","1","1","0","0","0","0","0","0","0","0","0","0","1","1","0","0","0","0","0","0","0","0","0","0","0","0","0","0","0","0","209542"
"209542","Oregon State University","2019","Tenured, instructors","3","1","2","0","0","0","0","0","0","0","0","0","1","0","1","0","0","0","2","1","1","0","0","0","0","0","0","0","0","0","209542"
"209542","Oregon State University","2019","On-Tenure track total","244","134","110","1","1","0","21","15","6","3","2","1","6","2","4","0","0","0","131","61","70","4","3","1","38","24","14","40","26","14","209542"
"209542","Oregon State University","2019","On-tenure track, associate professors","16","6","10","0","0","0","0","0","0","0","0","0","0","0","0","0","0","0","14","5","9","0","0","0","0","0","0","2","1","1","209542"
"209542","Oregon State University","2019","On-tenure track, assistant professors","228","128","100","1","1","0","21","15","6","3","2","1","6","2","4","0","0","0","117","56","61","4","3","1","38","24","14","38","25","13","209542"
"209542","Oregon State University","2019","Not on tenure track/No tenure system system total","520","241","279","1","1","0","19","8","11","6","4","2","26","11","15","2","1","1","412","188","224","13","3","10","21","9","12","20","16","4","209542"
"209542","Oregon State University","2019","Not on tenure/no tenure system, professors","2","1","1","0","0","0","0","0","0","0","0","0","0","0","0","0","0","0","1","1","0","1","0","1","0","0","0","0","0","0","209542"
"209542","Oregon State University","2019","Not on tenure/no tenure system, associate professors","17","5","12","0","0","0","2","0","2","0","0","0","2","1","1","0","0","0","12","3","9","0","0","0","0","0","0","1","1","0","209542"
"209542","Oregon State University","2019","Not on tenure/no tenure system, assistant professors","38","17","21","0","0","0","2","1","1","1","1","0","3","1","2","0","0","0","24","8","16","0","0","0","4","2","2","4","4","0","209542"
"209542","Oregon State University","2019","Not on tenure/no tenure system, instructors","463","218","245","1","1","0","15","7","8","5","3","2","21","9","12","2","1","1","375","176","199","12","3","9","17","7","10","15","11","4","209542"
"211361","California University of Pennsylvania","2019","Tenured total","173","89","84","0","0","0","7","4","3","10","4","6","2","2","0","0","0","0","153","79","74","1","0","1","0","0","0","0","0","0","-2"
"211361","California University of Pennsylvania","2019","Tenured, professors","91","47","44","0","0","0","3","3","0","4","1","3","0","0","0","0","0","0","83","43","40","1","0","1","0","0","0","0","0","0","-2"
"211361","California University of Pennsylvania","2019","Tenured, associate professors","61","33","28","0","0","0","4","1","3","4","2","2","1","1","0","0","0","0","52","29","23","0","0","0","0","0","0","0","0","0","-2"
"211361","California University of Pennsylvania","2019","Tenured, assistant professors","20","9","11","0","0","0","0","0","0","2","1","1","1","1","0","0","0","0","17","7","10","0","0","0","0","0","0","0","0","0","-2"
"211361","California University of Pennsylvania","2019","Tenured, instructors","1","0","1","0","0","0","0","0","0","0","0","0","0","0","0","0","0","0","1","0","1","0","0","0","0","0","0","0","0","0","-2"
"211361","California University of Pennsylvania","2019","On-Tenure track total","62","27","35","0","0","0","5","1","4","11","4","7","2","1","1","0","0","0","41","18","23","0","0","0","0","0","0","3","3","0","-2"
"211361","California University of Pennsylvania","2019","On-tenure track, associate professors","12","7","5","0","0","0","2","1","1","1","0","1","0","0","0","0","0","0","8","5","3","0","0","0","0","0","0","1","1","0","-2"
"211361","California University of Pennsylvania","2019","On-tenure track, assistant professors","49","20","29","0","0","0","3","0","3","10","4","6","2","1","1","0","0","0","32","13","19","0","0","0","0","0","0","2","2","0","-2"
"211361","California University of Pennsylvania","2019","On-tenure track, instructors","1","0","1","0","0","0","0","0","0","0","0","0","0","0","0","0","0","0","1","0","1","0","0","0","0","0","0","0","0","0","-2"
"211361","California University of Pennsylvania","2019","Not on tenure track/No tenure system system total","34","17","17","0","0","0","1","1","0","2","0","2","0","0","0","0","0","0","30","15","15","1","1","0","0","0","0","0","0","0","-2"
"211361","California University of Pennsylvania","2019","Not on tenure/no tenure system, associate professors","1","0","1","0","0","0","0","0","0","0","0","0","0","0","0","0","0","0","1","0","1","0","0","0","0","0","0","0","0","0","-2"
"211361","California University of Pennsylvania","2019","Not on tenure/no tenure system, assistant professors","10","6","4","0","0","0","1","1","0","1","0","1","0","0","0","0","0","0","7","4","3","1","1","0","0","0","0","0","0","0","-2"
"211361","California University of Pennsylvania","2019","Not on tenure/no tenure system, instructors","23","11","12","0","0","0","0","0","0","1","0","1","0","0","0","0","0","0","22","11","11","0","0","0","0","0","0","0","0","0","-2"
"212054","Drexel University","2019","Tenured total","505","316","189","1","1","0","86","60","26","21","14","7","14","6","8","1","0","1","345","215","130","4","2","2","17","11","6","16","7","9","-2"
"212054","Drexel University","2019","Tenured, professors","282","205","77","0","0","0","48","42","6","12","8","4","6","3","3","0","0","0","201","142","59","2","1","1","10","8","2","3","1","2","-2"
"212054","Drexel University","2019","Tenured, associate professors","222","110","112","1","1","0","38","18","20","9","6","3","8","3","5","1","0","1","143","72","71","2","1","1","7","3","4","13","6","7","-2"
"212054","Drexel University","2019","Tenured, assistant professors","1","1","0","0","0","0","0","0","0","0","0","0","0","0","0","0","0","0","1","1","0","0","0","0","0","0","0","0","0","0","-2"
"212054","Drexel University","2019","On-Tenure track total","164","94","70","0","0","0","20","12","8","8","3","5","8","6","2","0","0","0","96","53","43","3","0","3","5","1","4","24","19","5","-2"
"212054","Drexel University","2019","On-tenure track, professors","11","9","2","0","0","0","0","0","0","0","0","0","1","1","0","0","0","0","10","8","2","0","0","0","0","0","0","0","0","0","-2"
"212054","Drexel University","2019","On-tenure track, associate professors","18","11","7","0","0","0","3","3","0","0","0","0","0","0","0","0","0","0","15","8","7","0","0","0","0","0","0","0","0","0","-2"
"212054","Drexel University","2019","On-tenure track, assistant professors","135","74","61","0","0","0","17","9","8","8","3","5","7","5","2","0","0","0","71","37","34","3","0","3","5","1","4","24","19","5","-2"
"212054","Drexel University","2019","Not on tenure track/No tenure system system total","756","330","426","1","0","1","60","27","33","36","12","24","21","11","10","1","1","0","564","239","325","5","3","2","19","12","7","49","25","24","-2"
"212054","Drexel University","2019","Not on tenure/no tenure system, instructors","756","330","426","1","0","1","60","27","33","36","12","24","21","11","10","1","1","0","564","239","325","5","3","2","19","12","7","49","25","24","-2"
"213598","Lincoln University","2019","Tenured total","48","34","14","6","6","0","0","0","0","25","18","7","0","0","0","0","0","0","15","8","7","0","0","0","0","0","0","2","2","0","-2"
"213598","Lincoln University","2019","Tenured, professors","25","19","6","1","1","0","0","0","0","16","13","3","0","0","0","0","0","0","6","3","3","0","0","0","0","0","0","2","2","0","-2"
"213598","Lincoln University","2019","Tenured, associate professors","22","14","8","5","5","0","0","0","0","9","5","4","0","0","0","0","0","0","8","4","4","0","0","0","0","0","0","0","0","0","-2"
"213598","Lincoln University","2019","Tenured, assistant professors","1","1","0","0","0","0","0","0","0","0","0","0","0","0","0","0","0","0","1","1","0","0","0","0","0","0","0","0","0","0","-2"
"213598","Lincoln University","2019","On-Tenure track total","43","18","25","0","0","0","1","1","0","22","7","15","0","0","0","0","0","0","10","3","7","3","2","1","4","2","2","3","3","0","-2"
"213598","Lincoln University","2019","On-tenure track, professors","1","0","1","0","0","0","0","0","0","0","0","0","0","0","0","0","0","0","1","0","1","0","0","0","0","0","0","0","0","0","-2"
"213598","Lincoln University","2019","On-tenure track, associate professors","2","1","1","0","0","0","0","0","0","1","0","1","0","0","0","0","0","0","1","1","0","0","0","0","0","0","0","0","0","0","-2"
"213598","Lincoln University","2019","On-tenure track, assistant professors","33","13","20","0","0","0","1","1","0","18","6","12","0","0","0","0","0","0","8","2","6","0","0","0","3","1","2","3","3","0","-2"
"213598","Lincoln University","2019","On-tenure track, instructors","1","1","0","0","0","0","0","0","0","0","0","0","0","0","0","0","0","0","0","0","0","1","1","0","0","0","0","0","0","0","-2"
"213598","Lincoln University","2019","On-tenure track, lecturers","6","3","3","0","0","0","0","0","0","3","1","2","0","0","0","0","0","0","0","0","0","2","1","1","1","1","0","0","0","0","-2"
"213598","Lincoln University","2019","Not on tenure track/No tenure system system total","9","2","7","0","0","0","0","0","0","5","1","4","0","0","0","0","0","0","4","1","3","0","0","0","0","0","0","0","0","0","-2"
"213598","Lincoln University","2019","Not on tenure/no tenure system, assistant professors","5","2","3","0","0","0","0","0","0","3","1","2","0","0","0","0","0","0","2","1","1","0","0","0","0","0","0","0","0","0","-2"
"213598","Lincoln University","2019","Not on tenure/no tenure system, lecturers","4","0","4","0","0","0","0","0","0","2","0","2","0","0","0","0","0","0","2","0","2","0","0","0","0","0","0","0","0","0","-2"
"214041","Millersville University of Pennsylvania","2019","Tenured total","217","117","100","1","1","0","18","10","8","11","8","3","13","5","8","0","0","0","172","91","81","1","1","0","1","1","0","0","0","0","-2"
"214041","Millersville University of Pennsylvania","2019","Tenured, professors","85","51","34","0","0","0","10","8","2","4","3","1","3","0","3","0","0","0","68","40","28","0","0","0","0","0","0","0","0","0","-2"
"214041","Millersville University of Pennsylvania","2019","Tenured, associate professors","105","51","54","0","0","0","7","2","5","5","3","2","7","3","4","0","0","0","85","42","43","1","1","0","0","0","0","0","0","0","-2"
"214041","Millersville University of Pennsylvania","2019","Tenured, assistant professors","27","15","12","1","1","0","1","0","1","2","2","0","3","2","1","0","0","0","19","9","10","0","0","0","1","1","0","0","0","0","-2"
"214041","Millersville University of Pennsylvania","2019","On-Tenure track total","52","22","30","0","0","0","3","2","1","2","0","2","5","1","4","0","0","0","36","16","20","0","0","0","3","1","2","3","2","1","-2"
"214041","Millersville University of Pennsylvania","2019","On-tenure track, associate professors","1","0","1","0","0","0","0","0","0","0","0","0","0","0","0","0","0","0","1","0","1","0","0","0","0","0","0","0","0","0","-2"
"214041","Millersville University of Pennsylvania","2019","On-tenure track, assistant professors","49","22","27","0","0","0","3","2","1","2","0","2","5","1","4","0","0","0","33","16","17","0","0","0","3","1","2","3","2","1","-2"
"214041","Millersville University of Pennsylvania","2019","On-tenure track, instructors","2","0","2","0","0","0","0","0","0","0","0","0","0","0","0","0","0","0","2","0","2","0","0","0","0","0","0","0","0","0","-2"
"214041","Millersville University of Pennsylvania","2019","Not on tenure track/No tenure system system total","5","2","3","0","0","0","1","0","1","0","0","0","0","0","0","0","0","0","4","2","2","0","0","0","0","0","0","0","0","0","-2"
"214041","Millersville University of Pennsylvania","2019","Not on tenure/no tenure system, assistant professors","5","2","3","0","0","0","1","0","1","0","0","0","0","0","0","0","0","0","4","2","2","0","0","0","0","0","0","0","0","0","-2"
"214777","Pennsylvania State University-Main Campus","2019","Tenured total","2144","1457","687","8","5","3","302","232","70","72","43","29","79","51","28","0","0","0","1509","1005","504","9","5","4","136","89","47","29","27","2","214777"
"214777","Pennsylvania State University-Main Campus","2019","Tenured, professors","1190","883","307","3","3","0","168","135","33","26","21","5","44","29","15","0","0","0","876","641","235","4","2","2","62","45","17","7","7","0","214777"
"214777","Pennsylvania State University-Main Campus","2019","Tenured, associate professors","943","565","378","5","2","3","134","97","37","46","22","24","35","22","13","0","0","0","624","357","267","4","2","2","74","44","30","21","19","2","214777"
"214777","Pennsylvania State University-Main Campus","2019","Tenured, assistant professors","11","9","2","0","0","0","0","0","0","0","0","0","0","0","0","0","0","0","9","7","2","1","1","0","0","0","0","1","1","0","214777"
"214777","Pennsylvania State University-Main Campus","2019","On-Tenure track total","883","476","407","5","4","1","112","62","50","32","11","21","32","17","15","0","0","0","413","208","205","5","3","2","145","81","64","139","90","49","214777"
"214777","Pennsylvania State University-Main Campus","2019","On-tenure track, professors","6","5","1","0","0","0","1","1","0","1","0","1","0","0","0","0","0","0","3","3","0","0","0","0","1","1","0","0","0","0","214777"
"214777","Pennsylvania State University-Main Campus","2019","On-tenure track, associate professors","57","33","24","1","0","1","12","8","4","1","1","0","1","1","0","0","0","0","31","15","16","0","0","0","9","6","3","2","2","0","214777"
"214777","Pennsylvania State University-Main Campus","2019","On-tenure track, assistant professors","820","438","382","4","4","0","99","53","46","30","10","20","31","16","15","0","0","0","379","190","189","5","3","2","135","74","61","137","88","49","214777"
"214777","Pennsylvania State University-Main Campus","2019","Not on tenure track/No tenure system system total","2768","1332","1436","1","1","0","298","154","144","80","36","44","75","24","51","2","2","0","1995","972","1023","28","14","14","229","102","127","60","27","33","214777"
"214777","Pennsylvania State University-Main Campus","2019","Not on tenure/no tenure system, professors","248","164","84","0","0","0","21","16","5","4","3","1","1","1","0","1","1","0","208","135","73","3","2","1","9","6","3","1","0","1","214777"
"214777","Pennsylvania State University-Main Campus","2019","Not on tenure/no tenure system, associate professors","535","278","257","0","0","0","71","45","26","14","8","6","5","1","4","0","0","0","415","208","207","4","3","1","23","11","12","3","2","1","214777"
"214777","Pennsylvania State University-Main Campus","2019","Not on tenure/no tenure system, assistant professors","1353","617","736","0","0","0","176","84","92","53","19","34","38","12","26","1","1","0","906","421","485","14","7","7","123","51","72","42","22","20","214777"
"214777","Pennsylvania State University-Main Campus","2019","Not on tenure/no tenure system, instructors","226","82","144","0","0","0","13","3","10","1","1","0","5","1","4","0","0","0","180","68","112","3","1","2","21","6","15","3","2","1","214777"
"214777","Pennsylvania State University-Main Campus","2019","Not on tenure/no tenure system, lecturers","400","185","215","1","1","0","17","6","11","8","5","3","25","8","17","0","0","0","281","135","146","4","1","3","53","28","25","11","1","10","214777"
"214777","Pennsylvania State University-Main Campus","2019","Not on tenure/no tenure system, no academic rank","6","6","0","0","0","0","0","0","0","0","0","0","1","1","0","0","0","0","5","5","0","0","0","0","0","0","0","0","0","0","214777"
"217156","Brown University","2019","Tenured total","550","389","161","0","0","0","59","40","19","28","17","11","22","16","6","0","0","0","418","298","120","6","3","3","4","3","1","13","12","1","-2"
"217156","Brown University","2019","Tenured, professors","400","298","102","0","0","0","40","32","8","15","11","4","14","10","4","0","0","0","315","232","83","4","2","2","2","2","0","10","9","1","-2"
"217156","Brown University","2019","Tenured, associate professors","150","91","59","0","0","0","19","8","11","13","6","7","8","6","2","0","0","0","103","66","37","2","1","1","2","1","1","3","3","0","-2"
"217156","Brown University","2019","On-Tenure track total","147","93","54","1","0","1","17","9","8","11","8","3","14","7","7","0","0","0","72","47","25","6","4","2","4","3","1","22","15","7","-2"
"217156","Brown University","2019","On-tenure track, associate professors","4","2","2","0","0","0","0","0","0","0","0","0","0","0","0","0","0","0","2","1","1","0","0","0","1","0","1","1","1","0","-2"
"217156","Brown University","2019","On-tenure track, assistant professors","143","91","52","1","0","1","17","9","8","11","8","3","14","7","7","0","0","0","70","46","24","6","4","2","3","3","0","21","14","7","-2"
"217156","Brown University","2019","Not on tenure track/No tenure system system total","208","90","118","0","0","0","20","5","15","8","3","5","8","2","6","0","0","0","125","54","71","2","1","1","17","12","5","28","13","15","-2"
"217156","Brown University","2019","Not on tenure/no tenure system, professors","11","8","3","0","0","0","0","0","0","0","0","0","0","0","0","0","0","0","11","8","3","0","0","0","0","0","0","0","0","0","-2"
"217156","Brown University","2019","Not on tenure/no tenure system, associate professors","4","1","3","0","0","0","0","0","0","0","0","0","0","0","0","0","0","0","2","1","1","1","0","1","1","0","1","0","0","0","-2"
"217156","Brown University","2019","Not on tenure/no tenure system, assistant professors","11","3","8","0","0","0","2","0","2","0","0","0","0","0","0","0","0","0","8","2","6","1","1","0","0","0","0","0","0","0","-2"
"217156","Brown University","2019","Not on tenure/no tenure system, lecturers","76","29","47","0","0","0","10","4","6","3","1","2","4","1","3","0","0","0","53","20","33","0","0","0","2","2","0","4","1","3","-2"
"217156","Brown University","2019","Not on tenure/no tenure system, no academic rank","106","49","57","0","0","0","8","1","7","5","2","3","4","1","3","0","0","0","51","23","28","0","0","0","14","10","4","24","12","12","-2"
"217484","University of Rhode Island","2019","Tenured total","400","234","166","2","1","1","49","34","15","11","6","5","12","7","5","0","0","0","324","185","139","0","0","0","0","0","0","2","1","1","-2"
"217484","University of Rhode Island","2019","Tenured, professors","264","163","101","1","1","0","34","25","9","5","4","1","7","5","2","0","0","0","217","128","89","0","0","0","0","0","0","0","0","0","-2"
"217484","University of Rhode Island","2019","Tenured, associate professors","136","71","65","1","0","1","15","9","6","6","2","4","5","2","3","0","0","0","107","57","50","0","0","0","0","0","0","2","1","1","-2"
"217484","University of Rhode Island","2019","On-Tenure track total","159","70","89","1","0","1","24","11","13","9","6","3","4","1","3","0","0","0","90","36","54","0","0","0","1","1","0","30","15","15","-2"
"217484","University of Rhode Island","2019","On-tenure track, associate professors","4","2","2","0","0","0","2","1","1","0","0","0","0","0","0","0","0","0","2","1","1","0","0","0","0","0","0","0","0","0","-2"
"217484","University of Rhode Island","2019","On-tenure track, assistant professors","155","68","87","1","0","1","22","10","12","9","6","3","4","1","3","0","0","0","88","35","53","0","0","0","1","1","0","30","15","15","-2"
"217484","University of Rhode Island","2019","Not on tenure track/No tenure system system total","205","73","132","0","0","0","8","1","7","5","5","0","7","4","3","0","0","0","168","59","109","0","0","0","0","0","0","17","4","13","-2"
"217484","University of Rhode Island","2019","Not on tenure/no tenure system, professors","13","4","9","0","0","0","0","0","0","0","0","0","0","0","0","0","0","0","13","4","9","0","0","0","0","0","0","0","0","0","-2"
"217484","University of Rhode Island","2019","Not on tenure/no tenure system, associate professors","17","4","13","0","0","0","0","0","0","0","0","0","1","0","1","0","0","0","15","3","12","0","0","0","0","0","0","1","1","0","-2"
"217484","University of Rhode Island","2019","Not on tenure/no tenure system, assistant professors","19","6","13","0","0","0","0","0","0","2","2","0","0","0","0","0","0","0","17","4","13","0","0","0","0","0","0","0","0","0","-2"
"217484","University of Rhode Island","2019","Not on tenure/no tenure system, lecturers","156","59","97","0","0","0","8","1","7","3","3","0","6","4","2","0","0","0","123","48","75","0","0","0","0","0","0","16","3","13","-2"
"217819","College of Charleston","2019","Tenured total","330","196","134","0","0","0","15","12","3","14","6","8","17","7","10","0","0","0","280","167","113","4","4","0","0","0","0","0","0","0","-2"
"217819","College of Charleston","2019","Tenured, professors","150","95","55","0","0","0","7","6","1","4","2","2","6","2","4","0","0","0","132","84","48","1","1","0","0","0","0","0","0","0","-2"
"217819","College of Charleston","2019","Tenured, associate professors","179","101","78","0","0","0","8","6","2","10","4","6","11","5","6","0","0","0","147","83","64","3","3","0","0","0","0","0","0","0","-2"
"217819","College of Charleston","2019","Tenured, assistant professors","1","0","1","0","0","0","0","0","0","0","0","0","0","0","0","0","0","0","1","0","1","0","0","0","0","0","0","0","0","0","-2"
"217819","College of Charleston","2019","On-Tenure track total","111","53","58","0","0","0","4","3","1","4","1","3","5","2","3","0","0","0","90","41","49","2","1","1","0","0","0","6","5","1","-2"
"217819","College of Charleston","2019","On-tenure track, professors","3","1","2","0","0","0","1","0","1","0","0","0","0","0","0","0","0","0","2","1","1","0","0","0","0","0","0","0","0","0","-2"
"217819","College of Charleston","2019","On-tenure track, associate professors","2","1","1","0","0","0","0","0","0","0","0","0","0","0","0","0","0","0","2","1","1","0","0","0","0","0","0","0","0","0","-2"
"217819","College of Charleston","2019","On-tenure track, assistant professors","105","50","55","0","0","0","3","3","0","4","1","3","5","2","3","0","0","0","85","38","47","2","1","1","0","0","0","6","5","1","-2"
"217819","College of Charleston","2019","On-tenure track, instructors","1","1","0","0","0","0","0","0","0","0","0","0","0","0","0","0","0","0","1","1","0","0","0","0","0","0","0","0","0","0","-2"
"217819","College of Charleston","2019","Not on tenure track/No tenure system system total","85","31","54","0","0","0","4","3","1","5","2","3","3","1","2","1","1","0","67","22","45","0","0","0","0","0","0","5","2","3","-2"
"217819","College of Charleston","2019","Not on tenure/no tenure system, associate professors","6","3","3","0","0","0","1","1","0","1","0","1","0","0","0","0","0","0","4","2","2","0","0","0","0","0","0","0","0","0","-2"
"217819","College of Charleston","2019","Not on tenure/no tenure system, assistant professors","21","11","10","0","0","0","0","0","0","2","2","0","0","0","0","0","0","0","16","7","9","0","0","0","0","0","0","3","2","1","-2"
"217819","College of Charleston","2019","Not on tenure/no tenure system, instructors","58","17","41","0","0","0","3","2","1","2","0","2","3","1","2","1","1","0","47","13","34","0","0","0","0","0","0","2","0","2","-2"
"217873","Claflin University","2019","Tenured total","49","30","19","0","0","0","20","15","5","16","7","9","2","2","0","0","0","0","8","4","4","0","0","0","1","1","0","2","1","1","-2"
"217873","Claflin University","2019","Tenured, professors","13","9","4","0","0","0","7","6","1","5","3","2","0","0","0","0","0","0","1","0","1","0","0","0","0","0","0","0","0","0","-2"
"217873","Claflin University","2019","Tenured, associate professors","31","18","13","0","0","0","12","8","4","7","2","5","2","2","0","0","0","0","7","4","3","0","0","0","1","1","0","2","1","1","-2"
"217873","Claflin University","2019","Tenured, assistant professors","5","3","2","0","0","0","1","1","0","4","2","2","0","0","0","0","0","0","0","0","0","0","0","0","0","0","0","0","0","0","-2"
"217873","Claflin University","2019","On-Tenure track total","55","33","22","1","1","0","3","3","0","34","18","16","0","0","0","0","0","0","16","10","6","0","0","0","0","0","0","1","1","0","-2"
"217873","Claflin University","2019","On-tenure track, professors","4","2","2","0","0","0","0","0","0","4","2","2","0","0","0","0","0","0","0","0","0","0","0","0","0","0","0","0","0","0","-2"
"217873","Claflin University","2019","On-tenure track, associate professors","8","5","3","0","0","0","1","1","0","5","2","3","0","0","0","0","0","0","2","2","0","0","0","0","0","0","0","0","0","0","-2"
"217873","Claflin University","2019","On-tenure track, assistant professors","40","23","17","1","1","0","2","2","0","22","11","11","0","0","0","0","0","0","14","8","6","0","0","0","0","0","0","1","1","0","-2"
"217873","Claflin University","2019","On-tenure track, instructors","3","3","0","0","0","0","0","0","0","3","3","0","0","0","0","0","0","0","0","0","0","0","0","0","0","0","0","0","0","0","-2"
"217873","Claflin University","2019","Not on tenure track/No tenure system system total","18","6","12","0","0","0","3","1","2","10","3","7","0","0","0","0","0","0","5","2","3","0","0","0","0","0","0","0","0","0","-2"
"217873","Claflin University","2019","Not on tenure/no tenure system, assistant professors","5","2","3","0","0","0","1","0","1","1","0","1","0","0","0","0","0","0","3","2","1","0","0","0","0","0","0","0","0","0","-2"
"217873","Claflin University","2019","Not on tenure/no tenure system, instructors","13","4","9","0","0","0","2","1","1","9","3","6","0","0","0","0","0","0","2","0","2","0","0","0","0","0","0","0","0","0","-2"
"217882","Clemson University","2019","Tenured total","654","467","187","0","0","0","93","74","19","17","11","6","15","11","4","1","1","0","522","367","155","3","0","3","3","3","0","0","0","0","-2"
"217882","Clemson University","2019","Tenured, professors","354","274","80","0","0","0","55","49","6","10","7","3","3","3","0","0","0","0","280","212","68","3","0","3","3","3","0","0","0","0","-2"
"217882","Clemson University","2019","Tenured, associate professors","300","193","107","0","0","0","38","25","13","7","4","3","12","8","4","1","1","0","242","155","87","0","0","0","0","0","0","0","0","0","-2"
"217882","Clemson University","2019","On-Tenure track total","296","170","126","0","0","0","61","41","20","18","10","8","16","10","6","0","0","0","177","97","80","0","0","0","22","11","11","2","1","1","-2"
"217882","Clemson University","2019","On-tenure track, associate professors","18","9","9","0","0","0","5","2","3","1","1","0","0","0","0","0","0","0","11","5","6","0","0","0","1","1","0","0","0","0","-2"
"217882","Clemson University","2019","On-tenure track, assistant professors","278","161","117","0","0","0","56","39","17","17","9","8","16","10","6","0","0","0","166","92","74","0","0","0","21","10","11","2","1","1","-2"
"217882","Clemson University","2019","Not on tenure track/No tenure system system total","401","177","224","0","0","0","25","14","11","19","3","16","21","6","15","0","0","0","316","146","170","1","0","1","16","7","9","3","1","2","-2"
"217882","Clemson University","2019","Not on tenure/no tenure system, professors","1","1","0","0","0","0","0","0","0","1","1","0","0","0","0","0","0","0","0","0","0","0","0","0","0","0","0","0","0","0","-2"
"217882","Clemson University","2019","Not on tenure/no tenure system, instructors","2","1","1","0","0","0","0","0","0","0","0","0","0","0","0","0","0","0","2","1","1","0","0","0","0","0","0","0","0","0","-2"
"217882","Clemson University","2019","Not on tenure/no tenure system, lecturers","345","148","197","0","0","0","21","11","10","14","2","12","19","4","15","0","0","0","274","125","149","1","0","1","14","5","9","2","1","1","-2"
"217882","Clemson University","2019","Not on tenure/no tenure system, no academic rank","53","27","26","0","0","0","4","3","1","4","0","4","2","2","0","0","0","0","40","20","20","0","0","0","2","2","0","1","0","1","-2"
"218724","Coastal Carolina University","2019","Tenured total","206","134","72","0","0","0","12","9","3","11","6","5","6","4","2","0","0","0","177","115","62","0","0","0","0","0","0","0","0","0","-2"
"218724","Coastal Carolina University","2019","Tenured, professors","102","71","31","0","0","0","6","5","1","4","2","2","3","2","1","0","0","0","89","62","27","0","0","0","0","0","0","0","0","0","-2"
"218724","Coastal Carolina University","2019","Tenured, associate professors","103","63","40","0","0","0","6","4","2","7","4","3","3","2","1","0","0","0","87","53","34","0","0","0","0","0","0","0","0","0","-2"
"218724","Coastal Carolina University","2019","Tenured, assistant professors","1","0","1","0","0","0","0","0","0","0","0","0","0","0","0","0","0","0","1","0","1","0","0","0","0","0","0","0","0","0","-2"
"218724","Coastal Carolina University","2019","On-Tenure track total","118","54","64","0","0","0","10","8","2","9","1","8","3","2","1","0","0","0","93","40","53","0","0","0","3","3","0","0","0","0","-2"
"218724","Coastal Carolina University","2019","On-tenure track, associate professors","9","5","4","0","0","0","2","1","1","1","0","1","0","0","0","0","0","0","6","4","2","0","0","0","0","0","0","0","0","0","-2"
"218724","Coastal Carolina University","2019","On-tenure track, assistant professors","109","49","60","0","0","0","8","7","1","8","1","7","3","2","1","0","0","0","87","36","51","0","0","0","3","3","0","0","0","0","-2"
"218724","Coastal Carolina University","2019","Not on tenure track/No tenure system system total","164","77","87","0","0","0","0","0","0","6","2","4","3","1","2","0","0","0","153","73","80","1","0","1","1","1","0","0","0","0","-2"
"218724","Coastal Carolina University","2019","Not on tenure/no tenure system, assistant professors","13","9","4","0","0","0","0","0","0","1","1","0","0","0","0","0","0","0","11","7","4","0","0","0","1","1","0","0","0","0","-2"
"218724","Coastal Carolina University","2019","Not on tenure/no tenure system, instructors","6","4","2","0","0","0","0","0","0","0","0","0","1","1","0","0","0","0","5","3","2","0","0","0","0","0","0","0","0","0","-2"
"218724","Coastal Carolina University","2019","Not on tenure/no tenure system, lecturers","145","64","81","0","0","0","0","0","0","5","1","4","2","0","2","0","0","0","137","63","74","1","0","1","0","0","0","0","0","0","-2"
"219347","South Dakota School of Mines and Technology","2019","Tenured total","76","65","11","1","1","0","8","8","0","0","0","0","2","2","0","0","0","0","62","51","11","0","0","0","0","0","0","3","3","0","-2"
"219347","South Dakota School of Mines and Technology","2019","Tenured, professors","34","31","3","0","0","0","3","3","0","0","0","0","1","1","0","0","0","0","30","27","3","0","0","0","0","0","0","0","0","0","-2"
"219347","South Dakota School of Mines and Technology","2019","Tenured, associate professors","41","33","8","1","1","0","5","5","0","0","0","0","1","1","0","0","0","0","32","24","8","0","0","0","0","0","0","2","2","0","-2"
"219347","South Dakota School of Mines and Technology","2019","Tenured, assistant professors","1","1","0","0","0","0","0","0","0","0","0","0","0","0","0","0","0","0","0","0","0","0","0","0","0","0","0","1","1","0","-2"
"219347","South Dakota School of Mines and Technology","2019","On-Tenure track total","38","28","10","0","0","0","2","2","0","1","1","0","0","0","0","0","0","0","24","15","9","0","0","0","0","0","0","11","10","1","-2"
"219347","South Dakota School of Mines and Technology","2019","On-tenure track, associate professors","1","0","1","0","0","0","0","0","0","0","0","0","0","0","0","0","0","0","1","0","1","0","0","0","0","0","0","0","0","0","-2"
"219347","South Dakota School of Mines and Technology","2019","On-tenure track, assistant professors","37","28","9","0","0","0","2","2","0","1","1","0","0","0","0","0","0","0","23","15","8","0","0","0","0","0","0","11","10","1","-2"
"219347","South Dakota School of Mines and Technology","2019","Not on tenure track/No tenure system system total","40","24","16","1","1","0","1","1","0","0","0","0","0","0","0","0","0","0","37","22","15","0","0","0","0","0","0","1","0","1","-2"
"219347","South Dakota School of Mines and Technology","2019","Not on tenure/no tenure system, professors","2","2","0","0","0","0","0","0","0","0","0","0","0","0","0","0","0","0","2","2","0","0","0","0","0","0","0","0","0","0","-2"
"219347","South Dakota School of Mines and Technology","2019","Not on tenure/no tenure system, assistant professors","8","6","2","0","0","0","1","1","0","0","0","0","0","0","0","0","0","0","7","5","2","0","0","0","0","0","0","0","0","0","-2"
"219347","South Dakota School of Mines and Technology","2019","Not on tenure/no tenure system, instructors","9","4","5","1","1","0","0","0","0","0","0","0","0","0","0","0","0","0","7","3","4","0","0","0","0","0","0","1","0","1","-2"
"219347","South Dakota School of Mines and Technology","2019","Not on tenure/no tenure system, lecturers","21","12","9","0","0","0","0","0","0","0","0","0","0","0","0","0","0","0","21","12","9","0","0","0","0","0","0","0","0","0","-2"
"221759","The University of Tennessee-Knoxville","2019","Tenured total","843","553","290","2","2","0","104","78","26","25","14","11","28","21","7","0","0","0","675","435","240","6","1","5","0","0","0","3","2","1","-2"
"221759","The University of Tennessee-Knoxville","2019","Tenured, professors","503","354","149","1","1","0","63","52","11","9","5","4","12","9","3","0","0","0","414","286","128","4","1","3","0","0","0","0","0","0","-2"
"221759","The University of Tennessee-Knoxville","2019","Tenured, associate professors","338","198","140","1","1","0","41","26","15","16","9","7","16","12","4","0","0","0","259","148","111","2","0","2","0","0","0","3","2","1","-2"
"221759","The University of Tennessee-Knoxville","2019","Tenured, assistant professors","2","1","1","0","0","0","0","0","0","0","0","0","0","0","0","0","0","0","2","1","1","0","0","0","0","0","0","0","0","0","-2"
"221759","The University of Tennessee-Knoxville","2019","On-Tenure track total","289","160","129","0","0","0","22","15","7","21","10","11","17","8","9","0","0","0","187","98","89","5","2","3","0","0","0","37","27","10","-2"
"221759","The University of Tennessee-Knoxville","2019","On-tenure track, professors","5","4","1","0","0","0","1","1","0","0","0","0","0","0","0","0","0","0","4","3","1","0","0","0","0","0","0","0","0","0","-2"
"221759","The University of Tennessee-Knoxville","2019","On-tenure track, associate professors","22","13","9","0","0","0","4","3","1","2","1","1","1","0","1","0","0","0","14","8","6","0","0","0","0","0","0","1","1","0","-2"
"221759","The University of Tennessee-Knoxville","2019","On-tenure track, assistant professors","262","143","119","0","0","0","17","11","6","19","9","10","16","8","8","0","0","0","169","87","82","5","2","3","0","0","0","36","26","10","-2"
"221759","The University of Tennessee-Knoxville","2019","Not on tenure track/No tenure system system total","493","179","314","0","0","0","20","9","11","15","4","11","20","6","14","0","0","0","415","147","268","2","0","2","1","0","1","20","13","7","-2"
"221759","The University of Tennessee-Knoxville","2019","Not on tenure/no tenure system, professors","13","4","9","0","0","0","1","1","0","0","0","0","0","0","0","0","0","0","12","3","9","0","0","0","0","0","0","0","0","0","-2"
"221759","The University of Tennessee-Knoxville","2019","Not on tenure/no tenure system, associate professors","32","4","28","0","0","0","0","0","0","1","0","1","2","1","1","0","0","0","29","3","26","0","0","0","0","0","0","0","0","0","-2"
"221759","The University of Tennessee-Knoxville","2019","Not on tenure/no tenure system, assistant professors","79","20","59","0","0","0","3","2","1","3","0","3","2","1","1","0","0","0","65","15","50","0","0","0","1","0","1","5","2","3","-2"
"221759","The University of Tennessee-Knoxville","2019","Not on tenure/no tenure system, instructors","30","6","24","0","0","0","1","1","0","3","0","3","1","0","1","0","0","0","23","4","19","1","0","1","0","0","0","1","1","0","-2"
"221759","The University of Tennessee-Knoxville","2019","Not on tenure/no tenure system, lecturers","333","142","191","0","0","0","14","5","9","8","4","4","15","4","11","0","0","0","281","119","162","1","0","1","0","0","0","14","10","4","-2"
"221759","The University of Tennessee-Knoxville","2019","Not on tenure/no tenure system, no academic rank","6","3","3","0","0","0","1","0","1","0","0","0","0","0","0","0","0","0","5","3","2","0","0","0","0","0","0","0","0","0","-2"
"221768","The University of Tennessee-Martin","2019","Tenured total","158","98","60","0","0","0","6","3","3","7","4","3","2","1","1","0","0","0","143","90","53","0","0","0","0","0","0","0","0","0","-2"
"221768","The University of Tennessee-Martin","2019","Tenured, professors","82","57","25","0","0","0","1","0","1","4","2","2","1","1","0","0","0","0","76","54","22","0","0","0","0","0","0","0","0","0","-2"
"221768","The University of Tennessee-Martin","2019","Tenured, associate professors","65","35","30","0","0","0","4","2","2","3","2","1","1","0","1","0","0","0","57","31","26","0","0","0","0","0","0","0","0","0","-2"
"221768","The University of Tennessee-Martin","2019","Tenured, assistant professors","5","1","4","0","0","0","1","1","0","0","0","0","0","0","0","0","0","0","4","0","4","0","0","0","0","0","0","0","0","0","-2"
"221768","The University of Tennessee-Martin","2019","Tenured, instructors","6","5","1","0","0","0","0","0","0","0","0","0","0","0","0","0","0","0","6","5","1","0","0","0","0","0","0","0","0","0","-2"
"221768","The University of Tennessee-Martin","2019","On-Tenure track total","52","30","22","0","0","0","6","3","3","1","0","1","3","2","1","0","0","0","39","22","17","0","0","0","0","0","0","3","3","0","-2"
"221768","The University of Tennessee-Martin","2019","On-tenure track, associate professors","13","8","5","0","0","0","1","1","0","0","0","0","3","2","1","0","0","0","9","5","4","0","0","0","0","0","0","0","0","0","-2"
"221768","The University of Tennessee-Martin","2019","On-tenure track, assistant professors","39","22","17","0","0","0","5","2","3","1","0","1","0","0","0","0","0","0","30","17","13","0","0","0","0","0","0","3","3","0","-2"
"221768","The University of Tennessee-Martin","2019","Not on tenure track/No tenure system system total","75","29","46","0","0","0","2","1","1","4","1","3","1","1","0","0","0","0","65","26","39","0","0","0","0","0","0","3","0","3","-2"
"221768","The University of Tennessee-Martin","2019","Not on tenure/no tenure system, assistant professors","1","0","1","0","0","0","0","0","0","0","0","0","0","0","0","0","0","0","1","0","1","0","0","0","0","0","0","0","0","0","-2"
"221768","The University of Tennessee-Martin","2019","Not on tenure/no tenure system, instructors","2","1","1","0","0","0","0","0","0","0","0","0","0","0","0","0","0","0","2","1","1","0","0","0","0","0","0","0","0","0","-2"
"221768","The University of Tennessee-Martin","2019","Not on tenure/no tenure system, lecturers","72","28","44","0","0","0","2","1","1","4","1","3","1","1","0","0","0","0","62","25","37","0","0","0","0","0","0","3","0","3","-2"
"221838","Tennessee State University","2019","Tenured total","209","125","84","1","0","1","26","20","6","86","40","46","4","2","2","0","0","0","70","45","25","3","2","1","1","1","0","18","15","3","-2"
"221838","Tennessee State University","2019","Tenured, professors","100","67","33","0","0","0","19","16","3","38","20","18","3","1","2","0","0","0","31","21","10","2","2","0","0","0","0","7","7","0","-2"
"221838","Tennessee State University","2019","Tenured, associate professors","84","44","40","1","0","1","5","3","2","33","14","19","1","1","0","0","0","0","32","18","14","1","0","1","1","1","0","10","7","3","-2"
"221838","Tennessee State University","2019","Tenured, assistant professors","23","12","11","0","0","0","2","1","1","13","4","9","0","0","0","0","0","0","7","6","1","0","0","0","0","0","0","1","1","0","-2"
"221838","Tennessee State University","2019","Tenured, instructors","2","2","0","0","0","0","0","0","0","2","2","0","0","0","0","0","0","0","0","0","0","0","0","0","0","0","0","0","0","0","-2"
"221838","Tennessee State University","2019","On-Tenure track total","91","40","51","0","0","0","4","4","0","37","13","24","1","0","1","0","0","0","30","11","19","3","1","2","1","0","1","15","11","4","-2"
"221838","Tennessee State University","2019","On-tenure track, professors","2","0","2","0","0","0","0","0","0","2","0","2","0","0","0","0","0","0","0","0","0","0","0","0","0","0","0","0","0","0","-2"
"221838","Tennessee State University","2019","On-tenure track, associate professors","16","7","9","0","0","0","2","2","0","5","1","4","0","0","0","0","0","0","5","1","4","2","1","1","0","0","0","2","2","0","-2"
"221838","Tennessee State University","2019","On-tenure track, assistant professors","69","30","39","0","0","0","2","2","0","29","11","18","1","0","1","0","0","0","23","8","15","1","0","1","1","0","1","12","9","3","-2"
"221838","Tennessee State University","2019","On-tenure track, instructors","2","2","0","0","0","0","0","0","0","1","1","0","0","0","0","0","0","0","1","1","0","0","0","0","0","0","0","0","0","0","-2"
"221838","Tennessee State University","2019","On-tenure track, no academic rank","2","1","1","0","0","0","0","0","0","0","0","0","0","0","0","0","0","0","1","1","0","0","0","0","0","0","0","1","0","1","-2"
"221838","Tennessee State University","2019","Not on tenure track/No tenure system system total","20","11","9","0","0","0","1","0","1","10","6","4","0","0","0","0","0","0","8","4","4","0","0","0","0","0","0","1","1","0","-2"
"221838","Tennessee State University","2019","Not on tenure/no tenure system, instructors","2","2","0","0","0","0","0","0","0","2","2","0","0","0","0","0","0","0","0","0","0","0","0","0","0","0","0","0","0","0","-2"
"221838","Tennessee State University","2019","Not on tenure/no tenure system, no academic rank","18","9","9","0","0","0","1","0","1","8","4","4","0","0","0","0","0","0","8","4","4","0","0","0","0","0","0","1","1","0","-2"
"221999","Vanderbilt University","2019","Tenured total","628","442","186","2","1","1","44","33","11","29","16","13","22","15","7","1","1","0","486","349","137","0","0","0","42","26","16","2","1","1","-2"
"221999","Vanderbilt University","2019","Tenured, professors","423","319","104","0","0","0","27","23","4","18","12","6","13","9","4","0","0","0","344","260","84","0","0","0","20","15","5","1","0","1","-2"
"221999","Vanderbilt University","2019","Tenured, associate professors","205","123","82","2","1","1","17","10","7","11","4","7","9","6","3","1","1","0","142","89","53","0","0","0","22","11","11","1","1","0","-2"
"221999","Vanderbilt University","2019","On-Tenure track total","188","93","95","1","1","0","11","5","6","11","4","7","14","8","6","1","1","0","85","45","40","0","0","0","49","20","29","16","9","7","-2"
"221999","Vanderbilt University","2019","On-tenure track, associate professors","6","3","3","0","0","0","0","0","0","1","0","1","0","0","0","0","0","0","5","3","2","0","0","0","0","0","0","0","0","0","-2"
"221999","Vanderbilt University","2019","On-tenure track, assistant professors","182","90","92","1","1","0","11","5","6","10","4","6","14","8","6","1","1","0","80","42","38","0","0","0","49","20","29","16","9","7","-2"
"221999","Vanderbilt University","2019","Not on tenure track/No tenure system system total","467","156","311","0","0","0","17","5","12","26","6","20","16","2","14","0","0","0","331","108","223","0","0","0","59","24","35","18","11","7","-2"
"221999","Vanderbilt University","2019","Not on tenure/no tenure system, professors","54","28","26","0","0","0","2","2","0","4","3","1","2","1","1","0","0","0","42","19","23","0","0","0","4","3","1","0","0","0","-2"
"221999","Vanderbilt University","2019","Not on tenure/no tenure system, associate professors","71","28","43","0","0","0","3","0","3","5","1","4","2","0","2","0","0","0","55","26","29","0","0","0","5","0","5","1","1","0","-2"
"221999","Vanderbilt University","2019","Not on tenure/no tenure system, assistant professors","98","26","72","0","0","0","1","1","0","5","0","5","3","0","3","0","0","0","69","13","56","0","0","0","12","6","6","8","6","2","-2"
"221999","Vanderbilt University","2019","Not on tenure/no tenure system, instructors","51","8","43","0","0","0","1","0","1","5","0","5","0","0","0","0","0","0","43","7","36","0","0","0","2","1","1","0","0","0","-2"
"221999","Vanderbilt University","2019","Not on tenure/no tenure system, lecturers","180","64","116","0","0","0","8","2","6","5","2","3","9","1","8","0","0","0","116","42","74","0","0","0","33","13","20","9","4","5","-2"
"221999","Vanderbilt University","2019","Not on tenure/no tenure system, no academic rank","13","2","11","0","0","0","2","0","2","2","0","2","0","0","0","0","0","0","6","1","5","0","0","0","3","1","2","0","0","0","-2"
"224147","Texas A & M University-Corpus Christi","2019","Tenured total","164","102","62","1","1","0","20","15","5","4","4","0","21","11","10","0","0","0","110","69","41","3","1","2","3","0","3","2","1","1","-2"
"224147","Texas A & M University-Corpus Christi","2019","Tenured, professors","75","53","22","1","1","0","9","7","2","1","1","0","6","4","2","0","0","0","56","39","17","1","1","0","1","0","1","0","0","0","-2"
"224147","Texas A & M University-Corpus Christi","2019","Tenured, associate professors","87","49","38","0","0","0","11","8","3","3","3","0","14","7","7","0","0","0","53","30","23","2","0","2","2","0","2","2","1","1","-2"
"224147","Texas A & M University-Corpus Christi","2019","Tenured, assistant professors","2","0","2","0","0","0","0","0","0","0","0","0","1","0","1","0","0","0","1","0","1","0","0","0","0","0","0","0","0","0","-2"
"224147","Texas A & M University-Corpus Christi","2019","On-Tenure track total","129","60","69","0","0","0","15","8","7","3","2","1","16","9","7","0","0","0","64","20","44","4","2","2","6","4","2","21","15","6","-2"
"224147","Texas A & M University-Corpus Christi","2019","On-tenure track, associate professors","8","5","3","0","0","0","2","2","0","0","0","0","0","0","0","0","0","0","3","1","2","2","1","1","0","0","0","1","1","0","-2"
"224147","Texas A & M University-Corpus Christi","2019","On-tenure track, assistant professors","121","55","66","0","0","0","13","6","7","3","2","1","16","9","7","0","0","0","61","19","42","2","1","1","6","4","2","20","14","6","-2"
"224147","Texas A & M University-Corpus Christi","2019","Not on tenure track/No tenure system system total","122","39","83","0","0","0","9","3","6","2","0","2","19","3","16","0","0","0","78","27","51","1","0","1","2","0","2","11","6","5","-2"
"224147","Texas A & M University-Corpus Christi","2019","Not on tenure/no tenure system, professors","3","2","1","0","0","0","0","0","0","0","0","0","1","1","0","0","0","0","2","1","1","0","0","0","0","0","0","0","0","0","-2"
"224147","Texas A & M University-Corpus Christi","2019","Not on tenure/no tenure system, associate professors","11","6","5","0","0","0","2","0","2","0","0","0","0","0","0","0","0","0","8","6","2","0","0","0","1","0","1","0","0","0","-2"
"224147","Texas A & M University-Corpus Christi","2019","Not on tenure/no tenure system, assistant professors","88","26","62","0","0","0","6","3","3","2","0","2","16","2","14","0","0","0","53","15","38","1","0","1","1","0","1","9","6","3","-2"
"224147","Texas A & M University-Corpus Christi","2019","Not on tenure/no tenure system, instructors","8","2","6","0","0","0","1","0","1","0","0","0","0","0","0","0","0","0","5","2","3","0","0","0","0","0","0","2","0","2","-2"
"224147","Texas A & M University-Corpus Christi","2019","Not on tenure/no tenure system, lecturers","9","3","6","0","0","0","0","0","0","0","0","0","2","0","2","0","0","0","7","3","4","0","0","0","0","0","0","0","0","0","-2"
"224147","Texas A & M University-Corpus Christi","2019","Not on tenure/no tenure system, no academic rank","3","0","3","0","0","0","0","0","0","0","0","0","0","0","0","0","0","0","3","0","3","0","0","0","0","0","0","0","0","0","-2"
"225511","University of Houston","2019","Tenured total","780","532","248","1","1","0","186","133","53","29","18","11","69","38","31","0","0","0","486","335","151","7","5","2","0","0","0","2","2","0","-2"
"225511","University of Houston","2019","Tenured, professors","437","333","104","0","0","0","101","78","23","14","11","3","28","13","15","0","0","0","288","226","62","5","4","1","0","0","0","1","1","0","-2"
"225511","University of Houston","2019","Tenured, associate professors","343","199","144","1","1","0","85","55","30","15","7","8","41","25","16","0","0","0","198","109","89","2","1","1","0","0","0","1","1","0","-2"
"225511","University of Houston","2019","On-Tenure track total","247","139","108","0","0","0","48","30","18","21","7","14","17","7","10","0","0","0","105","60","45","1","1","0","2","1","1","53","33","20","-2"
"225511","University of Houston","2019","On-tenure track, professors","3","2","1","0","0","0","0","0","0","0","0","0","0","0","0","0","0","0","2","1","1","0","0","0","0","0","0","1","1","0","-2"
"225511","University of Houston","2019","On-tenure track, associate professors","12","8","4","0","0","0","2","1","1","1","0","1","1","0","1","0","0","0","5","5","0","0","0","0","0","0","0","3","2","1","-2"
"225511","University of Houston","2019","On-tenure track, assistant professors","232","129","103","0","0","0","46","29","17","20","7","13","16","7","9","0","0","0","98","54","44","1","1","0","2","1","1","49","30","19","-2"
"225511","University of Houston","2019","Not on tenure track/No tenure system system total","335","160","175","1","1","0","29","12","17","14","4","10","36","16","20","0","0","0","231","118","113","5","2","3","5","2","3","14","5","9","-2"
"225511","University of Houston","2019","Not on tenure/no tenure system, lecturers","91","42","49","0","0","0","7","1","6","2","1","1","17","10","7","0","0","0","58","28","30","1","0","1","2","1","1","4","1","3","-2"
"225511","University of Houston","2019","Not on tenure/no tenure system, no academic rank","244","118","126","1","1","0","22","11","11","12","3","9","19","6","13","0","0","0","173","90","83","4","2","2","3","1","2","10","4","6","-2"
"225627","University of the Incarnate Word","2019","Tenured total","152","68","84","1","0","1","10","4","6","8","3","5","30","12","18","0","0","0","102","49","53","0","0","0","0","0","0","1","0","1","-2"
"225627","University of the Incarnate Word","2019","Tenured, professors","68","31","37","0","0","0","4","2","2","2","0","2","15","6","9","0","0","0","46","23","23","0","0","0","0","0","0","1","0","1","-2"
"225627","University of the Incarnate Word","2019","Tenured, associate professors","84","37","47","1","0","1","6","2","4","6","3","3","15","6","9","0","0","0","56","26","30","0","0","0","0","0","0","0","0","0","-2"
"225627","University of the Incarnate Word","2019","On-Tenure track total","90","45","45","0","0","0","7","2","5","4","2","2","23","14","9","0","0","0","54","25","29","0","0","0","0","0","0","2","2","0","-2"
"225627","University of the Incarnate Word","2019","On-tenure track, professors","3","3","0","0","0","0","0","0","0","0","0","0","1","1","0","0","0","0","2","2","0","0","0","0","0","0","0","0","0","0","-2"
"225627","University of the Incarnate Word","2019","On-tenure track, associate professors","6","5","1","0","0","0","0","0","0","1","1","0","5","4","1","0","0","0","0","0","0","0","0","0","0","0","0","0","0","0","-2"
"225627","University of the Incarnate Word","2019","On-tenure track, assistant professors","80","37","43","0","0","0","7","2","5","3","1","2","17","9","8","0","0","0","51","23","28","0","0","0","0","0","0","2","2","0","-2"
"225627","University of the Incarnate Word","2019","On-tenure track, instructors","1","0","1","0","0","0","0","0","0","0","0","0","0","0","0","0","0","0","1","0","1","0","0","0","0","0","0","0","0","0","-2"
"225627","University of the Incarnate Word","2019","Not on tenure track/No tenure system system total","105","48","57","1","1","0","9","5","4","7","3","4","32","13","19","0","0","0","53","25","28","0","0","0","2","1","1","1","0","1","-2"
"225627","University of the Incarnate Word","2019","Not on tenure/no tenure system, professors","9","5","4","0","0","0","1","0","1","0","0","0","1","1","0","0","0","0","7","4","3","0","0","0","0","0","0","0","0","0","-2"
"225627","University of the Incarnate Word","2019","Not on tenure/no tenure system, associate professors","15","9","6","0","0","0","3","2","1","1","0","1","3","2","1","0","0","0","7","4","3","0","0","0","1","1","0","0","0","0","-2"
"225627","University of the Incarnate Word","2019","Not on tenure/no tenure system, assistant professors","44","22","22","1","1","0","4","3","1","4","2","2","12","6","6","0","0","0","21","10","11","0","0","0","1","0","1","1","0","1","-2"
"225627","University of the Incarnate Word","2019","Not on tenure/no tenure system, instructors","36","12","24","0","0","0","1","0","1","2","1","1","16","4","12","0","0","0","17","7","10","0","0","0","0","0","0","0","0","0","-2"
"225627","University of the Incarnate Word","2019","Not on tenure/no tenure system, lecturers","1","0","1","0","0","0","0","0","0","0","0","0","0","0","0","0","0","0","1","0","1","0","0","0","0","0","0","0","0","0","-2"
"227757","Rice University","2019","Tenured total","425","308","117","0","0","0","54","36","18","11","8","3","27","22","5","0","0","0","328","241","87","1","0","1","0","0","0","4","1","3","-2"
"227757","Rice University","2019","Tenured, professors","315","241","74","0","0","0","38","26","12","6","5","1","18","15","3","0","0","0","251","194","57","0","0","0","0","0","0","2","1","1","-2"
"227757","Rice University","2019","Tenured, associate professors","110","67","43","0","0","0","16","10","6","5","3","2","9","7","2","0","0","0","77","47","30","1","0","1","0","0","0","2","0","2","-2"
"227757","Rice University","2019","On-Tenure track total","114","69","45","1","0","1","17","10","7","2","1","1","10","6","4","0","0","0","55","33","22","5","2","3","0","0","0","24","17","7","-2"
"227757","Rice University","2019","On-tenure track, assistant professors","114","69","45","1","0","1","17","10","7","2","1","1","10","6","4","0","0","0","55","33","22","5","2","3","0","0","0","24","17","7","-2"
"227757","Rice University","2019","Not on tenure track/No tenure system system total","155","75","80","0","0","0","14","8","6","5","1","4","10","3","7","0","0","0","108","58","50","2","0","2","0","0","0","16","5","11","-2"
"227757","Rice University","2019","Not on tenure/no tenure system, associate professors","1","0","1","0","0","0","0","0","0","0","0","0","0","0","0","0","0","0","1","0","1","0","0","0","0","0","0","0","0","0","-2"
"227757","Rice University","2019","Not on tenure/no tenure system, instructors","19","12","7","0","0","0","2","2","0","0","0","0","1","1","0","0","0","0","10","5","5","1","0","1","0","0","0","5","4","1","-2"
"227757","Rice University","2019","Not on tenure/no tenure system, lecturers","132","60","72","0","0","0","11","5","6","5","1","4","9","2","7","0","0","0","96","52","44","1","0","1","0","0","0","10","0","10","-2"
"227757","Rice University","2019","Not on tenure/no tenure system, no academic rank","3","3","0","0","0","0","1","1","0","0","0","0","0","0","0","0","0","0","1","1","0","0","0","0","0","0","0","1","1","0","-2"
"228459","Texas State University","2019","Tenured total","518","295","223","1","1","0","53","37","16","14","8","6","59","28","31","0","0","0","341","186","155","5","3","2","42","29","13","3","3","0","-2"
"228459","Texas State University","2019","Tenured, professors","253","159","94","0","0","0","23","17","6","5","3","2","23","16","7","0","0","0","184","108","76","2","0","2","14","13","1","2","2","0","-2"
"228459","Texas State University","2019","Tenured, associate professors","261","133","128","1","1","0","30","20","10","9","5","4","36","12","24","0","0","0","153","75","78","3","3","0","28","16","12","1","1","0","-2"
"228459","Texas State University","2019","Tenured, assistant professors","4","3","1","0","0","0","0","0","0","0","0","0","0","0","0","0","0","0","4","3","1","0","0","0","0","0","0","0","0","0","-2"
"228459","Texas State University","2019","On-Tenure track total","226","102","124","1","1","0","40","12","28","11","5","6","22","9","13","0","0","0","133","67","66","0","0","0","19","8","11","0","0","0","-2"
"228459","Texas State University","2019","On-tenure track, professors","2","1","1","0","0","0","0","0","0","0","0","0","0","0","0","0","0","0","2","1","1","0","0","0","0","0","0","0","0","0","-2"
"228459","Texas State University","2019","On-tenure track, associate professors","8","4","4","0","0","0","0","0","0","1","0","1","0","0","0","0","0","0","5","3","2","0","0","0","2","1","1","0","0","0","-2"
"228459","Texas State University","2019","On-tenure track, assistant professors","216","97","119","1","1","0","40","12","28","10","5","5","22","9","13","0","0","0","126","63","63","0","0","0","17","7","10","0","0","0","-2"
"228459","Texas State University","2019","Not on tenure track/No tenure system system total","602","270","332","1","1","0","25","14","11","10","4","6","58","22","36","0","0","0","451","199","252","5","3","2","41","17","24","11","10","1","-2"
"228459","Texas State University","2019","Not on tenure/no tenure system, professors","8","6","2","0","0","0","0","0","0","0","0","0","0","0","0","0","0","0","6","4","2","0","0","0","2","2","0","0","0","0","-2"
"228459","Texas State University","2019","Not on tenure/no tenure system, associate professors","20","6","14","0","0","0","0","0","0","1","1","0","0","0","0","0","0","0","17","5","12","0","0","0","2","0","2","0","0","0","-2"
"228459","Texas State University","2019","Not on tenure/no tenure system, assistant professors","34","14","20","0","0","0","1","1","0","3","1","2","2","1","1","0","0","0","23","8","15","1","1","0","4","2","2","0","0","0","-2"
"228459","Texas State University","2019","Not on tenure/no tenure system, lecturers","521","233","288","1","1","0","21","11","10","5","1","4","51","18","33","0","0","0","396","177","219","4","2","2","32","13","19","11","10","1","-2"
"228459","Texas State University","2019","Not on tenure/no tenure system, no academic rank","19","11","8","0","0","0","3","2","1","1","1","0","5","3","2","0","0","0","9","5","4","0","0","0","1","0","1","0","0","0","-2"
"228723","Texas A & M University-College Station","2019","Tenured total","1585","1173","412","4","2","2","309","237","72","54","34","20","105","74","31","0","0","0","1043","772","271","7","5","2","44","35","9","19","14","5","-2"
"228723","Texas A & M University-College Station","2019","Tenured, professors","1018","809","209","1","0","1","175","145","30","28","24","4","52","40","12","0","0","0","723","568","155","5","4","1","28","22","6","6","6","0","-2"
"228723","Texas A & M University-College Station","2019","Tenured, associate professors","563","361","202","3","2","1","133","91","42","26","10","16","53","34","19","0","0","0","317","202","115","2","1","1","16","13","3","13","8","5","-2"
"228723","Texas A & M University-College Station","2019","Tenured, assistant professors","2","1","1","0","0","0","0","0","0","0","0","0","0","0","0","0","0","0","2","1","1","0","0","0","0","0","0","0","0","0","-2"
"228723","Texas A & M University-College Station","2019","Tenured, instructors","2","2","0","0","0","0","1","1","0","0","0","0","0","0","0","0","0","0","1","1","0","0","0","0","0","0","0","0","0","0","-2"
"228723","Texas A & M University-College Station","2019","On-Tenure track total","494","292","202","0","0","0","67","50","17","20","11","9","20","11","9","0","0","0","251","138","113","10","3","7","29","18","11","97","61","36","-2"
"228723","Texas A & M University-College Station","2019","On-tenure track, professors","7","7","0","0","0","0","1","1","0","0","0","0","0","0","0","0","0","0","6","6","0","0","0","0","0","0","0","0","0","0","-2"
"228723","Texas A & M University-College Station","2019","On-tenure track, associate professors","41","21","20","0","0","0","6","4","2","3","1","2","5","3","2","0","0","0","21","9","12","0","0","0","3","2","1","3","2","1","-2"
"228723","Texas A & M University-College Station","2019","On-tenure track, assistant professors","446","264","182","0","0","0","60","45","15","17","10","7","15","8","7","0","0","0","224","123","101","10","3","7","26","16","10","94","59","35","-2"
"228723","Texas A & M University-College Station","2019","Not on tenure track/No tenure system system total","1174","599","575","2","1","1","79","34","45","37","13","24","82","43","39","2","1","1","809","405","404","12","6","6","50","28","22","101","68","33","-2"
"228723","Texas A & M University-College Station","2019","Not on tenure/no tenure system, professors","132","109","23","0","0","0","13","12","1","6","3","3","8","7","1","0","0","0","83","65","18","0","0","0","4","4","0","18","18","0","-2"
"228723","Texas A & M University-College Station","2019","Not on tenure/no tenure system, associate professors","106","48","58","0","0","0","4","2","2","3","0","3","10","2","8","0","0","0","77","35","42","1","1","0","2","0","2","9","8","1","-2"
"228723","Texas A & M University-College Station","2019","Not on tenure/no tenure system, assistant professors","220","89","131","1","1","0","18","2","16","6","2","4","14","6","8","1","1","0","142","53","89","2","1","1","9","4","5","27","19","8","-2"
"228723","Texas A & M University-College Station","2019","Not on tenure/no tenure system, instructors","462","228","234","1","0","1","28","10","18","16","6","10","34","18","16","1","0","1","323","166","157","5","2","3","21","10","11","33","16","17","-2"
"228723","Texas A & M University-College Station","2019","Not on tenure/no tenure system, lecturers","254","125","129","0","0","0","16","8","8","6","2","4","16","10","6","0","0","0","184","86","98","4","2","2","14","10","4","14","7","7","-2"
"228769","The University of Texas at Arlington","2019","Tenured total","451","328","123","1","0","1","136","108","28","14","9","5","24","15","9","0","0","0","263","187","76","3","3","0","0","0","0","10","6","4","-2"
"228769","The University of Texas at Arlington","2019","Tenured, professors","228","188","40","0","0","0","79","67","12","4","3","1","7","7","0","0","0","0","135","109","26","1","1","0","0","0","0","2","1","1","-2"
"228769","The University of Texas at Arlington","2019","Tenured, associate professors","223","140","83","1","0","1","57","41","16","10","6","4","17","8","9","0","0","0","128","78","50","2","2","0","0","0","0","8","5","3","-2"
"228769","The University of Texas at Arlington","2019","On-Tenure track total","142","66","76","0","0","0","46","20","26","12","4","8","7","5","2","0","0","0","71","33","38","3","1","2","0","0","0","3","3","0","-2"
"228769","The University of Texas at Arlington","2019","On-tenure track, assistant professors","142","66","76","0","0","0","46","20","26","12","4","8","7","5","2","0","0","0","71","33","38","3","1","2","0","0","0","3","3","0","-2"
"228769","The University of Texas at Arlington","2019","Not on tenure track/No tenure system system total","498","196","302","2","1","1","37","20","17","47","10","37","30","18","12","0","0","0","315","121","194","3","2","1","52","16","36","12","8","4","-2"
"228769","The University of Texas at Arlington","2019","Not on tenure/no tenure system, lecturers","170","92","78","0","0","0","11","7","4","5","2","3","13","9","4","0","0","0","119","61","58","1","1","0","15","8","7","6","4","2","-2"
"228769","The University of Texas at Arlington","2019","Not on tenure/no tenure system, no academic rank","328","104","224","2","1","1","26","13","13","42","8","34","17","9","8","0","0","0","196","60","136","2","1","1","37","8","29","6","4","2","-2"
"228778","The University of Texas at Austin","2019","Tenured total","1439","970","469","3","1","2","155","115","40","58","33","25","100","60","40","0","0","0","1084","736","348","16","7","9","0","0","0","23","18","5","-2"
"228778","The University of Texas at Austin","2019","Tenured, professors","949","690","259","3","1","2","103","80","23","31","18","13","57","38","19","0","0","0","739","543","196","8","3","5","0","0","0","8","7","1","-2"
"228778","The University of Texas at Austin","2019","Tenured, associate professors","490","280","210","0","0","0","52","35","17","27","15","12","43","22","21","0","0","0","345","193","152","8","4","4","0","0","0","15","11","4","-2"
"228778","The University of Texas at Austin","2019","On-Tenure track total","356","182","174","0","0","0","44","26","18","22","10","12","38","13","25","0","0","0","191","97","94","4","2","2","0","0","0","57","34","23","-2"
"228778","The University of Texas at Austin","2019","On-tenure track, professors","2","1","1","0","0","0","1","1","0","0","0","0","0","0","0","0","0","0","1","0","1","0","0","0","0","0","0","0","0","0","-2"
"228778","The University of Texas at Austin","2019","On-tenure track, associate professors","12","6","6","0","0","0","1","1","0","1","1","0","1","0","1","0","0","0","9","4","5","0","0","0","0","0","0","0","0","0","-2"
"228778","The University of Texas at Austin","2019","On-tenure track, assistant professors","342","175","167","0","0","0","42","24","18","21","9","12","37","13","24","0","0","0","181","93","88","4","2","2","0","0","0","57","34","23","-2"
"228778","The University of Texas at Austin","2019","Not on tenure track/No tenure system system total","905","392","513","1","0","1","94","40","54","26","8","18","85","24","61","0","0","0","636","291","345","13","5","8","0","0","0","50","24","26","-2"
"228778","The University of Texas at Austin","2019","Not on tenure/no tenure system, assistant professors","2","1","1","0","0","0","0","0","0","0","0","0","0","0","0","0","0","0","2","1","1","0","0","0","0","0","0","0","0","0","-2"
"228778","The University of Texas at Austin","2019","Not on tenure/no tenure system, instructors","44","20","24","0","0","0","6","3","3","2","0","2","4","0","4","0","0","0","22","9","13","1","0","1","0","0","0","9","8","1","-2"
"228778","The University of Texas at Austin","2019","Not on tenure/no tenure system, lecturers","859","371","488","1","0","1","88","37","51","24","8","16","81","24","57","0","0","0","612","281","331","12","5","7","0","0","0","41","16","25","-2"
"228796","The University of Texas at El Paso","2019","Tenured total","337","246","91","0","0","0","54","40","14","5","4","1","100","66","34","0","0","0","172","132","40","4","3","1","0","0","0","2","1","1","-2"
"228796","The University of Texas at El Paso","2019","Tenured, professors","160","124","36","0","0","0","22","18","4","2","2","0","39","25","14","0","0","0","95","77","18","2","2","0","0","0","0","0","0","0","-2"
"228796","The University of Texas at El Paso","2019","Tenured, associate professors","177","122","55","0","0","0","32","22","10","3","2","1","61","41","20","0","0","0","77","55","22","2","1","1","0","0","0","2","1","1","-2"
"228796","The University of Texas at El Paso","2019","On-Tenure track total","152","85","67","0","0","0","28","18","10","4","3","1","34","19","15","0","0","0","58","30","28","2","2","0","1","1","0","25","12","13","-2"
"228796","The University of Texas at El Paso","2019","On-tenure track, associate professors","6","6","0","0","0","0","1","1","0","0","0","0","3","3","0","0","0","0","2","2","0","0","0","0","0","0","0","0","0","0","-2"
"228796","The University of Texas at El Paso","2019","On-tenure track, assistant professors","146","79","67","0","0","0","27","17","10","4","3","1","31","16","15","0","0","0","56","28","28","2","2","0","1","1","0","25","12","13","-2"
"228796","The University of Texas at El Paso","2019","Not on tenure track/No tenure system system total","285","108","177","1","0","1","8","2","6","5","3","2","141","53","88","1","0","1","109","38","71","3","1","2","2","2","0","15","9","6","-2"
"228796","The University of Texas at El Paso","2019","Not on tenure/no tenure system, lecturers","285","108","177","1","0","1","8","2","6","5","3","2","141","53","88","1","0","1","109","38","71","3","1","2","2","2","0","15","9","6","-2"
"229063","Texas Southern University","2019","Tenured total","220","124","96","0","0","0","37","24","13","135","69","66","8","6","2","0","0","0","29","18","11","0","0","0","0","0","0","11","7","4","-2"
"229063","Texas Southern University","2019","Tenured, professors","126","77","49","0","0","0","25","16","9","69","39","30","4","4","0","0","0","0","19","13","6","0","0","0","0","0","0","9","5","4","-2"
"229063","Texas Southern University","2019","Tenured, associate professors","89","44","45","0","0","0","11","7","4","63","28","35","4","2","2","0","0","0","9","5","4","0","0","0","0","0","0","2","2","0","-2"
"229063","Texas Southern University","2019","Tenured, assistant professors","5","3","2","0","0","0","1","1","0","3","2","1","0","0","0","0","0","0","1","0","1","0","0","0","0","0","0","0","0","0","-2"
"229063","Texas Southern University","2019","On-Tenure track total","23","6","17","0","0","0","5","2","3","15","3","12","0","0","0","0","0","0","3","1","2","0","0","0","0","0","0","0","0","0","-2"
"229063","Texas Southern University","2019","On-tenure track, associate professors","2","0","2","0","0","0","1","0","1","1","0","1","0","0","0","0","0","0","0","0","0","0","0","0","0","0","0","0","0","0","-2"
"229063","Texas Southern University","2019","On-tenure track, assistant professors","21","6","15","0","0","0","4","2","2","14","3","11","0","0","0","0","0","0","3","1","2","0","0","0","0","0","0","0","0","0","-2"
"229063","Texas Southern University","2019","Not on tenure track/No tenure system system total","190","84","106","1","1","0","12","7","5","144","54","90","13","8","5","0","0","0","18","13","5","0","0","0","0","0","0","2","1","1","-2"
"229063","Texas Southern University","2019","Not on tenure/no tenure system, instructors","10","6","4","0","0","0","1","1","0","6","5","1","1","0","1","0","0","0","1","0","1","0","0","0","0","0","0","1","0","1","-2"
"229063","Texas Southern University","2019","Not on tenure/no tenure system, no academic rank","180","78","102","1","1","0","11","6","5","138","49","89","12","8","4","0","0","0","17","13","4","0","0","0","0","0","0","1","1","0","-2"
"229115","Texas Tech University","2019","Tenured total","783","551","232","3","2","1","117","90","27","22","13","9","50","31","19","1","1","0","582","408","174","4","4","0","0","0","0","4","2","2","-2"
"229115","Texas Tech University","2019","Tenured, professors","391","295","96","3","2","1","55","47","8","14","9","5","17","11","6","1","1","0","297","223","74","1","1","0","0","0","0","3","1","2","-2"
"229115","Texas Tech University","2019","Tenured, associate professors","353","237","116","0","0","0","59","40","19","5","2","3","31","19","12","0","0","0","254","172","82","3","3","0","0","0","0","1","1","0","-2"
"229115","Texas Tech University","2019","Tenured, assistant professors","3","3","0","0","0","0","2","2","0","1","1","0","0","0","0","0","0","0","0","0","0","0","0","0","0","0","0","0","0","0","-2"
"229115","Texas Tech University","2019","Tenured, instructors","36","16","20","0","0","0","1","1","0","2","1","1","2","1","1","0","0","0","31","13","18","0","0","0","0","0","0","0","0","0","-2"
"229115","Texas Tech University","2019","On-Tenure track total","333","185","148","0","0","0","43","27","16","6","3","3","27","13","14","0","0","0","200","108","92","6","2","4","0","0","0","51","32","19","-2"
"229115","Texas Tech University","2019","On-tenure track, professors","1","1","0","0","0","0","0","0","0","0","0","0","0","0","0","0","0","0","1","1","0","0","0","0","0","0","0","0","0","0","-2"
"229115","Texas Tech University","2019","On-tenure track, associate professors","18","14","4","0","0","0","6","4","2","0","0","0","2","2","0","0","0","0","9","7","2","0","0","0","0","0","0","1","1","0","-2"
"229115","Texas Tech University","2019","On-tenure track, assistant professors","304","166","138","0","0","0","37","23","14","6","3","3","24","11","13","0","0","0","182","96","86","6","2","4","0","0","0","49","31","18","-2"
"229115","Texas Tech University","2019","On-tenure track, instructors","10","4","6","0","0","0","0","0","0","0","0","0","1","0","1","0","0","0","8","4","4","0","0","0","0","0","0","1","0","1","-2"
"229115","Texas Tech University","2019","Not on tenure track/No tenure system system total","574","271","303","1","0","1","38","17","21","7","4","3","56","24","32","0","0","0","362","154","208","5","3","2","0","0","0","105","69","36","-2"
"229115","Texas Tech University","2019","Not on tenure/no tenure system, lecturers","574","271","303","1","0","1","38","17","21","7","4","3","56","24","32","0","0","0","362","154","208","5","3","2","0","0","0","105","69","36","-2"
"230728","Utah State University","2019","Tenured total","486","353","133","0","0","0","29","21","8","3","2","1","24","13","11","0","0","0","418","309","109","3","1","2","9","7","2","0","0","0","-2"
"230728","Utah State University","2019","Tenured, professors","245","183","62","0","0","0","17","14","3","1","1","0","11","5","6","0","0","0","208","159","49","3","1","2","5","3","2","0","0","0","-2"
"230728","Utah State University","2019","Tenured, associate professors","240","169","71","0","0","0","12","7","5","2","1","1","13","8","5","0","0","0","209","149","60","0","0","0","4","4","0","0","0","0","-2"
"230728","Utah State University","2019","Tenured, instructors","1","1","0","0","0","0","0","0","0","0","0","0","0","0","0","0","0","0","1","1","0","0","0","0","0","0","0","0","0","0","-2"
"230728","Utah State University","2019","On-Tenure track total","226","121","105","1","0","1","21","12","9","0","0","0","13","6","7","1","1","0","127","67","60","4","2","2","59","33","26","0","0","0","-2"
"230728","Utah State University","2019","On-tenure track, associate professors","1","0","1","0","0","0","0","0","0","0","0","0","0","0","0","0","0","0","0","0","0","0","0","0","1","0","1","0","0","0","-2"
"230728","Utah State University","2019","On-tenure track, assistant professors","222","119","103","1","0","1","21","12","9","0","0","0","13","6","7","1","1","0","124","65","59","4","2","2","58","33","25","0","0","0","-2"
"230728","Utah State University","2019","On-tenure track, instructors","3","2","1","0","0","0","0","0","0","0","0","0","0","0","0","0","0","0","3","2","1","0","0","0","0","0","0","0","0","0","-2"
"230728","Utah State University","2019","Not on tenure track/No tenure system system total","298","143","155","3","2","1","3","1","2","1","1","0","7","3","4","0","0","0","257","125","132","3","1","2","24","10","14","0","0","0","-2"
"230728","Utah State University","2019","Not on tenure/no tenure system, professors","8","6","2","0","0","0","0","0","0","0","0","0","0","0","0","0","0","0","5","4","1","0","0","0","3","2","1","0","0","0","-2"
"230728","Utah State University","2019","Not on tenure/no tenure system, associate professors","27","14","13","0","0","0","0","0","0","0","0","0","0","0","0","0","0","0","25","13","12","1","1","0","1","0","1","0","0","0","-2"
"230728","Utah State University","2019","Not on tenure/no tenure system, assistant professors","105","43","62","0","0","0","1","1","0","0","0","0","3","1","2","0","0","0","88","37","51","1","0","1","12","4","8","0","0","0","-2"
"230728","Utah State University","2019","Not on tenure/no tenure system, instructors","26","10","16","1","1","0","0","0","0","0","0","0","1","1","0","0","0","0","21","7","14","0","0","0","3","1","2","0","0","0","-2"
"230728","Utah State University","2019","Not on tenure/no tenure system, lecturers","132","70","62","2","1","1","2","0","2","1","1","0","3","1","2","0","0","0","118","64","54","1","0","1","5","3","2","0","0","0","-2"
"230764","University of Utah","2019","Tenured total","1093","750","343","1","1","0","110","83","27","10","7","3","34","20","14","1","0","1","842","570","272","12","8","4","73","54","19","10","7","3","-2"
"230764","University of Utah","2019","Tenured, professors","699","510","189","1","1","0","67","55","12","5","4","1","15","10","5","0","0","0","568","407","161","3","2","1","32","25","7","8","6","2","-2"
"230764","University of Utah","2019","Tenured, associate professors","392","239","153","0","0","0","43","28","15","5","3","2","19","10","9","1","0","1","273","163","110","8","5","3","41","29","12","2","1","1","-2"
"230764","University of Utah","2019","Tenured, assistant professors","2","1","1","0","0","0","0","0","0","0","0","0","0","0","0","0","0","0","1","0","1","1","1","0","0","0","0","0","0","0","-2"
"230764","University of Utah","2019","On-Tenure track total","525","311","214","3","1","2","78","40","38","7","4","3","32","21","11","2","0","2","306","190","116","11","4","7","41","22","19","45","29","16","-2"
"230764","University of Utah","2019","On-tenure track, professors","26","16","10","0","0","0","2","2","0","0","0","0","2","2","0","0","0","0","18","11","7","1","0","1","1","0","1","2","1","1","-2"
"230764","University of Utah","2019","On-tenure track, associate professors","59","32","27","0","0","0","6","3","3","1","0","1","3","2","1","0","0","0","36","21","15","1","0","1","9","4","5","3","2","1","-2"
"230764","University of Utah","2019","On-tenure track, assistant professors","433","257","176","3","1","2","68","34","34","6","4","2","27","17","10","2","0","2","249","155","94","9","4","5","30","17","13","39","25","14","-2"
"230764","University of Utah","2019","On-tenure track, instructors","7","6","1","0","0","0","2","1","1","0","0","0","0","0","0","0","0","0","3","3","0","0","0","0","1","1","0","1","1","0","-2"
"230764","University of Utah","2019","Not on tenure track/No tenure system system total","606","308","298","3","0","3","23","9","14","5","2","3","23","8","15","1","1","0","466","236","230","10","8","2","48","29","19","27","15","12","-2"
"230764","University of Utah","2019","Not on tenure/no tenure system, professors","48","25","23","0","0","0","2","1","1","0","0","0","1","0","1","1","1","0","43","22","21","0","0","0","1","1","0","0","0","0","-2"
"230764","University of Utah","2019","Not on tenure/no tenure system, associate professors","84","43","41","0","0","0","6","3","3","1","0","1","2","0","2","0","0","0","61","30","31","1","1","0","13","9","4","0","0","0","-2"
"230764","University of Utah","2019","Not on tenure/no tenure system, assistant professors","156","66","90","1","0","1","8","3","5","1","0","1","3","1","2","0","0","0","114","45","69","6","5","1","12","5","7","11","7","4","-2"
"230764","University of Utah","2019","Not on tenure/no tenure system, instructors","19","5","14","0","0","0","0","0","0","0","0","0","1","1","0","0","0","0","18","4","14","0","0","0","0","0","0","0","0","0","-2"
"230764","University of Utah","2019","Not on tenure/no tenure system, lecturers","299","169","130","2","0","2","7","2","5","3","2","1","16","6","10","0","0","0","230","135","95","3","2","1","22","14","8","16","8","8","-2"
"230913","Northern Vermont University","2019","Tenured total","56","35","21","0","0","0","0","0","0","0","0","0","0","0","0","0","0","0","53","32","21","0","0","0","3","3","0","0","0","0","-2"
"230913","Northern Vermont University","2019","Tenured, professors","34","20","14","0","0","0","0","0","0","0","0","0","0","0","0","0","0","0","34","20","14","0","0","0","0","0","0","0","0","0","-2"
"230913","Northern Vermont University","2019","Tenured, associate professors","20","15","5","0","0","0","0","0","0","0","0","0","0","0","0","0","0","0","17","12","5","0","0","0","3","3","0","0","0","0","-2"
"230913","Northern Vermont University","2019","Tenured, assistant professors","2","0","2","0","0","0","0","0","0","0","0","0","0","0","0","0","0","0","2","0","2","0","0","0","0","0","0","0","0","0","-2"
"230913","Northern Vermont University","2019","On-Tenure track total","19","11","8","0","0","0","0","0","0","0","0","0","0","0","0","0","0","0","8","5","3","0","0","0","11","6","5","0","0","0","-2"
"230913","Northern Vermont University","2019","On-tenure track, associate professors","1","0","1","0","0","0","0","0","0","0","0","0","0","0","0","0","0","0","0","0","0","0","0","0","1","0","1","0","0","0","-2"
"230913","Northern Vermont University","2019","On-tenure track, assistant professors","18","11","7","0","0","0","0","0","0","0","0","0","0","0","0","0","0","0","8","5","3","0","0","0","10","6","4","0","0","0","-2"
"230913","Northern Vermont University","2019","Not on tenure track/No tenure system system total","6","1","5","0","0","0","0","0","0","0","0","0","0","0","0","0","0","0","2","1","1","0","0","0","4","0","4","0","0","0","-2"
"230913","Northern Vermont University","2019","Not on tenure/no tenure system, professors","1","1","0","0","0","0","0","0","0","0","0","0","0","0","0","0","0","0","1","1","0","0","0","0","0","0","0","0","0","0","-2"
"230913","Northern Vermont University","2019","Not on tenure/no tenure system, assistant professors","5","0","5","0","0","0","0","0","0","0","0","0","0","0","0","0","0","0","1","0","1","0","0","0","4","0","4","0","0","0","-2"
"232186","George Mason University","2019","Tenured total","685","444","241","1","1","0","105","73","32","26","14","12","22","15","7","0","0","0","491","313","178","10","5","5","25","19","6","5","4","1","-2"
"232186","George Mason University","2019","Tenured, professors","347","251","96","1","1","0","48","38","10","8","4","4","10","9","1","0","0","0","259","182","77","2","1","1","17","14","3","2","2","0","-2"
"232186","George Mason University","2019","Tenured, associate professors","338","193","145","0","0","0","57","35","22","18","10","8","12","6","6","0","0","0","232","131","101","8","4","4","8","5","3","3","2","1","-2"
"232186","George Mason University","2019","On-Tenure track total","228","126","102","0","0","0","29","17","12","10","6","4","11","6","5","0","0","0","119","62","57","8","5","3","6","3","3","45","27","18","-2"
"232186","George Mason University","2019","On-tenure track, professors","1","1","0","0","0","0","0","0","0","0","0","0","0","0","0","0","0","0","1","1","0","0","0","0","0","0","0","0","0","0","-2"
"232186","George Mason University","2019","On-tenure track, associate professors","10","5","5","0","0","0","3","1","2","0","0","0","1","1","0","0","0","0","6","3","3","0","0","0","0","0","0","0","0","0","-2"
"232186","George Mason University","2019","On-tenure track, assistant professors","217","120","97","0","0","0","26","16","10","10","6","4","10","5","5","0","0","0","112","58","54","8","5","3","6","3","3","45","27","18","-2"
"232186","George Mason University","2019","Not on tenure track/No tenure system system total","484","203","281","2","2","0","40","17","23","28","10","18","19","5","14","0","0","0","356","148","208","5","3","2","17","9","8","17","9","8","-2"
"232186","George Mason University","2019","Not on tenure/no tenure system, professors","38","18","20","0","0","0","1","1","0","2","2","0","0","0","0","0","0","0","32","13","19","1","0","1","2","2","0","0","0","0","-2"
"232186","George Mason University","2019","Not on tenure/no tenure system, associate professors","111","50","61","0","0","0","11","4","7","7","2","5","3","2","1","0","0","0","84","37","47","3","2","1","3","3","0","0","0","0","-2"
"232186","George Mason University","2019","Not on tenure/no tenure system, assistant professors","229","88","141","2","2","0","20","8","12","14","4","10","11","2","9","0","0","0","158","61","97","1","1","0","8","2","6","15","8","7","-2"
"232186","George Mason University","2019","Not on tenure/no tenure system, instructors","106","47","59","0","0","0","8","4","4","5","2","3","5","1","4","0","0","0","82","37","45","0","0","0","4","2","2","2","1","1","-2"
"232265","Hampton University","2019","Tenured total","60","34","26","0","0","0","10","7","3","33","13","20","3","2","1","0","0","0","14","12","2","0","0","0","0","0","0","0","0","0","-2"
"232265","Hampton University","2019","Tenured, professors","32","21","11","0","0","0","6","5","1","16","7","9","3","2","1","0","0","0","7","7","0","0","0","0","0","0","0","0","0","0","-2"
"232265","Hampton University","2019","Tenured, associate professors","25","10","15","0","0","0","4","2","2","17","6","11","0","0","0","0","0","0","4","2","2","0","0","0","0","0","0","0","0","0","-2"
"232265","Hampton University","2019","Tenured, assistant professors","3","3","0","0","0","0","0","0","0","0","0","0","0","0","0","0","0","0","3","3","0","0","0","0","0","0","0","0","0","0","-2"
"232265","Hampton University","2019","On-Tenure track total","36","13","23","0","0","0","3","2","1","27","7","20","1","0","1","0","0","0","5","4","1","0","0","0","0","0","0","0","0","0","-2"
"232265","Hampton University","2019","On-tenure track, professors","1","1","0","0","0","0","1","1","0","0","0","0","0","0","0","0","0","0","0","0","0","0","0","0","0","0","0","0","0","0","-2"
"232265","Hampton University","2019","On-tenure track, associate professors","13","6","7","0","0","0","0","0","0","11","4","7","0","0","0","0","0","0","2","2","0","0","0","0","0","0","0","0","0","0","-2"
"232265","Hampton University","2019","On-tenure track, assistant professors","22","6","16","0","0","0","2","1","1","16","3","13","1","0","1","0","0","0","3","2","1","0","0","0","0","0","0","0","0","0","-2"
"232265","Hampton University","2019","Not on tenure track/No tenure system system total","156","84","72","0","0","0","30","11","19","79","42","37","2","1","1","0","0","0","45","30","15","0","0","0","0","0","0","0","0","0","-2"
"232265","Hampton University","2019","Not on tenure/no tenure system, professors","2","2","0","0","0","0","0","0","0","1","1","0","0","0","0","0","0","0","1","1","0","0","0","0","0","0","0","0","0","0","-2"
"232265","Hampton University","2019","Not on tenure/no tenure system, associate professors","23","11","12","0","0","0","3","1","2","13","6","7","0","0","0","0","0","0","7","4","3","0","0","0","0","0","0","0","0","0","-2"
"232265","Hampton University","2019","Not on tenure/no tenure system, assistant professors","96","57","39","0","0","0","14","7","7","50","28","22","1","1","0","0","0","0","31","21","10","0","0","0","0","0","0","0","0","0","-2"
"232265","Hampton University","2019","Not on tenure/no tenure system, instructors","17","7","10","0","0","0","9","0","9","6","6","0","1","0","1","0","0","0","1","1","0","0","0","0","0","0","0","0","0","0","-2"
"232265","Hampton University","2019","Not on tenure/no tenure system, lecturers","3","1","2","0","0","0","1","0","1","1","0","1","0","0","0","0","0","0","1","1","0","0","0","0","0","0","0","0","0","0","-2"
"232265","Hampton University","2019","Not on tenure/no tenure system, no academic rank","15","6","9","0","0","0","3","3","0","8","1","7","0","0","0","0","0","0","4","2","2","0","0","0","0","0","0","0","0","0","-2"
"232982","Old Dominion University","2019","Tenured total","410","280","130","2","1","1","71","53","18","22","13","9","14","10","4","0","0","0","247","164","83","2","1","1","42","32","10","10","6","4","-2"
"232982","Old Dominion University","2019","Tenured, professors","205","155","50","1","0","1","37","29","8","11","7","4","6","5","1","0","0","0","116","86","30","0","0","0","28","24","4","6","4","2","-2"
"232982","Old Dominion University","2019","Tenured, associate professors","205","125","80","1","1","0","34","24","10","11","6","5","8","5","3","0","0","0","131","78","53","2","1","1","14","8","6","4","2","2","-2"
"232982","Old Dominion University","2019","On-Tenure track total","184","93","91","0","0","0","33","22","11","11","5","6","6","4","2","0","0","0","104","45","59","1","1","0","1","1","0","28","15","13","-2"
"232982","Old Dominion University","2019","On-tenure track, professors","1","1","0","0","0","0","0","0","0","1","1","0","0","0","0","0","0","0","0","0","0","0","0","0","0","0","0","0","0","0","-2"
"232982","Old Dominion University","2019","On-tenure track, associate professors","10","7","3","0","0","0","3","3","0","1","0","1","0","0","0","0","0","0","4","3","1","0","0","0","0","0","0","2","1","1","-2"
"232982","Old Dominion University","2019","On-tenure track, assistant professors","172","85","87","0","0","0","30","19","11","9","4","5","6","4","2","0","0","0","100","42","58","1","1","0","1","1","0","25","14","11","-2"
"232982","Old Dominion University","2019","On-tenure track, instructors","1","0","1","0","0","0","0","0","0","0","0","0","0","0","0","0","0","0","0","0","0","0","0","0","0","0","0","1","0","1","-2"
"232982","Old Dominion University","2019","Not on tenure track/No tenure system system total","274","98","176","0","0","0","14","9","5","20","2","18","15","5","10","0","0","0","194","65","129","6","3","3","14","7","7","11","7","4","-2"
"232982","Old Dominion University","2019","Not on tenure/no tenure system, professors","2","0","2","0","0","0","0","0","0","0","0","0","0","0","0","0","0","0","2","0","2","0","0","0","0","0","0","0","0","0","-2"
"232982","Old Dominion University","2019","Not on tenure/no tenure system, associate professors","3","2","1","0","0","0","0","0","0","1","0","1","0","0","0","0","0","0","1","1","0","0","0","0","0","0","0","1","1","0","-2"
"232982","Old Dominion University","2019","Not on tenure/no tenure system, assistant professors","28","12","16","0","0","0","3","3","0","5","2","3","3","0","3","0","0","0","12","2","10","0","0","0","1","1","0","4","4","0","-2"
"232982","Old Dominion University","2019","Not on tenure/no tenure system, instructors","7","2","5","0","0","0","0","0","0","0","0","0","0","0","0","0","0","0","6","1","5","0","0","0","1","1","0","0","0","0","-2"
"232982","Old Dominion University","2019","Not on tenure/no tenure system, lecturers","234","82","152","0","0","0","11","6","5","14","0","14","12","5","7","0","0","0","173","61","112","6","3","3","12","5","7","6","2","4","-2"
"233921","Virginia Polytechnic Institute and State University","2019","Tenured total","1044","755","289","4","3","1","142","108","34","31","20","11","34","25","9","1","1","0","813","584","229","5","2","3","0","0","0","14","12","2","-2"
"233921","Virginia Polytechnic Institute and State University","2019","Tenured, professors","574","464","110","1","0","1","85","73","12","16","11","5","16","13","3","0","0","0","449","362","87","2","1","1","0","0","0","5","4","1","-2"
"233921","Virginia Polytechnic Institute and State University","2019","Tenured, associate professors","470","291","179","3","3","0","57","35","22","15","9","6","18","12","6","1","1","0","364","222","142","3","1","2","0","0","0","9","8","1","-2"
"233921","Virginia Polytechnic Institute and State University","2019","On-Tenure track total","446","264","182","1","1","0","73","44","29","22","11","11","17","13","4","1","0","1","263","148","115","3","3","0","0","0","0","66","44","22","-2"
"233921","Virginia Polytechnic Institute and State University","2019","On-tenure track, associate professors","22","16","6","0","0","0","5","3","2","1","1","0","1","1","0","0","0","0","14","10","4","0","0","0","0","0","0","1","1","0","-2"
"233921","Virginia Polytechnic Institute and State University","2019","On-tenure track, assistant professors","424","248","176","1","1","0","68","41","27","21","10","11","16","12","4","1","0","1","249","138","111","3","3","0","0","0","0","65","43","22","-2"
"233921","Virginia Polytechnic Institute and State University","2019","Not on tenure track/No tenure system system total","598","313","285","0","0","0","32","17","15","19","9","10","24","5","19","1","1","0","466","239","227","7","4","3","0","0","0","49","38","11","-2"
"233921","Virginia Polytechnic Institute and State University","2019","Not on tenure/no tenure system, professors","31","26","5","0","0","0","1","1","0","1","1","0","0","0","0","0","0","0","27","22","5","0","0","0","0","0","0","2","2","0","-2"
"233921","Virginia Polytechnic Institute and State University","2019","Not on tenure/no tenure system, associate professors","58","34","24","0","0","0","2","1","1","1","1","0","2","1","1","0","0","0","50","28","22","0","0","0","0","0","0","3","3","0","-2"
"233921","Virginia Polytechnic Institute and State University","2019","Not on tenure/no tenure system, assistant professors","166","82","84","0","0","0","11","7","4","7","0","7","7","1","6","0","0","0","120","59","61","3","1","2","0","0","0","18","14","4","-2"
"233921","Virginia Polytechnic Institute and State University","2019","Not on tenure/no tenure system, instructors","302","143","159","0","0","0","17","7","10","10","7","3","13","3","10","0","0","0","233","105","128","3","2","1","0","0","0","26","19","7","-2"
"233921","Virginia Polytechnic Institute and State University","2019","Not on tenure/no tenure system, lecturers","3","2","1","0","0","0","0","0","0","0","0","0","0","0","0","0","0","0","3","2","1","0","0","0","0","0","0","0","0","0","-2"
"233921","Virginia Polytechnic Institute and State University","2019","Not on tenure/no tenure system, no academic rank","38","26","12","0","0","0","1","1","0","0","0","0","2","0","2","1","1","0","33","23","10","1","1","0","0","0","0","0","0","0","-2"
"234076","University of Virginia-Main Campus","2019","Tenured total","1036","745","291","0","0","0","89","64","25","45","26","19","27","19","8","0","0","0","813","596","217","12","5","7","11","6","5","39","29","10","-2"
"234076","University of Virginia-Main Campus","2019","Tenured, professors","669","512","157","0","0","0","52","44","8","20","14","6","16","13","3","0","0","0","542","416","126","8","3","5","7","3","4","24","19","5","-2"
"234076","University of Virginia-Main Campus","2019","Tenured, associate professors","367","233","134","0","0","0","37","20","17","25","12","13","11","6","5","0","0","0","271","180","91","4","2","2","4","3","1","15","10","5","-2"
"234076","University of Virginia-Main Campus","2019","On-Tenure track total","418","252","166","0","0","0","62","37","25","26","14","12","14","8","6","1","1","0","241","140","101","3","2","1","16","9","7","55","41","14","-2"
"234076","University of Virginia-Main Campus","2019","On-tenure track, associate professors","78","51","27","0","0","0","15","13","2","2","1","1","2","1","1","0","0","0","51","32","19","1","1","0","4","2","2","3","1","2","-2"
"234076","University of Virginia-Main Campus","2019","On-tenure track, assistant professors","340","201","139","0","0","0","47","24","23","24","13","11","12","7","5","1","1","0","190","108","82","2","1","1","12","7","5","52","40","12","-2"
"234076","University of Virginia-Main Campus","2019","Not on tenure track/No tenure system system total","953","468","485","0","0","0","99","43","56","28","9","19","23","5","18","0","0","0","687","351","336","7","3","4","39","19","20","70","38","32","-2"
"234076","University of Virginia-Main Campus","2019","Not on tenure/no tenure system, professors","102","68","34","0","0","0","5","0","5","4","1","3","1","1","0","0","0","0","88","62","26","0","0","0","4","4","0","0","0","0","-2"
"234076","University of Virginia-Main Campus","2019","Not on tenure/no tenure system, associate professors","258","137","121","0","0","0","23","10","13","7","3","4","5","2","3","0","0","0","207","114","93","3","1","2","7","4","3","6","3","3","-2"
"234076","University of Virginia-Main Campus","2019","Not on tenure/no tenure system, assistant professors","435","204","231","0","0","0","54","27","27","15","5","10","13","1","12","0","0","0","290","137","153","3","2","1","21","8","13","39","24","15","-2"
"234076","University of Virginia-Main Campus","2019","Not on tenure/no tenure system, instructors","49","26","23","0","0","0","7","4","3","1","0","1","2","1","1","0","0","0","26","14","12","0","0","0","7","3","4","6","4","2","-2"
"234076","University of Virginia-Main Campus","2019","Not on tenure/no tenure system, lecturers","109","33","76","0","0","0","10","2","8","1","0","1","2","0","2","0","0","0","76","24","52","1","0","1","0","0","0","19","7","12","-2"
"236939","Washington State University","2019","Tenured total","619","422","197","4","3","1","82","67","15","7","5","2","20","13","7","3","2","1","362","230","132","9","4","5","130","97","33","2","1","1","-2"
"236939","Washington State University","2019","Tenured, professors","336","246","90","2","2","0","46","41","5","3","3","0","11","8","3","3","2","1","209","145","64","7","3","4","55","42","13","0","0","0","-2"
"236939","Washington State University","2019","Tenured, associate professors","283","176","107","2","1","1","36","26","10","4","2","2","9","5","4","0","0","0","153","85","68","2","1","1","75","55","20","2","1","1","-2"
"236939","Washington State University","2019","On-Tenure track total","215","111","104","0","0","0","15","9","6","0","0","0","6","1","5","0","0","0","56","18","38","4","2","2","108","69","39","26","12","14","-2"
"236939","Washington State University","2019","On-tenure track, professors","2","1","1","0","0","0","0","0","0","0","0","0","0","0","0","0","0","0","1","0","1","0","0","0","1","1","0","0","0","0","-2"
"236939","Washington State University","2019","On-tenure track, associate professors","11","5","6","0","0","0","0","0","0","0","0","0","0","0","0","0","0","0","5","2","3","0","0","0","5","3","2","1","0","1","-2"
"236939","Washington State University","2019","On-tenure track, assistant professors","202","105","97","0","0","0","15","9","6","0","0","0","6","1","5","0","0","0","50","16","34","4","2","2","102","65","37","25","12","13","-2"
"236939","Washington State University","2019","Not on tenure track/No tenure system system total","498","219","279","1","0","1","18","2","16","6","4","2","23","9","14","0","0","0","296","119","177","3","1","2","132","72","60","19","12","7","-2"
"236939","Washington State University","2019","Not on tenure/no tenure system, instructors","196","72","124","0","0","0","6","0","6","0","0","0","8","2","6","0","0","0","113","37","76","1","0","1","60","28","32","8","5","3","-2"
"236939","Washington State University","2019","Not on tenure/no tenure system, no academic rank","302","147","155","1","0","1","12","2","10","6","4","2","15","7","8","0","0","0","183","82","101","2","1","1","72","44","28","11","7","4","-2"
"236948","University of Washington-Seattle Campus","2019","Tenured total","2237","1424","813","7","4","3","346","224","122","40","18","22","93","54","39","1","1","0","1602","1030","572","37","17","20","102","69","33","9","7","2","-2"
"236948","University of Washington-Seattle Campus","2019","Tenured, professors","1384","940","444","3","2","1","187","134","53","18","9","9","43","31","12","1","1","0","1069","719","350","13","10","3","46","30","16","4","4","0","-2"
"236948","University of Washington-Seattle Campus","2019","Tenured, associate professors","853","484","369","4","2","2","159","90","69","22","9","13","50","23","27","0","0","0","533","311","222","24","7","17","56","39","17","5","3","2","-2"
"236948","University of Washington-Seattle Campus","2019","On-Tenure track total","673","315","358","6","0","6","131","54","77","19","6","13","27","12","15","1","0","1","357","167","190","11","7","4","68","40","28","53","29","24","-2"
"236948","University of Washington-Seattle Campus","2019","On-tenure track, professors","1","0","1","0","0","0","1","0","1","0","0","0","0","0","0","0","0","0","0","0","0","0","0","0","0","0","0","0","0","0","-2"
"236948","University of Washington-Seattle Campus","2019","On-tenure track, associate professors","4","1","3","0","0","0","0","0","0","0","0","0","0","0","0","0","0","0","2","1","1","1","0","1","1","0","1","0","0","0","-2"
"236948","University of Washington-Seattle Campus","2019","On-tenure track, assistant professors","668","314","354","6","0","6","130","54","76","19","6","13","27","12","15","1","0","1","355","166","189","10","7","3","67","40","27","53","29","24","-2"
"236948","University of Washington-Seattle Campus","2019","Not on tenure track/No tenure system system total","1467","646","821","3","1","2","224","100","124","25","9","16","72","34","38","2","2","0","865","364","501","34","8","26","145","69","76","97","59","38","-2"
"236948","University of Washington-Seattle Campus","2019","Not on tenure/no tenure system, professors","105","63","42","0","0","0","9","4","5","0","0","0","5","4","1","0","0","0","87","52","35","0","0","0","3","2","1","1","1","0","-2"
"236948","University of Washington-Seattle Campus","2019","Not on tenure/no tenure system, associate professors","152","88","64","1","0","1","35","23","12","1","1","0","8","4","4","1","1","0","94","49","45","2","1","1","5","5","0","5","4","1","-2"
"236948","University of Washington-Seattle Campus","2019","Not on tenure/no tenure system, assistant professors","341","161","180","0","0","0","75","37","38","8","1","7","16","7","9","0","0","0","165","74","91","7","2","5","41","19","22","29","21","8","-2"
"236948","University of Washington-Seattle Campus","2019","Not on tenure/no tenure system, instructors","207","119","88","0","0","0","32","17","15","2","0","2","8","6","2","1","1","0","75","42","33","7","2","5","37","26","11","45","25","20","-2"
"236948","University of Washington-Seattle Campus","2019","Not on tenure/no tenure system, lecturers","662","215","447","2","1","1","73","19","54","14","7","7","35","13","22","0","0","0","444","147","297","18","3","15","59","17","42","17","8","9","-2"
"237057","Whitman College","2019","Tenured total","94","53","41","0","0","0","7","3","4","2","1","1","2","2","0","0","0","0","75","46","29","0","0","0","1","0","1","7","1","6","-2"
"237057","Whitman College","2019","Tenured, professors","40","27","13","0","0","0","2","0","2","0","0","0","0","0","0","0","0","0","37","27","10","0","0","0","0","0","0","1","0","1","-2"
"237057","Whitman College","2019","Tenured, associate professors","52","25","27","0","0","0","4","2","2","2","1","1","2","2","0","0","0","0","37","19","18","0","0","0","1","0","1","6","1","5","-2"
"237057","Whitman College","2019","Tenured, assistant professors","2","1","1","0","0","0","1","1","0","0","0","0","0","0","0","0","0","0","1","0","1","0","0","0","0","0","0","0","0","0","-2"
"237057","Whitman College","2019","On-Tenure track total","33","16","17","0","0","0","1","0","1","0","0","0","4","3","1","0","0","0","22","9","13","0","0","0","2","2","0","4","2","2","-2"
"237057","Whitman College","2019","On-tenure track, assistant professors","33","16","17","0","0","0","1","0","1","0","0","0","4","3","1","0","0","0","22","9","13","0","0","0","2","2","0","4","2","2","-2"
"237057","Whitman College","2019","Not on tenure track/No tenure system system total","69","34","35","0","0","0","2","1","1","3","2","1","2","1","1","1","1","0","41","18","23","2","1","1","16","9","7","2","1","1","-2"
"237057","Whitman College","2019","Not on tenure/no tenure system, associate professors","2","0","2","0","0","0","0","0","0","0","0","0","0","0","0","0","0","0","1","0","1","0","0","0","1","0","1","0","0","0","-2"
"237057","Whitman College","2019","Not on tenure/no tenure system, assistant professors","21","10","11","0","0","0","0","0","0","2","2","0","1","0","1","0","0","0","14","5","9","2","1","1","2","2","0","0","0","0","-2"
"237057","Whitman College","2019","Not on tenure/no tenure system, instructors","21","9","12","0","0","0","1","0","1","1","0","1","0","0","0","0","0","0","5","2","3","0","0","0","13","7","6","1","0","1","-2"
"237057","Whitman College","2019","Not on tenure/no tenure system, lecturers","25","15","10","0","0","0","1","1","0","0","0","0","1","1","0","1","1","0","21","11","10","0","0","0","0","0","0","1","1","0","-2"
"237525","Marshall University","2019","Tenured total","394","236","158","1","0","1","44","32","12","8","6","2","8","4","4","0","0","0","321","189","132","0","0","0","5","4","1","7","1","6","-2"
"237525","Marshall University","2019","Tenured, professors","232","151","81","1","0","1","25","19","6","6","5","1","6","3","3","0","0","0","186","119","67","0","0","0","4","4","0","4","1","3","-2"
"237525","Marshall University","2019","Tenured, associate professors","160","85","75","0","0","0","19","13","6","2","1","1","2","1","1","0","0","0","133","70","63","0","0","0","1","0","1","3","0","3","-2"
"237525","Marshall University","2019","Tenured, assistant professors","2","0","2","0","0","0","0","0","0","0","0","0","0","0","0","0","0","0","2","0","2","0","0","0","0","0","0","0","0","0","-2"
"237525","Marshall University","2019","On-Tenure track total","172","89","83","1","0","1","27","19","8","9","4","5","2","2","0","0","0","0","124","59","65","0","0","0","7","4","3","2","1","1","-2"
"237525","Marshall University","2019","On-tenure track, professors","4","4","0","0","0","0","0","0","0","0","0","0","0","0","0","0","0","0","4","4","0","0","0","0","0","0","0","0","0","0","-2"
"237525","Marshall University","2019","On-tenure track, associate professors","12","5","7","0","0","0","4","3","1","0","0","0","0","0","0","0","0","0","8","2","6","0","0","0","0","0","0","0","0","0","-2"
"237525","Marshall University","2019","On-tenure track, assistant professors","156","80","76","1","0","1","23","16","7","9","4","5","2","2","0","0","0","0","112","53","59","0","0","0","7","4","3","2","1","1","-2"
"237525","Marshall University","2019","Not on tenure track/No tenure system system total","268","142","126","1","1","0","23","12","11","10","5","5","6","2","4","0","0","0","206","109","97","0","0","0","17","9","8","5","4","1","-2"
"237525","Marshall University","2019","Not on tenure/no tenure system, professors","9","6","3","0","0","0","0","0","0","0","0","0","0","0","0","0","0","0","8","5","3","0","0","0","1","1","0","0","0","0","-2"
"237525","Marshall University","2019","Not on tenure/no tenure system, associate professors","36","29","7","1","1","0","1","1","0","3","2","1","2","1","1","0","0","0","27","22","5","0","0","0","1","1","0","1","1","0","-2"
"237525","Marshall University","2019","Not on tenure/no tenure system, assistant professors","148","85","63","0","0","0","17","10","7","6","3","3","3","1","2","0","0","0","109","62","47","0","0","0","11","7","4","2","2","0","-2"
"237525","Marshall University","2019","Not on tenure/no tenure system, instructors","75","22","53","0","0","0","5","1","4","1","0","1","1","0","1","0","0","0","62","20","42","0","0","0","4","0","4","2","1","1","-2"
"239512","Northland College","2019","Tenured total","25","17","8","0","0","0","1","1","0","0","0","0","0","0","0","0","0","0","24","16","8","0","0","0","0","0","0","0","0","0","-2"
"239512","Northland College","2019","Tenured, professors","13","10","3","0","0","0","1","1","0","0","0","0","0","0","0","0","0","0","12","9","3","0","0","0","0","0","0","0","0","0","-2"
"239512","Northland College","2019","Tenured, associate professors","12","7","5","0","0","0","0","0","0","0","0","0","0","0","0","0","0","0","12","7","5","0","0","0","0","0","0","0","0","0","-2"
"239512","Northland College","2019","On-Tenure track total","15","8","7","0","0","0","0","0","0","0","0","0","0","0","0","0","0","0","15","8","7","0","0","0","0","0","0","0","0","0","-2"
"239512","Northland College","2019","On-tenure track, assistant professors","15","8","7","0","0","0","0","0","0","0","0","0","0","0","0","0","0","0","15","8","7","0","0","0","0","0","0","0","0","0","-2"
"239512","Northland College","2019","Not on tenure track/No tenure system system total","7","2","5","0","0","0","0","0","0","0","0","0","0","0","0","0","0","0","6","1","5","0","0","0","1","1","0","0","0","0","-2"
"239512","Northland College","2019","Not on tenure/no tenure system, assistant professors","3","2","1","0","0","0","0","0","0","0","0","0","0","0","0","0","0","0","2","1","1","0","0","0","1","1","0","0","0","0","-2"
"239512","Northland College","2019","Not on tenure/no tenure system, instructors","4","0","4","0","0","0","0","0","0","0","0","0","0","0","0","0","0","0","4","0","4","0","0","0","0","0","0","0","0","0","-2"
"240444","University of Wisconsin-Madison","2019","Tenured total","1505","999","506","4","2","2","182","120","62","31","16","15","49","31","18","2","0","2","1181","796","385","15","8","7","33","22","11","8","4","4","-2"
"240444","University of Wisconsin-Madison","2019","Tenured, professors","1111","772","339","3","1","2","134","89","45","20","10","10","32","20","12","2","0","2","892","633","259","9","6","3","17","12","5","2","1","1","-2"
"240444","University of Wisconsin-Madison","2019","Tenured, associate professors","394","227","167","1","1","0","48","31","17","11","6","5","17","11","6","0","0","0","289","163","126","6","2","4","16","10","6","6","3","3","-2"
"240444","University of Wisconsin-Madison","2019","On-Tenure track total","444","241","203","2","1","1","81","44","37","24","8","16","26","13","13","0","0","0","211","113","98","12","6","6","32","18","14","56","38","18","-2"
"240444","University of Wisconsin-Madison","2019","On-tenure track, assistant professors","444","241","203","2","1","1","81","44","37","24","8","16","26","13","13","0","0","0","211","113","98","12","6","6","32","18","14","56","38","18","-2"
"240444","University of Wisconsin-Madison","2019","Not on tenure track/No tenure system system total","1630","877","753","4","2","2","132","79","53","28","11","17","40","21","19","1","0","1","1218","636","582","20","6","14","154","100","54","33","22","11","-2"
"240444","University of Wisconsin-Madison","2019","Not on tenure/no tenure system, professors","398","226","172","1","0","1","23","11","12","6","4","2","5","3","2","0","0","0","341","190","151","1","0","1","19","16","3","2","2","0","-2"
"240444","University of Wisconsin-Madison","2019","Not on tenure/no tenure system, associate professors","402","224","178","1","1","0","30","18","12","8","4","4","9","5","4","1","0","1","326","178","148","4","2","2","20","13","7","3","3","0","-2"
"240444","University of Wisconsin-Madison","2019","Not on tenure/no tenure system, assistant professors","550","291","259","1","1","0","58","36","22","11","2","9","18","9","9","0","0","0","340","171","169","10","2","8","90","57","33","22","13","9","-2"
"240444","University of Wisconsin-Madison","2019","Not on tenure/no tenure system, instructors","159","72","87","0","0","0","12","10","2","1","0","1","4","2","2","0","0","0","117","48","69","2","0","2","22","12","10","1","0","1","-2"
"240444","University of Wisconsin-Madison","2019","Not on tenure/no tenure system, lecturers","121","64","57","1","0","1","9","4","5","2","1","1","4","2","2","0","0","0","94","49","45","3","2","1","3","2","1","5","4","1","-2"
"240453","University of Wisconsin-Milwaukee","2019","Tenured total","557","349","208","4","3","1","107","73","34","22","13","9","24","14","10","0","0","0","392","242","150","4","2","2","0","0","0","4","2","2","240453"
"240453","University of Wisconsin-Milwaukee","2019","Tenured, professors","226","154","72","1","0","1","38","29","9","8","5","3","10","7","3","0","0","0","167","112","55","2","1","1","0","0","0","0","0","0","240453"
"240453","University of Wisconsin-Milwaukee","2019","Tenured, associate professors","330","194","136","3","3","0","69","44","25","14","8","6","14","7","7","0","0","0","224","129","95","2","1","1","0","0","0","4","2","2","240453"
"240453","University of Wisconsin-Milwaukee","2019","Tenured, assistant professors","1","1","0","0","0","0","0","0","0","0","0","0","0","0","0","0","0","0","1","1","0","0","0","0","0","0","0","0","0","0","240453"
"240453","University of Wisconsin-Milwaukee","2019","On-Tenure track total","115","50","65","0","0","0","18","8","10","3","1","2","9","3","6","0","0","0","69","26","43","1","0","1","0","0","0","15","12","3","240453"
"240453","University of Wisconsin-Milwaukee","2019","On-tenure track, associate professors","25","9","16","0","0","0","4","1","3","1","1","0","4","1","3","0","0","0","14","5","9","1","0","1","0","0","0","1","1","0","240453"
"240453","University of Wisconsin-Milwaukee","2019","On-tenure track, assistant professors","90","41","49","0","0","0","14","7","7","2","0","2","5","2","3","0","0","0","55","21","34","0","0","0","0","0","0","14","11","3","240453"
"240453","University of Wisconsin-Milwaukee","2019","Not on tenure track/No tenure system system total","384","148","236","1","0","1","25","13","12","12","1","11","11","4","7","0","0","0","319","122","197","5","3","2","0","0","0","11","5","6","240453"
"240453","University of Wisconsin-Milwaukee","2019","Not on tenure/no tenure system, professors","23","11","12","0","0","0","3","3","0","1","0","1","0","0","0","0","0","0","19","8","11","0","0","0","0","0","0","0","0","0","240453"
"240453","University of Wisconsin-Milwaukee","2019","Not on tenure/no tenure system, associate professors","27","3","24","0","0","0","2","1","1","2","0","2","2","0","2","0","0","0","21","2","19","0","0","0","0","0","0","0","0","0","240453"
"240453","University of Wisconsin-Milwaukee","2019","Not on tenure/no tenure system, assistant professors","86","31","55","1","0","1","7","5","2","7","0","7","2","2","0","0","0","0","59","17","42","3","3","0","0","0","0","7","4","3","240453"
"240453","University of Wisconsin-Milwaukee","2019","Not on tenure/no tenure system, instructors","28","4","24","0","0","0","1","1","0","1","0","1","0","0","0","0","0","0","26","3","23","0","0","0","0","0","0","0","0","0","240453"
"240453","University of Wisconsin-Milwaukee","2019","Not on tenure/no tenure system, lecturers","220","99","121","0","0","0","12","3","9","1","1","0","7","2","5","0","0","0","194","92","102","2","0","2","0","0","0","4","1","3","240453"
"240727","University of Wyoming","2019","Tenured total","376","250","126","3","2","1","35","26","9","8","3","5","9","5","4","1","1","0","256","177","79","2","1","1","60","33","27","2","2","0","-2"
"240727","University of Wyoming","2019","Tenured, professors","195","142","53","1","0","1","12","10","2","5","2","3","6","4","2","1","1","0","144","105","39","2","1","1","23","18","5","1","1","0","-2"
"240727","University of Wyoming","2019","Tenured, associate professors","181","108","73","2","2","0","23","16","7","3","1","2","3","1","2","0","0","0","112","72","40","0","0","0","37","15","22","1","1","0","-2"
"240727","University of Wyoming","2019","On-Tenure track total","157","83","74","0","0","0","5","1","4","0","0","0","0","0","0","0","0","0","65","31","34","2","0","2","70","41","29","15","10","5","-2"
"240727","University of Wyoming","2019","On-tenure track, associate professors","8","2","6","0","0","0","0","0","0","0","0","0","0","0","0","0","0","0","4","2","2","0","0","0","4","0","4","0","0","0","-2"
"240727","University of Wyoming","2019","On-tenure track, assistant professors","149","81","68","0","0","0","5","1","4","0","0","0","0","0","0","0","0","0","61","29","32","2","0","2","66","41","25","15","10","5","-2"
"240727","University of Wyoming","2019","Not on tenure track/No tenure system system total","188","85","103","0","0","0","1","0","1","1","1","0","5","1","4","0","0","0","121","52","69","2","0","2","55","29","26","3","2","1","-2"
"240727","University of Wyoming","2019","Not on tenure/no tenure system, professors","1","1","0","0","0","0","0","0","0","0","0","0","0","0","0","0","0","0","1","1","0","0","0","0","0","0","0","0","0","0","-2"
"240727","University of Wyoming","2019","Not on tenure/no tenure system, instructors","21","16","5","0","0","0","0","0","0","1","1","0","1","1","0","0","0","0","11","8","3","1","0","1","6","5","1","1","1","0","-2"
"240727","University of Wyoming","2019","Not on tenure/no tenure system, lecturers","166","68","98","0","0","0","1","0","1","0","0","0","4","0","4","0","0","0","109","43","66","1","0","1","49","24","25","2","1","1","-2"
"243665","University of the Virgin Islands","2019","Tenured total","34","25","9","0","0","0","0","0","0","11","9","2","1","1","0","0","0","0","19","13","6","1","0","1","0","0","0","2","2","0","-2"
"243665","University of the Virgin Islands","2019","Tenured, professors","14","11","3","0","0","0","0","0","0","3","3","0","0","0","0","0","0","0","10","7","3","0","0","0","0","0","0","1","1","0","-2"
"243665","University of the Virgin Islands","2019","Tenured, associate professors","16","12","4","0","0","0","0","0","0","7","5","2","1","1","0","0","0","0","7","5","2","0","0","0","0","0","0","1","1","0","-2"
"243665","University of the Virgin Islands","2019","Tenured, assistant professors","4","2","2","0","0","0","0","0","0","1","1","0","0","0","0","0","0","0","2","1","1","1","0","1","0","0","0","0","0","0","-2"
"243665","University of the Virgin Islands","2019","On-Tenure track total","19","7","12","0","0","0","1","0","1","8","3","5","1","0","1","1","1","0","5","2","3","0","0","0","2","0","2","1","1","0","-2"
"243665","University of the Virgin Islands","2019","On-tenure track, associate professors","3","1","2","0","0","0","0","0","0","2","1","1","0","0","0","0","0","0","0","0","0","0","0","0","1","0","1","0","0","0","-2"
"243665","University of the Virgin Islands","2019","On-tenure track, assistant professors","16","6","10","0","0","0","1","0","1","6","2","4","1","0","1","1","1","0","5","2","3","0","0","0","1","0","1","1","1","0","-2"
"243665","University of the Virgin Islands","2019","Not on tenure track/No tenure system system total","43","12","31","0","0","0","0","0","0","21","4","17","4","1","3","0","0","0","12","3","9","1","0","1","2","1","1","3","3","0","-2"
"243665","University of the Virgin Islands","2019","Not on tenure/no tenure system, professors","3","1","2","0","0","0","0","0","0","1","1","0","0","0","0","0","0","0","2","0","2","0","0","0","0","0","0","0","0","0","-2"
"243665","University of the Virgin Islands","2019","Not on tenure/no tenure system, associate professors","5","3","2","0","0","0","0","0","0","3","1","2","1","1","0","0","0","0","1","1","0","0","0","0","0","0","0","0","0","0","-2"
"243665","University of the Virgin Islands","2019","Not on tenure/no tenure system, assistant professors","23","5","18","0","0","0","0","0","0","11","1","10","2","0","2","0","0","0","6","1","5","0","0","0","2","1","1","2","2","0","-2"
"243665","University of the Virgin Islands","2019","Not on tenure/no tenure system, instructors","12","3","9","0","0","0","0","0","0","6","1","5","1","0","1","0","0","0","3","1","2","1","0","1","0","0","0","1","1","0","-2"
"243744","Stanford University","2019","Tenured total","1148","871","277","0","0","0","140","104","36","23","15","8","41","28","13","1","0","1","779","601","178","10","3","7","52","44","8","102","76","26","-2"
"243744","Stanford University","2019","Tenured, professors","915","717","198","0","0","0","100","78","22","18","13","5","27","21","6","0","0","0","647","508","139","6","1","5","42","37","5","75","59","16","-2"
"243744","Stanford University","2019","Tenured, associate professors","233","154","79","0","0","0","40","26","14","5","2","3","14","7","7","1","0","1","132","93","39","4","2","2","10","7","3","27","17","10","-2"
"243744","Stanford University","2019","On-Tenure track total","354","211","143","0","0","0","52","30","22","8","4","4","20","11","9","0","0","0","165","95","70","9","3","6","42","30","12","58","38","20","-2"
"243744","Stanford University","2019","On-tenure track, professors","7","5","2","0","0","0","1","1","0","0","0","0","1","1","0","0","0","0","5","3","2","0","0","0","0","0","0","0","0","0","-2"
"243744","Stanford University","2019","On-tenure track, associate professors","38","22","16","0","0","0","5","3","2","2","0","2","1","1","0","0","0","0","19","11","8","2","1","1","4","2","2","5","4","1","-2"
"243744","Stanford University","2019","On-tenure track, assistant professors","309","184","125","0","0","0","46","26","20","6","4","2","18","9","9","0","0","0","141","81","60","7","2","5","38","28","10","53","34","19","-2"
"243744","Stanford University","2019","Not on tenure track/No tenure system system total","606","393","213","2","1","1","148","87","61","12","4","8","24","20","4","0","0","0","358","241","117","4","2","2","31","22","9","27","16","11","-2"
"243744","Stanford University","2019","Not on tenure/no tenure system, professors","318","228","90","0","0","0","61","39","22","5","1","4","13","13","0","0","0","0","213","154","59","1","1","0","14","12","2","11","8","3","-2"
"243744","Stanford University","2019","Not on tenure/no tenure system, associate professors","157","91","66","1","0","1","42","23","19","5","3","2","8","6","2","0","0","0","84","51","33","2","0","2","7","4","3","8","4","4","-2"
"243744","Stanford University","2019","Not on tenure/no tenure system, assistant professors","131","74","57","1","1","0","45","25","20","2","0","2","3","1","2","0","0","0","61","36","25","1","1","0","10","6","4","8","4","4","-2"
"243780","Purdue University-Main Campus","2019","Tenured total","1265","925","340","1","1","0","261","205","56","39","26","13","54","40","14","1","1","0","886","639","247","12","7","5","7","2","5","4","4","0","-2"
"243780","Purdue University-Main Campus","2019","Tenured, professors","799","629","170","1","1","0","171","146","25","19","17","2","32","23","9","0","0","0","565","436","129","6","3","3","3","1","2","2","2","0","-2"
"243780","Purdue University-Main Campus","2019","Tenured, associate professors","465","295","170","0","0","0","90","59","31","20","9","11","22","17","5","1","1","0","320","202","118","6","4","2","4","1","3","2","2","0","-2"
"243780","Purdue University-Main Campus","2019","Tenured, assistant professors","1","1","0","0","0","0","0","0","0","0","0","0","0","0","0","0","0","0","1","1","0","0","0","0","0","0","0","0","0","0","-2"
"243780","Purdue University-Main Campus","2019","On-Tenure track total","486","306","180","2","1","1","84","48","36","13","10","3","24","16","8","0","0","0","241","142","99","9","4","5","9","5","4","104","80","24","-2"
"243780","Purdue University-Main Campus","2019","On-tenure track, professors","3","3","0","0","0","0","0","0","0","0","0","0","0","0","0","0","0","0","1","1","0","0","0","0","0","0","0","2","2","0","-2"
"243780","Purdue University-Main Campus","2019","On-tenure track, associate professors","10","8","2","0","0","0","2","2","0","0","0","0","0","0","0","0","0","0","3","2","1","0","0","0","1","0","1","4","4","0","-2"
"243780","Purdue University-Main Campus","2019","On-tenure track, assistant professors","473","295","178","2","1","1","82","46","36","13","10","3","24","16","8","0","0","0","237","139","98","9","4","5","8","5","3","98","74","24","-2"
"243780","Purdue University-Main Campus","2019","Not on tenure track/No tenure system system total","81","46","35","0","0","0","3","1","2","1","1","0","2","1","1","0","0","0","38","21","17","0","0","0","4","2","2","33","20","13","-2"
"243780","Purdue University-Main Campus","2019","Not on tenure/no tenure system, professors","9","8","1","0","0","0","0","0","0","0","0","0","0","0","0","0","0","0","7","6","1","0","0","0","0","0","0","2","2","0","-2"
"243780","Purdue University-Main Campus","2019","Not on tenure/no tenure system, associate professors","1","0","1","0","0","0","0","0","0","0","0","0","0","0","0","0","0","0","0","0","0","0","0","0","0","0","0","1","0","1","-2"
"243780","Purdue University-Main Campus","2019","Not on tenure/no tenure system, assistant professors","65","33","32","0","0","0","3","1","2","1","1","0","1","0","1","0","0","0","26","11","15","0","0","0","4","2","2","30","18","12","-2"
"243780","Purdue University-Main Campus","2019","Not on tenure/no tenure system, instructors","6","5","1","0","0","0","0","0","0","0","0","0","1","1","0","0","0","0","5","4","1","0","0","0","0","0","0","0","0","0","-2"
"409698","California State University-Monterey Bay","2019","Tenured total","93","47","46","1","1","0","18","8","10","3","1","2","20","12","8","1","0","1","45","23","22","1","0","1","4","2","2","0","0","0","-2"
"409698","California State University-Monterey Bay","2019","Tenured, professors","62","34","28","1","1","0","15","7","8","1","0","1","12","8","4","1","0","1","29","17","12","1","0","1","2","1","1","0","0","0","-2"
"409698","California State University-Monterey Bay","2019","Tenured, associate professors","31","13","18","0","0","0","3","1","2","2","1","1","8","4","4","0","0","0","16","6","10","0","0","0","2","1","1","0","0","0","-2"
"409698","California State University-Monterey Bay","2019","On-Tenure track total","83","35","48","0","0","0","10","3","7","2","2","0","13","5","8","0","0","0","49","21","28","1","1","0","3","1","2","5","2","3","-2"
"409698","California State University-Monterey Bay","2019","On-tenure track, associate professors","4","2","2","0","0","0","1","0","1","0","0","0","0","0","0","0","0","0","3","2","1","0","0","0","0","0","0","0","0","0","-2"
"409698","California State University-Monterey Bay","2019","On-tenure track, assistant professors","79","33","46","0","0","0","9","3","6","2","2","0","13","5","8","0","0","0","46","19","27","1","1","0","3","1","2","5","2","3","-2"
"409698","California State University-Monterey Bay","2019","Not on tenure track/No tenure system system total","51","23","28","0","0","0","5","3","2","2","0","2","12","6","6","0","0","0","25","11","14","1","1","0","6","2","4","0","0","0","-2"
"409698","California State University-Monterey Bay","2019","Not on tenure/no tenure system, lecturers","51","23","28","0","0","0","5","3","2","2","0","2","12","6","6","0","0","0","25","11","14","1","1","0","6","2","4","0","0","0","-2"
"445188","University of California-Merced","2019","Tenured total","159","97","62","1","0","1","26","19","7","3","2","1","26","20","6","0","0","0","96","52","44","0","0","0","6","3","3","1","1","0","-2"
"445188","University of California-Merced","2019","Tenured, professors","82","53","29","0","0","0","15","12","3","2","1","1","12","9","3","0","0","0","50","30","20","0","0","0","2","0","2","1","1","0","-2"
"445188","University of California-Merced","2019","Tenured, associate professors","64","38","26","1","0","1","10","7","3","1","1","0","10","8","2","0","0","0","39","20","19","0","0","0","3","2","1","0","0","0","-2"
"445188","University of California-Merced","2019","Tenured, lecturers","13","6","7","0","0","0","1","0","1","0","0","0","4","3","1","0","0","0","7","2","5","0","0","0","1","1","0","0","0","0","-2"
"445188","University of California-Merced","2019","On-Tenure track total","121","67","54","1","0","1","23","13","10","2","0","2","16","3","13","0","0","0","43","29","14","0","0","0","10","5","5","26","17","9","-2"
"445188","University of California-Merced","2019","On-tenure track, associate professors","2","1","1","0","0","0","0","0","0","0","0","0","2","1","1","0","0","0","0","0","0","0","0","0","0","0","0","0","0","0","-2"
"445188","University of California-Merced","2019","On-tenure track, assistant professors","111","61","50","1","0","1","22","12","10","2","0","2","14","2","12","0","0","0","37","26","11","0","0","0","10","5","5","25","16","9","-2"
"445188","University of California-Merced","2019","On-tenure track, lecturers","8","5","3","0","0","0","1","1","0","0","0","0","0","0","0","0","0","0","6","3","3","0","0","0","0","0","0","1","1","0","-2"
"445188","University of California-Merced","2019","Not on tenure track/No tenure system system total","127","58","69","0","0","0","13","5","8","2","1","1","17","6","11","0","0","0","81","37","44","0","0","0","5","1","4","9","8","1","-2"
"445188","University of California-Merced","2019","Not on tenure/no tenure system, lecturers","127","58","69","0","0","0","13","5","8","2","1","1","17","6","11","0","0","0","81","37","44","0","0","0","5","1","4","9","8","1","-2"
