"unitid","institution name","year","S2011_F.Tenure status and academic rank of full-time instruction/research/public service staff","S2011_F_RV.Grand total","S2011_F_RV.Grand total men","S2011_F_RV.Grand total women","S2011_F_RV.American Indian or Alaska Native total","S2011_F_RV.American Indian or Alaska Native men","S2011_F_RV.American Indian or Alaska Native women","S2011_F_RV.Asian total","S2011_F_RV.Asian men","S2011_F_RV.Asian women","S2011_F_RV.Black or African American total","S2011_F_RV.Black or African American men","S2011_F_RV.Black or African American women","S2011_F_RV.Hispanic or Latino total","S2011_F_RV.Hispanic or Latino men","S2011_F_RV.Hispanic or Latino women","S2011_F_RV.Native Hawaiian or Other Pacific Islander total","S2011_F_RV.Native Hawaiian or Other Pacific Islander men","S2011_F_RV.Native Hawaiian or Other Pacific Islander women","S2011_F_RV.White total","S2011_F_RV.White men","S2011_F_RV.White women","S2011_F_RV.Two or more races total","S2011_F_RV.Two or more races men","S2011_F_RV.Two or more races women","S2011_F_RV.Race/ethnicity unknown total","S2011_F_RV.Race/ethnicity unknown men","S2011_F_RV.Race/ethnicity unknown women","S2011_F_RV.Nonresident alien total","S2011_F_RV.Nonresident alien men","S2011_F_RV.Nonresident alien women","IDX_HR"
"100654","Alabama A & M University","2011","Total full-time Instruction/research/public service, Tenured, Professors","39","25","14","0","0","0","3","3","0","32","22","10","0","0","0","0","0","0","3","0","3","0","0","0","0","0","0","1","0","1","-2"
"100654","Alabama A & M University","2011","Total full-time Instruction/research/public service, Tenured, Associate professors","38","29","9","0","0","0","5","5","0","30","23","7","0","0","0","0","0","0","2","0","2","0","0","0","0","0","0","1","1","0","-2"
"100654","Alabama A & M University","2011","Total full-time Instruction/research/public service, Tenured, Assistant professors","32","20","12","0","0","0","1","0","1","31","20","11","0","0","0","0","0","0","0","0","0","0","0","0","0","0","0","0","0","0","-2"
"100654","Alabama A & M University","2011","Total full-time Instruction/research/public service, Tenured total","109","74","35","0","0","0","9","8","1","93","65","28","0","0","0","0","0","0","5","0","5","0","0","0","0","0","0","2","1","1","-2"
"100654","Alabama A & M University","2011","Total full-time Instruction/research/public service, Non-tenured on tenure track, Professors","7","6","1","0","0","0","1","0","1","6","6","0","0","0","0","0","0","0","0","0","0","0","0","0","0","0","0","0","0","0","-2"
"100654","Alabama A & M University","2011","Total full-time Instruction/research/public service, Non-tenured on tenure track, Associate professors","12","8","4","0","0","0","2","1","1","10","7","3","0","0","0","0","0","0","0","0","0","0","0","0","0","0","0","0","0","0","-2"
"100654","Alabama A & M University","2011","Total full-time Instruction/research/public service, Non-tenured on tenure track, Assistant professors","20","10","10","0","0","0","2","0","2","17","10","7","0","0","0","0","0","0","1","0","1","0","0","0","0","0","0","0","0","0","-2"
"100654","Alabama A & M University","2011","Total full-time Instruction/research/public service, Non-tenured on tenure track, Instructors","4","3","1","0","0","0","0","0","0","4","3","1","0","0","0","0","0","0","0","0","0","0","0","0","0","0","0","0","0","0","-2"
"100654","Alabama A & M University","2011","Total full-time Instruction/research/public service, Non-tenured on tenure track total","43","27","16","0","0","0","5","1","4","37","26","11","0","0","0","0","0","0","1","0","1","0","0","0","0","0","0","0","0","0","-2"
"100654","Alabama A & M University","2011","Total full-time Instruction/research/public service, Non-tenured not on tenure track, Professors","3","1","2","0","0","0","0","0","0","3","1","2","0","0","0","0","0","0","0","0","0","0","0","0","0","0","0","0","0","0","-2"
"100654","Alabama A & M University","2011","Total full-time Instruction/research/public service, Non-tenured not on tenure track, Associate professors","11","7","4","0","0","0","1","1","0","8","4","4","0","0","0","0","0","0","2","2","0","0","0","0","0","0","0","0","0","0","-2"
"100654","Alabama A & M University","2011","Total full-time Instruction/research/public servicey, Non-tenured not on tenure track, Assistant professors","62","41","21","0","0","0","2","2","0","39","22","17","0","0","0","0","0","0","11","8","3","0","0","0","0","0","0","10","9","1","-2"
"100654","Alabama A & M University","2011","Total full-time Instruction/research/public service, Non-tenured not on tenure track, Instructors","37","11","26","0","0","0","0","0","0","34","10","24","0","0","0","0","0","0","2","1","1","0","0","0","0","0","0","1","0","1","-2"
"100654","Alabama A & M University","2011","Total full-time Instruction/research/public service, Non-tenured not on tenure track total","113","60","53","0","0","0","3","3","0","84","37","47","0","0","0","0","0","0","15","11","4","0","0","0","0","0","0","11","9","2","-2"
"100706","University of Alabama in Huntsville","2011","Total full-time Instruction/research/public service, Tenured, Professors","78","69","9","0","0","0","12","12","0","1","1","0","2","2","0","0","0","0","63","54","9","0","0","0","0","0","0","0","0","0","-2"
"100706","University of Alabama in Huntsville","2011","Total full-time Instruction/research/public service, Tenured, Associate professors","71","47","24","0","0","0","17","16","1","5","3","2","0","0","0","0","0","0","49","28","21","0","0","0","0","0","0","0","0","0","-2"
"100706","University of Alabama in Huntsville","2011","Total full-time Instruction/research/public service, Tenured, Assistant professors","1","0","1","0","0","0","0","0","0","0","0","0","1","0","1","0","0","0","0","0","0","0","0","0","0","0","0","0","0","0","-2"
"100706","University of Alabama in Huntsville","2011","Total full-time Instruction/research/public service, Tenured total","150","116","34","0","0","0","29","28","1","6","4","2","3","2","1","0","0","0","112","82","30","0","0","0","0","0","0","0","0","0","-2"
"100706","University of Alabama in Huntsville","2011","Total full-time Instruction/research/public service, Non-tenured on tenure track, Professors","1","1","0","0","0","0","0","0","0","0","0","0","0","0","0","0","0","0","1","1","0","0","0","0","0","0","0","0","0","0","-2"
"100706","University of Alabama in Huntsville","2011","Total full-time Instruction/research/public service, Non-tenured on tenure track, Associate professors","9","6","3","0","0","0","2","2","0","1","0","1","0","0","0","0","0","0","6","4","2","0","0","0","0","0","0","0","0","0","-2"
"100706","University of Alabama in Huntsville","2011","Total full-time Instruction/research/public service, Non-tenured on tenure track, Assistant professors","65","49","16","0","0","0","11","10","1","3","1","2","3","2","1","0","0","0","46","34","12","0","0","0","0","0","0","2","2","0","-2"
"100706","University of Alabama in Huntsville","2011","Total full-time Instruction/research/public service, Non-tenured on tenure track total","75","56","19","0","0","0","13","12","1","4","1","3","3","2","1","0","0","0","53","39","14","0","0","0","0","0","0","2","2","0","-2"
"100706","University of Alabama in Huntsville","2011","Total full-time Instruction/research/public service, Non-tenured not on tenure track, Professors","3","3","0","0","0","0","0","0","0","0","0","0","0","0","0","0","0","0","3","3","0","0","0","0","0","0","0","0","0","0","-2"
"100706","University of Alabama in Huntsville","2011","Total full-time Instruction/research/public service, Non-tenured not on tenure track, Associate professors","9","3","6","0","0","0","0","0","0","0","0","0","1","0","1","0","0","0","8","3","5","0","0","0","0","0","0","0","0","0","-2"
"100706","University of Alabama in Huntsville","2011","Total full-time Instruction/research/public servicey, Non-tenured not on tenure track, Assistant professors","23","6","17","0","0","0","0","0","0","1","0","1","1","1","0","0","0","0","21","5","16","0","0","0","0","0","0","0","0","0","-2"
"100706","University of Alabama in Huntsville","2011","Total full-time Instruction/research/public service, Non-tenured not on tenure track, Instructors","14","2","12","0","0","0","0","0","0","2","0","2","0","0","0","0","0","0","12","2","10","0","0","0","0","0","0","0","0","0","-2"
"100706","University of Alabama in Huntsville","2011","Total full-time Instruction/research/public service, Non-tenured not on tenure track, Lecturers","40","14","26","0","0","0","2","1","1","2","1","1","1","0","1","0","0","0","34","11","23","0","0","0","0","0","0","1","1","0","-2"
"100706","University of Alabama in Huntsville","2011","Total full-time Instruction/research/public service, Non-tenured not on tenure track total","89","28","61","0","0","0","2","1","1","5","1","4","3","1","2","0","0","0","78","24","54","0","0","0","0","0","0","1","1","0","-2"
"100751","The University of Alabama","2011","Total full-time Instruction/research/public service, Tenured, Professors","316","242","74","0","0","0","25","23","2","11","6","5","5","4","1","0","0","0","272","209","63","1","0","1","0","0","0","2","0","2","-2"
"100751","The University of Alabama","2011","Total full-time Instruction/research/public service, Tenured, Associate professors","251","151","100","0","0","0","11","9","2","21","6","15","5","3","2","0","0","0","210","131","79","0","0","0","0","0","0","4","2","2","-2"
"100751","The University of Alabama","2011","Total full-time Instruction/research/public service, Tenured, Assistant professors","9","3","6","0","0","0","0","0","0","0","0","0","0","0","0","0","0","0","9","3","6","0","0","0","0","0","0","0","0","0","-2"
"100751","The University of Alabama","2011","Total full-time Instruction/research/public service, Tenured total","576","396","180","0","0","0","36","32","4","32","12","20","10","7","3","0","0","0","491","343","148","1","0","1","0","0","0","6","2","4","-2"
"100751","The University of Alabama","2011","Total full-time Instruction/research/public service, Non-tenured on tenure track, Professors","1","1","0","0","0","0","0","0","0","0","0","0","0","0","0","0","0","0","1","1","0","0","0","0","0","0","0","0","0","0","-2"
"100751","The University of Alabama","2011","Total full-time Instruction/research/public service, Non-tenured on tenure track, Associate professors","17","10","7","0","0","0","6","3","3","0","0","0","0","0","0","0","0","0","11","7","4","0","0","0","0","0","0","0","0","0","-2"
"100751","The University of Alabama","2011","Total full-time Instruction/research/public service, Non-tenured on tenure track, Assistant professors","249","131","118","0","0","0","24","12","12","13","2","11","10","4","6","0","0","0","176","98","78","1","0","1","0","0","0","25","15","10","-2"
"100751","The University of Alabama","2011","Total full-time Instruction/research/public service, Non-tenured on tenure track, Instructors","1","1","0","0","0","0","0","0","0","0","0","0","0","0","0","0","0","0","1","1","0","0","0","0","0","0","0","0","0","0","-2"
"100751","The University of Alabama","2011","Total full-time Instruction/research/public service, Non-tenured on tenure track total","268","143","125","0","0","0","30","15","15","13","2","11","10","4","6","0","0","0","189","107","82","1","0","1","0","0","0","25","15","10","-2"
"100751","The University of Alabama","2011","Total full-time Instruction/research/public service, Non-tenured not on tenure track, Professors","16","10","6","0","0","0","0","0","0","1","1","0","0","0","0","0","0","0","15","9","6","0","0","0","0","0","0","0","0","0","-2"
"100751","The University of Alabama","2011","Total full-time Instruction/research/public service, Non-tenured not on tenure track, Associate professors","25","13","12","0","0","0","1","0","1","1","0","1","0","0","0","0","0","0","23","13","10","0","0","0","0","0","0","0","0","0","-2"
"100751","The University of Alabama","2011","Total full-time Instruction/research/public servicey, Non-tenured not on tenure track, Assistant professors","86","32","54","1","0","1","5","2","3","11","5","6","0","0","0","0","0","0","67","24","43","0","0","0","0","0","0","2","1","1","-2"
"100751","The University of Alabama","2011","Total full-time Instruction/research/public service, Non-tenured not on tenure track, Instructors","231","95","136","0","0","0","2","1","1","7","2","5","5","4","1","0","0","0","208","85","123","0","0","0","0","0","0","9","3","6","-2"
"100751","The University of Alabama","2011","Total full-time Instruction/research/public service, Non-tenured not on tenure track, Lecturers","15","11","4","0","0","0","0","0","0","1","1","0","0","0","0","0","0","0","14","10","4","0","0","0","0","0","0","0","0","0","-2"
"100751","The University of Alabama","2011","Total full-time Instruction/research/public service, Non-tenured not on tenure track total","373","161","212","1","0","1","8","3","5","21","9","12","5","4","1","0","0","0","327","141","186","0","0","0","0","0","0","11","4","7","-2"
"101675","Miles College","2011","Total full-time Instruction/research/public service, Tenured, Professors","5","4","1","0","0","0","3","2","1","2","2","0","0","0","0","0","0","0","0","0","0","0","0","0","0","0","0","0","0","0","-2"
"101675","Miles College","2011","Total full-time Instruction/research/public service, Tenured total","5","4","1","0","0","0","3","2","1","2","2","0","0","0","0","0","0","0","0","0","0","0","0","0","0","0","0","0","0","0","-2"
"101675","Miles College","2011","Total full-time Instruction/research/public service, Non-tenured on tenure track, Professors","4","3","1","0","0","0","2","2","0","2","1","1","0","0","0","0","0","0","0","0","0","0","0","0","0","0","0","0","0","0","-2"
"101675","Miles College","2011","Total full-time Instruction/research/public service, Non-tenured on tenure track, Associate professors","4","3","1","0","0","0","0","0","0","4","3","1","0","0","0","0","0","0","0","0","0","0","0","0","0","0","0","0","0","0","-2"
"101675","Miles College","2011","Total full-time Instruction/research/public service, Non-tenured on tenure track, Assistant professors","22","7","15","0","0","0","2","1","1","15","2","13","0","0","0","0","0","0","4","3","1","0","0","0","1","1","0","0","0","0","-2"
"101675","Miles College","2011","Total full-time Instruction/research/public service, Non-tenured on tenure track, Instructors","58","26","32","0","0","0","0","0","0","49","22","27","0","0","0","0","0","0","8","3","5","0","0","0","1","1","0","0","0","0","-2"
"101675","Miles College","2011","Total full-time Instruction/research/public service, Non-tenured on tenure track total","88","39","49","0","0","0","4","3","1","70","28","42","0","0","0","0","0","0","12","6","6","0","0","0","2","2","0","0","0","0","-2"
"101675","Miles College","2011","Total full-time Instruction/research/public service, Non-tenured not on tenure track, Professors","1","1","0","0","0","0","0","0","0","1","1","0","0","0","0","0","0","0","0","0","0","0","0","0","0","0","0","0","0","0","-2"
"101675","Miles College","2011","Total full-time Instruction/research/public service, Non-tenured not on tenure track, Associate professors","1","1","0","0","0","0","0","0","0","0","0","0","0","0","0","0","0","0","1","1","0","0","0","0","0","0","0","0","0","0","-2"
"101675","Miles College","2011","Total full-time Instruction/research/public service, Non-tenured not on tenure track, Instructors","7","3","4","0","0","0","0","0","0","4","1","3","0","0","0","0","0","0","2","1","1","0","0","0","1","1","0","0","0","0","-2"
"101675","Miles College","2011","Total full-time Instruction/research/public service, Non-tenured not on tenure track total","9","5","4","0","0","0","0","0","0","5","2","3","0","0","0","0","0","0","3","2","1","0","0","0","1","1","0","0","0","0","-2"
"102094","University of South Alabama","2011","Total full-time Instruction/research/public service, Tenured, Professors","160","128","32","0","0","0","9","8","1","3","3","0","0","0","0","0","0","0","148","117","31","0","0","0","0","0","0","0","0","0","-2"
"102094","University of South Alabama","2011","Total full-time Instruction/research/public service, Tenured, Associate professors","125","84","41","0","0","0","10","8","2","2","1","1","2","2","0","0","0","0","110","73","37","1","0","1","0","0","0","0","0","0","-2"
"102094","University of South Alabama","2011","Total full-time Instruction/research/public service, Tenured, Assistant professors","12","5","7","0","0","0","1","0","1","1","1","0","0","0","0","0","0","0","10","4","6","0","0","0","0","0","0","0","0","0","-2"
"102094","University of South Alabama","2011","Total full-time Instruction/research/public service, Tenured total","297","217","80","0","0","0","20","16","4","6","5","1","2","2","0","0","0","0","268","194","74","1","0","1","0","0","0","0","0","0","-2"
"102094","University of South Alabama","2011","Total full-time Instruction/research/public service, Non-tenured on tenure track, Professors","5","4","1","0","0","0","1","1","0","1","1","0","0","0","0","0","0","0","3","2","1","0","0","0","0","0","0","0","0","0","-2"
"102094","University of South Alabama","2011","Total full-time Instruction/research/public service, Non-tenured on tenure track, Associate professors","9","6","3","0","0","0","2","2","0","0","0","0","0","0","0","0","0","0","7","4","3","0","0","0","0","0","0","0","0","0","-2"
"102094","University of South Alabama","2011","Total full-time Instruction/research/public service, Non-tenured on tenure track, Assistant professors","107","59","48","0","0","0","13","11","2","7","1","6","0","0","0","2","0","2","84","47","37","1","0","1","0","0","0","0","0","0","-2"
"102094","University of South Alabama","2011","Total full-time Instruction/research/public service, Non-tenured on tenure track total","121","69","52","0","0","0","16","14","2","8","2","6","0","0","0","2","0","2","94","53","41","1","0","1","0","0","0","0","0","0","-2"
"102094","University of South Alabama","2011","Total full-time Instruction/research/public service, Non-tenured not on tenure track, Professors","25","21","4","0","0","0","2","2","0","0","0","0","2","1","1","0","0","0","21","18","3","0","0","0","0","0","0","0","0","0","-2"
"102094","University of South Alabama","2011","Total full-time Instruction/research/public service, Non-tenured not on tenure track, Associate professors","49","30","19","0","0","0","6","5","1","1","0","1","0","0","0","0","0","0","42","25","17","0","0","0","0","0","0","0","0","0","-2"
"102094","University of South Alabama","2011","Total full-time Instruction/research/public servicey, Non-tenured not on tenure track, Assistant professors","101","49","52","0","0","0","14","9","5","7","1","6","3","2","1","0","0","0","77","37","40","0","0","0","0","0","0","0","0","0","-2"
"102094","University of South Alabama","2011","Total full-time Instruction/research/public service, Non-tenured not on tenure track, Instructors","144","44","100","0","0","0","6","3","3","10","1","9","1","0","1","1","1","0","126","39","87","0","0","0","0","0","0","0","0","0","-2"
"102094","University of South Alabama","2011","Total full-time Instruction/research/public service, Non-tenured not on tenure track, Lecturers","2","2","0","0","0","0","0","0","0","0","0","0","0","0","0","0","0","0","2","2","0","0","0","0","0","0","0","0","0","0","-2"
"102094","University of South Alabama","2011","Total full-time Instruction/research/public service, Non-tenured not on tenure track total","321","146","175","0","0","0","28","19","9","18","2","16","6","3","3","1","1","0","268","121","147","0","0","0","0","0","0","0","0","0","-2"
"102377","Tuskegee University","2011","Total full-time Instruction/research/public service, Tenured, Professors","42","32","10","0","0","0","15","13","2","14","8","6","0","0","0","0","0","0","5","4","1","0","0","0","2","2","0","6","5","1","-2"
"102377","Tuskegee University","2011","Total full-time Instruction/research/public service, Tenured, Associate professors","39","29","10","0","0","0","3","3","0","21","14","7","0","0","0","0","0","0","7","5","2","0","0","0","1","1","0","7","6","1","-2"
"102377","Tuskegee University","2011","Total full-time Instruction/research/public service, Tenured, Assistant professors","11","5","6","0","0","0","1","1","0","8","3","5","0","0","0","0","0","0","1","0","1","0","0","0","0","0","0","1","1","0","-2"
"102377","Tuskegee University","2011","Total full-time Instruction/research/public service, Tenured, Instructors","3","0","3","0","0","0","0","0","0","2","0","2","0","0","0","0","0","0","1","0","1","0","0","0","0","0","0","0","0","0","-2"
"102377","Tuskegee University","2011","Total full-time Instruction/research/public service, Tenured total","95","66","29","0","0","0","19","17","2","45","25","20","0","0","0","0","0","0","14","9","5","0","0","0","3","3","0","14","12","2","-2"
"102377","Tuskegee University","2011","Total full-time Instruction/research/public service, Non-tenured on tenure track, Professors","4","4","0","0","0","0","0","0","0","1","1","0","1","1","0","0","0","0","0","0","0","0","0","0","2","2","0","0","0","0","-2"
"102377","Tuskegee University","2011","Total full-time Instruction/research/public service, Non-tenured on tenure track, Associate professors","11","7","4","0","0","0","2","2","0","6","4","2","0","0","0","0","0","0","0","0","0","0","0","0","3","1","2","0","0","0","-2"
"102377","Tuskegee University","2011","Total full-time Instruction/research/public service, Non-tenured on tenure track, Assistant professors","74","41","33","0","0","0","6","4","2","16","7","9","0","0","0","0","0","0","5","2","3","0","0","0","37","20","17","10","8","2","-2"
"102377","Tuskegee University","2011","Total full-time Instruction/research/public service, Non-tenured on tenure track, Instructors","12","7","5","0","0","0","0","0","0","3","1","2","0","0","0","0","0","0","1","1","0","0","0","0","6","3","3","2","2","0","-2"
"102377","Tuskegee University","2011","Total full-time Instruction/research/public service, Non-tenured on tenure track total","101","59","42","0","0","0","8","6","2","26","13","13","1","1","0","0","0","0","6","3","3","0","0","0","48","26","22","12","10","2","-2"
"102377","Tuskegee University","2011","Total full-time Instruction/research/public service, Non-tenured not on tenure track, Professors","9","8","1","0","0","0","1","1","0","5","4","1","0","0","0","0","0","0","3","3","0","0","0","0","0","0","0","0","0","0","-2"
"102377","Tuskegee University","2011","Total full-time Instruction/research/public service, Non-tenured not on tenure track, Associate professors","17","11","6","0","0","0","0","0","0","8","4","4","1","0","1","0","0","0","0","0","0","0","0","0","1","1","0","7","6","1","-2"
"102377","Tuskegee University","2011","Total full-time Instruction/research/public servicey, Non-tenured not on tenure track, Assistant professors","34","20","14","0","0","0","2","2","0","17","9","8","0","0","0","0","0","0","2","2","0","0","0","0","6","3","3","7","4","3","-2"
"102377","Tuskegee University","2011","Total full-time Instruction/research/public service, Non-tenured not on tenure track, Instructors","31","10","21","0","0","0","2","0","2","19","5","14","0","0","0","0","0","0","4","2","2","0","0","0","4","2","2","2","1","1","-2"
"102377","Tuskegee University","2011","Total full-time Instruction/research/public service, Non-tenured not on tenure track, Lecturers","3","3","0","0","0","0","0","0","0","3","3","0","0","0","0","0","0","0","0","0","0","0","0","0","0","0","0","0","0","0","-2"
"102377","Tuskegee University","2011","Total full-time Instruction/research/public service, Non-tenured not on tenure track, No academic rank","1","1","0","0","0","0","0","0","0","1","1","0","0","0","0","0","0","0","0","0","0","0","0","0","0","0","0","0","0","0","-2"
"102377","Tuskegee University","2011","Total full-time Instruction/research/public service, Non-tenured not on tenure track total","95","53","42","0","0","0","5","3","2","53","26","27","1","0","1","0","0","0","9","7","2","0","0","0","11","6","5","16","11","5","-2"
"102614","University of Alaska Fairbanks","2011","Total full-time Instruction/research/public service, Tenured, Professors","131","109","22","0","0","0","17","16","1","0","0","0","1","1","0","0","0","0","109","90","19","2","1","1","2","1","1","0","0","0","-2"
"102614","University of Alaska Fairbanks","2011","Total full-time Instruction/research/public service, Tenured, Associate professors","133","75","58","2","1","1","12","7","5","2","1","1","4","3","1","0","0","0","109","61","48","1","1","0","2","1","1","1","0","1","-2"
"102614","University of Alaska Fairbanks","2011","Total full-time Instruction/research/public service, Tenured total","264","184","80","2","1","1","29","23","6","2","1","1","5","4","1","0","0","0","218","151","67","3","2","1","4","2","2","1","0","1","-2"
"102614","University of Alaska Fairbanks","2011","Total full-time Instruction/research/public service, Non-tenured on tenure track, Associate professors","14","11","3","0","0","0","1","1","0","0","0","0","0","0","0","0","0","0","12","9","3","0","0","0","0","0","0","1","1","0","-2"
"102614","University of Alaska Fairbanks","2011","Total full-time Instruction/research/public service, Non-tenured on tenure track, Assistant professors","139","74","65","7","3","4","8","6","2","1","0","1","3","1","2","0","0","0","108","56","52","2","1","1","3","2","1","7","5","2","-2"
"102614","University of Alaska Fairbanks","2011","Total full-time Instruction/research/public service, Non-tenured on tenure track total","153","85","68","7","3","4","9","7","2","1","0","1","3","1","2","0","0","0","120","65","55","2","1","1","3","2","1","8","6","2","-2"
"102614","University of Alaska Fairbanks","2011","Total full-time Instruction/research/public service, Non-tenured not on tenure track, Professors","11","10","1","0","0","0","1","0","1","0","0","0","0","0","0","0","0","0","10","10","0","0","0","0","0","0","0","0","0","0","-2"
"102614","University of Alaska Fairbanks","2011","Total full-time Instruction/research/public service, Non-tenured not on tenure track, Associate professors","21","16","5","0","0","0","2","2","0","0","0","0","0","0","0","0","0","0","18","14","4","0","0","0","0","0","0","1","0","1","-2"
"102614","University of Alaska Fairbanks","2011","Total full-time Instruction/research/public servicey, Non-tenured not on tenure track, Assistant professors","110","48","62","7","1","6","5","4","1","0","0","0","2","1","1","1","0","1","90","39","51","2","1","1","1","0","1","2","2","0","-2"
"102614","University of Alaska Fairbanks","2011","Total full-time Instruction/research/public service, Non-tenured not on tenure track, Instructors","39","12","27","6","1","5","2","0","2","1","0","1","2","0","2","0","0","0","27","11","16","1","0","1","0","0","0","0","0","0","-2"
"102614","University of Alaska Fairbanks","2011","Total full-time Instruction/research/public service, Non-tenured not on tenure track, No academic rank","56","34","22","0","0","0","0","0","0","0","0","0","0","0","0","0","0","0","33","17","16","0","0","0","2","2","0","21","15","6","-2"
"102614","University of Alaska Fairbanks","2011","Total full-time Instruction/research/public service, Non-tenured not on tenure track total","237","120","117","13","2","11","10","6","4","1","0","1","4","1","3","1","0","1","178","91","87","3","1","2","3","2","1","24","17","7","-2"
"104151","Arizona State University-Tempe","2011","Total full-time Instruction/research/public service, Tenured, Professors","711","533","178","8","6","2","58","48","10","11","8","3","47","38","9","0","0","0","570","420","150","4","2","2","4","2","2","9","9","0","-2"
"104151","Arizona State University-Tempe","2011","Total full-time Instruction/research/public service, Tenured, Associate professors","521","306","215","5","1","4","58","38","20","17","9","8","45","23","22","0","0","0","376","221","155","3","1","2","3","2","1","14","11","3","-2"
"104151","Arizona State University-Tempe","2011","Total full-time Instruction/research/public service, Tenured, Assistant professors","2","0","2","0","0","0","0","0","0","0","0","0","0","0","0","0","0","0","2","0","2","0","0","0","0","0","0","0","0","0","-2"
"104151","Arizona State University-Tempe","2011","Total full-time Instruction/research/public service, Tenured total","1234","839","395","13","7","6","116","86","30","28","17","11","92","61","31","0","0","0","948","641","307","7","3","4","7","4","3","23","20","3","-2"
"104151","Arizona State University-Tempe","2011","Total full-time Instruction/research/public service, Non-tenured on tenure track, Associate professors","18","12","6","1","1","0","3","2","1","0","0","0","1","1","0","0","0","0","11","6","5","0","0","0","1","1","0","1","1","0","-2"
"104151","Arizona State University-Tempe","2011","Total full-time Instruction/research/public service, Non-tenured on tenure track, Assistant professors","399","216","183","1","1","0","62","36","26","8","3","5","49","24","25","0","0","0","233","131","102","2","0","2","14","7","7","30","14","16","-2"
"104151","Arizona State University-Tempe","2011","Total full-time Instruction/research/public service, Non-tenured on tenure track total","417","228","189","2","2","0","65","38","27","8","3","5","50","25","25","0","0","0","244","137","107","2","0","2","15","8","7","31","15","16","-2"
"104151","Arizona State University-Tempe","2011","Total full-time Instruction/research/public service, Non-tenured not on tenure track, Professors","63","43","20","1","1","0","3","2","1","3","0","3","0","0","0","0","0","0","50","35","15","0","0","0","2","2","0","4","3","1","-2"
"104151","Arizona State University-Tempe","2011","Total full-time Instruction/research/public service, Non-tenured not on tenure track, Associate professors","89","36","53","0","0","0","9","7","2","3","1","2","6","3","3","0","0","0","68","23","45","2","1","1","0","0","0","1","1","0","-2"
"104151","Arizona State University-Tempe","2011","Total full-time Instruction/research/public servicey, Non-tenured not on tenure track, Assistant professors","128","64","64","2","1","1","12","7","5","3","0","3","6","4","2","0","0","0","84","37","47","0","0","0","2","1","1","19","14","5","-2"
"104151","Arizona State University-Tempe","2011","Total full-time Instruction/research/public service, Non-tenured not on tenure track, Instructors","177","61","116","2","0","2","5","2","3","6","2","4","9","2","7","0","0","0","145","49","96","0","0","0","2","1","1","8","5","3","-2"
"104151","Arizona State University-Tempe","2011","Total full-time Instruction/research/public service, Non-tenured not on tenure track, Lecturers","379","161","218","2","0","2","27","10","17","4","1","3","18","9","9","1","0","1","317","136","181","0","0","0","1","1","0","9","4","5","-2"
"104151","Arizona State University-Tempe","2011","Total full-time Instruction/research/public service, Non-tenured not on tenure track, No academic rank","55","26","29","0","0","0","7","3","4","0","0","0","7","1","6","0","0","0","32","14","18","0","0","0","0","0","0","9","8","1","-2"
"104151","Arizona State University-Tempe","2011","Total full-time Instruction/research/public service, Non-tenured not on tenure track total","891","391","500","7","2","5","63","31","32","19","4","15","46","19","27","1","0","1","696","294","402","2","1","1","7","5","2","50","35","15","-2"
"104179","University of Arizona","2011","Total full-time Instruction/research/public service, Tenured, Professors","720","552","168","4","3","1","54","41","13","9","5","4","40","32","8","0","0","0","594","453","141","0","0","0","16","15","1","3","3","0","-2"
"104179","University of Arizona","2011","Total full-time Instruction/research/public service, Tenured, Associate professors","395","242","153","3","0","3","38","22","16","4","2","2","34","13","21","0","0","0","280","181","99","1","1","0","33","22","11","2","1","1","-2"
"104179","University of Arizona","2011","Total full-time Instruction/research/public service, Tenured total","1115","794","321","7","3","4","92","63","29","13","7","6","74","45","29","0","0","0","874","634","240","1","1","0","49","37","12","5","4","1","-2"
"104179","University of Arizona","2011","Total full-time Instruction/research/public service, Non-tenured on tenure track, Professors","8","7","1","0","0","0","1","1","0","0","0","0","0","0","0","0","0","0","7","6","1","0","0","0","0","0","0","0","0","0","-2"
"104179","University of Arizona","2011","Total full-time Instruction/research/public service, Non-tenured on tenure track, Associate professors","41","29","12","0","0","0","7","7","0","0","0","0","2","2","0","0","0","0","25","15","10","0","0","0","3","1","2","4","4","0","-2"
"104179","University of Arizona","2011","Total full-time Instruction/research/public service, Non-tenured on tenure track, Assistant professors","302","166","136","4","1","3","45","27","18","4","3","1","25","10","15","0","0","0","163","87","76","1","1","0","35","19","16","25","18","7","-2"
"104179","University of Arizona","2011","Total full-time Instruction/research/public service, Non-tenured on tenure track total","351","202","149","4","1","3","53","35","18","4","3","1","27","12","15","0","0","0","195","108","87","1","1","0","38","20","18","29","22","7","-2"
"104179","University of Arizona","2011","Total full-time Instruction/research/public service, Non-tenured not on tenure track, Professors","59","43","16","0","0","0","8","6","2","2","1","1","2","1","1","0","0","0","45","35","10","0","0","0","2","0","2","0","0","0","-2"
"104179","University of Arizona","2011","Total full-time Instruction/research/public service, Non-tenured not on tenure track, Associate professors","110","57","53","1","0","1","10","8","2","0","0","0","7","4","3","0","0","0","83","39","44","1","1","0","7","4","3","1","1","0","-2"
"104179","University of Arizona","2011","Total full-time Instruction/research/public servicey, Non-tenured not on tenure track, Assistant professors","366","189","177","1","0","1","45","27","18","5","2","3","32","16","16","0","0","0","220","95","125","1","1","0","18","12","6","44","36","8","-2"
"104179","University of Arizona","2011","Total full-time Instruction/research/public service, Non-tenured not on tenure track, Instructors","77","36","41","2","2","0","2","0","2","0","0","0","13","5","8","0","0","0","51","26","25","0","0","0","1","1","0","8","2","6","-2"
"104179","University of Arizona","2011","Total full-time Instruction/research/public service, Non-tenured not on tenure track, Lecturers","143","69","74","1","0","1","5","2","3","4","3","1","14","6","8","0","0","0","108","53","55","1","0","1","9","4","5","1","1","0","-2"
"104179","University of Arizona","2011","Total full-time Instruction/research/public service, Non-tenured not on tenure track, No academic rank","8","3","5","0","0","0","1","1","0","0","0","0","0","0","0","0","0","0","4","1","3","0","0","0","0","0","0","3","1","2","-2"
"104179","University of Arizona","2011","Total full-time Instruction/research/public service, Non-tenured not on tenure track total","763","397","366","5","2","3","71","44","27","11","6","5","68","32","36","0","0","0","511","249","262","3","2","1","37","21","16","57","41","16","-2"
"104586","Embry-Riddle Aeronautical University-Prescott","2011","Total full-time Instruction/research/public service, Tenured, Professors","8","7","1","0","0","0","0","0","0","0","0","0","0","0","0","0","0","0","8","7","1","0","0","0","0","0","0","0","0","0","-2"
"104586","Embry-Riddle Aeronautical University-Prescott","2011","Total full-time Instruction/research/public service, Tenured, Associate professors","14","11","3","0","0","0","4","2","2","0","0","0","1","1","0","0","0","0","9","8","1","0","0","0","0","0","0","0","0","0","-2"
"104586","Embry-Riddle Aeronautical University-Prescott","2011","Total full-time Instruction/research/public service, Tenured total","22","18","4","0","0","0","4","2","2","0","0","0","1","1","0","0","0","0","17","15","2","0","0","0","0","0","0","0","0","0","-2"
"104586","Embry-Riddle Aeronautical University-Prescott","2011","Total full-time Instruction/research/public service, Non-tenured on tenure track, Associate professors","9","7","2","0","0","0","0","0","0","0","0","0","0","0","0","0","0","0","8","6","2","0","0","0","1","1","0","0","0","0","-2"
"104586","Embry-Riddle Aeronautical University-Prescott","2011","Total full-time Instruction/research/public service, Non-tenured on tenure track, Assistant professors","17","15","2","0","0","0","2","1","1","0","0","0","1","1","0","0","0","0","14","13","1","0","0","0","0","0","0","0","0","0","-2"
"104586","Embry-Riddle Aeronautical University-Prescott","2011","Total full-time Instruction/research/public service, Non-tenured on tenure track total","26","22","4","0","0","0","2","1","1","0","0","0","1","1","0","0","0","0","22","19","3","0","0","0","1","1","0","0","0","0","-2"
"104586","Embry-Riddle Aeronautical University-Prescott","2011","Total full-time Instruction/research/public service, Non-tenured not on tenure track, Associate professors","4","3","1","0","0","0","0","0","0","0","0","0","0","0","0","0","0","0","3","3","0","1","0","1","0","0","0","0","0","0","-2"
"104586","Embry-Riddle Aeronautical University-Prescott","2011","Total full-time Instruction/research/public servicey, Non-tenured not on tenure track, Assistant professors","15","13","2","0","0","0","0","0","0","0","0","0","0","0","0","0","0","0","14","12","2","1","1","0","0","0","0","0","0","0","-2"
"104586","Embry-Riddle Aeronautical University-Prescott","2011","Total full-time Instruction/research/public service, Non-tenured not on tenure track, Instructors","3","1","2","0","0","0","1","0","1","0","0","0","0","0","0","0","0","0","2","1","1","0","0","0","0","0","0","0","0","0","-2"
"104586","Embry-Riddle Aeronautical University-Prescott","2011","Total full-time Instruction/research/public service, Non-tenured not on tenure track total","22","17","5","0","0","0","1","0","1","0","0","0","0","0","0","0","0","0","19","16","3","2","1","1","0","0","0","0","0","0","-2"
"105330","Northern Arizona University","2011","Total full-time Instruction/research/public service, Tenured, Professors","254","162","92","6","2","4","5","2","3","2","2","0","11","5","6","0","0","0","220","146","74","1","1","0","4","3","1","5","1","4","-2"
"105330","Northern Arizona University","2011","Total full-time Instruction/research/public service, Tenured, Associate professors","161","92","69","7","2","5","4","3","1","4","3","1","8","2","6","0","0","0","126","75","51","0","0","0","3","1","2","9","6","3","-2"
"105330","Northern Arizona University","2011","Total full-time Instruction/research/public service, Tenured total","415","254","161","13","4","9","9","5","4","6","5","1","19","7","12","0","0","0","346","221","125","1","1","0","7","4","3","14","7","7","-2"
"105330","Northern Arizona University","2011","Total full-time Instruction/research/public service, Non-tenured on tenure track, Associate professors","3","0","3","0","0","0","0","0","0","0","0","0","0","0","0","0","0","0","3","0","3","0","0","0","0","0","0","0","0","0","-2"
"105330","Northern Arizona University","2011","Total full-time Instruction/research/public service, Non-tenured on tenure track, Assistant professors","100","45","55","5","0","5","2","1","1","2","1","1","5","3","2","2","2","0","69","31","38","1","1","0","6","3","3","8","3","5","-2"
"105330","Northern Arizona University","2011","Total full-time Instruction/research/public service, Non-tenured on tenure track total","103","45","58","5","0","5","2","1","1","2","1","1","5","3","2","2","2","0","72","31","41","1","1","0","6","3","3","8","3","5","-2"
"105330","Northern Arizona University","2011","Total full-time Instruction/research/public service, Non-tenured not on tenure track, Professors","4","3","1","0","0","0","0","0","0","0","0","0","0","0","0","0","0","0","4","3","1","0","0","0","0","0","0","0","0","0","-2"
"105330","Northern Arizona University","2011","Total full-time Instruction/research/public service, Non-tenured not on tenure track, Associate professors","28","6","22","0","0","0","0","0","0","0","0","0","3","0","3","0","0","0","23","6","17","1","0","1","1","0","1","0","0","0","-2"
"105330","Northern Arizona University","2011","Total full-time Instruction/research/public servicey, Non-tenured not on tenure track, Assistant professors","90","32","58","1","0","1","1","0","1","0","0","0","4","1","3","0","0","0","80","29","51","0","0","0","3","1","2","1","1","0","-2"
"105330","Northern Arizona University","2011","Total full-time Instruction/research/public service, Non-tenured not on tenure track, Instructors","91","44","47","2","1","1","1","1","0","2","0","2","4","2","2","0","0","0","69","34","35","0","0","0","7","4","3","6","2","4","-2"
"105330","Northern Arizona University","2011","Total full-time Instruction/research/public service, Non-tenured not on tenure track, Lecturers","133","58","75","3","0","3","2","1","1","0","0","0","6","2","4","0","0","0","108","48","60","0","0","0","5","4","1","9","3","6","-2"
"105330","Northern Arizona University","2011","Total full-time Instruction/research/public service, Non-tenured not on tenure track total","346","143","203","6","1","5","4","2","2","2","0","2","17","5","12","0","0","0","284","120","164","1","0","1","16","9","7","16","6","10","-2"
"110404","California Institute of Technology","2011","Total full-time Instruction/research/public service, Tenured, Professors","227","194","33","0","0","0","20","18","2","3","2","1","4","4","0","0","0","0","197","168","29","0","0","0","0","0","0","3","2","1","-2"
"110404","California Institute of Technology","2011","Total full-time Instruction/research/public service, Tenured total","227","194","33","0","0","0","20","18","2","3","2","1","4","4","0","0","0","0","197","168","29","0","0","0","0","0","0","3","2","1","-2"
"110404","California Institute of Technology","2011","Total full-time Instruction/research/public service, Non-tenured on tenure track, Associate professors","4","3","1","0","0","0","1","1","0","0","0","0","1","1","0","0","0","0","2","1","1","0","0","0","0","0","0","0","0","0","-2"
"110404","California Institute of Technology","2011","Total full-time Instruction/research/public service, Non-tenured on tenure track, Assistant professors","47","33","14","0","0","0","10","8","2","3","3","0","1","1","0","0","0","0","29","18","11","0","0","0","0","0","0","4","3","1","-2"
"110404","California Institute of Technology","2011","Total full-time Instruction/research/public service, Non-tenured on tenure track total","51","36","15","0","0","0","11","9","2","3","3","0","2","2","0","0","0","0","31","19","12","0","0","0","0","0","0","4","3","1","-2"
"110404","California Institute of Technology","2011","Total full-time Instruction/research/public service, Non-tenured not on tenure track, Instructors","18","13","5","0","0","0","2","0","2","0","0","0","0","0","0","0","0","0","8","6","2","0","0","0","0","0","0","8","7","1","-2"
"110404","California Institute of Technology","2011","Total full-time Instruction/research/public service, Non-tenured not on tenure track, Lecturers","13","8","5","0","0","0","2","0","2","0","0","0","2","1","1","0","0","0","9","7","2","0","0","0","0","0","0","0","0","0","-2"
"110404","California Institute of Technology","2011","Total full-time Instruction/research/public service, Non-tenured not on tenure track, No academic rank","64","49","15","0","0","0","9","3","6","1","0","1","2","2","0","0","0","0","38","31","7","0","0","0","0","0","0","14","13","1","-2"
"110404","California Institute of Technology","2011","Total full-time Instruction/research/public service, Non-tenured not on tenure track total","95","70","25","0","0","0","13","3","10","1","0","1","4","3","1","0","0","0","55","44","11","0","0","0","0","0","0","22","20","2","-2"
"110538","California State University-Chico","2011","Total full-time Instruction/research/public service, Tenured, Professors","222","143","79","2","2","0","21","15","6","3","2","1","12","7","5","0","0","0","183","117","66","0","0","0","1","0","1","0","0","0","-2"
"110538","California State University-Chico","2011","Total full-time Instruction/research/public service, Tenured, Associate professors","100","56","44","1","1","0","8","4","4","0","0","0","4","3","1","0","0","0","81","44","37","3","3","0","2","1","1","1","0","1","-2"
"110538","California State University-Chico","2011","Total full-time Instruction/research/public service, Tenured, Assistant professors","3","1","2","0","0","0","0","0","0","0","0","0","0","0","0","0","0","0","3","1","2","0","0","0","0","0","0","0","0","0","-2"
"110538","California State University-Chico","2011","Total full-time Instruction/research/public service, Tenured, No academic rank","2","0","2","0","0","0","0","0","0","0","0","0","0","0","0","0","0","0","2","0","2","0","0","0","0","0","0","0","0","0","-2"
"110538","California State University-Chico","2011","Total full-time Instruction/research/public service, Tenured total","327","200","127","3","3","0","29","19","10","3","2","1","16","10","6","0","0","0","269","162","107","3","3","0","3","1","2","1","0","1","-2"
"110538","California State University-Chico","2011","Total full-time Instruction/research/public service, Non-tenured on tenure track, Associate professors","7","6","1","0","0","0","1","1","0","0","0","0","0","0","0","0","0","0","5","4","1","0","0","0","0","0","0","1","1","0","-2"
"110538","California State University-Chico","2011","Total full-time Instruction/research/public service, Non-tenured on tenure track, Assistant professors","93","46","47","0","0","0","10","7","3","1","0","1","2","1","1","0","0","0","69","33","36","1","0","1","5","2","3","5","3","2","-2"
"110538","California State University-Chico","2011","Total full-time Instruction/research/public service, Non-tenured on tenure track total","100","52","48","0","0","0","11","8","3","1","0","1","2","1","1","0","0","0","74","37","37","1","0","1","5","2","3","6","4","2","-2"
"110538","California State University-Chico","2011","Total full-time Instruction/research/public service, Non-tenured not on tenure track, Lecturers","56","32","24","0","0","0","3","0","3","0","0","0","1","0","1","0","0","0","49","29","20","0","0","0","3","3","0","0","0","0","-2"
"110538","California State University-Chico","2011","Total full-time Instruction/research/public service, Non-tenured not on tenure track total","56","32","24","0","0","0","3","0","3","0","0","0","1","0","1","0","0","0","49","29","20","0","0","0","3","3","0","0","0","0","-2"
"110635","University of California-Berkeley","2011","Total full-time Instruction/research/public service, Tenured, Professors","830","640","190","1","0","1","90","68","22","17","15","2","35","27","8","0","0","0","674","520","154","0","0","0","12","10","2","1","0","1","-2"
"110635","University of California-Berkeley","2011","Total full-time Instruction/research/public service, Tenured, Associate professors","290","169","121","0","0","0","42","23","19","14","7","7","20","14","6","0","0","0","201","115","86","0","0","0","12","9","3","1","1","0","-2"
"110635","University of California-Berkeley","2011","Total full-time Instruction/research/public service, Tenured, Lecturers","18","10","8","0","0","0","2","1","1","0","0","0","1","1","0","0","0","0","15","8","7","0","0","0","0","0","0","0","0","0","-2"
"110635","University of California-Berkeley","2011","Total full-time Instruction/research/public service, Tenured total","1138","819","319","1","0","1","134","92","42","31","22","9","56","42","14","0","0","0","890","643","247","0","0","0","24","19","5","2","1","1","-2"
"110635","University of California-Berkeley","2011","Total full-time Instruction/research/public service, Non-tenured on tenure track, Professors","13","6","7","0","0","0","1","1","0","0","0","0","0","0","0","0","0","0","2","0","2","0","0","0","9","4","5","1","1","0","-2"
"110635","University of California-Berkeley","2011","Total full-time Instruction/research/public service, Non-tenured on tenure track, Associate professors","2","1","1","0","0","0","0","0","0","0","0","0","1","0","1","0","0","0","0","0","0","0","0","0","1","1","0","0","0","0","-2"
"110635","University of California-Berkeley","2011","Total full-time Instruction/research/public service, Non-tenured on tenure track, Assistant professors","193","118","75","2","0","2","26","13","13","7","1","6","12","7","5","0","0","0","98","62","36","0","0","0","33","24","9","15","11","4","-2"
"110635","University of California-Berkeley","2011","Total full-time Instruction/research/public service, Non-tenured on tenure track, Lecturers","1","1","0","0","0","0","0","0","0","0","0","0","0","0","0","0","0","0","1","1","0","0","0","0","0","0","0","0","0","0","-2"
"110635","University of California-Berkeley","2011","Total full-time Instruction/research/public service, Non-tenured on tenure track total","209","126","83","2","0","2","27","14","13","7","1","6","13","7","6","0","0","0","101","63","38","0","0","0","43","29","14","16","12","4","-2"
"110635","University of California-Berkeley","2011","Total full-time Instruction/research/public service, Non-tenured not on tenure track, Professors","34","22","12","0","0","0","0","0","0","1","1","0","0","0","0","0","0","0","30","18","12","0","0","0","1","1","0","2","2","0","-2"
"110635","University of California-Berkeley","2011","Total full-time Instruction/research/public service, Non-tenured not on tenure track, Associate professors","28","12","16","0","0","0","9","5","4","1","0","1","2","1","1","0","0","0","15","6","9","0","0","0","1","0","1","0","0","0","-2"
"110635","University of California-Berkeley","2011","Total full-time Instruction/research/public servicey, Non-tenured not on tenure track, Assistant professors","34","22","12","1","1","0","2","1","1","0","0","0","0","0","0","0","0","0","10","6","4","0","0","0","12","7","5","9","7","2","-2"
"110635","University of California-Berkeley","2011","Total full-time Instruction/research/public service, Non-tenured not on tenure track, Instructors","5","1","4","0","0","0","4","0","4","0","0","0","0","0","0","0","0","0","0","0","0","0","0","0","1","1","0","0","0","0","-2"
"110635","University of California-Berkeley","2011","Total full-time Instruction/research/public service, Non-tenured not on tenure track, Lecturers","146","61","85","2","1","1","30","11","19","3","1","2","1","1","0","0","0","0","90","39","51","0","0","0","13","5","8","7","3","4","-2"
"110635","University of California-Berkeley","2011","Total full-time Instruction/research/public service, Non-tenured not on tenure track, No academic rank","8","4","4","0","0","0","0","0","0","1","0","1","1","1","0","0","0","0","5","2","3","1","1","0","0","0","0","0","0","0","-2"
"110635","University of California-Berkeley","2011","Total full-time Instruction/research/public service, Non-tenured not on tenure track total","255","122","133","3","2","1","45","17","28","6","2","4","4","3","1","0","0","0","150","71","79","1","1","0","28","14","14","18","12","6","-2"
"110644","University of California-Davis","2011","Total full-time Instruction/research/public service, Tenured, Professors","900","676","224","3","1","2","117","92","25","13","8","5","28","18","10","0","0","0","725","547","178","1","1","0","9","7","2","4","2","2","-2"
"110644","University of California-Davis","2011","Total full-time Instruction/research/public service, Tenured, Associate professors","252","145","107","3","0","3","43","21","22","8","2","6","15","9","6","0","0","0","161","94","67","0","0","0","21","18","3","1","1","0","-2"
"110644","University of California-Davis","2011","Total full-time Instruction/research/public service, Tenured, Lecturers","17","11","6","0","0","0","1","0","1","0","0","0","0","0","0","0","0","0","16","11","5","0","0","0","0","0","0","0","0","0","-2"
"110644","University of California-Davis","2011","Total full-time Instruction/research/public service, Tenured total","1169","832","337","6","1","5","161","113","48","21","10","11","43","27","16","0","0","0","902","652","250","1","1","0","30","25","5","5","3","2","-2"
"110644","University of California-Davis","2011","Total full-time Instruction/research/public service, Non-tenured on tenure track, Professors","4","1","3","0","0","0","0","0","0","0","0","0","0","0","0","0","0","0","4","1","3","0","0","0","0","0","0","0","0","0","-2"
"110644","University of California-Davis","2011","Total full-time Instruction/research/public service, Non-tenured on tenure track, Assistant professors","193","106","87","0","0","0","43","17","26","7","3","4","12","6","6","0","0","0","113","67","46","0","0","0","15","11","4","3","2","1","-2"
"110644","University of California-Davis","2011","Total full-time Instruction/research/public service, Non-tenured on tenure track total","197","107","90","0","0","0","43","17","26","7","3","4","12","6","6","0","0","0","117","68","49","0","0","0","15","11","4","3","2","1","-2"
"110644","University of California-Davis","2011","Total full-time Instruction/research/public service, Non-tenured not on tenure track, Professors","189","144","45","1","0","1","30","26","4","1","1","0","7","5","2","0","0","0","146","109","37","0","0","0","3","2","1","1","1","0","-2"
"110644","University of California-Davis","2011","Total full-time Instruction/research/public service, Non-tenured not on tenure track, Associate professors","147","91","56","0","0","0","42","26","16","3","1","2","5","5","0","0","0","0","86","52","34","0","0","0","9","5","4","2","2","0","-2"
"110644","University of California-Davis","2011","Total full-time Instruction/research/public servicey, Non-tenured not on tenure track, Assistant professors","230","130","100","1","0","1","78","42","36","5","2","3","8","7","1","0","0","0","120","66","54","0","0","0","12","8","4","6","5","1","-2"
"110644","University of California-Davis","2011","Total full-time Instruction/research/public service, Non-tenured not on tenure track, Lecturers","117","60","57","0","0","0","4","2","2","1","0","1","6","2","4","0","0","0","103","56","47","0","0","0","3","0","3","0","0","0","-2"
"110644","University of California-Davis","2011","Total full-time Instruction/research/public service, Non-tenured not on tenure track total","683","425","258","2","0","2","154","96","58","10","4","6","26","19","7","0","0","0","455","283","172","0","0","0","27","15","12","9","8","1","-2"
"110653","University of California-Irvine","2011","Total full-time Instruction/research/public service, Tenured, Professors","589","450","139","1","1","0","97","74","23","10","7","3","26","22","4","0","0","0","451","343","108","0","0","0","4","3","1","0","0","0","-2"
"110653","University of California-Irvine","2011","Total full-time Instruction/research/public service, Tenured, Associate professors","251","148","103","0","0","0","63","36","27","11","7","4","20","11","9","0","0","0","155","93","62","0","0","0","2","1","1","0","0","0","-2"
"110653","University of California-Irvine","2011","Total full-time Instruction/research/public service, Tenured, Lecturers","28","16","12","0","0","0","3","3","0","0","0","0","1","1","0","0","0","0","24","12","12","0","0","0","0","0","0","0","0","0","-2"
"110653","University of California-Irvine","2011","Total full-time Instruction/research/public service, Tenured total","868","614","254","1","1","0","163","113","50","21","14","7","47","34","13","0","0","0","630","448","182","0","0","0","6","4","2","0","0","0","-2"
"110653","University of California-Irvine","2011","Total full-time Instruction/research/public service, Non-tenured on tenure track, Professors","6","5","1","0","0","0","1","1","0","1","1","0","0","0","0","0","0","0","3","2","1","0","0","0","1","1","0","0","0","0","-2"
"110653","University of California-Irvine","2011","Total full-time Instruction/research/public service, Non-tenured on tenure track, Associate professors","1","1","0","0","0","0","0","0","0","0","0","0","0","0","0","0","0","0","1","1","0","0","0","0","0","0","0","0","0","0","-2"
"110653","University of California-Irvine","2011","Total full-time Instruction/research/public service, Non-tenured on tenure track, Assistant professors","185","102","83","2","1","1","45","24","21","4","1","3","12","6","6","0","0","0","112","65","47","1","0","1","4","2","2","5","3","2","-2"
"110653","University of California-Irvine","2011","Total full-time Instruction/research/public service, Non-tenured on tenure track, Lecturers","10","3","7","0","0","0","1","1","0","0","0","0","0","0","0","0","0","0","9","2","7","0","0","0","0","0","0","0","0","0","-2"
"110653","University of California-Irvine","2011","Total full-time Instruction/research/public service, Non-tenured on tenure track total","202","111","91","2","1","1","47","26","21","5","2","3","12","6","6","0","0","0","125","70","55","1","0","1","5","3","2","5","3","2","-2"
"110653","University of California-Irvine","2011","Total full-time Instruction/research/public service, Non-tenured not on tenure track, Professors","113","78","35","1","1","0","34","22","12","2","1","1","4","2","2","0","0","0","70","50","20","0","0","0","2","2","0","0","0","0","-2"
"110653","University of California-Irvine","2011","Total full-time Instruction/research/public service, Non-tenured not on tenure track, Associate professors","87","47","40","1","0","1","29","19","10","2","2","0","3","2","1","0","0","0","50","23","27","0","0","0","1","0","1","1","1","0","-2"
"110653","University of California-Irvine","2011","Total full-time Instruction/research/public servicey, Non-tenured not on tenure track, Assistant professors","133","87","46","1","0","1","42","27","15","6","3","3","7","6","1","1","1","0","68","42","26","0","0","0","3","3","0","5","5","0","-2"
"110653","University of California-Irvine","2011","Total full-time Instruction/research/public service, Non-tenured not on tenure track, Instructors","42","25","17","0","0","0","16","9","7","4","3","1","0","0","0","1","1","0","18","9","9","0","0","0","1","1","0","2","2","0","-2"
"110653","University of California-Irvine","2011","Total full-time Instruction/research/public service, Non-tenured not on tenure track, Lecturers","72","24","48","0","0","0","12","3","9","0","0","0","5","0","5","0","0","0","51","19","32","0","0","0","3","1","2","1","1","0","-2"
"110653","University of California-Irvine","2011","Total full-time Instruction/research/public service, Non-tenured not on tenure track total","447","261","186","3","1","2","133","80","53","14","9","5","19","10","9","2","2","0","257","143","114","0","0","0","10","7","3","9","9","0","-2"
"110662","University of California-Los Angeles","2011","Total full-time Instruction/research/public service, Tenured, Professors","1166","892","274","5","3","2","159","127","32","28","17","11","62","42","20","0","0","0","911","702","209","0","0","0","0","0","0","1","1","0","-2"
"110662","University of California-Los Angeles","2011","Total full-time Instruction/research/public service, Tenured, Associate professors","291","176","115","0","0","0","64","38","26","17","8","9","20","15","5","0","0","0","189","115","74","1","0","1","0","0","0","0","0","0","-2"
"110662","University of California-Los Angeles","2011","Total full-time Instruction/research/public service, Tenured, Lecturers","7","5","2","0","0","0","0","0","0","0","0","0","0","0","0","0","0","0","7","5","2","0","0","0","0","0","0","0","0","0","-2"
"110662","University of California-Los Angeles","2011","Total full-time Instruction/research/public service, Tenured total","1464","1073","391","5","3","2","223","165","58","45","25","20","82","57","25","0","0","0","1107","822","285","1","0","1","0","0","0","1","1","0","-2"
"110662","University of California-Los Angeles","2011","Total full-time Instruction/research/public service, Non-tenured on tenure track, Professors","8","3","5","0","0","0","1","0","1","0","0","0","0","0","0","0","0","0","6","3","3","0","0","0","1","0","1","0","0","0","-2"
"110662","University of California-Los Angeles","2011","Total full-time Instruction/research/public service, Non-tenured on tenure track, Assistant professors","232","140","92","3","1","2","55","33","22","11","4","7","25","18","7","0","0","0","138","84","54","0","0","0","0","0","0","0","0","0","-2"
"110662","University of California-Los Angeles","2011","Total full-time Instruction/research/public service, Non-tenured on tenure track, Instructors","2","2","0","0","0","0","0","0","0","0","0","0","0","0","0","0","0","0","2","2","0","0","0","0","0","0","0","0","0","0","-2"
"110662","University of California-Los Angeles","2011","Total full-time Instruction/research/public service, Non-tenured on tenure track total","242","145","97","3","1","2","56","33","23","11","4","7","25","18","7","0","0","0","146","89","57","0","0","0","1","0","1","0","0","0","-2"
"110662","University of California-Los Angeles","2011","Total full-time Instruction/research/public service, Non-tenured not on tenure track, Professors","293","214","79","0","0","0","54","40","14","4","2","2","11","7","4","0","0","0","220","161","59","0","0","0","2","2","0","2","2","0","-2"
"110662","University of California-Los Angeles","2011","Total full-time Instruction/research/public service, Non-tenured not on tenure track, Associate professors","218","134","84","0","0","0","60","37","23","5","2","3","3","1","2","0","0","0","146","90","56","0","0","0","4","4","0","0","0","0","-2"
"110662","University of California-Los Angeles","2011","Total full-time Instruction/research/public servicey, Non-tenured not on tenure track, Assistant professors","442","242","200","0","0","0","144","74","70","11","0","11","23","14","9","1","0","1","242","141","101","1","1","0","9","4","5","11","8","3","-2"
"110662","University of California-Los Angeles","2011","Total full-time Instruction/research/public service, Non-tenured not on tenure track, Instructors","175","95","80","0","0","0","55","24","31","4","2","2","8","3","5","0","0","0","95","59","36","0","0","0","12","7","5","1","0","1","-2"
"110662","University of California-Los Angeles","2011","Total full-time Instruction/research/public service, Non-tenured not on tenure track, Lecturers","151","66","85","1","1","0","28","9","19","1","0","1","5","2","3","0","0","0","110","52","58","0","0","0","4","0","4","2","2","0","-2"
"110662","University of California-Los Angeles","2011","Total full-time Instruction/research/public service, Non-tenured not on tenure track, No academic rank","6","3","3","0","0","0","1","1","0","1","1","0","0","0","0","0","0","0","2","0","2","0","0","0","2","1","1","0","0","0","-2"
"110662","University of California-Los Angeles","2011","Total full-time Instruction/research/public service, Non-tenured not on tenure track total","1285","754","531","1","1","0","342","185","157","26","7","19","50","27","23","1","0","1","815","503","312","1","1","0","33","18","15","16","12","4","-2"
"110680","University of California-San Diego","2011","Total full-time Instruction/research/public service, Tenured, Professors","703","575","128","1","1","0","98","84","14","6","2","4","30","23","7","0","0","0","562","460","102","0","0","0","6","5","1","0","0","0","-2"
"110680","University of California-San Diego","2011","Total full-time Instruction/research/public service, Tenured, Associate professors","215","145","70","0","0","0","35","26","9","10","5","5","21","16","5","0","0","0","140","91","49","0","0","0","9","7","2","0","0","0","-2"
"110680","University of California-San Diego","2011","Total full-time Instruction/research/public service, Tenured, Lecturers","20","10","10","0","0","0","1","0","1","0","0","0","1","0","1","0","0","0","17","9","8","0","0","0","1","1","0","0","0","0","-2"
"110680","University of California-San Diego","2011","Total full-time Instruction/research/public service, Tenured total","938","730","208","1","1","0","134","110","24","16","7","9","52","39","13","0","0","0","719","560","159","0","0","0","16","13","3","0","0","0","-2"
"110680","University of California-San Diego","2011","Total full-time Instruction/research/public service, Non-tenured on tenure track, Professors","1","0","1","0","0","0","0","0","0","0","0","0","0","0","0","0","0","0","1","0","1","0","0","0","0","0","0","0","0","0","-2"
"110680","University of California-San Diego","2011","Total full-time Instruction/research/public service, Non-tenured on tenure track, Associate professors","1","0","1","0","0","0","0","0","0","1","0","1","0","0","0","0","0","0","0","0","0","0","0","0","0","0","0","0","0","0","-2"
"110680","University of California-San Diego","2011","Total full-time Instruction/research/public service, Non-tenured on tenure track, Assistant professors","174","116","58","0","0","0","44","30","14","4","3","1","16","11","5","0","0","0","101","68","33","0","0","0","4","1","3","5","3","2","-2"
"110680","University of California-San Diego","2011","Total full-time Instruction/research/public service, Non-tenured on tenure track, Lecturers","20","9","11","0","0","0","2","0","2","0","0","0","0","0","0","0","0","0","16","8","8","0","0","0","2","1","1","0","0","0","-2"
"110680","University of California-San Diego","2011","Total full-time Instruction/research/public service, Non-tenured on tenure track total","196","125","71","0","0","0","46","30","16","5","3","2","16","11","5","0","0","0","118","76","42","0","0","0","6","2","4","5","3","2","-2"
"110680","University of California-San Diego","2011","Total full-time Instruction/research/public service, Non-tenured not on tenure track, Professors","270","191","79","1","1","0","26","20","6","5","3","2","10","8","2","0","0","0","224","156","68","0","0","0","2","1","1","2","2","0","-2"
"110680","University of California-San Diego","2011","Total full-time Instruction/research/public service, Non-tenured not on tenure track, Associate professors","184","108","76","2","1","1","42","24","18","4","3","1","11","7","4","0","0","0","123","72","51","0","0","0","1","1","0","1","0","1","-2"
"110680","University of California-San Diego","2011","Total full-time Instruction/research/public servicey, Non-tenured not on tenure track, Assistant professors","270","158","112","3","2","1","65","42","23","3","2","1","16","8","8","0","0","0","162","93","69","0","0","0","18","8","10","3","3","0","-2"
"110680","University of California-San Diego","2011","Total full-time Instruction/research/public service, Non-tenured not on tenure track, Lecturers","69","27","42","0","0","0","22","5","17","1","0","1","2","0","2","0","0","0","44","22","22","0","0","0","0","0","0","0","0","0","-2"
"110680","University of California-San Diego","2011","Total full-time Instruction/research/public service, Non-tenured not on tenure track total","793","484","309","6","4","2","155","91","64","13","8","5","39","23","16","0","0","0","553","343","210","0","0","0","21","10","11","6","5","1","-2"
"115755","Humboldt State University","2011","Total full-time Instruction/research/public service, Tenured, Professors","119","72","47","2","1","1","6","5","1","3","2","1","5","3","2","0","0","0","102","60","42","0","0","0","1","1","0","0","0","0","-2"
"115755","Humboldt State University","2011","Total full-time Instruction/research/public service, Tenured, Associate professors","57","37","20","2","2","0","2","1","1","0","0","0","0","0","0","0","0","0","50","34","16","0","0","0","2","0","2","1","0","1","-2"
"115755","Humboldt State University","2011","Total full-time Instruction/research/public service, Tenured, Assistant professors","1","1","0","0","0","0","0","0","0","0","0","0","0","0","0","0","0","0","1","1","0","0","0","0","0","0","0","0","0","0","-2"
"115755","Humboldt State University","2011","Total full-time Instruction/research/public service, Tenured total","177","110","67","4","3","1","8","6","2","3","2","1","5","3","2","0","0","0","153","95","58","0","0","0","3","1","2","1","0","1","-2"
"115755","Humboldt State University","2011","Total full-time Instruction/research/public service, Non-tenured on tenure track, Associate professors","4","3","1","0","0","0","1","1","0","0","0","0","0","0","0","0","0","0","3","2","1","0","0","0","0","0","0","0","0","0","-2"
"115755","Humboldt State University","2011","Total full-time Instruction/research/public service, Non-tenured on tenure track, Assistant professors","34","18","16","1","0","1","2","2","0","1","0","1","2","1","1","0","0","0","26","14","12","0","0","0","1","0","1","1","1","0","-2"
"115755","Humboldt State University","2011","Total full-time Instruction/research/public service, Non-tenured on tenure track total","38","21","17","1","0","1","3","3","0","1","0","1","2","1","1","0","0","0","29","16","13","0","0","0","1","0","1","1","1","0","-2"
"115755","Humboldt State University","2011","Total full-time Instruction/research/public service, Non-tenured not on tenure track, Lecturers","48","24","24","2","1","1","0","0","0","1","0","1","2","2","0","1","0","1","39","19","20","0","0","0","3","2","1","0","0","0","-2"
"115755","Humboldt State University","2011","Total full-time Instruction/research/public service, Non-tenured not on tenure track total","48","24","24","2","1","1","0","0","0","1","0","1","2","2","0","1","0","1","39","19","20","0","0","0","3","2","1","0","0","0","-2"
"119678","Naval Postgraduate School","2011","Total full-time Instruction/research/public service, Tenured, Professors","86","75","11","0","0","0","13","11","2","1","0","1","2","2","0","0","0","0","61","53","8","0","0","0","9","9","0","0","0","0","-2"
"119678","Naval Postgraduate School","2011","Total full-time Instruction/research/public service, Tenured, Associate professors","76","60","16","0","0","0","8","7","1","0","0","0","4","1","3","0","0","0","58","47","11","0","0","0","6","5","1","0","0","0","-2"
"119678","Naval Postgraduate School","2011","Total full-time Instruction/research/public service, Tenured, Assistant professors","18","12","6","0","0","0","2","1","1","0","0","0","0","0","0","0","0","0","10","6","4","0","0","0","6","5","1","0","0","0","-2"
"119678","Naval Postgraduate School","2011","Total full-time Instruction/research/public service, Tenured total","180","147","33","0","0","0","23","19","4","1","0","1","6","3","3","0","0","0","129","106","23","0","0","0","21","19","2","0","0","0","-2"
"119678","Naval Postgraduate School","2011","Total full-time Instruction/research/public service, Non-tenured on tenure track, Professors","5","5","0","0","0","0","0","0","0","0","0","0","0","0","0","0","0","0","5","5","0","0","0","0","0","0","0","0","0","0","-2"
"119678","Naval Postgraduate School","2011","Total full-time Instruction/research/public service, Non-tenured on tenure track, Associate professors","22","18","4","0","0","0","2","1","1","0","0","0","2","2","0","0","0","0","15","14","1","0","0","0","3","1","2","0","0","0","-2"
"119678","Naval Postgraduate School","2011","Total full-time Instruction/research/public service, Non-tenured on tenure track, Assistant professors","34","26","8","1","1","0","4","4","0","0","0","0","1","1","0","0","0","0","20","16","4","0","0","0","8","4","4","0","0","0","-2"
"119678","Naval Postgraduate School","2011","Total full-time Instruction/research/public service, Non-tenured on tenure track total","61","49","12","1","1","0","6","5","1","0","0","0","3","3","0","0","0","0","40","35","5","0","0","0","11","5","6","0","0","0","-2"
"119678","Naval Postgraduate School","2011","Total full-time Instruction/research/public service, Non-tenured not on tenure track, Professors","45","37","8","0","0","0","1","1","0","2","2","0","0","0","0","0","0","0","26","25","1","0","0","0","16","9","7","0","0","0","-2"
"119678","Naval Postgraduate School","2011","Total full-time Instruction/research/public service, Non-tenured not on tenure track, Associate professors","26","19","7","0","0","0","2","1","1","0","0","0","1","1","0","0","0","0","21","16","5","0","0","0","2","1","1","0","0","0","-2"
"119678","Naval Postgraduate School","2011","Total full-time Instruction/research/public servicey, Non-tenured not on tenure track, Assistant professors","17","12","5","0","0","0","2","2","0","0","0","0","1","1","0","0","0","0","12","8","4","0","0","0","2","1","1","0","0","0","-2"
"119678","Naval Postgraduate School","2011","Total full-time Instruction/research/public service, Non-tenured not on tenure track, Instructors","5","5","0","0","0","0","0","0","0","0","0","0","0","0","0","0","0","0","3","3","0","0","0","0","2","2","0","0","0","0","-2"
"119678","Naval Postgraduate School","2011","Total full-time Instruction/research/public service, Non-tenured not on tenure track, Lecturers","114","95","19","1","0","1","1","0","1","1","1","0","2","1","1","0","0","0","93","81","12","0","0","0","16","12","4","0","0","0","-2"
"119678","Naval Postgraduate School","2011","Total full-time Instruction/research/public service, Non-tenured not on tenure track, No academic rank","125","93","32","0","0","0","5","3","2","0","0","0","0","0","0","0","0","0","74","58","16","0","0","0","46","32","14","0","0","0","-2"
"119678","Naval Postgraduate School","2011","Total full-time Instruction/research/public service, Non-tenured not on tenure track total","332","261","71","1","0","1","11","7","4","3","3","0","4","3","1","0","0","0","229","191","38","0","0","0","84","57","27","0","0","0","-2"
"122409","San Diego State University","2011","Total full-time Instruction/research/public service, Tenured, Professors","344","221","123","4","3","1","39","21","18","2","2","0","26","18","8","0","0","0","272","176","96","0","0","0","1","1","0","0","0","0","122409"
"122409","San Diego State University","2011","Total full-time Instruction/research/public service, Tenured, Associate professors","230","130","100","0","0","0","35","17","18","13","8","5","19","11","8","0","0","0","158","90","68","0","0","0","4","3","1","1","1","0","122409"
"122409","San Diego State University","2011","Total full-time Instruction/research/public service, Tenured, Assistant professors","10","4","6","0","0","0","2","1","1","0","0","0","1","0","1","0","0","0","7","3","4","0","0","0","0","0","0","0","0","0","122409"
"122409","San Diego State University","2011","Total full-time Instruction/research/public service, Tenured, No academic rank","13","7","6","0","0","0","0","0","0","0","0","0","3","1","2","0","0","0","9","5","4","0","0","0","0","0","0","1","1","0","122409"
"122409","San Diego State University","2011","Total full-time Instruction/research/public service, Tenured total","597","362","235","4","3","1","76","39","37","15","10","5","49","30","19","0","0","0","446","274","172","0","0","0","5","4","1","2","2","0","122409"
"122409","San Diego State University","2011","Total full-time Instruction/research/public service, Non-tenured on tenure track, Professors","2","2","0","0","0","0","0","0","0","0","0","0","0","0","0","0","0","0","2","2","0","0","0","0","0","0","0","0","0","0","122409"
"122409","San Diego State University","2011","Total full-time Instruction/research/public service, Non-tenured on tenure track, Associate professors","2","2","0","0","0","0","0","0","0","0","0","0","0","0","0","0","0","0","1","1","0","0","0","0","1","1","0","0","0","0","122409"
"122409","San Diego State University","2011","Total full-time Instruction/research/public service, Non-tenured on tenure track, Assistant professors","121","62","59","1","1","0","7","6","1","8","4","4","8","4","4","0","0","0","63","34","29","0","0","0","11","3","8","23","10","13","122409"
"122409","San Diego State University","2011","Total full-time Instruction/research/public service, Non-tenured on tenure track total","125","66","59","1","1","0","7","6","1","8","4","4","8","4","4","0","0","0","66","37","29","0","0","0","12","4","8","23","10","13","122409"
"122409","San Diego State University","2011","Total full-time Instruction/research/public service, Non-tenured not on tenure track, Lecturers","128","42","86","0","0","0","3","0","3","0","0","0","11","4","7","1","0","1","113","38","75","0","0","0","0","0","0","0","0","0","122409"
"122409","San Diego State University","2011","Total full-time Instruction/research/public service, Non-tenured not on tenure track total","128","42","86","0","0","0","3","0","3","0","0","0","11","4","7","1","0","1","113","38","75","0","0","0","0","0","0","0","0","0","122409"
"122597","San Francisco State University","2011","Total full-time Instruction/research/public service, Tenured, Professors","298","187","111","3","2","1","63","44","19","17","8","9","20","15","5","0","0","0","182","109","73","2","2","0","11","7","4","0","0","0","-2"
"122597","San Francisco State University","2011","Total full-time Instruction/research/public service, Tenured, Associate professors","172","81","91","3","1","2","35","14","21","10","4","6","18","5","13","0","0","0","97","51","46","3","2","1","5","3","2","1","1","0","-2"
"122597","San Francisco State University","2011","Total full-time Instruction/research/public service, Tenured, Assistant professors","6","1","5","0","0","0","2","0","2","0","0","0","1","0","1","0","0","0","2","1","1","0","0","0","1","0","1","0","0","0","-2"
"122597","San Francisco State University","2011","Total full-time Instruction/research/public service, Tenured, No academic rank","4","1","3","0","0","0","0","0","0","0","0","0","0","0","0","0","0","0","4","1","3","0","0","0","0","0","0","0","0","0","-2"
"122597","San Francisco State University","2011","Total full-time Instruction/research/public service, Tenured total","480","270","210","6","3","3","100","58","42","27","12","15","39","20","19","0","0","0","285","162","123","5","4","1","17","10","7","1","1","0","-2"
"122597","San Francisco State University","2011","Total full-time Instruction/research/public service, Non-tenured on tenure track, Professors","3","1","2","0","0","0","0","0","0","1","0","1","0","0","0","0","0","0","2","1","1","0","0","0","0","0","0","0","0","0","-2"
"122597","San Francisco State University","2011","Total full-time Instruction/research/public service, Non-tenured on tenure track, Associate professors","47","15","32","0","0","0","8","1","7","0","0","0","3","2","1","0","0","0","30","11","19","2","0","2","3","1","2","1","0","1","-2"
"122597","San Francisco State University","2011","Total full-time Instruction/research/public service, Non-tenured on tenure track, Assistant professors","186","83","103","3","1","2","48","18","30","7","4","3","15","8","7","0","0","0","90","43","47","3","1","2","17","7","10","3","1","2","-2"
"122597","San Francisco State University","2011","Total full-time Instruction/research/public service, Non-tenured on tenure track total","236","99","137","3","1","2","56","19","37","8","4","4","18","10","8","0","0","0","122","55","67","5","1","4","20","8","12","4","1","3","-2"
"122597","San Francisco State University","2011","Total full-time Instruction/research/public service, Non-tenured not on tenure track, Lecturers","79","37","42","0","0","0","10","3","7","3","2","1","4","1","3","0","0","0","56","28","28","0","0","0","5","3","2","1","0","1","-2"
"122597","San Francisco State University","2011","Total full-time Instruction/research/public service, Non-tenured not on tenure track total","79","37","42","0","0","0","10","3","7","3","2","1","4","1","3","0","0","0","56","28","28","0","0","0","5","3","2","1","0","1","-2"
"122755","San Jose State University","2011","Total full-time Instruction/research/public service, Tenured, Professors","325","202","123","2","1","1","66","45","21","10","5","5","16","9","7","0","0","0","221","138","83","1","0","1","8","3","5","1","1","0","-2"
"122755","San Jose State University","2011","Total full-time Instruction/research/public service, Tenured, Associate professors","152","81","71","2","1","1","32","18","14","7","5","2","14","9","5","0","0","0","79","39","40","3","1","2","15","8","7","0","0","0","-2"
"122755","San Jose State University","2011","Total full-time Instruction/research/public service, Tenured, Assistant professors","12","6","6","0","0","0","2","2","0","0","0","0","3","2","1","0","0","0","5","1","4","0","0","0","1","1","0","1","0","1","-2"
"122755","San Jose State University","2011","Total full-time Instruction/research/public service, Tenured, No academic rank","3","1","2","0","0","0","0","0","0","0","0","0","1","0","1","0","0","0","2","1","1","0","0","0","0","0","0","0","0","0","-2"
"122755","San Jose State University","2011","Total full-time Instruction/research/public service, Tenured total","492","290","202","4","2","2","100","65","35","17","10","7","34","20","14","0","0","0","307","179","128","4","1","3","24","12","12","2","1","1","-2"
"122755","San Jose State University","2011","Total full-time Instruction/research/public service, Non-tenured on tenure track, Associate professors","11","2","9","0","0","0","1","0","1","0","0","0","0","0","0","0","0","0","8","1","7","1","0","1","0","0","0","1","1","0","-2"
"122755","San Jose State University","2011","Total full-time Instruction/research/public service, Non-tenured on tenure track, Assistant professors","113","45","68","0","0","0","29","9","20","3","1","2","4","1","3","0","0","0","55","22","33","0","0","0","14","7","7","8","5","3","-2"
"122755","San Jose State University","2011","Total full-time Instruction/research/public service, Non-tenured on tenure track total","124","47","77","0","0","0","30","9","21","3","1","2","4","1","3","0","0","0","63","23","40","1","0","1","14","7","7","9","6","3","-2"
"122755","San Jose State University","2011","Total full-time Instruction/research/public service, Non-tenured not on tenure track, Lecturers","90","38","52","0","0","0","9","3","6","1","0","1","4","1","3","1","0","1","64","29","35","1","0","1","9","5","4","1","0","1","-2"
"122755","San Jose State University","2011","Total full-time Instruction/research/public service, Non-tenured not on tenure track total","90","38","52","0","0","0","9","3","6","1","0","1","4","1","3","1","0","1","64","29","35","1","0","1","9","5","4","1","0","1","-2"
"123961","University of Southern California","2011","Total full-time Instruction/research/public service, Tenured, Professors","784","626","158","1","1","0","98","81","17","13","13","0","22","15","7","0","0","0","628","496","132","5","4","1","15","14","1","2","2","0","-2"
"123961","University of Southern California","2011","Total full-time Instruction/research/public service, Tenured, Associate professors","338","231","107","0","0","0","64","50","14","13","3","10","13","7","6","0","0","0","233","160","73","2","2","0","11","7","4","2","2","0","-2"
"123961","University of Southern California","2011","Total full-time Instruction/research/public service, Tenured, Assistant professors","5","4","1","0","0","0","1","0","1","0","0","0","0","0","0","0","0","0","4","4","0","0","0","0","0","0","0","0","0","0","-2"
"123961","University of Southern California","2011","Total full-time Instruction/research/public service, Tenured, Lecturers","1","1","0","0","0","0","0","0","0","0","0","0","0","0","0","0","0","0","1","1","0","0","0","0","0","0","0","0","0","0","-2"
"123961","University of Southern California","2011","Total full-time Instruction/research/public service, Tenured total","1128","862","266","1","1","0","163","131","32","26","16","10","35","22","13","0","0","0","866","661","205","7","6","1","26","21","5","4","4","0","-2"
"123961","University of Southern California","2011","Total full-time Instruction/research/public service, Non-tenured on tenure track, Professors","11","8","3","0","0","0","3","2","1","2","1","1","1","1","0","0","0","0","3","2","1","0","0","0","0","0","0","2","2","0","-2"
"123961","University of Southern California","2011","Total full-time Instruction/research/public service, Non-tenured on tenure track, Associate professors","17","9","8","0","0","0","4","4","0","1","0","1","0","0","0","0","0","0","9","4","5","0","0","0","1","1","0","2","0","2","-2"
"123961","University of Southern California","2011","Total full-time Instruction/research/public service, Non-tenured on tenure track, Assistant professors","261","156","105","0","0","0","45","22","23","10","6","4","20","11","9","0","0","0","121","71","50","5","3","2","19","12","7","41","31","10","-2"
"123961","University of Southern California","2011","Total full-time Instruction/research/public service, Non-tenured on tenure track, Instructors","1","1","0","0","0","0","0","0","0","0","0","0","0","0","0","0","0","0","1","1","0","0","0","0","0","0","0","0","0","0","-2"
"123961","University of Southern California","2011","Total full-time Instruction/research/public service, Non-tenured on tenure track total","290","174","116","0","0","0","52","28","24","13","7","6","21","12","9","0","0","0","134","78","56","5","3","2","20","13","7","45","33","12","-2"
"123961","University of Southern California","2011","Total full-time Instruction/research/public service, Non-tenured not on tenure track, Professors","243","173","70","0","0","0","31","23","8","8","3","5","9","8","1","0","0","0","186","131","55","0","0","0","6","5","1","3","3","0","-2"
"123961","University of Southern California","2011","Total full-time Instruction/research/public service, Non-tenured not on tenure track, Associate professors","358","234","124","0","0","0","72","47","25","12","5","7","16","8","8","0","0","0","241","158","83","6","5","1","8","8","0","3","3","0","-2"
"123961","University of Southern California","2011","Total full-time Instruction/research/public servicey, Non-tenured not on tenure track, Assistant professors","843","442","401","2","1","1","246","138","108","25","7","18","55","22","33","1","1","0","419","211","208","16","9","7","32","19","13","47","34","13","-2"
"123961","University of Southern California","2011","Total full-time Instruction/research/public service, Non-tenured not on tenure track, Instructors","171","67","104","0","0","0","42","20","22","10","2","8","11","5","6","0","0","0","95","32","63","2","1","1","4","1","3","7","6","1","-2"
"123961","University of Southern California","2011","Total full-time Instruction/research/public service, Non-tenured not on tenure track, Lecturers","288","143","145","0","0","0","25","9","16","6","2","4","15","5","10","0","0","0","208","109","99","4","2","2","14","6","8","16","10","6","-2"
"123961","University of Southern California","2011","Total full-time Instruction/research/public service, Non-tenured not on tenure track total","1903","1059","844","2","1","1","416","237","179","61","19","42","106","48","58","1","1","0","1149","641","508","28","17","11","64","39","25","76","56","20","-2"
"126614","University of Colorado Boulder","2011","Total full-time Instruction/research/public service, Tenured, Professors","443","340","103","2","2","0","32","23","9","6","5","1","19","15","4","0","0","0","371","284","87","0","0","0","10","8","2","3","3","0","-2"
"126614","University of Colorado Boulder","2011","Total full-time Instruction/research/public service, Tenured, Associate professors","323","209","114","2","0","2","35","16","19","6","3","3","21","12","9","0","0","0","240","162","78","0","0","0","16","14","2","3","2","1","-2"
"126614","University of Colorado Boulder","2011","Total full-time Instruction/research/public service, Tenured total","766","549","217","4","2","2","67","39","28","12","8","4","40","27","13","0","0","0","611","446","165","0","0","0","26","22","4","6","5","1","-2"
"126614","University of Colorado Boulder","2011","Total full-time Instruction/research/public service, Non-tenured on tenure track, Associate professors","17","10","7","0","0","0","2","1","1","1","0","1","1","0","1","0","0","0","10","7","3","0","0","0","3","2","1","0","0","0","-2"
"126614","University of Colorado Boulder","2011","Total full-time Instruction/research/public service, Non-tenured on tenure track, Assistant professors","279","156","123","3","0","3","42","22","20","11","2","9","15","9","6","0","0","0","169","94","75","0","0","0","21","16","5","18","13","5","-2"
"126614","University of Colorado Boulder","2011","Total full-time Instruction/research/public service, Non-tenured on tenure track total","296","166","130","3","0","3","44","23","21","12","2","10","16","9","7","0","0","0","179","101","78","0","0","0","24","18","6","18","13","5","-2"
"126614","University of Colorado Boulder","2011","Total full-time Instruction/research/public service, Non-tenured not on tenure track, Instructors","282","122","160","0","0","0","15","8","7","3","1","2","11","2","9","0","0","0","232","100","132","0","0","0","14","6","8","7","5","2","-2"
"126614","University of Colorado Boulder","2011","Total full-time Instruction/research/public service, Non-tenured not on tenure track, No academic rank","657","451","206","1","0","1","47","31","16","3","2","1","23","14","9","0","0","0","374","251","123","0","0","0","30","19","11","179","134","45","-2"
"126614","University of Colorado Boulder","2011","Total full-time Instruction/research/public service, Non-tenured not on tenure track total","939","573","366","1","0","1","62","39","23","6","3","3","34","16","18","0","0","0","606","351","255","0","0","0","44","25","19","186","139","47","-2"
"126818","Colorado State University-Fort Collins","2011","Total full-time Instruction/research/public service, Tenured, Professors","371","284","87","1","1","0","20","17","3","3","3","0","13","10","3","0","0","0","314","238","76","1","1","0","0","0","0","19","14","5","-2"
"126818","Colorado State University-Fort Collins","2011","Total full-time Instruction/research/public service, Tenured, Associate professors","304","189","115","1","0","1","10","8","2","5","3","2","14","7","7","0","0","0","239","145","94","3","2","1","0","0","0","32","24","8","-2"
"126818","Colorado State University-Fort Collins","2011","Total full-time Instruction/research/public service, Tenured, Assistant professors","3","3","0","0","0","0","0","0","0","0","0","0","0","0","0","0","0","0","3","3","0","0","0","0","0","0","0","0","0","0","-2"
"126818","Colorado State University-Fort Collins","2011","Total full-time Instruction/research/public service, Tenured total","678","476","202","2","1","1","30","25","5","8","6","2","27","17","10","0","0","0","556","386","170","4","3","1","0","0","0","51","38","13","-2"
"126818","Colorado State University-Fort Collins","2011","Total full-time Instruction/research/public service, Non-tenured on tenure track, Professors","10","9","1","0","0","0","0","0","0","0","0","0","0","0","0","0","0","0","10","9","1","0","0","0","0","0","0","0","0","0","-2"
"126818","Colorado State University-Fort Collins","2011","Total full-time Instruction/research/public service, Non-tenured on tenure track, Associate professors","12","8","4","0","0","0","0","0","0","0","0","0","0","0","0","0","0","0","11","8","3","0","0","0","0","0","0","1","0","1","-2"
"126818","Colorado State University-Fort Collins","2011","Total full-time Instruction/research/public service, Non-tenured on tenure track, Assistant professors","255","135","120","0","0","0","22","14","8","3","2","1","18","9","9","0","0","0","170","83","87","2","0","2","3","2","1","37","25","12","-2"
"126818","Colorado State University-Fort Collins","2011","Total full-time Instruction/research/public service, Non-tenured on tenure track total","277","152","125","0","0","0","22","14","8","3","2","1","18","9","9","0","0","0","191","100","91","2","0","2","3","2","1","38","25","13","-2"
"126818","Colorado State University-Fort Collins","2011","Total full-time Instruction/research/public service, Non-tenured not on tenure track, Professors","2","2","0","0","0","0","0","0","0","0","0","0","0","0","0","0","0","0","2","2","0","0","0","0","0","0","0","0","0","0","-2"
"126818","Colorado State University-Fort Collins","2011","Total full-time Instruction/research/public service, Non-tenured not on tenure track, Associate professors","18","10","8","0","0","0","3","1","2","0","0","0","4","2","2","0","0","0","10","6","4","0","0","0","0","0","0","1","1","0","-2"
"126818","Colorado State University-Fort Collins","2011","Total full-time Instruction/research/public servicey, Non-tenured not on tenure track, Assistant professors","75","26","49","1","1","0","3","0","3","1","1","0","1","0","1","0","0","0","56","16","40","0","0","0","1","1","0","12","7","5","-2"
"126818","Colorado State University-Fort Collins","2011","Total full-time Instruction/research/public service, Non-tenured not on tenure track, Instructors","128","49","79","0","0","0","3","0","3","0","0","0","5","1","4","0","0","0","110","45","65","2","0","2","1","1","0","7","2","5","-2"
"126818","Colorado State University-Fort Collins","2011","Total full-time Instruction/research/public service, Non-tenured not on tenure track total","223","87","136","1","1","0","9","1","8","1","1","0","10","3","7","0","0","0","178","69","109","2","0","2","2","2","0","20","10","10","-2"
"127060","University of Denver","2011","Total full-time Instruction/research/public service, Tenured, Professors","159","119","40","1","1","0","6","6","0","1","1","0","7","7","0","0","0","0","133","97","36","1","1","0","9","5","4","1","1","0","-2"
"127060","University of Denver","2011","Total full-time Instruction/research/public service, Tenured, Associate professors","158","81","77","0","0","0","9","3","6","6","2","4","13","7","6","0","0","0","114","62","52","0","0","0","14","7","7","2","0","2","-2"
"127060","University of Denver","2011","Total full-time Instruction/research/public service, Tenured total","317","200","117","1","1","0","15","9","6","7","3","4","20","14","6","0","0","0","247","159","88","1","1","0","23","12","11","3","1","2","-2"
"127060","University of Denver","2011","Total full-time Instruction/research/public service, Non-tenured on tenure track, Associate professors","4","3","1","0","0","0","1","1","0","0","0","0","1","1","0","0","0","0","1","1","0","0","0","0","1","0","1","0","0","0","-2"
"127060","University of Denver","2011","Total full-time Instruction/research/public service, Non-tenured on tenure track, Assistant professors","121","66","55","0","0","0","12","8","4","4","1","3","4","2","2","0","0","0","62","29","33","3","2","1","24","16","8","12","8","4","-2"
"127060","University of Denver","2011","Total full-time Instruction/research/public service, Non-tenured on tenure track, Instructors","1","0","1","0","0","0","0","0","0","0","0","0","0","0","0","0","0","0","1","0","1","0","0","0","0","0","0","0","0","0","-2"
"127060","University of Denver","2011","Total full-time Instruction/research/public service, Non-tenured on tenure track total","126","69","57","0","0","0","13","9","4","4","1","3","5","3","2","0","0","0","64","30","34","3","2","1","25","16","9","12","8","4","-2"
"127060","University of Denver","2011","Total full-time Instruction/research/public service, Non-tenured not on tenure track, Professors","18","16","2","0","0","0","0","0","0","0","0","0","0","0","0","0","0","0","15","14","1","0","0","0","3","2","1","0","0","0","-2"
"127060","University of Denver","2011","Total full-time Instruction/research/public service, Non-tenured not on tenure track, Associate professors","13","6","7","0","0","0","0","0","0","1","1","0","0","0","0","0","0","0","11","5","6","0","0","0","1","0","1","0","0","0","-2"
"127060","University of Denver","2011","Total full-time Instruction/research/public servicey, Non-tenured not on tenure track, Assistant professors","8","0","8","0","0","0","0","0","0","0","0","0","1","0","1","0","0","0","7","0","7","0","0","0","0","0","0","0","0","0","-2"
"127060","University of Denver","2011","Total full-time Instruction/research/public service, Non-tenured not on tenure track, Instructors","1","0","1","0","0","0","0","0","0","0","0","0","0","0","0","0","0","0","1","0","1","0","0","0","0","0","0","0","0","0","-2"
"127060","University of Denver","2011","Total full-time Instruction/research/public service, Non-tenured not on tenure track, Lecturers","173","86","87","3","3","0","4","1","3","4","2","2","6","2","4","0","0","0","116","57","59","1","0","1","32","17","15","7","4","3","-2"
"127060","University of Denver","2011","Total full-time Instruction/research/public service, Non-tenured not on tenure track total","213","108","105","3","3","0","4","1","3","5","3","2","7","2","5","0","0","0","150","76","74","1","0","1","36","19","17","7","4","3","-2"
"127565","Metropolitan State University of Denver","2011","Total full-time Instruction/research/public service, Tenured, Professors","131","88","43","1","0","1","8","5","3","4","4","0","10","9","1","0","0","0","104","68","36","3","1","2","1","1","0","0","0","0","-2"
"127565","Metropolitan State University of Denver","2011","Total full-time Instruction/research/public service, Tenured, Associate professors","94","51","43","2","1","1","7","5","2","6","4","2","13","10","3","0","0","0","64","29","35","2","2","0","0","0","0","0","0","0","-2"
"127565","Metropolitan State University of Denver","2011","Total full-time Instruction/research/public service, Tenured, Assistant professors","6","2","4","0","0","0","0","0","0","0","0","0","1","0","1","0","0","0","5","2","3","0","0","0","0","0","0","0","0","0","-2"
"127565","Metropolitan State University of Denver","2011","Total full-time Instruction/research/public service, Tenured total","231","141","90","3","1","2","15","10","5","10","8","2","24","19","5","0","0","0","173","99","74","5","3","2","1","1","0","0","0","0","-2"
"127565","Metropolitan State University of Denver","2011","Total full-time Instruction/research/public service, Non-tenured on tenure track, Professors","2","1","1","0","0","0","0","0","0","0","0","0","0","0","0","0","0","0","2","1","1","0","0","0","0","0","0","0","0","0","-2"
"127565","Metropolitan State University of Denver","2011","Total full-time Instruction/research/public service, Non-tenured on tenure track, Associate professors","6","1","5","0","0","0","0","0","0","1","0","1","0","0","0","0","0","0","4","1","3","1","0","1","0","0","0","0","0","0","-2"
"127565","Metropolitan State University of Denver","2011","Total full-time Instruction/research/public service, Non-tenured on tenure track, Assistant professors","205","93","112","1","0","1","18","12","6","7","6","1","20","6","14","0","0","0","155","67","88","1","1","0","3","1","2","0","0","0","-2"
"127565","Metropolitan State University of Denver","2011","Total full-time Instruction/research/public service, Non-tenured on tenure track, Lecturers","1","1","0","0","0","0","0","0","0","0","0","0","0","0","0","0","0","0","1","1","0","0","0","0","0","0","0","0","0","0","-2"
"127565","Metropolitan State University of Denver","2011","Total full-time Instruction/research/public service, Non-tenured on tenure track total","214","96","118","1","0","1","18","12","6","8","6","2","20","6","14","0","0","0","162","70","92","2","1","1","3","1","2","0","0","0","-2"
"127565","Metropolitan State University of Denver","2011","Total full-time Instruction/research/public service, Non-tenured not on tenure track, Professors","1","0","1","0","0","0","0","0","0","0","0","0","0","0","0","0","0","0","1","0","1","0","0","0","0","0","0","0","0","0","-2"
"127565","Metropolitan State University of Denver","2011","Total full-time Instruction/research/public servicey, Non-tenured not on tenure track, Assistant professors","3","0","3","0","0","0","1","0","1","1","0","1","0","0","0","0","0","0","1","0","1","0","0","0","0","0","0","0","0","0","-2"
"127565","Metropolitan State University of Denver","2011","Total full-time Instruction/research/public service, Non-tenured not on tenure track, Instructors","12","9","3","0","0","0","0","0","0","0","0","0","1","0","1","0","0","0","11","9","2","0","0","0","0","0","0","0","0","0","-2"
"127565","Metropolitan State University of Denver","2011","Total full-time Instruction/research/public service, Non-tenured not on tenure track, Lecturers","66","29","37","1","0","1","0","0","0","6","2","4","4","3","1","0","0","0","54","23","31","0","0","0","1","1","0","0","0","0","-2"
"127565","Metropolitan State University of Denver","2011","Total full-time Instruction/research/public service, Non-tenured not on tenure track total","82","38","44","1","0","1","1","0","1","7","2","5","5","3","2","0","0","0","67","32","35","0","0","0","1","1","0","0","0","0","-2"
"127741","University of Northern Colorado","2011","Total full-time Instruction/research/public service, Tenured, Professors","161","94","67","3","2","1","4","3","1","6","3","3","11","4","7","0","0","0","132","79","53","5","3","2","0","0","0","0","0","0","-2"
"127741","University of Northern Colorado","2011","Total full-time Instruction/research/public service, Tenured, Associate professors","83","46","37","0","0","0","1","0","1","0","0","0","2","2","0","0","0","0","78","43","35","0","0","0","1","0","1","1","1","0","-2"
"127741","University of Northern Colorado","2011","Total full-time Instruction/research/public service, Tenured, Assistant professors","1","1","0","0","0","0","0","0","0","0","0","0","0","0","0","0","0","0","1","1","0","0","0","0","0","0","0","0","0","0","-2"
"127741","University of Northern Colorado","2011","Total full-time Instruction/research/public service, Tenured total","245","141","104","3","2","1","5","3","2","6","3","3","13","6","7","0","0","0","211","123","88","5","3","2","1","0","1","1","1","0","-2"
"127741","University of Northern Colorado","2011","Total full-time Instruction/research/public service, Non-tenured on tenure track, Professors","3","2","1","0","0","0","0","0","0","0","0","0","0","0","0","0","0","0","3","2","1","0","0","0","0","0","0","0","0","0","-2"
"127741","University of Northern Colorado","2011","Total full-time Instruction/research/public service, Non-tenured on tenure track, Associate professors","18","9","9","0","0","0","2","0","2","0","0","0","1","1","0","0","0","0","15","8","7","0","0","0","0","0","0","0","0","0","-2"
"127741","University of Northern Colorado","2011","Total full-time Instruction/research/public service, Non-tenured on tenure track, Assistant professors","77","35","42","0","0","0","3","3","0","3","3","0","3","1","2","0","0","0","62","26","36","0","0","0","1","0","1","5","2","3","-2"
"127741","University of Northern Colorado","2011","Total full-time Instruction/research/public service, Non-tenured on tenure track total","98","46","52","0","0","0","5","3","2","3","3","0","4","2","2","0","0","0","80","36","44","0","0","0","1","0","1","5","2","3","-2"
"127741","University of Northern Colorado","2011","Total full-time Instruction/research/public service, Non-tenured not on tenure track, Professors","3","3","0","0","0","0","0","0","0","0","0","0","0","0","0","0","0","0","3","3","0","0","0","0","0","0","0","0","0","0","-2"
"127741","University of Northern Colorado","2011","Total full-time Instruction/research/public service, Non-tenured not on tenure track, Associate professors","1","1","0","0","0","0","0","0","0","0","0","0","1","1","0","0","0","0","0","0","0","0","0","0","0","0","0","0","0","0","-2"
"127741","University of Northern Colorado","2011","Total full-time Instruction/research/public servicey, Non-tenured not on tenure track, Assistant professors","54","18","36","0","0","0","1","0","1","0","0","0","2","0","2","0","0","0","47","15","32","0","0","0","0","0","0","4","3","1","-2"
"127741","University of Northern Colorado","2011","Total full-time Instruction/research/public service, Non-tenured not on tenure track, Instructors","37","9","28","0","0","0","0","0","0","0","0","0","3","2","1","0","0","0","32","7","25","1","0","1","1","0","1","0","0","0","-2"
"127741","University of Northern Colorado","2011","Total full-time Instruction/research/public service, Non-tenured not on tenure track, Lecturers","54","25","29","1","0","1","0","0","0","2","2","0","6","3","3","0","0","0","41","18","23","1","0","1","1","0","1","2","2","0","-2"
"127741","University of Northern Colorado","2011","Total full-time Instruction/research/public service, Non-tenured not on tenure track total","149","56","93","1","0","1","1","0","1","2","2","0","12","6","6","0","0","0","123","43","80","2","0","2","2","0","2","6","5","1","-2"
"128328","United States Air Force Academy","2011","Total full-time Instruction/research/public service, Non-tenured not on tenure track, Professors","66","60","6","0","0","0","2","2","0","0","0","0","1","1","0","1","1","0","62","56","6","0","0","0","0","0","0","0","0","0","-2"
"128328","United States Air Force Academy","2011","Total full-time Instruction/research/public service, Non-tenured not on tenure track, Associate professors","40","26","14","0","0","0","2","1","1","0","0","0","2","2","0","0","0","0","35","23","12","0","0","0","1","0","1","0","0","0","-2"
"128328","United States Air Force Academy","2011","Total full-time Instruction/research/public servicey, Non-tenured not on tenure track, Assistant professors","50","36","14","0","0","0","4","2","2","1","1","0","2","1","1","0","0","0","43","32","11","0","0","0","0","0","0","0","0","0","-2"
"128328","United States Air Force Academy","2011","Total full-time Instruction/research/public service, Non-tenured not on tenure track, Instructors","22","7","15","0","0","0","1","1","0","0","0","0","2","0","2","0","0","0","19","6","13","0","0","0","0","0","0","0","0","0","-2"
"128328","United States Air Force Academy","2011","Total full-time Instruction/research/public service, Non-tenured not on tenure track total","178","129","49","0","0","0","9","6","3","1","1","0","7","4","3","1","1","0","159","117","42","0","0","0","1","0","1","0","0","0","-2"
"130776","Western Connecticut State University","2011","Total full-time Instruction/research/public service, Tenured, Professors","96","58","38","0","0","0","7","3","4","3","2","1","4","2","2","0","0","0","79","50","29","0","0","0","3","1","2","0","0","0","-2"
"130776","Western Connecticut State University","2011","Total full-time Instruction/research/public service, Tenured, Associate professors","43","20","23","0","0","0","4","3","1","1","0","1","3","2","1","0","0","0","31","13","18","0","0","0","4","2","2","0","0","0","-2"
"130776","Western Connecticut State University","2011","Total full-time Instruction/research/public service, Tenured, Assistant professors","12","7","5","0","0","0","0","0","0","1","1","0","0","0","0","0","0","0","9","4","5","0","0","0","2","2","0","0","0","0","-2"
"130776","Western Connecticut State University","2011","Total full-time Instruction/research/public service, Tenured total","151","85","66","0","0","0","11","6","5","5","3","2","7","4","3","0","0","0","119","67","52","0","0","0","9","5","4","0","0","0","-2"
"130776","Western Connecticut State University","2011","Total full-time Instruction/research/public service, Non-tenured on tenure track, Professors","1","1","0","0","0","0","0","0","0","0","0","0","0","0","0","0","0","0","1","1","0","0","0","0","0","0","0","0","0","0","-2"
"130776","Western Connecticut State University","2011","Total full-time Instruction/research/public service, Non-tenured on tenure track, Associate professors","7","2","5","0","0","0","0","0","0","0","0","0","0","0","0","0","0","0","6","1","5","0","0","0","1","1","0","0","0","0","-2"
"130776","Western Connecticut State University","2011","Total full-time Instruction/research/public service, Non-tenured on tenure track, Assistant professors","34","11","23","0","0","0","3","1","2","2","1","1","2","2","0","0","0","0","24","6","18","0","0","0","3","1","2","0","0","0","-2"
"130776","Western Connecticut State University","2011","Total full-time Instruction/research/public service, Non-tenured on tenure track total","42","14","28","0","0","0","3","1","2","2","1","1","2","2","0","0","0","0","31","8","23","0","0","0","4","2","2","0","0","0","-2"
"130776","Western Connecticut State University","2011","Total full-time Instruction/research/public servicey, Non-tenured not on tenure track, Assistant professors","25","10","15","0","0","0","0","0","0","0","0","0","0","0","0","0","0","0","21","8","13","0","0","0","4","2","2","0","0","0","-2"
"130776","Western Connecticut State University","2011","Total full-time Instruction/research/public service, Non-tenured not on tenure track, Instructors","7","1","6","0","0","0","0","0","0","0","0","0","0","0","0","0","0","0","7","1","6","0","0","0","0","0","0","0","0","0","-2"
"130776","Western Connecticut State University","2011","Total full-time Instruction/research/public service, Non-tenured not on tenure track total","32","11","21","0","0","0","0","0","0","0","0","0","0","0","0","0","0","0","28","9","19","0","0","0","4","2","2","0","0","0","-2"
"130794","Yale University","2011","Total full-time Instruction/research/public service, Tenured, Professors","706","544","162","1","1","0","51","36","15","22","14","8","16","12","4","1","1","0","600","470","130","1","0","1","2","2","0","12","8","4","-2"
"130794","Yale University","2011","Total full-time Instruction/research/public service, Tenured, Associate professors","73","43","30","0","0","0","14","11","3","1","1","0","2","1","1","0","0","0","52","28","24","1","0","1","1","1","0","2","1","1","-2"
"130794","Yale University","2011","Total full-time Instruction/research/public service, Tenured total","779","587","192","1","1","0","65","47","18","23","15","8","18","13","5","1","1","0","652","498","154","2","0","2","3","3","0","14","9","5","-2"
"130794","Yale University","2011","Total full-time Instruction/research/public service, Non-tenured on tenure track, Associate professors","111","70","41","2","1","1","14","10","4","7","0","7","2","1","1","1","0","1","73","50","23","1","1","0","1","0","1","10","7","3","-2"
"130794","Yale University","2011","Total full-time Instruction/research/public service, Non-tenured on tenure track, Assistant professors","572","316","256","1","0","1","82","48","34","28","18","10","16","8","8","1","0","1","341","188","153","0","0","0","24","10","14","79","44","35","-2"
"130794","Yale University","2011","Total full-time Instruction/research/public service, Non-tenured on tenure track, Lecturers","2","1","1","0","0","0","0","0","0","0","0","0","0","0","0","0","0","0","1","0","1","0","0","0","0","0","0","1","1","0","-2"
"130794","Yale University","2011","Total full-time Instruction/research/public service, Non-tenured on tenure track total","685","387","298","3","1","2","96","58","38","35","18","17","18","9","9","2","0","2","415","238","177","1","1","0","25","10","15","90","52","38","-2"
"130794","Yale University","2011","Total full-time Instruction/research/public service, Non-tenured not on tenure track, Professors","237","178","59","0","0","0","16","11","5","2","2","0","5","4","1","0","0","0","212","159","53","0","0","0","1","1","0","1","1","0","-2"
"130794","Yale University","2011","Total full-time Instruction/research/public service, Non-tenured not on tenure track, Associate professors","247","159","88","0","0","0","42","26","16","5","1","4","6","3","3","0","0","0","185","123","62","1","0","1","1","1","0","7","5","2","-2"
"130794","Yale University","2011","Total full-time Instruction/research/public servicey, Non-tenured not on tenure track, Assistant professors","73","38","35","0","0","0","9","4","5","3","1","2","3","1","2","0","0","0","46","26","20","0","0","0","0","0","0","12","6","6","-2"
"130794","Yale University","2011","Total full-time Instruction/research/public service, Non-tenured not on tenure track, Lecturers","1089","579","510","1","1","0","229","129","100","19","10","9","34","7","27","1","0","1","515","265","250","2","1","1","42","18","24","246","148","98","-2"
"130794","Yale University","2011","Total full-time Instruction/research/public service, Non-tenured not on tenure track total","1646","954","692","1","1","0","296","170","126","29","14","15","48","15","33","1","0","1","958","573","385","3","1","2","44","20","24","266","160","106","-2"
"130934","Delaware State University","2011","Total full-time Instruction/research/public service, Tenured, Professors","36","26","10","0","0","0","9","8","1","12","9","3","0","0","0","0","0","0","14","8","6","0","0","0","1","1","0","0","0","0","-2"
"130934","Delaware State University","2011","Total full-time Instruction/research/public service, Tenured, Associate professors","61","37","24","0","0","0","7","6","1","26","12","14","2","2","0","0","0","0","24","15","9","1","1","0","1","1","0","0","0","0","-2"
"130934","Delaware State University","2011","Total full-time Instruction/research/public service, Tenured, Assistant professors","3","1","2","0","0","0","0","0","0","3","1","2","0","0","0","0","0","0","0","0","0","0","0","0","0","0","0","0","0","0","-2"
"130934","Delaware State University","2011","Total full-time Instruction/research/public service, Tenured total","100","64","36","0","0","0","16","14","2","41","22","19","2","2","0","0","0","0","38","23","15","1","1","0","2","2","0","0","0","0","-2"
"130934","Delaware State University","2011","Total full-time Instruction/research/public service, Non-tenured on tenure track, Professors","4","4","0","1","1","0","1","1","0","1","1","0","0","0","0","0","0","0","1","1","0","0","0","0","0","0","0","0","0","0","-2"
"130934","Delaware State University","2011","Total full-time Instruction/research/public service, Non-tenured on tenure track, Associate professors","32","18","14","1","1","0","5","3","2","10","7","3","2","0","2","0","0","0","14","7","7","0","0","0","0","0","0","0","0","0","-2"
"130934","Delaware State University","2011","Total full-time Instruction/research/public service, Non-tenured on tenure track, Assistant professors","48","28","20","1","0","1","12","8","4","11","6","5","2","2","0","0","0","0","20","10","10","0","0","0","1","1","0","1","1","0","-2"
"130934","Delaware State University","2011","Total full-time Instruction/research/public service, Non-tenured on tenure track total","84","50","34","3","2","1","18","12","6","22","14","8","4","2","2","0","0","0","35","18","17","0","0","0","1","1","0","1","1","0","-2"
"130934","Delaware State University","2011","Total full-time Instruction/research/public servicey, Non-tenured not on tenure track, Assistant professors","13","8","5","0","0","0","3","2","1","7","5","2","0","0","0","0","0","0","3","1","2","0","0","0","0","0","0","0","0","0","-2"
"130934","Delaware State University","2011","Total full-time Instruction/research/public service, Non-tenured not on tenure track, Instructors","12","4","8","0","0","0","1","0","1","7","2","5","0","0","0","0","0","0","4","2","2","0","0","0","0","0","0","0","0","0","-2"
"130934","Delaware State University","2011","Total full-time Instruction/research/public service, Non-tenured not on tenure track, Lecturers","2","1","1","0","0","0","0","0","0","0","0","0","0","0","0","0","0","0","2","1","1","0","0","0","0","0","0","0","0","0","-2"
"130934","Delaware State University","2011","Total full-time Instruction/research/public service, Non-tenured not on tenure track total","27","13","14","0","0","0","4","2","2","14","7","7","0","0","0","0","0","0","9","4","5","0","0","0","0","0","0","0","0","0","-2"
"130943","University of Delaware","2011","Total full-time Instruction/research/public service, Tenured, Professors","386","290","96","0","0","0","44","39","5","15","8","7","7","7","0","0","0","0","320","236","84","0","0","0","0","0","0","0","0","0","-2"
"130943","University of Delaware","2011","Total full-time Instruction/research/public service, Tenured, Associate professors","286","176","110","0","0","0","32","22","10","18","9","9","12","5","7","0","0","0","220","138","82","0","0","0","0","0","0","4","2","2","-2"
"130943","University of Delaware","2011","Total full-time Instruction/research/public service, Tenured total","672","466","206","0","0","0","76","61","15","33","17","16","19","12","7","0","0","0","540","374","166","0","0","0","0","0","0","4","2","2","-2"
"130943","University of Delaware","2011","Total full-time Instruction/research/public service, Non-tenured on tenure track, Associate professors","7","3","4","1","0","1","0","0","0","0","0","0","1","1","0","0","0","0","5","2","3","0","0","0","0","0","0","0","0","0","-2"
"130943","University of Delaware","2011","Total full-time Instruction/research/public service, Non-tenured on tenure track, Assistant professors","179","92","87","0","0","0","34","19","15","10","3","7","4","2","2","0","0","0","116","57","59","1","0","1","2","1","1","12","10","2","-2"
"130943","University of Delaware","2011","Total full-time Instruction/research/public service, Non-tenured on tenure track total","186","95","91","1","0","1","34","19","15","10","3","7","5","3","2","0","0","0","121","59","62","1","0","1","2","1","1","12","10","2","-2"
"130943","University of Delaware","2011","Total full-time Instruction/research/public service, Non-tenured not on tenure track, Professors","9","7","2","0","0","0","2","2","0","0","0","0","0","0","0","0","0","0","7","5","2","0","0","0","0","0","0","0","0","0","-2"
"130943","University of Delaware","2011","Total full-time Instruction/research/public service, Non-tenured not on tenure track, Associate professors","41","21","20","0","0","0","2","2","0","2","1","1","0","0","0","0","0","0","37","18","19","0","0","0","0","0","0","0","0","0","-2"
"130943","University of Delaware","2011","Total full-time Instruction/research/public servicey, Non-tenured not on tenure track, Assistant professors","121","63","58","1","0","1","7","5","2","4","3","1","4","1","3","0","0","0","104","53","51","0","0","0","0","0","0","1","1","0","-2"
"130943","University of Delaware","2011","Total full-time Instruction/research/public service, Non-tenured not on tenure track, Instructors","102","30","72","2","1","1","2","0","2","2","1","1","4","0","4","0","0","0","92","28","64","0","0","0","0","0","0","0","0","0","-2"
"130943","University of Delaware","2011","Total full-time Instruction/research/public service, Non-tenured not on tenure track total","273","121","152","3","1","2","13","9","4","8","5","3","8","1","7","0","0","0","240","104","136","0","0","0","0","0","0","1","1","0","-2"
"131520","Howard University","2011","Total full-time Instruction/research/public service, Tenured, Professors","257","187","70","0","0","0","36","31","5","144","101","43","2","1","1","0","0","0","53","38","15","0","0","0","15","10","5","7","6","1","-2"
"131520","Howard University","2011","Total full-time Instruction/research/public service, Tenured, Associate professors","251","149","102","0","0","0","17","10","7","164","92","72","4","0","4","0","0","0","40","28","12","2","1","1","11","8","3","13","10","3","-2"
"131520","Howard University","2011","Total full-time Instruction/research/public service, Tenured, Assistant professors","9","5","4","0","0","0","1","1","0","7","4","3","1","0","1","0","0","0","0","0","0","0","0","0","0","0","0","0","0","0","-2"
"131520","Howard University","2011","Total full-time Instruction/research/public service, Tenured, Instructors","1","0","1","0","0","0","0","0","0","1","0","1","0","0","0","0","0","0","0","0","0","0","0","0","0","0","0","0","0","0","-2"
"131520","Howard University","2011","Total full-time Instruction/research/public service, Tenured total","518","341","177","0","0","0","54","42","12","316","197","119","7","1","6","0","0","0","93","66","27","2","1","1","26","18","8","20","16","4","-2"
"131520","Howard University","2011","Total full-time Instruction/research/public service, Non-tenured on tenure track, Professors","1","1","0","0","0","0","1","1","0","0","0","0","0","0","0","0","0","0","0","0","0","0","0","0","0","0","0","0","0","0","-2"
"131520","Howard University","2011","Total full-time Instruction/research/public service, Non-tenured on tenure track, Associate professors","21","11","10","0","0","0","0","0","0","12","6","6","0","0","0","0","0","0","3","1","2","0","0","0","4","4","0","2","0","2","-2"
"131520","Howard University","2011","Total full-time Instruction/research/public service, Non-tenured on tenure track, Assistant professors","120","48","72","0","0","0","10","8","2","72","23","49","6","0","6","0","0","0","13","7","6","1","0","1","12","7","5","6","3","3","-2"
"131520","Howard University","2011","Total full-time Instruction/research/public service, Non-tenured on tenure track, Instructors","3","0","3","0","0","0","0","0","0","3","0","3","0","0","0","0","0","0","0","0","0","0","0","0","0","0","0","0","0","0","-2"
"131520","Howard University","2011","Total full-time Instruction/research/public service, Non-tenured on tenure track, Lecturers","1","1","0","0","0","0","1","1","0","0","0","0","0","0","0","0","0","0","0","0","0","0","0","0","0","0","0","0","0","0","-2"
"131520","Howard University","2011","Total full-time Instruction/research/public service, Non-tenured on tenure track total","146","61","85","0","0","0","12","10","2","87","29","58","6","0","6","0","0","0","16","8","8","1","0","1","16","11","5","8","3","5","-2"
"131520","Howard University","2011","Total full-time Instruction/research/public service, Non-tenured not on tenure track, Professors","13","7","6","0","0","0","1","1","0","8","3","5","0","0","0","0","0","0","3","2","1","0","0","0","1","1","0","0","0","0","-2"
"131520","Howard University","2011","Total full-time Instruction/research/public service, Non-tenured not on tenure track, Associate professors","43","24","19","0","0","0","4","2","2","29","15","14","0","0","0","0","0","0","6","3","3","1","1","0","0","0","0","3","3","0","-2"
"131520","Howard University","2011","Total full-time Instruction/research/public servicey, Non-tenured not on tenure track, Assistant professors","134","65","69","0","0","0","13","6","7","99","44","55","2","1","1","1","0","1","12","9","3","0","0","0","4","2","2","3","3","0","-2"
"131520","Howard University","2011","Total full-time Instruction/research/public service, Non-tenured not on tenure track, Instructors","83","38","45","0","0","0","5","4","1","57","21","36","0","0","0","0","0","0","13","7","6","0","0","0","7","5","2","1","1","0","-2"
"131520","Howard University","2011","Total full-time Instruction/research/public service, Non-tenured not on tenure track, Lecturers","80","41","39","0","0","0","2","0","2","41","24","17","2","0","2","0","0","0","7","1","6","1","1","0","18","12","6","9","3","6","-2"
"131520","Howard University","2011","Total full-time Instruction/research/public service, Non-tenured not on tenure track, No academic rank","4","2","2","0","0","0","2","2","0","1","0","1","1","0","1","0","0","0","0","0","0","0","0","0","0","0","0","0","0","0","-2"
"131520","Howard University","2011","Total full-time Instruction/research/public service, Non-tenured not on tenure track total","357","177","180","0","0","0","27","15","12","235","107","128","5","1","4","1","0","1","41","22","19","2","2","0","30","20","10","16","10","6","-2"
"133553","Embry-Riddle Aeronautical University-Daytona Beach","2011","Total full-time Instruction/research/public service, Tenured, Professors","51","47","4","0","0","0","6","5","1","0","0","0","0","0","0","0","0","0","45","42","3","0","0","0","0","0","0","0","0","0","-2"
"133553","Embry-Riddle Aeronautical University-Daytona Beach","2011","Total full-time Instruction/research/public service, Tenured, Associate professors","50","41","9","0","0","0","7","6","1","2","1","1","0","0","0","0","0","0","41","34","7","0","0","0","0","0","0","0","0","0","-2"
"133553","Embry-Riddle Aeronautical University-Daytona Beach","2011","Total full-time Instruction/research/public service, Tenured total","101","88","13","0","0","0","13","11","2","2","1","1","0","0","0","0","0","0","86","76","10","0","0","0","0","0","0","0","0","0","-2"
"133553","Embry-Riddle Aeronautical University-Daytona Beach","2011","Total full-time Instruction/research/public service, Non-tenured on tenure track, Professors","2","2","0","0","0","0","0","0","0","0","0","0","0","0","0","0","0","0","2","2","0","0","0","0","0","0","0","0","0","0","-2"
"133553","Embry-Riddle Aeronautical University-Daytona Beach","2011","Total full-time Instruction/research/public service, Non-tenured on tenure track, Associate professors","18","15","3","0","0","0","3","3","0","0","0","0","0","0","0","0","0","0","14","12","2","0","0","0","0","0","0","1","0","1","-2"
"133553","Embry-Riddle Aeronautical University-Daytona Beach","2011","Total full-time Instruction/research/public service, Non-tenured on tenure track, Assistant professors","44","27","17","0","0","0","0","0","0","0","0","0","1","0","1","0","0","0","35","22","13","0","0","0","1","1","0","7","4","3","-2"
"133553","Embry-Riddle Aeronautical University-Daytona Beach","2011","Total full-time Instruction/research/public service, Non-tenured on tenure track total","64","44","20","0","0","0","3","3","0","0","0","0","1","0","1","0","0","0","51","36","15","0","0","0","1","1","0","8","4","4","-2"
"133553","Embry-Riddle Aeronautical University-Daytona Beach","2011","Total full-time Instruction/research/public service, Non-tenured not on tenure track, Professors","4","3","1","0","0","0","0","0","0","0","0","0","0","0","0","0","0","0","4","3","1","0","0","0","0","0","0","0","0","0","-2"
"133553","Embry-Riddle Aeronautical University-Daytona Beach","2011","Total full-time Instruction/research/public service, Non-tenured not on tenure track, Associate professors","19","12","7","0","0","0","2","1","1","0","0","0","0","0","0","0","0","0","17","11","6","0","0","0","0","0","0","0","0","0","-2"
"133553","Embry-Riddle Aeronautical University-Daytona Beach","2011","Total full-time Instruction/research/public servicey, Non-tenured not on tenure track, Assistant professors","38","31","7","0","0","0","1","0","1","2","2","0","2","1","1","0","0","0","31","26","5","0","0","0","0","0","0","2","2","0","-2"
"133553","Embry-Riddle Aeronautical University-Daytona Beach","2011","Total full-time Instruction/research/public service, Non-tenured not on tenure track, Instructors","15","6","9","0","0","0","0","0","0","0","0","0","2","2","0","0","0","0","13","4","9","0","0","0","0","0","0","0","0","0","-2"
"133553","Embry-Riddle Aeronautical University-Daytona Beach","2011","Total full-time Instruction/research/public service, Non-tenured not on tenure track total","76","52","24","0","0","0","3","1","2","2","2","0","4","3","1","0","0","0","65","44","21","0","0","0","0","0","0","2","2","0","-2"
"133650","Florida Agricultural and Mechanical University","2011","Total full-time Instruction/research/public service, Tenured, Professors","137","99","38","0","0","0","15","13","2","95","66","29","1","0","1","0","0","0","26","20","6","0","0","0","0","0","0","0","0","0","-2"
"133650","Florida Agricultural and Mechanical University","2011","Total full-time Instruction/research/public service, Tenured, Associate professors","128","72","56","0","0","0","4","2","2","93","51","42","5","3","2","0","0","0","26","16","10","0","0","0","0","0","0","0","0","0","-2"
"133650","Florida Agricultural and Mechanical University","2011","Total full-time Instruction/research/public service, Tenured, Assistant professors","11","7","4","0","0","0","0","0","0","11","7","4","0","0","0","0","0","0","0","0","0","0","0","0","0","0","0","0","0","0","-2"
"133650","Florida Agricultural and Mechanical University","2011","Total full-time Instruction/research/public service, Tenured total","276","178","98","0","0","0","19","15","4","199","124","75","6","3","3","0","0","0","52","36","16","0","0","0","0","0","0","0","0","0","-2"
"133650","Florida Agricultural and Mechanical University","2011","Total full-time Instruction/research/public service, Non-tenured on tenure track, Professors","3","1","2","0","0","0","0","0","0","3","1","2","0","0","0","0","0","0","0","0","0","0","0","0","0","0","0","0","0","0","-2"
"133650","Florida Agricultural and Mechanical University","2011","Total full-time Instruction/research/public service, Non-tenured on tenure track, Associate professors","48","17","31","0","0","0","3","3","0","31","8","23","1","0","1","0","0","0","13","6","7","0","0","0","0","0","0","0","0","0","-2"
"133650","Florida Agricultural and Mechanical University","2011","Total full-time Instruction/research/public service, Non-tenured on tenure track, Assistant professors","78","29","49","0","0","0","5","4","1","59","20","39","2","0","2","0","0","0","12","5","7","0","0","0","0","0","0","0","0","0","-2"
"133650","Florida Agricultural and Mechanical University","2011","Total full-time Instruction/research/public service, Non-tenured on tenure track, Instructors","2","0","2","0","0","0","0","0","0","2","0","2","0","0","0","0","0","0","0","0","0","0","0","0","0","0","0","0","0","0","-2"
"133650","Florida Agricultural and Mechanical University","2011","Total full-time Instruction/research/public service, Non-tenured on tenure track total","131","47","84","0","0","0","8","7","1","95","29","66","3","0","3","0","0","0","25","11","14","0","0","0","0","0","0","0","0","0","-2"
"133650","Florida Agricultural and Mechanical University","2011","Total full-time Instruction/research/public service, Non-tenured not on tenure track, Professors","4","3","1","0","0","0","0","0","0","1","0","1","0","0","0","0","0","0","3","3","0","0","0","0","0","0","0","0","0","0","-2"
"133650","Florida Agricultural and Mechanical University","2011","Total full-time Instruction/research/public service, Non-tenured not on tenure track, Associate professors","8","4","4","0","0","0","0","0","0","4","3","1","1","0","1","0","0","0","3","1","2","0","0","0","0","0","0","0","0","0","-2"
"133650","Florida Agricultural and Mechanical University","2011","Total full-time Instruction/research/public servicey, Non-tenured not on tenure track, Assistant professors","54","30","24","0","0","0","4","2","2","44","25","19","0","0","0","0","0","0","5","2","3","1","1","0","0","0","0","0","0","0","-2"
"133650","Florida Agricultural and Mechanical University","2011","Total full-time Instruction/research/public service, Non-tenured not on tenure track, Instructors","64","25","39","0","0","0","1","1","0","50","19","31","2","0","2","0","0","0","11","5","6","0","0","0","0","0","0","0","0","0","-2"
"133650","Florida Agricultural and Mechanical University","2011","Total full-time Instruction/research/public service, Non-tenured not on tenure track total","130","62","68","0","0","0","5","3","2","99","47","52","3","0","3","0","0","0","22","11","11","1","1","0","0","0","0","0","0","0","-2"
"133881","Florida Institute of Technology","2011","Total full-time Instruction/research/public service, Non-tenured not on tenure track, Professors","79","71","8","0","0","0","12","11","1","0","0","0","1","1","0","1","1","0","59","53","6","0","0","0","0","0","0","6","5","1","-2"
"133881","Florida Institute of Technology","2011","Total full-time Instruction/research/public service, Non-tenured not on tenure track, Associate professors","86","70","16","0","0","0","3","3","0","1","1","0","4","2","2","0","0","0","67","53","14","0","0","0","2","2","0","9","9","0","-2"
"133881","Florida Institute of Technology","2011","Total full-time Instruction/research/public servicey, Non-tenured not on tenure track, Assistant professors","54","32","22","0","0","0","3","3","0","1","1","0","5","2","3","0","0","0","35","20","15","0","0","0","0","0","0","10","6","4","-2"
"133881","Florida Institute of Technology","2011","Total full-time Instruction/research/public service, Non-tenured not on tenure track, Instructors","15","5","10","0","0","0","0","0","0","2","0","2","0","0","0","0","0","0","10","4","6","0","0","0","0","0","0","3","1","2","-2"
"133881","Florida Institute of Technology","2011","Total full-time Instruction/research/public service, Non-tenured not on tenure track total","234","178","56","0","0","0","18","17","1","4","2","2","10","5","5","1","1","0","171","130","41","0","0","0","2","2","0","28","21","7","-2"
"133951","Florida International University","2011","Total full-time Instruction/research/public service, Tenured, Professors","214","173","41","1","0","1","31","29","2","6","5","1","38","32","6","0","0","0","137","106","31","0","0","0","0","0","0","1","1","0","-2"
"133951","Florida International University","2011","Total full-time Instruction/research/public service, Tenured, Associate professors","220","143","77","0","0","0","35","28","7","18","10","8","21","16","5","0","0","0","141","84","57","0","0","0","0","0","0","5","5","0","-2"
"133951","Florida International University","2011","Total full-time Instruction/research/public service, Tenured, Assistant professors","1","0","1","0","0","0","0","0","0","0","0","0","1","0","1","0","0","0","0","0","0","0","0","0","0","0","0","0","0","0","-2"
"133951","Florida International University","2011","Total full-time Instruction/research/public service, Tenured total","435","316","119","1","0","1","66","57","9","24","15","9","60","48","12","0","0","0","278","190","88","0","0","0","0","0","0","6","6","0","-2"
"133951","Florida International University","2011","Total full-time Instruction/research/public service, Non-tenured on tenure track, Professors","2","2","0","0","0","0","0","0","0","0","0","0","0","0","0","0","0","0","2","2","0","0","0","0","0","0","0","0","0","0","-2"
"133951","Florida International University","2011","Total full-time Instruction/research/public service, Non-tenured on tenure track, Associate professors","17","8","9","0","0","0","6","4","2","0","0","0","2","0","2","0","0","0","8","3","5","0","0","0","0","0","0","1","1","0","-2"
"133951","Florida International University","2011","Total full-time Instruction/research/public service, Non-tenured on tenure track, Assistant professors","199","115","84","1","1","0","35","24","11","12","3","9","13","4","9","0","0","0","98","61","37","0","0","0","0","0","0","40","22","18","-2"
"133951","Florida International University","2011","Total full-time Instruction/research/public service, Non-tenured on tenure track, Instructors","1","1","0","0","0","0","0","0","0","0","0","0","0","0","0","0","0","0","1","1","0","0","0","0","0","0","0","0","0","0","-2"
"133951","Florida International University","2011","Total full-time Instruction/research/public service, Non-tenured on tenure track, Lecturers","1","0","1","0","0","0","0","0","0","0","0","0","1","0","1","0","0","0","0","0","0","0","0","0","0","0","0","0","0","0","-2"
"133951","Florida International University","2011","Total full-time Instruction/research/public service, Non-tenured on tenure track total","220","126","94","1","1","0","41","28","13","12","3","9","16","4","12","0","0","0","109","67","42","0","0","0","0","0","0","41","23","18","-2"
"133951","Florida International University","2011","Total full-time Instruction/research/public service, Non-tenured not on tenure track, Professors","6","4","2","0","0","0","0","0","0","0","0","0","1","1","0","0","0","0","5","3","2","0","0","0","0","0","0","0","0","0","-2"
"133951","Florida International University","2011","Total full-time Instruction/research/public service, Non-tenured not on tenure track, Associate professors","17","8","9","0","0","0","1","1","0","5","2","3","4","3","1","0","0","0","7","2","5","0","0","0","0","0","0","0","0","0","-2"
"133951","Florida International University","2011","Total full-time Instruction/research/public servicey, Non-tenured not on tenure track, Assistant professors","74","24","50","0","0","0","5","2","3","6","2","4","16","5","11","0","0","0","35","9","26","0","0","0","0","0","0","12","6","6","-2"
"133951","Florida International University","2011","Total full-time Instruction/research/public service, Non-tenured not on tenure track, Instructors","167","89","78","0","0","0","14","7","7","13","8","5","39","15","24","0","0","0","92","54","38","0","0","0","1","1","0","8","4","4","-2"
"133951","Florida International University","2011","Total full-time Instruction/research/public service, Non-tenured not on tenure track, Lecturers","46","24","22","0","0","0","2","1","1","2","2","0","10","2","8","0","0","0","31","19","12","0","0","0","0","0","0","1","0","1","-2"
"133951","Florida International University","2011","Total full-time Instruction/research/public service, Non-tenured not on tenure track total","310","149","161","0","0","0","22","11","11","26","14","12","70","26","44","0","0","0","170","87","83","0","0","0","1","1","0","21","10","11","-2"
"133979","Florida Memorial University","2011","Total full-time Instruction/research/public service, Tenured, Professors","8","5","3","0","0","0","3","3","0","3","2","1","0","0","0","0","0","0","2","0","2","0","0","0","0","0","0","0","0","0","-2"
"133979","Florida Memorial University","2011","Total full-time Instruction/research/public service, Tenured, Associate professors","25","12","13","0","0","0","2","2","0","14","5","9","0","0","0","0","0","0","8","4","4","1","1","0","0","0","0","0","0","0","-2"
"133979","Florida Memorial University","2011","Total full-time Instruction/research/public service, Tenured total","33","17","16","0","0","0","5","5","0","17","7","10","0","0","0","0","0","0","10","4","6","1","1","0","0","0","0","0","0","0","-2"
"133979","Florida Memorial University","2011","Total full-time Instruction/research/public service, Non-tenured on tenure track, Associate professors","13","7","6","0","0","0","1","1","0","10","5","5","1","0","1","0","0","0","1","1","0","0","0","0","0","0","0","0","0","0","-2"
"133979","Florida Memorial University","2011","Total full-time Instruction/research/public service, Non-tenured on tenure track, Assistant professors","28","19","9","0","0","0","3","2","1","18","14","4","4","1","3","0","0","0","2","2","0","1","0","1","0","0","0","0","0","0","-2"
"133979","Florida Memorial University","2011","Total full-time Instruction/research/public service, Non-tenured on tenure track total","41","26","15","0","0","0","4","3","1","28","19","9","5","1","4","0","0","0","3","3","0","1","0","1","0","0","0","0","0","0","-2"
"133979","Florida Memorial University","2011","Total full-time Instruction/research/public servicey, Non-tenured not on tenure track, Assistant professors","3","1","2","0","0","0","0","0","0","3","1","2","0","0","0","0","0","0","0","0","0","0","0","0","0","0","0","0","0","0","-2"
"133979","Florida Memorial University","2011","Total full-time Instruction/research/public service, Non-tenured not on tenure track, Instructors","17","9","8","0","0","0","2","2","0","9","4","5","4","1","3","0","0","0","2","2","0","0","0","0","0","0","0","0","0","0","-2"
"133979","Florida Memorial University","2011","Total full-time Instruction/research/public service, Non-tenured not on tenure track total","20","10","10","0","0","0","2","2","0","12","5","7","4","1","3","0","0","0","2","2","0","0","0","0","0","0","0","0","0","0","-2"
"134097","Florida State University","2011","Total full-time Instruction/research/public service, Tenured, Professors","449","344","105","0","0","0","37","31","6","12","7","5","15","11","4","0","0","0","378","289","89","0","0","0","0","0","0","7","6","1","-2"
"134097","Florida State University","2011","Total full-time Instruction/research/public service, Tenured, Associate professors","317","196","121","1","1","0","34","26","8","18","9","9","14","10","4","0","0","0","241","146","95","2","0","2","0","0","0","7","4","3","-2"
"134097","Florida State University","2011","Total full-time Instruction/research/public service, Tenured, Assistant professors","2","0","2","0","0","0","0","0","0","1","0","1","0","0","0","0","0","0","1","0","1","0","0","0","0","0","0","0","0","0","-2"
"134097","Florida State University","2011","Total full-time Instruction/research/public service, Tenured, No academic rank","1","1","0","0","0","0","0","0","0","0","0","0","0","0","0","0","0","0","1","1","0","0","0","0","0","0","0","0","0","0","-2"
"134097","Florida State University","2011","Total full-time Instruction/research/public service, Tenured total","769","541","228","1","1","0","71","57","14","31","16","15","29","21","8","0","0","0","621","436","185","2","0","2","0","0","0","14","10","4","-2"
"134097","Florida State University","2011","Total full-time Instruction/research/public service, Non-tenured on tenure track, Professors","3","3","0","0","0","0","1","1","0","0","0","0","0","0","0","0","0","0","2","2","0","0","0","0","0","0","0","0","0","0","-2"
"134097","Florida State University","2011","Total full-time Instruction/research/public service, Non-tenured on tenure track, Associate professors","18","11","7","0","0","0","3","1","2","0","0","0","2","1","1","0","0","0","13","9","4","0","0","0","0","0","0","0","0","0","-2"
"134097","Florida State University","2011","Total full-time Instruction/research/public service, Non-tenured on tenure track, Assistant professors","192","119","73","1","1","0","32","22","10","9","2","7","5","3","2","0","0","0","134","84","50","1","1","0","0","0","0","10","6","4","-2"
"134097","Florida State University","2011","Total full-time Instruction/research/public service, Non-tenured on tenure track, No academic rank","1","0","1","0","0","0","0","0","0","0","0","0","0","0","0","0","0","0","1","0","1","0","0","0","0","0","0","0","0","0","-2"
"134097","Florida State University","2011","Total full-time Instruction/research/public service, Non-tenured on tenure track total","214","133","81","1","1","0","36","24","12","9","2","7","7","4","3","0","0","0","150","95","55","1","1","0","0","0","0","10","6","4","-2"
"134097","Florida State University","2011","Total full-time Instruction/research/public service, Non-tenured not on tenure track, Professors","17","11","6","0","0","0","1","0","1","1","0","1","0","0","0","0","0","0","14","10","4","0","0","0","0","0","0","1","1","0","-2"
"134097","Florida State University","2011","Total full-time Instruction/research/public service, Non-tenured not on tenure track, Associate professors","17","9","8","0","0","0","1","0","1","1","1","0","2","1","1","0","0","0","13","7","6","0","0","0","0","0","0","0","0","0","-2"
"134097","Florida State University","2011","Total full-time Instruction/research/public servicey, Non-tenured not on tenure track, Assistant professors","55","28","27","0","0","0","4","2","2","4","1","3","6","6","0","0","0","0","34","15","19","1","0","1","0","0","0","6","4","2","-2"
"134097","Florida State University","2011","Total full-time Instruction/research/public service, Non-tenured not on tenure track, Instructors","8","4","4","0","0","0","0","0","0","0","0","0","0","0","0","0","0","0","8","4","4","0","0","0","0","0","0","0","0","0","-2"
"134097","Florida State University","2011","Total full-time Instruction/research/public service, Non-tenured not on tenure track, Lecturers","19","3","16","0","0","0","1","0","1","0","0","0","1","0","1","0","0","0","6","3","3","0","0","0","0","0","0","11","0","11","-2"
"134097","Florida State University","2011","Total full-time Instruction/research/public service, Non-tenured not on tenure track, No academic rank","551","286","265","1","0","1","49","30","19","18","5","13","22","9","13","0","0","0","422","205","217","2","0","2","0","0","0","37","37","0","-2"
"134097","Florida State University","2011","Total full-time Instruction/research/public service, Non-tenured not on tenure track total","667","341","326","1","0","1","56","32","24","24","7","17","31","16","15","0","0","0","497","244","253","3","0","3","0","0","0","55","42","13","-2"
"135726","University of Miami","2011","Total full-time Instruction/research/public service, Tenured, Professors","610","503","107","1","1","0","58","48","10","8","6","2","67","53","14","0","0","0","471","390","81","1","1","0","3","3","0","1","1","0","-2"
"135726","University of Miami","2011","Total full-time Instruction/research/public service, Tenured, Associate professors","262","178","84","2","2","0","36","29","7","10","5","5","27","17","10","0","0","0","184","122","62","0","0","0","2","2","0","1","1","0","-2"
"135726","University of Miami","2011","Total full-time Instruction/research/public service, Tenured, Assistant professors","2","2","0","0","0","0","0","0","0","0","0","0","0","0","0","0","0","0","2","2","0","0","0","0","0","0","0","0","0","0","-2"
"135726","University of Miami","2011","Total full-time Instruction/research/public service, Tenured total","874","683","191","3","3","0","94","77","17","18","11","7","94","70","24","0","0","0","657","514","143","1","1","0","5","5","0","2","2","0","-2"
"135726","University of Miami","2011","Total full-time Instruction/research/public service, Non-tenured on tenure track, Professors","10","10","0","1","1","0","0","0","0","0","0","0","0","0","0","0","0","0","7","7","0","1","1","0","0","0","0","1","1","0","-2"
"135726","University of Miami","2011","Total full-time Instruction/research/public service, Non-tenured on tenure track, Associate professors","57","37","20","0","0","0","10","8","2","2","1","1","8","7","1","1","0","1","33","19","14","1","0","1","0","0","0","2","2","0","-2"
"135726","University of Miami","2011","Total full-time Instruction/research/public service, Non-tenured on tenure track, Assistant professors","201","119","82","0","0","0","33","22","11","6","3","3","24","16","8","0","0","0","110","59","51","0","0","0","0","0","0","28","19","9","-2"
"135726","University of Miami","2011","Total full-time Instruction/research/public service, Non-tenured on tenure track total","268","166","102","1","1","0","43","30","13","8","4","4","32","23","9","1","0","1","150","85","65","2","1","1","0","0","0","31","22","9","-2"
"135726","University of Miami","2011","Total full-time Instruction/research/public service, Non-tenured not on tenure track, Professors","130","103","27","0","0","0","11","8","3","0","0","0","30","21","9","0","0","0","87","73","14","0","0","0","0","0","0","2","1","1","-2"
"135726","University of Miami","2011","Total full-time Instruction/research/public service, Non-tenured not on tenure track, Associate professors","233","156","77","0","0","0","26","17","9","8","4","4","61","40","21","0","0","0","131","89","42","1","1","0","1","1","0","5","4","1","-2"
"135726","University of Miami","2011","Total full-time Instruction/research/public servicey, Non-tenured not on tenure track, Assistant professors","669","350","319","0","0","0","84","42","42","32","12","20","198","97","101","0","0","0","286","150","136","5","0","5","3","3","0","61","46","15","-2"
"135726","University of Miami","2011","Total full-time Instruction/research/public service, Non-tenured not on tenure track, Instructors","85","42","43","0","0","0","13","6","7","4","2","2","15","6","9","0","0","0","44","23","21","0","0","0","1","0","1","8","5","3","-2"
"135726","University of Miami","2011","Total full-time Instruction/research/public service, Non-tenured not on tenure track, Lecturers","274","126","148","0","0","0","10","3","7","13","4","9","53","22","31","0","0","0","186","91","95","6","4","2","0","0","0","6","2","4","-2"
"135726","University of Miami","2011","Total full-time Instruction/research/public service, Non-tenured not on tenure track total","1391","777","614","0","0","0","144","76","68","57","22","35","357","186","171","0","0","0","734","426","308","12","5","7","5","4","1","82","58","24","-2"
"137351","University of South Florida-Main Campus","2011","Total full-time Instruction/research/public service, Tenured, Professors","360","269","91","4","2","2","40","39","1","11","7","4","16","11","5","0","0","0","288","209","79","1","1","0","0","0","0","0","0","0","-2"
"137351","University of South Florida-Main Campus","2011","Total full-time Instruction/research/public service, Tenured, Associate professors","304","177","127","0","0","0","28","19","9","23","8","15","19","8","11","0","0","0","234","142","92","0","0","0","0","0","0","0","0","0","-2"
"137351","University of South Florida-Main Campus","2011","Total full-time Instruction/research/public service, Tenured, Assistant professors","5","3","2","0","0","0","0","0","0","0","0","0","1","1","0","0","0","0","4","2","2","0","0","0","0","0","0","0","0","0","-2"
"137351","University of South Florida-Main Campus","2011","Total full-time Instruction/research/public service, Tenured, Instructors","1","1","0","0","0","0","0","0","0","0","0","0","0","0","0","0","0","0","1","1","0","0","0","0","0","0","0","0","0","0","-2"
"137351","University of South Florida-Main Campus","2011","Total full-time Instruction/research/public service, Tenured, Lecturers","1","1","0","0","0","0","0","0","0","0","0","0","0","0","0","0","0","0","1","1","0","0","0","0","0","0","0","0","0","0","-2"
"137351","University of South Florida-Main Campus","2011","Total full-time Instruction/research/public service, Tenured total","671","451","220","4","2","2","68","58","10","34","15","19","36","20","16","0","0","0","528","355","173","1","1","0","0","0","0","0","0","0","-2"
"137351","University of South Florida-Main Campus","2011","Total full-time Instruction/research/public service, Non-tenured on tenure track, Professors","21","19","2","0","0","0","0","0","0","2","1","1","1","1","0","0","0","0","17","17","0","0","0","0","0","0","0","1","0","1","-2"
"137351","University of South Florida-Main Campus","2011","Total full-time Instruction/research/public service, Non-tenured on tenure track, Associate professors","29","21","8","0","0","0","4","3","1","2","0","2","1","1","0","0","0","0","22","17","5","0","0","0","0","0","0","0","0","0","-2"
"137351","University of South Florida-Main Campus","2011","Total full-time Instruction/research/public service, Non-tenured on tenure track, Assistant professors","255","132","123","0","0","0","49","27","22","15","7","8","11","5","6","0","0","0","142","66","76","1","0","1","1","1","0","36","26","10","-2"
"137351","University of South Florida-Main Campus","2011","Total full-time Instruction/research/public service, Non-tenured on tenure track, Instructors","4","3","1","0","0","0","1","1","0","0","0","0","0","0","0","0","0","0","2","2","0","1","0","1","0","0","0","0","0","0","-2"
"137351","University of South Florida-Main Campus","2011","Total full-time Instruction/research/public service, Non-tenured on tenure track total","309","175","134","0","0","0","54","31","23","19","8","11","13","7","6","0","0","0","183","102","81","2","0","2","1","1","0","37","26","11","-2"
"137351","University of South Florida-Main Campus","2011","Total full-time Instruction/research/public service, Non-tenured not on tenure track, Professors","22","20","2","0","0","0","1","1","0","0","0","0","2","2","0","0","0","0","19","17","2","0","0","0","0","0","0","0","0","0","-2"
"137351","University of South Florida-Main Campus","2011","Total full-time Instruction/research/public service, Non-tenured not on tenure track, Associate professors","49","27","22","0","0","0","1","0","1","4","2","2","5","4","1","0","0","0","37","19","18","0","0","0","0","0","0","2","2","0","-2"
"137351","University of South Florida-Main Campus","2011","Total full-time Instruction/research/public servicey, Non-tenured not on tenure track, Assistant professors","182","95","87","1","1","0","24","13","11","7","4","3","28","17","11","1","1","0","106","55","51","2","0","2","0","0","0","13","4","9","-2"
"137351","University of South Florida-Main Campus","2011","Total full-time Instruction/research/public service, Non-tenured not on tenure track, Instructors","185","67","118","1","1","0","6","1","5","11","4","7","13","4","9","0","0","0","144","54","90","1","0","1","0","0","0","9","3","6","-2"
"137351","University of South Florida-Main Campus","2011","Total full-time Instruction/research/public service, Non-tenured not on tenure track, Lecturers","5","4","1","0","0","0","0","0","0","1","1","0","0","0","0","0","0","0","4","3","1","0","0","0","0","0","0","0","0","0","-2"
"137351","University of South Florida-Main Campus","2011","Total full-time Instruction/research/public service, Non-tenured not on tenure track total","443","213","230","2","2","0","32","15","17","23","11","12","48","27","21","1","1","0","310","148","162","3","0","3","0","0","0","24","9","15","-2"
"139755","Georgia Institute of Technology-Main Campus","2011","Total full-time Instruction/research/public service, Tenured, Professors","415","363","52","0","0","0","87","78","9","6","5","1","11","10","1","0","0","0","310","269","41","0","0","0","0","0","0","1","1","0","-2"
"139755","Georgia Institute of Technology-Main Campus","2011","Total full-time Instruction/research/public service, Tenured, Associate professors","232","177","55","0","0","0","46","35","11","12","8","4","6","4","2","0","0","0","166","130","36","0","0","0","1","0","1","1","0","1","-2"
"139755","Georgia Institute of Technology-Main Campus","2011","Total full-time Instruction/research/public service, Tenured total","647","540","107","0","0","0","133","113","20","18","13","5","17","14","3","0","0","0","476","399","77","0","0","0","1","0","1","2","1","1","-2"
"139755","Georgia Institute of Technology-Main Campus","2011","Total full-time Instruction/research/public service, Non-tenured on tenure track, Professors","4","2","2","0","0","0","0","0","0","0","0","0","0","0","0","0","0","0","4","2","2","0","0","0","0","0","0","0","0","0","-2"
"139755","Georgia Institute of Technology-Main Campus","2011","Total full-time Instruction/research/public service, Non-tenured on tenure track, Associate professors","21","18","3","0","0","0","8","8","0","2","2","0","1","1","0","0","0","0","10","7","3","0","0","0","0","0","0","0","0","0","-2"
"139755","Georgia Institute of Technology-Main Campus","2011","Total full-time Instruction/research/public service, Non-tenured on tenure track, Assistant professors","224","160","64","0","0","0","57","41","16","11","7","4","12","7","5","0","0","0","135","96","39","1","1","0","1","1","0","7","7","0","-2"
"139755","Georgia Institute of Technology-Main Campus","2011","Total full-time Instruction/research/public service, Non-tenured on tenure track total","249","180","69","0","0","0","65","49","16","13","9","4","13","8","5","0","0","0","149","105","44","1","1","0","1","1","0","7","7","0","-2"
"139755","Georgia Institute of Technology-Main Campus","2011","Total full-time Instruction/research/public service, Non-tenured not on tenure track, Associate professors","1","1","0","0","0","0","1","1","0","0","0","0","0","0","0","0","0","0","0","0","0","0","0","0","0","0","0","0","0","0","-2"
"139755","Georgia Institute of Technology-Main Campus","2011","Total full-time Instruction/research/public servicey, Non-tenured not on tenure track, Assistant professors","1","1","0","0","0","0","0","0","0","0","0","0","0","0","0","0","0","0","1","1","0","0","0","0","0","0","0","0","0","0","-2"
"139755","Georgia Institute of Technology-Main Campus","2011","Total full-time Instruction/research/public service, Non-tenured not on tenure track, Instructors","45","16","29","0","0","0","4","3","1","0","0","0","0","0","0","0","0","0","38","12","26","1","1","0","1","0","1","1","0","1","-2"
"139755","Georgia Institute of Technology-Main Campus","2011","Total full-time Instruction/research/public service, Non-tenured not on tenure track, Lecturers","31","15","16","0","0","0","3","1","2","1","0","1","0","0","0","0","0","0","26","13","13","0","0","0","0","0","0","1","1","0","-2"
"139755","Georgia Institute of Technology-Main Campus","2011","Total full-time Instruction/research/public service, Non-tenured not on tenure track, No academic rank","1","0","1","0","0","0","0","0","0","0","0","0","0","0","0","0","0","0","1","0","1","0","0","0","0","0","0","0","0","0","-2"
"139755","Georgia Institute of Technology-Main Campus","2011","Total full-time Instruction/research/public service, Non-tenured not on tenure track total","79","33","46","0","0","0","8","5","3","1","0","1","0","0","0","0","0","0","66","26","40","1","1","0","1","0","1","2","1","1","-2"
"139959","University of Georgia","2011","Total full-time Instruction/research/public service, Tenured, Professors","694","534","160","3","2","1","42","36","6","38","23","15","19","11","8","0","0","0","587","457","130","2","2","0","3","3","0","0","0","0","-2"
"139959","University of Georgia","2011","Total full-time Instruction/research/public service, Tenured, Associate professors","479","292","187","0","0","0","46","27","19","33","16","17","18","13","5","0","0","0","380","235","145","1","0","1","1","1","0","0","0","0","-2"
"139959","University of Georgia","2011","Total full-time Instruction/research/public service, Tenured, Assistant professors","1","1","0","0","0","0","0","0","0","0","0","0","0","0","0","0","0","0","1","1","0","0","0","0","0","0","0","0","0","0","-2"
"139959","University of Georgia","2011","Total full-time Instruction/research/public service, Tenured total","1174","827","347","3","2","1","88","63","25","71","39","32","37","24","13","0","0","0","968","693","275","3","2","1","4","4","0","0","0","0","-2"
"139959","University of Georgia","2011","Total full-time Instruction/research/public service, Non-tenured on tenure track, Professors","2","2","0","0","0","0","0","0","0","0","0","0","0","0","0","0","0","0","2","2","0","0","0","0","0","0","0","0","0","0","-2"
"139959","University of Georgia","2011","Total full-time Instruction/research/public service, Non-tenured on tenure track, Associate professors","17","14","3","0","0","0","2","2","0","0","0","0","1","1","0","0","0","0","12","10","2","2","1","1","0","0","0","0","0","0","-2"
"139959","University of Georgia","2011","Total full-time Instruction/research/public service, Non-tenured on tenure track, Assistant professors","370","206","164","0","0","0","56","38","18","18","8","10","18","7","11","0","0","0","257","140","117","1","0","1","8","5","3","12","8","4","-2"
"139959","University of Georgia","2011","Total full-time Instruction/research/public service, Non-tenured on tenure track, Instructors","1","1","0","0","0","0","0","0","0","0","0","0","0","0","0","0","0","0","1","1","0","0","0","0","0","0","0","0","0","0","-2"
"139959","University of Georgia","2011","Total full-time Instruction/research/public service, Non-tenured on tenure track total","390","223","167","0","0","0","58","40","18","18","8","10","19","8","11","0","0","0","272","153","119","3","1","2","8","5","3","12","8","4","-2"
"139959","University of Georgia","2011","Total full-time Instruction/research/public service, Non-tenured not on tenure track, Professors","5","3","2","0","0","0","0","0","0","0","0","0","0","0","0","0","0","0","5","3","2","0","0","0","0","0","0","0","0","0","-2"
"139959","University of Georgia","2011","Total full-time Instruction/research/public service, Non-tenured not on tenure track, Associate professors","14","9","5","0","0","0","0","0","0","0","0","0","0","0","0","0","0","0","14","9","5","0","0","0","0","0","0","0","0","0","-2"
"139959","University of Georgia","2011","Total full-time Instruction/research/public servicey, Non-tenured not on tenure track, Assistant professors","30","11","19","0","0","0","3","0","3","3","0","3","1","0","1","0","0","0","22","11","11","0","0","0","1","0","1","0","0","0","-2"
"139959","University of Georgia","2011","Total full-time Instruction/research/public service, Non-tenured not on tenure track, Instructors","50","16","34","1","0","1","0","0","0","1","0","1","4","1","3","0","0","0","43","15","28","1","0","1","0","0","0","0","0","0","-2"
"139959","University of Georgia","2011","Total full-time Instruction/research/public service, Non-tenured not on tenure track, Lecturers","135","60","75","0","0","0","6","1","5","10","5","5","4","1","3","0","0","0","111","52","59","0","0","0","1","0","1","3","1","2","-2"
"139959","University of Georgia","2011","Total full-time Instruction/research/public service, Non-tenured not on tenure track, No academic rank","545","268","277","0","0","0","49","33","16","35","15","20","12","5","7","0","0","0","441","212","229","1","0","1","5","1","4","2","2","0","-2"
"139959","University of Georgia","2011","Total full-time Instruction/research/public service, Non-tenured not on tenure track total","779","367","412","1","0","1","58","34","24","49","20","29","21","7","14","0","0","0","636","302","334","2","0","2","7","1","6","5","3","2","-2"
"140720","Paine College","2011","Total full-time Instruction/research/public service, Tenured, Professors","4","4","0","0","0","0","1","1","0","1","1","0","0","0","0","0","0","0","2","2","0","0","0","0","0","0","0","0","0","0","-2"
"140720","Paine College","2011","Total full-time Instruction/research/public service, Tenured, Associate professors","4","4","0","0","0","0","3","3","0","1","1","0","0","0","0","0","0","0","0","0","0","0","0","0","0","0","0","0","0","0","-2"
"140720","Paine College","2011","Total full-time Instruction/research/public service, Tenured total","8","8","0","0","0","0","4","4","0","2","2","0","0","0","0","0","0","0","2","2","0","0","0","0","0","0","0","0","0","0","-2"
"140720","Paine College","2011","Total full-time Instruction/research/public service, Non-tenured on tenure track, Professors","1","0","1","0","0","0","0","0","0","1","0","1","0","0","0","0","0","0","0","0","0","0","0","0","0","0","0","0","0","0","-2"
"140720","Paine College","2011","Total full-time Instruction/research/public service, Non-tenured on tenure track, Associate professors","3","2","1","0","0","0","0","0","0","3","2","1","0","0","0","0","0","0","0","0","0","0","0","0","0","0","0","0","0","0","-2"
"140720","Paine College","2011","Total full-time Instruction/research/public service, Non-tenured on tenure track, Assistant professors","15","7","8","0","0","0","2","1","1","5","2","3","0","0","0","0","0","0","7","3","4","0","0","0","0","0","0","1","1","0","-2"
"140720","Paine College","2011","Total full-time Instruction/research/public service, Non-tenured on tenure track total","19","9","10","0","0","0","2","1","1","9","4","5","0","0","0","0","0","0","7","3","4","0","0","0","0","0","0","1","1","0","-2"
"140720","Paine College","2011","Total full-time Instruction/research/public service, Non-tenured not on tenure track, Associate professors","5","2","3","0","0","0","0","0","0","3","0","3","0","0","0","0","0","0","2","2","0","0","0","0","0","0","0","0","0","0","-2"
"140720","Paine College","2011","Total full-time Instruction/research/public servicey, Non-tenured not on tenure track, Assistant professors","26","17","9","0","0","0","3","2","1","14","9","5","1","1","0","0","0","0","8","5","3","0","0","0","0","0","0","0","0","0","-2"
"140720","Paine College","2011","Total full-time Instruction/research/public service, Non-tenured not on tenure track, Instructors","4","2","2","0","0","0","1","1","0","3","1","2","0","0","0","0","0","0","0","0","0","0","0","0","0","0","0","0","0","0","-2"
"140720","Paine College","2011","Total full-time Instruction/research/public service, Non-tenured not on tenure track total","35","21","14","0","0","0","4","3","1","20","10","10","1","1","0","0","0","0","10","7","3","0","0","0","0","0","0","0","0","0","-2"
"140960","Savannah State University","2011","Total full-time Instruction/research/public service, Tenured, Professors","16","13","3","0","0","0","6","6","0","9","6","3","0","0","0","0","0","0","1","1","0","0","0","0","0","0","0","0","0","0","-2"
"140960","Savannah State University","2011","Total full-time Instruction/research/public service, Tenured, Associate professors","27","18","9","0","0","0","11","8","3","12","8","4","0","0","0","0","0","0","4","2","2","0","0","0","0","0","0","0","0","0","-2"
"140960","Savannah State University","2011","Total full-time Instruction/research/public service, Tenured, Assistant professors","15","7","8","0","0","0","2","1","1","8","4","4","0","0","0","0","0","0","5","2","3","0","0","0","0","0","0","0","0","0","-2"
"140960","Savannah State University","2011","Total full-time Instruction/research/public service, Tenured, Lecturers","2","1","1","0","0","0","1","1","0","0","0","0","0","0","0","0","0","0","1","0","1","0","0","0","0","0","0","0","0","0","-2"
"140960","Savannah State University","2011","Total full-time Instruction/research/public service, Tenured total","60","39","21","0","0","0","20","16","4","29","18","11","0","0","0","0","0","0","11","5","6","0","0","0","0","0","0","0","0","0","-2"
"140960","Savannah State University","2011","Total full-time Instruction/research/public service, Non-tenured on tenure track, Professors","1","1","0","0","0","0","0","0","0","1","1","0","0","0","0","0","0","0","0","0","0","0","0","0","0","0","0","0","0","0","-2"
"140960","Savannah State University","2011","Total full-time Instruction/research/public service, Non-tenured on tenure track, Associate professors","4","2","2","0","0","0","1","0","1","2","2","0","0","0","0","0","0","0","1","0","1","0","0","0","0","0","0","0","0","0","-2"
"140960","Savannah State University","2011","Total full-time Instruction/research/public service, Non-tenured on tenure track, Assistant professors","44","23","21","0","0","0","10","7","3","15","8","7","1","0","1","0","0","0","12","7","5","0","0","0","6","1","5","0","0","0","-2"
"140960","Savannah State University","2011","Total full-time Instruction/research/public service, Non-tenured on tenure track, Lecturers","1","1","0","0","0","0","0","0","0","0","0","0","0","0","0","0","0","0","1","1","0","0","0","0","0","0","0","0","0","0","-2"
"140960","Savannah State University","2011","Total full-time Instruction/research/public service, Non-tenured on tenure track total","50","27","23","0","0","0","11","7","4","18","11","7","1","0","1","0","0","0","14","8","6","0","0","0","6","1","5","0","0","0","-2"
"140960","Savannah State University","2011","Total full-time Instruction/research/public service, Non-tenured not on tenure track, Professors","1","1","0","0","0","0","0","0","0","1","1","0","0","0","0","0","0","0","0","0","0","0","0","0","0","0","0","0","0","0","-2"
"140960","Savannah State University","2011","Total full-time Instruction/research/public service, Non-tenured not on tenure track, Associate professors","1","1","0","0","0","0","0","0","0","0","0","0","0","0","0","0","0","0","1","1","0","0","0","0","0","0","0","0","0","0","-2"
"140960","Savannah State University","2011","Total full-time Instruction/research/public servicey, Non-tenured not on tenure track, Assistant professors","8","3","5","0","0","0","0","0","0","6","2","4","0","0","0","0","0","0","2","1","1","0","0","0","0","0","0","0","0","0","-2"
"140960","Savannah State University","2011","Total full-time Instruction/research/public service, Non-tenured not on tenure track, Instructors","27","9","18","0","0","0","3","2","1","13","2","11","0","0","0","0","0","0","10","5","5","0","0","0","1","0","1","0","0","0","-2"
"140960","Savannah State University","2011","Total full-time Instruction/research/public service, Non-tenured not on tenure track, Lecturers","15","6","9","0","0","0","0","0","0","10","4","6","0","0","0","0","0","0","4","1","3","0","0","0","1","1","0","0","0","0","-2"
"140960","Savannah State University","2011","Total full-time Instruction/research/public service, Non-tenured not on tenure track, No academic rank","1","1","0","0","0","0","0","0","0","1","1","0","0","0","0","0","0","0","0","0","0","0","0","0","0","0","0","0","0","0","-2"
"140960","Savannah State University","2011","Total full-time Instruction/research/public service, Non-tenured not on tenure track total","53","21","32","0","0","0","3","2","1","31","10","21","0","0","0","0","0","0","17","8","9","0","0","0","2","1","1","0","0","0","-2"
"141060","Spelman College","2011","Total full-time Instruction/research/public service, Tenured, Professors","30","11","19","0","0","0","4","1","3","17","6","11","0","0","0","0","0","0","9","4","5","0","0","0","0","0","0","0","0","0","-2"
"141060","Spelman College","2011","Total full-time Instruction/research/public service, Tenured, Associate professors","60","23","37","0","0","0","5","3","2","35","11","24","5","3","2","0","0","0","13","6","7","2","0","2","0","0","0","0","0","0","-2"
"141060","Spelman College","2011","Total full-time Instruction/research/public service, Tenured total","90","34","56","0","0","0","9","4","5","52","17","35","5","3","2","0","0","0","22","10","12","2","0","2","0","0","0","0","0","0","-2"
"141060","Spelman College","2011","Total full-time Instruction/research/public service, Non-tenured on tenure track, Assistant professors","33","12","21","0","0","0","3","2","1","22","7","15","1","0","1","0","0","0","4","1","3","2","2","0","1","0","1","0","0","0","-2"
"141060","Spelman College","2011","Total full-time Instruction/research/public service, Non-tenured on tenure track total","33","12","21","0","0","0","3","2","1","22","7","15","1","0","1","0","0","0","4","1","3","2","2","0","1","0","1","0","0","0","-2"
"141060","Spelman College","2011","Total full-time Instruction/research/public service, Non-tenured not on tenure track, Instructors","22","3","19","0","0","0","0","0","0","19","3","16","1","0","1","0","0","0","2","0","2","0","0","0","0","0","0","0","0","0","-2"
"141060","Spelman College","2011","Total full-time Instruction/research/public service, Non-tenured not on tenure track, Lecturers","28","6","22","0","0","0","1","0","1","22","5","17","1","0","1","0","0","0","3","0","3","1","1","0","0","0","0","0","0","0","-2"
"141060","Spelman College","2011","Total full-time Instruction/research/public service, Non-tenured not on tenure track total","50","9","41","0","0","0","1","0","1","41","8","33","2","0","2","0","0","0","5","0","5","1","1","0","0","0","0","0","0","0","-2"
"141574","University of Hawaii at Manoa","2011","Total full-time Instruction/research/public service, Tenured, Professors","551","411","140","2","2","0","131","95","36","4","2","2","5","2","3","11","4","7","393","302","91","1","0","1","0","0","0","4","4","0","-2"
"141574","University of Hawaii at Manoa","2011","Total full-time Instruction/research/public service, Tenured, Associate professors","296","159","137","0","0","0","85","39","46","2","0","2","8","4","4","14","3","11","175","105","70","0","0","0","0","0","0","12","8","4","-2"
"141574","University of Hawaii at Manoa","2011","Total full-time Instruction/research/public service, Tenured, Assistant professors","11","6","5","0","0","0","6","2","4","0","0","0","0","0","0","3","2","1","2","2","0","0","0","0","0","0","0","0","0","0","-2"
"141574","University of Hawaii at Manoa","2011","Total full-time Instruction/research/public service, Tenured total","858","576","282","2","2","0","222","136","86","6","2","4","13","6","7","28","9","19","570","409","161","1","0","1","0","0","0","16","12","4","-2"
"141574","University of Hawaii at Manoa","2011","Total full-time Instruction/research/public service, Non-tenured on tenure track, Professors","10","8","2","1","0","1","3","3","0","1","1","0","0","0","0","0","0","0","3","2","1","0","0","0","0","0","0","2","2","0","-2"
"141574","University of Hawaii at Manoa","2011","Total full-time Instruction/research/public service, Non-tenured on tenure track, Associate professors","27","17","10","0","0","0","7","6","1","2","0","2","0","0","0","2","2","0","13","8","5","0","0","0","0","0","0","3","1","2","-2"
"141574","University of Hawaii at Manoa","2011","Total full-time Instruction/research/public service, Non-tenured on tenure track, Assistant professors","250","126","124","1","0","1","60","33","27","1","1","0","6","4","2","14","5","9","110","59","51","9","4","5","0","0","0","49","20","29","-2"
"141574","University of Hawaii at Manoa","2011","Total full-time Instruction/research/public service, Non-tenured on tenure track total","287","151","136","2","0","2","70","42","28","4","2","2","6","4","2","16","7","9","126","69","57","9","4","5","0","0","0","54","23","31","-2"
"141574","University of Hawaii at Manoa","2011","Total full-time Instruction/research/public service, Non-tenured not on tenure track, Professors","25","21","4","0","0","0","6","4","2","0","0","0","2","2","0","1","1","0","14","12","2","0","0","0","0","0","0","2","2","0","-2"
"141574","University of Hawaii at Manoa","2011","Total full-time Instruction/research/public service, Non-tenured not on tenure track, Associate professors","47","34","13","0","0","0","13","8","5","0","0","0","1","1","0","1","0","1","30","23","7","0","0","0","0","0","0","2","2","0","-2"
"141574","University of Hawaii at Manoa","2011","Total full-time Instruction/research/public servicey, Non-tenured not on tenure track, Assistant professors","129","65","64","2","0","2","40","15","25","2","1","1","3","2","1","7","3","4","50","26","24","3","1","2","0","0","0","22","17","5","-2"
"141574","University of Hawaii at Manoa","2011","Total full-time Instruction/research/public service, Non-tenured not on tenure track, Instructors","174","53","121","0","0","0","49","9","40","4","0","4","5","3","2","20","4","16","64","23","41","5","0","5","2","0","2","25","14","11","-2"
"141574","University of Hawaii at Manoa","2011","Total full-time Instruction/research/public service, Non-tenured not on tenure track total","375","173","202","2","0","2","108","36","72","6","1","5","11","8","3","29","8","21","158","84","74","8","1","7","2","0","2","51","35","16","-2"
"141644","Hawaii Pacific University","2011","Total full-time Instruction/research/public service, Tenured, Professors","4","4","0","0","0","0","1","1","0","0","0","0","0","0","0","0","0","0","3","3","0","0","0","0","0","0","0","0","0","0","-2"
"141644","Hawaii Pacific University","2011","Total full-time Instruction/research/public service, Tenured, Associate professors","1","1","0","0","0","0","0","0","0","0","0","0","0","0","0","0","0","0","1","1","0","0","0","0","0","0","0","0","0","0","-2"
"141644","Hawaii Pacific University","2011","Total full-time Instruction/research/public service, Tenured, Assistant professors","1","1","0","0","0","0","0","0","0","0","0","0","0","0","0","0","0","0","1","1","0","0","0","0","0","0","0","0","0","0","-2"
"141644","Hawaii Pacific University","2011","Total full-time Instruction/research/public service, Tenured total","6","6","0","0","0","0","1","1","0","0","0","0","0","0","0","0","0","0","5","5","0","0","0","0","0","0","0","0","0","0","-2"
"141644","Hawaii Pacific University","2011","Total full-time Instruction/research/public service, Non-tenured not on tenure track, Professors","30","19","11","1","0","1","1","1","0","0","0","0","1","1","0","0","0","0","26","16","10","0","0","0","1","1","0","0","0","0","-2"
"141644","Hawaii Pacific University","2011","Total full-time Instruction/research/public service, Non-tenured not on tenure track, Associate professors","71","40","31","1","0","1","13","8","5","1","0","1","0","0","0","1","0","1","42","26","16","11","5","6","2","1","1","0","0","0","-2"
"141644","Hawaii Pacific University","2011","Total full-time Instruction/research/public servicey, Non-tenured not on tenure track, Assistant professors","109","45","64","0","0","0","26","7","19","0","0","0","2","0","2","1","0","1","73","36","37","4","0","4","3","2","1","0","0","0","-2"
"141644","Hawaii Pacific University","2011","Total full-time Instruction/research/public service, Non-tenured not on tenure track, Instructors","42","26","16","0","0","0","7","4","3","1","0","1","1","0","1","1","0","1","28","19","9","3","2","1","1","1","0","0","0","0","-2"
"141644","Hawaii Pacific University","2011","Total full-time Instruction/research/public service, Non-tenured not on tenure track total","252","130","122","2","0","2","47","20","27","2","0","2","4","1","3","3","0","3","169","97","72","18","7","11","7","5","2","0","0","0","-2"
"142115","Boise State University","2011","Total full-time Instruction/research/public service, Tenured, Professors","160","112","48","1","1","0","5","4","1","0","0","0","2","2","0","0","0","0","148","102","46","2","2","0","0","0","0","2","1","1","-2"
"142115","Boise State University","2011","Total full-time Instruction/research/public service, Tenured, Associate professors","171","89","82","1","0","1","7","6","1","2","2","0","4","0","4","0","0","0","151","76","75","2","1","1","0","0","0","4","4","0","-2"
"142115","Boise State University","2011","Total full-time Instruction/research/public service, Tenured, Assistant professors","16","5","11","0","0","0","0","0","0","0","0","0","0","0","0","0","0","0","15","4","11","0","0","0","0","0","0","1","1","0","-2"
"142115","Boise State University","2011","Total full-time Instruction/research/public service, Tenured total","347","206","141","2","1","1","12","10","2","2","2","0","6","2","4","0","0","0","314","182","132","4","3","1","0","0","0","7","6","1","-2"
"142115","Boise State University","2011","Total full-time Instruction/research/public service, Non-tenured on tenure track, Associate professors","7","3","4","1","0","1","0","0","0","0","0","0","1","0","1","0","0","0","5","3","2","0","0","0","0","0","0","0","0","0","-2"
"142115","Boise State University","2011","Total full-time Instruction/research/public service, Non-tenured on tenure track, Assistant professors","118","68","50","1","1","0","7","6","1","0","0","0","6","3","3","0","0","0","86","45","41","0","0","0","0","0","0","18","13","5","-2"
"142115","Boise State University","2011","Total full-time Instruction/research/public service, Non-tenured on tenure track total","125","71","54","2","1","1","7","6","1","0","0","0","7","3","4","0","0","0","91","48","43","0","0","0","0","0","0","18","13","5","-2"
"142115","Boise State University","2011","Total full-time Instruction/research/public service, Non-tenured not on tenure track, Professors","4","1","3","0","0","0","0","0","0","0","0","0","0","0","0","0","0","0","4","1","3","0","0","0","0","0","0","0","0","0","-2"
"142115","Boise State University","2011","Total full-time Instruction/research/public service, Non-tenured not on tenure track, Associate professors","3","2","1","0","0","0","2","2","0","0","0","0","0","0","0","0","0","0","1","0","1","0","0","0","0","0","0","0","0","0","-2"
"142115","Boise State University","2011","Total full-time Instruction/research/public servicey, Non-tenured not on tenure track, Assistant professors","14","8","6","0","0","0","0","0","0","0","0","0","0","0","0","0","0","0","14","8","6","0","0","0","0","0","0","0","0","0","-2"
"142115","Boise State University","2011","Total full-time Instruction/research/public service, Non-tenured not on tenure track, Instructors","6","2","4","0","0","0","0","0","0","0","0","0","0","0","0","0","0","0","5","2","3","0","0","0","0","0","0","1","0","1","-2"
"142115","Boise State University","2011","Total full-time Instruction/research/public service, Non-tenured not on tenure track, Lecturers","96","36","60","1","1","0","3","1","2","1","0","1","2","1","1","0","0","0","87","33","54","1","0","1","0","0","0","1","0","1","-2"
"142115","Boise State University","2011","Total full-time Instruction/research/public service, Non-tenured not on tenure track, No academic rank","27","19","8","0","0","0","2","1","1","0","0","0","2","1","1","2","0","2","14","10","4","0","0","0","0","0","0","7","7","0","-2"
"142115","Boise State University","2011","Total full-time Instruction/research/public service, Non-tenured not on tenure track total","150","68","82","1","1","0","7","4","3","1","0","1","4","2","2","2","0","2","125","54","71","1","0","1","0","0","0","9","7","2","-2"
"142294","The College of Idaho","2011","Total full-time Instruction/research/public service, Tenured, Professors","28","19","9","0","0","0","1","0","1","0","0","0","0","0","0","0","0","0","27","19","8","0","0","0","0","0","0","0","0","0","-2"
"142294","The College of Idaho","2011","Total full-time Instruction/research/public service, Tenured, Associate professors","7","3","4","0","0","0","1","0","1","0","0","0","0","0","0","0","0","0","5","3","2","0","0","0","0","0","0","1","0","1","-2"
"142294","The College of Idaho","2011","Total full-time Instruction/research/public service, Tenured total","35","22","13","0","0","0","2","0","2","0","0","0","0","0","0","0","0","0","32","22","10","0","0","0","0","0","0","1","0","1","-2"
"142294","The College of Idaho","2011","Total full-time Instruction/research/public service, Non-tenured on tenure track, Assistant professors","15","8","7","0","0","0","0","0","0","0","0","0","0","0","0","1","1","0","13","7","6","0","0","0","1","0","1","0","0","0","-2"
"142294","The College of Idaho","2011","Total full-time Instruction/research/public service, Non-tenured on tenure track total","15","8","7","0","0","0","0","0","0","0","0","0","0","0","0","1","1","0","13","7","6","0","0","0","1","0","1","0","0","0","-2"
"142294","The College of Idaho","2011","Total full-time Instruction/research/public service, Non-tenured not on tenure track, Professors","1","1","0","0","0","0","0","0","0","0","0","0","0","0","0","0","0","0","1","1","0","0","0","0","0","0","0","0","0","0","-2"
"142294","The College of Idaho","2011","Total full-time Instruction/research/public servicey, Non-tenured not on tenure track, Assistant professors","5","4","1","0","0","0","0","0","0","0","0","0","0","0","0","0","0","0","5","4","1","0","0","0","0","0","0","0","0","0","-2"
"142294","The College of Idaho","2011","Total full-time Instruction/research/public service, Non-tenured not on tenure track, Instructors","14","5","9","0","0","0","0","0","0","0","0","0","1","0","1","0","0","0","13","5","8","0","0","0","0","0","0","0","0","0","-2"
"142294","The College of Idaho","2011","Total full-time Instruction/research/public service, Non-tenured not on tenure track, Lecturers","1","1","0","0","0","0","0","0","0","0","0","0","0","0","0","0","0","0","1","1","0","0","0","0","0","0","0","0","0","0","-2"
"142294","The College of Idaho","2011","Total full-time Instruction/research/public service, Non-tenured not on tenure track, No academic rank","3","3","0","0","0","0","0","0","0","0","0","0","0","0","0","0","0","0","2","2","0","0","0","0","0","0","0","1","1","0","-2"
"142294","The College of Idaho","2011","Total full-time Instruction/research/public service, Non-tenured not on tenure track total","24","14","10","0","0","0","0","0","0","0","0","0","1","0","1","0","0","0","22","13","9","0","0","0","0","0","0","1","1","0","-2"
"144050","University of Chicago","2011","Total full-time Instruction/research/public service, Tenured, Professors","586","473","113","0","0","0","56","52","4","11","8","3","20","17","3","0","0","0","496","393","103","3","3","0","0","0","0","0","0","0","-2"
"144050","University of Chicago","2011","Total full-time Instruction/research/public service, Tenured, Associate professors","164","106","58","0","0","0","24","16","8","10","8","2","6","5","1","0","0","0","121","75","46","3","2","1","0","0","0","0","0","0","-2"
"144050","University of Chicago","2011","Total full-time Instruction/research/public service, Tenured total","750","579","171","0","0","0","80","68","12","21","16","5","26","22","4","0","0","0","617","468","149","6","5","1","0","0","0","0","0","0","-2"
"144050","University of Chicago","2011","Total full-time Instruction/research/public service, Non-tenured on tenure track, Professors","1","1","0","0","0","0","0","0","0","0","0","0","0","0","0","0","0","0","0","0","0","0","0","0","0","0","0","1","1","0","-2"
"144050","University of Chicago","2011","Total full-time Instruction/research/public service, Non-tenured on tenure track, Associate professors","26","19","7","0","0","0","3","3","0","0","0","0","1","1","0","0","0","0","20","14","6","0","0","0","0","0","0","2","1","1","-2"
"144050","University of Chicago","2011","Total full-time Instruction/research/public service, Non-tenured on tenure track, Assistant professors","310","201","109","0","0","0","45","21","24","10","7","3","11","7","4","0","0","0","207","137","70","4","3","1","0","0","0","33","26","7","-2"
"144050","University of Chicago","2011","Total full-time Instruction/research/public service, Non-tenured on tenure track, Instructors","15","11","4","0","0","0","1","1","0","1","0","1","0","0","0","0","0","0","12","9","3","0","0","0","0","0","0","1","1","0","-2"
"144050","University of Chicago","2011","Total full-time Instruction/research/public service, Non-tenured on tenure track total","352","232","120","0","0","0","49","25","24","11","7","4","12","8","4","0","0","0","239","160","79","4","3","1","0","0","0","37","29","8","-2"
"144050","University of Chicago","2011","Total full-time Instruction/research/public service, Non-tenured not on tenure track, Professors","177","140","37","0","0","0","19","13","6","5","3","2","0","0","0","0","0","0","149","120","29","0","0","0","0","0","0","4","4","0","-2"
"144050","University of Chicago","2011","Total full-time Instruction/research/public service, Non-tenured not on tenure track, Associate professors","251","167","84","0","0","0","42","29","13","6","4","2","5","0","5","0","0","0","193","131","62","3","2","1","0","0","0","2","1","1","-2"
"144050","University of Chicago","2011","Total full-time Instruction/research/public servicey, Non-tenured not on tenure track, Assistant professors","379","201","178","0","0","0","121","68","53","15","3","12","6","2","4","0","0","0","190","101","89","4","2","2","0","0","0","43","25","18","-2"
"144050","University of Chicago","2011","Total full-time Instruction/research/public service, Non-tenured not on tenure track, Instructors","84","47","37","0","0","0","13","6","7","5","3","2","0","0","0","0","0","0","40","23","17","1","1","0","0","0","0","25","14","11","-2"
"144050","University of Chicago","2011","Total full-time Instruction/research/public service, Non-tenured not on tenure track, Lecturers","128","59","69","0","0","0","14","6","8","3","2","1","5","3","2","0","0","0","95","44","51","0","0","0","0","0","0","11","4","7","-2"
"144050","University of Chicago","2011","Total full-time Instruction/research/public service, Non-tenured not on tenure track, No academic rank","50","24","26","0","0","0","15","7","8","5","0","5","0","0","0","0","0","0","28","15","13","0","0","0","0","0","0","2","2","0","-2"
"144050","University of Chicago","2011","Total full-time Instruction/research/public service, Non-tenured not on tenure track total","1069","638","431","0","0","0","224","129","95","39","15","24","16","5","11","0","0","0","695","434","261","8","5","3","0","0","0","87","50","37","-2"
"144865","College of DuPage","2011","Total full-time Instruction/research/public service, Tenured, Professors","167","74","93","2","2","0","13","7","6","6","2","4","1","0","1","0","0","0","143","63","80","2","0","2","0","0","0","0","0","0","-2"
"144865","College of DuPage","2011","Total full-time Instruction/research/public service, Tenured, Associate professors","51","24","27","0","0","0","4","0","4","1","1","0","3","2","1","0","0","0","43","21","22","0","0","0","0","0","0","0","0","0","-2"
"144865","College of DuPage","2011","Total full-time Instruction/research/public service, Tenured, Assistant professors","29","15","14","0","0","0","1","0","1","1","0","1","2","2","0","0","0","0","24","12","12","1","1","0","0","0","0","0","0","0","-2"
"144865","College of DuPage","2011","Total full-time Instruction/research/public service, Tenured total","247","113","134","2","2","0","18","7","11","8","3","5","6","4","2","0","0","0","210","96","114","3","1","2","0","0","0","0","0","0","-2"
"144865","College of DuPage","2011","Total full-time Instruction/research/public service, Non-tenured on tenure track, Professors","3","2","1","0","0","0","0","0","0","1","1","0","0","0","0","0","0","0","2","1","1","0","0","0","0","0","0","0","0","0","-2"
"144865","College of DuPage","2011","Total full-time Instruction/research/public service, Non-tenured on tenure track, Associate professors","4","4","0","0","0","0","1","1","0","0","0","0","0","0","0","0","0","0","3","3","0","0","0","0","0","0","0","0","0","0","-2"
"144865","College of DuPage","2011","Total full-time Instruction/research/public service, Non-tenured on tenure track, Assistant professors","14","6","8","0","0","0","0","0","0","1","1","0","0","0","0","0","0","0","13","5","8","0","0","0","0","0","0","0","0","0","-2"
"144865","College of DuPage","2011","Total full-time Instruction/research/public service, Non-tenured on tenure track, Instructors","1","1","0","0","0","0","0","0","0","0","0","0","0","0","0","0","0","0","1","1","0","0","0","0","0","0","0","0","0","0","-2"
"144865","College of DuPage","2011","Total full-time Instruction/research/public service, Non-tenured on tenure track total","22","13","9","0","0","0","1","1","0","2","2","0","0","0","0","0","0","0","19","10","9","0","0","0","0","0","0","0","0","0","-2"
"144865","College of DuPage","2011","Total full-time Instruction/research/public servicey, Non-tenured not on tenure track, Assistant professors","2","0","2","0","0","0","0","0","0","0","0","0","0","0","0","0","0","0","2","0","2","0","0","0","0","0","0","0","0","0","-2"
"144865","College of DuPage","2011","Total full-time Instruction/research/public service, Non-tenured not on tenure track, Instructors","1","1","0","0","0","0","0","0","0","0","0","0","0","0","0","0","0","0","1","1","0","0","0","0","0","0","0","0","0","0","-2"
"144865","College of DuPage","2011","Total full-time Instruction/research/public service, Non-tenured not on tenure track total","3","1","2","0","0","0","0","0","0","0","0","0","0","0","0","0","0","0","3","1","2","0","0","0","0","0","0","0","0","0","-2"
"145637","University of Illinois at Urbana-Champaign","2011","Total full-time Instruction/research/public service, Tenured, Professors","768","610","158","2","1","1","88","77","11","22","16","6","29","20","9","0","0","0","617","488","129","3","2","1","4","4","0","3","2","1","-2"
"145637","University of Illinois at Urbana-Champaign","2011","Total full-time Instruction/research/public service, Tenured, Associate professors","501","320","181","1","0","1","82","55","27","27","13","14","28","16","12","0","0","0","357","233","124","5","2","3","0","0","0","1","1","0","-2"
"145637","University of Illinois at Urbana-Champaign","2011","Total full-time Instruction/research/public service, Tenured, No academic rank","1","1","0","0","0","0","0","0","0","0","0","0","0","0","0","0","0","0","1","1","0","0","0","0","0","0","0","0","0","0","-2"
"145637","University of Illinois at Urbana-Champaign","2011","Total full-time Instruction/research/public service, Tenured total","1270","931","339","3","1","2","170","132","38","49","29","20","57","36","21","0","0","0","975","722","253","8","4","4","4","4","0","4","3","1","-2"
"145637","University of Illinois at Urbana-Champaign","2011","Total full-time Instruction/research/public service, Non-tenured on tenure track, Professors","1","0","1","0","0","0","0","0","0","0","0","0","0","0","0","0","0","0","1","0","1","0","0","0","0","0","0","0","0","0","-2"
"145637","University of Illinois at Urbana-Champaign","2011","Total full-time Instruction/research/public service, Non-tenured on tenure track, Associate professors","7","6","1","0","0","0","1","1","0","0","0","0","1","1","0","0","0","0","4","3","1","0","0","0","1","1","0","0","0","0","-2"
"145637","University of Illinois at Urbana-Champaign","2011","Total full-time Instruction/research/public service, Non-tenured on tenure track, Assistant professors","393","231","162","3","2","1","77","47","30","26","12","14","33","18","15","0","0","0","214","126","88","2","0","2","5","3","2","33","23","10","-2"
"145637","University of Illinois at Urbana-Champaign","2011","Total full-time Instruction/research/public service, Non-tenured on tenure track total","401","237","164","3","2","1","78","48","30","26","12","14","34","19","15","0","0","0","219","129","90","2","0","2","6","4","2","33","23","10","-2"
"145637","University of Illinois at Urbana-Champaign","2011","Total full-time Instruction/research/public service, Non-tenured not on tenure track, Professors","20","14","6","0","0","0","3","3","0","0","0","0","1","0","1","0","0","0","16","11","5","0","0","0","0","0","0","0","0","0","-2"
"145637","University of Illinois at Urbana-Champaign","2011","Total full-time Instruction/research/public service, Non-tenured not on tenure track, Associate professors","28","13","15","0","0","0","2","1","1","2","1","1","0","0","0","0","0","0","24","11","13","0","0","0","0","0","0","0","0","0","-2"
"145637","University of Illinois at Urbana-Champaign","2011","Total full-time Instruction/research/public servicey, Non-tenured not on tenure track, Assistant professors","121","68","53","0","0","0","17","9","8","2","0","2","5","2","3","0","0","0","74","38","36","1","1","0","1","1","0","21","17","4","-2"
"145637","University of Illinois at Urbana-Champaign","2011","Total full-time Instruction/research/public service, Non-tenured not on tenure track, Instructors","55","25","30","0","0","0","2","2","0","4","2","2","1","0","1","0","0","0","45","21","24","0","0","0","0","0","0","3","0","3","-2"
"145637","University of Illinois at Urbana-Champaign","2011","Total full-time Instruction/research/public service, Non-tenured not on tenure track, Lecturers","162","85","77","0","0","0","9","4","5","5","3","2","3","3","0","0","0","0","132","64","68","1","1","0","2","2","0","10","8","2","-2"
"145637","University of Illinois at Urbana-Champaign","2011","Total full-time Instruction/research/public service, Non-tenured not on tenure track, No academic rank","91","49","42","0","0","0","11","6","5","4","2","2","1","1","0","0","0","0","65","32","33","1","1","0","0","0","0","9","7","2","-2"
"145637","University of Illinois at Urbana-Champaign","2011","Total full-time Instruction/research/public service, Non-tenured not on tenure track total","477","254","223","0","0","0","44","25","19","17","8","9","11","6","5","0","0","0","356","177","179","3","3","0","3","3","0","43","32","11","-2"
"147703","Northern Illinois University","2011","Total full-time Instruction/research/public service, Tenured, Professors","216","152","64","0","0","0","27","23","4","5","3","2","5","1","4","0","0","0","171","119","52","2","0","2","1","1","0","5","5","0","-2"
"147703","Northern Illinois University","2011","Total full-time Instruction/research/public service, Tenured, Associate professors","292","159","133","0","0","0","16","9","7","14","7","7","9","3","6","0","0","0","218","120","98","2","2","0","3","2","1","30","16","14","-2"
"147703","Northern Illinois University","2011","Total full-time Instruction/research/public service, Tenured, Assistant professors","5","2","3","0","0","0","0","0","0","1","0","1","0","0","0","0","0","0","4","2","2","0","0","0","0","0","0","0","0","0","-2"
"147703","Northern Illinois University","2011","Total full-time Instruction/research/public service, Tenured total","513","313","200","0","0","0","43","32","11","20","10","10","14","4","10","0","0","0","393","241","152","4","2","2","4","3","1","35","21","14","-2"
"147703","Northern Illinois University","2011","Total full-time Instruction/research/public service, Non-tenured on tenure track, Associate professors","10","9","1","0","0","0","1","1","0","0","0","0","1","1","0","0","0","0","7","6","1","0","0","0","0","0","0","1","1","0","-2"
"147703","Northern Illinois University","2011","Total full-time Instruction/research/public service, Non-tenured on tenure track, Assistant professors","186","85","101","1","0","1","12","8","4","6","3","3","2","1","1","0","0","0","113","51","62","1","1","0","4","2","2","47","19","28","-2"
"147703","Northern Illinois University","2011","Total full-time Instruction/research/public service, Non-tenured on tenure track, Instructors","2","2","0","0","0","0","0","0","0","0","0","0","0","0","0","0","0","0","2","2","0","0","0","0","0","0","0","0","0","0","-2"
"147703","Northern Illinois University","2011","Total full-time Instruction/research/public service, Non-tenured on tenure track, No academic rank","2","2","0","0","0","0","0","0","0","0","0","0","0","0","0","0","0","0","2","2","0","0","0","0","0","0","0","0","0","0","-2"
"147703","Northern Illinois University","2011","Total full-time Instruction/research/public service, Non-tenured on tenure track total","200","98","102","1","0","1","13","9","4","6","3","3","3","2","1","0","0","0","124","61","63","1","1","0","4","2","2","48","20","28","-2"
"147703","Northern Illinois University","2011","Total full-time Instruction/research/public service, Non-tenured not on tenure track, Professors","1","1","0","0","0","0","0","0","0","0","0","0","0","0","0","0","0","0","1","1","0","0","0","0","0","0","0","0","0","0","-2"
"147703","Northern Illinois University","2011","Total full-time Instruction/research/public servicey, Non-tenured not on tenure track, Assistant professors","13","6","7","0","0","0","1","0","1","0","0","0","3","0","3","0","0","0","8","6","2","0","0","0","0","0","0","1","0","1","-2"
"147703","Northern Illinois University","2011","Total full-time Instruction/research/public service, Non-tenured not on tenure track, Instructors","157","61","96","0","0","0","6","3","3","4","3","1","4","2","2","0","0","0","141","53","88","0","0","0","1","0","1","1","0","1","-2"
"147703","Northern Illinois University","2011","Total full-time Instruction/research/public service, Non-tenured not on tenure track, No academic rank","1","0","1","0","0","0","0","0","0","0","0","0","0","0","0","0","0","0","0","0","0","0","0","0","0","0","0","1","0","1","-2"
"147703","Northern Illinois University","2011","Total full-time Instruction/research/public service, Non-tenured not on tenure track total","172","68","104","0","0","0","7","3","4","4","3","1","7","2","5","0","0","0","150","60","90","0","0","0","1","0","1","3","0","3","-2"
"147767","Northwestern University","2011","Total full-time Instruction/research/public service, Tenured, Professors","672","528","144","0","0","0","68","61","7","16","8","8","15","10","5","0","0","0","568","445","123","0","0","0","2","2","0","3","2","1","-2"
"147767","Northwestern University","2011","Total full-time Instruction/research/public service, Tenured, Associate professors","278","190","88","0","0","0","36","24","12","17","11","6","12","10","2","0","0","0","206","142","64","2","0","2","3","1","2","2","2","0","-2"
"147767","Northwestern University","2011","Total full-time Instruction/research/public service, Tenured, Assistant professors","1","1","0","0","0","0","0","0","0","0","0","0","0","0","0","0","0","0","1","1","0","0","0","0","0","0","0","0","0","0","-2"
"147767","Northwestern University","2011","Total full-time Instruction/research/public service, Tenured total","951","719","232","0","0","0","104","85","19","33","19","14","27","20","7","0","0","0","775","588","187","2","0","2","5","3","2","5","4","1","-2"
"147767","Northwestern University","2011","Total full-time Instruction/research/public service, Non-tenured on tenure track, Associate professors","29","23","6","0","0","0","12","9","3","0","0","0","0","0","0","0","0","0","17","14","3","0","0","0","0","0","0","0","0","0","-2"
"147767","Northwestern University","2011","Total full-time Instruction/research/public service, Non-tenured on tenure track, Assistant professors","274","170","104","0","0","0","47","31","16","15","8","7","13","7","6","0","0","0","163","98","65","2","1","1","1","0","1","33","25","8","-2"
"147767","Northwestern University","2011","Total full-time Instruction/research/public service, Non-tenured on tenure track total","303","193","110","0","0","0","59","40","19","15","8","7","13","7","6","0","0","0","180","112","68","2","1","1","1","0","1","33","25","8","-2"
"147767","Northwestern University","2011","Total full-time Instruction/research/public service, Non-tenured not on tenure track, Professors","130","97","33","1","0","1","12","7","5","4","3","1","2","2","0","0","0","0","111","85","26","0","0","0","0","0","0","0","0","0","-2"
"147767","Northwestern University","2011","Total full-time Instruction/research/public service, Non-tenured not on tenure track, Associate professors","197","119","78","0","0","0","41","26","15","4","2","2","7","3","4","0","0","0","143","86","57","0","0","0","0","0","0","2","2","0","-2"
"147767","Northwestern University","2011","Total full-time Instruction/research/public servicey, Non-tenured not on tenure track, Assistant professors","405","210","195","0","0","0","97","50","47","9","4","5","11","6","5","1","1","0","245","121","124","2","1","1","2","1","1","38","26","12","-2"
"147767","Northwestern University","2011","Total full-time Instruction/research/public service, Non-tenured not on tenure track, Instructors","36","16","20","0","0","0","7","4","3","5","2","3","0","0","0","0","0","0","22","8","14","0","0","0","1","1","0","1","1","0","-2"
"147767","Northwestern University","2011","Total full-time Instruction/research/public service, Non-tenured not on tenure track, Lecturers","269","112","157","0","0","0","23","6","17","7","3","4","6","5","1","0","0","0","212","88","124","0","0","0","7","4","3","14","6","8","-2"
"147767","Northwestern University","2011","Total full-time Instruction/research/public service, Non-tenured not on tenure track total","1037","554","483","1","0","1","180","93","87","29","14","15","26","16","10","1","1","0","733","388","345","2","1","1","10","6","4","55","35","20","-2"
"149772","Western Illinois University","2011","Total full-time Instruction/research/public service, Tenured, Professors","205","138","67","2","2","0","18","16","2","8","5","3","3","2","1","0","0","0","172","112","60","2","1","1","0","0","0","0","0","0","-2"
"149772","Western Illinois University","2011","Total full-time Instruction/research/public service, Tenured, Associate professors","162","97","65","2","0","2","13","5","8","10","6","4","4","0","4","0","0","0","129","84","45","2","2","0","0","0","0","2","0","2","-2"
"149772","Western Illinois University","2011","Total full-time Instruction/research/public service, Tenured, Assistant professors","5","3","2","0","0","0","0","0","0","0","0","0","0","0","0","0","0","0","4","2","2","0","0","0","0","0","0","1","1","0","-2"
"149772","Western Illinois University","2011","Total full-time Instruction/research/public service, Tenured total","372","238","134","4","2","2","31","21","10","18","11","7","7","2","5","0","0","0","305","198","107","4","3","1","0","0","0","3","1","2","-2"
"149772","Western Illinois University","2011","Total full-time Instruction/research/public service, Non-tenured on tenure track, Associate professors","16","12","4","0","0","0","2","2","0","1","0","1","0","0","0","0","0","0","11","8","3","1","1","0","0","0","0","1","1","0","-2"
"149772","Western Illinois University","2011","Total full-time Instruction/research/public service, Non-tenured on tenure track, Assistant professors","138","68","70","0","0","0","20","9","11","10","8","2","4","2","2","0","0","0","85","39","46","0","0","0","1","1","0","18","9","9","-2"
"149772","Western Illinois University","2011","Total full-time Instruction/research/public service, Non-tenured on tenure track total","154","80","74","0","0","0","22","11","11","11","8","3","4","2","2","0","0","0","96","47","49","1","1","0","1","1","0","19","10","9","-2"
"149772","Western Illinois University","2011","Total full-time Instruction/research/public servicey, Non-tenured not on tenure track, Assistant professors","21","8","13","0","0","0","1","0","1","0","0","0","0","0","0","0","0","0","20","8","12","0","0","0","0","0","0","0","0","0","-2"
"149772","Western Illinois University","2011","Total full-time Instruction/research/public service, Non-tenured not on tenure track, Instructors","112","41","71","0","0","0","2","0","2","2","1","1","1","1","0","0","0","0","103","36","67","0","0","0","2","2","0","2","1","1","-2"
"149772","Western Illinois University","2011","Total full-time Instruction/research/public service, Non-tenured not on tenure track, Lecturers","7","1","6","0","0","0","0","0","0","0","0","0","0","0","0","0","0","0","6","1","5","0","0","0","0","0","0","1","0","1","-2"
"149772","Western Illinois University","2011","Total full-time Instruction/research/public service, Non-tenured not on tenure track total","140","50","90","0","0","0","3","0","3","2","1","1","1","1","0","0","0","0","129","45","84","0","0","0","2","2","0","3","1","2","-2"
"150136","Ball State University","2011","Total full-time Instruction/research/public service, Tenured, Professors","221","172","49","0","0","0","20","15","5","2","1","1","3","3","0","0","0","0","193","150","43","3","3","0","0","0","0","0","0","0","-2"
"150136","Ball State University","2011","Total full-time Instruction/research/public service, Tenured, Associate professors","199","105","94","0","0","0","16","9","7","8","3","5","3","2","1","0","0","0","170","90","80","2","1","1","0","0","0","0","0","0","-2"
"150136","Ball State University","2011","Total full-time Instruction/research/public service, Tenured, Assistant professors","38","20","18","0","0","0","0","0","0","1","1","0","0","0","0","0","0","0","37","19","18","0","0","0","0","0","0","0","0","0","-2"
"150136","Ball State University","2011","Total full-time Instruction/research/public service, Tenured, Instructors","1","0","1","0","0","0","0","0","0","1","0","1","0","0","0","0","0","0","0","0","0","0","0","0","0","0","0","0","0","0","-2"
"150136","Ball State University","2011","Total full-time Instruction/research/public service, Tenured total","459","297","162","0","0","0","36","24","12","12","5","7","6","5","1","0","0","0","400","259","141","5","4","1","0","0","0","0","0","0","-2"
"150136","Ball State University","2011","Total full-time Instruction/research/public service, Non-tenured on tenure track, Professors","1","1","0","0","0","0","0","0","0","0","0","0","0","0","0","0","0","0","1","1","0","0","0","0","0","0","0","0","0","0","-2"
"150136","Ball State University","2011","Total full-time Instruction/research/public service, Non-tenured on tenure track, Associate professors","25","15","10","0","0","0","4","2","2","0","0","0","1","1","0","0","0","0","20","12","8","0","0","0","0","0","0","0","0","0","-2"
"150136","Ball State University","2011","Total full-time Instruction/research/public service, Non-tenured on tenure track, Assistant professors","168","86","82","0","0","0","29","18","11","3","0","3","4","2","2","0","0","0","130","65","65","1","1","0","1","0","1","0","0","0","-2"
"150136","Ball State University","2011","Total full-time Instruction/research/public service, Non-tenured on tenure track total","194","102","92","0","0","0","33","20","13","3","0","3","5","3","2","0","0","0","151","78","73","1","1","0","1","0","1","0","0","0","-2"
"150136","Ball State University","2011","Total full-time Instruction/research/public service, Non-tenured not on tenure track, Professors","1","1","0","0","0","0","0","0","0","0","0","0","0","0","0","0","0","0","1","1","0","0","0","0","0","0","0","0","0","0","-2"
"150136","Ball State University","2011","Total full-time Instruction/research/public service, Non-tenured not on tenure track, Associate professors","7","6","1","0","0","0","0","0","0","0","0","0","1","0","1","0","0","0","6","6","0","0","0","0","0","0","0","0","0","0","-2"
"150136","Ball State University","2011","Total full-time Instruction/research/public servicey, Non-tenured not on tenure track, Assistant professors","113","56","57","0","0","0","4","1","3","5","2","3","8","5","3","0","0","0","89","43","46","3","1","2","4","4","0","0","0","0","-2"
"150136","Ball State University","2011","Total full-time Instruction/research/public service, Non-tenured not on tenure track, Instructors","184","62","122","0","0","0","5","2","3","1","0","1","3","1","2","0","0","0","168","56","112","4","2","2","3","1","2","0","0","0","-2"
"150136","Ball State University","2011","Total full-time Instruction/research/public service, Non-tenured not on tenure track total","305","125","180","0","0","0","9","3","6","6","2","4","12","6","6","0","0","0","264","106","158","7","3","4","7","5","2","0","0","0","-2"
"151351","Indiana University-Bloomington","2011","Total full-time Instruction/research/public service, Tenured, Professors","644","481","163","0","0","0","33","26","7","17","8","9","19","14","5","0","0","0","571","429","142","3","3","0","1","1","0","0","0","0","-2"
"151351","Indiana University-Bloomington","2011","Total full-time Instruction/research/public service, Tenured, Associate professors","353","217","136","1","1","0","35","22","13","15","10","5","20","12","8","0","0","0","280","170","110","2","2","0","0","0","0","0","0","0","-2"
"151351","Indiana University-Bloomington","2011","Total full-time Instruction/research/public service, Tenured total","997","698","299","1","1","0","68","48","20","32","18","14","39","26","13","0","0","0","851","599","252","5","5","0","1","1","0","0","0","0","-2"
"151351","Indiana University-Bloomington","2011","Total full-time Instruction/research/public service, Non-tenured on tenure track, Professors","2","2","0","0","0","0","0","0","0","0","0","0","0","0","0","0","0","0","2","2","0","0","0","0","0","0","0","0","0","0","-2"
"151351","Indiana University-Bloomington","2011","Total full-time Instruction/research/public service, Non-tenured on tenure track, Associate professors","68","43","25","0","0","0","5","4","1","6","4","2","1","1","0","0","0","0","56","34","22","0","0","0","0","0","0","0","0","0","-2"
"151351","Indiana University-Bloomington","2011","Total full-time Instruction/research/public service, Non-tenured on tenure track, Assistant professors","289","157","132","2","0","2","52","24","28","19","9","10","10","7","3","1","1","0","199","113","86","6","3","3","0","0","0","0","0","0","-2"
"151351","Indiana University-Bloomington","2011","Total full-time Instruction/research/public service, Non-tenured on tenure track total","359","202","157","2","0","2","57","28","29","25","13","12","11","8","3","1","1","0","257","149","108","6","3","3","0","0","0","0","0","0","-2"
"151351","Indiana University-Bloomington","2011","Total full-time Instruction/research/public service, Non-tenured not on tenure track, Professors","34","24","10","0","0","0","3","0","3","3","2","1","1","1","0","0","0","0","27","21","6","0","0","0","0","0","0","0","0","0","-2"
"151351","Indiana University-Bloomington","2011","Total full-time Instruction/research/public service, Non-tenured not on tenure track, Associate professors","51","26","25","0","0","0","3","1","2","2","1","1","1","1","0","0","0","0","45","23","22","0","0","0","0","0","0","0","0","0","-2"
"151351","Indiana University-Bloomington","2011","Total full-time Instruction/research/public servicey, Non-tenured not on tenure track, Assistant professors","93","44","49","0","0","0","7","5","2","1","1","0","1","0","1","0","0","0","82","36","46","2","2","0","0","0","0","0","0","0","-2"
"151351","Indiana University-Bloomington","2011","Total full-time Instruction/research/public service, Non-tenured not on tenure track, Lecturers","345","157","188","2","1","1","23","8","15","16","10","6","22","12","10","0","0","0","280","126","154","2","0","2","0","0","0","0","0","0","-2"
"151351","Indiana University-Bloomington","2011","Total full-time Instruction/research/public service, Non-tenured not on tenure track, No academic rank","534","310","224","4","4","0","118","85","33","11","4","7","17","9","8","0","0","0","379","206","173","5","2","3","0","0","0","0","0","0","-2"
"151351","Indiana University-Bloomington","2011","Total full-time Instruction/research/public service, Non-tenured not on tenure track total","1057","561","496","6","5","1","154","99","55","33","18","15","42","23","19","0","0","0","813","412","401","9","4","5","0","0","0","0","0","0","-2"
"152600","Valparaiso University","2011","Total full-time Instruction/research/public service, Tenured, Professors","62","46","16","1","1","0","2","2","0","0","0","0","1","1","0","0","0","0","58","42","16","0","0","0","0","0","0","0","0","0","-2"
"152600","Valparaiso University","2011","Total full-time Instruction/research/public service, Tenured, Associate professors","82","50","32","0","0","0","3","3","0","2","2","0","1","0","1","0","0","0","73","44","29","0","0","0","1","0","1","2","1","1","-2"
"152600","Valparaiso University","2011","Total full-time Instruction/research/public service, Tenured, Assistant professors","13","8","5","0","0","0","0","0","0","1","0","1","0","0","0","0","0","0","12","8","4","0","0","0","0","0","0","0","0","0","-2"
"152600","Valparaiso University","2011","Total full-time Instruction/research/public service, Tenured total","157","104","53","1","1","0","5","5","0","3","2","1","2","1","1","0","0","0","143","94","49","0","0","0","1","0","1","2","1","1","-2"
"152600","Valparaiso University","2011","Total full-time Instruction/research/public service, Non-tenured on tenure track, Associate professors","5","3","2","0","0","0","0","0","0","1","0","1","0","0","0","0","0","0","4","3","1","0","0","0","0","0","0","0","0","0","-2"
"152600","Valparaiso University","2011","Total full-time Instruction/research/public service, Non-tenured on tenure track, Assistant professors","53","26","27","0","0","0","1","0","1","4","3","1","0","0","0","0","0","0","33","14","19","0","0","0","12","6","6","3","3","0","-2"
"152600","Valparaiso University","2011","Total full-time Instruction/research/public service, Non-tenured on tenure track, Instructors","3","1","2","0","0","0","1","1","0","0","0","0","0","0","0","0","0","0","1","0","1","0","0","0","1","0","1","0","0","0","-2"
"152600","Valparaiso University","2011","Total full-time Instruction/research/public service, Non-tenured on tenure track total","61","30","31","0","0","0","2","1","1","5","3","2","0","0","0","0","0","0","38","17","21","0","0","0","13","6","7","3","3","0","-2"
"152600","Valparaiso University","2011","Total full-time Instruction/research/public service, Non-tenured not on tenure track, Professors","7","4","3","0","0","0","0","0","0","0","0","0","0","0","0","0","0","0","5","3","2","0","0","0","2","1","1","0","0","0","-2"
"152600","Valparaiso University","2011","Total full-time Instruction/research/public servicey, Non-tenured not on tenure track, Assistant professors","19","7","12","0","0","0","0","0","0","0","0","0","0","0","0","0","0","0","8","3","5","0","0","0","10","3","7","1","1","0","-2"
"152600","Valparaiso University","2011","Total full-time Instruction/research/public service, Non-tenured not on tenure track, Instructors","4","1","3","0","0","0","0","0","0","0","0","0","0","0","0","0","0","0","2","0","2","0","0","0","2","1","1","0","0","0","-2"
"152600","Valparaiso University","2011","Total full-time Instruction/research/public service, Non-tenured not on tenure track, Lecturers","12","6","6","0","0","0","1","0","1","0","0","0","0","0","0","0","0","0","7","3","4","0","0","0","3","2","1","1","1","0","-2"
"152600","Valparaiso University","2011","Total full-time Instruction/research/public service, Non-tenured not on tenure track total","42","18","24","0","0","0","1","0","1","0","0","0","0","0","0","0","0","0","22","9","13","0","0","0","17","7","10","2","2","0","-2"
"153603","Iowa State University","2011","Total full-time Instruction/research/public service, Tenured, Professors","487","400","87","2","2","0","66","59","7","6","5","1","9","7","2","0","0","0","403","326","77","0","0","0","0","0","0","1","1","0","-2"
"153603","Iowa State University","2011","Total full-time Instruction/research/public service, Tenured, Associate professors","374","250","124","3","3","0","70","58","12","9","6","3","5","3","2","0","0","0","284","177","107","1","1","0","0","0","0","2","2","0","-2"
"153603","Iowa State University","2011","Total full-time Instruction/research/public service, Tenured, Assistant professors","5","4","1","0","0","0","0","0","0","0","0","0","0","0","0","0","0","0","5","4","1","0","0","0","0","0","0","0","0","0","-2"
"153603","Iowa State University","2011","Total full-time Instruction/research/public service, Tenured total","866","654","212","5","5","0","136","117","19","15","11","4","14","10","4","0","0","0","692","507","185","1","1","0","0","0","0","3","3","0","-2"
"153603","Iowa State University","2011","Total full-time Instruction/research/public service, Non-tenured on tenure track, Associate professors","6","2","4","0","0","0","0","0","0","0","0","0","0","0","0","0","0","0","6","2","4","0","0","0","0","0","0","0","0","0","-2"
"153603","Iowa State University","2011","Total full-time Instruction/research/public service, Non-tenured on tenure track, Assistant professors","271","164","107","0","0","0","44","31","13","8","3","5","11","5","6","1","1","0","170","101","69","2","1","1","0","0","0","35","22","13","-2"
"153603","Iowa State University","2011","Total full-time Instruction/research/public service, Non-tenured on tenure track total","277","166","111","0","0","0","44","31","13","8","3","5","11","5","6","1","1","0","176","103","73","2","1","1","0","0","0","35","22","13","-2"
"153603","Iowa State University","2011","Total full-time Instruction/research/public service, Non-tenured not on tenure track, Professors","10","7","3","0","0","0","2","2","0","0","0","0","0","0","0","0","0","0","8","5","3","0","0","0","0","0","0","0","0","0","-2"
"153603","Iowa State University","2011","Total full-time Instruction/research/public service, Non-tenured not on tenure track, Associate professors","11","10","1","0","0","0","1","1","0","0","0","0","0","0","0","0","0","0","9","8","1","0","0","0","0","0","0","1","1","0","-2"
"153603","Iowa State University","2011","Total full-time Instruction/research/public servicey, Non-tenured not on tenure track, Assistant professors","41","21","20","0","0","0","5","1","4","1","0","1","1","1","0","0","0","0","27","15","12","0","0","0","0","0","0","7","4","3","-2"
"153603","Iowa State University","2011","Total full-time Instruction/research/public service, Non-tenured not on tenure track, Instructors","29","5","24","0","0","0","1","0","1","1","0","1","2","0","2","0","0","0","20","2","18","0","0","0","0","0","0","5","3","2","-2"
"153603","Iowa State University","2011","Total full-time Instruction/research/public service, Non-tenured not on tenure track, Lecturers","189","87","102","1","0","1","13","8","5","4","2","2","7","2","5","0","0","0","157","70","87","1","0","1","0","0","0","6","5","1","-2"
"153603","Iowa State University","2011","Total full-time Instruction/research/public service, Non-tenured not on tenure track total","280","130","150","1","0","1","22","12","10","6","2","4","10","3","7","0","0","0","221","100","121","1","0","1","0","0","0","19","13","6","-2"
"153658","University of Iowa","2011","Total full-time Instruction/research/public service, Tenured, Professors","647","507","140","1","1","0","49","43","6","10","7","3","13","6","7","0","0","0","560","438","122","3","2","1","11","10","1","0","0","0","-2"
"153658","University of Iowa","2011","Total full-time Instruction/research/public service, Tenured, Associate professors","430","270","160","3","0","3","48","36","12","10","3","7","17","9","8","0","0","0","344","216","128","4","2","2","3","3","0","1","1","0","-2"
"153658","University of Iowa","2011","Total full-time Instruction/research/public service, Tenured total","1077","777","300","4","1","3","97","79","18","20","10","10","30","15","15","0","0","0","904","654","250","7","4","3","14","13","1","1","1","0","-2"
"153658","University of Iowa","2011","Total full-time Instruction/research/public service, Non-tenured on tenure track, Professors","1","1","0","0","0","0","0","0","0","0","0","0","0","0","0","0","0","0","1","1","0","0","0","0","0","0","0","0","0","0","-2"
"153658","University of Iowa","2011","Total full-time Instruction/research/public service, Non-tenured on tenure track, Associate professors","19","10","9","0","0","0","2","2","0","1","0","1","0","0","0","0","0","0","13","6","7","0","0","0","3","2","1","0","0","0","-2"
"153658","University of Iowa","2011","Total full-time Instruction/research/public service, Non-tenured on tenure track, Assistant professors","332","179","153","3","0","3","43","27","16","16","7","9","18","14","4","0","0","0","206","102","104","5","4","1","6","2","4","35","23","12","-2"
"153658","University of Iowa","2011","Total full-time Instruction/research/public service, Non-tenured on tenure track total","352","190","162","3","0","3","45","29","16","17","7","10","18","14","4","0","0","0","220","109","111","5","4","1","9","4","5","35","23","12","-2"
"153658","University of Iowa","2011","Total full-time Instruction/research/public service, Non-tenured not on tenure track, Professors","92","65","27","0","0","0","4","2","2","2","2","0","1","1","0","0","0","0","82","57","25","0","0","0","2","2","0","1","1","0","-2"
"153658","University of Iowa","2011","Total full-time Instruction/research/public service, Non-tenured not on tenure track, Associate professors","151","88","63","1","1","0","15","13","2","3","2","1","4","4","0","0","0","0","121","63","58","0","0","0","3","2","1","4","3","1","-2"
"153658","University of Iowa","2011","Total full-time Instruction/research/public servicey, Non-tenured not on tenure track, Assistant professors","283","151","132","0","0","0","26","14","12","9","3","6","12","8","4","0","0","0","183","89","94","2","1","1","15","9","6","36","27","9","-2"
"153658","University of Iowa","2011","Total full-time Instruction/research/public service, Non-tenured not on tenure track, Instructors","8","3","5","0","0","0","0","0","0","0","0","0","1","0","1","0","0","0","5","2","3","0","0","0","1","0","1","1","1","0","-2"
"153658","University of Iowa","2011","Total full-time Instruction/research/public service, Non-tenured not on tenure track, Lecturers","128","53","75","2","0","2","3","1","2","1","1","0","2","0","2","0","0","0","108","49","59","1","0","1","3","0","3","8","2","6","-2"
"153658","University of Iowa","2011","Total full-time Instruction/research/public service, Non-tenured not on tenure track, No academic rank","68","43","25","0","0","0","11","6","5","1","1","0","1","1","0","0","0","0","26","12","14","0","0","0","9","6","3","20","17","3","-2"
"153658","University of Iowa","2011","Total full-time Instruction/research/public service, Non-tenured not on tenure track total","730","403","327","3","1","2","59","36","23","16","9","7","21","14","7","0","0","0","525","272","253","3","1","2","33","19","14","70","51","19","-2"
"155317","University of Kansas","2011","Total full-time Instruction/research/public service, Tenured, Professors","544","424","120","2","1","1","44","38","6","11","6","5","14","12","2","0","0","0","469","364","105","0","0","0","4","3","1","0","0","0","-2"
"155317","University of Kansas","2011","Total full-time Instruction/research/public service, Tenured, Associate professors","477","292","185","1","1","0","56","41","15","18","13","5","19","10","9","0","0","0","368","221","147","7","1","6","6","3","3","2","2","0","-2"
"155317","University of Kansas","2011","Total full-time Instruction/research/public service, Tenured, Assistant professors","2","0","2","0","0","0","0","0","0","0","0","0","0","0","0","0","0","0","2","0","2","0","0","0","0","0","0","0","0","0","-2"
"155317","University of Kansas","2011","Total full-time Instruction/research/public service, Tenured total","1023","716","307","3","2","1","100","79","21","29","19","10","33","22","11","0","0","0","839","585","254","7","1","6","10","6","4","2","2","0","-2"
"155317","University of Kansas","2011","Total full-time Instruction/research/public service, Non-tenured on tenure track, Professors","2","2","0","0","0","0","2","2","0","0","0","0","0","0","0","0","0","0","0","0","0","0","0","0","0","0","0","0","0","0","-2"
"155317","University of Kansas","2011","Total full-time Instruction/research/public service, Non-tenured on tenure track, Associate professors","24","16","8","1","1","0","3","2","1","0","0","0","1","1","0","0","0","0","17","11","6","1","0","1","0","0","0","1","1","0","-2"
"155317","University of Kansas","2011","Total full-time Instruction/research/public service, Non-tenured on tenure track, Assistant professors","287","160","127","3","1","2","47","28","19","10","4","6","9","4","5","0","0","0","180","105","75","2","1","1","2","1","1","34","16","18","-2"
"155317","University of Kansas","2011","Total full-time Instruction/research/public service, Non-tenured on tenure track total","313","178","135","4","2","2","52","32","20","10","4","6","10","5","5","0","0","0","197","116","81","3","1","2","2","1","1","35","17","18","-2"
"155317","University of Kansas","2011","Total full-time Instruction/research/public service, Non-tenured not on tenure track, Professors","52","33","19","1","1","0","2","2","0","0","0","0","1","0","1","0","0","0","47","30","17","1","0","1","0","0","0","0","0","0","-2"
"155317","University of Kansas","2011","Total full-time Instruction/research/public service, Non-tenured not on tenure track, Associate professors","102","58","44","2","1","1","16","10","6","0","0","0","2","1","1","0","0","0","78","42","36","0","0","0","2","2","0","2","2","0","-2"
"155317","University of Kansas","2011","Total full-time Instruction/research/public servicey, Non-tenured not on tenure track, Assistant professors","386","203","183","1","0","1","47","26","21","12","6","6","8","4","4","0","0","0","270","133","137","3","2","1","3","2","1","42","30","12","-2"
"155317","University of Kansas","2011","Total full-time Instruction/research/public service, Non-tenured not on tenure track, Instructors","64","21","43","0","0","0","6","4","2","3","1","2","2","2","0","0","0","0","47","12","35","1","0","1","0","0","0","5","2","3","-2"
"155317","University of Kansas","2011","Total full-time Instruction/research/public service, Non-tenured not on tenure track, Lecturers","106","42","64","0","0","0","4","0","4","2","1","1","3","3","0","0","0","0","95","37","58","0","0","0","0","0","0","2","1","1","-2"
"155317","University of Kansas","2011","Total full-time Instruction/research/public service, Non-tenured not on tenure track, No academic rank","40","22","18","0","0","0","4","3","1","1","0","1","0","0","0","0","0","0","28","13","15","0","0","0","0","0","0","7","6","1","-2"
"155317","University of Kansas","2011","Total full-time Instruction/research/public service, Non-tenured not on tenure track total","750","379","371","4","2","2","79","45","34","18","8","10","16","10","6","0","0","0","565","267","298","5","2","3","5","4","1","58","41","17","-2"
"157447","Northern Kentucky University","2011","Total full-time Instruction/research/public service, Tenured, Professors","87","55","32","0","0","0","5","2","3","4","3","1","0","0","0","0","0","0","77","49","28","0","0","0","1","1","0","0","0","0","-2"
"157447","Northern Kentucky University","2011","Total full-time Instruction/research/public service, Tenured, Associate professors","157","85","72","0","0","0","6","3","3","8","6","2","2","2","0","0","0","0","140","73","67","0","0","0","0","0","0","1","1","0","-2"
"157447","Northern Kentucky University","2011","Total full-time Instruction/research/public service, Tenured, Assistant professors","1","1","0","0","0","0","0","0","0","0","0","0","0","0","0","0","0","0","1","1","0","0","0","0","0","0","0","0","0","0","-2"
"157447","Northern Kentucky University","2011","Total full-time Instruction/research/public service, Tenured total","245","141","104","0","0","0","11","5","6","12","9","3","2","2","0","0","0","0","218","123","95","0","0","0","1","1","0","1","1","0","-2"
"157447","Northern Kentucky University","2011","Total full-time Instruction/research/public service, Non-tenured on tenure track, Associate professors","2","1","1","0","0","0","0","0","0","0","0","0","0","0","0","0","0","0","2","1","1","0","0","0","0","0","0","0","0","0","-2"
"157447","Northern Kentucky University","2011","Total full-time Instruction/research/public service, Non-tenured on tenure track, Assistant professors","124","48","76","1","1","0","8","5","3","6","2","4","2","1","1","0","0","0","97","34","63","2","0","2","3","2","1","5","3","2","-2"
"157447","Northern Kentucky University","2011","Total full-time Instruction/research/public service, Non-tenured on tenure track total","126","49","77","1","1","0","8","5","3","6","2","4","2","1","1","0","0","0","99","35","64","2","0","2","3","2","1","5","3","2","-2"
"157447","Northern Kentucky University","2011","Total full-time Instruction/research/public service, Non-tenured not on tenure track, Professors","3","3","0","0","0","0","0","0","0","0","0","0","0","0","0","0","0","0","3","3","0","0","0","0","0","0","0","0","0","0","-2"
"157447","Northern Kentucky University","2011","Total full-time Instruction/research/public servicey, Non-tenured not on tenure track, Assistant professors","4","1","3","0","0","0","0","0","0","2","0","2","0","0","0","0","0","0","2","1","1","0","0","0","0","0","0","0","0","0","-2"
"157447","Northern Kentucky University","2011","Total full-time Instruction/research/public service, Non-tenured not on tenure track, Instructors","3","2","1","0","0","0","0","0","0","0","0","0","0","0","0","0","0","0","3","2","1","0","0","0","0","0","0","0","0","0","-2"
"157447","Northern Kentucky University","2011","Total full-time Instruction/research/public service, Non-tenured not on tenure track, Lecturers","166","69","97","1","1","0","4","2","2","4","1","3","1","0","1","0","0","0","148","64","84","2","0","2","5","1","4","1","0","1","-2"
"157447","Northern Kentucky University","2011","Total full-time Instruction/research/public service, Non-tenured not on tenure track total","176","75","101","1","1","0","4","2","2","6","1","5","1","0","1","0","0","0","156","70","86","2","0","2","5","1","4","1","0","1","-2"
"157951","Western Kentucky University","2011","Total full-time Instruction/research/public service, Tenured, Professors","158","109","49","2","2","0","11","10","1","5","2","3","1","1","0","0","0","0","134","90","44","4","3","1","1","1","0","0","0","0","-2"
"157951","Western Kentucky University","2011","Total full-time Instruction/research/public service, Tenured, Associate professors","201","117","84","2","1","1","11","10","1","15","8","7","5","4","1","0","0","0","163","91","72","2","2","0","3","1","2","0","0","0","-2"
"157951","Western Kentucky University","2011","Total full-time Instruction/research/public service, Tenured, Assistant professors","23","9","14","0","0","0","0","0","0","0","0","0","0","0","0","0","0","0","23","9","14","0","0","0","0","0","0","0","0","0","-2"
"157951","Western Kentucky University","2011","Total full-time Instruction/research/public service, Tenured total","382","235","147","4","3","1","22","20","2","20","10","10","6","5","1","0","0","0","320","190","130","6","5","1","4","2","2","0","0","0","-2"
"157951","Western Kentucky University","2011","Total full-time Instruction/research/public service, Non-tenured on tenure track, Professors","1","0","1","0","0","0","0","0","0","0","0","0","0","0","0","0","0","0","1","0","1","0","0","0","0","0","0","0","0","0","-2"
"157951","Western Kentucky University","2011","Total full-time Instruction/research/public service, Non-tenured on tenure track, Associate professors","10","8","2","0","0","0","0","0","0","1","0","1","0","0","0","0","0","0","9","8","1","0","0","0","0","0","0","0","0","0","-2"
"157951","Western Kentucky University","2011","Total full-time Instruction/research/public service, Non-tenured on tenure track, Assistant professors","182","80","102","1","0","1","29","13","16","14","5","9","3","2","1","0","0","0","130","56","74","4","3","1","1","1","0","0","0","0","-2"
"157951","Western Kentucky University","2011","Total full-time Instruction/research/public service, Non-tenured on tenure track total","193","88","105","1","0","1","29","13","16","15","5","10","3","2","1","0","0","0","140","64","76","4","3","1","1","1","0","0","0","0","-2"
"157951","Western Kentucky University","2011","Total full-time Instruction/research/public service, Non-tenured not on tenure track, Professors","1","1","0","0","0","0","0","0","0","0","0","0","0","0","0","0","0","0","1","1","0","0","0","0","0","0","0","0","0","0","-2"
"157951","Western Kentucky University","2011","Total full-time Instruction/research/public servicey, Non-tenured not on tenure track, Assistant professors","18","9","9","0","0","0","1","0","1","1","0","1","0","0","0","0","0","0","16","9","7","0","0","0","0","0","0","0","0","0","-2"
"157951","Western Kentucky University","2011","Total full-time Instruction/research/public service, Non-tenured not on tenure track, Instructors","157","52","105","1","1","0","6","1","5","5","2","3","6","6","0","0","0","0","137","41","96","2","1","1","0","0","0","0","0","0","-2"
"157951","Western Kentucky University","2011","Total full-time Instruction/research/public service, Non-tenured not on tenure track, No academic rank","20","11","9","0","0","0","1","1","0","2","1","1","0","0","0","0","0","0","16","9","7","1","0","1","0","0","0","0","0","0","-2"
"157951","Western Kentucky University","2011","Total full-time Instruction/research/public service, Non-tenured not on tenure track total","196","73","123","1","1","0","8","2","6","8","3","5","6","6","0","0","0","0","170","60","110","3","1","2","0","0","0","0","0","0","-2"
"159993","University of Louisiana at Monroe","2011","Total full-time Instruction/research/public service, Tenured, Professors","55","37","18","0","0","0","3","2","1","2","0","2","0","0","0","0","0","0","49","35","14","0","0","0","1","0","1","0","0","0","-2"
"159993","University of Louisiana at Monroe","2011","Total full-time Instruction/research/public service, Tenured, Associate professors","72","41","31","0","0","0","1","0","1","4","3","1","2","1","1","0","0","0","65","37","28","0","0","0","0","0","0","0","0","0","-2"
"159993","University of Louisiana at Monroe","2011","Total full-time Instruction/research/public service, Tenured, Assistant professors","17","3","14","0","0","0","0","0","0","0","0","0","0","0","0","0","0","0","17","3","14","0","0","0","0","0","0","0","0","0","-2"
"159993","University of Louisiana at Monroe","2011","Total full-time Instruction/research/public service, Tenured, No academic rank","1","1","0","0","0","0","0","0","0","0","0","0","0","0","0","0","0","0","1","1","0","0","0","0","0","0","0","0","0","0","-2"
"159993","University of Louisiana at Monroe","2011","Total full-time Instruction/research/public service, Tenured total","145","82","63","0","0","0","4","2","2","6","3","3","2","1","1","0","0","0","132","76","56","0","0","0","1","0","1","0","0","0","-2"
"159993","University of Louisiana at Monroe","2011","Total full-time Instruction/research/public service, Non-tenured on tenure track, Professors","2","1","1","0","0","0","0","0","0","0","0","0","0","0","0","0","0","0","2","1","1","0","0","0","0","0","0","0","0","0","-2"
"159993","University of Louisiana at Monroe","2011","Total full-time Instruction/research/public service, Non-tenured on tenure track, Associate professors","19","9","10","0","0","0","0","0","0","2","0","2","0","0","0","0","0","0","17","9","8","0","0","0","0","0","0","0","0","0","-2"
"159993","University of Louisiana at Monroe","2011","Total full-time Instruction/research/public service, Non-tenured on tenure track, Assistant professors","83","39","44","0","0","0","6","6","0","5","1","4","3","0","3","0","0","0","68","31","37","0","0","0","1","1","0","0","0","0","-2"
"159993","University of Louisiana at Monroe","2011","Total full-time Instruction/research/public service, Non-tenured on tenure track, Instructors","1","0","1","0","0","0","0","0","0","0","0","0","0","0","0","0","0","0","1","0","1","0","0","0","0","0","0","0","0","0","-2"
"159993","University of Louisiana at Monroe","2011","Total full-time Instruction/research/public service, Non-tenured on tenure track total","105","49","56","0","0","0","6","6","0","7","1","6","3","0","3","0","0","0","88","41","47","0","0","0","1","1","0","0","0","0","-2"
"159993","University of Louisiana at Monroe","2011","Total full-time Instruction/research/public service, Non-tenured not on tenure track, Associate professors","5","1","4","0","0","0","0","0","0","1","0","1","0","0","0","0","0","0","4","1","3","0","0","0","0","0","0","0","0","0","-2"
"159993","University of Louisiana at Monroe","2011","Total full-time Instruction/research/public servicey, Non-tenured not on tenure track, Assistant professors","28","9","19","0","0","0","0","0","0","2","1","1","0","0","0","0","0","0","26","8","18","0","0","0","0","0","0","0","0","0","-2"
"159993","University of Louisiana at Monroe","2011","Total full-time Instruction/research/public service, Non-tenured not on tenure track, Instructors","53","21","32","1","1","0","0","0","0","2","0","2","2","0","2","0","0","0","48","20","28","0","0","0","0","0","0","0","0","0","-2"
"159993","University of Louisiana at Monroe","2011","Total full-time Instruction/research/public service, Non-tenured not on tenure track total","86","31","55","1","1","0","0","0","0","5","1","4","2","0","2","0","0","0","78","29","49","0","0","0","0","0","0","0","0","0","-2"
"160755","Tulane University of Louisiana","2011","Total full-time Instruction/research/public service, Tenured, Professors","248","205","43","1","1","0","23","22","1","5","4","1","8","8","0","0","0","0","208","168","40","1","0","1","1","1","0","1","1","0","-2"
"160755","Tulane University of Louisiana","2011","Total full-time Instruction/research/public service, Tenured, Associate professors","158","95","63","0","0","0","16","12","4","7","0","7","4","3","1","0","0","0","129","79","50","1","0","1","1","1","0","0","0","0","-2"
"160755","Tulane University of Louisiana","2011","Total full-time Instruction/research/public service, Tenured, Assistant professors","1","1","0","0","0","0","0","0","0","0","0","0","0","0","0","0","0","0","1","1","0","0","0","0","0","0","0","0","0","0","-2"
"160755","Tulane University of Louisiana","2011","Total full-time Instruction/research/public service, Tenured total","407","301","106","1","1","0","39","34","5","12","4","8","12","11","1","0","0","0","338","248","90","2","0","2","2","2","0","1","1","0","-2"
"160755","Tulane University of Louisiana","2011","Total full-time Instruction/research/public service, Non-tenured on tenure track, Professors","1","1","0","0","0","0","0","0","0","0","0","0","0","0","0","0","0","0","1","1","0","0","0","0","0","0","0","0","0","0","-2"
"160755","Tulane University of Louisiana","2011","Total full-time Instruction/research/public service, Non-tenured on tenure track, Associate professors","19","11","8","0","0","0","4","2","2","1","1","0","0","0","0","0","0","0","12","7","5","1","0","1","0","0","0","1","1","0","-2"
"160755","Tulane University of Louisiana","2011","Total full-time Instruction/research/public service, Non-tenured on tenure track, Assistant professors","150","82","68","0","0","0","29","16","13","8","1","7","8","4","4","0","0","0","87","48","39","1","1","0","0","0","0","17","12","5","-2"
"160755","Tulane University of Louisiana","2011","Total full-time Instruction/research/public service, Non-tenured on tenure track total","170","94","76","0","0","0","33","18","15","9","2","7","8","4","4","0","0","0","100","56","44","2","1","1","0","0","0","18","13","5","-2"
"160755","Tulane University of Louisiana","2011","Total full-time Instruction/research/public service, Non-tenured not on tenure track, Professors","32","23","9","0","0","0","1","1","0","1","1","0","1","1","0","0","0","0","29","20","9","0","0","0","0","0","0","0","0","0","-2"
"160755","Tulane University of Louisiana","2011","Total full-time Instruction/research/public service, Non-tenured not on tenure track, Associate professors","68","44","24","0","0","0","10","8","2","5","3","2","6","3","3","0","0","0","44","29","15","0","0","0","0","0","0","3","1","2","-2"
"160755","Tulane University of Louisiana","2011","Total full-time Instruction/research/public servicey, Non-tenured not on tenure track, Assistant professors","174","97","77","1","1","0","20","11","9","20","6","14","11","6","5","0","0","0","101","59","42","2","1","1","3","3","0","16","10","6","-2"
"160755","Tulane University of Louisiana","2011","Total full-time Instruction/research/public service, Non-tenured not on tenure track, Instructors","33","11","22","0","0","0","1","0","1","4","0","4","4","2","2","0","0","0","24","9","15","0","0","0","0","0","0","0","0","0","-2"
"160755","Tulane University of Louisiana","2011","Total full-time Instruction/research/public service, Non-tenured not on tenure track, Lecturers","9","6","3","0","0","0","0","0","0","1","1","0","2","1","1","0","0","0","5","3","2","0","0","0","0","0","0","1","1","0","-2"
"160755","Tulane University of Louisiana","2011","Total full-time Instruction/research/public service, Non-tenured not on tenure track, No academic rank","241","121","120","1","1","0","39","20","19","5","3","2","11","6","5","0","0","0","166","79","87","2","2","0","2","2","0","15","8","7","-2"
"160755","Tulane University of Louisiana","2011","Total full-time Instruction/research/public service, Non-tenured not on tenure track total","557","302","255","2","2","0","71","40","31","36","14","22","35","19","16","0","0","0","369","199","170","4","3","1","5","5","0","35","20","15","-2"
"162928","Johns Hopkins University","2011","Total full-time Instruction/research/public service, Tenured, Professors","891","698","193","1","1","0","74","60","14","19","14","5","21","19","2","0","0","0","772","601","171","0","0","0","0","0","0","4","3","1","-2"
"162928","Johns Hopkins University","2011","Total full-time Instruction/research/public service, Tenured, Associate professors","72","60","12","0","0","0","9","9","0","2","1","1","1","1","0","0","0","0","56","46","10","0","0","0","0","0","0","4","3","1","-2"
"162928","Johns Hopkins University","2011","Total full-time Instruction/research/public service, Tenured, Assistant professors","3","0","3","0","0","0","0","0","0","0","0","0","0","0","0","0","0","0","3","0","3","0","0","0","0","0","0","0","0","0","-2"
"162928","Johns Hopkins University","2011","Total full-time Instruction/research/public service, Tenured, Instructors","3","2","1","0","0","0","0","0","0","2","1","1","0","0","0","0","0","0","0","0","0","0","0","0","0","0","0","1","1","0","-2"
"162928","Johns Hopkins University","2011","Total full-time Instruction/research/public service, Tenured, No academic rank","1","1","0","0","0","0","0","0","0","0","0","0","0","0","0","0","0","0","1","1","0","0","0","0","0","0","0","0","0","0","-2"
"162928","Johns Hopkins University","2011","Total full-time Instruction/research/public service, Tenured total","970","761","209","1","1","0","83","69","14","23","16","7","22","20","2","0","0","0","832","648","184","0","0","0","0","0","0","9","7","2","-2"
"162928","Johns Hopkins University","2011","Total full-time Instruction/research/public service, Non-tenured on tenure track, Professors","20","17","3","0","0","0","5","4","1","0","0","0","2","2","0","0","0","0","13","11","2","0","0","0","0","0","0","0","0","0","-2"
"162928","Johns Hopkins University","2011","Total full-time Instruction/research/public service, Non-tenured on tenure track, Associate professors","521","341","180","0","0","0","87","53","34","17","8","9","10","9","1","0","0","0","400","266","134","0","0","0","0","0","0","7","5","2","-2"
"162928","Johns Hopkins University","2011","Total full-time Instruction/research/public service, Non-tenured on tenure track, Assistant professors","1045","574","471","2","1","1","199","126","73","62","24","38","30","16","14","4","3","1","681","359","322","0","0","0","0","0","0","67","45","22","-2"
"162928","Johns Hopkins University","2011","Total full-time Instruction/research/public service, Non-tenured on tenure track, Instructors","195","111","84","5","3","2","40","26","14","14","5","9","5","3","2","1","1","0","112","62","50","0","0","0","0","0","0","18","11","7","-2"
"162928","Johns Hopkins University","2011","Total full-time Instruction/research/public service, Non-tenured on tenure track, No academic rank","15","6","9","0","0","0","2","2","0","0","0","0","0","0","0","0","0","0","11","4","7","0","0","0","0","0","0","2","0","2","-2"
"162928","Johns Hopkins University","2011","Total full-time Instruction/research/public service, Non-tenured on tenure track total","1796","1049","747","7","4","3","333","211","122","93","37","56","47","30","17","5","4","1","1217","702","515","0","0","0","0","0","0","94","61","33","-2"
"162928","Johns Hopkins University","2011","Total full-time Instruction/research/public service, Non-tenured not on tenure track, Professors","43","31","12","0","0","0","4","2","2","2","0","2","0","0","0","0","0","0","34","26","8","0","0","0","0","0","0","3","3","0","-2"
"162928","Johns Hopkins University","2011","Total full-time Instruction/research/public service, Non-tenured not on tenure track, Associate professors","57","25","32","0","0","0","9","6","3","3","2","1","0","0","0","0","0","0","43","16","27","0","0","0","0","0","0","2","1","1","-2"
"162928","Johns Hopkins University","2011","Total full-time Instruction/research/public servicey, Non-tenured not on tenure track, Assistant professors","58","26","32","1","1","0","4","4","0","5","1","4","0","0","0","0","0","0","41","14","27","0","0","0","0","0","0","7","6","1","-2"
"162928","Johns Hopkins University","2011","Total full-time Instruction/research/public service, Non-tenured not on tenure track, Instructors","96","32","64","0","0","0","5","1","4","8","4","4","3","1","2","0","0","0","79","25","54","0","0","0","0","0","0","1","1","0","-2"
"162928","Johns Hopkins University","2011","Total full-time Instruction/research/public service, Non-tenured not on tenure track, Lecturers","149","57","92","0","0","0","13","3","10","4","2","2","5","1","4","0","0","0","118","47","71","0","0","0","0","0","0","9","4","5","-2"
"162928","Johns Hopkins University","2011","Total full-time Instruction/research/public service, Non-tenured not on tenure track, No academic rank","816","403","413","3","1","2","169","94","75","30","15","15","15","7","8","0","0","0","469","213","256","0","0","0","0","0","0","130","73","57","-2"
"162928","Johns Hopkins University","2011","Total full-time Instruction/research/public service, Non-tenured not on tenure track total","1219","574","645","4","2","2","204","110","94","52","24","28","23","9","14","0","0","0","784","341","443","0","0","0","0","0","0","152","88","64","-2"
"163268","University of Maryland-Baltimore County","2011","Total full-time Instruction/research/public service, Tenured, Professors","139","110","29","0","0","0","21","20","1","4","3","1","1","1","0","1","1","0","112","85","27","0","0","0","0","0","0","0","0","0","-2"
"163268","University of Maryland-Baltimore County","2011","Total full-time Instruction/research/public service, Tenured, Associate professors","147","83","64","0","0","0","18","8","10","12","7","5","5","2","3","0","0","0","110","65","45","0","0","0","0","0","0","2","1","1","-2"
"163268","University of Maryland-Baltimore County","2011","Total full-time Instruction/research/public service, Tenured, Assistant professors","1","1","0","0","0","0","1","1","0","0","0","0","0","0","0","0","0","0","0","0","0","0","0","0","0","0","0","0","0","0","-2"
"163268","University of Maryland-Baltimore County","2011","Total full-time Instruction/research/public service, Tenured total","287","194","93","0","0","0","40","29","11","16","10","6","6","3","3","1","1","0","222","150","72","0","0","0","0","0","0","2","1","1","-2"
"163268","University of Maryland-Baltimore County","2011","Total full-time Instruction/research/public service, Non-tenured on tenure track, Professors","2","1","1","0","0","0","0","0","0","0","0","0","0","0","0","0","0","0","1","0","1","0","0","0","0","0","0","1","1","0","-2"
"163268","University of Maryland-Baltimore County","2011","Total full-time Instruction/research/public service, Non-tenured on tenure track, Associate professors","4","2","2","0","0","0","0","0","0","0","0","0","0","0","0","0","0","0","4","2","2","0","0","0","0","0","0","0","0","0","-2"
"163268","University of Maryland-Baltimore County","2011","Total full-time Instruction/research/public service, Non-tenured on tenure track, Assistant professors","76","25","51","1","1","0","12","4","8","4","2","2","5","0","5","1","0","1","42","12","30","1","0","1","0","0","0","10","6","4","-2"
"163268","University of Maryland-Baltimore County","2011","Total full-time Instruction/research/public service, Non-tenured on tenure track, No academic rank","1","1","0","0","0","0","0","0","0","0","0","0","0","0","0","0","0","0","0","0","0","0","0","0","0","0","0","1","1","0","-2"
"163268","University of Maryland-Baltimore County","2011","Total full-time Instruction/research/public service, Non-tenured on tenure track total","83","29","54","1","1","0","12","4","8","4","2","2","5","0","5","1","0","1","47","14","33","1","0","1","0","0","0","12","8","4","-2"
"163268","University of Maryland-Baltimore County","2011","Total full-time Instruction/research/public service, Non-tenured not on tenure track, Professors","15","11","4","0","0","0","1","1","0","0","0","0","0","0","0","0","0","0","13","9","4","0","0","0","0","0","0","1","1","0","-2"
"163268","University of Maryland-Baltimore County","2011","Total full-time Instruction/research/public service, Non-tenured not on tenure track, Associate professors","40","27","13","0","0","0","10","5","5","1","1","0","0","0","0","0","0","0","23","17","6","0","0","0","0","0","0","6","4","2","-2"
"163268","University of Maryland-Baltimore County","2011","Total full-time Instruction/research/public servicey, Non-tenured not on tenure track, Assistant professors","56","33","23","0","0","0","8","5","3","3","1","2","1","1","0","0","0","0","24","13","11","0","0","0","0","0","0","20","13","7","-2"
"163268","University of Maryland-Baltimore County","2011","Total full-time Instruction/research/public service, Non-tenured not on tenure track, Instructors","12","4","8","0","0","0","0","0","0","2","1","1","0","0","0","0","0","0","10","3","7","0","0","0","0","0","0","0","0","0","-2"
"163268","University of Maryland-Baltimore County","2011","Total full-time Instruction/research/public service, Non-tenured not on tenure track, Lecturers","80","34","46","0","0","0","3","1","2","4","1","3","1","0","1","0","0","0","69","30","39","0","0","0","0","0","0","3","2","1","-2"
"163268","University of Maryland-Baltimore County","2011","Total full-time Instruction/research/public service, Non-tenured not on tenure track, No academic rank","86","43","43","0","0","0","9","3","6","3","1","2","2","1","1","0","0","0","41","21","20","1","1","0","0","0","0","30","16","14","-2"
"163268","University of Maryland-Baltimore County","2011","Total full-time Instruction/research/public service, Non-tenured not on tenure track total","289","152","137","0","0","0","31","15","16","13","5","8","4","2","2","0","0","0","180","93","87","1","1","0","0","0","0","60","36","24","-2"
"163286","University of Maryland-College Park","2011","Total full-time Instruction/research/public service, Tenured, Professors","662","519","143","0","0","0","68","54","14","17","11","6","19","12","7","0","0","0","538","426","112","1","1","0","16","12","4","3","3","0","-2"
"163286","University of Maryland-College Park","2011","Total full-time Instruction/research/public service, Tenured, Associate professors","459","298","161","2","2","0","71","51","20","25","9","16","18","8","10","0","0","0","325","213","112","2","1","1","12","11","1","4","3","1","-2"
"163286","University of Maryland-College Park","2011","Total full-time Instruction/research/public service, Tenured, Assistant professors","2","2","0","0","0","0","0","0","0","0","0","0","0","0","0","0","0","0","2","2","0","0","0","0","0","0","0","0","0","0","-2"
"163286","University of Maryland-College Park","2011","Total full-time Instruction/research/public service, Tenured total","1123","819","304","2","2","0","139","105","34","42","20","22","37","20","17","0","0","0","865","641","224","3","2","1","28","23","5","7","6","1","-2"
"163286","University of Maryland-College Park","2011","Total full-time Instruction/research/public service, Non-tenured on tenure track, Associate professors","5","4","1","0","0","0","1","1","0","1","1","0","0","0","0","0","0","0","3","2","1","0","0","0","0","0","0","0","0","0","-2"
"163286","University of Maryland-College Park","2011","Total full-time Instruction/research/public service, Non-tenured on tenure track, Assistant professors","342","189","153","0","0","0","56","29","27","31","18","13","20","11","9","0","0","0","168","89","79","2","1","1","29","16","13","36","25","11","-2"
"163286","University of Maryland-College Park","2011","Total full-time Instruction/research/public service, Non-tenured on tenure track total","347","193","154","0","0","0","57","30","27","32","19","13","20","11","9","0","0","0","171","91","80","2","1","1","29","16","13","36","25","11","-2"
"163286","University of Maryland-College Park","2011","Total full-time Instruction/research/public service, Non-tenured not on tenure track, Professors","62","50","12","0","0","0","9","8","1","1","0","1","2","2","0","0","0","0","46","36","10","1","1","0","2","2","0","1","1","0","-2"
"163286","University of Maryland-College Park","2011","Total full-time Instruction/research/public service, Non-tenured not on tenure track, Associate professors","68","56","12","0","0","0","13","12","1","0","0","0","1","1","0","0","0","0","50","39","11","0","0","0","2","2","0","2","2","0","-2"
"163286","University of Maryland-College Park","2011","Total full-time Instruction/research/public servicey, Non-tenured not on tenure track, Assistant professors","47","32","15","0","0","0","15","11","4","0","0","0","2","1","1","0","0","0","22","12","10","0","0","0","1","1","0","7","7","0","-2"
"163286","University of Maryland-College Park","2011","Total full-time Instruction/research/public service, Non-tenured not on tenure track, Instructors","51","12","39","0","0","0","2","0","2","7","3","4","1","0","1","0","0","0","37","8","29","0","0","0","4","1","3","0","0","0","-2"
"163286","University of Maryland-College Park","2011","Total full-time Instruction/research/public service, Non-tenured not on tenure track, Lecturers","282","123","159","0","0","0","17","5","12","12","3","9","18","11","7","0","0","0","205","93","112","1","0","1","15","5","10","14","6","8","-2"
"163286","University of Maryland-College Park","2011","Total full-time Instruction/research/public service, Non-tenured not on tenure track, No academic rank","1220","768","452","3","2","1","137","84","53","40","13","27","30","13","17","4","2","2","562","332","230","3","1","2","63","39","24","378","282","96","-2"
"163286","University of Maryland-College Park","2011","Total full-time Instruction/research/public service, Non-tenured not on tenure track total","1730","1041","689","3","2","1","193","120","73","60","19","41","54","28","26","4","2","2","922","520","402","5","2","3","87","50","37","402","298","104","-2"
"163338","University of Maryland Eastern Shore","2011","Total full-time Instruction/research/public service, Tenured, Professors","27","20","7","0","0","0","6","4","2","12","10","2","0","0","0","0","0","0","9","6","3","0","0","0","0","0","0","0","0","0","-2"
"163338","University of Maryland Eastern Shore","2011","Total full-time Instruction/research/public service, Tenured, Associate professors","40","19","21","0","0","0","5","1","4","12","5","7","1","1","0","0","0","0","21","12","9","0","0","0","1","0","1","0","0","0","-2"
"163338","University of Maryland Eastern Shore","2011","Total full-time Instruction/research/public service, Tenured, Assistant professors","6","3","3","0","0","0","0","0","0","4","1","3","0","0","0","0","0","0","2","2","0","0","0","0","0","0","0","0","0","0","-2"
"163338","University of Maryland Eastern Shore","2011","Total full-time Instruction/research/public service, Tenured total","73","42","31","0","0","0","11","5","6","28","16","12","1","1","0","0","0","0","32","20","12","0","0","0","1","0","1","0","0","0","-2"
"163338","University of Maryland Eastern Shore","2011","Total full-time Instruction/research/public service, Non-tenured on tenure track, Professors","3","1","2","0","0","0","0","0","0","2","0","2","0","0","0","0","0","0","1","1","0","0","0","0","0","0","0","0","0","0","-2"
"163338","University of Maryland Eastern Shore","2011","Total full-time Instruction/research/public service, Non-tenured on tenure track, Associate professors","17","13","4","1","1","0","4","2","2","9","8","1","0","0","0","0","0","0","2","1","1","1","1","0","0","0","0","0","0","0","-2"
"163338","University of Maryland Eastern Shore","2011","Total full-time Instruction/research/public service, Non-tenured on tenure track, Assistant professors","46","32","14","1","0","1","6","6","0","12","7","5","1","1","0","0","0","0","16","10","6","2","1","1","1","1","0","7","6","1","-2"
"163338","University of Maryland Eastern Shore","2011","Total full-time Instruction/research/public service, Non-tenured on tenure track, Instructors","2","2","0","0","0","0","0","0","0","1","1","0","0","0","0","0","0","0","0","0","0","0","0","0","0","0","0","1","1","0","-2"
"163338","University of Maryland Eastern Shore","2011","Total full-time Instruction/research/public service, Non-tenured on tenure track, No academic rank","1","0","1","0","0","0","0","0","0","1","0","1","0","0","0","0","0","0","0","0","0","0","0","0","0","0","0","0","0","0","-2"
"163338","University of Maryland Eastern Shore","2011","Total full-time Instruction/research/public service, Non-tenured on tenure track total","69","48","21","2","1","1","10","8","2","25","16","9","1","1","0","0","0","0","19","12","7","3","2","1","1","1","0","8","7","1","-2"
"163338","University of Maryland Eastern Shore","2011","Total full-time Instruction/research/public service, Non-tenured not on tenure track, Associate professors","2","1","1","0","0","0","0","0","0","1","0","1","0","0","0","0","0","0","1","1","0","0","0","0","0","0","0","0","0","0","-2"
"163338","University of Maryland Eastern Shore","2011","Total full-time Instruction/research/public servicey, Non-tenured not on tenure track, Assistant professors","7","2","5","0","0","0","0","0","0","3","1","2","1","0","1","0","0","0","2","1","1","0","0","0","0","0","0","1","0","1","-2"
"163338","University of Maryland Eastern Shore","2011","Total full-time Instruction/research/public service, Non-tenured not on tenure track, Instructors","2","2","0","0","0","0","0","0","0","1","1","0","0","0","0","0","0","0","1","1","0","0","0","0","0","0","0","0","0","0","-2"
"163338","University of Maryland Eastern Shore","2011","Total full-time Instruction/research/public service, Non-tenured not on tenure track, Lecturers","57","22","35","1","0","1","5","5","0","22","9","13","3","1","2","0","0","0","25","7","18","0","0","0","0","0","0","1","0","1","-2"
"163338","University of Maryland Eastern Shore","2011","Total full-time Instruction/research/public service, Non-tenured not on tenure track, No academic rank","5","5","0","0","0","0","0","0","0","2","2","0","0","0","0","0","0","0","2","2","0","0","0","0","0","0","0","1","1","0","-2"
"163338","University of Maryland Eastern Shore","2011","Total full-time Instruction/research/public service, Non-tenured not on tenure track total","73","32","41","1","0","1","5","5","0","29","13","16","4","1","3","0","0","0","31","12","19","0","0","0","0","0","0","3","1","2","-2"
"163851","Salisbury University","2011","Total full-time Instruction/research/public service, Tenured, Professors","97","69","28","0","0","0","5","3","2","3","2","1","0","0","0","0","0","0","89","64","25","0","0","0","0","0","0","0","0","0","-2"
"163851","Salisbury University","2011","Total full-time Instruction/research/public service, Tenured, Associate professors","104","58","46","0","0","0","9","5","4","7","5","2","2","2","0","0","0","0","85","46","39","0","0","0","1","0","1","0","0","0","-2"
"163851","Salisbury University","2011","Total full-time Instruction/research/public service, Tenured, Assistant professors","19","9","10","0","0","0","1","1","0","3","1","2","0","0","0","0","0","0","15","7","8","0","0","0","0","0","0","0","0","0","-2"
"163851","Salisbury University","2011","Total full-time Instruction/research/public service, Tenured total","220","136","84","0","0","0","15","9","6","13","8","5","2","2","0","0","0","0","189","117","72","0","0","0","1","0","1","0","0","0","-2"
"163851","Salisbury University","2011","Total full-time Instruction/research/public service, Non-tenured on tenure track, Assistant professors","77","40","37","0","0","0","3","1","2","6","5","1","1","1","0","0","0","0","59","30","29","0","0","0","1","1","0","7","2","5","-2"
"163851","Salisbury University","2011","Total full-time Instruction/research/public service, Non-tenured on tenure track, Instructors","5","2","3","0","0","0","0","0","0","1","1","0","1","0","1","0","0","0","3","1","2","0","0","0","0","0","0","0","0","0","-2"
"163851","Salisbury University","2011","Total full-time Instruction/research/public service, Non-tenured on tenure track total","82","42","40","0","0","0","3","1","2","7","6","1","2","1","1","0","0","0","62","31","31","0","0","0","1","1","0","7","2","5","-2"
"163851","Salisbury University","2011","Total full-time Instruction/research/public servicey, Non-tenured not on tenure track, Assistant professors","3","1","2","0","0","0","0","0","0","0","0","0","0","0","0","0","0","0","2","1","1","0","0","0","1","0","1","0","0","0","-2"
"163851","Salisbury University","2011","Total full-time Instruction/research/public service, Non-tenured not on tenure track, Lecturers","85","31","54","0","0","0","4","2","2","3","2","1","2","1","1","0","0","0","76","26","50","0","0","0","0","0","0","0","0","0","-2"
"163851","Salisbury University","2011","Total full-time Instruction/research/public service, Non-tenured not on tenure track, No academic rank","11","4","7","0","0","0","1","0","1","0","0","0","0","0","0","0","0","0","10","4","6","0","0","0","0","0","0","0","0","0","-2"
"163851","Salisbury University","2011","Total full-time Instruction/research/public service, Non-tenured not on tenure track total","99","36","63","0","0","0","5","2","3","3","2","1","2","1","1","0","0","0","88","31","57","0","0","0","1","0","1","0","0","0","-2"
"164155","United States Naval Academy","2011","Total full-time Instruction/research/public service, Tenured, Professors","121","86","35","0","0","0","4","3","1","1","1","0","3","0","3","0","0","0","113","82","31","0","0","0","0","0","0","0","0","0","-2"
"164155","United States Naval Academy","2011","Total full-time Instruction/research/public service, Tenured, Associate professors","106","73","33","0","0","0","3","0","3","4","3","1","2","0","2","0","0","0","97","70","27","0","0","0","0","0","0","0","0","0","-2"
"164155","United States Naval Academy","2011","Total full-time Instruction/research/public service, Tenured, Assistant professors","3","3","0","0","0","0","1","1","0","0","0","0","0","0","0","0","0","0","2","2","0","0","0","0","0","0","0","0","0","0","-2"
"164155","United States Naval Academy","2011","Total full-time Instruction/research/public service, Tenured, No academic rank","1","1","0","0","0","0","0","0","0","0","0","0","0","0","0","0","0","0","1","1","0","0","0","0","0","0","0","0","0","0","-2"
"164155","United States Naval Academy","2011","Total full-time Instruction/research/public service, Tenured total","231","163","68","0","0","0","8","4","4","5","4","1","5","0","5","0","0","0","213","155","58","0","0","0","0","0","0","0","0","0","-2"
"164155","United States Naval Academy","2011","Total full-time Instruction/research/public service, Non-tenured on tenure track, Associate professors","4","4","0","0","0","0","1","1","0","0","0","0","0","0","0","0","0","0","3","3","0","0","0","0","0","0","0","0","0","0","-2"
"164155","United States Naval Academy","2011","Total full-time Instruction/research/public service, Non-tenured on tenure track, Assistant professors","67","43","24","0","0","0","8","4","4","5","1","4","2","1","1","0","0","0","52","37","15","0","0","0","0","0","0","0","0","0","-2"
"164155","United States Naval Academy","2011","Total full-time Instruction/research/public service, Non-tenured on tenure track total","71","47","24","0","0","0","9","5","4","5","1","4","2","1","1","0","0","0","55","40","15","0","0","0","0","0","0","0","0","0","-2"
"164155","United States Naval Academy","2011","Total full-time Instruction/research/public service, Non-tenured not on tenure track, Professors","2","2","0","0","0","0","0","0","0","0","0","0","0","0","0","0","0","0","2","2","0","0","0","0","0","0","0","0","0","0","-2"
"164155","United States Naval Academy","2011","Total full-time Instruction/research/public servicey, Non-tenured not on tenure track, Assistant professors","3","2","1","0","0","0","0","0","0","0","0","0","0","0","0","0","0","0","3","2","1","0","0","0","0","0","0","0","0","0","-2"
"164155","United States Naval Academy","2011","Total full-time Instruction/research/public service, Non-tenured not on tenure track, Instructors","4","2","2","0","0","0","0","0","0","0","0","0","0","0","0","0","0","0","4","2","2","0","0","0","0","0","0","0","0","0","-2"
"164155","United States Naval Academy","2011","Total full-time Instruction/research/public service, Non-tenured not on tenure track, No academic rank","27","20","7","0","0","0","2","0","2","0","0","0","0","0","0","0","0","0","25","20","5","0","0","0","0","0","0","0","0","0","-2"
"164155","United States Naval Academy","2011","Total full-time Instruction/research/public service, Non-tenured not on tenure track total","36","26","10","0","0","0","2","0","2","0","0","0","0","0","0","0","0","0","34","26","8","0","0","0","0","0","0","0","0","0","-2"
"166027","Harvard University","2011","Total full-time Instruction/research/public service, Tenured, Professors","1034","818","216","0","0","0","89","72","17","32","21","11","23","19","4","0","0","0","872","693","179","7","4","3","4","4","0","7","5","2","-2"
"166027","Harvard University","2011","Total full-time Instruction/research/public service, Tenured total","1034","818","216","0","0","0","89","72","17","32","21","11","23","19","4","0","0","0","872","693","179","7","4","3","4","4","0","7","5","2","-2"
"166027","Harvard University","2011","Total full-time Instruction/research/public service, Non-tenured on tenure track, Associate professors","221","138","83","0","0","0","30","15","15","8","3","5","13","8","5","0","0","0","161","108","53","3","1","2","1","0","1","5","3","2","-2"
"166027","Harvard University","2011","Total full-time Instruction/research/public service, Non-tenured on tenure track, Assistant professors","262","170","92","0","0","0","49","33","16","7","3","4","12","7","5","0","0","0","160","108","52","5","3","2","1","1","0","28","15","13","-2"
"166027","Harvard University","2011","Total full-time Instruction/research/public service, Non-tenured on tenure track total","483","308","175","0","0","0","79","48","31","15","6","9","25","15","10","0","0","0","321","216","105","8","4","4","2","1","1","33","18","15","-2"
"166027","Harvard University","2011","Total full-time Instruction/research/public service, Non-tenured not on tenure track, Professors","80","62","18","0","0","0","3","2","1","6","5","1","4","2","2","0","0","0","63","49","14","2","2","0","0","0","0","2","2","0","-2"
"166027","Harvard University","2011","Total full-time Instruction/research/public service, Non-tenured not on tenure track, Associate professors","2","1","1","0","0","0","0","0","0","0","0","0","0","0","0","0","0","0","2","1","1","0","0","0","0","0","0","0","0","0","-2"
"166027","Harvard University","2011","Total full-time Instruction/research/public servicey, Non-tenured not on tenure track, Assistant professors","6","4","2","0","0","0","1","1","0","0","0","0","1","1","0","0","0","0","4","2","2","0","0","0","0","0","0","0","0","0","-2"
"166027","Harvard University","2011","Total full-time Instruction/research/public service, Non-tenured not on tenure track, Instructors","186","87","99","0","0","0","40","21","19","3","0","3","10","5","5","0","0","0","107","49","58","2","0","2","2","0","2","22","12","10","-2"
"166027","Harvard University","2011","Total full-time Instruction/research/public service, Non-tenured not on tenure track, Lecturers","197","110","87","0","0","0","13","6","7","5","2","3","3","2","1","0","0","0","158","88","70","3","0","3","1","1","0","14","11","3","-2"
"166027","Harvard University","2011","Total full-time Instruction/research/public service, Non-tenured not on tenure track, No academic rank","75","44","31","1","1","0","9","5","4","0","0","0","3","3","0","0","0","0","51","28","23","0","0","0","1","1","0","10","6","4","-2"
"166027","Harvard University","2011","Total full-time Instruction/research/public service, Non-tenured not on tenure track total","546","308","238","1","1","0","66","35","31","14","7","7","21","13","8","0","0","0","385","217","168","7","2","5","4","2","2","48","31","17","-2"
"166513","University of Massachusetts-Lowell","2011","Total full-time Instruction/research/public service, Tenured, Professors","179","138","41","0","0","0","29","24","5","3","1","2","2","1","1","0","0","0","144","111","33","0","0","0","1","1","0","0","0","0","-2"
"166513","University of Massachusetts-Lowell","2011","Total full-time Instruction/research/public service, Tenured, Associate professors","111","63","48","1","1","0","17","11","6","2","2","0","3","2","1","0","0","0","85","45","40","0","0","0","0","0","0","3","2","1","-2"
"166513","University of Massachusetts-Lowell","2011","Total full-time Instruction/research/public service, Tenured total","290","201","89","1","1","0","46","35","11","5","3","2","5","3","2","0","0","0","229","156","73","0","0","0","1","1","0","3","2","1","-2"
"166513","University of Massachusetts-Lowell","2011","Total full-time Instruction/research/public service, Non-tenured on tenure track, Professors","1","1","0","0","0","0","0","0","0","0","0","0","0","0","0","0","0","0","1","1","0","0","0","0","0","0","0","0","0","0","-2"
"166513","University of Massachusetts-Lowell","2011","Total full-time Instruction/research/public service, Non-tenured on tenure track, Associate professors","12","7","5","0","0","0","4","3","1","0","0","0","2","2","0","0","0","0","6","2","4","0","0","0","0","0","0","0","0","0","-2"
"166513","University of Massachusetts-Lowell","2011","Total full-time Instruction/research/public service, Non-tenured on tenure track, Assistant professors","94","47","47","0","0","0","19","12","7","2","1","1","2","1","1","0","0","0","58","29","29","0","0","0","3","0","3","10","4","6","-2"
"166513","University of Massachusetts-Lowell","2011","Total full-time Instruction/research/public service, Non-tenured on tenure track total","107","55","52","0","0","0","23","15","8","2","1","1","4","3","1","0","0","0","65","32","33","0","0","0","3","0","3","10","4","6","-2"
"166513","University of Massachusetts-Lowell","2011","Total full-time Instruction/research/public service, Non-tenured not on tenure track, Professors","6","4","2","0","0","0","4","3","1","0","0","0","0","0","0","0","0","0","2","1","1","0","0","0","0","0","0","0","0","0","-2"
"166513","University of Massachusetts-Lowell","2011","Total full-time Instruction/research/public service, Non-tenured not on tenure track, Associate professors","1","1","0","0","0","0","0","0","0","0","0","0","0","0","0","0","0","0","1","1","0","0","0","0","0","0","0","0","0","0","-2"
"166513","University of Massachusetts-Lowell","2011","Total full-time Instruction/research/public servicey, Non-tenured not on tenure track, Assistant professors","11","1","10","0","0","0","0","0","0","0","0","0","0","0","0","0","0","0","9","1","8","0","0","0","2","0","2","0","0","0","-2"
"166513","University of Massachusetts-Lowell","2011","Total full-time Instruction/research/public service, Non-tenured not on tenure track, Lecturers","51","26","25","0","0","0","1","1","0","1","1","0","1","1","0","0","0","0","43","20","23","0","0","0","2","1","1","3","2","1","-2"
"166513","University of Massachusetts-Lowell","2011","Total full-time Instruction/research/public service, Non-tenured not on tenure track, No academic rank","18","5","13","0","0","0","2","1","1","0","0","0","0","0","0","0","0","0","14","3","11","0","0","0","2","1","1","0","0","0","-2"
"166513","University of Massachusetts-Lowell","2011","Total full-time Instruction/research/public service, Non-tenured not on tenure track total","87","37","50","0","0","0","7","5","2","1","1","0","1","1","0","0","0","0","69","26","43","0","0","0","6","2","4","3","2","1","-2"
"166629","University of Massachusetts-Amherst","2011","Total full-time Instruction/research/public service, Tenured, Professors","449","332","117","1","1","0","34","30","4","14","8","6","12","8","4","0","0","0","376","277","99","3","1","2","9","7","2","0","0","0","-2"
"166629","University of Massachusetts-Amherst","2011","Total full-time Instruction/research/public service, Tenured, Associate professors","273","151","122","2","1","1","34","21","13","7","5","2","14","5","9","0","0","0","205","111","94","4","3","1","6","4","2","1","1","0","-2"
"166629","University of Massachusetts-Amherst","2011","Total full-time Instruction/research/public service, Tenured, Assistant professors","1","0","1","0","0","0","0","0","0","0","0","0","0","0","0","0","0","0","1","0","1","0","0","0","0","0","0","0","0","0","-2"
"166629","University of Massachusetts-Amherst","2011","Total full-time Instruction/research/public service, Tenured total","723","483","240","3","2","1","68","51","17","21","13","8","26","13","13","0","0","0","582","388","194","7","4","3","15","11","4","1","1","0","-2"
"166629","University of Massachusetts-Amherst","2011","Total full-time Instruction/research/public service, Non-tenured on tenure track, Professors","5","2","3","0","0","0","0","0","0","1","1","0","0","0","0","0","0","0","4","1","3","0","0","0","0","0","0","0","0","0","-2"
"166629","University of Massachusetts-Amherst","2011","Total full-time Instruction/research/public service, Non-tenured on tenure track, Associate professors","8","5","3","0","0","0","1","0","1","0","0","0","0","0","0","0","0","0","4","2","2","0","0","0","1","1","0","2","2","0","-2"
"166629","University of Massachusetts-Amherst","2011","Total full-time Instruction/research/public service, Non-tenured on tenure track, Assistant professors","251","132","119","1","0","1","28","15","13","21","7","14","18","12","6","0","0","0","139","75","64","1","1","0","13","6","7","30","16","14","-2"
"166629","University of Massachusetts-Amherst","2011","Total full-time Instruction/research/public service, Non-tenured on tenure track, Instructors","2","0","2","0","0","0","0","0","0","0","0","0","0","0","0","0","0","0","2","0","2","0","0","0","0","0","0","0","0","0","-2"
"166629","University of Massachusetts-Amherst","2011","Total full-time Instruction/research/public service, Non-tenured on tenure track total","266","139","127","1","0","1","29","15","14","22","8","14","18","12","6","0","0","0","149","78","71","1","1","0","14","7","7","32","18","14","-2"
"166629","University of Massachusetts-Amherst","2011","Total full-time Instruction/research/public service, Non-tenured not on tenure track, Professors","6","5","1","0","0","0","0","0","0","0","0","0","0","0","0","0","0","0","5","4","1","0","0","0","0","0","0","1","1","0","-2"
"166629","University of Massachusetts-Amherst","2011","Total full-time Instruction/research/public service, Non-tenured not on tenure track, Associate professors","13","8","5","0","0","0","1","1","0","0","0","0","1","0","1","0","0","0","11","7","4","0","0","0","0","0","0","0","0","0","-2"
"166629","University of Massachusetts-Amherst","2011","Total full-time Instruction/research/public servicey, Non-tenured not on tenure track, Assistant professors","34","13","21","0","0","0","2","1","1","2","1","1","1","0","1","0","0","0","26","10","16","0","0","0","2","0","2","1","1","0","-2"
"166629","University of Massachusetts-Amherst","2011","Total full-time Instruction/research/public service, Non-tenured not on tenure track, Lecturers","231","122","109","3","0","3","7","4","3","9","5","4","4","1","3","0","0","0","181","96","85","3","2","1","7","6","1","17","8","9","-2"
"166629","University of Massachusetts-Amherst","2011","Total full-time Instruction/research/public service, Non-tenured not on tenure track total","284","148","136","3","0","3","10","6","4","11","6","5","6","1","5","0","0","0","223","117","106","3","2","1","9","6","3","19","10","9","-2"
"166683","Massachusetts Institute of Technology","2011","Total full-time Instruction/research/public service, Tenured, Professors","610","511","99","0","0","0","60","54","6","11","9","2","9","9","0","0","0","0","506","419","87","1","1","0","22","19","3","1","0","1","-2"
"166683","Massachusetts Institute of Technology","2011","Total full-time Instruction/research/public service, Tenured, Associate professors","134","97","37","0","0","0","21","13","8","7","6","1","4","4","0","0","0","0","88","66","22","4","2","2","5","3","2","5","3","2","-2"
"166683","Massachusetts Institute of Technology","2011","Total full-time Instruction/research/public service, Tenured total","744","608","136","0","0","0","81","67","14","18","15","3","13","13","0","0","0","0","594","485","109","5","3","2","27","22","5","6","3","3","-2"
"166683","Massachusetts Institute of Technology","2011","Total full-time Instruction/research/public service, Non-tenured on tenure track, Associate professors","65","50","15","0","0","0","9","4","5","5","2","3","5","5","0","0","0","0","34","29","5","3","3","0","5","4","1","4","3","1","-2"
"166683","Massachusetts Institute of Technology","2011","Total full-time Instruction/research/public service, Non-tenured on tenure track, Assistant professors","159","104","55","1","0","1","18","11","7","5","2","3","9","8","1","0","0","0","65","43","22","2","2","0","30","17","13","29","21","8","-2"
"166683","Massachusetts Institute of Technology","2011","Total full-time Instruction/research/public service, Non-tenured on tenure track total","224","154","70","1","0","1","27","15","12","10","4","6","14","13","1","0","0","0","99","72","27","5","5","0","35","21","14","33","24","9","-2"
"166683","Massachusetts Institute of Technology","2011","Total full-time Instruction/research/public service, Non-tenured not on tenure track, Professors","1","1","0","0","0","0","0","0","0","0","0","0","0","0","0","0","0","0","1","1","0","0","0","0","0","0","0","0","0","0","-2"
"166683","Massachusetts Institute of Technology","2011","Total full-time Instruction/research/public service, Non-tenured not on tenure track, Associate professors","8","4","4","0","0","0","1","0","1","1","1","0","0","0","0","0","0","0","6","3","3","0","0","0","0","0","0","0","0","0","-2"
"166683","Massachusetts Institute of Technology","2011","Total full-time Instruction/research/public servicey, Non-tenured not on tenure track, Assistant professors","1","1","0","0","0","0","0","0","0","0","0","0","0","0","0","0","0","0","1","1","0","0","0","0","0","0","0","0","0","0","-2"
"166683","Massachusetts Institute of Technology","2011","Total full-time Instruction/research/public service, Non-tenured not on tenure track total","10","6","4","0","0","0","1","0","1","1","1","0","0","0","0","0","0","0","8","5","3","0","0","0","0","0","0","0","0","0","-2"
"169248","Central Michigan University","2011","Total full-time Instruction/research/public service, Tenured, Professors","262","184","78","1","1","0","31","22","9","12","6","6","6","4","2","0","0","0","212","151","61","0","0","0","0","0","0","0","0","0","-2"
"169248","Central Michigan University","2011","Total full-time Instruction/research/public service, Tenured, Associate professors","133","74","59","1","1","0","9","6","3","3","2","1","7","4","3","0","0","0","112","60","52","0","0","0","0","0","0","1","1","0","-2"
"169248","Central Michigan University","2011","Total full-time Instruction/research/public service, Tenured, Assistant professors","27","14","13","0","0","0","0","0","0","2","2","0","1","1","0","0","0","0","23","10","13","0","0","0","0","0","0","1","1","0","-2"
"169248","Central Michigan University","2011","Total full-time Instruction/research/public service, Tenured total","422","272","150","2","2","0","40","28","12","17","10","7","14","9","5","0","0","0","347","221","126","0","0","0","0","0","0","2","2","0","-2"
"169248","Central Michigan University","2011","Total full-time Instruction/research/public service, Non-tenured on tenure track, Professors","2","2","0","0","0","0","0","0","0","0","0","0","0","0","0","0","0","0","2","2","0","0","0","0","0","0","0","0","0","0","-2"
"169248","Central Michigan University","2011","Total full-time Instruction/research/public service, Non-tenured on tenure track, Associate professors","5","3","2","0","0","0","2","2","0","0","0","0","0","0","0","0","0","0","3","1","2","0","0","0","0","0","0","0","0","0","-2"
"169248","Central Michigan University","2011","Total full-time Instruction/research/public service, Non-tenured on tenure track, Assistant professors","157","83","74","0","0","0","14","5","9","2","0","2","6","3","3","0","0","0","106","60","46","5","3","2","1","0","1","23","12","11","-2"
"169248","Central Michigan University","2011","Total full-time Instruction/research/public service, Non-tenured on tenure track, Instructors","3","1","2","0","0","0","0","0","0","0","0","0","0","0","0","0","0","0","3","1","2","0","0","0","0","0","0","0","0","0","-2"
"169248","Central Michigan University","2011","Total full-time Instruction/research/public service, Non-tenured on tenure track total","167","89","78","0","0","0","16","7","9","2","0","2","6","3","3","0","0","0","114","64","50","5","3","2","1","0","1","23","12","11","-2"
"169248","Central Michigan University","2011","Total full-time Instruction/research/public service, Non-tenured not on tenure track, Professors","2","2","0","0","0","0","1","1","0","0","0","0","0","0","0","0","0","0","1","1","0","0","0","0","0","0","0","0","0","0","-2"
"169248","Central Michigan University","2011","Total full-time Instruction/research/public service, Non-tenured not on tenure track, Associate professors","7","6","1","1","1","0","0","0","0","0","0","0","0","0","0","0","0","0","6","5","1","0","0","0","0","0","0","0","0","0","-2"
"169248","Central Michigan University","2011","Total full-time Instruction/research/public servicey, Non-tenured not on tenure track, Assistant professors","60","41","19","0","0","0","3","3","0","1","0","1","3","1","2","0","0","0","53","37","16","0","0","0","0","0","0","0","0","0","-2"
"169248","Central Michigan University","2011","Total full-time Instruction/research/public service, Non-tenured not on tenure track, Instructors","162","70","92","4","3","1","6","2","4","3","2","1","2","1","1","0","0","0","145","61","84","1","0","1","1","1","0","0","0","0","-2"
"169248","Central Michigan University","2011","Total full-time Instruction/research/public service, Non-tenured not on tenure track total","231","119","112","5","4","1","10","6","4","4","2","2","5","2","3","0","0","0","205","104","101","1","0","1","1","1","0","0","0","0","-2"
"170976","University of Michigan-Ann Arbor","2011","Total full-time Instruction/research/public service, Tenured, Professors","1356","1033","323","5","3","2","142","113","29","57","34","23","41","23","18","1","0","1","1079","838","241","7","4","3","7","6","1","17","12","5","-2"
"170976","University of Michigan-Ann Arbor","2011","Total full-time Instruction/research/public service, Tenured, Associate professors","652","410","242","5","4","1","91","58","33","33","19","14","32","22","10","2","1","1","458","287","171","8","5","3","3","2","1","20","12","8","-2"
"170976","University of Michigan-Ann Arbor","2011","Total full-time Instruction/research/public service, Tenured total","2008","1443","565","10","7","3","233","171","62","90","53","37","73","45","28","3","1","2","1537","1125","412","15","9","6","10","8","2","37","24","13","-2"
"170976","University of Michigan-Ann Arbor","2011","Total full-time Instruction/research/public service, Non-tenured on tenure track, Professors","4","4","0","0","0","0","0","0","0","0","0","0","0","0","0","0","0","0","4","4","0","0","0","0","0","0","0","0","0","0","-2"
"170976","University of Michigan-Ann Arbor","2011","Total full-time Instruction/research/public service, Non-tenured on tenure track, Associate professors","20","16","4","0","0","0","3","3","0","1","1","0","1","1","0","0","0","0","10","7","3","0","0","0","0","0","0","5","4","1","-2"
"170976","University of Michigan-Ann Arbor","2011","Total full-time Instruction/research/public service, Non-tenured on tenure track, Assistant professors","602","374","228","1","0","1","99","71","28","27","16","11","24","16","8","0","0","0","350","209","141","7","5","2","7","5","2","87","52","35","-2"
"170976","University of Michigan-Ann Arbor","2011","Total full-time Instruction/research/public service, Non-tenured on tenure track total","626","394","232","1","0","1","102","74","28","28","17","11","25","17","8","0","0","0","364","220","144","7","5","2","7","5","2","92","56","36","-2"
"170976","University of Michigan-Ann Arbor","2011","Total full-time Instruction/research/public service, Non-tenured not on tenure track, Professors","157","117","40","0","0","0","4","3","1","1","1","0","4","3","1","0","0","0","140","105","35","0","0","0","0","0","0","8","5","3","-2"
"170976","University of Michigan-Ann Arbor","2011","Total full-time Instruction/research/public service, Non-tenured not on tenure track, Associate professors","211","132","79","0","0","0","40","26","14","3","1","2","11","7","4","0","0","0","148","93","55","3","2","1","1","0","1","5","3","2","-2"
"170976","University of Michigan-Ann Arbor","2011","Total full-time Instruction/research/public servicey, Non-tenured not on tenure track, Assistant professors","579","327","252","1","1","0","115","66","49","17","7","10","9","4","5","0","0","0","367","205","162","10","4","6","12","7","5","48","33","15","-2"
"170976","University of Michigan-Ann Arbor","2011","Total full-time Instruction/research/public service, Non-tenured not on tenure track, Instructors","126","57","69","0","0","0","23","10","13","6","3","3","5","0","5","0","0","0","77","33","44","0","0","0","3","3","0","12","8","4","-2"
"170976","University of Michigan-Ann Arbor","2011","Total full-time Instruction/research/public service, Non-tenured not on tenure track, Lecturers","622","281","341","4","2","2","67","24","43","18","9","9","32","12","20","0","0","0","432","195","237","11","4","7","9","6","3","49","29","20","-2"
"170976","University of Michigan-Ann Arbor","2011","Total full-time Instruction/research/public service, Non-tenured not on tenure track, No academic rank","1520","961","559","0","0","0","173","110","63","29","12","17","28","14","14","1","0","1","485","283","202","9","3","6","7","3","4","788","536","252","-2"
"170976","University of Michigan-Ann Arbor","2011","Total full-time Instruction/research/public service, Non-tenured not on tenure track total","3215","1875","1340","5","3","2","422","239","183","74","33","41","89","40","49","1","0","1","1649","914","735","33","13","20","32","19","13","910","614","296","-2"
"171100","Michigan State University","2011","Total full-time Instruction/research/public service, Tenured, Professors","910","697","213","7","7","0","85","69","16","33","24","9","16","12","4","1","1","0","757","575","182","2","1","1","0","0","0","9","8","1","-2"
"171100","Michigan State University","2011","Total full-time Instruction/research/public service, Tenured, Associate professors","527","321","206","6","2","4","74","47","27","25","17","8","18","10","8","0","0","0","394","240","154","2","0","2","0","0","0","8","5","3","-2"
"171100","Michigan State University","2011","Total full-time Instruction/research/public service, Tenured total","1437","1018","419","13","9","4","159","116","43","58","41","17","34","22","12","1","1","0","1151","815","336","4","1","3","0","0","0","17","13","4","-2"
"171100","Michigan State University","2011","Total full-time Instruction/research/public service, Non-tenured on tenure track, Associate professors","19","13","6","0","0","0","4","4","0","1","1","0","0","0","0","0","0","0","13","7","6","1","1","0","0","0","0","0","0","0","-2"
"171100","Michigan State University","2011","Total full-time Instruction/research/public service, Non-tenured on tenure track, Assistant professors","403","220","183","4","4","0","59","37","22","23","9","14","27","13","14","1","1","0","252","132","120","1","0","1","0","0","0","36","24","12","-2"
"171100","Michigan State University","2011","Total full-time Instruction/research/public service, Non-tenured on tenure track total","422","233","189","4","4","0","63","41","22","24","10","14","27","13","14","1","1","0","265","139","126","2","1","1","0","0","0","36","24","12","-2"
"171100","Michigan State University","2011","Total full-time Instruction/research/public service, Non-tenured not on tenure track, Professors","60","49","11","0","0","0","6","4","2","5","4","1","1","1","0","0","0","0","45","37","8","0","0","0","0","0","0","3","3","0","-2"
"171100","Michigan State University","2011","Total full-time Instruction/research/public service, Non-tenured not on tenure track, Associate professors","111","72","39","0","0","0","11","6","5","6","5","1","3","1","2","0","0","0","89","58","31","0","0","0","0","0","0","2","2","0","-2"
"171100","Michigan State University","2011","Total full-time Instruction/research/public servicey, Non-tenured not on tenure track, Assistant professors","353","206","147","0","0","0","53","28","25","19","13","6","14","11","3","0","0","0","224","122","102","0","0","0","0","0","0","43","32","11","-2"
"171100","Michigan State University","2011","Total full-time Instruction/research/public service, Non-tenured not on tenure track, Instructors","194","69","125","0","0","0","4","2","2","5","2","3","6","2","4","0","0","0","152","56","96","0","0","0","3","1","2","24","6","18","-2"
"171100","Michigan State University","2011","Total full-time Instruction/research/public service, Non-tenured not on tenure track total","718","396","322","0","0","0","74","40","34","35","24","11","24","15","9","0","0","0","510","273","237","0","0","0","3","1","2","72","43","29","-2"
"171128","Michigan Technological University","2011","Total full-time Instruction/research/public service, Tenured, Professors","99","81","18","0","0","0","18","15","3","0","0","0","2","1","1","0","0","0","71","57","14","0","0","0","7","7","0","1","1","0","-2"
"171128","Michigan Technological University","2011","Total full-time Instruction/research/public service, Tenured, Associate professors","109","83","26","0","0","0","14","14","0","2","1","1","2","2","0","0","0","0","76","53","23","0","0","0","14","12","2","1","1","0","-2"
"171128","Michigan Technological University","2011","Total full-time Instruction/research/public service, Tenured, Assistant professors","2","2","0","0","0","0","0","0","0","0","0","0","0","0","0","0","0","0","2","2","0","0","0","0","0","0","0","0","0","0","-2"
"171128","Michigan Technological University","2011","Total full-time Instruction/research/public service, Tenured total","210","166","44","0","0","0","32","29","3","2","1","1","4","3","1","0","0","0","149","112","37","0","0","0","21","19","2","2","2","0","-2"
"171128","Michigan Technological University","2011","Total full-time Instruction/research/public service, Non-tenured on tenure track, Professors","1","1","0","0","0","0","0","0","0","0","0","0","0","0","0","0","0","0","0","0","0","0","0","0","0","0","0","1","1","0","-2"
"171128","Michigan Technological University","2011","Total full-time Instruction/research/public service, Non-tenured on tenure track, Associate professors","10","7","3","0","0","0","2","1","1","0","0","0","0","0","0","0","0","0","5","3","2","0","0","0","3","3","0","0","0","0","-2"
"171128","Michigan Technological University","2011","Total full-time Instruction/research/public service, Non-tenured on tenure track, Assistant professors","124","82","42","0","0","0","18","12","6","2","1","1","4","1","3","0","0","0","52","33","19","1","1","0","13","9","4","34","25","9","-2"
"171128","Michigan Technological University","2011","Total full-time Instruction/research/public service, Non-tenured on tenure track total","135","90","45","0","0","0","20","13","7","2","1","1","4","1","3","0","0","0","57","36","21","1","1","0","16","12","4","35","26","9","-2"
"171128","Michigan Technological University","2011","Total full-time Instruction/research/public service, Non-tenured not on tenure track, Professors","1","1","0","0","0","0","0","0","0","0","0","0","0","0","0","0","0","0","1","1","0","0","0","0","0","0","0","0","0","0","-2"
"171128","Michigan Technological University","2011","Total full-time Instruction/research/public service, Non-tenured not on tenure track, Associate professors","1","1","0","0","0","0","0","0","0","0","0","0","0","0","0","0","0","0","1","1","0","0","0","0","0","0","0","0","0","0","-2"
"171128","Michigan Technological University","2011","Total full-time Instruction/research/public servicey, Non-tenured not on tenure track, Assistant professors","5","5","0","0","0","0","0","0","0","0","0","0","0","0","0","0","0","0","4","4","0","0","0","0","1","1","0","0","0","0","-2"
"171128","Michigan Technological University","2011","Total full-time Instruction/research/public service, Non-tenured not on tenure track, Instructors","26","17","9","0","0","0","0","0","0","0","0","0","1","1","0","0","0","0","21","14","7","1","1","0","0","0","0","3","1","2","-2"
"171128","Michigan Technological University","2011","Total full-time Instruction/research/public service, Non-tenured not on tenure track, Lecturers","40","19","21","0","0","0","3","0","3","0","0","0","0","0","0","0","0","0","34","16","18","0","0","0","1","1","0","2","2","0","-2"
"171128","Michigan Technological University","2011","Total full-time Instruction/research/public service, Non-tenured not on tenure track total","73","43","30","0","0","0","3","0","3","0","0","0","1","1","0","0","0","0","61","36","25","1","1","0","2","2","0","5","3","2","-2"
"174066","University of Minnesota-Twin Cities","2011","Total full-time Instruction/research/public service, Tenured, Professors","1052","790","262","2","1","1","106","89","17","15","11","4","21","16","5","0","0","0","897","664","233","3","2","1","0","0","0","8","7","1","174066"
"174066","University of Minnesota-Twin Cities","2011","Total full-time Instruction/research/public service, Tenured, Associate professors","638","374","264","3","1","2","71","48","23","25","13","12","19","8","11","0","0","0","507","295","212","7","4","3","1","0","1","5","5","0","174066"
"174066","University of Minnesota-Twin Cities","2011","Total full-time Instruction/research/public service, Tenured, Assistant professors","3","2","1","0","0","0","0","0","0","0","0","0","0","0","0","0","0","0","3","2","1","0","0","0","0","0","0","0","0","0","174066"
"174066","University of Minnesota-Twin Cities","2011","Total full-time Instruction/research/public service, Tenured total","1693","1166","527","5","2","3","177","137","40","40","24","16","40","24","16","0","0","0","1407","961","446","10","6","4","1","0","1","13","12","1","174066"
"174066","University of Minnesota-Twin Cities","2011","Total full-time Instruction/research/public service, Non-tenured on tenure track, Professors","1","1","0","0","0","0","0","0","0","0","0","0","0","0","0","0","0","0","1","1","0","0","0","0","0","0","0","0","0","0","174066"
"174066","University of Minnesota-Twin Cities","2011","Total full-time Instruction/research/public service, Non-tenured on tenure track, Associate professors","22","14","8","0","0","0","3","3","0","1","1","0","1","0","1","0","0","0","16","9","7","0","0","0","0","0","0","1","1","0","174066"
"174066","University of Minnesota-Twin Cities","2011","Total full-time Instruction/research/public service, Non-tenured on tenure track, Assistant professors","393","226","167","2","0","2","70","41","29","19","6","13","12","6","6","1","0","1","245","143","102","7","4","3","7","5","2","30","21","9","174066"
"174066","University of Minnesota-Twin Cities","2011","Total full-time Instruction/research/public service, Non-tenured on tenure track, Instructors","1","1","0","0","0","0","0","0","0","0","0","0","0","0","0","0","0","0","1","1","0","0","0","0","0","0","0","0","0","0","174066"
"174066","University of Minnesota-Twin Cities","2011","Total full-time Instruction/research/public service, Non-tenured on tenure track, Lecturers","1","0","1","0","0","0","0","0","0","0","0","0","0","0","0","0","0","0","1","0","1","0","0","0","0","0","0","0","0","0","174066"
"174066","University of Minnesota-Twin Cities","2011","Total full-time Instruction/research/public service, Non-tenured on tenure track total","418","242","176","2","0","2","73","44","29","20","7","13","13","6","7","1","0","1","264","154","110","7","4","3","7","5","2","31","22","9","174066"
"174066","University of Minnesota-Twin Cities","2011","Total full-time Instruction/research/public service, Non-tenured not on tenure track, Professors","34","28","6","0","0","0","4","3","1","0","0","0","1","1","0","0","0","0","27","22","5","0","0","0","1","1","0","1","1","0","174066"
"174066","University of Minnesota-Twin Cities","2011","Total full-time Instruction/research/public service, Non-tenured not on tenure track, Associate professors","97","71","26","0","0","0","10","10","0","5","4","1","0","0","0","0","0","0","78","55","23","0","0","0","0","0","0","4","2","2","174066"
"174066","University of Minnesota-Twin Cities","2011","Total full-time Instruction/research/public servicey, Non-tenured not on tenure track, Assistant professors","239","123","116","4","1","3","33","22","11","9","6","3","9","5","4","0","0","0","155","71","84","2","1","1","7","3","4","20","14","6","174066"
"174066","University of Minnesota-Twin Cities","2011","Total full-time Instruction/research/public service, Non-tenured not on tenure track, Instructors","26","14","12","1","0","1","2","2","0","1","1","0","1","0","1","0","0","0","20","10","10","0","0","0","0","0","0","1","1","0","174066"
"174066","University of Minnesota-Twin Cities","2011","Total full-time Instruction/research/public service, Non-tenured not on tenure track total","396","236","160","5","1","4","49","37","12","15","11","4","11","6","5","0","0","0","280","158","122","2","1","1","8","4","4","26","18","8","174066"
"174783","Saint Cloud State University","2011","Total full-time Instruction/research/public service, Tenured, Professors","226","139","87","3","2","1","24","17","7","12","11","1","9","5","4","0","0","0","173","100","73","1","1","0","2","1","1","2","2","0","-2"
"174783","Saint Cloud State University","2011","Total full-time Instruction/research/public service, Tenured, Associate professors","127","68","59","2","0","2","19","12","7","4","3","1","6","3","3","0","0","0","86","48","38","1","0","1","5","1","4","4","1","3","-2"
"174783","Saint Cloud State University","2011","Total full-time Instruction/research/public service, Tenured, Assistant professors","15","11","4","0","0","0","0","0","0","0","0","0","0","0","0","0","0","0","15","11","4","0","0","0","0","0","0","0","0","0","-2"
"174783","Saint Cloud State University","2011","Total full-time Instruction/research/public service, Tenured total","368","218","150","5","2","3","43","29","14","16","14","2","15","8","7","0","0","0","274","159","115","2","1","1","7","2","5","6","3","3","-2"
"174783","Saint Cloud State University","2011","Total full-time Instruction/research/public service, Non-tenured on tenure track, Professors","1","1","0","0","0","0","0","0","0","0","0","0","0","0","0","0","0","0","1","1","0","0","0","0","0","0","0","0","0","0","-2"
"174783","Saint Cloud State University","2011","Total full-time Instruction/research/public service, Non-tenured on tenure track, Associate professors","7","3","4","0","0","0","0","0","0","0","0","0","0","0","0","0","0","0","7","3","4","0","0","0","0","0","0","0","0","0","-2"
"174783","Saint Cloud State University","2011","Total full-time Instruction/research/public service, Non-tenured on tenure track, Assistant professors","58","25","33","1","0","1","13","6","7","2","2","0","3","1","2","0","0","0","32","12","20","0","0","0","1","1","0","6","3","3","-2"
"174783","Saint Cloud State University","2011","Total full-time Instruction/research/public service, Non-tenured on tenure track total","66","29","37","1","0","1","13","6","7","2","2","0","3","1","2","0","0","0","40","16","24","0","0","0","1","1","0","6","3","3","-2"
"174783","Saint Cloud State University","2011","Total full-time Instruction/research/public service, Non-tenured not on tenure track, Professors","1","0","1","0","0","0","0","0","0","0","0","0","0","0","0","0","0","0","1","0","1","0","0","0","0","0","0","0","0","0","-2"
"174783","Saint Cloud State University","2011","Total full-time Instruction/research/public service, Non-tenured not on tenure track, Associate professors","9","5","4","0","0","0","0","0","0","0","0","0","0","0","0","0","0","0","9","5","4","0","0","0","0","0","0","0","0","0","-2"
"174783","Saint Cloud State University","2011","Total full-time Instruction/research/public servicey, Non-tenured not on tenure track, Assistant professors","31","14","17","0","0","0","1","1","0","2","0","2","2","2","0","0","0","0","26","11","15","0","0","0","0","0","0","0","0","0","-2"
"174783","Saint Cloud State University","2011","Total full-time Instruction/research/public service, Non-tenured not on tenure track, Instructors","12","3","9","1","0","1","1","1","0","0","0","0","1","0","1","0","0","0","9","2","7","0","0","0","0","0","0","0","0","0","-2"
"174783","Saint Cloud State University","2011","Total full-time Instruction/research/public service, Non-tenured not on tenure track total","53","22","31","1","0","1","2","2","0","2","0","2","3","2","1","0","0","0","45","18","27","0","0","0","0","0","0","0","0","0","-2"
"175856","Jackson State University","2011","Total full-time Instruction/research/public service, Tenured, Professors","68","42","26","0","0","0","15","13","2","34","19","15","2","0","2","0","0","0","17","10","7","0","0","0","0","0","0","0","0","0","-2"
"175856","Jackson State University","2011","Total full-time Instruction/research/public service, Tenured, Associate professors","87","52","35","0","0","0","18","15","3","54","27","27","0","0","0","0","0","0","15","10","5","0","0","0","0","0","0","0","0","0","-2"
"175856","Jackson State University","2011","Total full-time Instruction/research/public service, Tenured, Assistant professors","18","11","7","0","0","0","4","4","0","11","6","5","0","0","0","0","0","0","3","1","2","0","0","0","0","0","0","0","0","0","-2"
"175856","Jackson State University","2011","Total full-time Instruction/research/public service, Tenured total","173","105","68","0","0","0","37","32","5","99","52","47","2","0","2","0","0","0","35","21","14","0","0","0","0","0","0","0","0","0","-2"
"175856","Jackson State University","2011","Total full-time Instruction/research/public service, Non-tenured on tenure track, Professors","2","1","1","0","0","0","0","0","0","2","1","1","0","0","0","0","0","0","0","0","0","0","0","0","0","0","0","0","0","0","-2"
"175856","Jackson State University","2011","Total full-time Instruction/research/public service, Non-tenured on tenure track, Associate professors","13","8","5","1","1","0","3","2","1","6","3","3","0","0","0","0","0","0","3","2","1","0","0","0","0","0","0","0","0","0","-2"
"175856","Jackson State University","2011","Total full-time Instruction/research/public service, Non-tenured on tenure track, Assistant professors","70","38","32","0","0","0","6","5","1","42","17","25","1","1","0","0","0","0","21","15","6","0","0","0","0","0","0","0","0","0","-2"
"175856","Jackson State University","2011","Total full-time Instruction/research/public service, Non-tenured on tenure track total","85","47","38","1","1","0","9","7","2","50","21","29","1","1","0","0","0","0","24","17","7","0","0","0","0","0","0","0","0","0","-2"
"175856","Jackson State University","2011","Total full-time Instruction/research/public service, Non-tenured not on tenure track, Professors","11","5","6","0","0","0","2","2","0","8","2","6","0","0","0","0","0","0","1","1","0","0","0","0","0","0","0","0","0","0","-2"
"175856","Jackson State University","2011","Total full-time Instruction/research/public service, Non-tenured not on tenure track, Associate professors","7","5","2","0","0","0","1","0","1","3","3","0","0","0","0","0","0","0","3","2","1","0","0","0","0","0","0","0","0","0","-2"
"175856","Jackson State University","2011","Total full-time Instruction/research/public servicey, Non-tenured not on tenure track, Assistant professors","36","15","21","0","0","0","4","3","1","29","9","20","0","0","0","0","0","0","3","3","0","0","0","0","0","0","0","0","0","0","-2"
"175856","Jackson State University","2011","Total full-time Instruction/research/public service, Non-tenured not on tenure track, Instructors","65","26","39","0","0","0","3","1","2","55","22","33","1","0","1","0","0","0","6","3","3","0","0","0","0","0","0","0","0","0","-2"
"175856","Jackson State University","2011","Total full-time Instruction/research/public service, Non-tenured not on tenure track, Lecturers","1","0","1","0","0","0","0","0","0","0","0","0","0","0","0","0","0","0","1","0","1","0","0","0","0","0","0","0","0","0","-2"
"175856","Jackson State University","2011","Total full-time Instruction/research/public service, Non-tenured not on tenure track total","120","51","69","0","0","0","10","6","4","95","36","59","1","0","1","0","0","0","14","9","5","0","0","0","0","0","0","0","0","0","-2"
"176017","University of Mississippi","2011","Total full-time Instruction/research/public service, Tenured, Professors","148","122","26","2","2","0","1","1","0","3","2","1","1","1","0","0","0","0","134","110","24","7","6","1","0","0","0","0","0","0","-2"
"176017","University of Mississippi","2011","Total full-time Instruction/research/public service, Tenured, Associate professors","207","122","85","0","0","0","3","1","2","16","7","9","1","1","0","0","0","0","170","99","71","12","10","2","0","0","0","5","4","1","-2"
"176017","University of Mississippi","2011","Total full-time Instruction/research/public service, Tenured, Assistant professors","3","2","1","0","0","0","0","0","0","0","0","0","0","0","0","0","0","0","3","2","1","0","0","0","0","0","0","0","0","0","-2"
"176017","University of Mississippi","2011","Total full-time Instruction/research/public service, Tenured total","358","246","112","2","2","0","4","2","2","19","9","10","2","2","0","0","0","0","307","211","96","19","16","3","0","0","0","5","4","1","-2"
"176017","University of Mississippi","2011","Total full-time Instruction/research/public service, Non-tenured on tenure track, Professors","1","1","0","0","0","0","0","0","0","0","0","0","0","0","0","0","0","0","1","1","0","0","0","0","0","0","0","0","0","0","-2"
"176017","University of Mississippi","2011","Total full-time Instruction/research/public service, Non-tenured on tenure track, Associate professors","5","3","2","0","0","0","0","0","0","1","0","1","0","0","0","0","0","0","4","3","1","0","0","0","0","0","0","0","0","0","-2"
"176017","University of Mississippi","2011","Total full-time Instruction/research/public service, Non-tenured on tenure track, Assistant professors","146","86","60","0","0","0","1","1","0","14","5","9","2","1","1","1","0","1","111","68","43","4","1","3","0","0","0","13","10","3","-2"
"176017","University of Mississippi","2011","Total full-time Instruction/research/public service, Non-tenured on tenure track total","152","90","62","0","0","0","1","1","0","15","5","10","2","1","1","1","0","1","116","72","44","4","1","3","0","0","0","13","10","3","-2"
"176017","University of Mississippi","2011","Total full-time Instruction/research/public service, Non-tenured not on tenure track, Professors","18","15","3","1","1","0","1","1","0","0","0","0","0","0","0","0","0","0","14","11","3","2","2","0","0","0","0","0","0","0","-2"
"176017","University of Mississippi","2011","Total full-time Instruction/research/public service, Non-tenured not on tenure track, Associate professors","11","6","5","0","0","0","2","2","0","0","0","0","0","0","0","0","0","0","7","3","4","1","0","1","0","0","0","1","1","0","-2"
"176017","University of Mississippi","2011","Total full-time Instruction/research/public servicey, Non-tenured not on tenure track, Assistant professors","65","37","28","0","0","0","1","1","0","5","2","3","2","2","0","0","0","0","52","28","24","1","1","0","0","0","0","4","3","1","-2"
"176017","University of Mississippi","2011","Total full-time Instruction/research/public service, Non-tenured not on tenure track, Instructors","160","54","106","0","0","0","3","1","2","8","3","5","7","0","7","0","0","0","127","43","84","5","2","3","0","0","0","10","5","5","-2"
"176017","University of Mississippi","2011","Total full-time Instruction/research/public service, Non-tenured not on tenure track, Lecturers","15","6","9","0","0","0","0","0","0","0","0","0","0","0","0","0","0","0","15","6","9","0","0","0","0","0","0","0","0","0","-2"
"176017","University of Mississippi","2011","Total full-time Instruction/research/public service, Non-tenured not on tenure track total","269","118","151","1","1","0","7","5","2","13","5","8","9","2","7","0","0","0","215","91","124","9","5","4","0","0","0","15","9","6","-2"
"176044","Mississippi Valley State University","2011","Total full-time Instruction/research/public service, Tenured, Professors","14","11","3","0","0","0","4","4","0","7","5","2","0","0","0","0","0","0","3","2","1","0","0","0","0","0","0","0","0","0","-2"
"176044","Mississippi Valley State University","2011","Total full-time Instruction/research/public service, Tenured, Associate professors","24","14","10","0","0","0","3","0","3","14","10","4","1","0","1","0","0","0","6","4","2","0","0","0","0","0","0","0","0","0","-2"
"176044","Mississippi Valley State University","2011","Total full-time Instruction/research/public service, Tenured, Assistant professors","20","8","12","0","0","0","2","2","0","18","6","12","0","0","0","0","0","0","0","0","0","0","0","0","0","0","0","0","0","0","-2"
"176044","Mississippi Valley State University","2011","Total full-time Instruction/research/public service, Tenured total","58","33","25","0","0","0","9","6","3","39","21","18","1","0","1","0","0","0","9","6","3","0","0","0","0","0","0","0","0","0","-2"
"176044","Mississippi Valley State University","2011","Total full-time Instruction/research/public service, Non-tenured on tenure track, Professors","6","4","2","0","0","0","1","1","0","4","3","1","0","0","0","0","0","0","1","0","1","0","0","0","0","0","0","0","0","0","-2"
"176044","Mississippi Valley State University","2011","Total full-time Instruction/research/public service, Non-tenured on tenure track, Associate professors","9","5","4","0","0","0","1","1","0","7","4","3","0","0","0","0","0","0","1","0","1","0","0","0","0","0","0","0","0","0","-2"
"176044","Mississippi Valley State University","2011","Total full-time Instruction/research/public service, Non-tenured on tenure track, Assistant professors","34","17","17","0","0","0","6","6","0","20","7","13","0","0","0","0","0","0","8","4","4","0","0","0","0","0","0","0","0","0","-2"
"176044","Mississippi Valley State University","2011","Total full-time Instruction/research/public service, Non-tenured on tenure track total","49","26","23","0","0","0","8","8","0","31","14","17","0","0","0","0","0","0","10","4","6","0","0","0","0","0","0","0","0","0","-2"
"176044","Mississippi Valley State University","2011","Total full-time Instruction/research/public service, Non-tenured not on tenure track, Instructors","23","8","15","0","0","0","0","0","0","20","6","14","0","0","0","0","0","0","3","2","1","0","0","0","0","0","0","0","0","0","-2"
"176044","Mississippi Valley State University","2011","Total full-time Instruction/research/public service, Non-tenured not on tenure track total","23","8","15","0","0","0","0","0","0","20","6","14","0","0","0","0","0","0","3","2","1","0","0","0","0","0","0","0","0","0","-2"
"176080","Mississippi State University","2011","Total full-time Instruction/research/public service, Tenured, Professors","227","185","42","0","0","0","12","12","0","8","5","3","6","6","0","0","0","0","201","162","39","0","0","0","0","0","0","0","0","0","-2"
"176080","Mississippi State University","2011","Total full-time Instruction/research/public service, Tenured, Associate professors","191","130","61","0","0","0","24","14","10","9","1","8","4","4","0","0","0","0","150","109","41","3","1","2","0","0","0","1","1","0","-2"
"176080","Mississippi State University","2011","Total full-time Instruction/research/public service, Tenured, Assistant professors","4","2","2","0","0","0","0","0","0","0","0","0","0","0","0","0","0","0","4","2","2","0","0","0","0","0","0","0","0","0","-2"
"176080","Mississippi State University","2011","Total full-time Instruction/research/public service, Tenured total","422","317","105","0","0","0","36","26","10","17","6","11","10","10","0","0","0","0","355","273","82","3","1","2","0","0","0","1","1","0","-2"
"176080","Mississippi State University","2011","Total full-time Instruction/research/public service, Non-tenured on tenure track, Associate professors","10","9","1","0","0","0","1","1","0","0","0","0","1","1","0","0","0","0","6","5","1","0","0","0","0","0","0","2","2","0","-2"
"176080","Mississippi State University","2011","Total full-time Instruction/research/public service, Non-tenured on tenure track, Assistant professors","253","162","91","1","1","0","20","17","3","16","7","9","4","3","1","0","0","0","188","117","71","3","1","2","0","0","0","21","16","5","-2"
"176080","Mississippi State University","2011","Total full-time Instruction/research/public service, Non-tenured on tenure track, Instructors","1","0","1","0","0","0","0","0","0","0","0","0","0","0","0","0","0","0","1","0","1","0","0","0","0","0","0","0","0","0","-2"
"176080","Mississippi State University","2011","Total full-time Instruction/research/public service, Non-tenured on tenure track total","264","171","93","1","1","0","21","18","3","16","7","9","5","4","1","0","0","0","195","122","73","3","1","2","0","0","0","23","18","5","-2"
"176080","Mississippi State University","2011","Total full-time Instruction/research/public service, Non-tenured not on tenure track, Professors","56","40","16","0","0","0","3","3","0","3","2","1","1","1","0","0","0","0","49","34","15","0","0","0","0","0","0","0","0","0","-2"
"176080","Mississippi State University","2011","Total full-time Instruction/research/public service, Non-tenured not on tenure track, Associate professors","45","33","12","0","0","0","2","1","1","0","0","0","2","1","1","0","0","0","41","31","10","0","0","0","0","0","0","0","0","0","-2"
"176080","Mississippi State University","2011","Total full-time Instruction/research/public servicey, Non-tenured not on tenure track, Assistant professors","107","73","34","1","0","1","11","7","4","3","1","2","3","3","0","0","0","0","68","43","25","0","0","0","0","0","0","21","19","2","-2"
"176080","Mississippi State University","2011","Total full-time Instruction/research/public service, Non-tenured not on tenure track, Instructors","154","58","96","1","1","0","3","1","2","6","2","4","4","0","4","1","0","1","137","53","84","2","1","1","0","0","0","0","0","0","-2"
"176080","Mississippi State University","2011","Total full-time Instruction/research/public service, Non-tenured not on tenure track, Lecturers","58","24","34","0","0","0","1","0","1","1","0","1","3","1","2","1","1","0","52","22","30","0","0","0","0","0","0","0","0","0","-2"
"176080","Mississippi State University","2011","Total full-time Instruction/research/public service, Non-tenured not on tenure track total","420","228","192","2","1","1","20","12","8","13","5","8","13","6","7","2","1","1","347","183","164","2","1","1","0","0","0","21","19","2","-2"
"178396","University of Missouri-Columbia","2011","Total full-time Instruction/research/public service, Tenured, Professors","488","392","96","1","1","0","71","64","7","9","5","4","8","6","2","0","0","0","392","309","83","1","1","0","6","6","0","0","0","0","-2"
"178396","University of Missouri-Columbia","2011","Total full-time Instruction/research/public service, Tenured, Associate professors","398","266","132","0","0","0","41","32","9","12","7","5","14","10","4","1","1","0","326","213","113","0","0","0","4","3","1","0","0","0","-2"
"178396","University of Missouri-Columbia","2011","Total full-time Instruction/research/public service, Tenured, Assistant professors","3","0","3","0","0","0","1","0","1","0","0","0","0","0","0","0","0","0","1","0","1","0","0","0","0","0","0","1","0","1","-2"
"178396","University of Missouri-Columbia","2011","Total full-time Instruction/research/public service, Tenured total","889","658","231","1","1","0","113","96","17","21","12","9","22","16","6","1","1","0","719","522","197","1","1","0","10","9","1","1","0","1","-2"
"178396","University of Missouri-Columbia","2011","Total full-time Instruction/research/public service, Non-tenured on tenure track, Professors","2","1","1","0","0","0","2","1","1","0","0","0","0","0","0","0","0","0","0","0","0","0","0","0","0","0","0","0","0","0","-2"
"178396","University of Missouri-Columbia","2011","Total full-time Instruction/research/public service, Non-tenured on tenure track, Associate professors","30","19","11","0","0","0","6","4","2","0","0","0","2","1","1","0","0","0","21","14","7","0","0","0","1","0","1","0","0","0","-2"
"178396","University of Missouri-Columbia","2011","Total full-time Instruction/research/public service, Non-tenured on tenure track, Assistant professors","292","165","127","2","2","0","30","18","12","12","6","6","18","11","7","1","0","1","192","101","91","1","0","1","3","2","1","33","25","8","-2"
"178396","University of Missouri-Columbia","2011","Total full-time Instruction/research/public service, Non-tenured on tenure track total","324","185","139","2","2","0","38","23","15","12","6","6","20","12","8","1","0","1","213","115","98","1","0","1","4","2","2","33","25","8","-2"
"178396","University of Missouri-Columbia","2011","Total full-time Instruction/research/public service, Non-tenured not on tenure track, Professors","59","44","15","0","0","0","6","5","1","2","2","0","1","1","0","0","0","0","50","36","14","0","0","0","0","0","0","0","0","0","-2"
"178396","University of Missouri-Columbia","2011","Total full-time Instruction/research/public service, Non-tenured not on tenure track, Associate professors","162","88","74","0","0","0","12","7","5","2","1","1","3","1","2","0","0","0","142","77","65","0","0","0","1","1","0","2","1","1","-2"
"178396","University of Missouri-Columbia","2011","Total full-time Instruction/research/public servicey, Non-tenured not on tenure track, Assistant professors","427","238","189","3","1","2","43","25","18","7","4","3","8","5","3","1","0","1","320","172","148","2","1","1","2","2","0","41","28","13","-2"
"178396","University of Missouri-Columbia","2011","Total full-time Instruction/research/public service, Non-tenured not on tenure track, Instructors","123","39","84","1","0","1","4","1","3","1","0","1","3","0","3","0","0","0","111","37","74","0","0","0","0","0","0","3","1","2","-2"
"178396","University of Missouri-Columbia","2011","Total full-time Instruction/research/public service, Non-tenured not on tenure track, Lecturers","9","3","6","0","0","0","2","0","2","0","0","0","1","1","0","0","0","0","6","2","4","0","0","0","0","0","0","0","0","0","-2"
"178396","University of Missouri-Columbia","2011","Total full-time Instruction/research/public service, Non-tenured not on tenure track, No academic rank","1137","660","477","5","3","2","94","58","36","36","16","20","19","12","7","2","2","0","725","393","332","1","1","0","9","3","6","246","172","74","-2"
"178396","University of Missouri-Columbia","2011","Total full-time Instruction/research/public service, Non-tenured not on tenure track total","1917","1072","845","9","4","5","161","96","65","48","23","25","35","20","15","3","2","1","1354","717","637","3","2","1","12","6","6","292","202","90","-2"
"178411","Missouri University of Science and Technology","2011","Total full-time Instruction/research/public service, Tenured, Professors","118","105","13","0","0","0","23","22","1","3","2","1","2","2","0","0","0","0","82","71","11","1","1","0","1","1","0","6","6","0","-2"
"178411","Missouri University of Science and Technology","2011","Total full-time Instruction/research/public service, Tenured, Associate professors","90","75","15","0","0","0","20","17","3","1","1","0","1","1","0","0","0","0","63","53","10","2","2","0","0","0","0","3","1","2","-2"
"178411","Missouri University of Science and Technology","2011","Total full-time Instruction/research/public service, Tenured total","208","180","28","0","0","0","43","39","4","4","3","1","3","3","0","0","0","0","145","124","21","3","3","0","1","1","0","9","7","2","-2"
"178411","Missouri University of Science and Technology","2011","Total full-time Instruction/research/public service, Non-tenured on tenure track, Associate professors","4","4","0","0","0","0","2","2","0","0","0","0","0","0","0","0","0","0","2","2","0","0","0","0","0","0","0","0","0","0","-2"
"178411","Missouri University of Science and Technology","2011","Total full-time Instruction/research/public service, Non-tenured on tenure track, Assistant professors","74","51","23","0","0","0","12","9","3","0","0","0","4","3","1","0","0","0","32","19","13","0","0","0","0","0","0","26","20","6","-2"
"178411","Missouri University of Science and Technology","2011","Total full-time Instruction/research/public service, Non-tenured on tenure track total","78","55","23","0","0","0","14","11","3","0","0","0","4","3","1","0","0","0","34","21","13","0","0","0","0","0","0","26","20","6","-2"
"178411","Missouri University of Science and Technology","2011","Total full-time Instruction/research/public service, Non-tenured not on tenure track, Professors","3","3","0","0","0","0","0","0","0","0","0","0","0","0","0","0","0","0","3","3","0","0","0","0","0","0","0","0","0","0","-2"
"178411","Missouri University of Science and Technology","2011","Total full-time Instruction/research/public service, Non-tenured not on tenure track, Associate professors","13","8","5","0","0","0","2","2","0","0","0","0","0","0","0","0","0","0","9","4","5","0","0","0","0","0","0","2","2","0","-2"
"178411","Missouri University of Science and Technology","2011","Total full-time Instruction/research/public servicey, Non-tenured not on tenure track, Assistant professors","29","15","14","0","0","0","4","2","2","0","0","0","0","0","0","0","0","0","17","8","9","0","0","0","0","0","0","8","5","3","-2"
"178411","Missouri University of Science and Technology","2011","Total full-time Instruction/research/public service, Non-tenured not on tenure track, Instructors","1","0","1","0","0","0","0","0","0","0","0","0","0","0","0","0","0","0","1","0","1","0","0","0","0","0","0","0","0","0","-2"
"178411","Missouri University of Science and Technology","2011","Total full-time Instruction/research/public service, Non-tenured not on tenure track, Lecturers","16","7","9","0","0","0","1","0","1","0","0","0","0","0","0","0","0","0","15","7","8","0","0","0","0","0","0","0","0","0","-2"
"178411","Missouri University of Science and Technology","2011","Total full-time Instruction/research/public service, Non-tenured not on tenure track, No academic rank","29","25","4","0","0","0","1","1","0","0","0","0","0","0","0","0","0","0","8","7","1","0","0","0","0","0","0","20","17","3","-2"
"178411","Missouri University of Science and Technology","2011","Total full-time Instruction/research/public service, Non-tenured not on tenure track total","91","58","33","0","0","0","8","5","3","0","0","0","0","0","0","0","0","0","53","29","24","0","0","0","0","0","0","30","24","6","-2"
"179159","Saint Louis University","2011","Total full-time Instruction/research/public service, Tenured, Professors","291","236","55","0","0","0","19","16","3","3","2","1","6","5","1","0","0","0","246","200","46","4","4","0","1","0","1","12","9","3","-2"
"179159","Saint Louis University","2011","Total full-time Instruction/research/public service, Tenured, Associate professors","215","130","85","0","0","0","13","9","4","9","6","3","6","2","4","0","0","0","169","97","72","1","1","0","1","1","0","16","14","2","-2"
"179159","Saint Louis University","2011","Total full-time Instruction/research/public service, Tenured, Assistant professors","3","1","2","0","0","0","0","0","0","0","0","0","0","0","0","0","0","0","3","1","2","0","0","0","0","0","0","0","0","0","-2"
"179159","Saint Louis University","2011","Total full-time Instruction/research/public service, Tenured, Instructors","1","1","0","0","0","0","0","0","0","0","0","0","0","0","0","0","0","0","1","1","0","0","0","0","0","0","0","0","0","0","-2"
"179159","Saint Louis University","2011","Total full-time Instruction/research/public service, Tenured total","510","368","142","0","0","0","32","25","7","12","8","4","12","7","5","0","0","0","419","299","120","5","5","0","2","1","1","28","23","5","-2"
"179159","Saint Louis University","2011","Total full-time Instruction/research/public service, Non-tenured on tenure track, Professors","8","5","3","0","0","0","0","0","0","0","0","0","0","0","0","0","0","0","8","5","3","0","0","0","0","0","0","0","0","0","-2"
"179159","Saint Louis University","2011","Total full-time Instruction/research/public service, Non-tenured on tenure track, Associate professors","20","10","10","0","0","0","5","4","1","0","0","0","0","0","0","0","0","0","14","5","9","0","0","0","0","0","0","1","1","0","-2"
"179159","Saint Louis University","2011","Total full-time Instruction/research/public service, Non-tenured on tenure track, Assistant professors","208","110","98","0","0","0","16","8","8","6","4","2","13","8","5","0","0","0","134","69","65","5","3","2","6","2","4","28","16","12","-2"
"179159","Saint Louis University","2011","Total full-time Instruction/research/public service, Non-tenured on tenure track, Instructors","3","0","3","0","0","0","0","0","0","1","0","1","0","0","0","0","0","0","1","0","1","1","0","1","0","0","0","0","0","0","-2"
"179159","Saint Louis University","2011","Total full-time Instruction/research/public service, Non-tenured on tenure track total","239","125","114","0","0","0","21","12","9","7","4","3","13","8","5","0","0","0","157","79","78","6","3","3","6","2","4","29","17","12","-2"
"179159","Saint Louis University","2011","Total full-time Instruction/research/public service, Non-tenured not on tenure track, Professors","71","52","19","0","0","0","6","4","2","2","0","2","0","0","0","0","0","0","59","46","13","0","0","0","1","0","1","3","2","1","-2"
"179159","Saint Louis University","2011","Total full-time Instruction/research/public service, Non-tenured not on tenure track, Associate professors","139","71","68","0","0","0","17","11","6","3","1","2","2","1","1","0","0","0","109","52","57","0","0","0","0","0","0","8","6","2","-2"
"179159","Saint Louis University","2011","Total full-time Instruction/research/public servicey, Non-tenured not on tenure track, Assistant professors","251","114","137","0","0","0","35","10","25","5","2","3","5","2","3","0","0","0","172","82","90","2","0","2","7","6","1","25","12","13","-2"
"179159","Saint Louis University","2011","Total full-time Instruction/research/public service, Non-tenured not on tenure track, Instructors","100","44","56","0","0","0","7","2","5","6","2","4","6","4","2","0","0","0","65","26","39","4","0","4","3","3","0","9","7","2","-2"
"179159","Saint Louis University","2011","Total full-time Instruction/research/public service, Non-tenured not on tenure track, No academic rank","46","28","18","0","0","0","4","1","3","2","2","0","0","0","0","0","0","0","13","9","4","0","0","0","1","0","1","26","16","10","-2"
"179159","Saint Louis University","2011","Total full-time Instruction/research/public service, Non-tenured not on tenure track total","607","309","298","0","0","0","69","28","41","18","7","11","13","7","6","0","0","0","418","215","203","6","0","6","12","9","3","71","43","28","-2"
"179867","Washington University in St Louis","2011","Total full-time Instruction/research/public service, Tenured, Professors","641","530","111","0","0","0","40","34","6","12","7","5","13","12","1","0","0","0","575","476","99","1","1","0","0","0","0","0","0","0","-2"
"179867","Washington University in St Louis","2011","Total full-time Instruction/research/public service, Tenured, Associate professors","279","195","84","0","0","0","39","31","8","9","3","6","5","4","1","0","0","0","225","156","69","1","1","0","0","0","0","0","0","0","-2"
"179867","Washington University in St Louis","2011","Total full-time Instruction/research/public service, Tenured, Assistant professors","1","1","0","0","0","0","0","0","0","0","0","0","0","0","0","0","0","0","1","1","0","0","0","0","0","0","0","0","0","0","-2"
"179867","Washington University in St Louis","2011","Total full-time Instruction/research/public service, Tenured total","921","726","195","0","0","0","79","65","14","21","10","11","18","16","2","0","0","0","801","633","168","2","2","0","0","0","0","0","0","0","-2"
"179867","Washington University in St Louis","2011","Total full-time Instruction/research/public service, Non-tenured on tenure track, Professors","4","2","2","0","0","0","0","0","0","1","0","1","0","0","0","0","0","0","3","2","1","0","0","0","0","0","0","0","0","0","-2"
"179867","Washington University in St Louis","2011","Total full-time Instruction/research/public service, Non-tenured on tenure track, Associate professors","15","11","4","0","0","0","4","2","2","1","1","0","0","0","0","0","0","0","9","7","2","1","1","0","0","0","0","0","0","0","-2"
"179867","Washington University in St Louis","2011","Total full-time Instruction/research/public service, Non-tenured on tenure track, Assistant professors","329","205","124","0","0","0","79","46","33","12","5","7","17","14","3","1","0","1","219","139","80","0","0","0","0","0","0","1","1","0","-2"
"179867","Washington University in St Louis","2011","Total full-time Instruction/research/public service, Non-tenured on tenure track total","348","218","130","0","0","0","83","48","35","14","6","8","17","14","3","1","0","1","231","148","83","1","1","0","0","0","0","1","1","0","-2"
"179867","Washington University in St Louis","2011","Total full-time Instruction/research/public service, Non-tenured not on tenure track, Professors","163","117","46","0","0","0","13","9","4","2","2","0","1","1","0","0","0","0","147","105","42","0","0","0","0","0","0","0","0","0","-2"
"179867","Washington University in St Louis","2011","Total full-time Instruction/research/public service, Non-tenured not on tenure track, Associate professors","229","159","70","0","0","0","36","25","11","6","3","3","7","4","3","1","1","0","179","126","53","0","0","0","0","0","0","0","0","0","-2"
"179867","Washington University in St Louis","2011","Total full-time Instruction/research/public servicey, Non-tenured not on tenure track, Assistant professors","454","260","194","0","0","0","97","66","31","10","2","8","18","10","8","2","2","0","326","179","147","1","1","0","0","0","0","0","0","0","-2"
"179867","Washington University in St Louis","2011","Total full-time Instruction/research/public service, Non-tenured not on tenure track, Instructors","306","171","135","1","0","1","105","65","40","8","3","5","6","3","3","0","0","0","186","100","86","0","0","0","0","0","0","0","0","0","-2"
"179867","Washington University in St Louis","2011","Total full-time Instruction/research/public service, Non-tenured not on tenure track, Lecturers","146","63","83","0","0","0","19","7","12","4","3","1","7","2","5","0","0","0","113","51","62","1","0","1","0","0","0","2","0","2","-2"
"179867","Washington University in St Louis","2011","Total full-time Instruction/research/public service, Non-tenured not on tenure track, No academic rank","119","72","47","0","0","0","24","17","7","3","0","3","3","2","1","1","0","1","82","48","34","1","0","1","0","0","0","5","5","0","-2"
"179867","Washington University in St Louis","2011","Total full-time Instruction/research/public service, Non-tenured not on tenure track total","1417","842","575","1","0","1","294","189","105","33","13","20","42","22","20","4","3","1","1033","609","424","3","1","2","0","0","0","7","5","2","-2"
"180461","Montana State University","2011","Total full-time Instruction/research/public service, Tenured, Professors","194","162","32","2","2","0","4","3","1","0","0","0","1","1","0","0","0","0","180","151","29","4","3","1","3","2","1","0","0","0","-2"
"180461","Montana State University","2011","Total full-time Instruction/research/public service, Tenured, Associate professors","168","100","68","0","0","0","7","5","2","0","0","0","2","2","0","0","0","0","155","89","66","0","0","0","4","4","0","0","0","0","-2"
"180461","Montana State University","2011","Total full-time Instruction/research/public service, Tenured, Assistant professors","11","6","5","0","0","0","0","0","0","0","0","0","0","0","0","0","0","0","10","5","5","0","0","0","1","1","0","0","0","0","-2"
"180461","Montana State University","2011","Total full-time Instruction/research/public service, Tenured, Instructors","6","3","3","0","0","0","0","0","0","0","0","0","0","0","0","0","0","0","6","3","3","0","0","0","0","0","0","0","0","0","-2"
"180461","Montana State University","2011","Total full-time Instruction/research/public service, Tenured total","379","271","108","2","2","0","11","8","3","0","0","0","3","3","0","0","0","0","351","248","103","4","3","1","8","7","1","0","0","0","-2"
"180461","Montana State University","2011","Total full-time Instruction/research/public service, Non-tenured on tenure track, Associate professors","5","4","1","0","0","0","0","0","0","0","0","0","0","0","0","0","0","0","5","4","1","0","0","0","0","0","0","0","0","0","-2"
"180461","Montana State University","2011","Total full-time Instruction/research/public service, Non-tenured on tenure track, Assistant professors","139","73","66","0","0","0","9","5","4","0","0","0","3","3","0","0","0","0","122","61","61","2","2","0","3","2","1","0","0","0","-2"
"180461","Montana State University","2011","Total full-time Instruction/research/public service, Non-tenured on tenure track, Instructors","4","3","1","0","0","0","0","0","0","0","0","0","1","0","1","0","0","0","3","3","0","0","0","0","0","0","0","0","0","0","-2"
"180461","Montana State University","2011","Total full-time Instruction/research/public service, Non-tenured on tenure track total","148","80","68","0","0","0","9","5","4","0","0","0","4","3","1","0","0","0","130","68","62","2","2","0","3","2","1","0","0","0","-2"
"180461","Montana State University","2011","Total full-time Instruction/research/public service, Non-tenured not on tenure track, Professors","2","2","0","0","0","0","0","0","0","0","0","0","0","0","0","0","0","0","2","2","0","0","0","0","0","0","0","0","0","0","-2"
"180461","Montana State University","2011","Total full-time Instruction/research/public service, Non-tenured not on tenure track, Associate professors","2","2","0","0","0","0","0","0","0","0","0","0","0","0","0","0","0","0","2","2","0","0","0","0","0","0","0","0","0","0","-2"
"180461","Montana State University","2011","Total full-time Instruction/research/public servicey, Non-tenured not on tenure track, Assistant professors","14","5","9","0","0","0","0","0","0","0","0","0","0","0","0","0","0","0","14","5","9","0","0","0","0","0","0","0","0","0","-2"
"180461","Montana State University","2011","Total full-time Instruction/research/public service, Non-tenured not on tenure track, Instructors","35","12","23","1","1","0","0","0","0","0","0","0","0","0","0","0","0","0","34","11","23","0","0","0","0","0","0","0","0","0","-2"
"180461","Montana State University","2011","Total full-time Instruction/research/public service, Non-tenured not on tenure track total","53","21","32","1","1","0","0","0","0","0","0","0","0","0","0","0","0","0","52","20","32","0","0","0","0","0","0","0","0","0","-2"
"181002","Creighton University","2011","Total full-time Instruction/research/public service, Tenured, Professors","166","136","30","0","0","0","24","21","3","2","0","2","4","4","0","0","0","0","134","110","24","0","0","0","0","0","0","2","1","1","-2"
"181002","Creighton University","2011","Total full-time Instruction/research/public service, Tenured, Associate professors","206","135","71","0","0","0","17","12","5","6","3","3","5","2","3","0","0","0","177","117","60","0","0","0","0","0","0","1","1","0","-2"
"181002","Creighton University","2011","Total full-time Instruction/research/public service, Tenured, Assistant professors","33","19","14","0","0","0","3","2","1","1","1","0","0","0","0","0","0","0","29","16","13","0","0","0","0","0","0","0","0","0","-2"
"181002","Creighton University","2011","Total full-time Instruction/research/public service, Tenured total","405","290","115","0","0","0","44","35","9","9","4","5","9","6","3","0","0","0","340","243","97","0","0","0","0","0","0","3","2","1","-2"
"181002","Creighton University","2011","Total full-time Instruction/research/public service, Non-tenured on tenure track, Professors","9","8","1","0","0","0","0","0","0","0","0","0","1","1","0","0","0","0","7","6","1","0","0","0","0","0","0","1","1","0","-2"
"181002","Creighton University","2011","Total full-time Instruction/research/public service, Non-tenured on tenure track, Associate professors","18","11","7","1","1","0","1","1","0","2","2","0","1","0","1","0","0","0","11","5","6","0","0","0","0","0","0","2","2","0","-2"
"181002","Creighton University","2011","Total full-time Instruction/research/public service, Non-tenured on tenure track, Assistant professors","103","61","42","1","0","1","5","1","4","0","0","0","2","1","1","0","0","0","77","44","33","0","0","0","0","0","0","18","15","3","-2"
"181002","Creighton University","2011","Total full-time Instruction/research/public service, Non-tenured on tenure track, Instructors","24","11","13","0","0","0","2","1","1","0","0","0","0","0","0","0","0","0","21","9","12","0","0","0","0","0","0","1","1","0","-2"
"181002","Creighton University","2011","Total full-time Instruction/research/public service, Non-tenured on tenure track total","154","91","63","2","1","1","8","3","5","2","2","0","4","2","2","0","0","0","116","64","52","0","0","0","0","0","0","22","19","3","-2"
"181002","Creighton University","2011","Total full-time Instruction/research/public service, Non-tenured not on tenure track, Professors","4","4","0","0","0","0","0","0","0","0","0","0","0","0","0","0","0","0","4","4","0","0","0","0","0","0","0","0","0","0","-2"
"181002","Creighton University","2011","Total full-time Instruction/research/public service, Non-tenured not on tenure track, Associate professors","23","17","6","0","0","0","2","1","1","0","0","0","1","1","0","0","0","0","19","14","5","0","0","0","0","0","0","1","1","0","-2"
"181002","Creighton University","2011","Total full-time Instruction/research/public servicey, Non-tenured not on tenure track, Assistant professors","105","42","63","0","0","0","5","3","2","3","2","1","1","0","1","0","0","0","92","34","58","0","0","0","0","0","0","4","3","1","-2"
"181002","Creighton University","2011","Total full-time Instruction/research/public service, Non-tenured not on tenure track, Instructors","28","10","18","1","1","0","1","0","1","1","0","1","0","0","0","0","0","0","21","7","14","0","0","0","0","0","0","4","2","2","-2"
"181002","Creighton University","2011","Total full-time Instruction/research/public service, Non-tenured not on tenure track, Lecturers","4","2","2","0","0","0","1","0","1","0","0","0","1","0","1","0","0","0","2","2","0","0","0","0","0","0","0","0","0","0","-2"
"181002","Creighton University","2011","Total full-time Instruction/research/public service, Non-tenured not on tenure track total","164","75","89","1","1","0","9","4","5","4","2","2","3","1","2","0","0","0","138","61","77","0","0","0","0","0","0","9","6","3","-2"
"181464","University of Nebraska-Lincoln","2011","Total full-time Instruction/research/public service, Tenured, Professors","444","361","83","0","0","0","33","30","3","5","3","2","8","7","1","0","0","0","397","320","77","0","0","0","0","0","0","1","1","0","-2"
"181464","University of Nebraska-Lincoln","2011","Total full-time Instruction/research/public service, Tenured, Associate professors","271","168","103","5","1","4","35","22","13","10","4","6","13","10","3","0","0","0","207","130","77","0","0","0","0","0","0","1","1","0","-2"
"181464","University of Nebraska-Lincoln","2011","Total full-time Instruction/research/public service, Tenured, Assistant professors","2","1","1","0","0","0","0","0","0","0","0","0","0","0","0","0","0","0","2","1","1","0","0","0","0","0","0","0","0","0","-2"
"181464","University of Nebraska-Lincoln","2011","Total full-time Instruction/research/public service, Tenured total","717","530","187","5","1","4","68","52","16","15","7","8","21","17","4","0","0","0","606","451","155","0","0","0","0","0","0","2","2","0","-2"
"181464","University of Nebraska-Lincoln","2011","Total full-time Instruction/research/public service, Non-tenured on tenure track, Associate professors","23","15","8","0","0","0","5","5","0","2","0","2","0","0","0","0","0","0","16","10","6","0","0","0","0","0","0","0","0","0","-2"
"181464","University of Nebraska-Lincoln","2011","Total full-time Instruction/research/public service, Non-tenured on tenure track, Assistant professors","228","143","85","1","0","1","32","20","12","6","2","4","9","7","2","0","0","0","149","92","57","1","0","1","0","0","0","30","22","8","-2"
"181464","University of Nebraska-Lincoln","2011","Total full-time Instruction/research/public service, Non-tenured on tenure track total","251","158","93","1","0","1","37","25","12","8","2","6","9","7","2","0","0","0","165","102","63","1","0","1","0","0","0","30","22","8","-2"
"181464","University of Nebraska-Lincoln","2011","Total full-time Instruction/research/public service, Non-tenured not on tenure track, Professors","94","52","42","0","0","0","2","2","0","0","0","0","0","0","0","0","0","0","91","49","42","0","0","0","0","0","0","1","1","0","-2"
"181464","University of Nebraska-Lincoln","2011","Total full-time Instruction/research/public service, Non-tenured not on tenure track, Associate professors","68","30","38","0","0","0","1","1","0","0","0","0","1","0","1","0","0","0","66","29","37","0","0","0","0","0","0","0","0","0","-2"
"181464","University of Nebraska-Lincoln","2011","Total full-time Instruction/research/public servicey, Non-tenured not on tenure track, Assistant professors","129","67","62","0","0","0","18","13","5","3","3","0","4","2","2","0","0","0","85","37","48","0","0","0","0","0","0","19","12","7","-2"
"181464","University of Nebraska-Lincoln","2011","Total full-time Instruction/research/public service, Non-tenured not on tenure track, Lecturers","157","66","91","0","0","0","7","4","3","3","1","2","7","4","3","0","0","0","134","54","80","0","0","0","0","0","0","6","3","3","-2"
"181464","University of Nebraska-Lincoln","2011","Total full-time Instruction/research/public service, Non-tenured not on tenure track, No academic rank","183","128","55","0","0","0","16","14","2","3","1","2","4","2","2","0","0","0","43","26","17","1","0","1","0","0","0","116","85","31","-2"
"181464","University of Nebraska-Lincoln","2011","Total full-time Instruction/research/public service, Non-tenured not on tenure track total","631","343","288","0","0","0","44","34","10","9","5","4","16","8","8","0","0","0","419","195","224","1","0","1","0","0","0","142","101","41","-2"
"182281","University of Nevada-Las Vegas","2011","Total full-time Instruction/research/public service, Tenured, Professors","252","192","60","2","1","1","37","31","6","8","7","1","9","6","3","0","0","0","196","147","49","0","0","0","0","0","0","0","0","0","-2"
"182281","University of Nevada-Las Vegas","2011","Total full-time Instruction/research/public service, Tenured, Associate professors","224","149","75","2","1","1","31","23","8","8","4","4","15","7","8","0","0","0","168","114","54","0","0","0","0","0","0","0","0","0","-2"
"182281","University of Nevada-Las Vegas","2011","Total full-time Instruction/research/public service, Tenured, Assistant professors","5","4","1","0","0","0","1","1","0","0","0","0","0","0","0","0","0","0","4","3","1","0","0","0","0","0","0","0","0","0","-2"
"182281","University of Nevada-Las Vegas","2011","Total full-time Instruction/research/public service, Tenured total","481","345","136","4","2","2","69","55","14","16","11","5","24","13","11","0","0","0","368","264","104","0","0","0","0","0","0","0","0","0","-2"
"182281","University of Nevada-Las Vegas","2011","Total full-time Instruction/research/public service, Non-tenured on tenure track, Associate professors","19","6","13","0","0","0","0","0","0","1","0","1","2","1","1","0","0","0","14","4","10","1","0","1","0","0","0","1","1","0","-2"
"182281","University of Nevada-Las Vegas","2011","Total full-time Instruction/research/public service, Non-tenured on tenure track, Assistant professors","113","58","55","1","0","1","17","9","8","4","3","1","6","3","3","0","0","0","71","33","38","2","1","1","0","0","0","12","9","3","-2"
"182281","University of Nevada-Las Vegas","2011","Total full-time Instruction/research/public service, Non-tenured on tenure track, Instructors","1","0","1","0","0","0","0","0","0","0","0","0","0","0","0","0","0","0","0","0","0","1","0","1","0","0","0","0","0","0","-2"
"182281","University of Nevada-Las Vegas","2011","Total full-time Instruction/research/public service, Non-tenured on tenure track total","133","64","69","1","0","1","17","9","8","5","3","2","8","4","4","0","0","0","85","37","48","4","1","3","0","0","0","13","10","3","-2"
"182281","University of Nevada-Las Vegas","2011","Total full-time Instruction/research/public service, Non-tenured not on tenure track, Professors","7","6","1","0","0","0","0","0","0","0","0","0","0","0","0","0","0","0","7","6","1","0","0","0","0","0","0","0","0","0","-2"
"182281","University of Nevada-Las Vegas","2011","Total full-time Instruction/research/public service, Non-tenured not on tenure track, Associate professors","28","21","7","0","0","0","4","4","0","2","1","1","2","0","2","0","0","0","20","16","4","0","0","0","0","0","0","0","0","0","-2"
"182281","University of Nevada-Las Vegas","2011","Total full-time Instruction/research/public servicey, Non-tenured not on tenure track, Assistant professors","64","31","33","0","0","0","7","3","4","3","1","2","2","2","0","0","0","0","48","23","25","0","0","0","0","0","0","4","2","2","-2"
"182281","University of Nevada-Las Vegas","2011","Total full-time Instruction/research/public service, Non-tenured not on tenure track, Lecturers","67","29","38","0","0","0","7","2","5","4","0","4","3","1","2","0","0","0","52","26","26","1","0","1","0","0","0","0","0","0","-2"
"182281","University of Nevada-Las Vegas","2011","Total full-time Instruction/research/public service, Non-tenured not on tenure track total","166","87","79","0","0","0","18","9","9","9","2","7","7","3","4","0","0","0","127","71","56","1","0","1","0","0","0","4","2","2","-2"
"182290","University of Nevada-Reno","2011","Total full-time Instruction/research/public service, Tenured, Professors","210","165","45","0","0","0","18","15","3","0","0","0","5","4","1","0","0","0","184","143","41","3","3","0","0","0","0","0","0","0","-2"
"182290","University of Nevada-Reno","2011","Total full-time Instruction/research/public service, Tenured, Associate professors","204","120","84","2","1","1","17","15","2","4","3","1","8","5","3","0","0","0","172","96","76","1","0","1","0","0","0","0","0","0","-2"
"182290","University of Nevada-Reno","2011","Total full-time Instruction/research/public service, Tenured, Assistant professors","3","2","1","0","0","0","0","0","0","0","0","0","1","1","0","0","0","0","2","1","1","0","0","0","0","0","0","0","0","0","-2"
"182290","University of Nevada-Reno","2011","Total full-time Instruction/research/public service, Tenured total","417","287","130","2","1","1","35","30","5","4","3","1","14","10","4","0","0","0","358","240","118","4","3","1","0","0","0","0","0","0","-2"
"182290","University of Nevada-Reno","2011","Total full-time Instruction/research/public service, Non-tenured on tenure track, Professors","3","3","0","0","0","0","1","1","0","0","0","0","0","0","0","0","0","0","2","2","0","0","0","0","0","0","0","0","0","0","-2"
"182290","University of Nevada-Reno","2011","Total full-time Instruction/research/public service, Non-tenured on tenure track, Associate professors","10","7","3","0","0","0","2","2","0","1","1","0","1","0","1","0","0","0","6","4","2","0","0","0","0","0","0","0","0","0","-2"
"182290","University of Nevada-Reno","2011","Total full-time Instruction/research/public service, Non-tenured on tenure track, Assistant professors","125","63","62","0","0","0","23","16","7","1","0","1","8","3","5","0","0","0","91","43","48","1","1","0","0","0","0","1","0","1","-2"
"182290","University of Nevada-Reno","2011","Total full-time Instruction/research/public service, Non-tenured on tenure track total","138","73","65","0","0","0","26","19","7","2","1","1","9","3","6","0","0","0","99","49","50","1","1","0","0","0","0","1","0","1","-2"
"182290","University of Nevada-Reno","2011","Total full-time Instruction/research/public service, Non-tenured not on tenure track, Professors","25","19","6","0","0","0","1","1","0","1","0","1","0","0","0","0","0","0","23","18","5","0","0","0","0","0","0","0","0","0","-2"
"182290","University of Nevada-Reno","2011","Total full-time Instruction/research/public service, Non-tenured not on tenure track, Associate professors","47","30","17","0","0","0","3","2","1","2","2","0","0","0","0","0","0","0","40","26","14","2","0","2","0","0","0","0","0","0","-2"
"182290","University of Nevada-Reno","2011","Total full-time Instruction/research/public servicey, Non-tenured not on tenure track, Assistant professors","74","43","31","1","1","0","12","6","6","2","2","0","1","0","1","0","0","0","58","34","24","0","0","0","0","0","0","0","0","0","-2"
"182290","University of Nevada-Reno","2011","Total full-time Instruction/research/public service, Non-tenured not on tenure track, Instructors","114","46","68","1","0","1","20","9","11","0","0","0","8","4","4","0","0","0","79","28","51","5","4","1","1","1","0","0","0","0","-2"
"182290","University of Nevada-Reno","2011","Total full-time Instruction/research/public service, Non-tenured not on tenure track total","260","138","122","2","1","1","36","18","18","5","4","1","9","4","5","0","0","0","200","106","94","7","4","3","1","1","0","0","0","0","-2"
"182670","Dartmouth College","2011","Total full-time Instruction/research/public service, Tenured, Professors","271","202","69","1","1","0","12","8","4","3","2","1","6","4","2","0","0","0","244","184","60","4","2","2","0","0","0","1","1","0","-2"
"182670","Dartmouth College","2011","Total full-time Instruction/research/public service, Tenured, Associate professors","131","80","51","1","1","0","9","6","3","6","4","2","9","5","4","0","0","0","101","61","40","4","2","2","0","0","0","1","1","0","-2"
"182670","Dartmouth College","2011","Total full-time Instruction/research/public service, Tenured total","402","282","120","2","2","0","21","14","7","9","6","3","15","9","6","0","0","0","345","245","100","8","4","4","0","0","0","2","2","0","-2"
"182670","Dartmouth College","2011","Total full-time Instruction/research/public service, Non-tenured on tenure track, Associate professors","28","17","11","0","0","0","1","0","1","0","0","0","1","0","1","0","0","0","24","15","9","0","0","0","0","0","0","2","2","0","-2"
"182670","Dartmouth College","2011","Total full-time Instruction/research/public service, Non-tenured on tenure track, Assistant professors","112","66","46","2","0","2","12","8","4","9","4","5","8","4","4","0","0","0","68","42","26","0","0","0","0","0","0","13","8","5","-2"
"182670","Dartmouth College","2011","Total full-time Instruction/research/public service, Non-tenured on tenure track, Instructors","4","2","2","0","0","0","0","0","0","1","0","1","0","0","0","0","0","0","2","1","1","0","0","0","0","0","0","1","1","0","-2"
"182670","Dartmouth College","2011","Total full-time Instruction/research/public service, Non-tenured on tenure track total","144","85","59","2","0","2","13","8","5","10","4","6","9","4","5","0","0","0","94","58","36","0","0","0","0","0","0","16","11","5","-2"
"182670","Dartmouth College","2011","Total full-time Instruction/research/public service, Non-tenured not on tenure track, Professors","33","25","8","0","0","0","3","2","1","0","0","0","0","0","0","0","0","0","29","22","7","1","1","0","0","0","0","0","0","0","-2"
"182670","Dartmouth College","2011","Total full-time Instruction/research/public service, Non-tenured not on tenure track, Associate professors","43","27","16","0","0","0","2","2","0","1","0","1","1","0","1","0","0","0","39","25","14","0","0","0","0","0","0","0","0","0","-2"
"182670","Dartmouth College","2011","Total full-time Instruction/research/public servicey, Non-tenured not on tenure track, Assistant professors","95","52","43","0","0","0","11","7","4","0","0","0","4","3","1","0","0","0","75","38","37","0","0","0","0","0","0","5","4","1","-2"
"182670","Dartmouth College","2011","Total full-time Instruction/research/public service, Non-tenured not on tenure track, Instructors","44","19","25","0","0","0","2","1","1","0","0","0","0","0","0","0","0","0","39","15","24","0","0","0","0","0","0","3","3","0","-2"
"182670","Dartmouth College","2011","Total full-time Instruction/research/public service, Non-tenured not on tenure track, Lecturers","44","14","30","1","0","1","3","1","2","0","0","0","3","0","3","0","0","0","30","9","21","2","2","0","0","0","0","5","2","3","-2"
"182670","Dartmouth College","2011","Total full-time Instruction/research/public service, Non-tenured not on tenure track, No academic rank","8","2","6","0","0","0","0","0","0","0","0","0","0","0","0","0","0","0","6","2","4","0","0","0","0","0","0","2","0","2","-2"
"182670","Dartmouth College","2011","Total full-time Instruction/research/public service, Non-tenured not on tenure track total","267","139","128","1","0","1","21","13","8","1","0","1","8","3","5","0","0","0","218","111","107","3","3","0","0","0","0","15","9","6","-2"
"183044","University of New Hampshire-Main Campus","2011","Total full-time Instruction/research/public service, Tenured, Professors","234","184","50","0","0","0","9","6","3","1","1","0","1","1","0","0","0","0","213","169","44","1","1","0","9","6","3","0","0","0","-2"
"183044","University of New Hampshire-Main Campus","2011","Total full-time Instruction/research/public service, Tenured, Associate professors","208","116","92","0","0","0","14","7","7","4","3","1","11","6","5","0","0","0","165","90","75","2","2","0","12","8","4","0","0","0","-2"
"183044","University of New Hampshire-Main Campus","2011","Total full-time Instruction/research/public service, Tenured total","442","300","142","0","0","0","23","13","10","5","4","1","12","7","5","0","0","0","378","259","119","3","3","0","21","14","7","0","0","0","-2"
"183044","University of New Hampshire-Main Campus","2011","Total full-time Instruction/research/public service, Non-tenured on tenure track, Professors","2","2","0","0","0","0","0","0","0","0","0","0","0","0","0","0","0","0","2","2","0","0","0","0","0","0","0","0","0","0","-2"
"183044","University of New Hampshire-Main Campus","2011","Total full-time Instruction/research/public service, Non-tenured on tenure track, Associate professors","20","14","6","0","0","0","1","1","0","0","0","0","2","2","0","0","0","0","15","10","5","0","0","0","2","1","1","0","0","0","-2"
"183044","University of New Hampshire-Main Campus","2011","Total full-time Instruction/research/public service, Non-tenured on tenure track, Assistant professors","114","55","59","2","1","1","11","4","7","2","1","1","2","1","1","0","0","0","48","24","24","0","0","0","43","21","22","6","3","3","-2"
"183044","University of New Hampshire-Main Campus","2011","Total full-time Instruction/research/public service, Non-tenured on tenure track total","136","71","65","2","1","1","12","5","7","2","1","1","4","3","1","0","0","0","65","36","29","0","0","0","45","22","23","6","3","3","-2"
"183044","University of New Hampshire-Main Campus","2011","Total full-time Instruction/research/public service, Non-tenured not on tenure track, Professors","16","14","2","0","0","0","1","1","0","0","0","0","0","0","0","0","0","0","12","11","1","0","0","0","3","2","1","0","0","0","-2"
"183044","University of New Hampshire-Main Campus","2011","Total full-time Instruction/research/public service, Non-tenured not on tenure track, Associate professors","27","19","8","0","0","0","0","0","0","0","0","0","1","1","0","0","0","0","24","17","7","0","0","0","2","1","1","0","0","0","-2"
"183044","University of New Hampshire-Main Campus","2011","Total full-time Instruction/research/public servicey, Non-tenured not on tenure track, Assistant professors","46","19","27","0","0","0","1","1","0","0","0","0","0","0","0","0","0","0","31","10","21","0","0","0","14","8","6","0","0","0","-2"
"183044","University of New Hampshire-Main Campus","2011","Total full-time Instruction/research/public service, Non-tenured not on tenure track, Instructors","2","2","0","0","0","0","0","0","0","0","0","0","0","0","0","0","0","0","2","2","0","0","0","0","0","0","0","0","0","0","-2"
"183044","University of New Hampshire-Main Campus","2011","Total full-time Instruction/research/public service, Non-tenured not on tenure track, Lecturers","42","18","24","0","0","0","5","2","3","0","0","0","0","0","0","0","0","0","19","6","13","0","0","0","18","10","8","0","0","0","-2"
"183044","University of New Hampshire-Main Campus","2011","Total full-time Instruction/research/public service, Non-tenured not on tenure track total","133","72","61","0","0","0","7","4","3","0","0","0","1","1","0","0","0","0","88","46","42","0","0","0","37","21","16","0","0","0","-2"
"183080","Plymouth State University","2011","Total full-time Instruction/research/public service, Tenured, Professors","76","51","25","0","0","0","5","4","1","0","0","0","0","0","0","0","0","0","69","46","23","0","0","0","2","1","1","0","0","0","-2"
"183080","Plymouth State University","2011","Total full-time Instruction/research/public service, Tenured, Associate professors","40","25","15","0","0","0","2","2","0","2","1","1","1","0","1","0","0","0","31","19","12","0","0","0","4","3","1","0","0","0","-2"
"183080","Plymouth State University","2011","Total full-time Instruction/research/public service, Tenured, Assistant professors","2","2","0","0","0","0","0","0","0","0","0","0","0","0","0","0","0","0","2","2","0","0","0","0","0","0","0","0","0","0","-2"
"183080","Plymouth State University","2011","Total full-time Instruction/research/public service, Tenured total","118","78","40","0","0","0","7","6","1","2","1","1","1","0","1","0","0","0","102","67","35","0","0","0","6","4","2","0","0","0","-2"
"183080","Plymouth State University","2011","Total full-time Instruction/research/public service, Non-tenured on tenure track, Professors","1","0","1","0","0","0","0","0","0","0","0","0","0","0","0","0","0","0","1","0","1","0","0","0","0","0","0","0","0","0","-2"
"183080","Plymouth State University","2011","Total full-time Instruction/research/public service, Non-tenured on tenure track, Associate professors","10","4","6","0","0","0","0","0","0","0","0","0","0","0","0","0","0","0","6","2","4","0","0","0","2","0","2","2","2","0","-2"
"183080","Plymouth State University","2011","Total full-time Instruction/research/public service, Non-tenured on tenure track, Assistant professors","33","10","23","0","0","0","1","1","0","0","0","0","0","0","0","0","0","0","30","8","22","0","0","0","1","1","0","1","0","1","-2"
"183080","Plymouth State University","2011","Total full-time Instruction/research/public service, Non-tenured on tenure track, Instructors","1","0","1","0","0","0","0","0","0","0","0","0","0","0","0","0","0","0","1","0","1","0","0","0","0","0","0","0","0","0","-2"
"183080","Plymouth State University","2011","Total full-time Instruction/research/public service, Non-tenured on tenure track total","45","14","31","0","0","0","1","1","0","0","0","0","0","0","0","0","0","0","38","10","28","0","0","0","3","1","2","3","2","1","-2"
"183080","Plymouth State University","2011","Total full-time Instruction/research/public service, Non-tenured not on tenure track, Associate professors","2","1","1","0","0","0","0","0","0","0","0","0","0","0","0","0","0","0","2","1","1","0","0","0","0","0","0","0","0","0","-2"
"183080","Plymouth State University","2011","Total full-time Instruction/research/public servicey, Non-tenured not on tenure track, Assistant professors","4","1","3","0","0","0","0","0","0","0","0","0","0","0","0","0","0","0","4","1","3","0","0","0","0","0","0","0","0","0","-2"
"183080","Plymouth State University","2011","Total full-time Instruction/research/public service, Non-tenured not on tenure track, Lecturers","22","10","12","0","0","0","1","0","1","0","0","0","3","1","2","0","0","0","16","8","8","0","0","0","2","1","1","0","0","0","-2"
"183080","Plymouth State University","2011","Total full-time Instruction/research/public service, Non-tenured not on tenure track, No academic rank","1","0","1","0","0","0","0","0","0","0","0","0","0","0","0","0","0","0","1","0","1","0","0","0","0","0","0","0","0","0","-2"
"183080","Plymouth State University","2011","Total full-time Instruction/research/public service, Non-tenured not on tenure track total","29","12","17","0","0","0","1","0","1","0","0","0","3","1","2","0","0","0","23","10","13","0","0","0","2","1","1","0","0","0","-2"
"185262","Kean University","2011","Total full-time Instruction/research/public service, Tenured, Professors","112","69","43","0","0","0","6","6","0","15","7","8","8","6","2","0","0","0","83","50","33","0","0","0","0","0","0","0","0","0","-2"
"185262","Kean University","2011","Total full-time Instruction/research/public service, Tenured, Associate professors","76","38","38","0","0","0","9","2","7","6","2","4","5","3","2","0","0","0","56","31","25","0","0","0","0","0","0","0","0","0","-2"
"185262","Kean University","2011","Total full-time Instruction/research/public service, Tenured, Assistant professors","71","35","36","0","0","0","9","6","3","8","3","5","7","2","5","0","0","0","45","24","21","0","0","0","0","0","0","2","0","2","-2"
"185262","Kean University","2011","Total full-time Instruction/research/public service, Tenured total","259","142","117","0","0","0","24","14","10","29","12","17","20","11","9","0","0","0","184","105","79","0","0","0","0","0","0","2","0","2","-2"
"185262","Kean University","2011","Total full-time Instruction/research/public service, Non-tenured on tenure track, Professors","1","1","0","0","0","0","0","0","0","0","0","0","0","0","0","0","0","0","1","1","0","0","0","0","0","0","0","0","0","0","-2"
"185262","Kean University","2011","Total full-time Instruction/research/public service, Non-tenured on tenure track, Associate professors","7","5","2","0","0","0","0","0","0","0","0","0","0","0","0","0","0","0","7","5","2","0","0","0","0","0","0","0","0","0","-2"
"185262","Kean University","2011","Total full-time Instruction/research/public service, Non-tenured on tenure track, Assistant professors","55","19","36","0","0","0","8","1","7","3","1","2","2","1","1","0","0","0","32","13","19","0","0","0","0","0","0","10","3","7","-2"
"185262","Kean University","2011","Total full-time Instruction/research/public service, Non-tenured on tenure track total","63","25","38","0","0","0","8","1","7","3","1","2","2","1","1","0","0","0","40","19","21","0","0","0","0","0","0","10","3","7","-2"
"185262","Kean University","2011","Total full-time Instruction/research/public service, Non-tenured not on tenure track, Associate professors","2","1","1","0","0","0","0","0","0","0","0","0","0","0","0","0","0","0","1","1","0","0","0","0","0","0","0","1","0","1","-2"
"185262","Kean University","2011","Total full-time Instruction/research/public servicey, Non-tenured not on tenure track, Assistant professors","6","1","5","0","0","0","0","0","0","1","0","1","0","0","0","0","0","0","5","1","4","0","0","0","0","0","0","0","0","0","-2"
"185262","Kean University","2011","Total full-time Instruction/research/public service, Non-tenured not on tenure track, Lecturers","9","3","6","0","0","0","0","0","0","1","0","1","0","0","0","0","0","0","7","2","5","0","0","0","1","1","0","0","0","0","-2"
"185262","Kean University","2011","Total full-time Instruction/research/public service, Non-tenured not on tenure track total","17","5","12","0","0","0","0","0","0","2","0","2","0","0","0","0","0","0","13","4","9","0","0","0","1","1","0","1","0","1","-2"
"186131","Princeton University","2011","Total full-time Instruction/research/public service, Tenured, Professors","464","370","94","0","0","0","42","37","5","20","13","7","10","9","1","0","0","0","389","308","81","1","1","0","0","0","0","2","2","0","-2"
"186131","Princeton University","2011","Total full-time Instruction/research/public service, Tenured, Associate professors","80","57","23","0","0","0","7","6","1","1","0","1","4","3","1","0","0","0","66","47","19","1","0","1","0","0","0","1","1","0","-2"
"186131","Princeton University","2011","Total full-time Instruction/research/public service, Tenured, Lecturers","1","1","0","0","0","0","0","0","0","0","0","0","0","0","0","0","0","0","1","1","0","0","0","0","0","0","0","0","0","0","-2"
"186131","Princeton University","2011","Total full-time Instruction/research/public service, Tenured total","545","428","117","0","0","0","49","43","6","21","13","8","14","12","2","0","0","0","456","356","100","2","1","1","0","0","0","3","3","0","-2"
"186131","Princeton University","2011","Total full-time Instruction/research/public service, Non-tenured on tenure track, Assistant professors","179","110","69","0","0","0","12","6","6","4","3","1","6","3","3","0","0","0","110","65","45","0","0","0","1","1","0","46","32","14","-2"
"186131","Princeton University","2011","Total full-time Instruction/research/public service, Non-tenured on tenure track total","179","110","69","0","0","0","12","6","6","4","3","1","6","3","3","0","0","0","110","65","45","0","0","0","1","1","0","46","32","14","-2"
"186131","Princeton University","2011","Total full-time Instruction/research/public service, Non-tenured not on tenure track, Instructors","13","11","2","0","0","0","0","0","0","0","0","0","0","0","0","0","0","0","1","1","0","0","0","0","0","0","0","12","10","2","-2"
"186131","Princeton University","2011","Total full-time Instruction/research/public service, Non-tenured not on tenure track, Lecturers","123","58","65","0","0","0","7","2","5","3","3","0","2","0","2","0","0","0","74","38","36","1","0","1","4","1","3","32","14","18","-2"
"186131","Princeton University","2011","Total full-time Instruction/research/public service, Non-tenured not on tenure track total","136","69","67","0","0","0","7","2","5","3","3","0","2","0","2","0","0","0","75","39","36","1","0","1","4","1","3","44","24","20","-2"
"186380","Rutgers University-New Brunswick","2011","Total full-time Instruction/research/public service, Tenured, Professors","746","577","169","0","0","0","83","70","13","19","12","7","13","12","1","1","1","0","621","479","142","1","1","0","5","1","4","3","1","2","-2"
"186380","Rutgers University-New Brunswick","2011","Total full-time Instruction/research/public service, Tenured, Associate professors","456","243","213","3","1","2","56","33","23","19","4","15","16","10","6","0","0","0","344","184","160","2","1","1","3","2","1","13","8","5","-2"
"186380","Rutgers University-New Brunswick","2011","Total full-time Instruction/research/public service, Tenured total","1202","820","382","3","1","2","139","103","36","38","16","22","29","22","7","1","1","0","965","663","302","3","2","1","8","3","5","16","9","7","-2"
"186380","Rutgers University-New Brunswick","2011","Total full-time Instruction/research/public service, Non-tenured on tenure track, Professors","21","15","6","0","0","0","4","3","1","0","0","0","0","0","0","0","0","0","14","9","5","0","0","0","3","3","0","0","0","0","-2"
"186380","Rutgers University-New Brunswick","2011","Total full-time Instruction/research/public service, Non-tenured on tenure track, Associate professors","40","22","18","0","0","0","4","2","2","1","0","1","0","0","0","0","0","0","18","11","7","0","0","0","13","5","8","4","4","0","-2"
"186380","Rutgers University-New Brunswick","2011","Total full-time Instruction/research/public service, Non-tenured on tenure track, Assistant professors","263","128","135","1","1","0","21","12","9","8","3","5","12","4","8","0","0","0","119","52","67","2","0","2","49","24","25","51","32","19","-2"
"186380","Rutgers University-New Brunswick","2011","Total full-time Instruction/research/public service, Non-tenured on tenure track total","324","165","159","1","1","0","29","17","12","9","3","6","12","4","8","0","0","0","151","72","79","2","0","2","65","32","33","55","36","19","-2"
"186380","Rutgers University-New Brunswick","2011","Total full-time Instruction/research/public service, Non-tenured not on tenure track, Professors","12","4","8","0","0","0","1","0","1","0","0","0","1","0","1","0","0","0","3","1","2","0","0","0","6","2","4","1","1","0","-2"
"186380","Rutgers University-New Brunswick","2011","Total full-time Instruction/research/public service, Non-tenured not on tenure track, Associate professors","38","22","16","1","0","1","6","4","2","1","1","0","1","0","1","0","0","0","25","15","10","0","0","0","3","2","1","1","0","1","-2"
"186380","Rutgers University-New Brunswick","2011","Total full-time Instruction/research/public servicey, Non-tenured not on tenure track, Assistant professors","137","68","69","0","0","0","35","18","17","2","0","2","4","2","2","0","0","0","65","30","35","1","1","0","13","3","10","17","14","3","-2"
"186380","Rutgers University-New Brunswick","2011","Total full-time Instruction/research/public service, Non-tenured not on tenure track, Instructors","350","175","175","0","0","0","33","15","18","4","2","2","6","2","4","0","0","0","189","86","103","0","0","0","23","16","7","95","54","41","-2"
"186380","Rutgers University-New Brunswick","2011","Total full-time Instruction/research/public service, Non-tenured not on tenure track, Lecturers","73","39","34","0","0","0","9","5","4","4","4","0","2","1","1","0","0","0","40","20","20","0","0","0","12","5","7","6","4","2","-2"
"186380","Rutgers University-New Brunswick","2011","Total full-time Instruction/research/public service, Non-tenured not on tenure track, No academic rank","351","211","140","0","0","0","22","10","12","2","0","2","4","4","0","0","0","0","58","39","19","2","0","2","123","54","69","140","104","36","-2"
"186380","Rutgers University-New Brunswick","2011","Total full-time Instruction/research/public service, Non-tenured not on tenure track total","961","519","442","1","0","1","106","52","54","13","7","6","18","9","9","0","0","0","380","191","189","3","1","2","180","82","98","260","177","83","-2"
"187967","New Mexico Institute of Mining and Technology","2011","Total full-time Instruction/research/public service, Tenured, Professors","39","36","3","0","0","0","4","4","0","0","0","0","2","2","0","0","0","0","33","30","3","0","0","0","0","0","0","0","0","0","-2"
"187967","New Mexico Institute of Mining and Technology","2011","Total full-time Instruction/research/public service, Tenured, Associate professors","40","31","9","0","0","0","6","6","0","0","0","0","1","1","0","0","0","0","33","24","9","0","0","0","0","0","0","0","0","0","-2"
"187967","New Mexico Institute of Mining and Technology","2011","Total full-time Instruction/research/public service, Tenured, Assistant professors","1","1","0","0","0","0","0","0","0","0","0","0","0","0","0","0","0","0","1","1","0","0","0","0","0","0","0","0","0","0","-2"
"187967","New Mexico Institute of Mining and Technology","2011","Total full-time Instruction/research/public service, Tenured total","80","68","12","0","0","0","10","10","0","0","0","0","3","3","0","0","0","0","67","55","12","0","0","0","0","0","0","0","0","0","-2"
"187967","New Mexico Institute of Mining and Technology","2011","Total full-time Instruction/research/public service, Non-tenured on tenure track, Associate professors","3","3","0","0","0","0","0","0","0","0","0","0","1","1","0","0","0","0","2","2","0","0","0","0","0","0","0","0","0","0","-2"
"187967","New Mexico Institute of Mining and Technology","2011","Total full-time Instruction/research/public service, Non-tenured on tenure track, Assistant professors","20","17","3","0","0","0","5","5","0","0","0","0","2","2","0","0","0","0","13","10","3","0","0","0","0","0","0","0","0","0","-2"
"187967","New Mexico Institute of Mining and Technology","2011","Total full-time Instruction/research/public service, Non-tenured on tenure track total","23","20","3","0","0","0","5","5","0","0","0","0","3","3","0","0","0","0","15","12","3","0","0","0","0","0","0","0","0","0","-2"
"187967","New Mexico Institute of Mining and Technology","2011","Total full-time Instruction/research/public service, Non-tenured not on tenure track, Professors","4","4","0","0","0","0","0","0","0","0","0","0","0","0","0","0","0","0","4","4","0","0","0","0","0","0","0","0","0","0","-2"
"187967","New Mexico Institute of Mining and Technology","2011","Total full-time Instruction/research/public service, Non-tenured not on tenure track, Associate professors","4","3","1","0","0","0","0","0","0","0","0","0","0","0","0","0","0","0","4","3","1","0","0","0","0","0","0","0","0","0","-2"
"187967","New Mexico Institute of Mining and Technology","2011","Total full-time Instruction/research/public servicey, Non-tenured not on tenure track, Assistant professors","4","2","2","0","0","0","3","1","2","0","0","0","0","0","0","0","0","0","1","1","0","0","0","0","0","0","0","0","0","0","-2"
"187967","New Mexico Institute of Mining and Technology","2011","Total full-time Instruction/research/public service, Non-tenured not on tenure track, Instructors","5","2","3","0","0","0","0","0","0","0","0","0","0","0","0","0","0","0","5","2","3","0","0","0","0","0","0","0","0","0","-2"
"187967","New Mexico Institute of Mining and Technology","2011","Total full-time Instruction/research/public service, Non-tenured not on tenure track, Lecturers","2","0","2","0","0","0","0","0","0","0","0","0","0","0","0","0","0","0","2","0","2","0","0","0","0","0","0","0","0","0","-2"
"187967","New Mexico Institute of Mining and Technology","2011","Total full-time Instruction/research/public service, Non-tenured not on tenure track total","19","11","8","0","0","0","3","1","2","0","0","0","0","0","0","0","0","0","16","10","6","0","0","0","0","0","0","0","0","0","-2"
"190150","Columbia University in the City of New York","2011","Total full-time Instruction/research/public service, Tenured, Professors","829","639","190","0","0","0","87","70","17","18","12","6","14","12","2","0","0","0","691","527","164","3","2","1","6","6","0","10","10","0","-2"
"190150","Columbia University in the City of New York","2011","Total full-time Instruction/research/public service, Tenured, Associate professors","157","110","47","1","1","0","24","17","7","8","6","2","5","2","3","0","0","0","118","83","35","0","0","0","0","0","0","1","1","0","-2"
"190150","Columbia University in the City of New York","2011","Total full-time Instruction/research/public service, Tenured total","986","749","237","1","1","0","111","87","24","26","18","8","19","14","5","0","0","0","809","610","199","3","2","1","6","6","0","11","11","0","-2"
"190150","Columbia University in the City of New York","2011","Total full-time Instruction/research/public service, Non-tenured on tenure track, Professors","59","48","11","0","0","0","6","5","1","1","1","0","3","3","0","0","0","0","43","33","10","0","0","0","0","0","0","6","6","0","-2"
"190150","Columbia University in the City of New York","2011","Total full-time Instruction/research/public service, Non-tenured on tenure track, Associate professors","131","84","47","0","0","0","15","11","4","10","5","5","8","6","2","0","0","0","89","54","35","0","0","0","1","1","0","8","7","1","-2"
"190150","Columbia University in the City of New York","2011","Total full-time Instruction/research/public service, Non-tenured on tenure track, Assistant professors","414","245","169","2","1","1","62","31","31","17","7","10","20","9","11","0","0","0","224","132","92","5","3","2","5","4","1","79","58","21","-2"
"190150","Columbia University in the City of New York","2011","Total full-time Instruction/research/public service, Non-tenured on tenure track, Instructors","9","5","4","0","0","0","1","1","0","1","1","0","1","0","1","0","0","0","3","1","2","0","0","0","0","0","0","3","2","1","-2"
"190150","Columbia University in the City of New York","2011","Total full-time Instruction/research/public service, Non-tenured on tenure track, Lecturers","82","54","28","0","0","0","6","5","1","6","4","2","2","2","0","0","0","0","64","41","23","0","0","0","0","0","0","4","2","2","-2"
"190150","Columbia University in the City of New York","2011","Total full-time Instruction/research/public service, Non-tenured on tenure track total","695","436","259","2","1","1","90","53","37","35","18","17","34","20","14","0","0","0","423","261","162","5","3","2","6","5","1","100","75","25","-2"
"190150","Columbia University in the City of New York","2011","Total full-time Instruction/research/public service, Non-tenured not on tenure track, Professors","370","268","102","0","0","0","23","15","8","14","7","7","14","10","4","0","0","0","312","233","79","1","1","0","2","0","2","4","2","2","-2"
"190150","Columbia University in the City of New York","2011","Total full-time Instruction/research/public service, Non-tenured not on tenure track, Associate professors","335","197","138","0","0","0","41","27","14","14","8","6","11","5","6","0","0","0","260","152","108","0","0","0","3","2","1","6","3","3","-2"
"190150","Columbia University in the City of New York","2011","Total full-time Instruction/research/public servicey, Non-tenured not on tenure track, Assistant professors","837","382","455","0","0","0","156","73","83","44","22","22","53","28","25","1","0","1","536","236","300","8","4","4","16","6","10","23","13","10","-2"
"190150","Columbia University in the City of New York","2011","Total full-time Instruction/research/public service, Non-tenured not on tenure track, Instructors","130","46","84","0","0","0","27","9","18","15","3","12","7","2","5","1","0","1","70","27","43","0","0","0","2","0","2","8","5","3","-2"
"190150","Columbia University in the City of New York","2011","Total full-time Instruction/research/public service, Non-tenured not on tenure track, Lecturers","264","110","154","0","0","0","35","18","17","4","4","0","12","4","8","0","0","0","159","62","97","2","0","2","2","1","1","50","21","29","-2"
"190150","Columbia University in the City of New York","2011","Total full-time Instruction/research/public service, Non-tenured not on tenure track total","1936","1003","933","0","0","0","282","142","140","91","44","47","97","49","48","2","0","2","1337","710","627","11","5","6","25","9","16","91","44","47","-2"
"190415","Cornell University","2011","Total full-time Instruction/research/public service, Tenured, Professors","771","608","163","2","2","0","47","42","5","23","16","7","16","10","6","0","0","0","669","526","143","0","0","0","7","6","1","7","6","1","-2"
"190415","Cornell University","2011","Total full-time Instruction/research/public service, Tenured, Associate professors","387","253","134","3","0","3","35","23","12","12","3","9","15","6","9","0","0","0","313","213","100","1","0","1","2","2","0","6","6","0","-2"
"190415","Cornell University","2011","Total full-time Instruction/research/public service, Tenured total","1158","861","297","5","2","3","82","65","17","35","19","16","31","16","15","0","0","0","982","739","243","1","0","1","9","8","1","13","12","1","-2"
"190415","Cornell University","2011","Total full-time Instruction/research/public service, Non-tenured on tenure track, Professors","3","3","0","0","0","0","0","0","0","0","0","0","0","0","0","0","0","0","3","3","0","0","0","0","0","0","0","0","0","0","-2"
"190415","Cornell University","2011","Total full-time Instruction/research/public service, Non-tenured on tenure track, Associate professors","13","9","4","1","1","0","1","0","1","1","0","1","0","0","0","0","0","0","7","5","2","0","0","0","0","0","0","3","3","0","-2"
"190415","Cornell University","2011","Total full-time Instruction/research/public service, Non-tenured on tenure track, Assistant professors","253","162","91","1","1","0","34","24","10","9","7","2","8","6","2","0","0","0","157","94","63","1","0","1","5","4","1","38","26","12","-2"
"190415","Cornell University","2011","Total full-time Instruction/research/public service, Non-tenured on tenure track total","269","174","95","2","2","0","35","24","11","10","7","3","8","6","2","0","0","0","167","102","65","1","0","1","5","4","1","41","29","12","-2"
"190415","Cornell University","2011","Total full-time Instruction/research/public service, Non-tenured not on tenure track, Professors","22","15","7","0","0","0","0","0","0","0","0","0","1","0","1","0","0","0","13","9","4","0","0","0","0","0","0","8","6","2","-2"
"190415","Cornell University","2011","Total full-time Instruction/research/public service, Non-tenured not on tenure track, Associate professors","16","11","5","0","0","0","3","0","3","0","0","0","0","0","0","0","0","0","11","9","2","0","0","0","0","0","0","2","2","0","-2"
"190415","Cornell University","2011","Total full-time Instruction/research/public servicey, Non-tenured not on tenure track, Assistant professors","34","19","15","0","0","0","1","1","0","0","0","0","3","0","3","0","0","0","24","14","10","0","0","0","0","0","0","6","4","2","-2"
"190415","Cornell University","2011","Total full-time Instruction/research/public service, Non-tenured not on tenure track, Instructors","4","2","2","0","0","0","0","0","0","0","0","0","0","0","0","0","0","0","4","2","2","0","0","0","0","0","0","0","0","0","-2"
"190415","Cornell University","2011","Total full-time Instruction/research/public service, Non-tenured not on tenure track, Lecturers","244","110","134","0","0","0","20","4","16","7","4","3","9","6","3","0","0","0","182","88","94","2","0","2","2","0","2","22","8","14","-2"
"190415","Cornell University","2011","Total full-time Instruction/research/public service, Non-tenured not on tenure track total","320","157","163","0","0","0","24","5","19","7","4","3","13","6","7","0","0","0","234","122","112","2","0","2","2","0","2","38","20","18","-2"
"190567","CUNY City College","2011","Total full-time Instruction/research/public service, Tenured, Professors","212","156","56","1","1","0","27","21","6","14","8","6","12","6","6","0","0","0","156","118","38","0","0","0","0","0","0","2","2","0","-2"
"190567","CUNY City College","2011","Total full-time Instruction/research/public service, Tenured, Associate professors","139","76","63","0","0","0","15","13","2","14","7","7","13","6","7","0","0","0","96","49","47","0","0","0","0","0","0","1","1","0","-2"
"190567","CUNY City College","2011","Total full-time Instruction/research/public service, Tenured, Assistant professors","22","13","9","0","0","0","4","3","1","1","1","0","3","2","1","0","0","0","14","7","7","0","0","0","0","0","0","0","0","0","-2"
"190567","CUNY City College","2011","Total full-time Instruction/research/public service, Tenured, Lecturers","5","3","2","0","0","0","1","0","1","2","1","1","1","1","0","0","0","0","1","1","0","0","0","0","0","0","0","0","0","0","-2"
"190567","CUNY City College","2011","Total full-time Instruction/research/public service, Tenured total","378","248","130","1","1","0","47","37","10","31","17","14","29","15","14","0","0","0","267","175","92","0","0","0","0","0","0","3","3","0","-2"
"190567","CUNY City College","2011","Total full-time Instruction/research/public service, Non-tenured on tenure track, Professors","7","4","3","0","0","0","0","0","0","1","0","1","1","1","0","0","0","0","5","3","2","0","0","0","0","0","0","0","0","0","-2"
"190567","CUNY City College","2011","Total full-time Instruction/research/public service, Non-tenured on tenure track, Associate professors","24","14","10","0","0","0","5","1","4","0","0","0","0","0","0","0","0","0","17","13","4","0","0","0","0","0","0","2","0","2","-2"
"190567","CUNY City College","2011","Total full-time Instruction/research/public service, Non-tenured on tenure track, Assistant professors","102","49","53","1","1","0","15","7","8","16","5","11","10","3","7","0","0","0","50","27","23","0","0","0","0","0","0","10","6","4","-2"
"190567","CUNY City College","2011","Total full-time Instruction/research/public service, Non-tenured on tenure track, Lecturers","50","23","27","0","0","0","4","4","0","5","1","4","5","3","2","0","0","0","34","14","20","0","0","0","0","0","0","2","1","1","-2"
"190567","CUNY City College","2011","Total full-time Instruction/research/public service, Non-tenured on tenure track total","183","90","93","1","1","0","24","12","12","22","6","16","16","7","9","0","0","0","106","57","49","0","0","0","0","0","0","14","7","7","-2"
"190567","CUNY City College","2011","Total full-time Instruction/research/public service, Non-tenured not on tenure track, Professors","8","6","2","0","0","0","0","0","0","1","0","1","1","1","0","0","0","0","5","5","0","0","0","0","0","0","0","1","0","1","-2"
"190567","CUNY City College","2011","Total full-time Instruction/research/public service, Non-tenured not on tenure track, Associate professors","1","1","0","0","0","0","1","1","0","0","0","0","0","0","0","0","0","0","0","0","0","0","0","0","0","0","0","0","0","0","-2"
"190567","CUNY City College","2011","Total full-time Instruction/research/public servicey, Non-tenured not on tenure track, Assistant professors","7","5","2","0","0","0","0","0","0","1","0","1","0","0","0","0","0","0","5","4","1","0","0","0","0","0","0","1","1","0","-2"
"190567","CUNY City College","2011","Total full-time Instruction/research/public service, Non-tenured not on tenure track, Instructors","3","0","3","0","0","0","0","0","0","0","0","0","0","0","0","0","0","0","2","0","2","0","0","0","0","0","0","1","0","1","-2"
"190567","CUNY City College","2011","Total full-time Instruction/research/public service, Non-tenured not on tenure track, Lecturers","1","1","0","0","0","0","0","0","0","0","0","0","0","0","0","0","0","0","1","1","0","0","0","0","0","0","0","0","0","0","-2"
"190567","CUNY City College","2011","Total full-time Instruction/research/public service, Non-tenured not on tenure track total","20","13","7","0","0","0","1","1","0","2","0","2","1","1","0","0","0","0","13","10","3","0","0","0","0","0","0","3","1","2","-2"
"190576","CUNY Graduate School and University Center","2011","Total full-time Instruction/research/public service, Tenured, Professors","123","73","50","1","0","1","2","1","1","8","6","2","5","3","2","0","0","0","107","63","44","0","0","0","0","0","0","0","0","0","-2"
"190576","CUNY Graduate School and University Center","2011","Total full-time Instruction/research/public service, Tenured, Associate professors","15","10","5","0","0","0","0","0","0","0","0","0","0","0","0","0","0","0","13","9","4","0","0","0","0","0","0","2","1","1","-2"
"190576","CUNY Graduate School and University Center","2011","Total full-time Instruction/research/public service, Tenured total","138","83","55","1","0","1","2","1","1","8","6","2","5","3","2","0","0","0","120","72","48","0","0","0","0","0","0","2","1","1","-2"
"190576","CUNY Graduate School and University Center","2011","Total full-time Instruction/research/public service, Non-tenured on tenure track, Associate professors","7","6","1","0","0","0","2","1","1","1","1","0","0","0","0","0","0","0","3","3","0","0","0","0","0","0","0","1","1","0","-2"
"190576","CUNY Graduate School and University Center","2011","Total full-time Instruction/research/public service, Non-tenured on tenure track, Assistant professors","6","1","5","0","0","0","0","0","0","0","0","0","1","0","1","0","0","0","4","1","3","0","0","0","0","0","0","1","0","1","-2"
"190576","CUNY Graduate School and University Center","2011","Total full-time Instruction/research/public service, Non-tenured on tenure track total","13","7","6","0","0","0","2","1","1","1","1","0","1","0","1","0","0","0","7","4","3","0","0","0","0","0","0","2","1","1","-2"
"190576","CUNY Graduate School and University Center","2011","Total full-time Instruction/research/public service, Non-tenured not on tenure track, Professors","21","14","7","0","0","0","1","1","0","0","0","0","2","1","1","0","0","0","18","12","6","0","0","0","0","0","0","0","0","0","-2"
"190576","CUNY Graduate School and University Center","2011","Total full-time Instruction/research/public service, Non-tenured not on tenure track, Associate professors","5","3","2","0","0","0","0","0","0","0","0","0","0","0","0","0","0","0","5","3","2","0","0","0","0","0","0","0","0","0","-2"
"190576","CUNY Graduate School and University Center","2011","Total full-time Instruction/research/public servicey, Non-tenured not on tenure track, Assistant professors","13","4","9","0","0","0","0","0","0","2","0","2","0","0","0","0","0","0","11","4","7","0","0","0","0","0","0","0","0","0","-2"
"190576","CUNY Graduate School and University Center","2011","Total full-time Instruction/research/public service, Non-tenured not on tenure track, Lecturers","5","3","2","0","0","0","0","0","0","1","0","1","0","0","0","0","0","0","4","3","1","0","0","0","0","0","0","0","0","0","-2"
"190576","CUNY Graduate School and University Center","2011","Total full-time Instruction/research/public service, Non-tenured not on tenure track total","44","24","20","0","0","0","1","1","0","3","0","3","2","1","1","0","0","0","38","22","16","0","0","0","0","0","0","0","0","0","-2"
"191630","Hobart William Smith Colleges","2011","Total full-time Instruction/research/public service, Tenured, Professors","60","42","18","0","0","0","2","1","1","0","0","0","0","0","0","0","0","0","56","41","15","0","0","0","2","0","2","0","0","0","-2"
"191630","Hobart William Smith Colleges","2011","Total full-time Instruction/research/public service, Tenured, Associate professors","53","31","22","0","0","0","5","4","1","2","1","1","2","2","0","0","0","0","29","16","13","0","0","0","15","8","7","0","0","0","-2"
"191630","Hobart William Smith Colleges","2011","Total full-time Instruction/research/public service, Tenured total","113","73","40","0","0","0","7","5","2","2","1","1","2","2","0","0","0","0","85","57","28","0","0","0","17","8","9","0","0","0","-2"
"191630","Hobart William Smith Colleges","2011","Total full-time Instruction/research/public service, Non-tenured on tenure track, Assistant professors","56","27","29","0","0","0","5","2","3","3","1","2","2","1","1","0","0","0","30","13","17","0","0","0","13","8","5","3","2","1","-2"
"191630","Hobart William Smith Colleges","2011","Total full-time Instruction/research/public service, Non-tenured on tenure track, Instructors","3","2","1","0","0","0","0","0","0","2","2","0","0","0","0","0","0","0","1","0","1","0","0","0","0","0","0","0","0","0","-2"
"191630","Hobart William Smith Colleges","2011","Total full-time Instruction/research/public service, Non-tenured on tenure track total","59","29","30","0","0","0","5","2","3","5","3","2","2","1","1","0","0","0","31","13","18","0","0","0","13","8","5","3","2","1","-2"
"191630","Hobart William Smith Colleges","2011","Total full-time Instruction/research/public service, Non-tenured not on tenure track, Associate professors","1","0","1","0","0","0","0","0","0","0","0","0","0","0","0","0","0","0","1","0","1","0","0","0","0","0","0","0","0","0","-2"
"191630","Hobart William Smith Colleges","2011","Total full-time Instruction/research/public servicey, Non-tenured not on tenure track, Assistant professors","16","6","10","0","0","0","1","1","0","0","0","0","1","1","0","0","0","0","9","2","7","0","0","0","3","1","2","2","1","1","-2"
"191630","Hobart William Smith Colleges","2011","Total full-time Instruction/research/public service, Non-tenured not on tenure track, Instructors","2","0","2","0","0","0","0","0","0","0","0","0","0","0","0","0","0","0","1","0","1","0","0","0","1","0","1","0","0","0","-2"
"191630","Hobart William Smith Colleges","2011","Total full-time Instruction/research/public service, Non-tenured not on tenure track total","19","6","13","0","0","0","1","1","0","0","0","0","1","1","0","0","0","0","11","2","9","0","0","0","4","1","3","2","1","1","-2"
"193900","New York University","2011","Total full-time Instruction/research/public service, Tenured, Professors","916","673","243","0","0","0","53","39","14","25","14","11","39","28","11","0","0","0","786","583","203","2","1","1","0","0","0","11","8","3","-2"
"193900","New York University","2011","Total full-time Instruction/research/public service, Tenured, Associate professors","429","258","171","0","0","0","48","24","24","22","10","12","20","9","11","0","0","0","327","209","118","1","1","0","0","0","0","11","5","6","-2"
"193900","New York University","2011","Total full-time Instruction/research/public service, Tenured, No academic rank","44","18","26","0","0","0","1","0","1","4","1","3","1","0","1","0","0","0","37","17","20","0","0","0","0","0","0","1","0","1","-2"
"193900","New York University","2011","Total full-time Instruction/research/public service, Tenured total","1389","949","440","0","0","0","102","63","39","51","25","26","60","37","23","0","0","0","1150","809","341","3","2","1","0","0","0","23","13","10","-2"
"193900","New York University","2011","Total full-time Instruction/research/public service, Non-tenured on tenure track, Professors","8","4","4","0","0","0","1","0","1","0","0","0","0","0","0","0","0","0","7","4","3","0","0","0","0","0","0","0","0","0","-2"
"193900","New York University","2011","Total full-time Instruction/research/public service, Non-tenured on tenure track, Associate professors","46","29","17","0","0","0","11","8","3","3","2","1","3","2","1","0","0","0","26","16","10","0","0","0","0","0","0","3","1","2","-2"
"193900","New York University","2011","Total full-time Instruction/research/public service, Non-tenured on tenure track, Assistant professors","391","222","169","1","1","0","64","32","32","15","11","4","19","13","6","1","0","1","228","124","104","3","2","1","0","0","0","60","39","21","-2"
"193900","New York University","2011","Total full-time Instruction/research/public service, Non-tenured on tenure track, No academic rank","23","10","13","0","0","0","0","0","0","2","2","0","0","0","0","0","0","0","21","8","13","0","0","0","0","0","0","0","0","0","-2"
"193900","New York University","2011","Total full-time Instruction/research/public service, Non-tenured on tenure track total","468","265","203","1","1","0","76","40","36","20","15","5","22","15","7","1","0","1","282","152","130","3","2","1","0","0","0","63","40","23","-2"
"193900","New York University","2011","Total full-time Instruction/research/public service, Non-tenured not on tenure track, Professors","266","177","89","0","0","0","50","30","20","33","19","14","22","14","8","0","0","0","149","106","43","0","0","0","0","0","0","12","8","4","-2"
"193900","New York University","2011","Total full-time Instruction/research/public service, Non-tenured not on tenure track, Associate professors","258","179","79","0","0","0","30","19","11","11","6","5","9","6","3","1","1","0","200","142","58","1","1","0","0","0","0","6","4","2","-2"
"193900","New York University","2011","Total full-time Instruction/research/public servicey, Non-tenured not on tenure track, Assistant professors","566","309","257","1","1","0","131","63","68","31","13","18","29","14","15","0","0","0","339","200","139","0","0","0","0","0","0","35","18","17","-2"
"193900","New York University","2011","Total full-time Instruction/research/public service, Non-tenured not on tenure track, Instructors","167","83","84","0","0","0","45","24","21","8","2","6","7","4","3","1","1","0","97","46","51","0","0","0","0","0","0","9","6","3","-2"
"193900","New York University","2011","Total full-time Instruction/research/public service, Non-tenured not on tenure track, Lecturers","169","67","102","0","0","0","15","3","12","0","0","0","12","7","5","0","0","0","119","52","67","1","1","0","2","0","2","20","4","16","-2"
"193900","New York University","2011","Total full-time Instruction/research/public service, Non-tenured not on tenure track, No academic rank","1510","749","761","1","0","1","132","57","75","84","27","57","75","24","51","2","1","1","960","488","472","13","4","9","1","0","1","242","148","94","-2"
"193900","New York University","2011","Total full-time Instruction/research/public service, Non-tenured not on tenure track total","2936","1564","1372","2","1","1","403","196","207","167","67","100","154","69","85","4","3","1","1864","1034","830","15","6","9","3","0","3","324","188","136","-2"
"196060","SUNY at Albany","2011","Total full-time Instruction/research/public service, Tenured, Professors","191","155","36","0","0","0","15","14","1","3","3","0","4","3","1","0","0","0","166","132","34","0","0","0","2","2","0","1","1","0","-2"
"196060","SUNY at Albany","2011","Total full-time Instruction/research/public service, Tenured, Associate professors","218","126","92","1","0","1","26","15","11","12","5","7","10","5","5","0","0","0","169","101","68","0","0","0","0","0","0","0","0","0","-2"
"196060","SUNY at Albany","2011","Total full-time Instruction/research/public service, Tenured, Assistant professors","1","1","0","0","0","0","0","0","0","0","0","0","1","1","0","0","0","0","0","0","0","0","0","0","0","0","0","0","0","0","-2"
"196060","SUNY at Albany","2011","Total full-time Instruction/research/public service, Tenured total","410","282","128","1","0","1","41","29","12","15","8","7","15","9","6","0","0","0","335","233","102","0","0","0","2","2","0","1","1","0","-2"
"196060","SUNY at Albany","2011","Total full-time Instruction/research/public service, Non-tenured on tenure track, Professors","3","3","0","0","0","0","2","2","0","0","0","0","1","1","0","0","0","0","0","0","0","0","0","0","0","0","0","0","0","0","-2"
"196060","SUNY at Albany","2011","Total full-time Instruction/research/public service, Non-tenured on tenure track, Associate professors","5","2","3","0","0","0","1","0","1","0","0","0","0","0","0","0","0","0","1","1","0","0","0","0","3","1","2","0","0","0","-2"
"196060","SUNY at Albany","2011","Total full-time Instruction/research/public service, Non-tenured on tenure track, Assistant professors","114","57","57","1","0","1","14","6","8","5","1","4","4","1","3","0","0","0","55","26","29","0","0","0","13","7","6","22","16","6","-2"
"196060","SUNY at Albany","2011","Total full-time Instruction/research/public service, Non-tenured on tenure track total","122","62","60","1","0","1","17","8","9","5","1","4","5","2","3","0","0","0","56","27","29","0","0","0","16","8","8","22","16","6","-2"
"196060","SUNY at Albany","2011","Total full-time Instruction/research/public service, Non-tenured not on tenure track, Professors","3","3","0","0","0","0","0","0","0","1","1","0","0","0","0","0","0","0","1","1","0","0","0","0","1","1","0","0","0","0","-2"
"196060","SUNY at Albany","2011","Total full-time Instruction/research/public service, Non-tenured not on tenure track, Associate professors","5","3","2","0","0","0","0","0","0","2","1","1","0","0","0","0","0","0","2","1","1","0","0","0","0","0","0","1","1","0","-2"
"196060","SUNY at Albany","2011","Total full-time Instruction/research/public servicey, Non-tenured not on tenure track, Assistant professors","22","13","9","0","0","0","3","1","2","0","0","0","0","0","0","0","0","0","10","5","5","0","0","0","2","1","1","7","6","1","-2"
"196060","SUNY at Albany","2011","Total full-time Instruction/research/public service, Non-tenured not on tenure track, Lecturers","29","7","22","0","0","0","1","0","1","1","0","1","2","0","2","0","0","0","22","7","15","0","0","0","0","0","0","3","0","3","-2"
"196060","SUNY at Albany","2011","Total full-time Instruction/research/public service, Non-tenured not on tenure track total","59","26","33","0","0","0","4","1","3","4","2","2","2","0","2","0","0","0","35","14","21","0","0","0","3","2","1","11","7","4","-2"
"196097","Stony Brook University","2011","Total full-time Instruction/research/public service, Tenured, Professors","451","361","90","0","0","0","44","36","8","9","7","2","9","7","2","0","0","0","383","305","78","0","0","0","0","0","0","6","6","0","-2"
"196097","Stony Brook University","2011","Total full-time Instruction/research/public service, Tenured, Associate professors","227","152","75","1","1","0","26","18","8","11","7","4","8","6","2","0","0","0","176","115","61","0","0","0","0","0","0","5","5","0","-2"
"196097","Stony Brook University","2011","Total full-time Instruction/research/public service, Tenured, Assistant professors","2","0","2","0","0","0","0","0","0","0","0","0","0","0","0","0","0","0","2","0","2","0","0","0","0","0","0","0","0","0","-2"
"196097","Stony Brook University","2011","Total full-time Instruction/research/public service, Tenured total","680","513","167","1","1","0","70","54","16","20","14","6","17","13","4","0","0","0","561","420","141","0","0","0","0","0","0","11","11","0","-2"
"196097","Stony Brook University","2011","Total full-time Instruction/research/public service, Non-tenured on tenure track, Professors","4","3","1","0","0","0","1","1","0","0","0","0","0","0","0","0","0","0","2","1","1","0","0","0","0","0","0","1","1","0","-2"
"196097","Stony Brook University","2011","Total full-time Instruction/research/public service, Non-tenured on tenure track, Associate professors","9","5","4","0","0","0","1","1","0","0","0","0","0","0","0","0","0","0","3","1","2","0","0","0","0","0","0","5","3","2","-2"
"196097","Stony Brook University","2011","Total full-time Instruction/research/public service, Non-tenured on tenure track, Assistant professors","193","125","68","0","0","0","28","19","9","5","1","4","4","3","1","0","0","0","93","57","36","0","0","0","2","1","1","61","44","17","-2"
"196097","Stony Brook University","2011","Total full-time Instruction/research/public service, Non-tenured on tenure track total","206","133","73","0","0","0","30","21","9","5","1","4","4","3","1","0","0","0","98","59","39","0","0","0","2","1","1","67","48","19","-2"
"196097","Stony Brook University","2011","Total full-time Instruction/research/public service, Non-tenured not on tenure track, Professors","47","32","15","0","0","0","8","5","3","1","1","0","1","1","0","0","0","0","33","21","12","0","0","0","0","0","0","4","4","0","-2"
"196097","Stony Brook University","2011","Total full-time Instruction/research/public service, Non-tenured not on tenure track, Associate professors","140","85","55","0","0","0","20","10","10","4","1","3","2","1","1","0","0","0","110","71","39","0","0","0","0","0","0","4","2","2","-2"
"196097","Stony Brook University","2011","Total full-time Instruction/research/public servicey, Non-tenured not on tenure track, Assistant professors","335","189","146","0","0","0","49","33","16","13","5","8","11","3","8","0","0","0","199","98","101","0","0","0","1","0","1","62","50","12","-2"
"196097","Stony Brook University","2011","Total full-time Instruction/research/public service, Non-tenured not on tenure track, Instructors","25","10","15","0","0","0","1","0","1","3","1","2","0","0","0","0","0","0","15","4","11","0","0","0","0","0","0","6","5","1","-2"
"196097","Stony Brook University","2011","Total full-time Instruction/research/public service, Non-tenured not on tenure track, Lecturers","124","64","60","0","0","0","15","2","13","3","2","1","1","0","1","0","0","0","87","44","43","0","0","0","0","0","0","18","16","2","-2"
"196097","Stony Brook University","2011","Total full-time Instruction/research/public service, Non-tenured not on tenure track total","671","380","291","0","0","0","93","50","43","24","10","14","15","5","10","0","0","0","444","238","206","0","0","0","1","0","1","94","77","17","-2"
"196121","SUNY College at Brockport","2011","Total full-time Instruction/research/public service, Tenured, Professors","55","39","16","1","0","1","8","8","0","2","2","0","1","0","1","0","0","0","43","29","14","0","0","0","0","0","0","0","0","0","-2"
"196121","SUNY College at Brockport","2011","Total full-time Instruction/research/public service, Tenured, Associate professors","114","62","52","0","0","0","6","5","1","5","3","2","4","3","1","1","1","0","97","50","47","0","0","0","0","0","0","1","0","1","-2"
"196121","SUNY College at Brockport","2011","Total full-time Instruction/research/public service, Tenured, Assistant professors","13","0","13","0","0","0","1","0","1","1","0","1","1","0","1","0","0","0","10","0","10","0","0","0","0","0","0","0","0","0","-2"
"196121","SUNY College at Brockport","2011","Total full-time Instruction/research/public service, Tenured, Instructors","4","1","3","0","0","0","0","0","0","1","1","0","0","0","0","0","0","0","3","0","3","0","0","0","0","0","0","0","0","0","-2"
"196121","SUNY College at Brockport","2011","Total full-time Instruction/research/public service, Tenured total","186","102","84","1","0","1","15","13","2","9","6","3","6","3","3","1","1","0","153","79","74","0","0","0","0","0","0","1","0","1","-2"
"196121","SUNY College at Brockport","2011","Total full-time Instruction/research/public service, Non-tenured on tenure track, Associate professors","21","10","11","0","0","0","3","3","0","0","0","0","1","1","0","0","0","0","17","6","11","0","0","0","0","0","0","0","0","0","-2"
"196121","SUNY College at Brockport","2011","Total full-time Instruction/research/public service, Non-tenured on tenure track, Assistant professors","82","43","39","0","0","0","11","7","4","2","2","0","2","1","1","0","0","0","59","27","32","1","1","0","0","0","0","7","5","2","-2"
"196121","SUNY College at Brockport","2011","Total full-time Instruction/research/public service, Non-tenured on tenure track, Instructors","10","1","9","0","0","0","0","0","0","4","0","4","1","1","0","0","0","0","4","0","4","0","0","0","0","0","0","1","0","1","-2"
"196121","SUNY College at Brockport","2011","Total full-time Instruction/research/public service, Non-tenured on tenure track total","113","54","59","0","0","0","14","10","4","6","2","4","4","3","1","0","0","0","80","33","47","1","1","0","0","0","0","8","5","3","-2"
"196121","SUNY College at Brockport","2011","Total full-time Instruction/research/public service, Non-tenured not on tenure track, Professors","1","1","0","0","0","0","0","0","0","0","0","0","0","0","0","0","0","0","1","1","0","0","0","0","0","0","0","0","0","0","-2"
"196121","SUNY College at Brockport","2011","Total full-time Instruction/research/public service, Non-tenured not on tenure track, Associate professors","2","0","2","0","0","0","0","0","0","0","0","0","0","0","0","0","0","0","2","0","2","0","0","0","0","0","0","0","0","0","-2"
"196121","SUNY College at Brockport","2011","Total full-time Instruction/research/public servicey, Non-tenured not on tenure track, Assistant professors","32","14","18","0","0","0","1","0","1","2","1","1","1","1","0","0","0","0","26","12","14","0","0","0","0","0","0","2","0","2","-2"
"196121","SUNY College at Brockport","2011","Total full-time Instruction/research/public service, Non-tenured not on tenure track, Lecturers","16","6","10","0","0","0","0","0","0","1","1","0","0","0","0","0","0","0","15","5","10","0","0","0","0","0","0","0","0","0","-2"
"196121","SUNY College at Brockport","2011","Total full-time Instruction/research/public service, Non-tenured not on tenure track total","51","21","30","0","0","0","1","0","1","3","2","1","1","1","0","0","0","0","44","18","26","0","0","0","0","0","0","2","0","2","-2"
"196130","SUNY Buffalo State","2011","Total full-time Instruction/research/public service, Tenured, Professors","102","75","27","1","0","1","7","6","1","7","4","3","1","1","0","0","0","0","86","64","22","0","0","0","0","0","0","0","0","0","-2"
"196130","SUNY Buffalo State","2011","Total full-time Instruction/research/public service, Tenured, Associate professors","152","88","64","1","1","0","4","1","3","7","4","3","8","3","5","0","0","0","128","76","52","0","0","0","0","0","0","4","3","1","-2"
"196130","SUNY Buffalo State","2011","Total full-time Instruction/research/public service, Tenured, Assistant professors","5","2","3","1","1","0","1","0","1","0","0","0","0","0","0","0","0","0","3","1","2","0","0","0","0","0","0","0","0","0","-2"
"196130","SUNY Buffalo State","2011","Total full-time Instruction/research/public service, Tenured total","259","165","94","3","2","1","12","7","5","14","8","6","9","4","5","0","0","0","217","141","76","0","0","0","0","0","0","4","3","1","-2"
"196130","SUNY Buffalo State","2011","Total full-time Instruction/research/public service, Non-tenured on tenure track, Associate professors","17","9","8","0","0","0","2","2","0","0","0","0","2","2","0","0","0","0","11","5","6","0","0","0","0","0","0","2","0","2","-2"
"196130","SUNY Buffalo State","2011","Total full-time Instruction/research/public service, Non-tenured on tenure track, Assistant professors","86","30","56","0","0","0","11","3","8","5","3","2","4","0","4","0","0","0","59","19","40","2","2","0","0","0","0","5","3","2","-2"
"196130","SUNY Buffalo State","2011","Total full-time Instruction/research/public service, Non-tenured on tenure track total","103","39","64","0","0","0","13","5","8","5","3","2","6","2","4","0","0","0","70","24","46","2","2","0","0","0","0","7","3","4","-2"
"196130","SUNY Buffalo State","2011","Total full-time Instruction/research/public service, Non-tenured not on tenure track, Professors","1","1","0","0","0","0","0","0","0","0","0","0","0","0","0","0","0","0","1","1","0","0","0","0","0","0","0","0","0","0","-2"
"196130","SUNY Buffalo State","2011","Total full-time Instruction/research/public service, Non-tenured not on tenure track, Associate professors","1","0","1","0","0","0","0","0","0","0","0","0","0","0","0","0","0","0","1","0","1","0","0","0","0","0","0","0","0","0","-2"
"196130","SUNY Buffalo State","2011","Total full-time Instruction/research/public service, Non-tenured not on tenure track, Lecturers","39","15","24","0","0","0","2","1","1","2","1","1","2","1","1","0","0","0","32","12","20","0","0","0","0","0","0","1","0","1","-2"
"196130","SUNY Buffalo State","2011","Total full-time Instruction/research/public service, Non-tenured not on tenure track total","41","16","25","0","0","0","2","1","1","2","1","1","2","1","1","0","0","0","34","13","21","0","0","0","0","0","0","1","0","1","-2"
"196185","SUNY Oneonta","2011","Total full-time Instruction/research/public service, Tenured, Professors","31","24","7","0","0","0","3","3","0","3","1","2","0","0","0","0","0","0","25","20","5","0","0","0","0","0","0","0","0","0","-2"
"196185","SUNY Oneonta","2011","Total full-time Instruction/research/public service, Tenured, Associate professors","71","43","28","0","0","0","10","6","4","1","0","1","1","1","0","0","0","0","59","36","23","0","0","0","0","0","0","0","0","0","-2"
"196185","SUNY Oneonta","2011","Total full-time Instruction/research/public service, Tenured, Assistant professors","15","6","9","0","0","0","2","1","1","0","0","0","0","0","0","0","0","0","13","5","8","0","0","0","0","0","0","0","0","0","-2"
"196185","SUNY Oneonta","2011","Total full-time Instruction/research/public service, Tenured total","117","73","44","0","0","0","15","10","5","4","1","3","1","1","0","0","0","0","97","61","36","0","0","0","0","0","0","0","0","0","-2"
"196185","SUNY Oneonta","2011","Total full-time Instruction/research/public service, Non-tenured on tenure track, Associate professors","12","7","5","0","0","0","3","2","1","0","0","0","0","0","0","0","0","0","9","5","4","0","0","0","0","0","0","0","0","0","-2"
"196185","SUNY Oneonta","2011","Total full-time Instruction/research/public service, Non-tenured on tenure track, Assistant professors","91","48","43","0","0","0","5","1","4","5","2","3","2","1","1","0","0","0","68","40","28","0","0","0","0","0","0","11","4","7","-2"
"196185","SUNY Oneonta","2011","Total full-time Instruction/research/public service, Non-tenured on tenure track total","103","55","48","0","0","0","8","3","5","5","2","3","2","1","1","0","0","0","77","45","32","0","0","0","0","0","0","11","4","7","-2"
"196185","SUNY Oneonta","2011","Total full-time Instruction/research/public service, Non-tenured not on tenure track, Professors","1","1","0","0","0","0","0","0","0","0","0","0","0","0","0","0","0","0","1","1","0","0","0","0","0","0","0","0","0","0","-2"
"196185","SUNY Oneonta","2011","Total full-time Instruction/research/public service, Non-tenured not on tenure track, Lecturers","29","15","14","1","0","1","0","0","0","1","0","1","2","0","2","0","0","0","22","13","9","0","0","0","0","0","0","3","2","1","-2"
"196185","SUNY Oneonta","2011","Total full-time Instruction/research/public service, Non-tenured not on tenure track total","30","16","14","1","0","1","0","0","0","1","0","1","2","0","2","0","0","0","23","14","9","0","0","0","0","0","0","3","2","1","-2"
"196194","SUNY College at Oswego","2011","Total full-time Instruction/research/public service, Tenured, Professors","66","47","19","0","0","0","9","8","1","2","2","0","0","0","0","0","0","0","55","37","18","0","0","0","0","0","0","0","0","0","-2"
"196194","SUNY College at Oswego","2011","Total full-time Instruction/research/public service, Tenured, Associate professors","86","46","40","0","0","0","3","3","0","6","1","5","5","3","2","0","0","0","70","39","31","2","0","2","0","0","0","0","0","0","-2"
"196194","SUNY College at Oswego","2011","Total full-time Instruction/research/public service, Tenured, Assistant professors","16","10","6","0","0","0","1","1","0","1","0","1","0","0","0","0","0","0","14","9","5","0","0","0","0","0","0","0","0","0","-2"
"196194","SUNY College at Oswego","2011","Total full-time Instruction/research/public service, Tenured total","168","103","65","0","0","0","13","12","1","9","3","6","5","3","2","0","0","0","139","85","54","2","0","2","0","0","0","0","0","0","-2"
"196194","SUNY College at Oswego","2011","Total full-time Instruction/research/public service, Non-tenured on tenure track, Professors","1","1","0","0","0","0","1","1","0","0","0","0","0","0","0","0","0","0","0","0","0","0","0","0","0","0","0","0","0","0","-2"
"196194","SUNY College at Oswego","2011","Total full-time Instruction/research/public service, Non-tenured on tenure track, Associate professors","11","7","4","0","0","0","0","0","0","1","1","0","0","0","0","0","0","0","10","6","4","0","0","0","0","0","0","0","0","0","-2"
"196194","SUNY College at Oswego","2011","Total full-time Instruction/research/public service, Non-tenured on tenure track, Assistant professors","72","37","35","1","1","0","4","2","2","5","1","4","3","1","2","1","0","1","54","30","24","0","0","0","0","0","0","4","2","2","-2"
"196194","SUNY College at Oswego","2011","Total full-time Instruction/research/public service, Non-tenured on tenure track, Instructors","2","0","2","0","0","0","0","0","0","0","0","0","0","0","0","0","0","0","2","0","2","0","0","0","0","0","0","0","0","0","-2"
"196194","SUNY College at Oswego","2011","Total full-time Instruction/research/public service, Non-tenured on tenure track total","86","45","41","1","1","0","5","3","2","6","2","4","3","1","2","1","0","1","66","36","30","0","0","0","0","0","0","4","2","2","-2"
"196194","SUNY College at Oswego","2011","Total full-time Instruction/research/public servicey, Non-tenured not on tenure track, Assistant professors","43","22","21","0","0","0","0","0","0","1","1","0","2","1","1","0","0","0","38","20","18","0","0","0","0","0","0","2","0","2","-2"
"196194","SUNY College at Oswego","2011","Total full-time Instruction/research/public service, Non-tenured not on tenure track, Instructors","9","3","6","0","0","0","0","0","0","0","0","0","0","0","0","0","0","0","9","3","6","0","0","0","0","0","0","0","0","0","-2"
"196194","SUNY College at Oswego","2011","Total full-time Instruction/research/public service, Non-tenured not on tenure track, Lecturers","7","4","3","0","0","0","0","0","0","0","0","0","0","0","0","0","0","0","7","4","3","0","0","0","0","0","0","0","0","0","-2"
"196194","SUNY College at Oswego","2011","Total full-time Instruction/research/public service, Non-tenured not on tenure track total","59","29","30","0","0","0","0","0","0","1","1","0","2","1","1","0","0","0","54","27","27","0","0","0","0","0","0","2","0","2","-2"
"196291","SUNY Maritime College","2011","Total full-time Instruction/research/public service, Tenured, Professors","19","14","5","0","0","0","1","1","0","0","0","0","0","0","0","0","0","0","18","13","5","0","0","0","0","0","0","0","0","0","-2"
"196291","SUNY Maritime College","2011","Total full-time Instruction/research/public service, Tenured, Associate professors","8","8","0","0","0","0","0","0","0","0","0","0","0","0","0","0","0","0","8","8","0","0","0","0","0","0","0","0","0","0","-2"
"196291","SUNY Maritime College","2011","Total full-time Instruction/research/public service, Tenured, Assistant professors","3","3","0","0","0","0","0","0","0","0","0","0","0","0","0","0","0","0","3","3","0","0","0","0","0","0","0","0","0","0","-2"
"196291","SUNY Maritime College","2011","Total full-time Instruction/research/public service, Tenured total","30","25","5","0","0","0","1","1","0","0","0","0","0","0","0","0","0","0","29","24","5","0","0","0","0","0","0","0","0","0","-2"
"196291","SUNY Maritime College","2011","Total full-time Instruction/research/public service, Non-tenured on tenure track, Associate professors","5","4","1","0","0","0","0","0","0","0","0","0","0","0","0","0","0","0","4","4","0","0","0","0","0","0","0","1","0","1","-2"
"196291","SUNY Maritime College","2011","Total full-time Instruction/research/public service, Non-tenured on tenure track, Assistant professors","15","10","5","0","0","0","2","1","1","0","0","0","0","0","0","0","0","0","11","7","4","0","0","0","0","0","0","2","2","0","-2"
"196291","SUNY Maritime College","2011","Total full-time Instruction/research/public service, Non-tenured on tenure track total","20","14","6","0","0","0","2","1","1","0","0","0","0","0","0","0","0","0","15","11","4","0","0","0","0","0","0","3","2","1","-2"
"196291","SUNY Maritime College","2011","Total full-time Instruction/research/public service, Non-tenured not on tenure track, Instructors","9","7","2","0","0","0","0","0","0","0","0","0","0","0","0","0","0","0","9","7","2","0","0","0","0","0","0","0","0","0","-2"
"196291","SUNY Maritime College","2011","Total full-time Instruction/research/public service, Non-tenured not on tenure track, Lecturers","38","30","8","0","0","0","0","0","0","2","1","1","0","0","0","0","0","0","34","28","6","0","0","0","0","0","0","2","1","1","-2"
"196291","SUNY Maritime College","2011","Total full-time Instruction/research/public service, Non-tenured not on tenure track total","47","37","10","0","0","0","0","0","0","2","1","1","0","0","0","0","0","0","43","35","8","0","0","0","0","0","0","2","1","1","-2"
"197869","Appalachian State University","2011","Total full-time Instruction/research/public service, Tenured, Professors","271","178","93","1","1","0","3","3","0","3","2","1","6","3","3","0","0","0","252","164","88","1","1","0","3","2","1","2","2","0","-2"
"197869","Appalachian State University","2011","Total full-time Instruction/research/public service, Tenured, Associate professors","194","97","97","3","1","2","3","2","1","8","6","2","3","1","2","0","0","0","165","80","85","2","2","0","1","1","0","9","4","5","-2"
"197869","Appalachian State University","2011","Total full-time Instruction/research/public service, Tenured total","465","275","190","4","2","2","6","5","1","11","8","3","9","4","5","0","0","0","417","244","173","3","3","0","4","3","1","11","6","5","-2"
"197869","Appalachian State University","2011","Total full-time Instruction/research/public service, Non-tenured on tenure track, Associate professors","13","7","6","0","0","0","1","0","1","0","0","0","0","0","0","0","0","0","12","7","5","0","0","0","0","0","0","0","0","0","-2"
"197869","Appalachian State University","2011","Total full-time Instruction/research/public service, Non-tenured on tenure track, Assistant professors","217","105","112","1","1","0","6","4","2","5","3","2","6","3","3","0","0","0","182","87","95","1","0","1","0","0","0","16","7","9","-2"
"197869","Appalachian State University","2011","Total full-time Instruction/research/public service, Non-tenured on tenure track total","230","112","118","1","1","0","7","4","3","5","3","2","6","3","3","0","0","0","194","94","100","1","0","1","0","0","0","16","7","9","-2"
"197869","Appalachian State University","2011","Total full-time Instruction/research/public servicey, Non-tenured not on tenure track, Assistant professors","3","3","0","0","0","0","0","0","0","0","0","0","0","0","0","0","0","0","3","3","0","0","0","0","0","0","0","0","0","0","-2"
"197869","Appalachian State University","2011","Total full-time Instruction/research/public service, Non-tenured not on tenure track, Instructors","12","5","7","0","0","0","0","0","0","0","0","0","1","1","0","0","0","0","10","3","7","0","0","0","0","0","0","1","1","0","-2"
"197869","Appalachian State University","2011","Total full-time Instruction/research/public service, Non-tenured not on tenure track, Lecturers","113","47","66","0","0","0","1","0","1","3","3","0","2","0","2","0","0","0","104","43","61","1","0","1","0","0","0","2","1","1","-2"
"197869","Appalachian State University","2011","Total full-time Instruction/research/public service, Non-tenured not on tenure track, No academic rank","48","22","26","0","0","0","0","0","0","0","0","0","2","1","1","0","0","0","42","20","22","2","0","2","1","0","1","1","1","0","-2"
"197869","Appalachian State University","2011","Total full-time Instruction/research/public service, Non-tenured not on tenure track total","176","77","99","0","0","0","1","0","1","3","3","0","5","2","3","0","0","0","159","69","90","3","0","3","1","0","1","4","3","1","-2"
"198419","Duke University","2011","Total full-time Instruction/research/public service, Tenured, Professors","860","693","167","0","0","0","74","58","16","32","25","7","14","12","2","1","1","0","733","591","142","0","0","0","0","0","0","6","6","0","-2"
"198419","Duke University","2011","Total full-time Instruction/research/public service, Tenured, Associate professors","377","261","116","1","1","0","41","33","8","14","8","6","10","7","3","0","0","0","300","205","95","0","0","0","0","0","0","11","7","4","-2"
"198419","Duke University","2011","Total full-time Instruction/research/public service, Tenured, Assistant professors","3","3","0","0","0","0","2","2","0","0","0","0","0","0","0","0","0","0","1","1","0","0","0","0","0","0","0","0","0","0","-2"
"198419","Duke University","2011","Total full-time Instruction/research/public service, Tenured total","1240","957","283","1","1","0","117","93","24","46","33","13","24","19","5","1","1","0","1034","797","237","0","0","0","0","0","0","17","13","4","-2"
"198419","Duke University","2011","Total full-time Instruction/research/public service, Non-tenured on tenure track, Professors","3","2","1","0","0","0","1","1","0","0","0","0","0","0","0","0","0","0","2","1","1","0","0","0","0","0","0","0","0","0","-2"
"198419","Duke University","2011","Total full-time Instruction/research/public service, Non-tenured on tenure track, Associate professors","100","66","34","0","0","0","14","7","7","4","1","3","5","4","1","0","0","0","73","53","20","0","0","0","0","0","0","4","1","3","-2"
"198419","Duke University","2011","Total full-time Instruction/research/public service, Non-tenured on tenure track, Assistant professors","405","245","160","0","0","0","74","48","26","14","5","9","11","8","3","0","0","0","269","156","113","1","1","0","0","0","0","36","27","9","-2"
"198419","Duke University","2011","Total full-time Instruction/research/public service, Non-tenured on tenure track total","508","313","195","0","0","0","89","56","33","18","6","12","16","12","4","0","0","0","344","210","134","1","1","0","0","0","0","40","28","12","-2"
"198419","Duke University","2011","Total full-time Instruction/research/public service, Non-tenured not on tenure track, Professors","208","150","58","0","0","0","19","15","4","9","6","3","4","3","1","0","0","0","163","117","46","1","0","1","0","0","0","12","9","3","-2"
"198419","Duke University","2011","Total full-time Instruction/research/public service, Non-tenured not on tenure track, Associate professors","298","179","119","0","0","0","42","27","15","12","7","5","4","3","1","0","0","0","234","137","97","0","0","0","0","0","0","6","5","1","-2"
"198419","Duke University","2011","Total full-time Instruction/research/public servicey, Non-tenured not on tenure track, Assistant professors","748","387","361","1","0","1","111","56","55","37","18","19","23","11","12","1","0","1","521","266","255","1","0","1","0","0","0","53","36","17","-2"
"198419","Duke University","2011","Total full-time Instruction/research/public service, Non-tenured not on tenure track, Lecturers","39","13","26","0","0","0","4","1","3","0","0","0","2","1","1","0","0","0","30","9","21","0","0","0","0","0","0","3","2","1","-2"
"198419","Duke University","2011","Total full-time Instruction/research/public service, Non-tenured not on tenure track, No academic rank","471","196","275","1","0","1","61","27","34","19","7","12","16","5","11","0","0","0","330","133","197","1","0","1","0","0","0","43","24","19","-2"
"198419","Duke University","2011","Total full-time Instruction/research/public service, Non-tenured not on tenure track total","1764","925","839","2","0","2","237","126","111","77","38","39","49","23","26","1","0","1","1278","662","616","3","0","3","0","0","0","117","76","41","-2"
"199102","North Carolina A & T State University","2011","Total full-time Instruction/research/public service, Tenured, Professors","100","77","23","2","2","0","15","14","1","44","31","13","1","1","0","0","0","0","30","22","8","0","0","0","2","2","0","6","5","1","-2"
"199102","North Carolina A & T State University","2011","Total full-time Instruction/research/public service, Tenured, Associate professors","162","95","67","0","0","0","18","14","4","96","48","48","2","1","1","0","0","0","44","30","14","0","0","0","0","0","0","2","2","0","-2"
"199102","North Carolina A & T State University","2011","Total full-time Instruction/research/public service, Tenured, Assistant professors","7","4","3","0","0","0","1","1","0","6","3","3","0","0","0","0","0","0","0","0","0","0","0","0","0","0","0","0","0","0","-2"
"199102","North Carolina A & T State University","2011","Total full-time Instruction/research/public service, Tenured total","269","176","93","2","2","0","34","29","5","146","82","64","3","2","1","0","0","0","74","52","22","0","0","0","2","2","0","8","7","1","-2"
"199102","North Carolina A & T State University","2011","Total full-time Instruction/research/public service, Non-tenured on tenure track, Professors","1","0","1","0","0","0","0","0","0","1","0","1","0","0","0","0","0","0","0","0","0","0","0","0","0","0","0","0","0","0","-2"
"199102","North Carolina A & T State University","2011","Total full-time Instruction/research/public service, Non-tenured on tenure track, Associate professors","22","11","11","0","0","0","4","2","2","14","7","7","0","0","0","0","0","0","4","2","2","0","0","0","0","0","0","0","0","0","-2"
"199102","North Carolina A & T State University","2011","Total full-time Instruction/research/public service, Non-tenured on tenure track, Assistant professors","106","55","51","0","0","0","16","10","6","50","19","31","1","1","0","0","0","0","31","17","14","0","0","0","0","0","0","8","8","0","-2"
"199102","North Carolina A & T State University","2011","Total full-time Instruction/research/public service, Non-tenured on tenure track total","129","66","63","0","0","0","20","12","8","65","26","39","1","1","0","0","0","0","35","19","16","0","0","0","0","0","0","8","8","0","-2"
"199102","North Carolina A & T State University","2011","Total full-time Instruction/research/public service, Non-tenured not on tenure track, Professors","1","1","0","0","0","0","0","0","0","1","1","0","0","0","0","0","0","0","0","0","0","0","0","0","0","0","0","0","0","0","-2"
"199102","North Carolina A & T State University","2011","Total full-time Instruction/research/public service, Non-tenured not on tenure track, Associate professors","1","1","0","0","0","0","0","0","0","0","0","0","0","0","0","0","0","0","1","1","0","0","0","0","0","0","0","0","0","0","-2"
"199102","North Carolina A & T State University","2011","Total full-time Instruction/research/public service, Non-tenured not on tenure track, Instructors","3","1","2","0","0","0","0","0","0","2","0","2","0","0","0","0","0","0","1","1","0","0","0","0","0","0","0","0","0","0","-2"
"199102","North Carolina A & T State University","2011","Total full-time Instruction/research/public service, Non-tenured not on tenure track, Lecturers","28","8","20","1","0","1","1","0","1","21","6","15","0","0","0","0","0","0","5","2","3","0","0","0","0","0","0","0","0","0","-2"
"199102","North Carolina A & T State University","2011","Total full-time Instruction/research/public service, Non-tenured not on tenure track, No academic rank","77","31","46","1","0","1","3","3","0","55","20","35","0","0","0","0","0","0","18","8","10","0","0","0","0","0","0","0","0","0","-2"
"199102","North Carolina A & T State University","2011","Total full-time Instruction/research/public service, Non-tenured not on tenure track total","110","42","68","2","0","2","4","3","1","79","27","52","0","0","0","0","0","0","25","12","13","0","0","0","0","0","0","0","0","0","-2"
"199111","University of North Carolina at Asheville","2011","Total full-time Instruction/research/public service, Tenured, Professors","61","41","20","1","1","0","1","1","0","2","1","1","1","1","0","0","0","0","56","37","19","0","0","0","0","0","0","0","0","0","-2"
"199111","University of North Carolina at Asheville","2011","Total full-time Instruction/research/public service, Tenured, Associate professors","65","38","27","0","0","0","5","3","2","4","2","2","1","0","1","0","0","0","55","33","22","0","0","0","0","0","0","0","0","0","-2"
"199111","University of North Carolina at Asheville","2011","Total full-time Instruction/research/public service, Tenured, Assistant professors","1","1","0","0","0","0","0","0","0","1","1","0","0","0","0","0","0","0","0","0","0","0","0","0","0","0","0","0","0","0","-2"
"199111","University of North Carolina at Asheville","2011","Total full-time Instruction/research/public service, Tenured total","127","80","47","1","1","0","6","4","2","7","4","3","2","1","1","0","0","0","111","70","41","0","0","0","0","0","0","0","0","0","-2"
"199111","University of North Carolina at Asheville","2011","Total full-time Instruction/research/public service, Non-tenured on tenure track, Associate professors","1","0","1","0","0","0","0","0","0","1","0","1","0","0","0","0","0","0","0","0","0","0","0","0","0","0","0","0","0","0","-2"
"199111","University of North Carolina at Asheville","2011","Total full-time Instruction/research/public service, Non-tenured on tenure track, Assistant professors","41","19","22","0","0","0","4","1","3","1","1","0","2","0","2","1","0","1","31","16","15","1","0","1","0","0","0","1","1","0","-2"
"199111","University of North Carolina at Asheville","2011","Total full-time Instruction/research/public service, Non-tenured on tenure track, Instructors","1","0","1","0","0","0","0","0","0","0","0","0","0","0","0","0","0","0","1","0","1","0","0","0","0","0","0","0","0","0","-2"
"199111","University of North Carolina at Asheville","2011","Total full-time Instruction/research/public service, Non-tenured on tenure track total","43","19","24","0","0","0","4","1","3","2","1","1","2","0","2","1","0","1","32","16","16","1","0","1","0","0","0","1","1","0","-2"
"199111","University of North Carolina at Asheville","2011","Total full-time Instruction/research/public service, Non-tenured not on tenure track, Lecturers","36","15","21","0","0","0","0","0","0","1","1","0","1","1","0","0","0","0","33","13","20","0","0","0","0","0","0","1","0","1","-2"
"199111","University of North Carolina at Asheville","2011","Total full-time Instruction/research/public service, Non-tenured not on tenure track, No academic rank","5","1","4","0","0","0","0","0","0","2","0","2","0","0","0","0","0","0","2","1","1","0","0","0","0","0","0","1","0","1","-2"
"199111","University of North Carolina at Asheville","2011","Total full-time Instruction/research/public service, Non-tenured not on tenure track total","41","16","25","0","0","0","0","0","0","3","1","2","1","1","0","0","0","0","35","14","21","0","0","0","0","0","0","2","0","2","-2"
"199120","University of North Carolina at Chapel Hill","2011","Total full-time Instruction/research/public service, Tenured, Professors","919","687","232","1","1","0","59","49","10","23","12","11","16","10","6","0","0","0","817","612","205","0","0","0","0","0","0","3","3","0","-2"
"199120","University of North Carolina at Chapel Hill","2011","Total full-time Instruction/research/public service, Tenured, Associate professors","471","281","190","2","1","1","45","28","17","37","14","23","17","11","6","0","0","0","361","221","140","4","4","0","0","0","0","5","2","3","-2"
"199120","University of North Carolina at Chapel Hill","2011","Total full-time Instruction/research/public service, Tenured total","1390","968","422","3","2","1","104","77","27","60","26","34","33","21","12","0","0","0","1178","833","345","4","4","0","0","0","0","8","5","3","-2"
"199120","University of North Carolina at Chapel Hill","2011","Total full-time Instruction/research/public service, Non-tenured on tenure track, Associate professors","27","14","13","0","0","0","2","1","1","2","2","0","2","0","2","0","0","0","20","11","9","0","0","0","0","0","0","1","0","1","-2"
"199120","University of North Carolina at Chapel Hill","2011","Total full-time Instruction/research/public service, Non-tenured on tenure track, Assistant professors","445","247","198","5","2","3","59","35","24","30","8","22","27","15","12","0","0","0","283","159","124","1","0","1","0","0","0","40","28","12","-2"
"199120","University of North Carolina at Chapel Hill","2011","Total full-time Instruction/research/public service, Non-tenured on tenure track total","472","261","211","5","2","3","61","36","25","32","10","22","29","15","14","0","0","0","303","170","133","1","0","1","0","0","0","41","28","13","-2"
"199120","University of North Carolina at Chapel Hill","2011","Total full-time Instruction/research/public service, Non-tenured not on tenure track, Professors","42","27","15","0","0","0","3","3","0","0","0","0","0","0","0","0","0","0","39","24","15","0","0","0","0","0","0","0","0","0","-2"
"199120","University of North Carolina at Chapel Hill","2011","Total full-time Instruction/research/public service, Non-tenured not on tenure track, Associate professors","69","37","32","0","0","0","17","10","7","2","1","1","2","1","1","0","0","0","47","24","23","0","0","0","0","0","0","1","1","0","-2"
"199120","University of North Carolina at Chapel Hill","2011","Total full-time Instruction/research/public servicey, Non-tenured not on tenure track, Assistant professors","195","105","90","0","0","0","38","25","13","4","0","4","7","4","3","0","0","0","120","61","59","1","1","0","0","0","0","25","14","11","-2"
"199120","University of North Carolina at Chapel Hill","2011","Total full-time Instruction/research/public service, Non-tenured not on tenure track, Instructors","26","13","13","0","0","0","6","3","3","1","0","1","0","0","0","0","0","0","15","7","8","0","0","0","0","0","0","4","3","1","-2"
"199120","University of North Carolina at Chapel Hill","2011","Total full-time Instruction/research/public service, Non-tenured not on tenure track, Lecturers","110","39","71","0","0","0","8","4","4","4","1","3","8","4","4","0","0","0","70","26","44","1","0","1","0","0","0","19","4","15","-2"
"199120","University of North Carolina at Chapel Hill","2011","Total full-time Instruction/research/public service, Non-tenured not on tenure track, No academic rank","839","366","473","1","0","1","58","26","32","47","18","29","22","12","10","1","1","0","688","294","394","3","1","2","2","2","0","17","12","5","-2"
"199120","University of North Carolina at Chapel Hill","2011","Total full-time Instruction/research/public service, Non-tenured not on tenure track total","1281","587","694","1","0","1","130","71","59","58","20","38","39","21","18","1","1","0","979","436","543","5","2","3","2","2","0","66","34","32","-2"
"199139","University of North Carolina at Charlotte","2011","Total full-time Instruction/research/public service, Tenured, Professors","213","168","45","0","0","0","21","19","2","5","5","0","4","2","2","0","0","0","179","139","40","0","0","0","4","3","1","0","0","0","-2"
"199139","University of North Carolina at Charlotte","2011","Total full-time Instruction/research/public service, Tenured, Associate professors","292","180","112","0","0","0","38","32","6","20","10","10","8","4","4","0","0","0","212","127","85","0","0","0","1","1","0","13","6","7","-2"
"199139","University of North Carolina at Charlotte","2011","Total full-time Instruction/research/public service, Tenured, Assistant professors","2","1","1","0","0","0","0","0","0","0","0","0","0","0","0","0","0","0","2","1","1","0","0","0","0","0","0","0","0","0","-2"
"199139","University of North Carolina at Charlotte","2011","Total full-time Instruction/research/public service, Tenured total","507","349","158","0","0","0","59","51","8","25","15","10","12","6","6","0","0","0","393","267","126","0","0","0","5","4","1","13","6","7","-2"
"199139","University of North Carolina at Charlotte","2011","Total full-time Instruction/research/public service, Non-tenured on tenure track, Professors","1","1","0","0","0","0","0","0","0","1","1","0","0","0","0","0","0","0","0","0","0","0","0","0","0","0","0","0","0","0","-2"
"199139","University of North Carolina at Charlotte","2011","Total full-time Instruction/research/public service, Non-tenured on tenure track, Associate professors","12","6","6","0","0","0","1","0","1","0","0","0","1","1","0","0","0","0","7","3","4","0","0","0","3","2","1","0","0","0","-2"
"199139","University of North Carolina at Charlotte","2011","Total full-time Instruction/research/public service, Non-tenured on tenure track, Assistant professors","212","108","104","0","0","0","19","14","5","19","9","10","5","1","4","0","0","0","126","66","60","0","0","0","9","2","7","34","16","18","-2"
"199139","University of North Carolina at Charlotte","2011","Total full-time Instruction/research/public service, Non-tenured on tenure track total","225","115","110","0","0","0","20","14","6","20","10","10","6","2","4","0","0","0","133","69","64","0","0","0","12","4","8","34","16","18","-2"
"199139","University of North Carolina at Charlotte","2011","Total full-time Instruction/research/public service, Non-tenured not on tenure track, Lecturers","183","65","118","0","0","0","6","1","5","11","2","9","5","1","4","0","0","0","151","53","98","0","0","0","5","4","1","5","4","1","-2"
"199139","University of North Carolina at Charlotte","2011","Total full-time Instruction/research/public service, Non-tenured not on tenure track, No academic rank","56","18","38","0","0","0","1","1","0","2","0","2","0","0","0","0","0","0","47","14","33","0","0","0","3","2","1","3","1","2","-2"
"199139","University of North Carolina at Charlotte","2011","Total full-time Instruction/research/public service, Non-tenured not on tenure track total","239","83","156","0","0","0","7","2","5","13","2","11","5","1","4","0","0","0","198","67","131","0","0","0","8","6","2","8","5","3","-2"
"199157","North Carolina Central University","2011","Total full-time Instruction/research/public service, Tenured, Professors","65","43","22","0","0","0","7","5","2","40","24","16","0","0","0","0","0","0","17","14","3","0","0","0","1","0","1","0","0","0","-2"
"199157","North Carolina Central University","2011","Total full-time Instruction/research/public service, Tenured, Associate professors","53","29","24","0","0","0","4","3","1","29","16","13","1","1","0","0","0","0","15","6","9","0","0","0","2","1","1","2","2","0","-2"
"199157","North Carolina Central University","2011","Total full-time Instruction/research/public service, Tenured, Assistant professors","11","9","2","0","0","0","0","0","0","6","4","2","0","0","0","0","0","0","5","5","0","0","0","0","0","0","0","0","0","0","-2"
"199157","North Carolina Central University","2011","Total full-time Instruction/research/public service, Tenured total","129","81","48","0","0","0","11","8","3","75","44","31","1","1","0","0","0","0","37","25","12","0","0","0","3","1","2","2","2","0","-2"
"199157","North Carolina Central University","2011","Total full-time Instruction/research/public service, Non-tenured on tenure track, Associate professors","39","20","19","0","0","0","6","4","2","20","10","10","2","1","1","0","0","0","8","3","5","0","0","0","2","1","1","1","1","0","-2"
"199157","North Carolina Central University","2011","Total full-time Instruction/research/public service, Non-tenured on tenure track, Assistant professors","133","55","78","0","0","0","10","4","6","67","20","47","1","1","0","0","0","0","38","19","19","0","0","0","6","2","4","11","9","2","-2"
"199157","North Carolina Central University","2011","Total full-time Instruction/research/public service, Non-tenured on tenure track total","172","75","97","0","0","0","16","8","8","87","30","57","3","2","1","0","0","0","46","22","24","0","0","0","8","3","5","12","10","2","-2"
"199157","North Carolina Central University","2011","Total full-time Instruction/research/public service, Non-tenured not on tenure track, Associate professors","1","1","0","0","0","0","0","0","0","0","0","0","0","0","0","0","0","0","1","1","0","0","0","0","0","0","0","0","0","0","-2"
"199157","North Carolina Central University","2011","Total full-time Instruction/research/public service, Non-tenured not on tenure track, Instructors","4","1","3","0","0","0","0","0","0","2","0","2","0","0","0","0","0","0","1","0","1","0","0","0","0","0","0","1","1","0","-2"
"199157","North Carolina Central University","2011","Total full-time Instruction/research/public service, Non-tenured not on tenure track, Lecturers","5","3","2","0","0","0","0","0","0","3","2","1","1","1","0","0","0","0","1","0","1","0","0","0","0","0","0","0","0","0","-2"
"199157","North Carolina Central University","2011","Total full-time Instruction/research/public service, Non-tenured not on tenure track, No academic rank","114","45","69","0","0","0","4","2","2","68","24","44","1","0","1","0","0","0","34","17","17","0","0","0","5","2","3","2","0","2","-2"
"199157","North Carolina Central University","2011","Total full-time Instruction/research/public service, Non-tenured not on tenure track total","124","50","74","0","0","0","4","2","2","73","26","47","2","1","1","0","0","0","37","18","19","0","0","0","5","2","3","3","1","2","-2"
"199193","North Carolina State University at Raleigh","2011","Total full-time Instruction/research/public service, Tenured, Professors","652","545","107","0","0","0","42","40","2","12","10","2","13","5","8","0","0","0","549","459","90","4","2","2","4","3","1","28","26","2","-2"
"199193","North Carolina State University at Raleigh","2011","Total full-time Instruction/research/public service, Tenured, Associate professors","404","282","122","0","0","0","44","35","9","27","12","15","18","12","6","1","1","0","304","215","89","1","1","0","1","1","0","8","5","3","-2"
"199193","North Carolina State University at Raleigh","2011","Total full-time Instruction/research/public service, Tenured, Assistant professors","3","1","2","0","0","0","0","0","0","0","0","0","0","0","0","0","0","0","3","1","2","0","0","0","0","0","0","0","0","0","-2"
"199193","North Carolina State University at Raleigh","2011","Total full-time Instruction/research/public service, Tenured total","1059","828","231","0","0","0","86","75","11","39","22","17","31","17","14","1","1","0","856","675","181","5","3","2","5","4","1","36","31","5","-2"
"199193","North Carolina State University at Raleigh","2011","Total full-time Instruction/research/public service, Non-tenured on tenure track, Associate professors","18","15","3","0","0","0","5","5","0","1","0","1","1","0","1","0","0","0","10","9","1","0","0","0","0","0","0","1","1","0","-2"
"199193","North Carolina State University at Raleigh","2011","Total full-time Instruction/research/public service, Non-tenured on tenure track, Assistant professors","281","168","113","1","1","0","37","23","14","10","6","4","10","4","6","0","0","0","182","108","74","1","0","1","16","8","8","24","18","6","-2"
"199193","North Carolina State University at Raleigh","2011","Total full-time Instruction/research/public service, Non-tenured on tenure track total","299","183","116","1","1","0","42","28","14","11","6","5","11","4","7","0","0","0","192","117","75","1","0","1","16","8","8","25","19","6","-2"
"199193","North Carolina State University at Raleigh","2011","Total full-time Instruction/research/public service, Non-tenured not on tenure track, Professors","6","6","0","0","0","0","0","0","0","0","0","0","0","0","0","0","0","0","5","5","0","0","0","0","1","1","0","0","0","0","-2"
"199193","North Carolina State University at Raleigh","2011","Total full-time Instruction/research/public service, Non-tenured not on tenure track, Associate professors","24","19","5","0","0","0","3","3","0","0","0","0","1","0","1","0","0","0","19","15","4","0","0","0","0","0","0","1","1","0","-2"
"199193","North Carolina State University at Raleigh","2011","Total full-time Instruction/research/public servicey, Non-tenured not on tenure track, Assistant professors","49","31","18","0","0","0","5","4","1","0","0","0","2","0","2","0","0","0","32","20","12","0","0","0","1","1","0","9","6","3","-2"
"199193","North Carolina State University at Raleigh","2011","Total full-time Instruction/research/public service, Non-tenured not on tenure track, Instructors","5","4","1","0","0","0","0","0","0","0","0","0","0","0","0","0","0","0","3","3","0","1","0","1","0","0","0","1","1","0","-2"
"199193","North Carolina State University at Raleigh","2011","Total full-time Instruction/research/public service, Non-tenured not on tenure track, Lecturers","146","62","84","0","0","0","3","2","1","3","1","2","6","4","2","0","0","0","127","53","74","1","0","1","6","2","4","0","0","0","-2"
"199193","North Carolina State University at Raleigh","2011","Total full-time Instruction/research/public service, Non-tenured not on tenure track, No academic rank","148","66","82","1","0","1","5","2","3","6","2","4","5","1","4","0","0","0","128","59","69","0","0","0","1","1","0","2","1","1","-2"
"199193","North Carolina State University at Raleigh","2011","Total full-time Instruction/research/public service, Non-tenured not on tenure track total","378","188","190","1","0","1","16","11","5","9","3","6","14","5","9","0","0","0","314","155","159","2","0","2","9","5","4","13","9","4","-2"
"199847","Wake Forest University","2011","Total full-time Instruction/research/public service, Tenured, Professors","354","271","83","1","1","0","12","10","2","8","6","2","6","6","0","0","0","0","326","247","79","0","0","0","1","1","0","0","0","0","-2"
"199847","Wake Forest University","2011","Total full-time Instruction/research/public service, Tenured, Associate professors","139","86","53","1","1","0","9","8","1","3","2","1","11","4","7","0","0","0","113","69","44","0","0","0","1","1","0","1","1","0","-2"
"199847","Wake Forest University","2011","Total full-time Instruction/research/public service, Tenured total","493","357","136","2","2","0","21","18","3","11","8","3","17","10","7","0","0","0","439","316","123","0","0","0","2","2","0","1","1","0","-2"
"199847","Wake Forest University","2011","Total full-time Instruction/research/public service, Non-tenured on tenure track, Professors","101","88","13","0","0","0","9","8","1","2","1","1","3","2","1","1","1","0","85","75","10","0","0","0","0","0","0","1","1","0","-2"
"199847","Wake Forest University","2011","Total full-time Instruction/research/public service, Non-tenured on tenure track, Associate professors","209","148","61","0","0","0","23","19","4","6","4","2","3","1","2","0","0","0","172","121","51","0","0","0","1","1","0","4","2","2","-2"
"199847","Wake Forest University","2011","Total full-time Instruction/research/public service, Non-tenured on tenure track, Assistant professors","443","261","182","3","2","1","61","34","27","28","10","18","13","7","6","0","0","0","318","197","121","2","0","2","6","5","1","12","6","6","-2"
"199847","Wake Forest University","2011","Total full-time Instruction/research/public service, Non-tenured on tenure track, Instructors","30","16","14","0","0","0","9","6","3","3","1","2","0","0","0","0","0","0","16","7","9","0","0","0","0","0","0","2","2","0","-2"
"199847","Wake Forest University","2011","Total full-time Instruction/research/public service, Non-tenured on tenure track, Lecturers","1","0","1","0","0","0","0","0","0","0","0","0","0","0","0","0","0","0","1","0","1","0","0","0","0","0","0","0","0","0","-2"
"199847","Wake Forest University","2011","Total full-time Instruction/research/public service, Non-tenured on tenure track, No academic rank","1","1","0","0","0","0","0","0","0","0","0","0","0","0","0","0","0","0","0","0","0","1","1","0","0","0","0","0","0","0","-2"
"199847","Wake Forest University","2011","Total full-time Instruction/research/public service, Non-tenured on tenure track total","785","514","271","3","2","1","102","67","35","39","16","23","19","10","9","1","1","0","592","400","192","3","1","2","7","6","1","19","11","8","-2"
"199847","Wake Forest University","2011","Total full-time Instruction/research/public service, Non-tenured not on tenure track, Professors","5","5","0","0","0","0","0","0","0","0","0","0","1","1","0","0","0","0","3","3","0","0","0","0","0","0","0","1","1","0","-2"
"199847","Wake Forest University","2011","Total full-time Instruction/research/public service, Non-tenured not on tenure track, Associate professors","13","10","3","0","0","0","1","1","0","0","0","0","0","0","0","0","0","0","12","9","3","0","0","0","0","0","0","0","0","0","-2"
"199847","Wake Forest University","2011","Total full-time Instruction/research/public servicey, Non-tenured not on tenure track, Assistant professors","78","44","34","1","0","1","16","9","7","6","3","3","3","3","0","0","0","0","49","26","23","0","0","0","0","0","0","3","3","0","-2"
"199847","Wake Forest University","2011","Total full-time Instruction/research/public service, Non-tenured not on tenure track, Instructors","46","25","21","0","0","0","7","6","1","0","0","0","1","0","1","0","0","0","36","18","18","0","0","0","0","0","0","2","1","1","-2"
"199847","Wake Forest University","2011","Total full-time Instruction/research/public service, Non-tenured not on tenure track, Lecturers","73","31","42","0","0","0","3","1","2","6","4","2","3","1","2","0","0","0","55","25","30","0","0","0","3","0","3","3","0","3","-2"
"199847","Wake Forest University","2011","Total full-time Instruction/research/public service, Non-tenured not on tenure track, No academic rank","125","78","47","0","0","0","2","1","1","9","4","5","2","2","0","0","0","0","104","67","37","0","0","0","0","0","0","8","4","4","-2"
"199847","Wake Forest University","2011","Total full-time Instruction/research/public service, Non-tenured not on tenure track total","340","193","147","1","0","1","29","18","11","21","11","10","10","7","3","0","0","0","259","148","111","0","0","0","3","0","3","17","9","8","-2"
"200280","University of North Dakota","2011","Total full-time Instruction/research/public service, Tenured, Professors","138","102","36","1","1","0","9","8","1","0","0","0","0","0","0","0","0","0","126","92","34","0","0","0","0","0","0","2","1","1","-2"
"200280","University of North Dakota","2011","Total full-time Instruction/research/public service, Tenured, Associate professors","193","124","69","2","1","1","6","6","0","4","3","1","0","0","0","0","0","0","145","84","61","0","0","0","5","5","0","31","25","6","-2"
"200280","University of North Dakota","2011","Total full-time Instruction/research/public service, Tenured, Assistant professors","8","6","2","0","0","0","0","0","0","0","0","0","1","1","0","0","0","0","7","5","2","0","0","0","0","0","0","0","0","0","-2"
"200280","University of North Dakota","2011","Total full-time Instruction/research/public service, Tenured total","339","232","107","3","2","1","15","14","1","4","3","1","1","1","0","0","0","0","278","181","97","0","0","0","5","5","0","33","26","7","-2"
"200280","University of North Dakota","2011","Total full-time Instruction/research/public service, Non-tenured on tenure track, Professors","2","1","1","0","0","0","0","0","0","0","0","0","0","0","0","0","0","0","1","0","1","0","0","0","0","0","0","1","1","0","-2"
"200280","University of North Dakota","2011","Total full-time Instruction/research/public service, Non-tenured on tenure track, Associate professors","14","10","4","0","0","0","1","1","0","0","0","0","0","0","0","0","0","0","8","7","1","0","0","0","0","0","0","5","2","3","-2"
"200280","University of North Dakota","2011","Total full-time Instruction/research/public service, Non-tenured on tenure track, Assistant professors","133","76","57","0","0","0","6","2","4","1","1","0","1","0","1","0","0","0","91","51","40","2","0","2","1","0","1","31","22","9","-2"
"200280","University of North Dakota","2011","Total full-time Instruction/research/public service, Non-tenured on tenure track total","149","87","62","0","0","0","7","3","4","1","1","0","1","0","1","0","0","0","100","58","42","2","0","2","1","0","1","37","25","12","-2"
"200280","University of North Dakota","2011","Total full-time Instruction/research/public service, Non-tenured not on tenure track, Professors","10","7","3","0","0","0","1","1","0","0","0","0","0","0","0","0","0","0","9","6","3","0","0","0","0","0","0","0","0","0","-2"
"200280","University of North Dakota","2011","Total full-time Instruction/research/public service, Non-tenured not on tenure track, Associate professors","40","21","19","1","0","1","0","0","0","0","0","0","0","0","0","0","0","0","38","20","18","0","0","0","1","1","0","0","0","0","-2"
"200280","University of North Dakota","2011","Total full-time Instruction/research/public servicey, Non-tenured not on tenure track, Assistant professors","89","38","51","3","2","1","7","2","5","1","0","1","0","0","0","0","0","0","64","26","38","3","1","2","0","0","0","11","7","4","-2"
"200280","University of North Dakota","2011","Total full-time Instruction/research/public service, Non-tenured not on tenure track, Instructors","31","10","21","0","0","0","1","0","1","1","1","0","0","0","0","0","0","0","29","9","20","0","0","0","0","0","0","0","0","0","-2"
"200280","University of North Dakota","2011","Total full-time Instruction/research/public service, Non-tenured not on tenure track, Lecturers","46","29","17","0","0","0","0","0","0","0","0","0","1","0","1","0","0","0","43","27","16","0","0","0","0","0","0","2","2","0","-2"
"200280","University of North Dakota","2011","Total full-time Instruction/research/public service, Non-tenured not on tenure track, No academic rank","2","2","0","0","0","0","0","0","0","0","0","0","0","0","0","0","0","0","1","1","0","0","0","0","0","0","0","1","1","0","-2"
"200280","University of North Dakota","2011","Total full-time Instruction/research/public service, Non-tenured not on tenure track total","218","107","111","4","2","2","9","3","6","2","1","1","1","0","1","0","0","0","184","89","95","3","1","2","1","1","0","14","10","4","-2"
"201885","University of Cincinnati-Main Campus","2011","Total full-time Instruction/research/public service, Tenured, Professors","527","407","120","1","1","0","65","56","9","23","11","12","8","6","2","0","0","0","423","328","95","0","0","0","6","4","2","1","1","0","-2"
"201885","University of Cincinnati-Main Campus","2011","Total full-time Instruction/research/public service, Tenured, Associate professors","298","180","118","0","0","0","38","25","13","16","9","7","9","6","3","0","0","0","223","132","91","0","0","0","9","6","3","3","2","1","-2"
"201885","University of Cincinnati-Main Campus","2011","Total full-time Instruction/research/public service, Tenured, Assistant professors","12","8","4","0","0","0","2","2","0","1","0","1","0","0","0","0","0","0","8","6","2","0","0","0","1","0","1","0","0","0","-2"
"201885","University of Cincinnati-Main Campus","2011","Total full-time Instruction/research/public service, Tenured, Instructors","1","1","0","0","0","0","0","0","0","0","0","0","0","0","0","0","0","0","1","1","0","0","0","0","0","0","0","0","0","0","-2"
"201885","University of Cincinnati-Main Campus","2011","Total full-time Instruction/research/public service, Tenured total","838","596","242","1","1","0","105","83","22","40","20","20","17","12","5","0","0","0","655","467","188","0","0","0","16","10","6","4","3","1","-2"
"201885","University of Cincinnati-Main Campus","2011","Total full-time Instruction/research/public service, Non-tenured on tenure track, Professors","14","12","2","0","0","0","1","1","0","0","0","0","0","0","0","0","0","0","12","10","2","0","0","0","1","1","0","0","0","0","-2"
"201885","University of Cincinnati-Main Campus","2011","Total full-time Instruction/research/public service, Non-tenured on tenure track, Associate professors","38","26","12","0","0","0","9","6","3","2","2","0","0","0","0","0","0","0","20","13","7","0","0","0","4","4","0","3","1","2","-2"
"201885","University of Cincinnati-Main Campus","2011","Total full-time Instruction/research/public service, Non-tenured on tenure track, Assistant professors","34","18","16","0","0","0","2","1","1","1","0","1","2","0","2","0","0","0","18","12","6","0","0","0","5","3","2","6","2","4","-2"
"201885","University of Cincinnati-Main Campus","2011","Total full-time Instruction/research/public service, Non-tenured on tenure track, Instructors","1","1","0","0","0","0","0","0","0","0","0","0","0","0","0","0","0","0","1","1","0","0","0","0","0","0","0","0","0","0","-2"
"201885","University of Cincinnati-Main Campus","2011","Total full-time Instruction/research/public service, Non-tenured on tenure track, No academic rank","1","1","0","0","0","0","0","0","0","0","0","0","0","0","0","0","0","0","1","1","0","0","0","0","0","0","0","0","0","0","-2"
"201885","University of Cincinnati-Main Campus","2011","Total full-time Instruction/research/public service, Non-tenured on tenure track total","88","58","30","0","0","0","12","8","4","3","2","1","2","0","2","0","0","0","52","37","15","0","0","0","10","8","2","9","3","6","-2"
"201885","University of Cincinnati-Main Campus","2011","Total full-time Instruction/research/public service, Non-tenured not on tenure track, Professors","126","88","38","0","0","0","13","11","2","3","3","0","1","1","0","0","0","0","102","67","35","0","0","0","5","4","1","2","2","0","-2"
"201885","University of Cincinnati-Main Campus","2011","Total full-time Instruction/research/public service, Non-tenured not on tenure track, Associate professors","270","146","124","2","2","0","30","17","13","7","4","3","7","1","6","0","0","0","194","105","89","0","0","0","17","7","10","13","10","3","-2"
"201885","University of Cincinnati-Main Campus","2011","Total full-time Instruction/research/public servicey, Non-tenured not on tenure track, Assistant professors","564","300","264","2","2","0","51","30","21","21","8","13","11","4","7","2","0","2","347","178","169","2","2","0","52","29","23","76","47","29","-2"
"201885","University of Cincinnati-Main Campus","2011","Total full-time Instruction/research/public service, Non-tenured not on tenure track, Instructors","81","24","57","0","0","0","6","2","4","4","1","3","3","0","3","0","0","0","55","16","39","0","0","0","9","3","6","4","2","2","-2"
"201885","University of Cincinnati-Main Campus","2011","Total full-time Instruction/research/public service, Non-tenured not on tenure track, No academic rank","13","6","7","0","0","0","1","0","1","1","0","1","0","0","0","0","0","0","3","2","1","0","0","0","1","0","1","7","4","3","-2"
"201885","University of Cincinnati-Main Campus","2011","Total full-time Instruction/research/public service, Non-tenured not on tenure track total","1054","564","490","4","4","0","101","60","41","36","16","20","22","6","16","2","0","2","701","368","333","2","2","0","84","43","41","102","65","37","-2"
"204796","Ohio State University-Main Campus","2011","Total full-time Instruction/research/public service, Tenured, Professors","1044","820","224","1","0","1","113","100","13","29","19","10","22","17","5","0","0","0","817","631","186","1","1","0","21","20","1","40","32","8","-2"
"204796","Ohio State University-Main Campus","2011","Total full-time Instruction/research/public service, Tenured, Associate professors","809","513","296","0","0","0","80","57","23","41","24","17","29","19","10","0","0","0","600","372","228","7","4","3","9","5","4","43","32","11","-2"
"204796","Ohio State University-Main Campus","2011","Total full-time Instruction/research/public service, Tenured, Assistant professors","44","22","22","0","0","0","0","0","0","1","0","1","0","0","0","0","0","0","42","21","21","0","0","0","1","1","0","0","0","0","-2"
"204796","Ohio State University-Main Campus","2011","Total full-time Instruction/research/public service, Tenured, Instructors","2","1","1","0","0","0","0","0","0","0","0","0","0","0","0","0","0","0","2","1","1","0","0","0","0","0","0","0","0","0","-2"
"204796","Ohio State University-Main Campus","2011","Total full-time Instruction/research/public service, Tenured total","1899","1356","543","1","0","1","193","157","36","71","43","28","51","36","15","0","0","0","1461","1025","436","8","5","3","31","26","5","83","64","19","-2"
"204796","Ohio State University-Main Campus","2011","Total full-time Instruction/research/public service, Non-tenured on tenure track, Professors","1","1","0","0","0","0","0","0","0","0","0","0","0","0","0","0","0","0","0","0","0","0","0","0","0","0","0","1","1","0","-2"
"204796","Ohio State University-Main Campus","2011","Total full-time Instruction/research/public service, Non-tenured on tenure track, Associate professors","23","14","9","0","0","0","7","5","2","0","0","0","2","2","0","0","0","0","10","5","5","0","0","0","4","2","2","0","0","0","-2"
"204796","Ohio State University-Main Campus","2011","Total full-time Instruction/research/public service, Non-tenured on tenure track, Assistant professors","584","341","243","0","0","0","76","50","26","24","10","14","19","8","11","1","0","1","361","205","156","3","1","2","29","21","8","71","46","25","-2"
"204796","Ohio State University-Main Campus","2011","Total full-time Instruction/research/public service, Non-tenured on tenure track, Instructors","3","2","1","0","0","0","0","0","0","0","0","0","0","0","0","0","0","0","2","1","1","0","0","0","1","1","0","0","0","0","-2"
"204796","Ohio State University-Main Campus","2011","Total full-time Instruction/research/public service, Non-tenured on tenure track total","611","358","253","0","0","0","83","55","28","24","10","14","21","10","11","1","0","1","373","211","162","3","1","2","34","24","10","72","47","25","-2"
"204796","Ohio State University-Main Campus","2011","Total full-time Instruction/research/public service, Non-tenured not on tenure track, Professors","90","68","22","0","0","0","7","6","1","2","1","1","1","1","0","0","0","0","75","55","20","0","0","0","3","3","0","2","2","0","-2"
"204796","Ohio State University-Main Campus","2011","Total full-time Instruction/research/public service, Non-tenured not on tenure track, Associate professors","211","128","83","1","0","1","14","7","7","5","3","2","4","3","1","0","0","0","163","95","68","0","0","0","13","11","2","11","9","2","-2"
"204796","Ohio State University-Main Campus","2011","Total full-time Instruction/research/public servicey, Non-tenured not on tenure track, Assistant professors","570","321","249","1","0","1","103","47","56","20","10","10","21","12","9","0","0","0","370","216","154","0","0","0","24","18","6","31","18","13","-2"
"204796","Ohio State University-Main Campus","2011","Total full-time Instruction/research/public service, Non-tenured not on tenure track, Instructors","2","1","1","0","0","0","0","0","0","0","0","0","0","0","0","0","0","0","2","1","1","0","0","0","0","0","0","0","0","0","-2"
"204796","Ohio State University-Main Campus","2011","Total full-time Instruction/research/public service, Non-tenured not on tenure track total","873","518","355","2","0","2","124","60","64","27","14","13","26","16","10","0","0","0","610","367","243","0","0","0","40","32","8","44","29","15","-2"
"204857","Ohio University-Main Campus","2011","Total full-time Instruction/research/public service, Tenured, Professors","222","166","56","3","2","1","22","21","1","8","6","2","6","4","2","0","0","0","176","127","49","0","0","0","1","1","0","6","5","1","-2"
"204857","Ohio University-Main Campus","2011","Total full-time Instruction/research/public service, Tenured, Associate professors","326","213","113","3","1","2","21","16","5","17","13","4","10","7","3","0","0","0","260","167","93","5","2","3","1","0","1","9","7","2","-2"
"204857","Ohio University-Main Campus","2011","Total full-time Instruction/research/public service, Tenured, Assistant professors","11","7","4","0","0","0","0","0","0","2","1","1","0","0","0","0","0","0","9","6","3","0","0","0","0","0","0","0","0","0","-2"
"204857","Ohio University-Main Campus","2011","Total full-time Instruction/research/public service, Tenured total","559","386","173","6","3","3","43","37","6","27","20","7","16","11","5","0","0","0","445","300","145","5","2","3","2","1","1","15","12","3","-2"
"204857","Ohio University-Main Campus","2011","Total full-time Instruction/research/public service, Non-tenured on tenure track, Associate professors","8","4","4","0","0","0","1","1","0","1","1","0","0","0","0","0","0","0","5","2","3","0","0","0","1","0","1","0","0","0","-2"
"204857","Ohio University-Main Campus","2011","Total full-time Instruction/research/public service, Non-tenured on tenure track, Assistant professors","181","102","79","0","0","0","14","7","7","13","7","6","7","4","3","0","0","0","96","50","46","0","0","0","24","15","9","27","19","8","-2"
"204857","Ohio University-Main Campus","2011","Total full-time Instruction/research/public service, Non-tenured on tenure track total","189","106","83","0","0","0","15","8","7","14","8","6","7","4","3","0","0","0","101","52","49","0","0","0","25","15","10","27","19","8","-2"
"204857","Ohio University-Main Campus","2011","Total full-time Instruction/research/public service, Non-tenured not on tenure track, Professors","6","2","4","0","0","0","1","0","1","0","0","0","0","0","0","0","0","0","1","0","1","0","0","0","3","1","2","1","1","0","-2"
"204857","Ohio University-Main Campus","2011","Total full-time Instruction/research/public service, Non-tenured not on tenure track, Associate professors","7","4","3","0","0","0","1","0","1","1","1","0","0","0","0","0","0","0","4","2","2","0","0","0","1","1","0","0","0","0","-2"
"204857","Ohio University-Main Campus","2011","Total full-time Instruction/research/public servicey, Non-tenured not on tenure track, Assistant professors","75","40","35","0","0","0","2","0","2","0","0","0","2","2","0","0","0","0","40","21","19","0","0","0","23","12","11","8","5","3","-2"
"204857","Ohio University-Main Campus","2011","Total full-time Instruction/research/public service, Non-tenured not on tenure track, Instructors","60","21","39","0","0","0","0","0","0","0","0","0","0","0","0","0","0","0","42","16","26","0","0","0","12","5","7","6","0","6","-2"
"204857","Ohio University-Main Campus","2011","Total full-time Instruction/research/public service, Non-tenured not on tenure track, Lecturers","15","9","6","0","0","0","1","1","0","0","0","0","0","0","0","0","0","0","11","7","4","0","0","0","2","0","2","1","1","0","-2"
"204857","Ohio University-Main Campus","2011","Total full-time Instruction/research/public service, Non-tenured not on tenure track, No academic rank","22","8","14","0","0","0","0","0","0","0","0","0","0","0","0","0","0","0","9","4","5","0","0","0","10","3","7","3","1","2","-2"
"204857","Ohio University-Main Campus","2011","Total full-time Instruction/research/public service, Non-tenured not on tenure track total","185","84","101","0","0","0","5","1","4","1","1","0","2","2","0","0","0","0","107","50","57","0","0","0","51","22","29","19","8","11","-2"
"207500","University of Oklahoma-Norman Campus","2011","Total full-time Instruction/research/public service, Tenured, Professors","388","317","71","5","3","2","46","40","6","3","2","1","15","12","3","0","0","0","311","252","59","0","0","0","3","3","0","5","5","0","-2"
"207500","University of Oklahoma-Norman Campus","2011","Total full-time Instruction/research/public service, Tenured, Associate professors","293","179","114","9","6","3","16","11","5","12","6","6","5","0","5","0","0","0","222","136","86","2","1","1","6","6","0","21","13","8","-2"
"207500","University of Oklahoma-Norman Campus","2011","Total full-time Instruction/research/public service, Tenured total","681","496","185","14","9","5","62","51","11","15","8","7","20","12","8","0","0","0","533","388","145","2","1","1","9","9","0","26","18","8","-2"
"207500","University of Oklahoma-Norman Campus","2011","Total full-time Instruction/research/public service, Non-tenured on tenure track, Associate professors","18","10","8","0","0","0","2","2","0","1","0","1","0","0","0","0","0","0","12","6","6","0","0","0","0","0","0","3","2","1","-2"
"207500","University of Oklahoma-Norman Campus","2011","Total full-time Instruction/research/public service, Non-tenured on tenure track, Assistant professors","225","133","92","7","3","4","15","8","7","7","5","2","6","4","2","1","0","1","139","79","60","3","0","3","9","7","2","38","27","11","-2"
"207500","University of Oklahoma-Norman Campus","2011","Total full-time Instruction/research/public service, Non-tenured on tenure track total","243","143","100","7","3","4","17","10","7","8","5","3","6","4","2","1","0","1","151","85","66","3","0","3","9","7","2","41","29","12","-2"
"207500","University of Oklahoma-Norman Campus","2011","Total full-time Instruction/research/public service, Non-tenured not on tenure track, Professors","8","7","1","0","0","0","1","1","0","0","0","0","0","0","0","0","0","0","6","5","1","1","1","0","0","0","0","0","0","0","-2"
"207500","University of Oklahoma-Norman Campus","2011","Total full-time Instruction/research/public service, Non-tenured not on tenure track, Associate professors","17","5","12","0","0","0","1","0","1","4","0","4","0","0","0","0","0","0","11","5","6","0","0","0","0","0","0","1","0","1","-2"
"207500","University of Oklahoma-Norman Campus","2011","Total full-time Instruction/research/public servicey, Non-tenured not on tenure track, Assistant professors","58","25","33","2","2","0","0","0","0","3","1","2","1","0","1","0","0","0","50","22","28","0","0","0","1","0","1","1","0","1","-2"
"207500","University of Oklahoma-Norman Campus","2011","Total full-time Instruction/research/public service, Non-tenured not on tenure track, Instructors","103","44","59","11","6","5","3","1","2","1","0","1","10","2","8","0","0","0","67","32","35","0","0","0","2","1","1","9","2","7","-2"
"207500","University of Oklahoma-Norman Campus","2011","Total full-time Instruction/research/public service, Non-tenured not on tenure track, Lecturers","50","32","18","0","0","0","0","0","0","0","0","0","2","0","2","0","0","0","36","23","13","0","0","0","1","1","0","11","8","3","-2"
"207500","University of Oklahoma-Norman Campus","2011","Total full-time Instruction/research/public service, Non-tenured not on tenure track, No academic rank","277","195","82","3","1","2","20","14","6","2","1","1","7","5","2","0","0","0","121","86","35","3","0","3","1","0","1","120","88","32","-2"
"207500","University of Oklahoma-Norman Campus","2011","Total full-time Instruction/research/public service, Non-tenured not on tenure track total","513","308","205","16","9","7","25","16","9","10","2","8","20","7","13","0","0","0","291","173","118","4","1","3","5","2","3","142","98","44","-2"
"207971","University of Tulsa","2011","Total full-time Instruction/research/public service, Tenured, Professors","102","85","17","5","4","1","8","8","0","1","1","0","1","1","0","0","0","0","86","70","16","0","0","0","1","1","0","0","0","0","-2"
"207971","University of Tulsa","2011","Total full-time Instruction/research/public service, Tenured, Associate professors","77","52","25","4","2","2","4","3","1","1","0","1","2","2","0","0","0","0","63","42","21","0","0","0","1","1","0","2","2","0","-2"
"207971","University of Tulsa","2011","Total full-time Instruction/research/public service, Tenured total","179","137","42","9","6","3","12","11","1","2","1","1","3","3","0","0","0","0","149","112","37","0","0","0","2","2","0","2","2","0","-2"
"207971","University of Tulsa","2011","Total full-time Instruction/research/public service, Non-tenured on tenure track, Associate professors","1","1","0","0","0","0","0","0","0","0","0","0","0","0","0","0","0","0","0","0","0","0","0","0","0","0","0","1","1","0","-2"
"207971","University of Tulsa","2011","Total full-time Instruction/research/public service, Non-tenured on tenure track, Assistant professors","60","43","17","0","0","0","4","4","0","1","0","1","2","0","2","0","0","0","43","33","10","0","0","0","0","0","0","10","6","4","-2"
"207971","University of Tulsa","2011","Total full-time Instruction/research/public service, Non-tenured on tenure track total","61","44","17","0","0","0","4","4","0","1","0","1","2","0","2","0","0","0","43","33","10","0","0","0","0","0","0","11","7","4","-2"
"207971","University of Tulsa","2011","Total full-time Instruction/research/public service, Non-tenured not on tenure track, Professors","13","6","7","2","1","1","0","0","0","0","0","0","1","0","1","0","0","0","10","5","5","0","0","0","0","0","0","0","0","0","-2"
"207971","University of Tulsa","2011","Total full-time Instruction/research/public service, Non-tenured not on tenure track, Associate professors","13","6","7","2","2","0","0","0","0","0","0","0","0","0","0","0","0","0","11","4","7","0","0","0","0","0","0","0","0","0","-2"
"207971","University of Tulsa","2011","Total full-time Instruction/research/public servicey, Non-tenured not on tenure track, Assistant professors","26","10","16","5","1","4","1","0","1","1","0","1","0","0","0","0","0","0","17","7","10","0","0","0","1","1","0","1","1","0","-2"
"207971","University of Tulsa","2011","Total full-time Instruction/research/public service, Non-tenured not on tenure track, Instructors","21","7","14","1","0","1","0","0","0","0","0","0","4","0","4","0","0","0","15","7","8","0","0","0","0","0","0","1","0","1","-2"
"207971","University of Tulsa","2011","Total full-time Instruction/research/public service, Non-tenured not on tenure track, No academic rank","2","1","1","0","0","0","0","0","0","0","0","0","0","0","0","0","0","0","2","1","1","0","0","0","0","0","0","0","0","0","-2"
"207971","University of Tulsa","2011","Total full-time Instruction/research/public service, Non-tenured not on tenure track total","75","30","45","10","4","6","1","0","1","1","0","1","5","0","5","0","0","0","55","24","31","0","0","0","1","1","0","2","1","1","-2"
"209542","Oregon State University","2011","Total full-time Instruction/research/public service, Tenured, Professors","278","208","70","0","0","0","16","13","3","1","0","1","7","6","1","0","0","0","236","174","62","1","1","0","10","7","3","7","7","0","209542"
"209542","Oregon State University","2011","Total full-time Instruction/research/public service, Tenured, Associate professors","260","151","109","3","1","2","32","19","13","4","4","0","10","6","4","0","0","0","183","103","80","1","1","0","10","3","7","17","14","3","209542"
"209542","Oregon State University","2011","Total full-time Instruction/research/public service, Tenured, Assistant professors","7","6","1","0","0","0","0","0","0","0","0","0","1","1","0","0","0","0","6","5","1","0","0","0","0","0","0","0","0","0","209542"
"209542","Oregon State University","2011","Total full-time Instruction/research/public service, Tenured, Instructors","8","4","4","0","0","0","1","0","1","0","0","0","1","0","1","0","0","0","5","4","1","0","0","0","0","0","0","1","0","1","209542"
"209542","Oregon State University","2011","Total full-time Instruction/research/public service, Tenured total","553","369","184","3","1","2","49","32","17","5","4","1","19","13","6","0","0","0","430","286","144","2","2","0","20","10","10","25","21","4","209542"
"209542","Oregon State University","2011","Total full-time Instruction/research/public service, Non-tenured on tenure track, Professors","1","1","0","0","0","0","0","0","0","0","0","0","0","0","0","0","0","0","1","1","0","0","0","0","0","0","0","0","0","0","209542"
"209542","Oregon State University","2011","Total full-time Instruction/research/public service, Non-tenured on tenure track, Associate professors","30","23","7","0","0","0","0","0","0","0","0","0","1","0","1","0","0","0","23","18","5","0","0","0","4","3","1","2","2","0","209542"
"209542","Oregon State University","2011","Total full-time Instruction/research/public service, Non-tenured on tenure track, Assistant professors","217","130","87","0","0","0","20","12","8","2","2","0","13","5","8","0","0","0","136","77","59","0","0","0","13","9","4","33","25","8","209542"
"209542","Oregon State University","2011","Total full-time Instruction/research/public service, Non-tenured on tenure track total","248","154","94","0","0","0","20","12","8","2","2","0","14","5","9","0","0","0","160","96","64","0","0","0","17","12","5","35","27","8","209542"
"209542","Oregon State University","2011","Total full-time Instruction/research/public service, Non-tenured not on tenure track, Professors","14","10","4","0","0","0","2","2","0","1","0","1","0","0","0","0","0","0","10","8","2","0","0","0","1","0","1","0","0","0","209542"
"209542","Oregon State University","2011","Total full-time Instruction/research/public service, Non-tenured not on tenure track, Associate professors","29","18","11","0","0","0","2","1","1","0","0","0","1","1","0","0","0","0","19","12","7","0","0","0","3","2","1","4","2","2","209542"
"209542","Oregon State University","2011","Total full-time Instruction/research/public servicey, Non-tenured not on tenure track, Assistant professors","79","49","30","0","0","0","5","4","1","0","0","0","4","3","1","0","0","0","57","32","25","0","0","0","4","3","1","9","7","2","209542"
"209542","Oregon State University","2011","Total full-time Instruction/research/public service, Non-tenured not on tenure track, Instructors","286","130","156","4","1","3","9","4","5","3","1","2","12","2","10","0","0","0","237","109","128","0","0","0","7","4","3","14","9","5","209542"
"209542","Oregon State University","2011","Total full-time Instruction/research/public service, Non-tenured not on tenure track, No academic rank","465","270","195","3","1","2","12","6","6","3","1","2","10","7","3","2","0","2","353","207","146","1","1","0","15","10","5","66","37","29","209542"
"209542","Oregon State University","2011","Total full-time Instruction/research/public service, Non-tenured not on tenure track total","873","477","396","7","2","5","30","17","13","7","2","5","27","13","14","2","0","2","676","368","308","1","1","0","30","19","11","93","55","38","209542"
"211361","California University of Pennsylvania","2011","Total full-time Instruction/research/public service, Tenured, Professors","86","53","33","0","0","0","4","4","0","6","3","3","0","0","0","0","0","0","76","46","30","0","0","0","0","0","0","0","0","0","-2"
"211361","California University of Pennsylvania","2011","Total full-time Instruction/research/public service, Tenured, Associate professors","59","34","25","0","0","0","3","2","1","3","1","2","1","0","1","0","0","0","51","31","20","1","0","1","0","0","0","0","0","0","-2"
"211361","California University of Pennsylvania","2011","Total full-time Instruction/research/public service, Tenured, Assistant professors","21","12","9","0","0","0","0","0","0","1","1","0","2","1","1","0","0","0","18","10","8","0","0","0","0","0","0","0","0","0","-2"
"211361","California University of Pennsylvania","2011","Total full-time Instruction/research/public service, Tenured, Instructors","1","0","1","0","0","0","0","0","0","0","0","0","0","0","0","0","0","0","1","0","1","0","0","0","0","0","0","0","0","0","-2"
"211361","California University of Pennsylvania","2011","Total full-time Instruction/research/public service, Tenured total","167","99","68","0","0","0","7","6","1","10","5","5","3","1","2","0","0","0","146","87","59","1","0","1","0","0","0","0","0","0","-2"
"211361","California University of Pennsylvania","2011","Total full-time Instruction/research/public service, Non-tenured on tenure track, Professors","2","0","2","0","0","0","0","0","0","0","0","0","0","0","0","0","0","0","2","0","2","0","0","0","0","0","0","0","0","0","-2"
"211361","California University of Pennsylvania","2011","Total full-time Instruction/research/public service, Non-tenured on tenure track, Associate professors","23","12","11","0","0","0","0","0","0","4","2","2","0","0","0","0","0","0","18","10","8","0","0","0","0","0","0","1","0","1","-2"
"211361","California University of Pennsylvania","2011","Total full-time Instruction/research/public service, Non-tenured on tenure track, Assistant professors","46","17","29","0","0","0","3","1","2","4","2","2","0","0","0","0","0","0","38","14","24","0","0","0","0","0","0","1","0","1","-2"
"211361","California University of Pennsylvania","2011","Total full-time Instruction/research/public service, Non-tenured on tenure track, Instructors","3","0","3","0","0","0","0","0","0","0","0","0","0","0","0","0","0","0","3","0","3","0","0","0","0","0","0","0","0","0","-2"
"211361","California University of Pennsylvania","2011","Total full-time Instruction/research/public service, Non-tenured on tenure track total","74","29","45","0","0","0","3","1","2","8","4","4","0","0","0","0","0","0","61","24","37","0","0","0","0","0","0","2","0","2","-2"
"211361","California University of Pennsylvania","2011","Total full-time Instruction/research/public servicey, Non-tenured not on tenure track, Assistant professors","8","4","4","0","0","0","1","1","0","2","1","1","0","0","0","0","0","0","5","2","3","0","0","0","0","0","0","0","0","0","-2"
"211361","California University of Pennsylvania","2011","Total full-time Instruction/research/public service, Non-tenured not on tenure track, Instructors","21","8","13","0","0","0","1","0","1","2","1","1","1","0","1","0","0","0","17","7","10","0","0","0","0","0","0","0","0","0","-2"
"211361","California University of Pennsylvania","2011","Total full-time Instruction/research/public service, Non-tenured not on tenure track total","29","12","17","0","0","0","2","1","1","4","2","2","1","0","1","0","0","0","22","9","13","0","0","0","0","0","0","0","0","0","-2"
"212054","Drexel University","2011","Total full-time Instruction/research/public service, Tenured, Professors","242","197","45","0","0","0","35","32","3","7","7","0","2","1","1","0","0","0","183","146","37","2","2","0","12","8","4","1","1","0","-2"
"212054","Drexel University","2011","Total full-time Instruction/research/public service, Tenured, Associate professors","202","124","78","1","1","0","35","26","9","5","2","3","6","2","4","0","0","0","143","87","56","1","0","1","10","6","4","1","0","1","-2"
"212054","Drexel University","2011","Total full-time Instruction/research/public service, Tenured total","444","321","123","1","1","0","70","58","12","12","9","3","8","3","5","0","0","0","326","233","93","3","2","1","22","14","8","2","1","1","-2"
"212054","Drexel University","2011","Total full-time Instruction/research/public service, Non-tenured on tenure track, Assistant professors","210","115","95","0","0","0","19","11","8","8","2","6","5","3","2","0","0","0","120","65","55","1","1","0","32","18","14","25","15","10","-2"
"212054","Drexel University","2011","Total full-time Instruction/research/public service, Non-tenured on tenure track total","210","115","95","0","0","0","19","11","8","8","2","6","5","3","2","0","0","0","120","65","55","1","1","0","32","18","14","25","15","10","-2"
"212054","Drexel University","2011","Total full-time Instruction/research/public service, Non-tenured not on tenure track, Instructors","724","362","362","4","2","2","56","29","27","29","15","14","13","4","9","0","0","0","529","263","266","2","1","1","59","31","28","32","17","15","-2"
"212054","Drexel University","2011","Total full-time Instruction/research/public service, Non-tenured not on tenure track total","724","362","362","4","2","2","56","29","27","29","15","14","13","4","9","0","0","0","529","263","266","2","1","1","59","31","28","32","17","15","-2"
"213598","Lincoln University","2011","Total full-time Instruction/research/public service, Tenured, Professors","29","24","5","0","0","0","4","4","0","13","11","2","0","0","0","0","0","0","10","7","3","0","0","0","2","2","0","0","0","0","-2"
"213598","Lincoln University","2011","Total full-time Instruction/research/public service, Tenured, Associate professors","29","18","11","0","0","0","6","5","1","13","9","4","0","0","0","0","0","0","10","4","6","0","0","0","0","0","0","0","0","0","-2"
"213598","Lincoln University","2011","Total full-time Instruction/research/public service, Tenured, Assistant professors","6","3","3","0","0","0","1","1","0","4","2","2","0","0","0","0","0","0","1","0","1","0","0","0","0","0","0","0","0","0","-2"
"213598","Lincoln University","2011","Total full-time Instruction/research/public service, Tenured, Instructors","1","1","0","0","0","0","0","0","0","0","0","0","0","0","0","0","0","0","1","1","0","0","0","0","0","0","0","0","0","0","-2"
"213598","Lincoln University","2011","Total full-time Instruction/research/public service, Tenured total","65","46","19","0","0","0","11","10","1","30","22","8","0","0","0","0","0","0","22","12","10","0","0","0","2","2","0","0","0","0","-2"
"213598","Lincoln University","2011","Total full-time Instruction/research/public service, Non-tenured on tenure track, Associate professors","2","1","1","0","0","0","0","0","0","2","1","1","0","0","0","0","0","0","0","0","0","0","0","0","0","0","0","0","0","0","-2"
"213598","Lincoln University","2011","Total full-time Instruction/research/public service, Non-tenured on tenure track, Assistant professors","23","10","13","1","0","1","4","2","2","11","5","6","0","0","0","0","0","0","7","3","4","0","0","0","0","0","0","0","0","0","-2"
"213598","Lincoln University","2011","Total full-time Instruction/research/public service, Non-tenured on tenure track, Instructors","2","1","1","0","0","0","1","0","1","1","1","0","0","0","0","0","0","0","0","0","0","0","0","0","0","0","0","0","0","0","-2"
"213598","Lincoln University","2011","Total full-time Instruction/research/public service, Non-tenured on tenure track total","27","12","15","1","0","1","5","2","3","14","7","7","0","0","0","0","0","0","7","3","4","0","0","0","0","0","0","0","0","0","-2"
"213598","Lincoln University","2011","Total full-time Instruction/research/public service, Non-tenured not on tenure track, Professors","1","0","1","0","0","0","0","0","0","1","0","1","0","0","0","0","0","0","0","0","0","0","0","0","0","0","0","0","0","0","-2"
"213598","Lincoln University","2011","Total full-time Instruction/research/public service, Non-tenured not on tenure track, Associate professors","1","0","1","0","0","0","0","0","0","0","0","0","0","0","0","0","0","0","1","0","1","0","0","0","0","0","0","0","0","0","-2"
"213598","Lincoln University","2011","Total full-time Instruction/research/public servicey, Non-tenured not on tenure track, Assistant professors","5","3","2","0","0","0","1","0","1","3","2","1","0","0","0","0","0","0","1","1","0","0","0","0","0","0","0","0","0","0","-2"
"213598","Lincoln University","2011","Total full-time Instruction/research/public service, Non-tenured not on tenure track, Instructors","3","1","2","0","0","0","0","0","0","0","0","0","0","0","0","0","0","0","3","1","2","0","0","0","0","0","0","0","0","0","-2"
"213598","Lincoln University","2011","Total full-time Instruction/research/public service, Non-tenured not on tenure track, Lecturers","6","3","3","0","0","0","0","0","0","1","1","0","1","1","0","0","0","0","4","1","3","0","0","0","0","0","0","0","0","0","-2"
"213598","Lincoln University","2011","Total full-time Instruction/research/public service, Non-tenured not on tenure track total","16","7","9","0","0","0","1","0","1","5","3","2","1","1","0","0","0","0","9","3","6","0","0","0","0","0","0","0","0","0","-2"
"214041","Millersville University of Pennsylvania","2011","Total full-time Instruction/research/public service, Tenured, Professors","89","51","38","0","0","0","6","4","2","3","1","2","3","1","2","0","0","0","77","45","32","0","0","0","0","0","0","0","0","0","-2"
"214041","Millersville University of Pennsylvania","2011","Total full-time Instruction/research/public service, Tenured, Associate professors","93","44","49","0","0","0","6","3","3","4","1","3","5","0","5","0","0","0","77","40","37","1","0","1","0","0","0","0","0","0","-2"
"214041","Millersville University of Pennsylvania","2011","Total full-time Instruction/research/public service, Tenured, Assistant professors","35","16","19","0","0","0","3","2","1","3","3","0","3","2","1","0","0","0","25","9","16","0","0","0","0","0","0","1","0","1","-2"
"214041","Millersville University of Pennsylvania","2011","Total full-time Instruction/research/public service, Tenured total","217","111","106","0","0","0","15","9","6","10","5","5","11","3","8","0","0","0","179","94","85","1","0","1","0","0","0","1","0","1","-2"
"214041","Millersville University of Pennsylvania","2011","Total full-time Instruction/research/public service, Non-tenured on tenure track, Associate professors","4","2","2","0","0","0","0","0","0","1","1","0","0","0","0","0","0","0","3","1","2","0","0","0","0","0","0","0","0","0","-2"
"214041","Millersville University of Pennsylvania","2011","Total full-time Instruction/research/public service, Non-tenured on tenure track, Assistant professors","53","26","27","1","1","0","2","1","1","0","0","0","3","2","1","0","0","0","43","20","23","0","0","0","0","0","0","4","2","2","-2"
"214041","Millersville University of Pennsylvania","2011","Total full-time Instruction/research/public service, Non-tenured on tenure track total","57","28","29","1","1","0","2","1","1","1","1","0","3","2","1","0","0","0","46","21","25","0","0","0","0","0","0","4","2","2","-2"
"214041","Millersville University of Pennsylvania","2011","Total full-time Instruction/research/public servicey, Non-tenured not on tenure track, Assistant professors","1","1","0","0","0","0","0","0","0","0","0","0","0","0","0","0","0","0","1","1","0","0","0","0","0","0","0","0","0","0","-2"
"214041","Millersville University of Pennsylvania","2011","Total full-time Instruction/research/public service, Non-tenured not on tenure track total","1","1","0","0","0","0","0","0","0","0","0","0","0","0","0","0","0","0","1","1","0","0","0","0","0","0","0","0","0","0","-2"
"214777","Pennsylvania State University-Main Campus","2011","Total full-time Instruction/research/public service, Tenured, Professors","874","684","190","2","2","0","95","86","9","29","21","8","14","11","3","0","0","0","693","533","160","0","0","0","34","26","8","7","5","2","-2"
"214777","Pennsylvania State University-Main Campus","2011","Total full-time Instruction/research/public service, Tenured, Associate professors","510","306","204","3","2","1","55","38","17","23","11","12","21","8","13","0","0","0","370","219","151","4","2","2","25","17","8","9","9","0","-2"
"214777","Pennsylvania State University-Main Campus","2011","Total full-time Instruction/research/public service, Tenured, Assistant professors","1","0","1","0","0","0","0","0","0","0","0","0","0","0","0","0","0","0","1","0","1","0","0","0","0","0","0","0","0","0","-2"
"214777","Pennsylvania State University-Main Campus","2011","Total full-time Instruction/research/public service, Tenured, Instructors","1","1","0","0","0","0","0","0","0","0","0","0","0","0","0","0","0","0","0","0","0","0","0","0","1","1","0","0","0","0","-2"
"214777","Pennsylvania State University-Main Campus","2011","Total full-time Instruction/research/public service, Tenured total","1386","991","395","5","4","1","150","124","26","52","32","20","35","19","16","0","0","0","1064","752","312","4","2","2","60","44","16","16","14","2","-2"
"214777","Pennsylvania State University-Main Campus","2011","Total full-time Instruction/research/public service, Non-tenured on tenure track, Professors","1","0","1","0","0","0","0","0","0","0","0","0","0","0","0","0","0","0","0","0","0","0","0","0","0","0","0","1","0","1","-2"
"214777","Pennsylvania State University-Main Campus","2011","Total full-time Instruction/research/public service, Non-tenured on tenure track, Associate professors","28","20","8","0","0","0","3","2","1","1","1","0","3","1","2","0","0","0","18","14","4","0","0","0","2","2","0","1","0","1","-2"
"214777","Pennsylvania State University-Main Campus","2011","Total full-time Instruction/research/public service, Non-tenured on tenure track, Assistant professors","348","194","154","2","1","1","19","10","9","21","7","14","23","10","13","0","0","0","205","116","89","2","1","1","11","3","8","65","46","19","-2"
"214777","Pennsylvania State University-Main Campus","2011","Total full-time Instruction/research/public service, Non-tenured on tenure track total","377","214","163","2","1","1","22","12","10","22","8","14","26","11","15","0","0","0","223","130","93","2","1","1","13","5","8","67","46","21","-2"
"214777","Pennsylvania State University-Main Campus","2011","Total full-time Instruction/research/public service, Non-tenured not on tenure track, Professors","54","46","8","0","0","0","3","2","1","1","1","0","0","0","0","0","0","0","44","39","5","0","0","0","4","3","1","2","1","1","-2"
"214777","Pennsylvania State University-Main Campus","2011","Total full-time Instruction/research/public service, Non-tenured not on tenure track, Associate professors","129","91","38","0","0","0","12","9","3","0","0","0","0","0","0","0","0","0","108","74","34","0","0","0","5","5","0","4","3","1","-2"
"214777","Pennsylvania State University-Main Campus","2011","Total full-time Instruction/research/public servicey, Non-tenured not on tenure track, Assistant professors","418","258","160","2","1","1","30","13","17","12","9","3","5","2","3","0","0","0","290","173","117","2","2","0","12","8","4","65","50","15","-2"
"214777","Pennsylvania State University-Main Campus","2011","Total full-time Instruction/research/public service, Non-tenured not on tenure track, Instructors","423","208","215","2","1","1","13","4","9","8","4","4","10","3","7","0","0","0","351","176","175","1","0","1","13","7","6","25","13","12","-2"
"214777","Pennsylvania State University-Main Campus","2011","Total full-time Instruction/research/public service, Non-tenured not on tenure track, Lecturers","409","207","202","0","0","0","15","4","11","11","8","3","18","7","11","0","0","0","326","172","154","1","0","1","13","7","6","25","9","16","-2"
"214777","Pennsylvania State University-Main Campus","2011","Total full-time Instruction/research/public service, Non-tenured not on tenure track total","1433","810","623","4","2","2","73","32","41","32","22","10","33","12","21","0","0","0","1119","634","485","4","2","2","47","30","17","121","76","45","-2"
"217156","Brown University","2011","Total full-time Instruction/research/public service, Tenured, Professors","347","262","85","0","0","0","28","22","6","10","9","1","7","4","3","0","0","0","299","225","74","3","2","1","0","0","0","0","0","0","-2"
"217156","Brown University","2011","Total full-time Instruction/research/public service, Tenured, Associate professors","140","92","48","0","0","0","21","14","7","7","7","0","7","6","1","0","0","0","102","63","39","1","0","1","0","0","0","2","2","0","-2"
"217156","Brown University","2011","Total full-time Instruction/research/public service, Tenured, No academic rank","1","0","1","0","0","0","0","0","0","0","0","0","0","0","0","0","0","0","1","0","1","0","0","0","0","0","0","0","0","0","-2"
"217156","Brown University","2011","Total full-time Instruction/research/public service, Tenured total","488","354","134","0","0","0","49","36","13","17","16","1","14","10","4","0","0","0","402","288","114","4","2","2","0","0","0","2","2","0","-2"
"217156","Brown University","2011","Total full-time Instruction/research/public service, Non-tenured on tenure track, Associate professors","3","2","1","0","0","0","1","1","0","0","0","0","0","0","0","0","0","0","2","1","1","0","0","0","0","0","0","0","0","0","-2"
"217156","Brown University","2011","Total full-time Instruction/research/public service, Non-tenured on tenure track, Assistant professors","111","64","47","0","0","0","11","5","6","7","1","6","4","3","1","0","0","0","76","44","32","1","1","0","1","1","0","11","9","2","-2"
"217156","Brown University","2011","Total full-time Instruction/research/public service, Non-tenured on tenure track, Instructors","1","1","0","0","0","0","0","0","0","0","0","0","0","0","0","0","0","0","1","1","0","0","0","0","0","0","0","0","0","0","-2"
"217156","Brown University","2011","Total full-time Instruction/research/public service, Non-tenured on tenure track total","115","67","48","0","0","0","12","6","6","7","1","6","4","3","1","0","0","0","79","46","33","1","1","0","1","1","0","11","9","2","-2"
"217156","Brown University","2011","Total full-time Instruction/research/public service, Non-tenured not on tenure track, Professors","18","13","5","0","0","0","0","0","0","1","1","0","1","1","0","0","0","0","15","10","5","0","0","0","0","0","0","1","1","0","-2"
"217156","Brown University","2011","Total full-time Instruction/research/public service, Non-tenured not on tenure track, Associate professors","15","7","8","0","0","0","0","0","0","0","0","0","0","0","0","0","0","0","15","7","8","0","0","0","0","0","0","0","0","0","-2"
"217156","Brown University","2011","Total full-time Instruction/research/public servicey, Non-tenured not on tenure track, Assistant professors","63","34","29","0","0","0","6","3","3","0","0","0","4","2","2","0","0","0","40","18","22","3","1","2","1","1","0","9","9","0","-2"
"217156","Brown University","2011","Total full-time Instruction/research/public service, Non-tenured not on tenure track, Instructors","1","0","1","0","0","0","0","0","0","0","0","0","0","0","0","0","0","0","1","0","1","0","0","0","0","0","0","0","0","0","-2"
"217156","Brown University","2011","Total full-time Instruction/research/public service, Non-tenured not on tenure track, Lecturers","56","16","40","0","0","0","8","3","5","1","0","1","3","0","3","0","0","0","42","12","30","0","0","0","0","0","0","2","1","1","-2"
"217156","Brown University","2011","Total full-time Instruction/research/public service, Non-tenured not on tenure track, No academic rank","68","35","33","1","0","1","4","3","1","4","2","2","1","0","1","0","0","0","39","20","19","1","0","1","4","3","1","14","7","7","-2"
"217156","Brown University","2011","Total full-time Instruction/research/public service, Non-tenured not on tenure track total","221","105","116","1","0","1","18","9","9","6","3","3","9","3","6","0","0","0","152","67","85","4","1","3","5","4","1","26","18","8","-2"
"217484","University of Rhode Island","2011","Total full-time Instruction/research/public service, Tenured, Professors","299","216","83","2","1","1","26","24","2","7","6","1","6","6","0","0","0","0","254","177","77","0","0","0","0","0","0","4","2","2","-2"
"217484","University of Rhode Island","2011","Total full-time Instruction/research/public service, Tenured, Associate professors","137","70","67","1","0","1","11","7","4","6","1","5","4","0","4","0","0","0","111","59","52","0","0","0","0","0","0","4","3","1","-2"
"217484","University of Rhode Island","2011","Total full-time Instruction/research/public service, Tenured total","436","286","150","3","1","2","37","31","6","13","7","6","10","6","4","0","0","0","365","236","129","0","0","0","0","0","0","8","5","3","-2"
"217484","University of Rhode Island","2011","Total full-time Instruction/research/public service, Non-tenured on tenure track, Professors","1","1","0","0","0","0","0","0","0","0","0","0","0","0","0","0","0","0","0","0","0","0","0","0","0","0","0","1","1","0","-2"
"217484","University of Rhode Island","2011","Total full-time Instruction/research/public service, Non-tenured on tenure track, Associate professors","12","5","7","0","0","0","2","2","0","0","0","0","1","0","1","0","0","0","9","3","6","0","0","0","0","0","0","0","0","0","-2"
"217484","University of Rhode Island","2011","Total full-time Instruction/research/public service, Non-tenured on tenure track, Assistant professors","96","44","52","1","0","1","17","9","8","0","0","0","5","2","3","0","0","0","67","29","38","0","0","0","0","0","0","6","4","2","-2"
"217484","University of Rhode Island","2011","Total full-time Instruction/research/public service, Non-tenured on tenure track, Instructors","2","0","2","0","0","0","0","0","0","0","0","0","0","0","0","0","0","0","2","0","2","0","0","0","0","0","0","0","0","0","-2"
"217484","University of Rhode Island","2011","Total full-time Instruction/research/public service, Non-tenured on tenure track total","111","50","61","1","0","1","19","11","8","0","0","0","6","2","4","0","0","0","78","32","46","0","0","0","0","0","0","7","5","2","-2"
"217484","University of Rhode Island","2011","Total full-time Instruction/research/public service, Non-tenured not on tenure track, Professors","7","4","3","0","0","0","0","0","0","0","0","0","0","0","0","0","0","0","6","3","3","0","0","0","0","0","0","1","1","0","-2"
"217484","University of Rhode Island","2011","Total full-time Instruction/research/public service, Non-tenured not on tenure track, Associate professors","19","5","14","0","0","0","0","0","0","0","0","0","0","0","0","0","0","0","19","5","14","0","0","0","0","0","0","0","0","0","-2"
"217484","University of Rhode Island","2011","Total full-time Instruction/research/public servicey, Non-tenured not on tenure track, Assistant professors","35","6","29","0","0","0","3","2","1","1","1","0","0","0","0","0","0","0","29","3","26","0","0","0","1","0","1","1","0","1","-2"
"217484","University of Rhode Island","2011","Total full-time Instruction/research/public service, Non-tenured not on tenure track, Instructors","4","3","1","0","0","0","0","0","0","0","0","0","0","0","0","0","0","0","4","3","1","0","0","0","0","0","0","0","0","0","-2"
"217484","University of Rhode Island","2011","Total full-time Instruction/research/public service, Non-tenured not on tenure track, Lecturers","91","38","53","0","0","0","6","0","6","0","0","0","5","3","2","0","0","0","75","33","42","0","0","0","0","0","0","5","2","3","-2"
"217484","University of Rhode Island","2011","Total full-time Instruction/research/public service, Non-tenured not on tenure track total","156","56","100","0","0","0","9","2","7","1","1","0","5","3","2","0","0","0","133","47","86","0","0","0","1","0","1","7","3","4","-2"
"217819","College of Charleston","2011","Total full-time Instruction/research/public service, Tenured, Professors","138","98","40","0","0","0","3","3","0","5","4","1","3","2","1","0","0","0","118","81","37","2","2","0","7","6","1","0","0","0","-2"
"217819","College of Charleston","2011","Total full-time Instruction/research/public service, Tenured, Associate professors","156","86","70","0","0","0","3","2","1","9","3","6","11","7","4","0","0","0","124","69","55","1","1","0","5","3","2","3","1","2","-2"
"217819","College of Charleston","2011","Total full-time Instruction/research/public service, Tenured, Assistant professors","4","1","3","0","0","0","0","0","0","0","0","0","0","0","0","0","0","0","4","1","3","0","0","0","0","0","0","0","0","0","-2"
"217819","College of Charleston","2011","Total full-time Instruction/research/public service, Tenured total","298","185","113","0","0","0","6","5","1","14","7","7","14","9","5","0","0","0","246","151","95","3","3","0","12","9","3","3","1","2","-2"
"217819","College of Charleston","2011","Total full-time Instruction/research/public service, Non-tenured on tenure track, Assistant professors","135","83","52","0","0","0","4","3","1","6","3","3","4","2","2","0","0","0","100","60","40","1","1","0","6","5","1","14","9","5","-2"
"217819","College of Charleston","2011","Total full-time Instruction/research/public service, Non-tenured on tenure track total","135","83","52","0","0","0","4","3","1","6","3","3","4","2","2","0","0","0","100","60","40","1","1","0","6","5","1","14","9","5","-2"
"217819","College of Charleston","2011","Total full-time Instruction/research/public service, Non-tenured not on tenure track, Professors","2","2","0","0","0","0","0","0","0","0","0","0","0","0","0","0","0","0","2","2","0","0","0","0","0","0","0","0","0","0","-2"
"217819","College of Charleston","2011","Total full-time Instruction/research/public servicey, Non-tenured not on tenure track, Assistant professors","26","10","16","0","0","0","0","0","0","1","0","1","1","1","0","0","0","0","20","8","12","0","0","0","1","0","1","3","1","2","-2"
"217819","College of Charleston","2011","Total full-time Instruction/research/public service, Non-tenured not on tenure track, Instructors","60","22","38","0","0","0","1","1","0","2","0","2","2","1","1","1","1","0","50","17","33","1","0","1","2","1","1","1","1","0","-2"
"217819","College of Charleston","2011","Total full-time Instruction/research/public service, Non-tenured not on tenure track total","88","34","54","0","0","0","1","1","0","3","0","3","3","2","1","1","1","0","72","27","45","1","0","1","3","1","2","4","2","2","-2"
"217873","Claflin University","2011","Total full-time Instruction/research/public service, Tenured, Professors","15","8","7","0","0","0","5","4","1","7","3","4","0","0","0","0","0","0","3","1","2","0","0","0","0","0","0","0","0","0","-2"
"217873","Claflin University","2011","Total full-time Instruction/research/public service, Tenured, Associate professors","12","9","3","0","0","0","5","4","1","2","0","2","0","0","0","0","0","0","5","5","0","0","0","0","0","0","0","0","0","0","-2"
"217873","Claflin University","2011","Total full-time Instruction/research/public service, Tenured, Assistant professors","7","4","3","0","0","0","0","0","0","4","3","1","0","0","0","0","0","0","3","1","2","0","0","0","0","0","0","0","0","0","-2"
"217873","Claflin University","2011","Total full-time Instruction/research/public service, Tenured total","34","21","13","0","0","0","10","8","2","13","6","7","0","0","0","0","0","0","11","7","4","0","0","0","0","0","0","0","0","0","-2"
"217873","Claflin University","2011","Total full-time Instruction/research/public service, Non-tenured on tenure track, Professors","3","2","1","0","0","0","0","0","0","3","2","1","0","0","0","0","0","0","0","0","0","0","0","0","0","0","0","0","0","0","-2"
"217873","Claflin University","2011","Total full-time Instruction/research/public service, Non-tenured on tenure track, Associate professors","10","9","1","0","0","0","2","2","0","5","4","1","1","1","0","0","0","0","2","2","0","0","0","0","0","0","0","0","0","0","-2"
"217873","Claflin University","2011","Total full-time Instruction/research/public service, Non-tenured on tenure track, Assistant professors","43","21","22","1","0","1","6","4","2","18","7","11","3","2","1","0","0","0","6","3","3","1","0","1","0","0","0","8","5","3","-2"
"217873","Claflin University","2011","Total full-time Instruction/research/public service, Non-tenured on tenure track, Instructors","1","1","0","0","0","0","1","1","0","0","0","0","0","0","0","0","0","0","0","0","0","0","0","0","0","0","0","0","0","0","-2"
"217873","Claflin University","2011","Total full-time Instruction/research/public service, Non-tenured on tenure track total","57","33","24","1","0","1","9","7","2","26","13","13","4","3","1","0","0","0","8","5","3","1","0","1","0","0","0","8","5","3","-2"
"217873","Claflin University","2011","Total full-time Instruction/research/public servicey, Non-tenured not on tenure track, Assistant professors","7","3","4","0","0","0","0","0","0","3","1","2","0","0","0","0","0","0","3","2","1","0","0","0","0","0","0","1","0","1","-2"
"217873","Claflin University","2011","Total full-time Instruction/research/public service, Non-tenured not on tenure track, Instructors","17","11","6","0","0","0","1","1","0","14","10","4","0","0","0","0","0","0","1","0","1","1","0","1","0","0","0","0","0","0","-2"
"217873","Claflin University","2011","Total full-time Instruction/research/public service, Non-tenured not on tenure track, Lecturers","2","1","1","0","0","0","0","0","0","1","0","1","0","0","0","0","0","0","1","1","0","0","0","0","0","0","0","0","0","0","-2"
"217873","Claflin University","2011","Total full-time Instruction/research/public service, Non-tenured not on tenure track total","26","15","11","0","0","0","1","1","0","18","11","7","0","0","0","0","0","0","5","3","2","1","0","1","0","0","0","1","0","1","-2"
"217882","Clemson University","2011","Total full-time Instruction/research/public service, Tenured, Professors","334","270","64","0","0","0","30","28","2","6","5","1","3","2","1","0","0","0","294","235","59","1","0","1","0","0","0","0","0","0","-2"
"217882","Clemson University","2011","Total full-time Instruction/research/public service, Tenured, Associate professors","223","154","69","0","0","0","23","17","6","9","7","2","5","3","2","0","0","0","185","126","59","0","0","0","1","1","0","0","0","0","-2"
"217882","Clemson University","2011","Total full-time Instruction/research/public service, Tenured total","557","424","133","0","0","0","53","45","8","15","12","3","8","5","3","0","0","0","479","361","118","1","0","1","1","1","0","0","0","0","-2"
"217882","Clemson University","2011","Total full-time Instruction/research/public service, Non-tenured on tenure track, Professors","1","1","0","0","0","0","0","0","0","0","0","0","0","0","0","0","0","0","1","1","0","0","0","0","0","0","0","0","0","0","-2"
"217882","Clemson University","2011","Total full-time Instruction/research/public service, Non-tenured on tenure track, Associate professors","18","14","4","0","0","0","2","2","0","1","1","0","0","0","0","0","0","0","14","10","4","0","0","0","1","1","0","0","0","0","-2"
"217882","Clemson University","2011","Total full-time Instruction/research/public service, Non-tenured on tenure track, Assistant professors","235","139","96","0","0","0","40","27","13","12","5","7","6","0","6","0","0","0","176","106","70","0","0","0","1","1","0","0","0","0","-2"
"217882","Clemson University","2011","Total full-time Instruction/research/public service, Non-tenured on tenure track total","254","154","100","0","0","0","42","29","13","13","6","7","6","0","6","0","0","0","191","117","74","0","0","0","2","2","0","0","0","0","-2"
"217882","Clemson University","2011","Total full-time Instruction/research/public service, Non-tenured not on tenure track, Professors","4","2","2","0","0","0","0","0","0","0","0","0","0","0","0","0","0","0","4","2","2","0","0","0","0","0","0","0","0","0","-2"
"217882","Clemson University","2011","Total full-time Instruction/research/public service, Non-tenured not on tenure track, Associate professors","7","7","0","0","0","0","0","0","0","0","0","0","0","0","0","0","0","0","7","7","0","0","0","0","0","0","0","0","0","0","-2"
"217882","Clemson University","2011","Total full-time Instruction/research/public servicey, Non-tenured not on tenure track, Assistant professors","12","10","2","0","0","0","0","0","0","0","0","0","0","0","0","0","0","0","12","10","2","0","0","0","0","0","0","0","0","0","-2"
"217882","Clemson University","2011","Total full-time Instruction/research/public service, Non-tenured not on tenure track, Instructors","3","1","2","0","0","0","0","0","0","0","0","0","0","0","0","0","0","0","3","1","2","0","0","0","0","0","0","0","0","0","-2"
"217882","Clemson University","2011","Total full-time Instruction/research/public service, Non-tenured not on tenure track, Lecturers","215","101","114","1","0","1","2","1","1","7","3","4","7","2","5","0","0","0","196","93","103","0","0","0","2","2","0","0","0","0","-2"
"217882","Clemson University","2011","Total full-time Instruction/research/public service, Non-tenured not on tenure track total","241","121","120","1","0","1","2","1","1","7","3","4","7","2","5","0","0","0","222","113","109","0","0","0","2","2","0","0","0","0","-2"
"218724","Coastal Carolina University","2011","Total full-time Instruction/research/public service, Tenured, Professors","63","45","18","1","1","0","1","1","0","2","1","1","2","1","1","0","0","0","55","39","16","1","1","0","1","1","0","0","0","0","-2"
"218724","Coastal Carolina University","2011","Total full-time Instruction/research/public service, Tenured, Associate professors","84","54","30","0","0","0","3","1","2","2","1","1","4","2","2","0","0","0","73","48","25","1","1","0","1","1","0","0","0","0","-2"
"218724","Coastal Carolina University","2011","Total full-time Instruction/research/public service, Tenured, Assistant professors","2","1","1","1","1","0","0","0","0","1","0","1","0","0","0","0","0","0","0","0","0","0","0","0","0","0","0","0","0","0","-2"
"218724","Coastal Carolina University","2011","Total full-time Instruction/research/public service, Tenured total","149","100","49","2","2","0","4","2","2","5","2","3","6","3","3","0","0","0","128","87","41","2","2","0","2","2","0","0","0","0","-2"
"218724","Coastal Carolina University","2011","Total full-time Instruction/research/public service, Non-tenured on tenure track, Associate professors","8","4","4","0","0","0","0","0","0","0","0","0","0","0","0","0","0","0","8","4","4","0","0","0","0","0","0","0","0","0","-2"
"218724","Coastal Carolina University","2011","Total full-time Instruction/research/public service, Non-tenured on tenure track, Assistant professors","98","52","46","0","0","0","8","5","3","6","3","3","1","1","0","0","0","0","81","41","40","0","0","0","2","2","0","0","0","0","-2"
"218724","Coastal Carolina University","2011","Total full-time Instruction/research/public service, Non-tenured on tenure track total","106","56","50","0","0","0","8","5","3","6","3","3","1","1","0","0","0","0","89","45","44","0","0","0","2","2","0","0","0","0","-2"
"218724","Coastal Carolina University","2011","Total full-time Instruction/research/public service, Non-tenured not on tenure track, Associate professors","1","0","1","0","0","0","0","0","0","0","0","0","0","0","0","0","0","0","1","0","1","0","0","0","0","0","0","0","0","0","-2"
"218724","Coastal Carolina University","2011","Total full-time Instruction/research/public servicey, Non-tenured not on tenure track, Assistant professors","4","3","1","0","0","0","0","0","0","0","0","0","0","0","0","0","0","0","4","3","1","0","0","0","0","0","0","0","0","0","-2"
"218724","Coastal Carolina University","2011","Total full-time Instruction/research/public service, Non-tenured not on tenure track, Instructors","13","7","6","0","0","0","1","0","1","0","0","0","2","2","0","0","0","0","10","5","5","0","0","0","0","0","0","0","0","0","-2"
"218724","Coastal Carolina University","2011","Total full-time Instruction/research/public service, Non-tenured not on tenure track, Lecturers","82","38","44","0","0","0","3","1","2","2","1","1","2","1","1","0","0","0","75","35","40","0","0","0","0","0","0","0","0","0","-2"
"218724","Coastal Carolina University","2011","Total full-time Instruction/research/public service, Non-tenured not on tenure track total","100","48","52","0","0","0","4","1","3","2","1","1","4","3","1","0","0","0","90","43","47","0","0","0","0","0","0","0","0","0","-2"
"219347","South Dakota School of Mines and Technology","2011","Total full-time Instruction/research/public service, Tenured, Professors","49","40","9","0","0","0","3","2","1","0","0","0","1","1","0","0","0","0","45","37","8","0","0","0","0","0","0","0","0","0","-2"
"219347","South Dakota School of Mines and Technology","2011","Total full-time Instruction/research/public service, Tenured, Associate professors","18","15","3","0","0","0","1","1","0","0","0","0","1","1","0","0","0","0","16","13","3","0","0","0","0","0","0","0","0","0","-2"
"219347","South Dakota School of Mines and Technology","2011","Total full-time Instruction/research/public service, Tenured total","67","55","12","0","0","0","4","3","1","0","0","0","2","2","0","0","0","0","61","50","11","0","0","0","0","0","0","0","0","0","-2"
"219347","South Dakota School of Mines and Technology","2011","Total full-time Instruction/research/public service, Non-tenured on tenure track, Professors","2","2","0","0","0","0","0","0","0","0","0","0","0","0","0","0","0","0","2","2","0","0","0","0","0","0","0","0","0","0","-2"
"219347","South Dakota School of Mines and Technology","2011","Total full-time Instruction/research/public service, Non-tenured on tenure track, Associate professors","8","6","2","0","0","0","1","1","0","0","0","0","0","0","0","0","0","0","7","5","2","0","0","0","0","0","0","0","0","0","-2"
"219347","South Dakota School of Mines and Technology","2011","Total full-time Instruction/research/public service, Non-tenured on tenure track, Assistant professors","27","26","1","0","0","0","4","4","0","0","0","0","0","0","0","0","0","0","20","19","1","0","0","0","0","0","0","3","3","0","-2"
"219347","South Dakota School of Mines and Technology","2011","Total full-time Instruction/research/public service, Non-tenured on tenure track total","37","34","3","0","0","0","5","5","0","0","0","0","0","0","0","0","0","0","29","26","3","0","0","0","0","0","0","3","3","0","-2"
"219347","South Dakota School of Mines and Technology","2011","Total full-time Instruction/research/public service, Non-tenured not on tenure track, Professors","2","2","0","0","0","0","0","0","0","0","0","0","0","0","0","0","0","0","2","2","0","0","0","0","0","0","0","0","0","0","-2"
"219347","South Dakota School of Mines and Technology","2011","Total full-time Instruction/research/public service, Non-tenured not on tenure track, Associate professors","5","3","2","0","0","0","1","1","0","0","0","0","0","0","0","0","0","0","4","2","2","0","0","0","0","0","0","0","0","0","-2"
"219347","South Dakota School of Mines and Technology","2011","Total full-time Instruction/research/public servicey, Non-tenured not on tenure track, Assistant professors","6","3","3","0","0","0","0","0","0","0","0","0","0","0","0","0","0","0","5","2","3","0","0","0","0","0","0","1","1","0","-2"
"219347","South Dakota School of Mines and Technology","2011","Total full-time Instruction/research/public service, Non-tenured not on tenure track, Instructors","13","9","4","1","1","0","1","1","0","0","0","0","0","0","0","0","0","0","11","7","4","0","0","0","0","0","0","0","0","0","-2"
"219347","South Dakota School of Mines and Technology","2011","Total full-time Instruction/research/public service, Non-tenured not on tenure track total","26","17","9","1","1","0","2","2","0","0","0","0","0","0","0","0","0","0","22","13","9","0","0","0","0","0","0","1","1","0","-2"
"221759","The University of Tennessee-Knoxville","2011","Total full-time Instruction/research/public service, Tenured, Professors","732","573","159","1","1","0","57","48","9","14","8","6","13","12","1","0","0","0","643","501","142","2","2","0","1","0","1","1","1","0","-2"
"221759","The University of Tennessee-Knoxville","2011","Total full-time Instruction/research/public service, Tenured, Associate professors","463","276","187","2","2","0","55","42","13","24","14","10","12","11","1","0","0","0","368","206","162","1","0","1","0","0","0","1","1","0","-2"
"221759","The University of Tennessee-Knoxville","2011","Total full-time Instruction/research/public service, Tenured, Assistant professors","12","5","7","0","0","0","2","1","1","2","1","1","0","0","0","0","0","0","8","3","5","0","0","0","0","0","0","0","0","0","-2"
"221759","The University of Tennessee-Knoxville","2011","Total full-time Instruction/research/public service, Tenured, Instructors","1","0","1","0","0","0","0","0","0","0","0","0","0","0","0","0","0","0","1","0","1","0","0","0","0","0","0","0","0","0","-2"
"221759","The University of Tennessee-Knoxville","2011","Total full-time Instruction/research/public service, Tenured total","1208","854","354","3","3","0","114","91","23","40","23","17","25","23","2","0","0","0","1020","710","310","3","2","1","1","0","1","2","2","0","-2"
"221759","The University of Tennessee-Knoxville","2011","Total full-time Instruction/research/public service, Non-tenured on tenure track, Professors","12","10","2","0","0","0","2","2","0","0","0","0","0","0","0","0","0","0","10","8","2","0","0","0","0","0","0","0","0","0","-2"
"221759","The University of Tennessee-Knoxville","2011","Total full-time Instruction/research/public service, Non-tenured on tenure track, Associate professors","52","31","21","2","2","0","15","10","5","2","1","1","1","1","0","0","0","0","28","14","14","1","0","1","0","0","0","3","3","0","-2"
"221759","The University of Tennessee-Knoxville","2011","Total full-time Instruction/research/public service, Non-tenured on tenure track, Assistant professors","333","183","150","1","0","1","39","25","14","21","7","14","10","7","3","0","0","0","214","115","99","3","1","2","0","0","0","45","28","17","-2"
"221759","The University of Tennessee-Knoxville","2011","Total full-time Instruction/research/public service, Non-tenured on tenure track, Instructors","2","1","1","0","0","0","0","0","0","0","0","0","0","0","0","0","0","0","2","1","1","0","0","0","0","0","0","0","0","0","-2"
"221759","The University of Tennessee-Knoxville","2011","Total full-time Instruction/research/public service, Non-tenured on tenure track total","399","225","174","3","2","1","56","37","19","23","8","15","11","8","3","0","0","0","254","138","116","4","1","3","0","0","0","48","31","17","-2"
"221759","The University of Tennessee-Knoxville","2011","Total full-time Instruction/research/public service, Non-tenured not on tenure track, Professors","28","23","5","0","0","0","0","0","0","0","0","0","0","0","0","0","0","0","28","23","5","0","0","0","0","0","0","0","0","0","-2"
"221759","The University of Tennessee-Knoxville","2011","Total full-time Instruction/research/public service, Non-tenured not on tenure track, Associate professors","86","49","37","1","0","1","12","10","2","2","2","0","1","1","0","0","0","0","66","33","33","0","0","0","0","0","0","4","3","1","-2"
"221759","The University of Tennessee-Knoxville","2011","Total full-time Instruction/research/public servicey, Non-tenured not on tenure track, Assistant professors","231","120","111","0","0","0","37","25","12","15","6","9","10","4","6","0","0","0","141","65","76","1","1","0","0","0","0","27","19","8","-2"
"221759","The University of Tennessee-Knoxville","2011","Total full-time Instruction/research/public service, Non-tenured not on tenure track, Instructors","43","11","32","0","0","0","3","2","1","4","1","3","1","1","0","0","0","0","33","6","27","0","0","0","0","0","0","2","1","1","-2"
"221759","The University of Tennessee-Knoxville","2011","Total full-time Instruction/research/public service, Non-tenured not on tenure track, Lecturers","260","110","150","0","0","0","7","1","6","6","3","3","10","1","9","0","0","0","231","101","130","0","0","0","0","0","0","6","4","2","-2"
"221759","The University of Tennessee-Knoxville","2011","Total full-time Instruction/research/public service, Non-tenured not on tenure track, No academic rank","21","15","6","1","1","0","0","0","0","0","0","0","0","0","0","0","0","0","7","2","5","0","0","0","0","0","0","13","12","1","-2"
"221759","The University of Tennessee-Knoxville","2011","Total full-time Instruction/research/public service, Non-tenured not on tenure track total","669","328","341","2","1","1","59","38","21","27","12","15","22","7","15","0","0","0","506","230","276","1","1","0","0","0","0","52","39","13","-2"
"221768","The University of Tennessee-Martin","2011","Total full-time Instruction/research/public service, Tenured, Professors","76","53","23","0","0","0","1","1","0","3","1","2","0","0","0","0","0","0","68","48","20","0","0","0","0","0","0","4","3","1","-2"
"221768","The University of Tennessee-Martin","2011","Total full-time Instruction/research/public service, Tenured, Associate professors","56","28","28","1","0","1","2","1","1","4","1","3","0","0","0","0","0","0","45","22","23","0","0","0","2","2","0","2","2","0","-2"
"221768","The University of Tennessee-Martin","2011","Total full-time Instruction/research/public service, Tenured, Assistant professors","14","5","9","0","0","0","0","0","0","1","1","0","0","0","0","0","0","0","13","4","9","0","0","0","0","0","0","0","0","0","-2"
"221768","The University of Tennessee-Martin","2011","Total full-time Instruction/research/public service, Tenured, Instructors","12","5","7","0","0","0","0","0","0","1","0","1","0","0","0","0","0","0","11","5","6","0","0","0","0","0","0","0","0","0","-2"
"221768","The University of Tennessee-Martin","2011","Total full-time Instruction/research/public service, Tenured total","158","91","67","1","0","1","3","2","1","9","3","6","0","0","0","0","0","0","137","79","58","0","0","0","2","2","0","6","5","1","-2"
"221768","The University of Tennessee-Martin","2011","Total full-time Instruction/research/public service, Non-tenured on tenure track, Associate professors","8","5","3","0","0","0","2","2","0","1","0","1","0","0","0","0","0","0","4","3","1","0","0","0","0","0","0","1","0","1","-2"
"221768","The University of Tennessee-Martin","2011","Total full-time Instruction/research/public service, Non-tenured on tenure track, Assistant professors","62","34","28","0","0","0","6","2","4","2","2","0","0","0","0","0","0","0","51","29","22","0","0","0","1","0","1","2","1","1","-2"
"221768","The University of Tennessee-Martin","2011","Total full-time Instruction/research/public service, Non-tenured on tenure track, Instructors","5","4","1","0","0","0","0","0","0","0","0","0","0","0","0","0","0","0","4","3","1","0","0","0","0","0","0","1","1","0","-2"
"221768","The University of Tennessee-Martin","2011","Total full-time Instruction/research/public service, Non-tenured on tenure track total","75","43","32","0","0","0","8","4","4","3","2","1","0","0","0","0","0","0","59","35","24","0","0","0","1","0","1","4","2","2","-2"
"221768","The University of Tennessee-Martin","2011","Total full-time Instruction/research/public servicey, Non-tenured not on tenure track, Assistant professors","3","2","1","0","0","0","0","0","0","1","0","1","0","0","0","0","0","0","2","2","0","0","0","0","0","0","0","0","0","0","-2"
"221768","The University of Tennessee-Martin","2011","Total full-time Instruction/research/public service, Non-tenured not on tenure track, Instructors","2","1","1","0","0","0","0","0","0","0","0","0","0","0","0","0","0","0","2","1","1","0","0","0","0","0","0","0","0","0","-2"
"221768","The University of Tennessee-Martin","2011","Total full-time Instruction/research/public service, Non-tenured not on tenure track, Lecturers","47","27","20","0","0","0","1","0","1","1","0","1","0","0","0","0","0","0","44","27","17","0","0","0","1","0","1","0","0","0","-2"
"221768","The University of Tennessee-Martin","2011","Total full-time Instruction/research/public service, Non-tenured not on tenure track total","52","30","22","0","0","0","1","0","1","2","0","2","0","0","0","0","0","0","48","30","18","0","0","0","1","0","1","0","0","0","-2"
"221838","Tennessee State University","2011","Total full-time Instruction/research/public service, Tenured, Professors","101","68","33","0","0","0","19","15","4","48","30","18","2","1","1","0","0","0","32","22","10","0","0","0","0","0","0","0","0","0","-2"
"221838","Tennessee State University","2011","Total full-time Instruction/research/public service, Tenured, Associate professors","92","53","39","2","1","1","8","5","3","36","17","19","2","1","1","0","0","0","40","25","15","0","0","0","0","0","0","4","4","0","-2"
"221838","Tennessee State University","2011","Total full-time Instruction/research/public service, Tenured, Assistant professors","39","17","22","0","0","0","3","3","0","24","8","16","0","0","0","0","0","0","12","6","6","0","0","0","0","0","0","0","0","0","-2"
"221838","Tennessee State University","2011","Total full-time Instruction/research/public service, Tenured, Instructors","4","2","2","0","0","0","1","0","1","3","2","1","0","0","0","0","0","0","0","0","0","0","0","0","0","0","0","0","0","0","-2"
"221838","Tennessee State University","2011","Total full-time Instruction/research/public service, Tenured, No academic rank","2","2","0","0","0","0","1","1","0","1","1","0","0","0","0","0","0","0","0","0","0","0","0","0","0","0","0","0","0","0","-2"
"221838","Tennessee State University","2011","Total full-time Instruction/research/public service, Tenured total","238","142","96","2","1","1","32","24","8","112","58","54","4","2","2","0","0","0","84","53","31","0","0","0","0","0","0","4","4","0","-2"
"221838","Tennessee State University","2011","Total full-time Instruction/research/public service, Non-tenured on tenure track, Professors","5","4","1","0","0","0","1","1","0","2","1","1","0","0","0","0","0","0","2","2","0","0","0","0","0","0","0","0","0","0","-2"
"221838","Tennessee State University","2011","Total full-time Instruction/research/public service, Non-tenured on tenure track, Associate professors","16","6","10","0","0","0","0","0","0","9","2","7","0","0","0","0","0","0","7","4","3","0","0","0","0","0","0","0","0","0","-2"
"221838","Tennessee State University","2011","Total full-time Instruction/research/public service, Non-tenured on tenure track, Assistant professors","57","30","27","0","0","0","4","3","1","12","4","8","1","1","0","0","0","0","27","10","17","0","0","0","0","0","0","13","12","1","-2"
"221838","Tennessee State University","2011","Total full-time Instruction/research/public service, Non-tenured on tenure track, Instructors","5","3","2","0","0","0","0","0","0","1","1","0","0","0","0","2","2","0","2","0","2","0","0","0","0","0","0","0","0","0","-2"
"221838","Tennessee State University","2011","Total full-time Instruction/research/public service, Non-tenured on tenure track, No academic rank","2","1","1","0","0","0","0","0","0","0","0","0","1","0","1","0","0","0","1","1","0","0","0","0","0","0","0","0","0","0","-2"
"221838","Tennessee State University","2011","Total full-time Instruction/research/public service, Non-tenured on tenure track total","85","44","41","0","0","0","5","4","1","24","8","16","2","1","1","2","2","0","39","17","22","0","0","0","0","0","0","13","12","1","-2"
"221838","Tennessee State University","2011","Total full-time Instruction/research/public service, Non-tenured not on tenure track, Professors","2","2","0","0","0","0","0","0","0","2","2","0","0","0","0","0","0","0","0","0","0","0","0","0","0","0","0","0","0","0","-2"
"221838","Tennessee State University","2011","Total full-time Instruction/research/public service, Non-tenured not on tenure track, Associate professors","8","2","6","1","0","1","0","0","0","5","1","4","0","0","0","0","0","0","2","1","1","0","0","0","0","0","0","0","0","0","-2"
"221838","Tennessee State University","2011","Total full-time Instruction/research/public servicey, Non-tenured not on tenure track, Assistant professors","20","5","15","0","0","0","0","0","0","14","3","11","0","0","0","0","0","0","4","1","3","0","0","0","0","0","0","2","1","1","-2"
"221838","Tennessee State University","2011","Total full-time Instruction/research/public service, Non-tenured not on tenure track, Instructors","3","0","3","0","0","0","0","0","0","1","0","1","0","0","0","0","0","0","2","0","2","0","0","0","0","0","0","0","0","0","-2"
"221838","Tennessee State University","2011","Total full-time Instruction/research/public service, Non-tenured not on tenure track, No academic rank","57","29","28","0","0","0","3","2","1","21","7","14","0","0","0","0","0","0","25","14","11","0","0","0","0","0","0","8","6","2","-2"
"221838","Tennessee State University","2011","Total full-time Instruction/research/public service, Non-tenured not on tenure track total","90","38","52","1","0","1","3","2","1","43","13","30","0","0","0","0","0","0","33","16","17","0","0","0","0","0","0","10","7","3","-2"
"221999","Vanderbilt University","2011","Total full-time Instruction/research/public service, Tenured, Professors","602","496","106","0","0","0","29","24","5","20","12","8","10","9","1","0","0","0","535","445","90","0","0","0","0","0","0","8","6","2","-2"
"221999","Vanderbilt University","2011","Total full-time Instruction/research/public service, Tenured, Associate professors","274","186","88","2","1","1","19","15","4","14","9","5","4","3","1","0","0","0","223","150","73","0","0","0","0","0","0","12","8","4","-2"
"221999","Vanderbilt University","2011","Total full-time Instruction/research/public service, Tenured total","876","682","194","2","1","1","48","39","9","34","21","13","14","12","2","0","0","0","758","595","163","0","0","0","0","0","0","20","14","6","-2"
"221999","Vanderbilt University","2011","Total full-time Instruction/research/public service, Non-tenured on tenure track, Professors","2","2","0","0","0","0","1","1","0","0","0","0","1","1","0","0","0","0","0","0","0","0","0","0","0","0","0","0","0","0","-2"
"221999","Vanderbilt University","2011","Total full-time Instruction/research/public service, Non-tenured on tenure track, Associate professors","22","13","9","0","0","0","2","2","0","2","1","1","1","0","1","0","0","0","17","10","7","0","0","0","0","0","0","0","0","0","-2"
"221999","Vanderbilt University","2011","Total full-time Instruction/research/public service, Non-tenured on tenure track, Assistant professors","326","203","123","1","0","1","44","33","11","14","7","7","13","8","5","0","0","0","218","135","83","0","0","0","0","0","0","36","20","16","-2"
"221999","Vanderbilt University","2011","Total full-time Instruction/research/public service, Non-tenured on tenure track, Instructors","1","0","1","0","0","0","0","0","0","0","0","0","0","0","0","0","0","0","0","0","0","0","0","0","0","0","0","1","0","1","-2"
"221999","Vanderbilt University","2011","Total full-time Instruction/research/public service, Non-tenured on tenure track total","351","218","133","1","0","1","47","36","11","16","8","8","15","9","6","0","0","0","235","145","90","0","0","0","0","0","0","37","20","17","-2"
"221999","Vanderbilt University","2011","Total full-time Instruction/research/public service, Non-tenured not on tenure track, Professors","156","116","40","0","0","0","8","7","1","4","3","1","1","0","1","0","0","0","142","105","37","0","0","0","0","0","0","1","1","0","-2"
"221999","Vanderbilt University","2011","Total full-time Instruction/research/public service, Non-tenured not on tenure track, Associate professors","314","207","107","0","0","0","31","21","10","11","6","5","4","2","2","0","0","0","260","171","89","0","0","0","0","0","0","8","7","1","-2"
"221999","Vanderbilt University","2011","Total full-time Instruction/research/public servicey, Non-tenured not on tenure track, Assistant professors","1116","603","513","1","0","1","133","70","63","35","15","20","31","13","18","1","1","0","860","464","396","2","2","0","0","0","0","53","38","15","-2"
"221999","Vanderbilt University","2011","Total full-time Instruction/research/public service, Non-tenured not on tenure track, Instructors","523","169","354","0","0","0","43","27","16","19","5","14","9","4","5","0","0","0","431","116","315","0","0","0","0","0","0","21","17","4","-2"
"221999","Vanderbilt University","2011","Total full-time Instruction/research/public service, Non-tenured not on tenure track, Lecturers","135","49","86","0","0","0","6","0","6","2","1","1","7","1","6","0","0","0","109","44","65","0","0","0","0","0","0","11","3","8","-2"
"221999","Vanderbilt University","2011","Total full-time Instruction/research/public service, Non-tenured not on tenure track, No academic rank","86","57","29","0","0","0","3","2","1","2","0","2","4","3","1","0","0","0","38","27","11","0","0","0","0","0","0","39","25","14","-2"
"221999","Vanderbilt University","2011","Total full-time Instruction/research/public service, Non-tenured not on tenure track total","2330","1201","1129","1","0","1","224","127","97","73","30","43","56","23","33","1","1","0","1840","927","913","2","2","0","0","0","0","133","91","42","-2"
"224147","Texas A & M University-Corpus Christi","2011","Total full-time Instruction/research/public service, Tenured, Professors","85","60","25","0","0","0","5","4","1","2","2","0","10","8","2","0","0","0","64","42","22","0","0","0","0","0","0","4","4","0","-2"
"224147","Texas A & M University-Corpus Christi","2011","Total full-time Instruction/research/public service, Tenured, Associate professors","64","48","16","0","0","0","3","2","1","3","2","1","5","5","0","0","0","0","49","35","14","0","0","0","1","1","0","3","3","0","-2"
"224147","Texas A & M University-Corpus Christi","2011","Total full-time Instruction/research/public service, Tenured, Assistant professors","4","0","4","0","0","0","0","0","0","0","0","0","1","0","1","0","0","0","3","0","3","0","0","0","0","0","0","0","0","0","-2"
"224147","Texas A & M University-Corpus Christi","2011","Total full-time Instruction/research/public service, Tenured total","153","108","45","0","0","0","8","6","2","5","4","1","16","13","3","0","0","0","116","77","39","0","0","0","1","1","0","7","7","0","-2"
"224147","Texas A & M University-Corpus Christi","2011","Total full-time Instruction/research/public service, Non-tenured on tenure track, Associate professors","16","6","10","0","0","0","0","0","0","0","0","0","1","1","0","0","0","0","12","4","8","0","0","0","1","0","1","2","1","1","-2"
"224147","Texas A & M University-Corpus Christi","2011","Total full-time Instruction/research/public service, Non-tenured on tenure track, Assistant professors","66","32","34","0","0","0","5","3","2","2","1","1","10","5","5","0","0","0","40","20","20","0","0","0","9","3","6","0","0","0","-2"
"224147","Texas A & M University-Corpus Christi","2011","Total full-time Instruction/research/public service, Non-tenured on tenure track, No academic rank","2","2","0","0","0","0","0","0","0","0","0","0","0","0","0","0","0","0","1","1","0","0","0","0","0","0","0","1","1","0","-2"
"224147","Texas A & M University-Corpus Christi","2011","Total full-time Instruction/research/public service, Non-tenured on tenure track total","84","40","44","0","0","0","5","3","2","2","1","1","11","6","5","0","0","0","53","25","28","0","0","0","10","3","7","3","2","1","-2"
"224147","Texas A & M University-Corpus Christi","2011","Total full-time Instruction/research/public service, Non-tenured not on tenure track, No academic rank","80","27","53","0","0","0","6","4","2","1","0","1","6","2","4","0","0","0","59","17","42","0","0","0","4","2","2","4","2","2","-2"
"224147","Texas A & M University-Corpus Christi","2011","Total full-time Instruction/research/public service, Non-tenured not on tenure track total","80","27","53","0","0","0","6","4","2","1","0","1","6","2","4","0","0","0","59","17","42","0","0","0","4","2","2","4","2","2","-2"
"225511","University of Houston","2011","Total full-time Instruction/research/public service, Tenured, Professors","391","326","65","0","0","0","62","53","9","6","5","1","15","11","4","0","0","0","307","256","51","1","1","0","0","0","0","0","0","0","-2"
"225511","University of Houston","2011","Total full-time Instruction/research/public service, Tenured, Associate professors","289","187","102","2","2","0","36","23","13","15","9","6","28","14","14","0","0","0","206","138","68","2","1","1","0","0","0","0","0","0","-2"
"225511","University of Houston","2011","Total full-time Instruction/research/public service, Tenured total","680","513","167","2","2","0","98","76","22","21","14","7","43","25","18","0","0","0","513","394","119","3","2","1","0","0","0","0","0","0","-2"
"225511","University of Houston","2011","Total full-time Instruction/research/public service, Non-tenured on tenure track, Professors","4","3","1","0","0","0","0","0","0","0","0","0","0","0","0","0","0","0","1","1","0","0","0","0","0","0","0","3","2","1","-2"
"225511","University of Houston","2011","Total full-time Instruction/research/public service, Non-tenured on tenure track, Associate professors","16","7","9","1","1","0","4","2","2","0","0","0","2","0","2","0","0","0","7","2","5","0","0","0","0","0","0","2","2","0","-2"
"225511","University of Houston","2011","Total full-time Instruction/research/public service, Non-tenured on tenure track, Assistant professors","210","112","98","1","1","0","52","24","28","4","1","3","14","8","6","0","0","0","111","60","51","1","1","0","0","0","0","27","17","10","-2"
"225511","University of Houston","2011","Total full-time Instruction/research/public service, Non-tenured on tenure track total","230","122","108","2","2","0","56","26","30","4","1","3","16","8","8","0","0","0","119","63","56","1","1","0","0","0","0","32","21","11","-2"
"225511","University of Houston","2011","Total full-time Instruction/research/public service, Non-tenured not on tenure track, Lecturers","54","21","33","0","0","0","3","0","3","1","1","0","7","2","5","0","0","0","42","18","24","1","0","1","0","0","0","0","0","0","-2"
"225511","University of Houston","2011","Total full-time Instruction/research/public service, Non-tenured not on tenure track, No academic rank","150","71","79","0","0","0","11","7","4","10","5","5","9","4","5","0","0","0","112","50","62","2","2","0","0","0","0","6","3","3","-2"
"225511","University of Houston","2011","Total full-time Instruction/research/public service, Non-tenured not on tenure track total","204","92","112","0","0","0","14","7","7","11","6","5","16","6","10","0","0","0","154","68","86","3","2","1","0","0","0","6","3","3","-2"
"225627","University of the Incarnate Word","2011","Total full-time Instruction/research/public service, Tenured, Professors","28","11","17","0","0","0","2","1","1","1","0","1","2","2","0","0","0","0","23","8","15","0","0","0","0","0","0","0","0","0","-2"
"225627","University of the Incarnate Word","2011","Total full-time Instruction/research/public service, Tenured, Associate professors","32","13","19","0","0","0","3","2","1","2","0","2","4","2","2","0","0","0","22","9","13","0","0","0","0","0","0","1","0","1","-2"
"225627","University of the Incarnate Word","2011","Total full-time Instruction/research/public service, Tenured, Assistant professors","27","16","11","0","0","0","0","0","0","2","1","1","5","2","3","0","0","0","16","9","7","0","0","0","1","1","0","3","3","0","-2"
"225627","University of the Incarnate Word","2011","Total full-time Instruction/research/public service, Tenured, Instructors","17","5","12","0","0","0","0","0","0","1","0","1","3","2","1","0","0","0","13","3","10","0","0","0","0","0","0","0","0","0","-2"
"225627","University of the Incarnate Word","2011","Total full-time Instruction/research/public service, Tenured, Lecturers","2","0","2","0","0","0","0","0","0","0","0","0","1","0","1","0","0","0","1","0","1","0","0","0","0","0","0","0","0","0","-2"
"225627","University of the Incarnate Word","2011","Total full-time Instruction/research/public service, Tenured total","106","45","61","0","0","0","5","3","2","6","1","5","15","8","7","0","0","0","75","29","46","0","0","0","1","1","0","4","3","1","-2"
"225627","University of the Incarnate Word","2011","Total full-time Instruction/research/public service, Non-tenured on tenure track, Professors","10","6","4","0","0","0","1","1","0","0","0","0","2","1","1","0","0","0","7","4","3","0","0","0","0","0","0","0","0","0","-2"
"225627","University of the Incarnate Word","2011","Total full-time Instruction/research/public service, Non-tenured on tenure track, Associate professors","16","2","14","0","0","0","0","0","0","1","0","1","4","1","3","0","0","0","11","1","10","0","0","0","0","0","0","0","0","0","-2"
"225627","University of the Incarnate Word","2011","Total full-time Instruction/research/public service, Non-tenured on tenure track, Assistant professors","31","18","13","0","0","0","1","1","0","1","1","0","4","3","1","0","0","0","23","11","12","0","0","0","0","0","0","2","2","0","-2"
"225627","University of the Incarnate Word","2011","Total full-time Instruction/research/public service, Non-tenured on tenure track, Instructors","9","6","3","0","0","0","1","1","0","1","0","1","1","0","1","0","0","0","5","4","1","0","0","0","0","0","0","1","1","0","-2"
"225627","University of the Incarnate Word","2011","Total full-time Instruction/research/public service, Non-tenured on tenure track, Lecturers","2","2","0","0","0","0","0","0","0","0","0","0","0","0","0","0","0","0","2","2","0","0","0","0","0","0","0","0","0","0","-2"
"225627","University of the Incarnate Word","2011","Total full-time Instruction/research/public service, Non-tenured on tenure track, No academic rank","1","0","1","0","0","0","0","0","0","0","0","0","0","0","0","0","0","0","1","0","1","0","0","0","0","0","0","0","0","0","-2"
"225627","University of the Incarnate Word","2011","Total full-time Instruction/research/public service, Non-tenured on tenure track total","69","34","35","0","0","0","3","3","0","3","1","2","11","5","6","0","0","0","49","22","27","0","0","0","0","0","0","3","3","0","-2"
"225627","University of the Incarnate Word","2011","Total full-time Instruction/research/public service, Non-tenured not on tenure track, Professors","13","5","8","0","0","0","0","0","0","0","0","0","4","2","2","0","0","0","9","3","6","0","0","0","0","0","0","0","0","0","-2"
"225627","University of the Incarnate Word","2011","Total full-time Instruction/research/public service, Non-tenured not on tenure track, Associate professors","20","12","8","0","0","0","1","1","0","0","0","0","5","3","2","0","0","0","11","7","4","0","0","0","1","0","1","2","1","1","-2"
"225627","University of the Incarnate Word","2011","Total full-time Instruction/research/public servicey, Non-tenured not on tenure track, Assistant professors","31","10","21","0","0","0","1","0","1","1","0","1","6","2","4","0","0","0","20","7","13","1","0","1","1","1","0","1","0","1","-2"
"225627","University of the Incarnate Word","2011","Total full-time Instruction/research/public service, Non-tenured not on tenure track, Instructors","13","8","5","0","0","0","0","0","0","1","1","0","5","2","3","0","0","0","7","5","2","0","0","0","0","0","0","0","0","0","-2"
"225627","University of the Incarnate Word","2011","Total full-time Instruction/research/public service, Non-tenured not on tenure track, Lecturers","1","0","1","0","0","0","0","0","0","0","0","0","1","0","1","0","0","0","0","0","0","0","0","0","0","0","0","0","0","0","-2"
"225627","University of the Incarnate Word","2011","Total full-time Instruction/research/public service, Non-tenured not on tenure track total","78","35","43","0","0","0","2","1","1","2","1","1","21","9","12","0","0","0","47","22","25","1","0","1","2","1","1","3","1","2","-2"
"227757","Rice University","2011","Total full-time Instruction/research/public service, Tenured, Professors","275","225","50","0","0","0","25","21","4","3","3","0","11","10","1","0","0","0","235","190","45","0","0","0","0","0","0","1","1","0","-2"
"227757","Rice University","2011","Total full-time Instruction/research/public service, Tenured, Associate professors","113","74","39","0","0","0","17","9","8","4","3","1","5","4","1","0","0","0","85","56","29","0","0","0","0","0","0","2","2","0","-2"
"227757","Rice University","2011","Total full-time Instruction/research/public service, Tenured total","388","299","89","0","0","0","42","30","12","7","6","1","16","14","2","0","0","0","320","246","74","0","0","0","0","0","0","3","3","0","-2"
"227757","Rice University","2011","Total full-time Instruction/research/public service, Non-tenured on tenure track, Professors","1","1","0","0","0","0","0","0","0","0","0","0","0","0","0","0","0","0","1","1","0","0","0","0","0","0","0","0","0","0","-2"
"227757","Rice University","2011","Total full-time Instruction/research/public service, Non-tenured on tenure track, Assistant professors","110","71","39","0","0","0","12","8","4","3","2","1","5","5","0","0","0","0","75","48","27","0","0","0","0","0","0","15","8","7","-2"
"227757","Rice University","2011","Total full-time Instruction/research/public service, Non-tenured on tenure track total","111","72","39","0","0","0","12","8","4","3","2","1","5","5","0","0","0","0","76","49","27","0","0","0","0","0","0","15","8","7","-2"
"227757","Rice University","2011","Total full-time Instruction/research/public service, Non-tenured not on tenure track, Instructors","18","12","6","0","0","0","0","0","0","0","0","0","1","1","0","0","0","0","10","5","5","0","0","0","0","0","0","7","6","1","-2"
"227757","Rice University","2011","Total full-time Instruction/research/public service, Non-tenured not on tenure track, Lecturers","112","54","58","0","0","0","9","2","7","0","0","0","9","3","6","0","0","0","91","48","43","0","0","0","0","0","0","3","1","2","-2"
"227757","Rice University","2011","Total full-time Instruction/research/public service, Non-tenured not on tenure track, No academic rank","35","22","13","0","0","0","1","1","0","3","1","2","0","0","0","0","0","0","28","18","10","1","1","0","0","0","0","2","1","1","-2"
"227757","Rice University","2011","Total full-time Instruction/research/public service, Non-tenured not on tenure track total","165","88","77","0","0","0","10","3","7","3","1","2","10","4","6","0","0","0","129","71","58","1","1","0","0","0","0","12","8","4","-2"
"228459","Texas State University","2011","Total full-time Instruction/research/public service, Tenured, Professors","277","193","84","1","1","0","13","9","4","3","3","0","17","11","6","0","0","0","195","125","70","2","2","0","45","41","4","1","1","0","-2"
"228459","Texas State University","2011","Total full-time Instruction/research/public service, Tenured, Associate professors","215","122","93","2","0","2","18","14","4","6","2","4","33","20","13","0","0","0","122","62","60","5","3","2","28","21","7","1","0","1","-2"
"228459","Texas State University","2011","Total full-time Instruction/research/public service, Tenured, Assistant professors","10","5","5","0","0","0","0","0","0","1","0","1","2","1","1","0","0","0","7","4","3","0","0","0","0","0","0","0","0","0","-2"
"228459","Texas State University","2011","Total full-time Instruction/research/public service, Tenured, Instructors","1","1","0","0","0","0","0","0","0","0","0","0","0","0","0","0","0","0","1","1","0","0","0","0","0","0","0","0","0","0","-2"
"228459","Texas State University","2011","Total full-time Instruction/research/public service, Tenured total","503","321","182","3","1","2","31","23","8","10","5","5","52","32","20","0","0","0","325","192","133","7","5","2","73","62","11","2","1","1","-2"
"228459","Texas State University","2011","Total full-time Instruction/research/public service, Non-tenured on tenure track, Professors","1","1","0","0","0","0","1","1","0","0","0","0","0","0","0","0","0","0","0","0","0","0","0","0","0","0","0","0","0","0","-2"
"228459","Texas State University","2011","Total full-time Instruction/research/public service, Non-tenured on tenure track, Associate professors","11","6","5","0","0","0","0","0","0","0","0","0","0","0","0","0","0","0","10","5","5","0","0","0","1","1","0","0","0","0","-2"
"228459","Texas State University","2011","Total full-time Instruction/research/public service, Non-tenured on tenure track, Assistant professors","238","118","120","2","2","0","28","18","10","15","7","8","34","14","20","0","0","0","119","51","68","0","0","0","39","25","14","1","1","0","-2"
"228459","Texas State University","2011","Total full-time Instruction/research/public service, Non-tenured on tenure track total","250","125","125","2","2","0","29","19","10","15","7","8","34","14","20","0","0","0","129","56","73","0","0","0","40","26","14","1","1","0","-2"
"228459","Texas State University","2011","Total full-time Instruction/research/public service, Non-tenured not on tenure track, Professors","4","4","0","0","0","0","0","0","0","0","0","0","1","1","0","0","0","0","2","2","0","0","0","0","1","1","0","0","0","0","-2"
"228459","Texas State University","2011","Total full-time Instruction/research/public service, Non-tenured not on tenure track, Associate professors","7","0","7","0","0","0","0","0","0","0","0","0","0","0","0","0","0","0","7","0","7","0","0","0","0","0","0","0","0","0","-2"
"228459","Texas State University","2011","Total full-time Instruction/research/public servicey, Non-tenured not on tenure track, Assistant professors","17","4","13","0","0","0","2","1","1","1","0","1","1","1","0","0","0","0","12","2","10","0","0","0","1","0","1","0","0","0","-2"
"228459","Texas State University","2011","Total full-time Instruction/research/public service, Non-tenured not on tenure track, Instructors","3","1","2","0","0","0","0","0","0","0","0","0","1","0","1","0","0","0","2","1","1","0","0","0","0","0","0","0","0","0","-2"
"228459","Texas State University","2011","Total full-time Instruction/research/public service, Non-tenured not on tenure track, Lecturers","314","136","178","0","0","0","7","2","5","5","3","2","22","10","12","0","0","0","232","98","134","3","1","2","43","22","21","2","0","2","-2"
"228459","Texas State University","2011","Total full-time Instruction/research/public service, Non-tenured not on tenure track, No academic rank","14","10","4","0","0","0","4","3","1","2","1","1","1","0","1","0","0","0","2","2","0","0","0","0","5","4","1","0","0","0","-2"
"228459","Texas State University","2011","Total full-time Instruction/research/public service, Non-tenured not on tenure track total","359","155","204","0","0","0","13","6","7","8","4","4","26","12","14","0","0","0","257","105","152","3","1","2","50","27","23","2","0","2","-2"
"228723","Texas A & M University-College Station","2011","Total full-time Instruction/research/public service, Tenured, Professors","797","691","106","1","0","1","92","83","9","21","16","5","33","25","8","0","0","0","647","565","82","0","0","0","2","1","1","1","1","0","-2"
"228723","Texas A & M University-College Station","2011","Total full-time Instruction/research/public service, Tenured, Associate professors","512","338","174","2","2","0","75","62","13","20","10","10","36","22","14","0","0","0","367","232","135","0","0","0","4","4","0","8","6","2","-2"
"228723","Texas A & M University-College Station","2011","Total full-time Instruction/research/public service, Tenured, Assistant professors","1","0","1","0","0","0","0","0","0","0","0","0","0","0","0","0","0","0","1","0","1","0","0","0","0","0","0","0","0","0","-2"
"228723","Texas A & M University-College Station","2011","Total full-time Instruction/research/public service, Tenured total","1310","1029","281","3","2","1","167","145","22","41","26","15","69","47","22","0","0","0","1015","797","218","0","0","0","6","5","1","9","7","2","-2"
"228723","Texas A & M University-College Station","2011","Total full-time Instruction/research/public service, Non-tenured on tenure track, Professors","4","3","1","0","0","0","1","0","1","0","0","0","0","0","0","0","0","0","3","3","0","0","0","0","0","0","0","0","0","0","-2"
"228723","Texas A & M University-College Station","2011","Total full-time Instruction/research/public service, Non-tenured on tenure track, Associate professors","16","13","3","0","0","0","1","1","0","0","0","0","0","0","0","0","0","0","14","11","3","0","0","0","0","0","0","1","1","0","-2"
"228723","Texas A & M University-College Station","2011","Total full-time Instruction/research/public service, Non-tenured on tenure track, Assistant professors","424","262","162","1","1","0","67","43","24","30","15","15","33","21","12","0","0","0","238","149","89","2","1","1","4","2","2","49","30","19","-2"
"228723","Texas A & M University-College Station","2011","Total full-time Instruction/research/public service, Non-tenured on tenure track total","444","278","166","1","1","0","69","44","25","30","15","15","33","21","12","0","0","0","255","163","92","2","1","1","4","2","2","50","31","19","-2"
"228723","Texas A & M University-College Station","2011","Total full-time Instruction/research/public service, Non-tenured not on tenure track, Professors","65","46","19","1","0","1","5","4","1","0","0","0","0","0","0","0","0","0","54","38","16","0","0","0","2","2","0","3","2","1","-2"
"228723","Texas A & M University-College Station","2011","Total full-time Instruction/research/public service, Non-tenured not on tenure track, Associate professors","59","35","24","0","0","0","6","4","2","3","1","2","1","1","0","0","0","0","49","29","20","0","0","0","0","0","0","0","0","0","-2"
"228723","Texas A & M University-College Station","2011","Total full-time Instruction/research/public servicey, Non-tenured not on tenure track, Assistant professors","114","71","43","0","0","0","9","6","3","5","1","4","4","1","3","0","0","0","71","42","29","0","0","0","2","1","1","23","20","3","-2"
"228723","Texas A & M University-College Station","2011","Total full-time Instruction/research/public service, Non-tenured not on tenure track, Instructors","116","48","68","1","0","1","0","0","0","0","0","0","3","3","0","0","0","0","105","44","61","0","0","0","3","1","2","4","0","4","-2"
"228723","Texas A & M University-College Station","2011","Total full-time Instruction/research/public service, Non-tenured not on tenure track, Lecturers","252","107","145","1","1","0","16","6","10","6","3","3","10","8","2","0","0","0","207","82","125","1","0","1","2","2","0","9","5","4","-2"
"228723","Texas A & M University-College Station","2011","Total full-time Instruction/research/public service, Non-tenured not on tenure track, No academic rank","2","1","1","0","0","0","1","1","0","1","0","1","0","0","0","0","0","0","0","0","0","0","0","0","0","0","0","0","0","0","-2"
"228723","Texas A & M University-College Station","2011","Total full-time Instruction/research/public service, Non-tenured not on tenure track total","608","308","300","3","1","2","37","21","16","15","5","10","18","13","5","0","0","0","486","235","251","1","0","1","9","6","3","39","27","12","-2"
"228769","The University of Texas at Arlington","2011","Total full-time Instruction/research/public service, Tenured, Professors","170","144","26","1","0","1","46","41","5","2","1","1","6","6","0","2","2","0","113","94","19","0","0","0","0","0","0","0","0","0","-2"
"228769","The University of Texas at Arlington","2011","Total full-time Instruction/research/public service, Tenured, Associate professors","196","136","60","0","0","0","35","29","6","7","7","0","15","9","6","7","7","0","132","84","48","0","0","0","0","0","0","0","0","0","-2"
"228769","The University of Texas at Arlington","2011","Total full-time Instruction/research/public service, Tenured total","366","280","86","1","0","1","81","70","11","9","8","1","21","15","6","9","9","0","245","178","67","0","0","0","0","0","0","0","0","0","-2"
"228769","The University of Texas at Arlington","2011","Total full-time Instruction/research/public service, Non-tenured on tenure track, Associate professors","9","5","4","0","0","0","0","0","0","0","0","0","1","1","0","0","0","0","8","4","4","0","0","0","0","0","0","0","0","0","-2"
"228769","The University of Texas at Arlington","2011","Total full-time Instruction/research/public service, Non-tenured on tenure track, Assistant professors","200","119","81","0","0","0","50","35","15","14","6","8","14","8","6","6","3","3","116","67","49","0","0","0","0","0","0","0","0","0","-2"
"228769","The University of Texas at Arlington","2011","Total full-time Instruction/research/public service, Non-tenured on tenure track total","209","124","85","0","0","0","50","35","15","14","6","8","15","9","6","6","3","3","124","71","53","0","0","0","0","0","0","0","0","0","-2"
"228769","The University of Texas at Arlington","2011","Total full-time Instruction/research/public service, Non-tenured not on tenure track, Lecturers","276","101","175","4","0","4","10","6","4","13","5","8","11","5","6","1","1","0","237","84","153","0","0","0","0","0","0","0","0","0","-2"
"228769","The University of Texas at Arlington","2011","Total full-time Instruction/research/public service, Non-tenured not on tenure track total","276","101","175","4","0","4","10","6","4","13","5","8","11","5","6","1","1","0","237","84","153","0","0","0","0","0","0","0","0","0","-2"
"228778","The University of Texas at Austin","2011","Total full-time Instruction/research/public service, Tenured, Professors","982","774","208","5","3","2","41","37","4","22","16","6","34","24","10","0","0","0","751","587","164","3","1","2","0","0","0","126","106","20","-2"
"228778","The University of Texas at Austin","2011","Total full-time Instruction/research/public service, Tenured, Associate professors","524","322","202","4","2","2","17","10","7","31","13","18","28","16","12","0","0","0","324","201","123","6","1","5","0","0","0","114","79","35","-2"
"228778","The University of Texas at Austin","2011","Total full-time Instruction/research/public service, Tenured total","1506","1096","410","9","5","4","58","47","11","53","29","24","62","40","22","0","0","0","1075","788","287","9","2","7","0","0","0","240","185","55","-2"
"228778","The University of Texas at Austin","2011","Total full-time Instruction/research/public service, Non-tenured on tenure track, Associate professors","3","2","1","0","0","0","0","0","0","0","0","0","0","0","0","0","0","0","3","2","1","0","0","0","0","0","0","0","0","0","-2"
"228778","The University of Texas at Austin","2011","Total full-time Instruction/research/public service, Non-tenured on tenure track, Assistant professors","400","229","171","0","0","0","16","7","9","24","12","12","22","12","10","0","0","0","198","105","93","3","2","1","0","0","0","137","91","46","-2"
"228778","The University of Texas at Austin","2011","Total full-time Instruction/research/public service, Non-tenured on tenure track, No academic rank","1","1","0","0","0","0","0","0","0","0","0","0","0","0","0","0","0","0","0","0","0","0","0","0","0","0","0","1","1","0","-2"
"228778","The University of Texas at Austin","2011","Total full-time Instruction/research/public service, Non-tenured on tenure track total","404","232","172","0","0","0","16","7","9","24","12","12","22","12","10","0","0","0","201","107","94","3","2","1","0","0","0","138","92","46","-2"
"228778","The University of Texas at Austin","2011","Total full-time Instruction/research/public service, Non-tenured not on tenure track, Lecturers","363","177","186","0","0","0","12","8","4","4","2","2","16","5","11","0","0","0","272","143","129","0","0","0","0","0","0","59","19","40","-2"
"228778","The University of Texas at Austin","2011","Total full-time Instruction/research/public service, Non-tenured not on tenure track, No academic rank","189","59","130","0","0","0","8","3","5","7","2","5","15","5","10","0","0","0","139","40","99","0","0","0","0","0","0","20","9","11","-2"
"228778","The University of Texas at Austin","2011","Total full-time Instruction/research/public service, Non-tenured not on tenure track total","552","236","316","0","0","0","20","11","9","11","4","7","31","10","21","0","0","0","411","183","228","0","0","0","0","0","0","79","28","51","-2"
"228796","The University of Texas at El Paso","2011","Total full-time Instruction/research/public service, Tenured, Professors","142","111","31","0","0","0","12","10","2","1","1","0","33","22","11","0","0","0","95","77","18","1","1","0","0","0","0","0","0","0","-2"
"228796","The University of Texas at El Paso","2011","Total full-time Instruction/research/public service, Tenured, Associate professors","186","133","53","0","0","0","18","14","4","2","2","0","53","35","18","0","0","0","113","82","31","0","0","0","0","0","0","0","0","0","-2"
"228796","The University of Texas at El Paso","2011","Total full-time Instruction/research/public service, Tenured, Assistant professors","2","1","1","1","1","0","0","0","0","0","0","0","0","0","0","0","0","0","1","0","1","0","0","0","0","0","0","0","0","0","-2"
"228796","The University of Texas at El Paso","2011","Total full-time Instruction/research/public service, Tenured total","330","245","85","1","1","0","30","24","6","3","3","0","86","57","29","0","0","0","209","159","50","1","1","0","0","0","0","0","0","0","-2"
"228796","The University of Texas at El Paso","2011","Total full-time Instruction/research/public service, Non-tenured on tenure track, Associate professors","13","11","2","0","0","0","3","2","1","0","0","0","6","6","0","0","0","0","4","3","1","0","0","0","0","0","0","0","0","0","-2"
"228796","The University of Texas at El Paso","2011","Total full-time Instruction/research/public service, Non-tenured on tenure track, Assistant professors","145","78","67","1","0","1","19","11","8","2","1","1","40","22","18","0","0","0","58","30","28","1","1","0","0","0","0","24","13","11","-2"
"228796","The University of Texas at El Paso","2011","Total full-time Instruction/research/public service, Non-tenured on tenure track total","158","89","69","1","0","1","22","13","9","2","1","1","46","28","18","0","0","0","62","33","29","1","1","0","0","0","0","24","13","11","-2"
"228796","The University of Texas at El Paso","2011","Total full-time Instruction/research/public service, Non-tenured not on tenure track, Lecturers","205","79","126","2","0","2","10","3","7","3","0","3","70","29","41","0","0","0","99","35","64","0","0","0","0","0","0","21","12","9","-2"
"228796","The University of Texas at El Paso","2011","Total full-time Instruction/research/public service, Non-tenured not on tenure track total","205","79","126","2","0","2","10","3","7","3","0","3","70","29","41","0","0","0","99","35","64","0","0","0","0","0","0","21","12","9","-2"
"229063","Texas Southern University","2011","Total full-time Instruction/research/public service, Tenured, Professors","115","87","28","0","0","0","9","8","1","76","55","21","3","3","0","0","0","0","18","14","4","0","0","0","0","0","0","9","7","2","-2"
"229063","Texas Southern University","2011","Total full-time Instruction/research/public service, Tenured, Associate professors","104","49","55","0","0","0","20","10","10","59","25","34","1","0","1","0","0","0","18","10","8","0","0","0","0","0","0","6","4","2","-2"
"229063","Texas Southern University","2011","Total full-time Instruction/research/public service, Tenured, Assistant professors","12","8","4","0","0","0","0","0","0","9","7","2","0","0","0","0","0","0","2","0","2","0","0","0","0","0","0","1","1","0","-2"
"229063","Texas Southern University","2011","Total full-time Instruction/research/public service, Tenured, Instructors","3","2","1","0","0","0","0","0","0","2","1","1","0","0","0","0","0","0","1","1","0","0","0","0","0","0","0","0","0","0","-2"
"229063","Texas Southern University","2011","Total full-time Instruction/research/public service, Tenured total","234","146","88","0","0","0","29","18","11","146","88","58","4","3","1","0","0","0","39","25","14","0","0","0","0","0","0","16","12","4","-2"
"229063","Texas Southern University","2011","Total full-time Instruction/research/public service, Non-tenured on tenure track, Associate professors","14","6","8","0","0","0","1","1","0","11","4","7","0","0","0","0","0","0","2","1","1","0","0","0","0","0","0","0","0","0","-2"
"229063","Texas Southern University","2011","Total full-time Instruction/research/public service, Non-tenured on tenure track, Assistant professors","71","27","44","0","0","0","9","4","5","52","17","35","1","1","0","0","0","0","6","4","2","0","0","0","0","0","0","3","1","2","-2"
"229063","Texas Southern University","2011","Total full-time Instruction/research/public service, Non-tenured on tenure track, Instructors","1","0","1","0","0","0","0","0","0","1","0","1","0","0","0","0","0","0","0","0","0","0","0","0","0","0","0","0","0","0","-2"
"229063","Texas Southern University","2011","Total full-time Instruction/research/public service, Non-tenured on tenure track, No academic rank","1","1","0","0","0","0","0","0","0","1","1","0","0","0","0","0","0","0","0","0","0","0","0","0","0","0","0","0","0","0","-2"
"229063","Texas Southern University","2011","Total full-time Instruction/research/public service, Non-tenured on tenure track total","87","34","53","0","0","0","10","5","5","65","22","43","1","1","0","0","0","0","8","5","3","0","0","0","0","0","0","3","1","2","-2"
"229063","Texas Southern University","2011","Total full-time Instruction/research/public service, Non-tenured not on tenure track, Instructors","2","1","1","0","0","0","0","0","0","2","1","1","0","0","0","0","0","0","0","0","0","0","0","0","0","0","0","0","0","0","-2"
"229063","Texas Southern University","2011","Total full-time Instruction/research/public service, Non-tenured not on tenure track, No academic rank","77","41","36","0","0","0","5","3","2","57","29","28","5","3","2","0","0","0","6","4","2","0","0","0","0","0","0","4","2","2","-2"
"229063","Texas Southern University","2011","Total full-time Instruction/research/public service, Non-tenured not on tenure track total","79","42","37","0","0","0","5","3","2","59","30","29","5","3","2","0","0","0","6","4","2","0","0","0","0","0","0","4","2","2","-2"
"229115","Texas Tech University","2011","Total full-time Instruction/research/public service, Tenured, Professors","298","230","68","2","1","1","21","15","6","5","3","2","11","8","3","0","0","0","239","185","54","0","0","0","0","0","0","20","18","2","-2"
"229115","Texas Tech University","2011","Total full-time Instruction/research/public service, Tenured, Associate professors","334","223","111","1","1","0","10","7","3","3","2","1","14","8","6","0","0","0","247","164","83","0","0","0","0","0","0","59","41","18","-2"
"229115","Texas Tech University","2011","Total full-time Instruction/research/public service, Tenured, Assistant professors","6","4","2","0","0","0","0","0","0","0","0","0","1","0","1","0","0","0","5","4","1","0","0","0","0","0","0","0","0","0","-2"
"229115","Texas Tech University","2011","Total full-time Instruction/research/public service, Tenured total","638","457","181","3","2","1","31","22","9","8","5","3","26","16","10","0","0","0","491","353","138","0","0","0","0","0","0","79","59","20","-2"
"229115","Texas Tech University","2011","Total full-time Instruction/research/public service, Non-tenured on tenure track, Professors","8","7","1","0","0","0","0","0","0","0","0","0","1","0","1","0","0","0","7","7","0","0","0","0","0","0","0","0","0","0","-2"
"229115","Texas Tech University","2011","Total full-time Instruction/research/public service, Non-tenured on tenure track, Associate professors","41","28","13","0","0","0","2","1","1","1","1","0","1","1","0","0","0","0","27","19","8","0","0","0","0","0","0","10","6","4","-2"
"229115","Texas Tech University","2011","Total full-time Instruction/research/public service, Non-tenured on tenure track, Assistant professors","256","159","97","0","0","0","14","11","3","3","1","2","18","9","9","0","0","0","150","95","55","2","0","2","0","0","0","69","43","26","-2"
"229115","Texas Tech University","2011","Total full-time Instruction/research/public service, Non-tenured on tenure track total","305","194","111","0","0","0","16","12","4","4","2","2","20","10","10","0","0","0","184","121","63","2","0","2","0","0","0","79","49","30","-2"
"229115","Texas Tech University","2011","Total full-time Instruction/research/public service, Non-tenured not on tenure track, Professors","5","4","1","0","0","0","0","0","0","0","0","0","1","1","0","0","0","0","4","3","1","0","0","0","0","0","0","0","0","0","-2"
"229115","Texas Tech University","2011","Total full-time Instruction/research/public service, Non-tenured not on tenure track, Associate professors","3","2","1","0","0","0","0","0","0","0","0","0","0","0","0","0","0","0","2","1","1","0","0","0","0","0","0","1","1","0","-2"
"229115","Texas Tech University","2011","Total full-time Instruction/research/public servicey, Non-tenured not on tenure track, Assistant professors","24","17","7","0","0","0","0","0","0","1","1","0","1","1","0","0","0","0","17","11","6","1","1","0","0","0","0","4","3","1","-2"
"229115","Texas Tech University","2011","Total full-time Instruction/research/public service, Non-tenured not on tenure track, Instructors","192","83","109","1","1","0","3","1","2","3","1","2","6","3","3","0","0","0","157","65","92","1","0","1","0","0","0","21","12","9","-2"
"229115","Texas Tech University","2011","Total full-time Instruction/research/public service, Non-tenured not on tenure track total","224","106","118","1","1","0","3","1","2","4","2","2","8","5","3","0","0","0","180","80","100","2","1","1","0","0","0","26","16","10","-2"
"230728","Utah State University","2011","Total full-time Instruction/research/public service, Tenured, Professors","220","183","37","0","0","0","9","8","1","1","1","0","2","1","1","0","0","0","194","161","33","1","1","0","4","3","1","9","8","1","-2"
"230728","Utah State University","2011","Total full-time Instruction/research/public service, Tenured, Associate professors","271","176","95","1","1","0","4","4","0","2","1","1","12","6","6","0","0","0","234","152","82","0","0","0","5","4","1","13","8","5","-2"
"230728","Utah State University","2011","Total full-time Instruction/research/public service, Tenured total","491","359","132","1","1","0","13","12","1","3","2","1","14","7","7","0","0","0","428","313","115","1","1","0","9","7","2","22","16","6","-2"
"230728","Utah State University","2011","Total full-time Instruction/research/public service, Non-tenured on tenure track, Professors","1","1","0","0","0","0","0","0","0","0","0","0","0","0","0","0","0","0","1","1","0","0","0","0","0","0","0","0","0","0","-2"
"230728","Utah State University","2011","Total full-time Instruction/research/public service, Non-tenured on tenure track, Associate professors","7","4","3","0","0","0","0","0","0","0","0","0","0","0","0","0","0","0","4","3","1","1","0","1","2","1","1","0","0","0","-2"
"230728","Utah State University","2011","Total full-time Instruction/research/public service, Non-tenured on tenure track, Assistant professors","187","104","83","1","0","1","11","9","2","0","0","0","7","3","4","0","0","0","125","75","50","0","0","0","21","4","17","22","13","9","-2"
"230728","Utah State University","2011","Total full-time Instruction/research/public service, Non-tenured on tenure track total","195","109","86","1","0","1","11","9","2","0","0","0","7","3","4","0","0","0","130","79","51","1","0","1","23","5","18","22","13","9","-2"
"230728","Utah State University","2011","Total full-time Instruction/research/public service, Non-tenured not on tenure track, Professors","5","5","0","0","0","0","0","0","0","0","0","0","0","0","0","0","0","0","4","4","0","0","0","0","0","0","0","1","1","0","-2"
"230728","Utah State University","2011","Total full-time Instruction/research/public service, Non-tenured not on tenure track, Associate professors","16","11","5","0","0","0","2","2","0","0","0","0","1","1","0","0","0","0","11","6","5","0","0","0","1","1","0","1","1","0","-2"
"230728","Utah State University","2011","Total full-time Instruction/research/public servicey, Non-tenured not on tenure track, Assistant professors","46","26","20","0","0","0","2","1","1","1","0","1","1","1","0","0","0","0","31","16","15","0","0","0","7","5","2","4","3","1","-2"
"230728","Utah State University","2011","Total full-time Instruction/research/public service, Non-tenured not on tenure track, Instructors","17","4","13","0","0","0","0","0","0","0","0","0","0","0","0","0","0","0","15","4","11","0","0","0","2","0","2","0","0","0","-2"
"230728","Utah State University","2011","Total full-time Instruction/research/public service, Non-tenured not on tenure track, Lecturers","97","51","46","1","0","1","1","0","1","2","1","1","2","1","1","0","0","0","79","40","39","0","0","0","11","8","3","1","1","0","-2"
"230728","Utah State University","2011","Total full-time Instruction/research/public service, Non-tenured not on tenure track total","181","97","84","1","0","1","5","3","2","3","1","2","4","3","1","0","0","0","140","70","70","0","0","0","21","14","7","7","6","1","-2"
"230764","University of Utah","2011","Total full-time Instruction/research/public service, Tenured, Professors","621","487","134","5","2","3","44","38","6","3","2","1","14","11","3","0","0","0","503","392","111","0","0","0","46","36","10","6","6","0","-2"
"230764","University of Utah","2011","Total full-time Instruction/research/public service, Tenured, Associate professors","324","218","106","0","0","0","23","15","8","7","5","2","16","11","5","0","0","0","239","159","80","2","0","2","26","20","6","11","8","3","-2"
"230764","University of Utah","2011","Total full-time Instruction/research/public service, Tenured, Assistant professors","1","0","1","0","0","0","0","0","0","0","0","0","0","0","0","0","0","0","1","0","1","0","0","0","0","0","0","0","0","0","-2"
"230764","University of Utah","2011","Total full-time Instruction/research/public service, Tenured total","946","705","241","5","2","3","67","53","14","10","7","3","30","22","8","0","0","0","743","551","192","2","0","2","72","56","16","17","14","3","-2"
"230764","University of Utah","2011","Total full-time Instruction/research/public service, Non-tenured on tenure track, Professors","13","12","1","0","0","0","0","0","0","0","0","0","0","0","0","0","0","0","5","5","0","0","0","0","8","7","1","0","0","0","-2"
"230764","University of Utah","2011","Total full-time Instruction/research/public service, Non-tenured on tenure track, Associate professors","48","28","20","0","0","0","5","5","0","0","0","0","0","0","0","0","0","0","16","4","12","0","0","0","27","19","8","0","0","0","-2"
"230764","University of Utah","2011","Total full-time Instruction/research/public service, Non-tenured on tenure track, Assistant professors","336","189","147","3","0","3","19","14","5","2","1","1","8","3","5","0","0","0","145","77","68","1","1","0","124","71","53","34","22","12","-2"
"230764","University of Utah","2011","Total full-time Instruction/research/public service, Non-tenured on tenure track, Instructors","7","3","4","0","0","0","1","0","1","0","0","0","0","0","0","0","0","0","3","1","2","0","0","0","2","1","1","1","1","0","-2"
"230764","University of Utah","2011","Total full-time Instruction/research/public service, Non-tenured on tenure track total","404","232","172","3","0","3","25","19","6","2","1","1","8","3","5","0","0","0","169","87","82","1","1","0","161","98","63","35","23","12","-2"
"230764","University of Utah","2011","Total full-time Instruction/research/public service, Non-tenured not on tenure track, Professors","149","103","46","0","0","0","8","6","2","0","0","0","2","0","2","0","0","0","127","87","40","0","0","0","11","9","2","1","1","0","-2"
"230764","University of Utah","2011","Total full-time Instruction/research/public service, Non-tenured not on tenure track, Associate professors","222","128","94","0","0","0","15","12","3","2","2","0","2","1","1","0","0","0","171","95","76","0","0","0","23","14","9","9","4","5","-2"
"230764","University of Utah","2011","Total full-time Instruction/research/public servicey, Non-tenured not on tenure track, Assistant professors","500","284","216","1","0","1","34","18","16","5","2","3","8","5","3","1","0","1","306","159","147","2","2","0","103","66","37","40","32","8","-2"
"230764","University of Utah","2011","Total full-time Instruction/research/public service, Non-tenured not on tenure track, Instructors","111","42","69","0","0","0","3","1","2","1","0","1","1","0","1","0","0","0","79","30","49","0","0","0","20","6","14","7","5","2","-2"
"230764","University of Utah","2011","Total full-time Instruction/research/public service, Non-tenured not on tenure track, Lecturers","178","107","71","2","1","1","3","1","2","2","1","1","2","1","1","0","0","0","132","83","49","2","0","2","26","14","12","9","6","3","-2"
"230764","University of Utah","2011","Total full-time Instruction/research/public service, Non-tenured not on tenure track, No academic rank","549","319","230","0","0","0","43","24","19","2","1","1","7","3","4","1","0","1","214","111","103","0","0","0","118","64","54","164","116","48","-2"
"230764","University of Utah","2011","Total full-time Instruction/research/public service, Non-tenured not on tenure track total","1709","983","726","3","1","2","106","62","44","12","6","6","22","10","12","2","0","2","1029","565","464","4","2","2","301","173","128","230","164","66","-2"
"230913","Northern Vermont University","2011","Total full-time Instruction/research/public service, Tenured, Professors","26","16","10","0","0","0","0","0","0","0","0","0","0","0","0","0","0","0","25","16","9","1","0","1","0","0","0","0","0","0","-2"
"230913","Northern Vermont University","2011","Total full-time Instruction/research/public service, Tenured, Associate professors","5","4","1","0","0","0","0","0","0","0","0","0","0","0","0","0","0","0","5","4","1","0","0","0","0","0","0","0","0","0","-2"
"230913","Northern Vermont University","2011","Total full-time Instruction/research/public service, Tenured, Assistant professors","1","0","1","0","0","0","0","0","0","0","0","0","0","0","0","0","0","0","1","0","1","0","0","0","0","0","0","0","0","0","-2"
"230913","Northern Vermont University","2011","Total full-time Instruction/research/public service, Tenured total","32","20","12","0","0","0","0","0","0","0","0","0","0","0","0","0","0","0","31","20","11","1","0","1","0","0","0","0","0","0","-2"
"230913","Northern Vermont University","2011","Total full-time Instruction/research/public service, Non-tenured on tenure track, Associate professors","2","2","0","0","0","0","0","0","0","0","0","0","0","0","0","0","0","0","2","2","0","0","0","0","0","0","0","0","0","0","-2"
"230913","Northern Vermont University","2011","Total full-time Instruction/research/public service, Non-tenured on tenure track, Assistant professors","13","7","6","0","0","0","0","0","0","0","0","0","0","0","0","0","0","0","11","5","6","0","0","0","2","2","0","0","0","0","-2"
"230913","Northern Vermont University","2011","Total full-time Instruction/research/public service, Non-tenured on tenure track total","15","9","6","0","0","0","0","0","0","0","0","0","0","0","0","0","0","0","13","7","6","0","0","0","2","2","0","0","0","0","-2"
"232186","George Mason University","2011","Total full-time Instruction/research/public service, Tenured, Professors","336","261","75","1","1","0","23","19","4","8","3","5","5","5","0","0","0","0","280","219","61","0","0","0","17","12","5","2","2","0","-2"
"232186","George Mason University","2011","Total full-time Instruction/research/public service, Tenured, Associate professors","313","189","124","1","0","1","40","30","10","12","6","6","11","6","5","0","0","0","232","137","95","0","0","0","15","9","6","2","1","1","-2"
"232186","George Mason University","2011","Total full-time Instruction/research/public service, Tenured total","649","450","199","2","1","1","63","49","14","20","9","11","16","11","5","0","0","0","512","356","156","0","0","0","32","21","11","4","3","1","-2"
"232186","George Mason University","2011","Total full-time Instruction/research/public service, Non-tenured on tenure track, Associate professors","16","8","8","0","0","0","1","1","0","1","0","1","0","0","0","1","0","1","10","5","5","0","0","0","2","2","0","1","0","1","-2"
"232186","George Mason University","2011","Total full-time Instruction/research/public service, Non-tenured on tenure track, Assistant professors","223","117","106","1","0","1","26","11","15","6","3","3","10","5","5","0","0","0","102","56","46","0","0","0","51","23","28","27","19","8","-2"
"232186","George Mason University","2011","Total full-time Instruction/research/public service, Non-tenured on tenure track total","239","125","114","1","0","1","27","12","15","7","3","4","10","5","5","1","0","1","112","61","51","0","0","0","53","25","28","28","19","9","-2"
"232186","George Mason University","2011","Total full-time Instruction/research/public service, Non-tenured not on tenure track, Professors","39","31","8","0","0","0","8","7","1","0","0","0","1","1","0","0","0","0","23","17","6","0","0","0","6","5","1","1","1","0","-2"
"232186","George Mason University","2011","Total full-time Instruction/research/public service, Non-tenured not on tenure track, Associate professors","74","42","32","1","1","0","8","7","1","4","1","3","3","2","1","0","0","0","46","23","23","0","0","0","7","4","3","5","4","1","-2"
"232186","George Mason University","2011","Total full-time Instruction/research/public servicey, Non-tenured not on tenure track, Assistant professors","199","92","107","0","0","0","12","7","5","10","5","5","6","3","3","0","0","0","131","57","74","0","0","0","22","10","12","18","10","8","-2"
"232186","George Mason University","2011","Total full-time Instruction/research/public service, Non-tenured not on tenure track, Instructors","144","67","77","0","0","0","11","9","2","4","1","3","4","0","4","0","0","0","91","37","54","1","0","1","15","8","7","18","12","6","-2"
"232186","George Mason University","2011","Total full-time Instruction/research/public service, Non-tenured not on tenure track total","456","232","224","1","1","0","39","30","9","18","7","11","14","6","8","0","0","0","291","134","157","1","0","1","50","27","23","42","27","15","-2"
"232265","Hampton University","2011","Total full-time Instruction/research/public service, Tenured, Professors","39","26","13","0","0","0","8","7","1","27","16","11","0","0","0","1","1","0","3","2","1","0","0","0","0","0","0","0","0","0","-2"
"232265","Hampton University","2011","Total full-time Instruction/research/public service, Tenured, Associate professors","39","22","17","0","0","0","4","4","0","20","8","12","2","1","1","0","0","0","13","9","4","0","0","0","0","0","0","0","0","0","-2"
"232265","Hampton University","2011","Total full-time Instruction/research/public service, Tenured, Assistant professors","14","8","6","0","0","0","2","2","0","7","3","4","1","0","1","0","0","0","4","3","1","0","0","0","0","0","0","0","0","0","-2"
"232265","Hampton University","2011","Total full-time Instruction/research/public service, Tenured total","92","56","36","0","0","0","14","13","1","54","27","27","3","1","2","1","1","0","20","14","6","0","0","0","0","0","0","0","0","0","-2"
"232265","Hampton University","2011","Total full-time Instruction/research/public service, Non-tenured on tenure track, Professors","3","1","2","0","0","0","0","0","0","2","1","1","0","0","0","0","0","0","1","0","1","0","0","0","0","0","0","0","0","0","-2"
"232265","Hampton University","2011","Total full-time Instruction/research/public service, Non-tenured on tenure track, Associate professors","14","6","8","0","0","0","1","0","1","12","5","7","0","0","0","1","1","0","0","0","0","0","0","0","0","0","0","0","0","0","-2"
"232265","Hampton University","2011","Total full-time Instruction/research/public service, Non-tenured on tenure track, Assistant professors","18","10","8","0","0","0","2","1","1","10","5","5","0","0","0","0","0","0","6","4","2","0","0","0","0","0","0","0","0","0","-2"
"232265","Hampton University","2011","Total full-time Instruction/research/public service, Non-tenured on tenure track, Lecturers","1","1","0","0","0","0","0","0","0","0","0","0","0","0","0","0","0","0","1","1","0","0","0","0","0","0","0","0","0","0","-2"
"232265","Hampton University","2011","Total full-time Instruction/research/public service, Non-tenured on tenure track total","36","18","18","0","0","0","3","1","2","24","11","13","0","0","0","1","1","0","8","5","3","0","0","0","0","0","0","0","0","0","-2"
"232265","Hampton University","2011","Total full-time Instruction/research/public service, Non-tenured not on tenure track, Professors","27","18","9","0","0","0","2","2","0","16","8","8","1","1","0","0","0","0","4","3","1","0","0","0","2","2","0","2","2","0","-2"
"232265","Hampton University","2011","Total full-time Instruction/research/public service, Non-tenured not on tenure track, Associate professors","41","18","23","0","0","0","8","4","4","25","11","14","0","0","0","0","0","0","8","3","5","0","0","0","0","0","0","0","0","0","-2"
"232265","Hampton University","2011","Total full-time Instruction/research/public servicey, Non-tenured not on tenure track, Assistant professors","116","49","67","1","0","1","11","5","6","75","28","47","3","1","2","0","0","0","23","13","10","0","0","0","0","0","0","3","2","1","-2"
"232265","Hampton University","2011","Total full-time Instruction/research/public service, Non-tenured not on tenure track, Instructors","13","1","12","0","0","0","3","1","2","7","0","7","0","0","0","0","0","0","1","0","1","0","0","0","0","0","0","2","0","2","-2"
"232265","Hampton University","2011","Total full-time Instruction/research/public service, Non-tenured not on tenure track, Lecturers","14","6","8","0","0","0","0","0","0","9","3","6","0","0","0","0","0","0","3","2","1","0","0","0","0","0","0","2","1","1","-2"
"232265","Hampton University","2011","Total full-time Instruction/research/public service, Non-tenured not on tenure track, No academic rank","31","16","15","0","0","0","5","5","0","18","6","12","0","0","0","0","0","0","6","5","1","0","0","0","0","0","0","2","0","2","-2"
"232265","Hampton University","2011","Total full-time Instruction/research/public service, Non-tenured not on tenure track total","242","108","134","1","0","1","29","17","12","150","56","94","4","2","2","0","0","0","45","26","19","0","0","0","2","2","0","11","5","6","-2"
"232982","Old Dominion University","2011","Total full-time Instruction/research/public service, Tenured, Professors","201","163","38","1","0","1","22","21","1","8","7","1","4","3","1","0","0","0","120","93","27","0","0","0","32","26","6","14","13","1","-2"
"232982","Old Dominion University","2011","Total full-time Instruction/research/public service, Tenured, Associate professors","180","105","75","1","1","0","14","8","6","14","6","8","7","5","2","0","0","0","114","65","49","0","0","0","26","18","8","4","2","2","-2"
"232982","Old Dominion University","2011","Total full-time Instruction/research/public service, Tenured total","381","268","113","2","1","1","36","29","7","22","13","9","11","8","3","0","0","0","234","158","76","0","0","0","58","44","14","18","15","3","-2"
"232982","Old Dominion University","2011","Total full-time Instruction/research/public service, Non-tenured on tenure track, Professors","3","2","1","0","0","0","0","0","0","0","0","0","0","0","0","0","0","0","2","2","0","0","0","0","1","0","1","0","0","0","-2"
"232982","Old Dominion University","2011","Total full-time Instruction/research/public service, Non-tenured on tenure track, Associate professors","18","12","6","0","0","0","2","2","0","2","1","1","1","1","0","0","0","0","9","5","4","0","0","0","3","2","1","1","1","0","-2"
"232982","Old Dominion University","2011","Total full-time Instruction/research/public service, Non-tenured on tenure track, Assistant professors","156","92","64","1","0","1","23","14","9","7","3","4","6","4","2","0","0","0","87","51","36","1","1","0","9","3","6","22","16","6","-2"
"232982","Old Dominion University","2011","Total full-time Instruction/research/public service, Non-tenured on tenure track, Instructors","1","1","0","0","0","0","0","0","0","0","0","0","0","0","0","0","0","0","1","1","0","0","0","0","0","0","0","0","0","0","-2"
"232982","Old Dominion University","2011","Total full-time Instruction/research/public service, Non-tenured on tenure track total","178","107","71","1","0","1","25","16","9","9","4","5","7","5","2","0","0","0","99","59","40","1","1","0","13","5","8","23","17","6","-2"
"232982","Old Dominion University","2011","Total full-time Instruction/research/public service, Non-tenured not on tenure track, Professors","7","7","0","0","0","0","0","0","0","0","0","0","0","0","0","0","0","0","6","6","0","0","0","0","0","0","0","1","1","0","-2"
"232982","Old Dominion University","2011","Total full-time Instruction/research/public service, Non-tenured not on tenure track, Associate professors","6","1","5","0","0","0","0","0","0","0","0","0","1","0","1","0","0","0","5","1","4","0","0","0","0","0","0","0","0","0","-2"
"232982","Old Dominion University","2011","Total full-time Instruction/research/public servicey, Non-tenured not on tenure track, Assistant professors","16","11","5","0","0","0","1","0","1","0","0","0","1","1","0","0","0","0","7","4","3","0","0","0","5","4","1","2","2","0","-2"
"232982","Old Dominion University","2011","Total full-time Instruction/research/public service, Non-tenured not on tenure track, Instructors","28","9","19","0","0","0","0","0","0","4","2","2","0","0","0","0","0","0","19","5","14","0","0","0","3","2","1","2","0","2","-2"
"232982","Old Dominion University","2011","Total full-time Instruction/research/public service, Non-tenured not on tenure track, Lecturers","149","48","101","1","1","0","6","3","3","9","1","8","5","4","1","0","0","0","103","33","70","2","0","2","21","4","17","2","2","0","-2"
"232982","Old Dominion University","2011","Total full-time Instruction/research/public service, Non-tenured not on tenure track total","206","76","130","1","1","0","7","3","4","13","3","10","7","5","2","0","0","0","140","49","91","2","0","2","29","10","19","7","5","2","-2"
"233921","Virginia Polytechnic Institute and State University","2011","Total full-time Instruction/research/public service, Tenured, Professors","538","446","92","2","0","2","62","58","4","15","10","5","10","9","1","1","0","1","445","366","79","2","2","0","0","0","0","1","1","0","-2"
"233921","Virginia Polytechnic Institute and State University","2011","Total full-time Instruction/research/public service, Tenured, Associate professors","460","317","143","3","2","1","44","31","13","18","11","7","17","16","1","0","0","0","373","255","118","1","0","1","0","0","0","4","2","2","-2"
"233921","Virginia Polytechnic Institute and State University","2011","Total full-time Instruction/research/public service, Tenured total","998","763","235","5","2","3","106","89","17","33","21","12","27","25","2","1","0","1","818","621","197","3","2","1","0","0","0","5","3","2","-2"
"233921","Virginia Polytechnic Institute and State University","2011","Total full-time Instruction/research/public service, Non-tenured on tenure track, Professors","2","2","0","0","0","0","0","0","0","0","0","0","0","0","0","0","0","0","1","1","0","0","0","0","0","0","0","1","1","0","-2"
"233921","Virginia Polytechnic Institute and State University","2011","Total full-time Instruction/research/public service, Non-tenured on tenure track, Associate professors","32","27","5","0","0","0","4","4","0","0","0","0","0","0","0","0","0","0","26","21","5","0","0","0","0","0","0","2","2","0","-2"
"233921","Virginia Polytechnic Institute and State University","2011","Total full-time Instruction/research/public service, Non-tenured on tenure track, Assistant professors","294","172","122","0","0","0","36","23","13","8","4","4","14","9","5","0","0","0","192","109","83","2","1","1","0","0","0","42","26","16","-2"
"233921","Virginia Polytechnic Institute and State University","2011","Total full-time Instruction/research/public service, Non-tenured on tenure track total","328","201","127","0","0","0","40","27","13","8","4","4","14","9","5","0","0","0","219","131","88","2","1","1","0","0","0","45","29","16","-2"
"233921","Virginia Polytechnic Institute and State University","2011","Total full-time Instruction/research/public service, Non-tenured not on tenure track, Professors","16","14","2","0","0","0","0","0","0","0","0","0","0","0","0","0","0","0","16","14","2","0","0","0","0","0","0","0","0","0","-2"
"233921","Virginia Polytechnic Institute and State University","2011","Total full-time Instruction/research/public service, Non-tenured not on tenure track, Associate professors","26","20","6","0","0","0","1","1","0","0","0","0","2","2","0","0","0","0","22","16","6","1","1","0","0","0","0","0","0","0","-2"
"233921","Virginia Polytechnic Institute and State University","2011","Total full-time Instruction/research/public servicey, Non-tenured not on tenure track, Assistant professors","100","59","41","0","0","0","5","3","2","1","1","0","4","2","2","0","0","0","71","39","32","1","1","0","0","0","0","18","13","5","-2"
"233921","Virginia Polytechnic Institute and State University","2011","Total full-time Instruction/research/public service, Non-tenured not on tenure track, Instructors","210","87","123","1","1","0","9","2","7","5","3","2","6","0","6","0","0","0","181","74","107","0","0","0","0","0","0","8","7","1","-2"
"233921","Virginia Polytechnic Institute and State University","2011","Total full-time Instruction/research/public service, Non-tenured not on tenure track, Lecturers","541","355","186","2","0","2","48","34","14","10","7","3","11","7","4","1","0","1","321","201","120","4","1","3","0","0","0","144","105","39","-2"
"233921","Virginia Polytechnic Institute and State University","2011","Total full-time Instruction/research/public service, Non-tenured not on tenure track total","893","535","358","3","1","2","63","40","23","16","11","5","23","11","12","1","0","1","611","344","267","6","3","3","0","0","0","170","125","45","-2"
"234076","University of Virginia-Main Campus","2011","Total full-time Instruction/research/public service, Tenured, Professors","743","618","125","0","0","0","47","41","6","16","11","5","5","4","1","0","0","0","672","559","113","0","0","0","1","1","0","2","2","0","-2"
"234076","University of Virginia-Main Campus","2011","Total full-time Instruction/research/public service, Tenured, Associate professors","333","223","110","0","0","0","18","13","5","22","17","5","7","5","2","0","0","0","283","185","98","1","1","0","0","0","0","2","2","0","-2"
"234076","University of Virginia-Main Campus","2011","Total full-time Instruction/research/public service, Tenured, Assistant professors","1","0","1","0","0","0","0","0","0","0","0","0","0","0","0","0","0","0","1","0","1","0","0","0","0","0","0","0","0","0","-2"
"234076","University of Virginia-Main Campus","2011","Total full-time Instruction/research/public service, Tenured total","1077","841","236","0","0","0","65","54","11","38","28","10","12","9","3","0","0","0","956","744","212","1","1","0","1","1","0","4","4","0","-2"
"234076","University of Virginia-Main Campus","2011","Total full-time Instruction/research/public service, Non-tenured on tenure track, Professors","2","2","0","0","0","0","0","0","0","0","0","0","0","0","0","0","0","0","2","2","0","0","0","0","0","0","0","0","0","0","-2"
"234076","University of Virginia-Main Campus","2011","Total full-time Instruction/research/public service, Non-tenured on tenure track, Associate professors","63","40","23","0","0","0","12","7","5","1","0","1","2","1","1","0","0","0","44","29","15","0","0","0","1","1","0","3","2","1","-2"
"234076","University of Virginia-Main Campus","2011","Total full-time Instruction/research/public service, Non-tenured on tenure track, Assistant professors","253","157","96","2","2","0","36","25","11","13","4","9","10","5","5","0","0","0","170","108","62","3","1","2","1","0","1","18","12","6","-2"
"234076","University of Virginia-Main Campus","2011","Total full-time Instruction/research/public service, Non-tenured on tenure track total","318","199","119","2","2","0","48","32","16","14","4","10","12","6","6","0","0","0","216","139","77","3","1","2","2","1","1","21","14","7","-2"
"234076","University of Virginia-Main Campus","2011","Total full-time Instruction/research/public service, Non-tenured not on tenure track, Professors","77","51","26","0","0","0","2","1","1","2","2","0","1","0","1","0","0","0","72","48","24","0","0","0","0","0","0","0","0","0","-2"
"234076","University of Virginia-Main Campus","2011","Total full-time Instruction/research/public service, Non-tenured not on tenure track, Associate professors","244","145","99","0","0","0","14","10","4","10","4","6","4","3","1","0","0","0","211","125","86","0","0","0","0","0","0","5","3","2","-2"
"234076","University of Virginia-Main Campus","2011","Total full-time Instruction/research/public servicey, Non-tenured not on tenure track, Assistant professors","259","124","135","2","2","0","25","14","11","9","5","4","6","3","3","0","0","0","203","93","110","1","0","1","4","1","3","9","6","3","-2"
"234076","University of Virginia-Main Campus","2011","Total full-time Instruction/research/public service, Non-tenured not on tenure track, Instructors","64","38","26","2","0","2","14","7","7","1","1","0","3","3","0","0","0","0","31","17","14","1","1","0","0","0","0","12","9","3","-2"
"234076","University of Virginia-Main Campus","2011","Total full-time Instruction/research/public service, Non-tenured not on tenure track, Lecturers","94","48","46","0","0","0","9","1","8","3","2","1","1","0","1","0","0","0","71","41","30","1","1","0","1","0","1","8","3","5","-2"
"234076","University of Virginia-Main Campus","2011","Total full-time Instruction/research/public service, Non-tenured not on tenure track total","738","406","332","4","2","2","64","33","31","25","14","11","15","9","6","0","0","0","588","324","264","3","2","1","5","1","4","34","21","13","-2"
"236939","Washington State University","2011","Total full-time Instruction/research/public service, Tenured, Professors","394","293","101","0","0","0","41","35","6","1","1","0","12","9","3","4","3","1","307","225","82","6","2","4","23","18","5","0","0","0","-2"
"236939","Washington State University","2011","Total full-time Instruction/research/public service, Tenured, Associate professors","329","196","133","1","0","1","26","21","5","4","2","2","8","3","5","1","0","1","226","129","97","5","2","3","58","39","19","0","0","0","-2"
"236939","Washington State University","2011","Total full-time Instruction/research/public service, Tenured, Assistant professors","1","1","0","0","0","0","0","0","0","0","0","0","0","0","0","0","0","0","1","1","0","0","0","0","0","0","0","0","0","0","-2"
"236939","Washington State University","2011","Total full-time Instruction/research/public service, Tenured total","724","490","234","1","0","1","67","56","11","5","3","2","20","12","8","5","3","2","534","355","179","11","4","7","81","57","24","0","0","0","-2"
"236939","Washington State University","2011","Total full-time Instruction/research/public service, Non-tenured on tenure track, Associate professors","7","4","3","0","0","0","1","0","1","1","1","0","0","0","0","0","0","0","3","1","2","0","0","0","2","2","0","0","0","0","-2"
"236939","Washington State University","2011","Total full-time Instruction/research/public service, Non-tenured on tenure track, Assistant professors","250","155","95","0","0","0","25","15","10","4","3","1","7","4","3","0","0","0","106","58","48","3","2","1","77","52","25","28","21","7","-2"
"236939","Washington State University","2011","Total full-time Instruction/research/public service, Non-tenured on tenure track total","257","159","98","0","0","0","26","15","11","5","4","1","7","4","3","0","0","0","109","59","50","3","2","1","79","54","25","28","21","7","-2"
"236939","Washington State University","2011","Total full-time Instruction/research/public service, Non-tenured not on tenure track, Professors","9","5","4","0","0","0","1","1","0","0","0","0","0","0","0","0","0","0","7","3","4","0","0","0","1","1","0","0","0","0","-2"
"236939","Washington State University","2011","Total full-time Instruction/research/public service, Non-tenured not on tenure track, Associate professors","10","7","3","0","0","0","0","0","0","0","0","0","0","0","0","0","0","0","9","7","2","0","0","0","1","0","1","0","0","0","-2"
"236939","Washington State University","2011","Total full-time Instruction/research/public servicey, Non-tenured not on tenure track, Assistant professors","24","9","15","1","0","1","0","0","0","0","0","0","2","2","0","0","0","0","15","4","11","0","0","0","4","2","2","2","1","1","-2"
"236939","Washington State University","2011","Total full-time Instruction/research/public service, Non-tenured not on tenure track, Instructors","142","55","87","0","0","0","3","1","2","1","1","0","4","1","3","0","0","0","96","36","60","1","1","0","30","13","17","7","2","5","-2"
"236939","Washington State University","2011","Total full-time Instruction/research/public service, Non-tenured not on tenure track, Lecturers","2","0","2","0","0","0","0","0","0","0","0","0","0","0","0","0","0","0","2","0","2","0","0","0","0","0","0","0","0","0","-2"
"236939","Washington State University","2011","Total full-time Instruction/research/public service, Non-tenured not on tenure track, No academic rank","469","289","180","2","1","1","26","14","12","5","4","1","9","8","1","0","0","0","186","96","90","3","1","2","84","56","28","154","109","45","-2"
"236939","Washington State University","2011","Total full-time Instruction/research/public service, Non-tenured not on tenure track total","656","365","291","3","1","2","30","16","14","6","5","1","15","11","4","0","0","0","315","146","169","4","2","2","120","72","48","163","112","51","-2"
"236948","University of Washington-Seattle Campus","2011","Total full-time Instruction/research/public service, Tenured, Professors","726","558","168","1","1","0","74","61","13","13","11","2","14","14","0","0","0","0","610","459","151","4","2","2","9","9","0","1","1","0","-2"
"236948","University of Washington-Seattle Campus","2011","Total full-time Instruction/research/public service, Tenured, Associate professors","369","195","174","1","0","1","43","20","23","11","2","9","17","12","5","0","0","0","285","156","129","6","1","5","6","4","2","0","0","0","-2"
"236948","University of Washington-Seattle Campus","2011","Total full-time Instruction/research/public service, Tenured total","1095","753","342","2","1","1","117","81","36","24","13","11","31","26","5","0","0","0","895","615","280","10","3","7","15","13","2","1","1","0","-2"
"236948","University of Washington-Seattle Campus","2011","Total full-time Instruction/research/public service, Non-tenured on tenure track, Associate professors","3","2","1","0","0","0","0","0","0","0","0","0","0","0","0","0","0","0","2","1","1","0","0","0","1","1","0","0","0","0","-2"
"236948","University of Washington-Seattle Campus","2011","Total full-time Instruction/research/public service, Non-tenured on tenure track, Assistant professors","255","144","111","2","0","2","41","21","20","9","3","6","20","13","7","0","0","0","126","72","54","6","2","4","32","19","13","19","14","5","-2"
"236948","University of Washington-Seattle Campus","2011","Total full-time Instruction/research/public service, Non-tenured on tenure track total","258","146","112","2","0","2","41","21","20","9","3","6","20","13","7","0","0","0","128","73","55","6","2","4","33","20","13","19","14","5","-2"
"236948","University of Washington-Seattle Campus","2011","Total full-time Instruction/research/public service, Non-tenured not on tenure track, Professors","515","378","137","2","1","1","42","31","11","1","1","0","10","8","2","0","0","0","444","324","120","4","4","0","10","7","3","2","2","0","-2"
"236948","University of Washington-Seattle Campus","2011","Total full-time Instruction/research/public service, Non-tenured not on tenure track, Associate professors","438","268","170","0","0","0","56","35","21","2","1","1","22","11","11","0","0","0","326","197","129","8","6","2","19","14","5","5","4","1","-2"
"236948","University of Washington-Seattle Campus","2011","Total full-time Instruction/research/public servicey, Non-tenured not on tenure track, Assistant professors","580","334","246","1","1","0","114","68","46","7","6","1","24","13","11","0","0","0","340","189","151","3","1","2","47","23","24","44","33","11","-2"
"236948","University of Washington-Seattle Campus","2011","Total full-time Instruction/research/public service, Non-tenured not on tenure track, Instructors","241","132","109","0","0","0","37","22","15","3","2","1","10","6","4","2","2","0","106","45","61","5","1","4","48","32","16","30","22","8","-2"
"236948","University of Washington-Seattle Campus","2011","Total full-time Instruction/research/public service, Non-tenured not on tenure track, Lecturers","294","122","172","2","1","1","36","14","22","5","2","3","13","2","11","0","0","0","211","93","118","1","0","1","17","4","13","9","6","3","-2"
"236948","University of Washington-Seattle Campus","2011","Total full-time Instruction/research/public service, Non-tenured not on tenure track, No academic rank","130","38","92","1","0","1","6","1","5","4","1","3","3","2","1","0","0","0","93","28","65","4","1","3","19","5","14","0","0","0","-2"
"236948","University of Washington-Seattle Campus","2011","Total full-time Instruction/research/public service, Non-tenured not on tenure track total","2198","1272","926","6","3","3","291","171","120","22","13","9","82","42","40","2","2","0","1520","876","644","25","13","12","160","85","75","90","67","23","-2"
"237057","Whitman College","2011","Total full-time Instruction/research/public service, Tenured, Professors","39","29","10","1","1","0","1","0","1","0","0","0","0","0","0","0","0","0","36","28","8","1","0","1","0","0","0","0","0","0","-2"
"237057","Whitman College","2011","Total full-time Instruction/research/public service, Tenured, Associate professors","42","23","19","0","0","0","4","2","2","1","1","0","1","0","1","0","0","0","35","19","16","1","1","0","0","0","0","0","0","0","-2"
"237057","Whitman College","2011","Total full-time Instruction/research/public service, Tenured, Assistant professors","1","1","0","0","0","0","1","1","0","0","0","0","0","0","0","0","0","0","0","0","0","0","0","0","0","0","0","0","0","0","-2"
"237057","Whitman College","2011","Total full-time Instruction/research/public service, Tenured total","82","53","29","1","1","0","6","3","3","1","1","0","1","0","1","0","0","0","71","47","24","2","1","1","0","0","0","0","0","0","-2"
"237057","Whitman College","2011","Total full-time Instruction/research/public service, Non-tenured on tenure track, Assistant professors","33","16","17","0","0","0","3","0","3","1","0","1","1","1","0","0","0","0","25","14","11","1","0","1","0","0","0","2","1","1","-2"
"237057","Whitman College","2011","Total full-time Instruction/research/public service, Non-tenured on tenure track total","33","16","17","0","0","0","3","0","3","1","0","1","1","1","0","0","0","0","25","14","11","1","0","1","0","0","0","2","1","1","-2"
"237057","Whitman College","2011","Total full-time Instruction/research/public service, Non-tenured not on tenure track, Professors","1","1","0","0","0","0","0","0","0","0","0","0","0","0","0","0","0","0","1","1","0","0","0","0","0","0","0","0","0","0","-2"
"237057","Whitman College","2011","Total full-time Instruction/research/public servicey, Non-tenured not on tenure track, Assistant professors","25","12","13","0","0","0","0","0","0","0","0","0","0","0","0","0","0","0","24","12","12","0","0","0","0","0","0","1","0","1","-2"
"237057","Whitman College","2011","Total full-time Instruction/research/public service, Non-tenured not on tenure track, Instructors","9","6","3","0","0","0","0","0","0","0","0","0","0","0","0","0","0","0","9","6","3","0","0","0","0","0","0","0","0","0","-2"
"237057","Whitman College","2011","Total full-time Instruction/research/public service, Non-tenured not on tenure track, Lecturers","13","6","7","0","0","0","0","0","0","0","0","0","1","1","0","0","0","0","11","4","7","1","1","0","0","0","0","0","0","0","-2"
"237057","Whitman College","2011","Total full-time Instruction/research/public service, Non-tenured not on tenure track, No academic rank","2","2","0","0","0","0","0","0","0","0","0","0","0","0","0","0","0","0","2","2","0","0","0","0","0","0","0","0","0","0","-2"
"237057","Whitman College","2011","Total full-time Instruction/research/public service, Non-tenured not on tenure track total","50","27","23","0","0","0","0","0","0","0","0","0","1","1","0","0","0","0","47","25","22","1","1","0","0","0","0","1","0","1","-2"
"237525","Marshall University","2011","Total full-time Instruction/research/public service, Tenured, Professors","234","157","77","1","0","1","11","9","2","7","7","0","6","3","3","0","0","0","206","138","68","0","0","0","0","0","0","3","0","3","-2"
"237525","Marshall University","2011","Total full-time Instruction/research/public service, Tenured, Associate professors","110","68","42","1","0","1","9","8","1","3","2","1","2","2","0","0","0","0","91","54","37","0","0","0","0","0","0","4","2","2","-2"
"237525","Marshall University","2011","Total full-time Instruction/research/public service, Tenured, Assistant professors","9","1","8","0","0","0","0","0","0","0","0","0","0","0","0","0","0","0","9","1","8","0","0","0","0","0","0","0","0","0","-2"
"237525","Marshall University","2011","Total full-time Instruction/research/public service, Tenured total","353","226","127","2","0","2","20","17","3","10","9","1","8","5","3","0","0","0","306","193","113","0","0","0","0","0","0","7","2","5","-2"
"237525","Marshall University","2011","Total full-time Instruction/research/public service, Non-tenured on tenure track, Professors","9","8","1","0","0","0","1","1","0","1","0","1","0","0","0","0","0","0","7","7","0","0","0","0","0","0","0","0","0","0","-2"
"237525","Marshall University","2011","Total full-time Instruction/research/public service, Non-tenured on tenure track, Associate professors","48","31","17","0","0","0","11","6","5","0","0","0","1","0","1","0","0","0","35","25","10","0","0","0","0","0","0","1","0","1","-2"
"237525","Marshall University","2011","Total full-time Instruction/research/public service, Non-tenured on tenure track, Assistant professors","155","96","59","0","0","0","14","9","5","7","5","2","3","1","2","0","0","0","124","77","47","0","0","0","1","0","1","6","4","2","-2"
"237525","Marshall University","2011","Total full-time Instruction/research/public service, Non-tenured on tenure track, Instructors","1","1","0","0","0","0","0","0","0","0","0","0","0","0","0","0","0","0","1","1","0","0","0","0","0","0","0","0","0","0","-2"
"237525","Marshall University","2011","Total full-time Instruction/research/public service, Non-tenured on tenure track total","213","136","77","0","0","0","26","16","10","8","5","3","4","1","3","0","0","0","167","110","57","0","0","0","1","0","1","7","4","3","-2"
"237525","Marshall University","2011","Total full-time Instruction/research/public service, Non-tenured not on tenure track, Professors","3","2","1","0","0","0","0","0","0","0","0","0","0","0","0","0","0","0","3","2","1","0","0","0","0","0","0","0","0","0","-2"
"237525","Marshall University","2011","Total full-time Instruction/research/public service, Non-tenured not on tenure track, Associate professors","11","10","1","0","0","0","0","0","0","0","0","0","0","0","0","0","0","0","11","10","1","0","0","0","0","0","0","0","0","0","-2"
"237525","Marshall University","2011","Total full-time Instruction/research/public servicey, Non-tenured not on tenure track, Assistant professors","62","35","27","0","0","0","6","4","2","1","0","1","2","2","0","0","0","0","53","29","24","0","0","0","0","0","0","0","0","0","-2"
"237525","Marshall University","2011","Total full-time Instruction/research/public service, Non-tenured not on tenure track, Instructors","74","29","45","0","0","0","2","1","1","0","0","0","1","0","1","0","0","0","67","26","41","0","0","0","0","0","0","4","2","2","-2"
"237525","Marshall University","2011","Total full-time Instruction/research/public service, Non-tenured not on tenure track total","150","76","74","0","0","0","8","5","3","1","0","1","3","2","1","0","0","0","134","67","67","0","0","0","0","0","0","4","2","2","-2"
"239512","Northland College","2011","Total full-time Instruction/research/public service, Tenured, Professors","12","9","3","0","0","0","1","1","0","0","0","0","0","0","0","0","0","0","11","8","3","0","0","0","0","0","0","0","0","0","-2"
"239512","Northland College","2011","Total full-time Instruction/research/public service, Tenured, Associate professors","11","9","2","0","0","0","0","0","0","0","0","0","0","0","0","0","0","0","11","9","2","0","0","0","0","0","0","0","0","0","-2"
"239512","Northland College","2011","Total full-time Instruction/research/public service, Tenured total","23","18","5","0","0","0","1","1","0","0","0","0","0","0","0","0","0","0","22","17","5","0","0","0","0","0","0","0","0","0","-2"
"239512","Northland College","2011","Total full-time Instruction/research/public service, Non-tenured on tenure track, Associate professors","2","1","1","0","0","0","0","0","0","0","0","0","0","0","0","0","0","0","2","1","1","0","0","0","0","0","0","0","0","0","-2"
"239512","Northland College","2011","Total full-time Instruction/research/public service, Non-tenured on tenure track, Assistant professors","13","6","7","0","0","0","0","0","0","0","0","0","0","0","0","0","0","0","11","5","6","1","1","0","1","0","1","0","0","0","-2"
"239512","Northland College","2011","Total full-time Instruction/research/public service, Non-tenured on tenure track total","15","7","8","0","0","0","0","0","0","0","0","0","0","0","0","0","0","0","13","6","7","1","1","0","1","0","1","0","0","0","-2"
"239512","Northland College","2011","Total full-time Instruction/research/public service, Non-tenured not on tenure track, Associate professors","1","1","0","0","0","0","0","0","0","0","0","0","0","0","0","0","0","0","1","1","0","0","0","0","0","0","0","0","0","0","-2"
"239512","Northland College","2011","Total full-time Instruction/research/public servicey, Non-tenured not on tenure track, Assistant professors","3","0","3","0","0","0","0","0","0","0","0","0","0","0","0","0","0","0","3","0","3","0","0","0","0","0","0","0","0","0","-2"
"239512","Northland College","2011","Total full-time Instruction/research/public service, Non-tenured not on tenure track, Instructors","4","2","2","0","0","0","0","0","0","1","1","0","0","0","0","0","0","0","3","1","2","0","0","0","0","0","0","0","0","0","-2"
"239512","Northland College","2011","Total full-time Instruction/research/public service, Non-tenured not on tenure track total","8","3","5","0","0","0","0","0","0","1","1","0","0","0","0","0","0","0","7","2","5","0","0","0","0","0","0","0","0","0","-2"
"240444","University of Wisconsin-Madison","2011","Total full-time Instruction/research/public service, Tenured, Professors","1109","821","288","1","0","1","102","83","19","19","10","9","34","21","13","0","0","0","918","681","237","6","3","3","27","21","6","2","2","0","-2"
"240444","University of Wisconsin-Madison","2011","Total full-time Instruction/research/public service, Tenured, Associate professors","384","243","141","4","2","2","42","25","17","6","5","1","18","12","6","0","0","0","295","182","113","2","2","0","12","10","2","5","5","0","-2"
"240444","University of Wisconsin-Madison","2011","Total full-time Instruction/research/public service, Tenured total","1493","1064","429","5","2","3","144","108","36","25","15","10","52","33","19","0","0","0","1213","863","350","8","5","3","39","31","8","7","7","0","-2"
"240444","University of Wisconsin-Madison","2011","Total full-time Instruction/research/public service, Non-tenured on tenure track, Assistant professors","422","253","169","2","1","1","45","26","19","19","7","12","16","6","10","0","0","0","251","143","108","4","3","1","45","36","9","40","31","9","-2"
"240444","University of Wisconsin-Madison","2011","Total full-time Instruction/research/public service, Non-tenured on tenure track, Instructors","1","1","0","0","0","0","0","0","0","0","0","0","0","0","0","0","0","0","0","0","0","0","0","0","0","0","0","1","1","0","-2"
"240444","University of Wisconsin-Madison","2011","Total full-time Instruction/research/public service, Non-tenured on tenure track total","423","254","169","2","1","1","45","26","19","19","7","12","16","6","10","0","0","0","251","143","108","4","3","1","45","36","9","41","32","9","-2"
"240444","University of Wisconsin-Madison","2011","Total full-time Instruction/research/public service, Non-tenured not on tenure track, Professors","304","193","111","0","0","0","9","5","4","2","2","0","8","3","5","0","0","0","269","171","98","0","0","0","10","7","3","6","5","1","-2"
"240444","University of Wisconsin-Madison","2011","Total full-time Instruction/research/public service, Non-tenured not on tenure track, Associate professors","325","196","129","1","0","1","18","8","10","7","5","2","4","3","1","0","0","0","275","171","104","1","0","1","13","5","8","6","4","2","-2"
"240444","University of Wisconsin-Madison","2011","Total full-time Instruction/research/public servicey, Non-tenured not on tenure track, Assistant professors","433","256","177","0","0","0","38","22","16","6","4","2","6","3","3","1","1","0","305","180","125","1","0","1","54","31","23","22","15","7","-2"
"240444","University of Wisconsin-Madison","2011","Total full-time Instruction/research/public service, Non-tenured not on tenure track, Instructors","89","41","48","0","0","0","6","4","2","1","0","1","1","0","1","0","0","0","45","14","31","0","0","0","32","20","12","4","3","1","-2"
"240444","University of Wisconsin-Madison","2011","Total full-time Instruction/research/public service, Non-tenured not on tenure track, Lecturers","67","36","31","0","0","0","3","2","1","1","0","1","1","0","1","0","0","0","59","32","27","0","0","0","1","0","1","2","2","0","-2"
"240444","University of Wisconsin-Madison","2011","Total full-time Instruction/research/public service, Non-tenured not on tenure track, No academic rank","8","4","4","0","0","0","1","1","0","0","0","0","2","2","0","0","0","0","4","0","4","0","0","0","1","1","0","0","0","0","-2"
"240444","University of Wisconsin-Madison","2011","Total full-time Instruction/research/public service, Non-tenured not on tenure track total","1226","726","500","1","0","1","75","42","33","17","11","6","22","11","11","1","1","0","957","568","389","2","0","2","111","64","47","40","29","11","-2"
"240453","University of Wisconsin-Milwaukee","2011","Total full-time Instruction/research/public service, Tenured, Professors","224","158","66","1","1","0","29","25","4","14","11","3","5","5","0","0","0","0","172","114","58","2","1","1","0","0","0","1","1","0","-2"
"240453","University of Wisconsin-Milwaukee","2011","Total full-time Instruction/research/public service, Tenured, Associate professors","302","184","118","4","3","1","47","31","16","16","9","7","14","11","3","0","0","0","220","129","91","0","0","0","0","0","0","1","1","0","-2"
"240453","University of Wisconsin-Milwaukee","2011","Total full-time Instruction/research/public service, Tenured, Assistant professors","3","1","2","0","0","0","0","0","0","0","0","0","1","0","1","0","0","0","2","1","1","0","0","0","0","0","0","0","0","0","-2"
"240453","University of Wisconsin-Milwaukee","2011","Total full-time Instruction/research/public service, Tenured total","529","343","186","5","4","1","76","56","20","30","20","10","20","16","4","0","0","0","394","244","150","2","1","1","0","0","0","2","2","0","-2"
"240453","University of Wisconsin-Milwaukee","2011","Total full-time Instruction/research/public service, Non-tenured on tenure track, Associate professors","41","20","21","0","0","0","7","5","2","1","0","1","3","1","2","0","0","0","28","12","16","0","0","0","0","0","0","2","2","0","-2"
"240453","University of Wisconsin-Milwaukee","2011","Total full-time Instruction/research/public service, Non-tenured on tenure track, Assistant professors","237","118","119","2","2","0","41","20","21","16","8","8","14","3","11","0","0","0","121","58","63","4","2","2","0","0","0","39","25","14","-2"
"240453","University of Wisconsin-Milwaukee","2011","Total full-time Instruction/research/public service, Non-tenured on tenure track total","278","138","140","2","2","0","48","25","23","17","8","9","17","4","13","0","0","0","149","70","79","4","2","2","0","0","0","41","27","14","-2"
"240453","University of Wisconsin-Milwaukee","2011","Total full-time Instruction/research/public service, Non-tenured not on tenure track, Professors","19","10","9","0","0","0","1","1","0","0","0","0","0","0","0","0","0","0","16","8","8","0","0","0","0","0","0","2","1","1","-2"
"240453","University of Wisconsin-Milwaukee","2011","Total full-time Instruction/research/public service, Non-tenured not on tenure track, Associate professors","21","3","18","0","0","0","0","0","0","0","0","0","0","0","0","0","0","0","21","3","18","0","0","0","0","0","0","0","0","0","-2"
"240453","University of Wisconsin-Milwaukee","2011","Total full-time Instruction/research/public servicey, Non-tenured not on tenure track, Assistant professors","42","10","32","0","0","0","2","2","0","4","2","2","2","0","2","0","0","0","34","6","28","0","0","0","0","0","0","0","0","0","-2"
"240453","University of Wisconsin-Milwaukee","2011","Total full-time Instruction/research/public service, Non-tenured not on tenure track, Instructors","9","1","8","0","0","0","1","0","1","1","0","1","0","0","0","0","0","0","7","1","6","0","0","0","0","0","0","0","0","0","-2"
"240453","University of Wisconsin-Milwaukee","2011","Total full-time Instruction/research/public service, Non-tenured not on tenure track, Lecturers","207","93","114","0","0","0","5","0","5","6","3","3","4","0","4","0","0","0","186","87","99","0","0","0","0","0","0","6","3","3","-2"
"240453","University of Wisconsin-Milwaukee","2011","Total full-time Instruction/research/public service, Non-tenured not on tenure track, No academic rank","1","1","0","0","0","0","0","0","0","0","0","0","0","0","0","0","0","0","0","0","0","0","0","0","0","0","0","1","1","0","-2"
"240453","University of Wisconsin-Milwaukee","2011","Total full-time Instruction/research/public service, Non-tenured not on tenure track total","299","118","181","0","0","0","9","3","6","11","5","6","6","0","6","0","0","0","264","105","159","0","0","0","0","0","0","9","5","4","-2"
"240727","University of Wyoming","2011","Total full-time Instruction/research/public service, Tenured, Professors","218","176","42","0","0","0","5","5","0","0","0","0","4","3","1","1","1","0","199","160","39","1","1","0","5","3","2","3","3","0","-2"
"240727","University of Wyoming","2011","Total full-time Instruction/research/public service, Tenured, Associate professors","209","136","73","2","1","1","12","9","3","5","2","3","5","1","4","0","0","0","162","108","54","0","0","0","18","12","6","5","3","2","-2"
"240727","University of Wyoming","2011","Total full-time Instruction/research/public service, Tenured total","427","312","115","2","1","1","17","14","3","5","2","3","9","4","5","1","1","0","361","268","93","1","1","0","23","15","8","8","6","2","-2"
"240727","University of Wyoming","2011","Total full-time Instruction/research/public service, Non-tenured on tenure track, Associate professors","12","12","0","0","0","0","1","1","0","0","0","0","0","0","0","0","0","0","5","5","0","1","1","0","4","4","0","1","1","0","-2"
"240727","University of Wyoming","2011","Total full-time Instruction/research/public service, Non-tenured on tenure track, Assistant professors","167","92","75","1","0","1","16","12","4","3","3","0","3","0","3","1","0","1","87","48","39","0","0","0","40","19","21","16","10","6","-2"
"240727","University of Wyoming","2011","Total full-time Instruction/research/public service, Non-tenured on tenure track, Instructors","1","1","0","0","0","0","0","0","0","0","0","0","0","0","0","0","0","0","1","1","0","0","0","0","0","0","0","0","0","0","-2"
"240727","University of Wyoming","2011","Total full-time Instruction/research/public service, Non-tenured on tenure track total","180","105","75","1","0","1","17","13","4","3","3","0","3","0","3","1","0","1","93","54","39","1","1","0","44","23","21","17","11","6","-2"
"240727","University of Wyoming","2011","Total full-time Instruction/research/public service, Non-tenured not on tenure track, Lecturers","261","91","170","4","1","3","5","0","5","0","0","0","1","0","1","0","0","0","211","77","134","0","0","0","36","13","23","4","0","4","-2"
"240727","University of Wyoming","2011","Total full-time Instruction/research/public service, Non-tenured not on tenure track, No academic rank","227","147","80","1","1","0","17","10","7","3","3","0","2","2","0","0","0","0","134","84","50","0","0","0","35","17","18","35","30","5","-2"
"240727","University of Wyoming","2011","Total full-time Instruction/research/public service, Non-tenured not on tenure track total","488","238","250","5","2","3","22","10","12","3","3","0","3","2","1","0","0","0","345","161","184","0","0","0","71","30","41","39","30","9","-2"
"243665","University of the Virgin Islands","2011","Total full-time Instruction/research/public service, Tenured, Professors","21","13","8","0","0","0","0","0","0","11","5","6","0","0","0","1","1","0","9","7","2","0","0","0","0","0","0","0","0","0","-2"
"243665","University of the Virgin Islands","2011","Total full-time Instruction/research/public service, Tenured, Associate professors","26","19","7","0","0","0","0","0","0","10","8","2","0","0","0","1","1","0","14","9","5","0","0","0","1","1","0","0","0","0","-2"
"243665","University of the Virgin Islands","2011","Total full-time Instruction/research/public service, Tenured, Assistant professors","11","6","5","0","0","0","0","0","0","3","3","0","1","0","1","0","0","0","6","3","3","0","0","0","1","0","1","0","0","0","-2"
"243665","University of the Virgin Islands","2011","Total full-time Instruction/research/public service, Tenured total","58","38","20","0","0","0","0","0","0","24","16","8","1","0","1","2","2","0","29","19","10","0","0","0","2","1","1","0","0","0","-2"
"243665","University of the Virgin Islands","2011","Total full-time Instruction/research/public service, Non-tenured on tenure track, Associate professors","13","7","6","0","0","0","0","0","0","5","2","3","0","0","0","1","1","0","6","4","2","0","0","0","1","0","1","0","0","0","-2"
"243665","University of the Virgin Islands","2011","Total full-time Instruction/research/public service, Non-tenured on tenure track, Assistant professors","8","3","5","0","0","0","0","0","0","5","1","4","1","1","0","0","0","0","2","1","1","0","0","0","0","0","0","0","0","0","-2"
"243665","University of the Virgin Islands","2011","Total full-time Instruction/research/public service, Non-tenured on tenure track, Instructors","1","0","1","0","0","0","0","0","0","0","0","0","1","0","1","0","0","0","0","0","0","0","0","0","0","0","0","0","0","0","-2"
"243665","University of the Virgin Islands","2011","Total full-time Instruction/research/public service, Non-tenured on tenure track total","22","10","12","0","0","0","0","0","0","10","3","7","2","1","1","1","1","0","8","5","3","0","0","0","1","0","1","0","0","0","-2"
"243665","University of the Virgin Islands","2011","Total full-time Instruction/research/public service, Non-tenured not on tenure track, Professors","2","1","1","0","0","0","0","0","0","0","0","0","0","0","0","0","0","0","2","1","1","0","0","0","0","0","0","0","0","0","-2"
"243665","University of the Virgin Islands","2011","Total full-time Instruction/research/public service, Non-tenured not on tenure track, Associate professors","9","3","6","0","0","0","0","0","0","5","1","4","0","0","0","1","1","0","2","1","1","0","0","0","1","0","1","0","0","0","-2"
"243665","University of the Virgin Islands","2011","Total full-time Instruction/research/public servicey, Non-tenured not on tenure track, Assistant professors","25","12","13","0","0","0","0","0","0","10","4","6","0","0","0","0","0","0","15","8","7","0","0","0","0","0","0","0","0","0","-2"
"243665","University of the Virgin Islands","2011","Total full-time Instruction/research/public service, Non-tenured not on tenure track, Instructors","4","3","1","0","0","0","0","0","0","1","1","0","1","0","1","0","0","0","2","2","0","0","0","0","0","0","0","0","0","0","-2"
"243665","University of the Virgin Islands","2011","Total full-time Instruction/research/public service, Non-tenured not on tenure track total","40","19","21","0","0","0","0","0","0","16","6","10","1","0","1","1","1","0","21","12","9","0","0","0","1","0","1","0","0","0","-2"
"243744","Stanford University","2011","Total full-time Instruction/research/public service, Tenured, Professors","772","621","151","2","1","1","73","62","11","15","10","5","25","20","5","0","0","0","636","510","126","0","0","0","21","18","3","0","0","0","-2"
"243744","Stanford University","2011","Total full-time Instruction/research/public service, Tenured, Associate professors","226","160","66","0","0","0","41","29","12","11","8","3","6","3","3","0","0","0","163","116","47","0","0","0","5","4","1","0","0","0","-2"
"243744","Stanford University","2011","Total full-time Instruction/research/public service, Tenured, Assistant professors","1","1","0","0","0","0","0","0","0","0","0","0","0","0","0","0","0","0","1","1","0","0","0","0","0","0","0","0","0","0","-2"
"243744","Stanford University","2011","Total full-time Instruction/research/public service, Tenured total","999","782","217","2","1","1","114","91","23","26","18","8","31","23","8","0","0","0","800","627","173","0","0","0","26","22","4","0","0","0","-2"
"243744","Stanford University","2011","Total full-time Instruction/research/public service, Non-tenured on tenure track, Professors","3","3","0","0","0","0","1","1","0","0","0","0","0","0","0","0","0","0","2","2","0","0","0","0","0","0","0","0","0","0","-2"
"243744","Stanford University","2011","Total full-time Instruction/research/public service, Non-tenured on tenure track, Associate professors","19","14","5","0","0","0","5","4","1","0","0","0","1","1","0","0","0","0","13","9","4","0","0","0","0","0","0","0","0","0","-2"
"243744","Stanford University","2011","Total full-time Instruction/research/public service, Non-tenured on tenure track, Assistant professors","249","169","80","2","2","0","58","36","22","6","2","4","14","12","2","0","0","0","160","110","50","0","0","0","9","7","2","0","0","0","-2"
"243744","Stanford University","2011","Total full-time Instruction/research/public service, Non-tenured on tenure track total","271","186","85","2","2","0","64","41","23","6","2","4","15","13","2","0","0","0","175","121","54","0","0","0","9","7","2","0","0","0","-2"
"243744","Stanford University","2011","Total full-time Instruction/research/public service, Non-tenured not on tenure track, Professors","239","177","62","0","0","0","27","19","8","3","2","1","7","4","3","0","0","0","199","150","49","0","0","0","3","2","1","0","0","0","-2"
"243744","Stanford University","2011","Total full-time Instruction/research/public service, Non-tenured not on tenure track, Associate professors","172","114","58","1","1","0","39","24","15","4","1","3","13","11","2","0","0","0","111","74","37","0","0","0","4","3","1","0","0","0","-2"
"243744","Stanford University","2011","Total full-time Instruction/research/public servicey, Non-tenured not on tenure track, Assistant professors","142","86","56","0","0","0","48","31","17","7","4","3","4","4","0","0","0","0","81","47","34","0","0","0","2","0","2","0","0","0","-2"
"243744","Stanford University","2011","Total full-time Instruction/research/public service, Non-tenured not on tenure track total","553","377","176","1","1","0","114","74","40","14","7","7","24","19","5","0","0","0","391","271","120","0","0","0","9","5","4","0","0","0","-2"
"243780","Purdue University-Main Campus","2011","Total full-time Instruction/research/public service, Tenured, Professors","767","643","124","1","1","0","134","122","12","13","12","1","13","10","3","0","0","0","605","498","107","1","0","1","0","0","0","0","0","0","-2"
"243780","Purdue University-Main Campus","2011","Total full-time Instruction/research/public service, Tenured, Associate professors","531","373","158","1","1","0","76","55","21","19","13","6","26","19","7","0","0","0","404","282","122","4","2","2","0","0","0","1","1","0","-2"
"243780","Purdue University-Main Campus","2011","Total full-time Instruction/research/public service, Tenured, Assistant professors","8","5","3","0","0","0","0","0","0","1","0","1","0","0","0","0","0","0","7","5","2","0","0","0","0","0","0","0","0","0","-2"
"243780","Purdue University-Main Campus","2011","Total full-time Instruction/research/public service, Tenured total","1306","1021","285","2","2","0","210","177","33","33","25","8","39","29","10","0","0","0","1016","785","231","5","2","3","0","0","0","1","1","0","-2"
"243780","Purdue University-Main Campus","2011","Total full-time Instruction/research/public service, Non-tenured on tenure track, Professors","1","1","0","0","0","0","1","1","0","0","0","0","0","0","0","0","0","0","0","0","0","0","0","0","0","0","0","0","0","0","-2"
"243780","Purdue University-Main Campus","2011","Total full-time Instruction/research/public service, Non-tenured on tenure track, Associate professors","6","3","3","0","0","0","1","0","1","0","0","0","0","0","0","0","0","0","3","1","2","0","0","0","0","0","0","2","2","0","-2"
"243780","Purdue University-Main Campus","2011","Total full-time Instruction/research/public service, Non-tenured on tenure track, Assistant professors","355","199","156","0","0","0","70","46","24","15","5","10","14","7","7","0","0","0","212","117","95","4","2","2","0","0","0","40","22","18","-2"
"243780","Purdue University-Main Campus","2011","Total full-time Instruction/research/public service, Non-tenured on tenure track, Instructors","3","1","2","0","0","0","0","0","0","0","0","0","0","0","0","0","0","0","2","1","1","1","0","1","0","0","0","0","0","0","-2"
"243780","Purdue University-Main Campus","2011","Total full-time Instruction/research/public service, Non-tenured on tenure track total","365","204","161","0","0","0","72","47","25","15","5","10","14","7","7","0","0","0","217","119","98","5","2","3","0","0","0","42","24","18","-2"
"243780","Purdue University-Main Campus","2011","Total full-time Instruction/research/public service, Non-tenured not on tenure track, Professors","13","8","5","0","0","0","3","2","1","0","0","0","0","0","0","0","0","0","9","5","4","0","0","0","0","0","0","1","1","0","-2"
"243780","Purdue University-Main Campus","2011","Total full-time Instruction/research/public service, Non-tenured not on tenure track, Associate professors","35","14","21","0","0","0","4","2","2","0","0","0","0","0","0","0","0","0","30","12","18","1","0","1","0","0","0","0","0","0","-2"
"243780","Purdue University-Main Campus","2011","Total full-time Instruction/research/public servicey, Non-tenured not on tenure track, Assistant professors","133","78","55","0","0","0","20","11","9","4","2","2","2","1","1","0","0","0","86","49","37","0","0","0","0","0","0","21","15","6","-2"
"243780","Purdue University-Main Campus","2011","Total full-time Instruction/research/public service, Non-tenured not on tenure track, Instructors","10","6","4","0","0","0","1","1","0","1","1","0","0","0","0","0","0","0","8","4","4","0","0","0","0","0","0","0","0","0","-2"
"243780","Purdue University-Main Campus","2011","Total full-time Instruction/research/public service, Non-tenured not on tenure track, Lecturers","115","49","66","0","0","0","7","1","6","2","1","1","5","1","4","0","0","0","97","44","53","0","0","0","0","0","0","4","2","2","-2"
"243780","Purdue University-Main Campus","2011","Total full-time Instruction/research/public service, Non-tenured not on tenure track, No academic rank","313","215","98","0","0","0","21","12","9","4","1","3","2","1","1","0","0","0","69","40","29","0","0","0","0","0","0","217","161","56","-2"
"243780","Purdue University-Main Campus","2011","Total full-time Instruction/research/public service, Non-tenured not on tenure track total","619","370","249","0","0","0","56","29","27","11","5","6","9","3","6","0","0","0","299","154","145","1","0","1","0","0","0","243","179","64","-2"
"409698","California State University-Monterey Bay","2011","Total full-time Instruction/research/public service, Tenured, Professors","49","31","18","1","1","0","12","7","5","2","1","1","9","6","3","1","0","1","24","16","8","0","0","0","0","0","0","0","0","0","-2"
"409698","California State University-Monterey Bay","2011","Total full-time Instruction/research/public service, Tenured, Associate professors","29","11","18","0","0","0","4","1","3","2","1","1","6","1","5","0","0","0","14","5","9","0","0","0","3","3","0","0","0","0","-2"
"409698","California State University-Monterey Bay","2011","Total full-time Instruction/research/public service, Tenured, No academic rank","3","2","1","0","0","0","0","0","0","0","0","0","0","0","0","0","0","0","3","2","1","0","0","0","0","0","0","0","0","0","-2"
"409698","California State University-Monterey Bay","2011","Total full-time Instruction/research/public service, Tenured total","81","44","37","1","1","0","16","8","8","4","2","2","15","7","8","1","0","1","41","23","18","0","0","0","3","3","0","0","0","0","-2"
"409698","California State University-Monterey Bay","2011","Total full-time Instruction/research/public service, Non-tenured on tenure track, Professors","1","1","0","0","0","0","0","0","0","0","0","0","1","1","0","0","0","0","0","0","0","0","0","0","0","0","0","0","0","0","-2"
"409698","California State University-Monterey Bay","2011","Total full-time Instruction/research/public service, Non-tenured on tenure track, Associate professors","1","1","0","0","0","0","0","0","0","1","1","0","0","0","0","0","0","0","0","0","0","0","0","0","0","0","0","0","0","0","-2"
"409698","California State University-Monterey Bay","2011","Total full-time Instruction/research/public service, Non-tenured on tenure track, Assistant professors","34","17","17","0","0","0","6","2","4","1","1","0","6","4","2","0","0","0","17","8","9","0","0","0","4","2","2","0","0","0","-2"
"409698","California State University-Monterey Bay","2011","Total full-time Instruction/research/public service, Non-tenured on tenure track total","36","19","17","0","0","0","6","2","4","2","2","0","7","5","2","0","0","0","17","8","9","0","0","0","4","2","2","0","0","0","-2"
"409698","California State University-Monterey Bay","2011","Total full-time Instruction/research/public service, Non-tenured not on tenure track, Lecturers","40","14","26","0","0","0","3","1","2","1","0","1","6","1","5","0","0","0","28","12","16","0","0","0","2","0","2","0","0","0","-2"
"409698","California State University-Monterey Bay","2011","Total full-time Instruction/research/public service, Non-tenured not on tenure track total","40","14","26","0","0","0","3","1","2","1","0","1","6","1","5","0","0","0","28","12","16","0","0","0","2","0","2","0","0","0","-2"
"445188","University of California-Merced","2011","Total full-time Instruction/research/public service, Tenured, Professors","31","24","7","0","0","0","1","1","0","0","0","0","4","4","0","0","0","0","26","19","7","0","0","0","0","0","0","0","0","0","-2"
"445188","University of California-Merced","2011","Total full-time Instruction/research/public service, Tenured, Associate professors","34","25","9","1","0","1","6","6","0","0","0","0","4","3","1","0","0","0","23","16","7","0","0","0","0","0","0","0","0","0","-2"
"445188","University of California-Merced","2011","Total full-time Instruction/research/public service, Tenured, Lecturers","1","0","1","0","0","0","0","0","0","0","0","0","1","0","1","0","0","0","0","0","0","0","0","0","0","0","0","0","0","0","-2"
"445188","University of California-Merced","2011","Total full-time Instruction/research/public service, Tenured total","66","49","17","1","0","1","7","7","0","0","0","0","9","7","2","0","0","0","49","35","14","0","0","0","0","0","0","0","0","0","-2"
"445188","University of California-Merced","2011","Total full-time Instruction/research/public service, Non-tenured on tenure track, Assistant professors","63","38","25","1","0","1","16","10","6","3","2","1","7","6","1","0","0","0","36","20","16","0","0","0","0","0","0","0","0","0","-2"
"445188","University of California-Merced","2011","Total full-time Instruction/research/public service, Non-tenured on tenure track, Lecturers","2","0","2","0","0","0","1","0","1","0","0","0","0","0","0","0","0","0","1","0","1","0","0","0","0","0","0","0","0","0","-2"
"445188","University of California-Merced","2011","Total full-time Instruction/research/public service, Non-tenured on tenure track total","65","38","27","1","0","1","17","10","7","3","2","1","7","6","1","0","0","0","37","20","17","0","0","0","0","0","0","0","0","0","-2"
"445188","University of California-Merced","2011","Total full-time Instruction/research/public servicey, Non-tenured not on tenure track, Assistant professors","3","3","0","0","0","0","1","1","0","0","0","0","0","0","0","0","0","0","2","2","0","0","0","0","0","0","0","0","0","0","-2"
"445188","University of California-Merced","2011","Total full-time Instruction/research/public service, Non-tenured not on tenure track, Lecturers","87","43","44","2","1","1","9","4","5","1","1","0","11","5","6","0","0","0","57","27","30","2","2","0","5","3","2","0","0","0","-2"
"445188","University of California-Merced","2011","Total full-time Instruction/research/public service, Non-tenured not on tenure track total","90","46","44","2","1","1","10","5","5","1","1","0","11","5","6","0","0","0","59","29","30","2","2","0","5","3","2","0","0","0","-2"
