"unitid","institution name","year","S2010_F.Tenure status and academic rank of full-time instruction/research/public service staff","S2010_F_RV.Grand total","S2010_F_RV.Grand total men","S2010_F_RV.Grand total women","S2010_F_RV.American Indian or Alaska Native total","S2010_F_RV.American Indian or Alaska Native men","S2010_F_RV.American Indian or Alaska Native women","S2010_F_RV.Asian total","S2010_F_RV.Asian men","S2010_F_RV.Asian women","S2010_F_RV.Black or African American total","S2010_F_RV.Black or African American men","S2010_F_RV.Black or African American women","S2010_F_RV.Hispanic or Latino total","S2010_F_RV.Hispanic or Latino men","S2010_F_RV.Hispanic or Latino women","S2010_F_RV.Native Hawaiian or Other Pacific Islander total","S2010_F_RV.Native Hawaiian or Other Pacific Islander men","S2010_F_RV.Native Hawaiian or Other Pacific Islander women","S2010_F_RV.White total","S2010_F_RV.White men","S2010_F_RV.White women","S2010_F_RV.Two or more races total","S2010_F_RV.Two or more races men","S2010_F_RV.Two or more races women","S2010_F_RV.Race/ethnicity unknown total","S2010_F_RV.Race/ethnicity unknown men","S2010_F_RV.Race/ethnicity unknown women","S2010_F_RV.Nonresident alien total","S2010_F_RV.Nonresident alien men","S2010_F_RV.Nonresident alien women","IDX_HR"
"100706","University of Alabama in Huntsville","2010","Total full-time Instruction/research/public service, Tenured, Professors","76","67","9","0","0","0","12","12","0","0","0","0","2","2","0","0","0","0","62","53","9","0","0","0","0","0","0","0","0","0","-2"
"100706","University of Alabama in Huntsville","2010","Total full-time Instruction/research/public service, Tenured, Associate professors","75","49","26","0","0","0","15","14","1","7","4","3","0","0","0","0","0","0","53","31","22","0","0","0","0","0","0","0","0","0","-2"
"100706","University of Alabama in Huntsville","2010","Total full-time Instruction/research/public service, Tenured, Assistant professors","1","0","1","0","0","0","0","0","0","0","0","0","1","0","1","0","0","0","0","0","0","0","0","0","0","0","0","0","0","0","-2"
"100706","University of Alabama in Huntsville","2010","Total full-time Instruction/research/public service, Tenured total","152","116","36","0","0","0","27","26","1","7","4","3","3","2","1","0","0","0","115","84","31","0","0","0","0","0","0","0","0","0","-2"
"100706","University of Alabama in Huntsville","2010","Total full-time Instruction/research/public service, Non-tenured on tenure track, Associate professors","10","7","3","0","0","0","3","3","0","1","0","1","0","0","0","0","0","0","6","4","2","0","0","0","0","0","0","0","0","0","-2"
"100706","University of Alabama in Huntsville","2010","Total full-time Instruction/research/public service, Non-tenured on tenure track, Assistant professors","59","42","17","0","0","0","11","10","1","3","1","2","2","1","1","0","0","0","41","28","13","0","0","0","0","0","0","2","2","0","-2"
"100706","University of Alabama in Huntsville","2010","Total full-time Instruction/research/public service, Non-tenured on tenure track total","69","49","20","0","0","0","14","13","1","4","1","3","2","1","1","0","0","0","47","32","15","0","0","0","0","0","0","2","2","0","-2"
"100706","University of Alabama in Huntsville","2010","Total full-time Instruction/research/public service, Non-tenured not on tenure track, Professors","2","2","0","0","0","0","0","0","0","0","0","0","0","0","0","0","0","0","2","2","0","0","0","0","0","0","0","0","0","0","-2"
"100706","University of Alabama in Huntsville","2010","Total full-time Instruction/research/public service, Non-tenured not on tenure track, Associate professors","10","6","4","0","0","0","1","1","0","0","0","0","1","0","1","0","0","0","8","5","3","0","0","0","0","0","0","0","0","0","-2"
"100706","University of Alabama in Huntsville","2010","Total full-time Instruction/research/public servicey, Non-tenured not on tenure track, Assistant professors","26","7","19","0","0","0","0","0","0","1","0","1","1","0","1","0","0","0","23","6","17","0","0","0","0","0","0","1","1","0","-2"
"100706","University of Alabama in Huntsville","2010","Total full-time Instruction/research/public service, Non-tenured not on tenure track, Instructors","13","2","11","0","0","0","0","0","0","2","0","2","0","0","0","0","0","0","11","2","9","0","0","0","0","0","0","0","0","0","-2"
"100706","University of Alabama in Huntsville","2010","Total full-time Instruction/research/public service, Non-tenured not on tenure track, Lecturers","40","16","24","0","0","0","3","1","2","2","1","1","0","0","0","0","0","0","34","13","21","0","0","0","0","0","0","1","1","0","-2"
"100706","University of Alabama in Huntsville","2010","Total full-time Instruction/research/public service, Non-tenured not on tenure track total","91","33","58","0","0","0","4","2","2","5","1","4","2","0","2","0","0","0","78","28","50","0","0","0","0","0","0","2","2","0","-2"
"100751","The University of Alabama","2010","Total full-time Instruction/research/public service, Tenured, Professors","313","237","76","0","0","0","26","24","2","12","7","5","5","4","1","0","0","0","269","202","67","0","0","0","0","0","0","1","0","1","-2"
"100751","The University of Alabama","2010","Total full-time Instruction/research/public service, Tenured, Associate professors","258","158","100","0","0","0","10","8","2","20","5","15","5","3","2","0","0","0","219","139","80","0","0","0","0","0","0","4","3","1","-2"
"100751","The University of Alabama","2010","Total full-time Instruction/research/public service, Tenured, Assistant professors","12","3","9","0","0","0","0","0","0","0","0","0","0","0","0","0","0","0","11","3","8","0","0","0","0","0","0","1","0","1","-2"
"100751","The University of Alabama","2010","Total full-time Instruction/research/public service, Tenured total","583","398","185","0","0","0","36","32","4","32","12","20","10","7","3","0","0","0","499","344","155","0","0","0","0","0","0","6","3","3","-2"
"100751","The University of Alabama","2010","Total full-time Instruction/research/public service, Non-tenured on tenure track, Professors","1","1","0","0","0","0","0","0","0","0","0","0","0","0","0","0","0","0","1","1","0","0","0","0","0","0","0","0","0","0","-2"
"100751","The University of Alabama","2010","Total full-time Instruction/research/public service, Non-tenured on tenure track, Associate professors","10","7","3","0","0","0","3","2","1","1","1","0","0","0","0","0","0","0","5","3","2","0","0","0","0","0","0","1","1","0","-2"
"100751","The University of Alabama","2010","Total full-time Instruction/research/public service, Non-tenured on tenure track, Assistant professors","251","128","123","0","0","0","23","11","12","13","3","10","10","4","6","0","0","0","177","95","82","1","0","1","0","0","0","27","15","12","-2"
"100751","The University of Alabama","2010","Total full-time Instruction/research/public service, Non-tenured on tenure track total","262","136","126","0","0","0","26","13","13","14","4","10","10","4","6","0","0","0","183","99","84","1","0","1","0","0","0","28","16","12","-2"
"100751","The University of Alabama","2010","Total full-time Instruction/research/public service, Non-tenured not on tenure track, Professors","12","8","4","0","0","0","0","0","0","0","0","0","0","0","0","0","0","0","12","8","4","0","0","0","0","0","0","0","0","0","-2"
"100751","The University of Alabama","2010","Total full-time Instruction/research/public service, Non-tenured not on tenure track, Associate professors","24","14","10","0","0","0","2","0","2","2","1","1","0","0","0","0","0","0","20","13","7","0","0","0","0","0","0","0","0","0","-2"
"100751","The University of Alabama","2010","Total full-time Instruction/research/public servicey, Non-tenured not on tenure track, Assistant professors","75","25","50","1","0","1","2","1","1","10","3","7","0","0","0","0","0","0","58","18","40","1","1","0","0","0","0","3","2","1","-2"
"100751","The University of Alabama","2010","Total full-time Instruction/research/public service, Non-tenured not on tenure track, Instructors","205","90","115","0","0","0","3","1","2","9","4","5","3","3","0","0","0","0","182","78","104","0","0","0","0","0","0","8","4","4","-2"
"100751","The University of Alabama","2010","Total full-time Instruction/research/public service, Non-tenured not on tenure track, Lecturers","14","10","4","0","0","0","0","0","0","1","1","0","0","0","0","0","0","0","13","9","4","0","0","0","0","0","0","0","0","0","-2"
"100751","The University of Alabama","2010","Total full-time Instruction/research/public service, Non-tenured not on tenure track total","330","147","183","1","0","1","7","2","5","22","9","13","3","3","0","0","0","0","285","126","159","1","1","0","0","0","0","11","6","5","-2"
"102094","University of South Alabama","2010","Total full-time Instruction/research/public service, Tenured, Professors","164","132","32","0","0","0","10","9","1","3","3","0","0","0","0","0","0","0","151","120","31","0","0","0","0","0","0","0","0","0","-2"
"102094","University of South Alabama","2010","Total full-time Instruction/research/public service, Tenured, Associate professors","111","75","36","0","0","0","10","8","2","1","1","0","2","2","0","0","0","0","97","64","33","1","0","1","0","0","0","0","0","0","-2"
"102094","University of South Alabama","2010","Total full-time Instruction/research/public service, Tenured, Assistant professors","13","6","7","0","0","0","0","0","0","2","1","1","0","0","0","0","0","0","11","5","6","0","0","0","0","0","0","0","0","0","-2"
"102094","University of South Alabama","2010","Total full-time Instruction/research/public service, Tenured total","288","213","75","0","0","0","20","17","3","6","5","1","2","2","0","0","0","0","259","189","70","1","0","1","0","0","0","0","0","0","-2"
"102094","University of South Alabama","2010","Total full-time Instruction/research/public service, Non-tenured on tenure track, Professors","3","2","1","0","0","0","1","1","0","1","1","0","0","0","0","0","0","0","1","0","1","0","0","0","0","0","0","0","0","0","-2"
"102094","University of South Alabama","2010","Total full-time Instruction/research/public service, Non-tenured on tenure track, Associate professors","5","4","1","0","0","0","1","1","0","0","0","0","0","0","0","0","0","0","4","3","1","0","0","0","0","0","0","0","0","0","-2"
"102094","University of South Alabama","2010","Total full-time Instruction/research/public service, Non-tenured on tenure track, Assistant professors","117","65","52","2","0","2","14","12","2","8","2","6","0","0","0","1","1","0","91","50","41","1","0","1","0","0","0","0","0","0","-2"
"102094","University of South Alabama","2010","Total full-time Instruction/research/public service, Non-tenured on tenure track, Instructors","2","2","0","0","0","0","1","1","0","0","0","0","0","0","0","0","0","0","1","1","0","0","0","0","0","0","0","0","0","0","-2"
"102094","University of South Alabama","2010","Total full-time Instruction/research/public service, Non-tenured on tenure track total","127","73","54","2","0","2","17","15","2","9","3","6","0","0","0","1","1","0","97","54","43","1","0","1","0","0","0","0","0","0","-2"
"102094","University of South Alabama","2010","Total full-time Instruction/research/public service, Non-tenured not on tenure track, Professors","26","21","5","0","0","0","2","2","0","0","0","0","3","2","1","0","0","0","21","17","4","0","0","0","0","0","0","0","0","0","-2"
"102094","University of South Alabama","2010","Total full-time Instruction/research/public service, Non-tenured not on tenure track, Associate professors","47","29","18","1","1","0","3","3","0","1","0","1","0","0","0","0","0","0","42","25","17","0","0","0","0","0","0","0","0","0","-2"
"102094","University of South Alabama","2010","Total full-time Instruction/research/public servicey, Non-tenured not on tenure track, Assistant professors","105","49","56","0","0","0","16","10","6","7","1","6","4","3","1","0","0","0","78","35","43","0","0","0","0","0","0","0","0","0","-2"
"102094","University of South Alabama","2010","Total full-time Instruction/research/public service, Non-tenured not on tenure track, Instructors","129","36","93","1","1","0","6","4","2","6","0","6","1","0","1","0","0","0","115","31","84","0","0","0","0","0","0","0","0","0","-2"
"102094","University of South Alabama","2010","Total full-time Instruction/research/public service, Non-tenured not on tenure track, Lecturers","8","3","5","0","0","0","1","0","1","2","0","2","1","1","0","0","0","0","4","2","2","0","0","0","0","0","0","0","0","0","-2"
"102094","University of South Alabama","2010","Total full-time Instruction/research/public service, Non-tenured not on tenure track total","315","138","177","2","2","0","28","19","9","16","1","15","9","6","3","0","0","0","260","110","150","0","0","0","0","0","0","0","0","0","-2"
"102614","University of Alaska Fairbanks","2010","Total full-time Instruction/research/public service, Tenured, Professors","135","115","20","0","0","0","16","15","1","0","0","0","1","1","0","0","0","0","113","96","17","2","1","1","3","2","1","0","0","0","-2"
"102614","University of Alaska Fairbanks","2010","Total full-time Instruction/research/public service, Tenured, Associate professors","136","78","58","1","0","1","12","7","5","2","1","1","4","3","1","0","0","0","111","64","47","1","1","0","2","1","1","3","1","2","-2"
"102614","University of Alaska Fairbanks","2010","Total full-time Instruction/research/public service, Tenured total","271","193","78","1","0","1","28","22","6","2","1","1","5","4","1","0","0","0","224","160","64","3","2","1","5","3","2","3","1","2","-2"
"102614","University of Alaska Fairbanks","2010","Total full-time Instruction/research/public service, Non-tenured on tenure track, Associate professors","14","11","3","0","0","0","1","1","0","0","0","0","0","0","0","0","0","0","12","9","3","0","0","0","0","0","0","1","1","0","-2"
"102614","University of Alaska Fairbanks","2010","Total full-time Instruction/research/public service, Non-tenured on tenure track, Assistant professors","132","74","58","6","2","4","9","7","2","1","0","1","3","1","2","0","0","0","98","54","44","2","1","1","2","2","0","11","7","4","-2"
"102614","University of Alaska Fairbanks","2010","Total full-time Instruction/research/public service, Non-tenured on tenure track total","146","85","61","6","2","4","10","8","2","1","0","1","3","1","2","0","0","0","110","63","47","2","1","1","2","2","0","12","8","4","-2"
"102614","University of Alaska Fairbanks","2010","Total full-time Instruction/research/public service, Non-tenured not on tenure track, Professors","12","11","1","0","0","0","1","0","1","0","0","0","0","0","0","0","0","0","11","11","0","0","0","0","0","0","0","0","0","0","-2"
"102614","University of Alaska Fairbanks","2010","Total full-time Instruction/research/public service, Non-tenured not on tenure track, Associate professors","17","14","3","0","0","0","2","2","0","0","0","0","0","0","0","0","0","0","13","10","3","0","0","0","0","0","0","2","2","0","-2"
"102614","University of Alaska Fairbanks","2010","Total full-time Instruction/research/public servicey, Non-tenured not on tenure track, Assistant professors","103","44","59","6","1","5","3","3","0","0","0","0","2","1","1","1","0","1","79","29","50","1","1","0","0","0","0","11","9","2","-2"
"102614","University of Alaska Fairbanks","2010","Total full-time Instruction/research/public service, Non-tenured not on tenure track, Instructors","37","11","26","5","2","3","1","0","1","1","0","1","2","0","2","0","0","0","27","9","18","1","0","1","0","0","0","0","0","0","-2"
"102614","University of Alaska Fairbanks","2010","Total full-time Instruction/research/public service, Non-tenured not on tenure track, No academic rank","38","21","17","0","0","0","0","0","0","0","0","0","0","0","0","0","0","0","22","8","14","0","0","0","0","0","0","16","13","3","-2"
"102614","University of Alaska Fairbanks","2010","Total full-time Instruction/research/public service, Non-tenured not on tenure track total","207","101","106","11","3","8","7","5","2","1","0","1","4","1","3","1","0","1","152","67","85","2","1","1","0","0","0","29","24","5","-2"
"104151","Arizona State University-Tempe","2010","Total full-time Instruction/research/public service, Tenured, Professors","737","562","175","9","7","2","58","48","10","11","7","4","48","37","11","0","0","0","595","450","145","4","2","2","4","3","1","8","8","0","-2"
"104151","Arizona State University-Tempe","2010","Total full-time Instruction/research/public service, Tenured, Associate professors","529","315","214","3","1","2","56","38","18","20","11","9","43","21","22","0","0","0","394","234","160","1","1","0","2","2","0","10","7","3","-2"
"104151","Arizona State University-Tempe","2010","Total full-time Instruction/research/public service, Tenured, Assistant professors","2","0","2","0","0","0","0","0","0","0","0","0","0","0","0","0","0","0","2","0","2","0","0","0","0","0","0","0","0","0","-2"
"104151","Arizona State University-Tempe","2010","Total full-time Instruction/research/public service, Tenured total","1268","877","391","12","8","4","114","86","28","31","18","13","91","58","33","0","0","0","991","684","307","5","3","2","6","5","1","18","15","3","-2"
"104151","Arizona State University-Tempe","2010","Total full-time Instruction/research/public service, Non-tenured on tenure track, Associate professors","21","15","6","1","1","0","3","2","1","0","0","0","2","2","0","0","0","0","12","8","4","0","0","0","0","0","0","3","2","1","-2"
"104151","Arizona State University-Tempe","2010","Total full-time Instruction/research/public service, Non-tenured on tenure track, Assistant professors","435","228","207","4","1","3","50","28","22","9","5","4","47","23","24","0","0","0","241","131","110","3","0","3","12","6","6","69","34","35","-2"
"104151","Arizona State University-Tempe","2010","Total full-time Instruction/research/public service, Non-tenured on tenure track total","456","243","213","5","2","3","53","30","23","9","5","4","49","25","24","0","0","0","253","139","114","3","0","3","12","6","6","72","36","36","-2"
"104151","Arizona State University-Tempe","2010","Total full-time Instruction/research/public service, Non-tenured not on tenure track, Professors","58","38","20","1","1","0","1","0","1","3","0","3","0","0","0","0","0","0","45","29","16","0","0","0","1","1","0","7","7","0","-2"
"104151","Arizona State University-Tempe","2010","Total full-time Instruction/research/public service, Non-tenured not on tenure track, Associate professors","85","41","44","0","0","0","9","7","2","2","1","1","7","4","3","0","0","0","64","28","36","2","1","1","0","0","0","1","0","1","-2"
"104151","Arizona State University-Tempe","2010","Total full-time Instruction/research/public servicey, Non-tenured not on tenure track, Assistant professors","120","59","61","1","1","0","9","6","3","4","0","4","7","4","3","0","0","0","82","32","50","0","0","0","2","1","1","15","15","0","-2"
"104151","Arizona State University-Tempe","2010","Total full-time Instruction/research/public service, Non-tenured not on tenure track, Instructors","164","61","103","2","0","2","5","3","2","5","2","3","12","6","6","0","0","0","130","44","86","0","0","0","2","2","0","8","4","4","-2"
"104151","Arizona State University-Tempe","2010","Total full-time Instruction/research/public service, Non-tenured not on tenure track, Lecturers","354","155","199","2","0","2","23","9","14","3","0","3","19","8","11","0","0","0","290","127","163","1","0","1","4","2","2","12","9","3","-2"
"104151","Arizona State University-Tempe","2010","Total full-time Instruction/research/public service, Non-tenured not on tenure track, No academic rank","56","23","33","0","0","0","8","5","3","2","1","1","5","0","5","0","0","0","27","9","18","0","0","0","0","0","0","14","8","6","-2"
"104151","Arizona State University-Tempe","2010","Total full-time Instruction/research/public service, Non-tenured not on tenure track total","837","377","460","6","2","4","55","30","25","19","4","15","50","22","28","0","0","0","638","269","369","3","1","2","9","6","3","57","43","14","-2"
"104179","University of Arizona","2010","Total full-time Instruction/research/public service, Tenured, Professors","748","576","172","5","2","3","60","46","14","9","5","4","42","33","9","0","0","0","617","477","140","0","0","0","12","10","2","3","3","0","-2"
"104179","University of Arizona","2010","Total full-time Instruction/research/public service, Tenured, Associate professors","380","226","154","5","1","4","35","21","14","6","3","3","32","13","19","0","0","0","271","166","105","0","0","0","28","19","9","3","3","0","-2"
"104179","University of Arizona","2010","Total full-time Instruction/research/public service, Tenured total","1128","802","326","10","3","7","95","67","28","15","8","7","74","46","28","0","0","0","888","643","245","0","0","0","40","29","11","6","6","0","-2"
"104179","University of Arizona","2010","Total full-time Instruction/research/public service, Non-tenured on tenure track, Professors","7","5","2","0","0","0","1","1","0","0","0","0","0","0","0","0","0","0","6","4","2","0","0","0","0","0","0","0","0","0","-2"
"104179","University of Arizona","2010","Total full-time Instruction/research/public service, Non-tenured on tenure track, Associate professors","45","30","15","1","0","1","4","4","0","0","0","0","3","2","1","0","0","0","29","19","10","0","0","0","4","2","2","4","3","1","-2"
"104179","University of Arizona","2010","Total full-time Instruction/research/public service, Non-tenured on tenure track, Assistant professors","290","162","128","3","1","2","46","28","18","4","3","1","23","8","15","0","0","0","161","88","73","1","1","0","29","18","11","23","15","8","-2"
"104179","University of Arizona","2010","Total full-time Instruction/research/public service, Non-tenured on tenure track total","342","197","145","4","1","3","51","33","18","4","3","1","26","10","16","0","0","0","196","111","85","1","1","0","33","20","13","27","18","9","-2"
"104179","University of Arizona","2010","Total full-time Instruction/research/public service, Non-tenured not on tenure track, Professors","60","47","13","0","0","0","8","5","3","2","1","1","1","1","0","0","0","0","46","39","7","0","0","0","2","0","2","1","1","0","-2"
"104179","University of Arizona","2010","Total full-time Instruction/research/public service, Non-tenured not on tenure track, Associate professors","111","57","54","0","0","0","12","9","3","0","0","0","7","3","4","0","0","0","80","39","41","0","0","0","12","6","6","0","0","0","-2"
"104179","University of Arizona","2010","Total full-time Instruction/research/public servicey, Non-tenured not on tenure track, Assistant professors","310","169","141","1","0","1","40","27","13","4","2","2","23","10","13","0","0","0","188","87","101","3","2","1","12","9","3","39","32","7","-2"
"104179","University of Arizona","2010","Total full-time Instruction/research/public service, Non-tenured not on tenure track, Instructors","60","22","38","1","1","0","2","0","2","0","0","0","19","3","16","0","0","0","31","16","15","0","0","0","1","1","0","6","1","5","-2"
"104179","University of Arizona","2010","Total full-time Instruction/research/public service, Non-tenured not on tenure track, Lecturers","149","68","81","0","0","0","3","1","2","3","2","1","11","5","6","0","0","0","123","55","68","0","0","0","4","1","3","5","4","1","-2"
"104179","University of Arizona","2010","Total full-time Instruction/research/public service, Non-tenured not on tenure track total","690","363","327","2","1","1","65","42","23","9","5","4","61","22","39","0","0","0","468","236","232","3","2","1","31","17","14","51","38","13","-2"
"104586","Embry-Riddle Aeronautical University-Prescott","2010","Total full-time Instruction/research/public service, Tenured, Professors","8","7","1","0","0","0","0","0","0","0","0","0","0","0","0","0","0","0","8","7","1","0","0","0","0","0","0","0","0","0","-2"
"104586","Embry-Riddle Aeronautical University-Prescott","2010","Total full-time Instruction/research/public service, Tenured, Associate professors","14","11","3","0","0","0","4","2","2","0","0","0","1","1","0","0","0","0","9","8","1","0","0","0","0","0","0","0","0","0","-2"
"104586","Embry-Riddle Aeronautical University-Prescott","2010","Total full-time Instruction/research/public service, Tenured total","22","18","4","0","0","0","4","2","2","0","0","0","1","1","0","0","0","0","17","15","2","0","0","0","0","0","0","0","0","0","-2"
"104586","Embry-Riddle Aeronautical University-Prescott","2010","Total full-time Instruction/research/public service, Non-tenured on tenure track, Professors","1","0","1","0","0","0","0","0","0","0","0","0","0","0","0","0","0","0","1","0","1","0","0","0","0","0","0","0","0","0","-2"
"104586","Embry-Riddle Aeronautical University-Prescott","2010","Total full-time Instruction/research/public service, Non-tenured on tenure track, Associate professors","8","6","2","0","0","0","0","0","0","0","0","0","0","0","0","0","0","0","8","6","2","0","0","0","0","0","0","0","0","0","-2"
"104586","Embry-Riddle Aeronautical University-Prescott","2010","Total full-time Instruction/research/public service, Non-tenured on tenure track, Assistant professors","15","12","3","0","0","0","1","0","1","0","0","0","1","1","0","0","0","0","13","11","2","0","0","0","0","0","0","0","0","0","-2"
"104586","Embry-Riddle Aeronautical University-Prescott","2010","Total full-time Instruction/research/public service, Non-tenured on tenure track total","24","18","6","0","0","0","1","0","1","0","0","0","1","1","0","0","0","0","22","17","5","0","0","0","0","0","0","0","0","0","-2"
"104586","Embry-Riddle Aeronautical University-Prescott","2010","Total full-time Instruction/research/public service, Non-tenured not on tenure track, Associate professors","5","4","1","0","0","0","0","0","0","0","0","0","0","0","0","0","0","0","4","4","0","1","0","1","0","0","0","0","0","0","-2"
"104586","Embry-Riddle Aeronautical University-Prescott","2010","Total full-time Instruction/research/public servicey, Non-tenured not on tenure track, Assistant professors","12","12","0","0","0","0","0","0","0","0","0","0","0","0","0","0","0","0","11","11","0","0","0","0","1","1","0","0","0","0","-2"
"104586","Embry-Riddle Aeronautical University-Prescott","2010","Total full-time Instruction/research/public service, Non-tenured not on tenure track, Instructors","3","1","2","0","0","0","1","0","1","0","0","0","0","0","0","0","0","0","2","1","1","0","0","0","0","0","0","0","0","0","-2"
"104586","Embry-Riddle Aeronautical University-Prescott","2010","Total full-time Instruction/research/public service, Non-tenured not on tenure track total","20","17","3","0","0","0","1","0","1","0","0","0","0","0","0","0","0","0","17","16","1","1","0","1","1","1","0","0","0","0","-2"
"105330","Northern Arizona University","2010","Total full-time Instruction/research/public service, Tenured, Professors","244","158","86","6","3","3","4","1","3","2","2","0","11","5","6","0","0","0","212","143","69","1","1","0","2","1","1","6","2","4","-2"
"105330","Northern Arizona University","2010","Total full-time Instruction/research/public service, Tenured, Associate professors","168","94","74","7","2","5","3","2","1","3","2","1","6","1","5","0","0","0","135","77","58","0","0","0","6","4","2","8","6","2","-2"
"105330","Northern Arizona University","2010","Total full-time Instruction/research/public service, Tenured total","412","252","160","13","5","8","7","3","4","5","4","1","17","6","11","0","0","0","347","220","127","1","1","0","8","5","3","14","8","6","-2"
"105330","Northern Arizona University","2010","Total full-time Instruction/research/public service, Non-tenured on tenure track, Associate professors","4","2","2","0","0","0","1","1","0","0","0","0","0","0","0","0","0","0","3","1","2","0","0","0","0","0","0","0","0","0","-2"
"105330","Northern Arizona University","2010","Total full-time Instruction/research/public service, Non-tenured on tenure track, Assistant professors","111","46","65","5","0","5","3","2","1","2","1","1","7","4","3","2","2","0","78","31","47","0","0","0","4","2","2","10","4","6","-2"
"105330","Northern Arizona University","2010","Total full-time Instruction/research/public service, Non-tenured on tenure track total","115","48","67","5","0","5","4","3","1","2","1","1","7","4","3","2","2","0","81","32","49","0","0","0","4","2","2","10","4","6","-2"
"105330","Northern Arizona University","2010","Total full-time Instruction/research/public service, Non-tenured not on tenure track, Professors","4","3","1","0","0","0","0","0","0","0","0","0","0","0","0","0","0","0","4","3","1","0","0","0","0","0","0","0","0","0","-2"
"105330","Northern Arizona University","2010","Total full-time Instruction/research/public service, Non-tenured not on tenure track, Associate professors","17","3","14","0","0","0","0","0","0","0","0","0","2","0","2","0","0","0","15","3","12","0","0","0","0","0","0","0","0","0","-2"
"105330","Northern Arizona University","2010","Total full-time Instruction/research/public servicey, Non-tenured not on tenure track, Assistant professors","87","29","58","2","0","2","0","0","0","1","0","1","2","1","1","0","0","0","72","25","47","1","0","1","7","2","5","2","1","1","-2"
"105330","Northern Arizona University","2010","Total full-time Instruction/research/public service, Non-tenured not on tenure track, Instructors","78","35","43","2","1","1","1","1","0","0","0","0","4","2","2","0","0","0","56","23","33","0","0","0","8","6","2","7","2","5","-2"
"105330","Northern Arizona University","2010","Total full-time Instruction/research/public service, Non-tenured not on tenure track, Lecturers","123","57","66","2","1","1","2","1","1","1","0","1","4","2","2","0","0","0","104","47","57","0","0","0","4","3","1","6","3","3","-2"
"105330","Northern Arizona University","2010","Total full-time Instruction/research/public service, Non-tenured not on tenure track total","309","127","182","6","2","4","3","2","1","2","0","2","12","5","7","0","0","0","251","101","150","1","0","1","19","11","8","15","6","9","-2"
"110538","California State University-Chico","2010","Total full-time Instruction/research/public service, Tenured, Professors","229","145","84","2","2","0","23","17","6","5","4","1","11","6","5","0","0","0","186","115","71","1","1","0","1","0","1","0","0","0","-2"
"110538","California State University-Chico","2010","Total full-time Instruction/research/public service, Tenured, Associate professors","93","55","38","1","1","0","5","3","2","1","0","1","6","4","2","0","0","0","74","43","31","3","3","0","2","1","1","1","0","1","-2"
"110538","California State University-Chico","2010","Total full-time Instruction/research/public service, Tenured, Assistant professors","4","1","3","0","0","0","0","0","0","0","0","0","0","0","0","0","0","0","4","1","3","0","0","0","0","0","0","0","0","0","-2"
"110538","California State University-Chico","2010","Total full-time Instruction/research/public service, Tenured, Lecturers","2","1","1","0","0","0","0","0","0","0","0","0","0","0","0","0","0","0","2","1","1","0","0","0","0","0","0","0","0","0","-2"
"110538","California State University-Chico","2010","Total full-time Instruction/research/public service, Tenured, No academic rank","2","0","2","0","0","0","0","0","0","0","0","0","0","0","0","0","0","0","2","0","2","0","0","0","0","0","0","0","0","0","-2"
"110538","California State University-Chico","2010","Total full-time Instruction/research/public service, Tenured total","330","202","128","3","3","0","28","20","8","6","4","2","17","10","7","0","0","0","268","160","108","4","4","0","3","1","2","1","0","1","-2"
"110538","California State University-Chico","2010","Total full-time Instruction/research/public service, Non-tenured on tenure track, Associate professors","6","5","1","0","0","0","1","1","0","0","0","0","0","0","0","0","0","0","5","4","1","0","0","0","0","0","0","0","0","0","-2"
"110538","California State University-Chico","2010","Total full-time Instruction/research/public service, Non-tenured on tenure track, Assistant professors","111","56","55","0","0","0","9","4","5","2","1","1","4","1","3","0","0","0","83","43","40","1","0","1","5","2","3","7","5","2","-2"
"110538","California State University-Chico","2010","Total full-time Instruction/research/public service, Non-tenured on tenure track total","117","61","56","0","0","0","10","5","5","2","1","1","4","1","3","0","0","0","88","47","41","1","0","1","5","2","3","7","5","2","-2"
"110538","California State University-Chico","2010","Total full-time Instruction/research/public service, Non-tenured not on tenure track, Lecturers","53","32","21","0","0","0","1","0","1","1","1","0","0","0","0","0","0","0","49","29","20","1","1","0","1","1","0","0","0","0","-2"
"110538","California State University-Chico","2010","Total full-time Instruction/research/public service, Non-tenured not on tenure track total","53","32","21","0","0","0","1","0","1","1","1","0","0","0","0","0","0","0","49","29","20","1","1","0","1","1","0","0","0","0","-2"
"110635","University of California-Berkeley","2010","Total full-time Instruction/research/public service, Tenured, Professors","851","668","183","0","0","0","85","67","18","16","15","1","36","28","8","0","0","0","704","550","154","0","0","0","9","8","1","1","0","1","-2"
"110635","University of California-Berkeley","2010","Total full-time Instruction/research/public service, Tenured, Associate professors","272","163","109","0","0","0","43","25","18","11","5","6","16","10","6","0","0","0","190","112","78","0","0","0","12","11","1","0","0","0","-2"
"110635","University of California-Berkeley","2010","Total full-time Instruction/research/public service, Tenured, Lecturers","17","11","6","0","0","0","1","1","0","0","0","0","1","1","0","0","0","0","15","9","6","0","0","0","0","0","0","0","0","0","-2"
"110635","University of California-Berkeley","2010","Total full-time Instruction/research/public service, Tenured total","1140","842","298","0","0","0","129","93","36","27","20","7","53","39","14","0","0","0","909","671","238","0","0","0","21","19","2","1","0","1","-2"
"110635","University of California-Berkeley","2010","Total full-time Instruction/research/public service, Non-tenured on tenure track, Professors","13","8","5","0","0","0","1","1","0","1","0","1","0","0","0","0","0","0","3","2","1","0","0","0","7","4","3","1","1","0","-2"
"110635","University of California-Berkeley","2010","Total full-time Instruction/research/public service, Non-tenured on tenure track, Associate professors","1","1","0","0","0","0","0","0","0","0","0","0","0","0","0","0","0","0","1","1","0","0","0","0","0","0","0","0","0","0","-2"
"110635","University of California-Berkeley","2010","Total full-time Instruction/research/public service, Non-tenured on tenure track, Assistant professors","216","128","88","2","0","2","29","15","14","10","3","7","12","8","4","0","0","0","122","74","48","0","0","0","25","18","7","16","10","6","-2"
"110635","University of California-Berkeley","2010","Total full-time Instruction/research/public service, Non-tenured on tenure track total","230","137","93","2","0","2","30","16","14","11","3","8","12","8","4","0","0","0","126","77","49","0","0","0","32","22","10","17","11","6","-2"
"110635","University of California-Berkeley","2010","Total full-time Instruction/research/public service, Non-tenured not on tenure track, Professors","36","24","12","0","0","0","0","0","0","1","1","0","0","0","0","0","0","0","28","17","11","0","0","0","4","3","1","3","3","0","-2"
"110635","University of California-Berkeley","2010","Total full-time Instruction/research/public service, Non-tenured not on tenure track, Associate professors","25","14","11","0","0","0","6","3","3","1","0","1","0","0","0","0","0","0","14","8","6","0","0","0","3","2","1","1","1","0","-2"
"110635","University of California-Berkeley","2010","Total full-time Instruction/research/public servicey, Non-tenured not on tenure track, Assistant professors","23","16","7","0","0","0","4","2","2","0","0","0","1","1","0","0","0","0","8","5","3","0","0","0","8","6","2","2","2","0","-2"
"110635","University of California-Berkeley","2010","Total full-time Instruction/research/public service, Non-tenured not on tenure track, Instructors","3","0","3","0","0","0","2","0","2","0","0","0","0","0","0","0","0","0","0","0","0","0","0","0","1","0","1","0","0","0","-2"
"110635","University of California-Berkeley","2010","Total full-time Instruction/research/public service, Non-tenured not on tenure track, Lecturers","145","56","89","1","0","1","31","10","21","3","1","2","4","2","2","0","0","0","90","37","53","0","0","0","12","5","7","4","1","3","-2"
"110635","University of California-Berkeley","2010","Total full-time Instruction/research/public service, Non-tenured not on tenure track, No academic rank","8","3","5","0","0","0","0","0","0","1","0","1","1","1","0","0","0","0","6","2","4","0","0","0","0","0","0","0","0","0","-2"
"110635","University of California-Berkeley","2010","Total full-time Instruction/research/public service, Non-tenured not on tenure track total","240","113","127","1","0","1","43","15","28","6","2","4","6","4","2","0","0","0","146","69","77","0","0","0","28","16","12","10","7","3","-2"
"110644","University of California-Davis","2010","Total full-time Instruction/research/public service, Tenured, Professors","907","686","221","3","1","2","108","86","22","12","8","4","33","23","10","0","0","0","739","560","179","0","0","0","9","7","2","3","1","2","-2"
"110644","University of California-Davis","2010","Total full-time Instruction/research/public service, Tenured, Associate professors","266","149","117","4","1","3","44","24","20","8","2","6","17","9","8","0","0","0","179","100","79","0","0","0","11","10","1","3","3","0","-2"
"110644","University of California-Davis","2010","Total full-time Instruction/research/public service, Tenured, Lecturers","19","14","5","0","0","0","0","0","0","0","0","0","0","0","0","0","0","0","19","14","5","0","0","0","0","0","0","0","0","0","-2"
"110644","University of California-Davis","2010","Total full-time Instruction/research/public service, Tenured total","1192","849","343","7","2","5","152","110","42","20","10","10","50","32","18","0","0","0","937","674","263","0","0","0","20","17","3","6","4","2","-2"
"110644","University of California-Davis","2010","Total full-time Instruction/research/public service, Non-tenured on tenure track, Professors","6","2","4","0","0","0","0","0","0","0","0","0","0","0","0","0","0","0","6","2","4","0","0","0","0","0","0","0","0","0","-2"
"110644","University of California-Davis","2010","Total full-time Instruction/research/public service, Non-tenured on tenure track, Assistant professors","224","125","99","1","0","1","50","20","30","6","2","4","12","6","6","0","0","0","129","80","49","0","0","0","20","14","6","6","3","3","-2"
"110644","University of California-Davis","2010","Total full-time Instruction/research/public service, Non-tenured on tenure track total","230","127","103","1","0","1","50","20","30","6","2","4","12","6","6","0","0","0","135","82","53","0","0","0","20","14","6","6","3","3","-2"
"110644","University of California-Davis","2010","Total full-time Instruction/research/public service, Non-tenured not on tenure track, Professors","176","130","46","2","1","1","28","22","6","1","1","0","7","5","2","0","0","0","133","98","35","0","0","0","3","2","1","2","1","1","-2"
"110644","University of California-Davis","2010","Total full-time Instruction/research/public service, Non-tenured not on tenure track, Associate professors","142","94","48","0","0","0","44","30","14","3","1","2","3","3","0","0","0","0","84","54","30","0","0","0","8","6","2","0","0","0","-2"
"110644","University of California-Davis","2010","Total full-time Instruction/research/public servicey, Non-tenured not on tenure track, Assistant professors","227","130","97","2","1","1","70","37","33","5","3","2","10","10","0","0","0","0","118","67","51","0","0","0","13","7","6","9","5","4","-2"
"110644","University of California-Davis","2010","Total full-time Instruction/research/public service, Non-tenured not on tenure track, Lecturers","128","66","62","0","0","0","8","3","5","4","2","2","7","3","4","0","0","0","104","58","46","0","0","0","3","0","3","2","0","2","-2"
"110644","University of California-Davis","2010","Total full-time Instruction/research/public service, Non-tenured not on tenure track, No academic rank","1","1","0","0","0","0","0","0","0","0","0","0","0","0","0","0","0","0","1","1","0","0","0","0","0","0","0","0","0","0","-2"
"110644","University of California-Davis","2010","Total full-time Instruction/research/public service, Non-tenured not on tenure track total","674","421","253","4","2","2","150","92","58","13","7","6","27","21","6","0","0","0","440","278","162","0","0","0","27","15","12","13","6","7","-2"
"110653","University of California-Irvine","2010","Total full-time Instruction/research/public service, Tenured, Professors","571","440","131","0","0","0","93","74","19","10","7","3","25","21","4","0","0","0","439","335","104","0","0","0","4","3","1","0","0","0","-2"
"110653","University of California-Irvine","2010","Total full-time Instruction/research/public service, Tenured, Associate professors","231","143","88","1","1","0","59","34","25","9","6","3","16","8","8","0","0","0","144","93","51","0","0","0","2","1","1","0","0","0","-2"
"110653","University of California-Irvine","2010","Total full-time Instruction/research/public service, Tenured, Lecturers","23","14","9","0","0","0","2","2","0","0","0","0","1","1","0","0","0","0","20","11","9","0","0","0","0","0","0","0","0","0","-2"
"110653","University of California-Irvine","2010","Total full-time Instruction/research/public service, Tenured total","825","597","228","1","1","0","154","110","44","19","13","6","42","30","12","0","0","0","603","439","164","0","0","0","6","4","2","0","0","0","-2"
"110653","University of California-Irvine","2010","Total full-time Instruction/research/public service, Non-tenured on tenure track, Professors","6","5","1","0","0","0","1","1","0","0","0","0","1","1","0","0","0","0","3","2","1","0","0","0","0","0","0","1","1","0","-2"
"110653","University of California-Irvine","2010","Total full-time Instruction/research/public service, Non-tenured on tenure track, Associate professors","1","1","0","0","0","0","0","0","0","0","0","0","0","0","0","0","0","0","1","1","0","0","0","0","0","0","0","0","0","0","-2"
"110653","University of California-Irvine","2010","Total full-time Instruction/research/public service, Non-tenured on tenure track, Assistant professors","198","103","95","2","1","1","47","23","24","5","1","4","15","8","7","0","0","0","123","67","56","0","0","0","3","1","2","3","2","1","-2"
"110653","University of California-Irvine","2010","Total full-time Instruction/research/public service, Non-tenured on tenure track, Lecturers","6","1","5","0","0","0","0","0","0","0","0","0","0","0","0","0","0","0","6","1","5","0","0","0","0","0","0","0","0","0","-2"
"110653","University of California-Irvine","2010","Total full-time Instruction/research/public service, Non-tenured on tenure track total","211","110","101","2","1","1","48","24","24","5","1","4","16","9","7","0","0","0","133","71","62","0","0","0","3","1","2","4","3","1","-2"
"110653","University of California-Irvine","2010","Total full-time Instruction/research/public service, Non-tenured not on tenure track, Professors","104","76","28","1","1","0","33","23","10","3","2","1","4","2","2","0","0","0","61","46","15","0","0","0","2","2","0","0","0","0","-2"
"110653","University of California-Irvine","2010","Total full-time Instruction/research/public service, Non-tenured not on tenure track, Associate professors","99","56","43","0","0","0","32","22","10","1","1","0","6","3","3","0","0","0","57","28","29","0","0","0","1","0","1","2","2","0","-2"
"110653","University of California-Irvine","2010","Total full-time Instruction/research/public servicey, Non-tenured not on tenure track, Assistant professors","119","72","47","1","0","1","42","26","16","2","1","1","5","3","2","0","0","0","63","36","27","0","0","0","2","2","0","4","4","0","-2"
"110653","University of California-Irvine","2010","Total full-time Instruction/research/public service, Non-tenured not on tenure track, Instructors","36","19","17","0","0","0","10","4","6","0","0","0","2","2","0","0","0","0","22","11","11","0","0","0","1","1","0","1","1","0","-2"
"110653","University of California-Irvine","2010","Total full-time Instruction/research/public service, Non-tenured not on tenure track, Lecturers","70","25","45","0","0","0","13","4","9","0","0","0","5","1","4","0","0","0","48","18","30","0","0","0","2","1","1","2","1","1","-2"
"110653","University of California-Irvine","2010","Total full-time Instruction/research/public service, Non-tenured not on tenure track total","428","248","180","2","1","1","130","79","51","6","4","2","22","11","11","0","0","0","251","139","112","0","0","0","8","6","2","9","8","1","-2"
"110662","University of California-Los Angeles","2010","Total full-time Instruction/research/public service, Tenured, Professors","1195","915","280","5","3","2","151","122","29","27","17","10","63","42","21","0","0","0","946","729","217","0","0","0","2","1","1","1","1","0","-2"
"110662","University of California-Los Angeles","2010","Total full-time Instruction/research/public service, Tenured, Associate professors","289","177","112","0","0","0","65","37","28","17","11","6","20","15","5","0","0","0","184","111","73","0","0","0","3","3","0","0","0","0","-2"
"110662","University of California-Los Angeles","2010","Total full-time Instruction/research/public service, Tenured, Lecturers","8","6","2","0","0","0","0","0","0","0","0","0","0","0","0","0","0","0","8","6","2","0","0","0","0","0","0","0","0","0","-2"
"110662","University of California-Los Angeles","2010","Total full-time Instruction/research/public service, Tenured total","1492","1098","394","5","3","2","216","159","57","44","28","16","83","57","26","0","0","0","1138","846","292","0","0","0","5","4","1","1","1","0","-2"
"110662","University of California-Los Angeles","2010","Total full-time Instruction/research/public service, Non-tenured on tenure track, Professors","7","1","6","0","0","0","2","0","2","0","0","0","0","0","0","0","0","0","4","1","3","0","0","0","1","0","1","0","0","0","-2"
"110662","University of California-Los Angeles","2010","Total full-time Instruction/research/public service, Non-tenured on tenure track, Assistant professors","250","150","100","3","1","2","59","35","24","12","3","9","23","17","6","0","0","0","147","88","59","0","0","0","6","6","0","0","0","0","-2"
"110662","University of California-Los Angeles","2010","Total full-time Instruction/research/public service, Non-tenured on tenure track, Instructors","2","2","0","0","0","0","0","0","0","0","0","0","0","0","0","0","0","0","2","2","0","0","0","0","0","0","0","0","0","0","-2"
"110662","University of California-Los Angeles","2010","Total full-time Instruction/research/public service, Non-tenured on tenure track total","259","153","106","3","1","2","61","35","26","12","3","9","23","17","6","0","0","0","153","91","62","0","0","0","7","6","1","0","0","0","-2"
"110662","University of California-Los Angeles","2010","Total full-time Instruction/research/public service, Non-tenured not on tenure track, Professors","258","188","70","0","0","0","44","32","12","5","3","2","9","5","4","0","0","0","198","146","52","0","0","0","0","0","0","2","2","0","-2"
"110662","University of California-Los Angeles","2010","Total full-time Instruction/research/public service, Non-tenured not on tenure track, Associate professors","215","134","81","0","0","0","61","41","20","4","0","4","4","3","1","0","0","0","145","89","56","0","0","0","1","1","0","0","0","0","-2"
"110662","University of California-Los Angeles","2010","Total full-time Instruction/research/public servicey, Non-tenured not on tenure track, Assistant professors","423","248","175","0","0","0","143","75","68","13","3","10","19","12","7","1","0","1","229","146","83","0","0","0","12","7","5","6","5","1","-2"
"110662","University of California-Los Angeles","2010","Total full-time Instruction/research/public service, Non-tenured not on tenure track, Instructors","139","74","65","0","0","0","42","19","23","1","1","0","8","5","3","0","0","0","81","45","36","0","0","0","6","4","2","1","0","1","-2"
"110662","University of California-Los Angeles","2010","Total full-time Instruction/research/public service, Non-tenured not on tenure track, Lecturers","128","55","73","0","0","0","24","7","17","2","1","1","5","2","3","0","0","0","91","44","47","0","0","0","3","0","3","3","1","2","-2"
"110662","University of California-Los Angeles","2010","Total full-time Instruction/research/public service, Non-tenured not on tenure track, No academic rank","8","2","6","0","0","0","2","1","1","0","0","0","0","0","0","0","0","0","2","0","2","0","0","0","4","1","3","0","0","0","-2"
"110662","University of California-Los Angeles","2010","Total full-time Instruction/research/public service, Non-tenured not on tenure track total","1171","701","470","0","0","0","316","175","141","25","8","17","45","27","18","1","0","1","746","470","276","0","0","0","26","13","13","12","8","4","-2"
"110680","University of California-San Diego","2010","Total full-time Instruction/research/public service, Tenured, Professors","689","573","116","1","1","0","93","79","14","6","2","4","29","24","5","0","0","0","557","464","93","0","0","0","3","3","0","0","0","0","-2"
"110680","University of California-San Diego","2010","Total full-time Instruction/research/public service, Tenured, Associate professors","221","149","72","0","0","0","38","30","8","6","2","4","19","14","5","0","0","0","150","97","53","0","0","0","8","6","2","0","0","0","-2"
"110680","University of California-San Diego","2010","Total full-time Instruction/research/public service, Tenured, Lecturers","17","8","9","0","0","0","1","0","1","0","0","0","1","0","1","0","0","0","14","7","7","0","0","0","1","1","0","0","0","0","-2"
"110680","University of California-San Diego","2010","Total full-time Instruction/research/public service, Tenured total","927","730","197","1","1","0","132","109","23","12","4","8","49","38","11","0","0","0","721","568","153","0","0","0","12","10","2","0","0","0","-2"
"110680","University of California-San Diego","2010","Total full-time Instruction/research/public service, Non-tenured on tenure track, Professors","1","0","1","0","0","0","0","0","0","0","0","0","0","0","0","0","0","0","1","0","1","0","0","0","0","0","0","0","0","0","-2"
"110680","University of California-San Diego","2010","Total full-time Instruction/research/public service, Non-tenured on tenure track, Associate professors","2","0","2","0","0","0","0","0","0","1","0","1","0","0","0","0","0","0","1","0","1","0","0","0","0","0","0","0","0","0","-2"
"110680","University of California-San Diego","2010","Total full-time Instruction/research/public service, Non-tenured on tenure track, Assistant professors","176","116","60","0","0","0","44","28","16","6","5","1","14","10","4","0","0","0","106","71","35","0","0","0","5","2","3","1","0","1","-2"
"110680","University of California-San Diego","2010","Total full-time Instruction/research/public service, Non-tenured on tenure track, Lecturers","22","10","12","0","0","0","2","0","2","0","0","0","0","0","0","0","0","0","18","9","9","0","0","0","2","1","1","0","0","0","-2"
"110680","University of California-San Diego","2010","Total full-time Instruction/research/public service, Non-tenured on tenure track total","201","126","75","0","0","0","46","28","18","7","5","2","14","10","4","0","0","0","126","80","46","0","0","0","7","3","4","1","0","1","-2"
"110680","University of California-San Diego","2010","Total full-time Instruction/research/public service, Non-tenured not on tenure track, Professors","262","191","71","1","1","0","26","23","3","4","2","2","12","9","3","0","0","0","217","154","63","0","0","0","1","1","0","1","1","0","-2"
"110680","University of California-San Diego","2010","Total full-time Instruction/research/public service, Non-tenured not on tenure track, Associate professors","197","119","78","2","1","1","37","23","14","5","5","0","13","7","6","0","0","0","135","81","54","0","0","0","3","2","1","2","0","2","-2"
"110680","University of California-San Diego","2010","Total full-time Instruction/research/public servicey, Non-tenured not on tenure track, Assistant professors","293","168","125","1","0","1","77","48","29","3","2","1","19","11","8","0","0","0","175","96","79","0","0","0","18","11","7","0","0","0","-2"
"110680","University of California-San Diego","2010","Total full-time Instruction/research/public service, Non-tenured not on tenure track, Lecturers","66","29","37","0","0","0","21","4","17","1","0","1","4","2","2","0","0","0","36","21","15","0","0","0","2","1","1","2","1","1","-2"
"110680","University of California-San Diego","2010","Total full-time Instruction/research/public service, Non-tenured not on tenure track total","818","507","311","4","2","2","161","98","63","13","9","4","48","29","19","0","0","0","563","352","211","0","0","0","24","15","9","5","2","3","-2"
"115755","Humboldt State University","2010","Total full-time Instruction/research/public service, Tenured, Professors","115","68","47","2","1","1","8","6","2","3","2","1","5","3","2","0","0","0","96","55","41","0","0","0","1","1","0","0","0","0","-2"
"115755","Humboldt State University","2010","Total full-time Instruction/research/public service, Tenured, Associate professors","57","38","19","2","2","0","1","0","1","0","0","0","0","0","0","0","0","0","53","36","17","0","0","0","1","0","1","0","0","0","-2"
"115755","Humboldt State University","2010","Total full-time Instruction/research/public service, Tenured, Assistant professors","2","2","0","0","0","0","0","0","0","0","0","0","0","0","0","0","0","0","2","2","0","0","0","0","0","0","0","0","0","0","-2"
"115755","Humboldt State University","2010","Total full-time Instruction/research/public service, Tenured, Instructors","1","0","1","0","0","0","0","0","0","0","0","0","0","0","0","0","0","0","1","0","1","0","0","0","0","0","0","0","0","0","-2"
"115755","Humboldt State University","2010","Total full-time Instruction/research/public service, Tenured total","175","108","67","4","3","1","9","6","3","3","2","1","5","3","2","0","0","0","152","93","59","0","0","0","2","1","1","0","0","0","-2"
"115755","Humboldt State University","2010","Total full-time Instruction/research/public service, Non-tenured on tenure track, Associate professors","4","3","1","0","0","0","1","1","0","0","0","0","0","0","0","0","0","0","3","2","1","0","0","0","0","0","0","0","0","0","-2"
"115755","Humboldt State University","2010","Total full-time Instruction/research/public service, Non-tenured on tenure track, Assistant professors","39","24","15","1","0","1","3","3","0","0","0","0","1","1","0","0","0","0","31","19","12","0","0","0","1","0","1","2","1","1","-2"
"115755","Humboldt State University","2010","Total full-time Instruction/research/public service, Non-tenured on tenure track total","43","27","16","1","0","1","4","4","0","0","0","0","1","1","0","0","0","0","34","21","13","0","0","0","1","0","1","2","1","1","-2"
"115755","Humboldt State University","2010","Total full-time Instruction/research/public service, Non-tenured not on tenure track, Lecturers","32","17","15","2","1","1","0","0","0","1","0","1","3","2","1","0","0","0","25","14","11","0","0","0","1","0","1","0","0","0","-2"
"115755","Humboldt State University","2010","Total full-time Instruction/research/public service, Non-tenured not on tenure track total","32","17","15","2","1","1","0","0","0","1","0","1","3","2","1","0","0","0","25","14","11","0","0","0","1","0","1","0","0","0","-2"
"122409","San Diego State University","2010","Total full-time Instruction/research/public service, Tenured, Professors","332","217","115","4","3","1","37","20","17","1","1","0","25","17","8","0","0","0","264","175","89","0","0","0","1","1","0","0","0","0","122409"
"122409","San Diego State University","2010","Total full-time Instruction/research/public service, Tenured, Associate professors","225","126","99","0","0","0","33","16","17","13","8","5","20","12","8","0","0","0","155","87","68","0","0","0","4","3","1","0","0","0","122409"
"122409","San Diego State University","2010","Total full-time Instruction/research/public service, Tenured, Assistant professors","2","2","0","0","0","0","0","0","0","0","0","0","0","0","0","0","0","0","2","2","0","0","0","0","0","0","0","0","0","0","122409"
"122409","San Diego State University","2010","Total full-time Instruction/research/public service, Tenured, No academic rank","11","6","5","0","0","0","0","0","0","0","0","0","2","1","1","0","0","0","9","5","4","0","0","0","0","0","0","0","0","0","122409"
"122409","San Diego State University","2010","Total full-time Instruction/research/public service, Tenured total","570","351","219","4","3","1","70","36","34","14","9","5","47","30","17","0","0","0","430","269","161","0","0","0","5","4","1","0","0","0","122409"
"122409","San Diego State University","2010","Total full-time Instruction/research/public service, Non-tenured on tenure track, Professors","4","1","3","0","0","0","0","0","0","0","0","0","0","0","0","0","0","0","4","1","3","0","0","0","0","0","0","0","0","0","122409"
"122409","San Diego State University","2010","Total full-time Instruction/research/public service, Non-tenured on tenure track, Associate professors","10","7","3","0","0","0","1","1","0","0","0","0","0","0","0","0","0","0","8","5","3","0","0","0","1","1","0","0","0","0","122409"
"122409","San Diego State University","2010","Total full-time Instruction/research/public service, Non-tenured on tenure track, Assistant professors","125","65","60","0","0","0","8","5","3","8","4","4","10","5","5","0","0","0","70","39","31","1","0","1","6","2","4","22","10","12","122409"
"122409","San Diego State University","2010","Total full-time Instruction/research/public service, Non-tenured on tenure track, No academic rank","1","1","0","0","0","0","0","0","0","0","0","0","0","0","0","0","0","0","0","0","0","0","0","0","0","0","0","1","1","0","122409"
"122409","San Diego State University","2010","Total full-time Instruction/research/public service, Non-tenured on tenure track total","140","74","66","0","0","0","9","6","3","8","4","4","10","5","5","0","0","0","82","45","37","1","0","1","7","3","4","23","11","12","122409"
"122409","San Diego State University","2010","Total full-time Instruction/research/public service, Non-tenured not on tenure track, Lecturers","139","48","91","0","0","0","5","1","4","0","0","0","11","3","8","1","0","1","120","44","76","0","0","0","2","0","2","0","0","0","122409"
"122409","San Diego State University","2010","Total full-time Instruction/research/public service, Non-tenured not on tenure track total","139","48","91","0","0","0","5","1","4","0","0","0","11","3","8","1","0","1","120","44","76","0","0","0","2","0","2","0","0","0","122409"
"122597","San Francisco State University","2010","Total full-time Instruction/research/public service, Tenured, Professors","301","194","107","3","2","1","65","46","19","16","8","8","17","13","4","0","0","0","187","116","71","2","2","0","11","7","4","0","0","0","-2"
"122597","San Francisco State University","2010","Total full-time Instruction/research/public service, Tenured, Associate professors","166","78","88","3","1","2","31","13","18","10","5","5","16","5","11","0","0","0","100","49","51","3","2","1","2","2","0","1","1","0","-2"
"122597","San Francisco State University","2010","Total full-time Instruction/research/public service, Tenured, Assistant professors","6","1","5","0","0","0","1","0","1","0","0","0","2","0","2","0","0","0","2","1","1","0","0","0","1","0","1","0","0","0","-2"
"122597","San Francisco State University","2010","Total full-time Instruction/research/public service, Tenured, No academic rank","4","1","3","0","0","0","0","0","0","0","0","0","0","0","0","0","0","0","4","1","3","0","0","0","0","0","0","0","0","0","-2"
"122597","San Francisco State University","2010","Total full-time Instruction/research/public service, Tenured total","477","274","203","6","3","3","97","59","38","26","13","13","35","18","17","0","0","0","293","167","126","5","4","1","14","9","5","1","1","0","-2"
"122597","San Francisco State University","2010","Total full-time Instruction/research/public service, Non-tenured on tenure track, Associate professors","46","16","30","0","0","0","9","2","7","3","1","2","2","2","0","0","0","0","27","11","16","1","0","1","4","0","4","0","0","0","-2"
"122597","San Francisco State University","2010","Total full-time Instruction/research/public service, Non-tenured on tenure track, Assistant professors","199","91","108","4","1","3","45","16","29","7","4","3","18","9","9","0","0","0","102","50","52","4","1","3","16","8","8","3","2","1","-2"
"122597","San Francisco State University","2010","Total full-time Instruction/research/public service, Non-tenured on tenure track total","245","107","138","4","1","3","54","18","36","10","5","5","20","11","9","0","0","0","129","61","68","5","1","4","20","8","12","3","2","1","-2"
"122597","San Francisco State University","2010","Total full-time Instruction/research/public service, Non-tenured not on tenure track, Lecturers","81","37","44","0","0","0","14","4","10","3","1","2","5","1","4","0","0","0","53","27","26","1","0","1","5","4","1","0","0","0","-2"
"122597","San Francisco State University","2010","Total full-time Instruction/research/public service, Non-tenured not on tenure track total","81","37","44","0","0","0","14","4","10","3","1","2","5","1","4","0","0","0","53","27","26","1","0","1","5","4","1","0","0","0","-2"
"122755","San Jose State University","2010","Total full-time Instruction/research/public service, Tenured, Professors","318","199","119","2","1","1","64","44","20","10","5","5","15","8","7","0","0","0","219","137","82","0","0","0","7","3","4","1","1","0","-2"
"122755","San Jose State University","2010","Total full-time Instruction/research/public service, Tenured, Associate professors","143","74","69","2","1","1","32","18","14","7","5","2","14","9","5","0","0","0","77","36","41","2","0","2","9","5","4","0","0","0","-2"
"122755","San Jose State University","2010","Total full-time Instruction/research/public service, Tenured, Assistant professors","11","6","5","0","0","0","3","2","1","0","0","0","3","2","1","0","0","0","3","1","2","0","0","0","1","1","0","1","0","1","-2"
"122755","San Jose State University","2010","Total full-time Instruction/research/public service, Tenured, No academic rank","3","1","2","0","0","0","0","0","0","0","0","0","1","0","1","0","0","0","2","1","1","0","0","0","0","0","0","0","0","0","-2"
"122755","San Jose State University","2010","Total full-time Instruction/research/public service, Tenured total","475","280","195","4","2","2","99","64","35","17","10","7","33","19","14","0","0","0","301","175","126","2","0","2","17","9","8","2","1","1","-2"
"122755","San Jose State University","2010","Total full-time Instruction/research/public service, Non-tenured on tenure track, Associate professors","17","6","11","0","0","0","2","1","1","0","0","0","0","0","0","0","0","0","12","3","9","0","0","0","2","1","1","1","1","0","-2"
"122755","San Jose State University","2010","Total full-time Instruction/research/public service, Non-tenured on tenure track, Assistant professors","136","56","80","0","0","0","25","7","18","2","1","1","6","1","5","0","0","0","73","32","41","2","1","1","18","7","11","10","7","3","-2"
"122755","San Jose State University","2010","Total full-time Instruction/research/public service, Non-tenured on tenure track total","153","62","91","0","0","0","27","8","19","2","1","1","6","1","5","0","0","0","85","35","50","2","1","1","20","8","12","11","8","3","-2"
"122755","San Jose State University","2010","Total full-time Instruction/research/public service, Non-tenured not on tenure track, Lecturers","65","31","34","0","0","0","8","4","4","2","0","2","3","1","2","0","0","0","46","24","22","1","0","1","5","2","3","0","0","0","-2"
"122755","San Jose State University","2010","Total full-time Instruction/research/public service, Non-tenured not on tenure track total","65","31","34","0","0","0","8","4","4","2","0","2","3","1","2","0","0","0","46","24","22","1","0","1","5","2","3","0","0","0","-2"
"123961","University of Southern California","2010","Total full-time Instruction/research/public service, Tenured, Professors","771","626","145","0","0","0","97","82","15","12","12","0","21","16","5","0","0","0","620","498","122","5","3","2","14","13","1","2","2","0","-2"
"123961","University of Southern California","2010","Total full-time Instruction/research/public service, Tenured, Associate professors","346","235","111","0","0","0","61","48","13","14","5","9","15","9","6","0","0","0","241","163","78","2","1","1","9","6","3","4","3","1","-2"
"123961","University of Southern California","2010","Total full-time Instruction/research/public service, Tenured, Assistant professors","5","4","1","0","0","0","1","0","1","0","0","0","0","0","0","0","0","0","4","4","0","0","0","0","0","0","0","0","0","0","-2"
"123961","University of Southern California","2010","Total full-time Instruction/research/public service, Tenured, Lecturers","1","1","0","0","0","0","0","0","0","0","0","0","0","0","0","0","0","0","1","1","0","0","0","0","0","0","0","0","0","0","-2"
"123961","University of Southern California","2010","Total full-time Instruction/research/public service, Tenured total","1123","866","257","0","0","0","159","130","29","26","17","9","36","25","11","0","0","0","866","666","200","7","4","3","23","19","4","6","5","1","-2"
"123961","University of Southern California","2010","Total full-time Instruction/research/public service, Non-tenured on tenure track, Professors","14","10","4","0","0","0","4","2","2","2","1","1","0","0","0","0","0","0","4","3","1","1","1","0","1","1","0","2","2","0","-2"
"123961","University of Southern California","2010","Total full-time Instruction/research/public service, Non-tenured on tenure track, Associate professors","16","12","4","0","0","0","2","2","0","1","0","1","0","0","0","0","0","0","10","8","2","0","0","0","1","1","0","2","1","1","-2"
"123961","University of Southern California","2010","Total full-time Instruction/research/public service, Non-tenured on tenure track, Assistant professors","259","156","103","0","0","0","44","23","21","12","6","6","17","9","8","0","0","0","119","72","47","5","3","2","16","10","6","46","33","13","-2"
"123961","University of Southern California","2010","Total full-time Instruction/research/public service, Non-tenured on tenure track total","289","178","111","0","0","0","50","27","23","15","7","8","17","9","8","0","0","0","133","83","50","6","4","2","18","12","6","50","36","14","-2"
"123961","University of Southern California","2010","Total full-time Instruction/research/public service, Non-tenured not on tenure track, Professors","236","170","66","0","0","0","27","20","7","7","3","4","9","7","2","0","0","0","182","130","52","0","0","0","7","6","1","4","4","0","-2"
"123961","University of Southern California","2010","Total full-time Instruction/research/public service, Non-tenured not on tenure track, Associate professors","334","215","119","0","0","0","72","47","25","9","5","4","15","9","6","0","0","0","229","147","82","3","2","1","4","3","1","2","2","0","-2"
"123961","University of Southern California","2010","Total full-time Instruction/research/public servicey, Non-tenured not on tenure track, Assistant professors","787","418","369","1","1","0","224","126","98","19","6","13","46","19","27","0","0","0","400","201","199","6","3","3","36","21","15","55","41","14","-2"
"123961","University of Southern California","2010","Total full-time Instruction/research/public service, Non-tenured not on tenure track, Instructors","159","62","97","1","1","0","42","21","21","8","1","7","10","7","3","0","0","0","88","28","60","1","0","1","5","1","4","4","3","1","-2"
"123961","University of Southern California","2010","Total full-time Instruction/research/public service, Non-tenured not on tenure track, Lecturers","294","148","146","0","0","0","28","9","19","6","3","3","21","7","14","0","0","0","210","113","97","4","2","2","12","5","7","13","9","4","-2"
"123961","University of Southern California","2010","Total full-time Instruction/research/public service, Non-tenured not on tenure track, No academic rank","1","1","0","0","0","0","0","0","0","0","0","0","0","0","0","0","0","0","1","1","0","0","0","0","0","0","0","0","0","0","-2"
"123961","University of Southern California","2010","Total full-time Instruction/research/public service, Non-tenured not on tenure track total","1811","1014","797","2","2","0","393","223","170","49","18","31","101","49","52","0","0","0","1110","620","490","14","7","7","64","36","28","78","59","19","-2"
"126818","Colorado State University-Fort Collins","2010","Total full-time Instruction/research/public service, Tenured, Professors","365","280","85","1","1","0","21","18","3","3","3","0","12","9","3","0","0","0","308","235","73","1","1","0","0","0","0","19","13","6","-2"
"126818","Colorado State University-Fort Collins","2010","Total full-time Instruction/research/public service, Tenured, Associate professors","293","187","106","2","1","1","11","9","2","4","3","1","14","7","7","0","0","0","231","141","90","2","1","1","3","3","0","26","22","4","-2"
"126818","Colorado State University-Fort Collins","2010","Total full-time Instruction/research/public service, Tenured, Assistant professors","3","3","0","0","0","0","0","0","0","0","0","0","0","0","0","0","0","0","3","3","0","0","0","0","0","0","0","0","0","0","-2"
"126818","Colorado State University-Fort Collins","2010","Total full-time Instruction/research/public service, Tenured total","661","470","191","3","2","1","32","27","5","7","6","1","26","16","10","0","0","0","542","379","163","3","2","1","3","3","0","45","35","10","-2"
"126818","Colorado State University-Fort Collins","2010","Total full-time Instruction/research/public service, Non-tenured on tenure track, Professors","3","3","0","0","0","0","0","0","0","0","0","0","0","0","0","0","0","0","3","3","0","0","0","0","0","0","0","0","0","0","-2"
"126818","Colorado State University-Fort Collins","2010","Total full-time Instruction/research/public service, Non-tenured on tenure track, Associate professors","17","11","6","0","0","0","1","0","1","0","0","0","0","0","0","0","0","0","12","10","2","0","0","0","0","0","0","4","1","3","-2"
"126818","Colorado State University-Fort Collins","2010","Total full-time Instruction/research/public service, Non-tenured on tenure track, Assistant professors","276","153","123","0","0","0","5","1","4","7","5","2","11","5","6","0","0","0","153","76","77","0","0","0","20","10","10","80","56","24","-2"
"126818","Colorado State University-Fort Collins","2010","Total full-time Instruction/research/public service, Non-tenured on tenure track total","296","167","129","0","0","0","6","1","5","7","5","2","11","5","6","0","0","0","168","89","79","0","0","0","20","10","10","84","57","27","-2"
"126818","Colorado State University-Fort Collins","2010","Total full-time Instruction/research/public service, Non-tenured not on tenure track, Professors","7","5","2","0","0","0","1","0","1","0","0","0","0","0","0","0","0","0","4","4","0","0","0","0","2","1","1","0","0","0","-2"
"126818","Colorado State University-Fort Collins","2010","Total full-time Instruction/research/public service, Non-tenured not on tenure track, Associate professors","16","11","5","0","0","0","3","1","2","0","0","0","3","2","1","0","0","0","8","6","2","0","0","0","0","0","0","2","2","0","-2"
"126818","Colorado State University-Fort Collins","2010","Total full-time Instruction/research/public servicey, Non-tenured not on tenure track, Assistant professors","77","29","48","1","1","0","5","2","3","0","0","0","2","0","2","0","0","0","52","16","36","0","0","0","1","1","0","16","9","7","-2"
"126818","Colorado State University-Fort Collins","2010","Total full-time Instruction/research/public service, Non-tenured not on tenure track, Instructors","118","44","74","1","0","1","4","1","3","0","0","0","3","0","3","0","0","0","96","38","58","1","0","1","3","1","2","10","4","6","-2"
"126818","Colorado State University-Fort Collins","2010","Total full-time Instruction/research/public service, Non-tenured not on tenure track total","218","89","129","2","1","1","13","4","9","0","0","0","8","2","6","0","0","0","160","64","96","1","0","1","6","3","3","28","15","13","-2"
"127060","University of Denver","2010","Total full-time Instruction/research/public service, Tenured, Professors","157","119","38","0","0","0","6","6","0","1","1","0","6","6","0","0","0","0","130","96","34","1","1","0","13","9","4","0","0","0","-2"
"127060","University of Denver","2010","Total full-time Instruction/research/public service, Tenured, Associate professors","153","80","73","1","1","0","7","2","5","6","3","3","13","7","6","0","0","0","114","60","54","0","0","0","12","7","5","0","0","0","-2"
"127060","University of Denver","2010","Total full-time Instruction/research/public service, Tenured total","310","199","111","1","1","0","13","8","5","7","4","3","19","13","6","0","0","0","244","156","88","1","1","0","25","16","9","0","0","0","-2"
"127060","University of Denver","2010","Total full-time Instruction/research/public service, Non-tenured on tenure track, Associate professors","3","3","0","0","0","0","1","1","0","0","0","0","0","0","0","0","0","0","2","2","0","0","0","0","0","0","0","0","0","0","-2"
"127060","University of Denver","2010","Total full-time Instruction/research/public service, Non-tenured on tenure track, Assistant professors","128","66","62","0","0","0","15","10","5","6","2","4","6","4","2","0","0","0","73","33","40","3","2","1","13","9","4","12","6","6","-2"
"127060","University of Denver","2010","Total full-time Instruction/research/public service, Non-tenured on tenure track total","131","69","62","0","0","0","16","11","5","6","2","4","6","4","2","0","0","0","75","35","40","3","2","1","13","9","4","12","6","6","-2"
"127060","University of Denver","2010","Total full-time Instruction/research/public service, Non-tenured not on tenure track, Professors","16","15","1","0","0","0","0","0","0","1","1","0","0","0","0","0","0","0","15","14","1","0","0","0","0","0","0","0","0","0","-2"
"127060","University of Denver","2010","Total full-time Instruction/research/public service, Non-tenured not on tenure track, Associate professors","11","7","4","0","0","0","0","0","0","1","1","0","1","1","0","0","0","0","9","5","4","0","0","0","0","0","0","0","0","0","-2"
"127060","University of Denver","2010","Total full-time Instruction/research/public servicey, Non-tenured not on tenure track, Assistant professors","13","2","11","0","0","0","0","0","0","0","0","0","0","0","0","0","0","0","12","2","10","0","0","0","0","0","0","1","0","1","-2"
"127060","University of Denver","2010","Total full-time Instruction/research/public service, Non-tenured not on tenure track, Lecturers","158","75","83","1","1","0","4","1","3","4","2","2","5","1","4","0","0","0","114","54","60","2","1","1","23","11","12","5","4","1","-2"
"127060","University of Denver","2010","Total full-time Instruction/research/public service, Non-tenured not on tenure track, No academic rank","1","0","1","0","0","0","0","0","0","0","0","0","0","0","0","0","0","0","1","0","1","0","0","0","0","0","0","0","0","0","-2"
"127060","University of Denver","2010","Total full-time Instruction/research/public service, Non-tenured not on tenure track total","199","99","100","1","1","0","4","1","3","6","4","2","6","2","4","0","0","0","151","75","76","2","1","1","23","11","12","6","4","2","-2"
"127565","Metropolitan State University of Denver","2010","Total full-time Instruction/research/public service, Tenured, Professors","125","84","41","1","0","1","8","5","3","3","3","0","10","9","1","0","0","0","99","65","34","3","1","2","1","1","0","0","0","0","-2"
"127565","Metropolitan State University of Denver","2010","Total full-time Instruction/research/public service, Tenured, Associate professors","83","43","40","2","1","1","7","5","2","5","3","2","10","7","3","0","0","0","58","26","32","1","1","0","0","0","0","0","0","0","-2"
"127565","Metropolitan State University of Denver","2010","Total full-time Instruction/research/public service, Tenured, Assistant professors","4","1","3","0","0","0","0","0","0","1","1","0","1","0","1","0","0","0","2","0","2","0","0","0","0","0","0","0","0","0","-2"
"127565","Metropolitan State University of Denver","2010","Total full-time Instruction/research/public service, Tenured total","212","128","84","3","1","2","15","10","5","9","7","2","21","16","5","0","0","0","159","91","68","4","2","2","1","1","0","0","0","0","-2"
"127565","Metropolitan State University of Denver","2010","Total full-time Instruction/research/public service, Non-tenured on tenure track, Professors","2","1","1","0","0","0","0","0","0","0","0","0","0","0","0","0","0","0","2","1","1","0","0","0","0","0","0","0","0","0","-2"
"127565","Metropolitan State University of Denver","2010","Total full-time Instruction/research/public service, Non-tenured on tenure track, Associate professors","11","2","9","0","0","0","0","0","0","1","0","1","0","0","0","0","0","0","8","2","6","2","0","2","0","0","0","0","0","0","-2"
"127565","Metropolitan State University of Denver","2010","Total full-time Instruction/research/public service, Non-tenured on tenure track, Assistant professors","195","96","99","1","0","1","16","10","6","8","7","1","21","9","12","0","0","0","143","66","77","3","3","0","3","1","2","0","0","0","-2"
"127565","Metropolitan State University of Denver","2010","Total full-time Instruction/research/public service, Non-tenured on tenure track total","208","99","109","1","0","1","16","10","6","9","7","2","21","9","12","0","0","0","153","69","84","5","3","2","3","1","2","0","0","0","-2"
"127565","Metropolitan State University of Denver","2010","Total full-time Instruction/research/public service, Non-tenured not on tenure track, Professors","2","0","2","0","0","0","0","0","0","0","0","0","0","0","0","0","0","0","2","0","2","0","0","0","0","0","0","0","0","0","-2"
"127565","Metropolitan State University of Denver","2010","Total full-time Instruction/research/public service, Non-tenured not on tenure track, Associate professors","1","1","0","0","0","0","0","0","0","0","0","0","0","0","0","0","0","0","1","1","0","0","0","0","0","0","0","0","0","0","-2"
"127565","Metropolitan State University of Denver","2010","Total full-time Instruction/research/public servicey, Non-tenured not on tenure track, Assistant professors","72","28","44","0","0","0","0","0","0","3","0","3","5","1","4","0","0","0","63","26","37","0","0","0","1","1","0","0","0","0","-2"
"127565","Metropolitan State University of Denver","2010","Total full-time Instruction/research/public service, Non-tenured not on tenure track, Instructors","22","15","7","0","0","0","0","0","0","1","0","1","2","2","0","0","0","0","18","12","6","1","1","0","0","0","0","0","0","0","-2"
"127565","Metropolitan State University of Denver","2010","Total full-time Instruction/research/public service, Non-tenured not on tenure track total","97","44","53","0","0","0","0","0","0","4","0","4","7","3","4","0","0","0","84","39","45","1","1","0","1","1","0","0","0","0","-2"
"127741","University of Northern Colorado","2010","Total full-time Instruction/research/public service, Tenured, Professors","166","98","68","3","2","1","4","2","2","5","2","3","10","4","6","0","0","0","144","88","56","0","0","0","0","0","0","0","0","0","-2"
"127741","University of Northern Colorado","2010","Total full-time Instruction/research/public service, Tenured, Associate professors","64","33","31","0","0","0","1","1","0","1","1","0","2","2","0","0","0","0","57","27","30","0","0","0","3","2","1","0","0","0","-2"
"127741","University of Northern Colorado","2010","Total full-time Instruction/research/public service, Tenured, Assistant professors","1","1","0","0","0","0","0","0","0","0","0","0","0","0","0","0","0","0","1","1","0","0","0","0","0","0","0","0","0","0","-2"
"127741","University of Northern Colorado","2010","Total full-time Instruction/research/public service, Tenured total","231","132","99","3","2","1","5","3","2","6","3","3","12","6","6","0","0","0","202","116","86","0","0","0","3","2","1","0","0","0","-2"
"127741","University of Northern Colorado","2010","Total full-time Instruction/research/public service, Non-tenured on tenure track, Professors","4","3","1","0","0","0","0","0","0","1","1","0","0","0","0","0","0","0","3","2","1","0","0","0","0","0","0","0","0","0","-2"
"127741","University of Northern Colorado","2010","Total full-time Instruction/research/public service, Non-tenured on tenure track, Associate professors","21","12","9","0","0","0","1","0","1","0","0","0","3","2","1","0","0","0","16","9","7","0","0","0","1","1","0","0","0","0","-2"
"127741","University of Northern Colorado","2010","Total full-time Instruction/research/public service, Non-tenured on tenure track, Assistant professors","88","46","42","0","0","0","6","4","2","1","1","0","2","1","1","0","0","0","67","33","34","0","0","0","4","2","2","8","5","3","-2"
"127741","University of Northern Colorado","2010","Total full-time Instruction/research/public service, Non-tenured on tenure track total","113","61","52","0","0","0","7","4","3","2","2","0","5","3","2","0","0","0","86","44","42","0","0","0","5","3","2","8","5","3","-2"
"127741","University of Northern Colorado","2010","Total full-time Instruction/research/public service, Non-tenured not on tenure track, Professors","3","3","0","0","0","0","0","0","0","0","0","0","0","0","0","0","0","0","3","3","0","0","0","0","0","0","0","0","0","0","-2"
"127741","University of Northern Colorado","2010","Total full-time Instruction/research/public service, Non-tenured not on tenure track, Associate professors","3","2","1","0","0","0","1","0","1","0","0","0","1","1","0","0","0","0","1","1","0","0","0","0","0","0","0","0","0","0","-2"
"127741","University of Northern Colorado","2010","Total full-time Instruction/research/public servicey, Non-tenured not on tenure track, Assistant professors","55","16","39","0","0","0","0","0","0","0","0","0","3","0","3","0","0","0","46","14","32","0","0","0","2","0","2","4","2","2","-2"
"127741","University of Northern Colorado","2010","Total full-time Instruction/research/public service, Non-tenured not on tenure track, Instructors","52","16","36","0","0","0","0","0","0","1","1","0","1","1","0","0","0","0","48","14","34","0","0","0","2","0","2","0","0","0","-2"
"127741","University of Northern Colorado","2010","Total full-time Instruction/research/public service, Non-tenured not on tenure track, Lecturers","41","18","23","1","0","1","0","0","0","1","1","0","2","0","2","0","0","0","34","15","19","0","0","0","3","2","1","0","0","0","-2"
"127741","University of Northern Colorado","2010","Total full-time Instruction/research/public service, Non-tenured not on tenure track total","154","55","99","1","0","1","1","0","1","2","2","0","7","2","5","0","0","0","132","47","85","0","0","0","7","2","5","4","2","2","-2"
"128328","United States Air Force Academy","2010","Total full-time Instruction/research/public service, Non-tenured not on tenure track, Professors","62","56","6","0","0","0","3","3","0","0","0","0","0","0","0","0","0","0","59","53","6","0","0","0","0","0","0","0","0","0","-2"
"128328","United States Air Force Academy","2010","Total full-time Instruction/research/public service, Non-tenured not on tenure track, Associate professors","41","29","12","0","0","0","2","1","1","0","0","0","1","1","0","0","0","0","38","27","11","0","0","0","0","0","0","0","0","0","-2"
"128328","United States Air Force Academy","2010","Total full-time Instruction/research/public servicey, Non-tenured not on tenure track, Assistant professors","55","36","19","0","0","0","3","2","1","0","0","0","1","1","0","0","0","0","50","32","18","1","1","0","0","0","0","0","0","0","-2"
"128328","United States Air Force Academy","2010","Total full-time Instruction/research/public service, Non-tenured not on tenure track, Instructors","46","21","25","0","0","0","2","0","2","0","0","0","0","0","0","0","0","0","43","21","22","1","0","1","0","0","0","0","0","0","-2"
"128328","United States Air Force Academy","2010","Total full-time Instruction/research/public service, Non-tenured not on tenure track total","204","142","62","0","0","0","10","6","4","0","0","0","2","2","0","0","0","0","190","133","57","2","1","1","0","0","0","0","0","0","-2"
"130776","Western Connecticut State University","2010","Total full-time Instruction/research/public service, Tenured, Professors","99","61","38","0","0","0","8","4","4","3","2","1","4","2","2","0","0","0","81","52","29","0","0","0","3","1","2","0","0","0","-2"
"130776","Western Connecticut State University","2010","Total full-time Instruction/research/public service, Tenured, Associate professors","49","26","23","0","0","0","4","3","1","2","1","1","2","1","1","0","0","0","37","19","18","0","0","0","4","2","2","0","0","0","-2"
"130776","Western Connecticut State University","2010","Total full-time Instruction/research/public service, Tenured, Assistant professors","9","4","5","0","0","0","0","0","0","0","0","0","0","0","0","0","0","0","7","2","5","0","0","0","2","2","0","0","0","0","-2"
"130776","Western Connecticut State University","2010","Total full-time Instruction/research/public service, Tenured total","157","91","66","0","0","0","12","7","5","5","3","2","6","3","3","0","0","0","125","73","52","0","0","0","9","5","4","0","0","0","-2"
"130776","Western Connecticut State University","2010","Total full-time Instruction/research/public service, Non-tenured on tenure track, Professors","1","1","0","0","0","0","0","0","0","0","0","0","0","0","0","0","0","0","1","1","0","0","0","0","0","0","0","0","0","0","-2"
"130776","Western Connecticut State University","2010","Total full-time Instruction/research/public service, Non-tenured on tenure track, Associate professors","5","0","5","0","0","0","0","0","0","0","0","0","0","0","0","0","0","0","5","0","5","0","0","0","0","0","0","0","0","0","-2"
"130776","Western Connecticut State University","2010","Total full-time Instruction/research/public service, Non-tenured on tenure track, Assistant professors","35","13","22","0","0","0","2","1","1","3","2","1","1","1","0","0","0","0","25","9","16","0","0","0","4","0","4","0","0","0","-2"
"130776","Western Connecticut State University","2010","Total full-time Instruction/research/public service, Non-tenured on tenure track total","41","14","27","0","0","0","2","1","1","3","2","1","1","1","0","0","0","0","31","10","21","0","0","0","4","0","4","0","0","0","-2"
"130776","Western Connecticut State University","2010","Total full-time Instruction/research/public service, Non-tenured not on tenure track, Associate professors","1","1","0","0","0","0","0","0","0","0","0","0","0","0","0","0","0","0","0","0","0","0","0","0","1","1","0","0","0","0","-2"
"130776","Western Connecticut State University","2010","Total full-time Instruction/research/public servicey, Non-tenured not on tenure track, Assistant professors","25","10","15","0","0","0","1","0","1","0","0","0","2","2","0","0","0","0","20","7","13","0","0","0","2","1","1","0","0","0","-2"
"130776","Western Connecticut State University","2010","Total full-time Instruction/research/public service, Non-tenured not on tenure track, Instructors","4","0","4","0","0","0","0","0","0","0","0","0","0","0","0","0","0","0","4","0","4","0","0","0","0","0","0","0","0","0","-2"
"130776","Western Connecticut State University","2010","Total full-time Instruction/research/public service, Non-tenured not on tenure track total","30","11","19","0","0","0","1","0","1","0","0","0","2","2","0","0","0","0","24","7","17","0","0","0","3","2","1","0","0","0","-2"
"130934","Delaware State University","2010","Total full-time Instruction/research/public service, Tenured, Professors","32","23","9","0","0","0","10","8","2","11","8","3","0","0","0","0","0","0","10","6","4","0","0","0","1","1","0","0","0","0","-2"
"130934","Delaware State University","2010","Total full-time Instruction/research/public service, Tenured, Associate professors","58","36","22","0","0","0","5","5","0","27","14","13","1","1","0","0","0","0","22","14","8","1","1","0","2","1","1","0","0","0","-2"
"130934","Delaware State University","2010","Total full-time Instruction/research/public service, Tenured, Assistant professors","4","2","2","0","0","0","1","1","0","3","1","2","0","0","0","0","0","0","0","0","0","0","0","0","0","0","0","0","0","0","-2"
"130934","Delaware State University","2010","Total full-time Instruction/research/public service, Tenured total","94","61","33","0","0","0","16","14","2","41","23","18","1","1","0","0","0","0","32","20","12","1","1","0","3","2","1","0","0","0","-2"
"130934","Delaware State University","2010","Total full-time Instruction/research/public service, Non-tenured on tenure track, Professors","4","4","0","1","1","0","1","1","0","1","1","0","0","0","0","0","0","0","1","1","0","0","0","0","0","0","0","0","0","0","-2"
"130934","Delaware State University","2010","Total full-time Instruction/research/public service, Non-tenured on tenure track, Associate professors","28","13","15","0","0","0","4","1","3","8","4","4","2","1","1","0","0","0","14","7","7","0","0","0","0","0","0","0","0","0","-2"
"130934","Delaware State University","2010","Total full-time Instruction/research/public service, Non-tenured on tenure track, Assistant professors","53","28","25","3","1","2","17","12","5","11","4","7","0","0","0","0","0","0","21","10","11","0","0","0","0","0","0","1","1","0","-2"
"130934","Delaware State University","2010","Total full-time Instruction/research/public service, Non-tenured on tenure track total","85","45","40","4","2","2","22","14","8","20","9","11","2","1","1","0","0","0","36","18","18","0","0","0","0","0","0","1","1","0","-2"
"130934","Delaware State University","2010","Total full-time Instruction/research/public servicey, Non-tenured not on tenure track, Assistant professors","6","3","3","0","0","0","0","0","0","2","1","1","1","1","0","0","0","0","3","1","2","0","0","0","0","0","0","0","0","0","-2"
"130934","Delaware State University","2010","Total full-time Instruction/research/public service, Non-tenured not on tenure track, Instructors","11","3","8","0","0","0","1","0","1","7","3","4","0","0","0","0","0","0","3","0","3","0","0","0","0","0","0","0","0","0","-2"
"130934","Delaware State University","2010","Total full-time Instruction/research/public service, Non-tenured not on tenure track, Lecturers","2","0","2","0","0","0","0","0","0","1","0","1","0","0","0","0","0","0","1","0","1","0","0","0","0","0","0","0","0","0","-2"
"130934","Delaware State University","2010","Total full-time Instruction/research/public service, Non-tenured not on tenure track total","19","6","13","0","0","0","1","0","1","10","4","6","1","1","0","0","0","0","7","1","6","0","0","0","0","0","0","0","0","0","-2"
"130943","University of Delaware","2010","Total full-time Instruction/research/public service, Tenured, Professors","367","277","90","0","0","0","41","37","4","11","6","5","5","5","0","0","0","0","310","229","81","0","0","0","0","0","0","0","0","0","-2"
"130943","University of Delaware","2010","Total full-time Instruction/research/public service, Tenured, Associate professors","307","196","111","0","0","0","31","23","8","17","9","8","12","7","5","0","0","0","242","154","88","0","0","0","0","0","0","5","3","2","-2"
"130943","University of Delaware","2010","Total full-time Instruction/research/public service, Tenured total","674","473","201","0","0","0","72","60","12","28","15","13","17","12","5","0","0","0","552","383","169","0","0","0","0","0","0","5","3","2","-2"
"130943","University of Delaware","2010","Total full-time Instruction/research/public service, Non-tenured on tenure track, Associate professors","5","2","3","1","0","1","0","0","0","0","0","0","0","0","0","0","0","0","3","1","2","0","0","0","0","0","0","1","1","0","-2"
"130943","University of Delaware","2010","Total full-time Instruction/research/public service, Non-tenured on tenure track, Assistant professors","162","84","78","0","0","0","23","11","12","11","6","5","4","1","3","0","0","0","103","52","51","0","0","0","2","1","1","19","13","6","-2"
"130943","University of Delaware","2010","Total full-time Instruction/research/public service, Non-tenured on tenure track total","167","86","81","1","0","1","23","11","12","11","6","5","4","1","3","0","0","0","106","53","53","0","0","0","2","1","1","20","14","6","-2"
"130943","University of Delaware","2010","Total full-time Instruction/research/public service, Non-tenured not on tenure track, Professors","12","9","3","0","0","0","1","1","0","1","1","0","0","0","0","0","0","0","10","7","3","0","0","0","0","0","0","0","0","0","-2"
"130943","University of Delaware","2010","Total full-time Instruction/research/public service, Non-tenured not on tenure track, Associate professors","38","23","15","0","0","0","2","2","0","2","1","1","0","0","0","0","0","0","33","20","13","0","0","0","1","0","1","0","0","0","-2"
"130943","University of Delaware","2010","Total full-time Instruction/research/public servicey, Non-tenured not on tenure track, Assistant professors","128","66","62","1","0","1","4","3","1","4","2","2","4","1","3","0","0","0","111","58","53","0","0","0","0","0","0","4","2","2","-2"
"130943","University of Delaware","2010","Total full-time Instruction/research/public service, Non-tenured not on tenure track, Instructors","107","31","76","2","1","1","3","0","3","2","1","1","4","0","4","0","0","0","95","28","67","0","0","0","0","0","0","1","1","0","-2"
"130943","University of Delaware","2010","Total full-time Instruction/research/public service, Non-tenured not on tenure track total","285","129","156","3","1","2","10","6","4","9","5","4","8","1","7","0","0","0","249","113","136","0","0","0","1","0","1","5","3","2","-2"
"133553","Embry-Riddle Aeronautical University-Daytona Beach","2010","Total full-time Instruction/research/public service, Tenured, Professors","44","42","2","0","0","0","6","5","1","0","0","0","0","0","0","0","0","0","38","37","1","0","0","0","0","0","0","0","0","0","-2"
"133553","Embry-Riddle Aeronautical University-Daytona Beach","2010","Total full-time Instruction/research/public service, Tenured, Associate professors","48","38","10","0","0","0","4","3","1","1","1","0","0","0","0","0","0","0","42","33","9","0","0","0","0","0","0","1","1","0","-2"
"133553","Embry-Riddle Aeronautical University-Daytona Beach","2010","Total full-time Instruction/research/public service, Tenured, Assistant professors","1","0","1","0","0","0","0","0","0","0","0","0","0","0","0","0","0","0","1","0","1","0","0","0","0","0","0","0","0","0","-2"
"133553","Embry-Riddle Aeronautical University-Daytona Beach","2010","Total full-time Instruction/research/public service, Tenured total","93","80","13","0","0","0","10","8","2","1","1","0","0","0","0","0","0","0","81","70","11","0","0","0","0","0","0","1","1","0","-2"
"133553","Embry-Riddle Aeronautical University-Daytona Beach","2010","Total full-time Instruction/research/public service, Non-tenured on tenure track, Professors","1","1","0","0","0","0","0","0","0","0","0","0","0","0","0","0","0","0","1","1","0","0","0","0","0","0","0","0","0","0","-2"
"133553","Embry-Riddle Aeronautical University-Daytona Beach","2010","Total full-time Instruction/research/public service, Non-tenured on tenure track, Associate professors","23","20","3","0","0","0","3","3","0","2","1","1","0","0","0","0","0","0","16","15","1","0","0","0","0","0","0","2","1","1","-2"
"133553","Embry-Riddle Aeronautical University-Daytona Beach","2010","Total full-time Instruction/research/public service, Non-tenured on tenure track, Assistant professors","33","21","12","0","0","0","0","0","0","0","0","0","1","0","1","0","0","0","27","18","9","0","0","0","1","1","0","4","2","2","-2"
"133553","Embry-Riddle Aeronautical University-Daytona Beach","2010","Total full-time Instruction/research/public service, Non-tenured on tenure track total","57","42","15","0","0","0","3","3","0","2","1","1","1","0","1","0","0","0","44","34","10","0","0","0","1","1","0","6","3","3","-2"
"133553","Embry-Riddle Aeronautical University-Daytona Beach","2010","Total full-time Instruction/research/public service, Non-tenured not on tenure track, Professors","2","2","0","0","0","0","0","0","0","0","0","0","0","0","0","0","0","0","2","2","0","0","0","0","0","0","0","0","0","0","-2"
"133553","Embry-Riddle Aeronautical University-Daytona Beach","2010","Total full-time Instruction/research/public service, Non-tenured not on tenure track, Associate professors","14","11","3","0","0","0","0","0","0","0","0","0","0","0","0","0","0","0","13","10","3","0","0","0","0","0","0","1","1","0","-2"
"133553","Embry-Riddle Aeronautical University-Daytona Beach","2010","Total full-time Instruction/research/public servicey, Non-tenured not on tenure track, Assistant professors","38","29","9","0","0","0","2","1","1","2","2","0","1","1","0","1","1","0","30","23","7","0","0","0","0","0","0","2","1","1","-2"
"133553","Embry-Riddle Aeronautical University-Daytona Beach","2010","Total full-time Instruction/research/public service, Non-tenured not on tenure track, Instructors","18","7","11","0","0","0","0","0","0","0","0","0","1","1","0","0","0","0","17","6","11","0","0","0","0","0","0","0","0","0","-2"
"133553","Embry-Riddle Aeronautical University-Daytona Beach","2010","Total full-time Instruction/research/public service, Non-tenured not on tenure track total","72","49","23","0","0","0","2","1","1","2","2","0","2","2","0","1","1","0","62","41","21","0","0","0","0","0","0","3","2","1","-2"
"133650","Florida Agricultural and Mechanical University","2010","Total full-time Instruction/research/public service, Tenured, Professors","145","103","42","0","0","0","16","14","2","100","68","32","1","0","1","0","0","0","28","21","7","0","0","0","0","0","0","0","0","0","-2"
"133650","Florida Agricultural and Mechanical University","2010","Total full-time Instruction/research/public service, Tenured, Associate professors","121","71","50","0","0","0","2","0","2","89","51","38","5","3","2","0","0","0","25","17","8","0","0","0","0","0","0","0","0","0","-2"
"133650","Florida Agricultural and Mechanical University","2010","Total full-time Instruction/research/public service, Tenured, Assistant professors","12","7","5","0","0","0","0","0","0","12","7","5","0","0","0","0","0","0","0","0","0","0","0","0","0","0","0","0","0","0","-2"
"133650","Florida Agricultural and Mechanical University","2010","Total full-time Instruction/research/public service, Tenured, No academic rank","3","0","3","0","0","0","0","0","0","3","0","3","0","0","0","0","0","0","0","0","0","0","0","0","0","0","0","0","0","0","-2"
"133650","Florida Agricultural and Mechanical University","2010","Total full-time Instruction/research/public service, Tenured total","281","181","100","0","0","0","18","14","4","204","126","78","6","3","3","0","0","0","53","38","15","0","0","0","0","0","0","0","0","0","-2"
"133650","Florida Agricultural and Mechanical University","2010","Total full-time Instruction/research/public service, Non-tenured on tenure track, Professors","6","4","2","0","0","0","2","2","0","2","1","1","0","0","0","0","0","0","2","1","1","0","0","0","0","0","0","0","0","0","-2"
"133650","Florida Agricultural and Mechanical University","2010","Total full-time Instruction/research/public service, Non-tenured on tenure track, Associate professors","51","21","30","0","0","0","4","4","0","30","10","20","0","0","0","0","0","0","17","7","10","0","0","0","0","0","0","0","0","0","-2"
"133650","Florida Agricultural and Mechanical University","2010","Total full-time Instruction/research/public service, Non-tenured on tenure track, Assistant professors","94","36","58","0","0","0","5","4","1","71","25","46","3","0","3","0","0","0","15","7","8","0","0","0","0","0","0","0","0","0","-2"
"133650","Florida Agricultural and Mechanical University","2010","Total full-time Instruction/research/public service, Non-tenured on tenure track, Instructors","2","0","2","0","0","0","0","0","0","1","0","1","0","0","0","0","0","0","1","0","1","0","0","0","0","0","0","0","0","0","-2"
"133650","Florida Agricultural and Mechanical University","2010","Total full-time Instruction/research/public service, Non-tenured on tenure track total","153","61","92","0","0","0","11","10","1","104","36","68","3","0","3","0","0","0","35","15","20","0","0","0","0","0","0","0","0","0","-2"
"133650","Florida Agricultural and Mechanical University","2010","Total full-time Instruction/research/public service, Non-tenured not on tenure track, Professors","8","5","3","0","0","0","0","0","0","2","1","1","1","0","1","0","0","0","5","4","1","0","0","0","0","0","0","0","0","0","-2"
"133650","Florida Agricultural and Mechanical University","2010","Total full-time Instruction/research/public service, Non-tenured not on tenure track, Associate professors","7","4","3","1","1","0","0","0","0","3","2","1","1","0","1","0","0","0","2","1","1","0","0","0","0","0","0","0","0","0","-2"
"133650","Florida Agricultural and Mechanical University","2010","Total full-time Instruction/research/public servicey, Non-tenured not on tenure track, Assistant professors","60","34","26","0","0","0","6","2","4","48","27","21","2","2","0","0","0","0","4","3","1","0","0","0","0","0","0","0","0","0","-2"
"133650","Florida Agricultural and Mechanical University","2010","Total full-time Instruction/research/public service, Non-tenured not on tenure track, Instructors","67","27","40","0","0","0","1","1","0","54","22","32","1","0","1","0","0","0","11","4","7","0","0","0","0","0","0","0","0","0","-2"
"133650","Florida Agricultural and Mechanical University","2010","Total full-time Instruction/research/public service, Non-tenured not on tenure track total","142","70","72","1","1","0","7","3","4","107","52","55","5","2","3","0","0","0","22","12","10","0","0","0","0","0","0","0","0","0","-2"
"133881","Florida Institute of Technology","2010","Total full-time Instruction/research/public service, Non-tenured not on tenure track, Professors","76","67","9","0","0","0","13","12","1","0","0","0","1","1","0","1","1","0","56","49","7","0","0","0","0","0","0","5","4","1","-2"
"133881","Florida Institute of Technology","2010","Total full-time Instruction/research/public service, Non-tenured not on tenure track, Associate professors","90","74","16","0","0","0","4","4","0","0","0","0","4","2","2","0","0","0","67","53","14","0","0","0","3","3","0","12","12","0","-2"
"133881","Florida Institute of Technology","2010","Total full-time Instruction/research/public servicey, Non-tenured not on tenure track, Assistant professors","53","32","21","0","0","0","1","1","0","2","2","0","4","1","3","0","0","0","34","20","14","0","0","0","0","0","0","12","8","4","-2"
"133881","Florida Institute of Technology","2010","Total full-time Instruction/research/public service, Non-tenured not on tenure track, Instructors","19","6","13","0","0","0","0","0","0","3","0","3","0","0","0","0","0","0","14","6","8","0","0","0","0","0","0","2","0","2","-2"
"133881","Florida Institute of Technology","2010","Total full-time Instruction/research/public service, Non-tenured not on tenure track total","238","179","59","0","0","0","18","17","1","5","2","3","9","4","5","1","1","0","171","128","43","0","0","0","3","3","0","31","24","7","-2"
"133951","Florida International University","2010","Total full-time Instruction/research/public service, Tenured, Professors","210","169","41","0","0","0","25","23","2","5","4","1","39","32","7","0","0","0","140","109","31","0","0","0","0","0","0","1","1","0","-2"
"133951","Florida International University","2010","Total full-time Instruction/research/public service, Tenured, Associate professors","227","151","76","0","0","0","39","32","7","19","11","8","20","16","4","0","0","0","144","87","57","0","0","0","0","0","0","5","5","0","-2"
"133951","Florida International University","2010","Total full-time Instruction/research/public service, Tenured, Assistant professors","1","0","1","0","0","0","0","0","0","0","0","0","1","0","1","0","0","0","0","0","0","0","0","0","0","0","0","0","0","0","-2"
"133951","Florida International University","2010","Total full-time Instruction/research/public service, Tenured total","438","320","118","0","0","0","64","55","9","24","15","9","60","48","12","0","0","0","284","196","88","0","0","0","0","0","0","6","6","0","-2"
"133951","Florida International University","2010","Total full-time Instruction/research/public service, Non-tenured on tenure track, Professors","1","1","0","0","0","0","0","0","0","0","0","0","0","0","0","0","0","0","1","1","0","0","0","0","0","0","0","0","0","0","-2"
"133951","Florida International University","2010","Total full-time Instruction/research/public service, Non-tenured on tenure track, Associate professors","14","8","6","0","0","0","2","2","0","0","0","0","3","0","3","0","0","0","7","4","3","0","0","0","0","0","0","2","2","0","-2"
"133951","Florida International University","2010","Total full-time Instruction/research/public service, Non-tenured on tenure track, Assistant professors","181","103","78","1","1","0","29","20","9","10","3","7","17","5","12","0","0","0","87","55","32","0","0","0","0","0","0","37","19","18","-2"
"133951","Florida International University","2010","Total full-time Instruction/research/public service, Non-tenured on tenure track total","196","112","84","1","1","0","31","22","9","10","3","7","20","5","15","0","0","0","95","60","35","0","0","0","0","0","0","39","21","18","-2"
"133951","Florida International University","2010","Total full-time Instruction/research/public service, Non-tenured not on tenure track, Professors","2","1","1","0","0","0","0","0","0","0","0","0","0","0","0","0","0","0","2","1","1","0","0","0","0","0","0","0","0","0","-2"
"133951","Florida International University","2010","Total full-time Instruction/research/public service, Non-tenured not on tenure track, Associate professors","14","7","7","0","0","0","2","1","1","3","1","2","2","2","0","0","0","0","7","3","4","0","0","0","0","0","0","0","0","0","-2"
"133951","Florida International University","2010","Total full-time Instruction/research/public servicey, Non-tenured not on tenure track, Assistant professors","37","9","28","0","0","0","2","0","2","1","0","1","10","3","7","0","0","0","22","5","17","0","0","0","0","0","0","2","1","1","-2"
"133951","Florida International University","2010","Total full-time Instruction/research/public service, Non-tenured not on tenure track, Instructors","113","63","50","0","0","0","7","4","3","11","7","4","22","9","13","0","0","0","66","41","25","0","0","0","0","0","0","7","2","5","-2"
"133951","Florida International University","2010","Total full-time Instruction/research/public service, Non-tenured not on tenure track, Lecturers","43","24","19","0","0","0","2","1","1","1","1","0","8","1","7","0","0","0","30","20","10","0","0","0","0","0","0","2","1","1","-2"
"133951","Florida International University","2010","Total full-time Instruction/research/public service, Non-tenured not on tenure track, No academic rank","1","1","0","0","0","0","0","0","0","0","0","0","0","0","0","0","0","0","1","1","0","0","0","0","0","0","0","0","0","0","-2"
"133951","Florida International University","2010","Total full-time Instruction/research/public service, Non-tenured not on tenure track total","210","105","105","0","0","0","13","6","7","16","9","7","42","15","27","0","0","0","128","71","57","0","0","0","0","0","0","11","4","7","-2"
"134097","Florida State University","2010","Total full-time Instruction/research/public service, Tenured, Professors","445","343","102","0","0","0","35","30","5","12","7","5","14","10","4","0","0","0","376","289","87","0","0","0","0","0","0","8","7","1","-2"
"134097","Florida State University","2010","Total full-time Instruction/research/public service, Tenured, Associate professors","333","205","128","1","1","0","32","25","7","20","9","11","12","8","4","0","0","0","262","159","103","0","0","0","0","0","0","6","3","3","-2"
"134097","Florida State University","2010","Total full-time Instruction/research/public service, Tenured total","778","548","230","1","1","0","67","55","12","32","16","16","26","18","8","0","0","0","638","448","190","0","0","0","0","0","0","14","10","4","-2"
"134097","Florida State University","2010","Total full-time Instruction/research/public service, Non-tenured on tenure track, Professors","4","2","2","0","0","0","0","0","0","0","0","0","0","0","0","0","0","0","4","2","2","0","0","0","0","0","0","0","0","0","-2"
"134097","Florida State University","2010","Total full-time Instruction/research/public service, Non-tenured on tenure track, Associate professors","18","12","6","0","0","0","4","2","2","0","0","0","2","1","1","0","0","0","12","9","3","0","0","0","0","0","0","0","0","0","-2"
"134097","Florida State University","2010","Total full-time Instruction/research/public service, Non-tenured on tenure track, Assistant professors","234","139","95","1","1","0","31","22","9","13","3","10","10","8","2","0","0","0","158","92","66","0","0","0","0","0","0","21","13","8","-2"
"134097","Florida State University","2010","Total full-time Instruction/research/public service, Non-tenured on tenure track total","256","153","103","1","1","0","35","24","11","13","3","10","12","9","3","0","0","0","174","103","71","0","0","0","0","0","0","21","13","8","-2"
"134097","Florida State University","2010","Total full-time Instruction/research/public service, Non-tenured not on tenure track, Professors","16","11","5","0","0","0","0","0","0","2","1","1","0","0","0","0","0","0","12","8","4","0","0","0","0","0","0","2","2","0","-2"
"134097","Florida State University","2010","Total full-time Instruction/research/public service, Non-tenured not on tenure track, Associate professors","15","7","8","0","0","0","0","0","0","0","0","0","2","1","1","0","0","0","12","5","7","0","0","0","0","0","0","1","1","0","-2"
"134097","Florida State University","2010","Total full-time Instruction/research/public servicey, Non-tenured not on tenure track, Assistant professors","25","10","15","0","0","0","2","1","1","3","1","2","1","1","0","0","0","0","17","6","11","0","0","0","0","0","0","2","1","1","-2"
"134097","Florida State University","2010","Total full-time Instruction/research/public service, Non-tenured not on tenure track, Instructors","6","5","1","0","0","0","0","0","0","0","0","0","0","0","0","0","0","0","6","5","1","0","0","0","0","0","0","0","0","0","-2"
"134097","Florida State University","2010","Total full-time Instruction/research/public service, Non-tenured not on tenure track, Lecturers","21","7","14","0","0","0","1","0","1","2","1","1","2","1","1","0","0","0","14","4","10","0","0","0","0","0","0","2","1","1","-2"
"134097","Florida State University","2010","Total full-time Instruction/research/public service, Non-tenured not on tenure track, No academic rank","523","268","255","1","0","1","43","25","18","16","4","12","17","9","8","0","0","0","398","195","203","0","0","0","0","0","0","48","35","13","-2"
"134097","Florida State University","2010","Total full-time Instruction/research/public service, Non-tenured not on tenure track total","606","308","298","1","0","1","46","26","20","23","7","16","22","12","10","0","0","0","459","223","236","0","0","0","0","0","0","55","40","15","-2"
"135726","University of Miami","2010","Total full-time Instruction/research/public service, Tenured, Professors","600","496","104","1","1","0","55","44","11","9","7","2","65","53","12","0","0","0","465","386","79","1","1","0","2","2","0","2","2","0","-2"
"135726","University of Miami","2010","Total full-time Instruction/research/public service, Tenured, Associate professors","260","174","86","2","2","0","30","26","4","10","5","5","30","18","12","0","0","0","187","122","65","0","0","0","0","0","0","1","1","0","-2"
"135726","University of Miami","2010","Total full-time Instruction/research/public service, Tenured, Assistant professors","2","2","0","0","0","0","0","0","0","0","0","0","0","0","0","0","0","0","2","2","0","0","0","0","0","0","0","0","0","0","-2"
"135726","University of Miami","2010","Total full-time Instruction/research/public service, Tenured total","862","672","190","3","3","0","85","70","15","19","12","7","95","71","24","0","0","0","654","510","144","1","1","0","2","2","0","3","3","0","-2"
"135726","University of Miami","2010","Total full-time Instruction/research/public service, Non-tenured on tenure track, Professors","7","6","1","0","0","0","1","1","0","0","0","0","2","1","1","0","0","0","3","3","0","0","0","0","0","0","0","1","1","0","-2"
"135726","University of Miami","2010","Total full-time Instruction/research/public service, Non-tenured on tenure track, Associate professors","60","40","20","0","0","0","11","8","3","2","1","1","6","5","1","0","0","0","37","23","14","1","0","1","0","0","0","3","3","0","-2"
"135726","University of Miami","2010","Total full-time Instruction/research/public service, Non-tenured on tenure track, Assistant professors","211","120","91","0","0","0","34","24","10","9","4","5","21","12","9","0","0","0","118","63","55","0","0","0","0","0","0","29","17","12","-2"
"135726","University of Miami","2010","Total full-time Instruction/research/public service, Non-tenured on tenure track total","278","166","112","0","0","0","46","33","13","11","5","6","29","18","11","0","0","0","158","89","69","1","0","1","0","0","0","33","21","12","-2"
"135726","University of Miami","2010","Total full-time Instruction/research/public service, Non-tenured not on tenure track, Professors","130","102","28","0","0","0","12","10","2","0","0","0","28","19","9","0","0","0","88","72","16","1","1","0","0","0","0","1","0","1","-2"
"135726","University of Miami","2010","Total full-time Instruction/research/public service, Non-tenured not on tenure track, Associate professors","226","152","74","0","0","0","26","17","9","8","5","3","61","42","19","1","0","1","122","82","40","1","1","0","0","0","0","7","5","2","-2"
"135726","University of Miami","2010","Total full-time Instruction/research/public servicey, Non-tenured not on tenure track, Assistant professors","654","341","313","0","0","0","84","42","42","36","12","24","184","82","102","0","0","0","280","156","124","5","0","5","1","1","0","64","48","16","-2"
"135726","University of Miami","2010","Total full-time Instruction/research/public service, Non-tenured not on tenure track, Instructors","80","43","37","0","0","0","9","6","3","2","2","0","18","10","8","3","1","2","41","18","23","0","0","0","0","0","0","7","6","1","-2"
"135726","University of Miami","2010","Total full-time Instruction/research/public service, Non-tenured not on tenure track, Lecturers","248","121","127","0","0","0","8","2","6","11","4","7","48","23","25","0","0","0","173","88","85","5","3","2","0","0","0","3","1","2","-2"
"135726","University of Miami","2010","Total full-time Instruction/research/public service, Non-tenured not on tenure track total","1338","759","579","0","0","0","139","77","62","57","23","34","339","176","163","4","1","3","704","416","288","12","5","7","1","1","0","82","60","22","-2"
"137351","University of South Florida-Main Campus","2010","Total full-time Instruction/research/public service, Tenured, Professors","376","289","87","3","1","2","41","41","0","11","8","3","15","10","5","0","0","0","304","227","77","0","0","0","1","1","0","1","1","0","-2"
"137351","University of South Florida-Main Campus","2010","Total full-time Instruction/research/public service, Tenured, Associate professors","307","171","136","1","0","1","25","18","7","22","6","16","17","9","8","0","0","0","240","136","104","1","1","0","1","1","0","0","0","0","-2"
"137351","University of South Florida-Main Campus","2010","Total full-time Instruction/research/public service, Tenured, Assistant professors","7","4","3","0","0","0","0","0","0","0","0","0","1","1","0","0","0","0","5","2","3","0","0","0","0","0","0","1","1","0","-2"
"137351","University of South Florida-Main Campus","2010","Total full-time Instruction/research/public service, Tenured, Instructors","1","1","0","0","0","0","0","0","0","0","0","0","0","0","0","0","0","0","1","1","0","0","0","0","0","0","0","0","0","0","-2"
"137351","University of South Florida-Main Campus","2010","Total full-time Instruction/research/public service, Tenured total","691","465","226","4","1","3","66","59","7","33","14","19","33","20","13","0","0","0","550","366","184","1","1","0","2","2","0","2","2","0","-2"
"137351","University of South Florida-Main Campus","2010","Total full-time Instruction/research/public service, Non-tenured on tenure track, Professors","19","17","2","0","0","0","1","1","0","1","1","0","1","1","0","0","0","0","13","12","1","0","0","0","2","2","0","1","0","1","-2"
"137351","University of South Florida-Main Campus","2010","Total full-time Instruction/research/public service, Non-tenured on tenure track, Associate professors","27","19","8","0","0","0","3","2","1","1","0","1","1","1","0","0","0","0","22","16","6","0","0","0","0","0","0","0","0","0","-2"
"137351","University of South Florida-Main Campus","2010","Total full-time Instruction/research/public service, Non-tenured on tenure track, Assistant professors","261","140","121","0","0","0","38","22","16","18","7","11","15","6","9","0","0","0","147","77","70","1","0","1","2","1","1","40","27","13","-2"
"137351","University of South Florida-Main Campus","2010","Total full-time Instruction/research/public service, Non-tenured on tenure track, Instructors","2","2","0","0","0","0","1","1","0","0","0","0","0","0","0","0","0","0","1","1","0","0","0","0","0","0","0","0","0","0","-2"
"137351","University of South Florida-Main Campus","2010","Total full-time Instruction/research/public service, Non-tenured on tenure track total","309","178","131","0","0","0","43","26","17","20","8","12","17","8","9","0","0","0","183","106","77","1","0","1","4","3","1","41","27","14","-2"
"137351","University of South Florida-Main Campus","2010","Total full-time Instruction/research/public service, Non-tenured not on tenure track, Professors","18","12","6","0","0","0","1","1","0","0","0","0","2","2","0","0","0","0","14","8","6","0","0","0","0","0","0","1","1","0","-2"
"137351","University of South Florida-Main Campus","2010","Total full-time Instruction/research/public service, Non-tenured not on tenure track, Associate professors","54","30","24","0","0","0","0","0","0","3","2","1","5","4","1","0","0","0","43","22","21","0","0","0","0","0","0","3","2","1","-2"
"137351","University of South Florida-Main Campus","2010","Total full-time Instruction/research/public servicey, Non-tenured not on tenure track, Assistant professors","194","98","96","2","1","1","27","13","14","11","5","6","26","18","8","1","1","0","111","52","59","1","0","1","0","0","0","15","8","7","-2"
"137351","University of South Florida-Main Campus","2010","Total full-time Instruction/research/public service, Non-tenured not on tenure track, Instructors","194","74","120","1","1","0","5","3","2","10","4","6","13","4","9","0","0","0","150","57","93","1","0","1","3","0","3","11","5","6","-2"
"137351","University of South Florida-Main Campus","2010","Total full-time Instruction/research/public service, Non-tenured not on tenure track, Lecturers","6","4","2","0","0","0","0","0","0","1","1","0","0","0","0","0","0","0","5","3","2","0","0","0","0","0","0","0","0","0","-2"
"137351","University of South Florida-Main Campus","2010","Total full-time Instruction/research/public service, Non-tenured not on tenure track total","466","218","248","3","2","1","33","17","16","25","12","13","46","28","18","1","1","0","323","142","181","2","0","2","3","0","3","30","16","14","-2"
"139755","Georgia Institute of Technology-Main Campus","2010","Total full-time Instruction/research/public service, Tenured, Professors","406","359","47","0","0","0","81","73","8","5","4","1","10","8","2","0","0","0","307","271","36","0","0","0","0","0","0","3","3","0","-2"
"139755","Georgia Institute of Technology-Main Campus","2010","Total full-time Instruction/research/public service, Tenured, Associate professors","219","168","51","0","0","0","42","31","11","8","4","4","5","4","1","0","0","0","161","128","33","0","0","0","0","0","0","3","1","2","-2"
"139755","Georgia Institute of Technology-Main Campus","2010","Total full-time Instruction/research/public service, Tenured total","625","527","98","0","0","0","123","104","19","13","8","5","15","12","3","0","0","0","468","399","69","0","0","0","0","0","0","6","4","2","-2"
"139755","Georgia Institute of Technology-Main Campus","2010","Total full-time Instruction/research/public service, Non-tenured on tenure track, Professors","5","3","2","0","0","0","0","0","0","0","0","0","0","0","0","0","0","0","5","3","2","0","0","0","0","0","0","0","0","0","-2"
"139755","Georgia Institute of Technology-Main Campus","2010","Total full-time Instruction/research/public service, Non-tenured on tenure track, Associate professors","21","18","3","0","0","0","6","6","0","2","2","0","1","1","0","0","0","0","10","7","3","0","0","0","0","0","0","2","2","0","-2"
"139755","Georgia Institute of Technology-Main Campus","2010","Total full-time Instruction/research/public service, Non-tenured on tenure track, Assistant professors","221","160","61","0","0","0","49","37","12","13","10","3","10","6","4","0","0","0","132","95","37","0","0","0","0","0","0","17","12","5","-2"
"139755","Georgia Institute of Technology-Main Campus","2010","Total full-time Instruction/research/public service, Non-tenured on tenure track total","247","181","66","0","0","0","55","43","12","15","12","3","11","7","4","0","0","0","147","105","42","0","0","0","0","0","0","19","14","5","-2"
"139755","Georgia Institute of Technology-Main Campus","2010","Total full-time Instruction/research/public service, Non-tenured not on tenure track, Associate professors","1","1","0","0","0","0","1","1","0","0","0","0","0","0","0","0","0","0","0","0","0","0","0","0","0","0","0","0","0","0","-2"
"139755","Georgia Institute of Technology-Main Campus","2010","Total full-time Instruction/research/public servicey, Non-tenured not on tenure track, Assistant professors","2","2","0","0","0","0","0","0","0","0","0","0","0","0","0","0","0","0","2","2","0","0","0","0","0","0","0","0","0","0","-2"
"139755","Georgia Institute of Technology-Main Campus","2010","Total full-time Instruction/research/public service, Non-tenured not on tenure track, Instructors","42","16","26","0","0","0","4","3","1","1","0","1","0","0","0","0","0","0","34","12","22","0","0","0","3","1","2","0","0","0","-2"
"139755","Georgia Institute of Technology-Main Campus","2010","Total full-time Instruction/research/public service, Non-tenured not on tenure track, Lecturers","30","14","16","0","0","0","3","1","2","1","0","1","0","0","0","0","0","0","26","13","13","0","0","0","0","0","0","0","0","0","-2"
"139755","Georgia Institute of Technology-Main Campus","2010","Total full-time Instruction/research/public service, Non-tenured not on tenure track total","75","33","42","0","0","0","8","5","3","2","0","2","0","0","0","0","0","0","62","27","35","0","0","0","3","1","2","0","0","0","-2"
"139959","University of Georgia","2010","Total full-time Instruction/research/public service, Tenured, Professors","679","528","151","3","2","1","34","28","6","34","21","13","18","10","8","0","0","0","587","464","123","2","2","0","1","1","0","0","0","0","-2"
"139959","University of Georgia","2010","Total full-time Instruction/research/public service, Tenured, Associate professors","461","277","184","0","0","0","41","24","17","34","15","19","17","12","5","0","0","0","365","223","142","1","0","1","2","2","0","1","1","0","-2"
"139959","University of Georgia","2010","Total full-time Instruction/research/public service, Tenured, Assistant professors","1","1","0","0","0","0","0","0","0","0","0","0","0","0","0","0","0","0","1","1","0","0","0","0","0","0","0","0","0","0","-2"
"139959","University of Georgia","2010","Total full-time Instruction/research/public service, Tenured total","1141","806","335","3","2","1","75","52","23","68","36","32","35","22","13","0","0","0","953","688","265","3","2","1","3","3","0","1","1","0","-2"
"139959","University of Georgia","2010","Total full-time Instruction/research/public service, Non-tenured on tenure track, Professors","2","2","0","0","0","0","0","0","0","0","0","0","0","0","0","0","0","0","2","2","0","0","0","0","0","0","0","0","0","0","-2"
"139959","University of Georgia","2010","Total full-time Instruction/research/public service, Non-tenured on tenure track, Associate professors","17","15","2","0","0","0","1","1","0","0","0","0","1","1","0","0","0","0","14","12","2","1","1","0","0","0","0","0","0","0","-2"
"139959","University of Georgia","2010","Total full-time Instruction/research/public service, Non-tenured on tenure track, Assistant professors","381","222","159","0","0","0","62","42","20","21","11","10","19","8","11","0","0","0","273","158","115","1","0","1","4","2","2","1","1","0","-2"
"139959","University of Georgia","2010","Total full-time Instruction/research/public service, Non-tenured on tenure track, Instructors","1","1","0","0","0","0","0","0","0","0","0","0","0","0","0","0","0","0","1","1","0","0","0","0","0","0","0","0","0","0","-2"
"139959","University of Georgia","2010","Total full-time Instruction/research/public service, Non-tenured on tenure track total","401","240","161","0","0","0","63","43","20","21","11","10","20","9","11","0","0","0","290","173","117","2","1","1","4","2","2","1","1","0","-2"
"139959","University of Georgia","2010","Total full-time Instruction/research/public service, Non-tenured not on tenure track, Professors","5","4","1","0","0","0","0","0","0","0","0","0","0","0","0","0","0","0","5","4","1","0","0","0","0","0","0","0","0","0","-2"
"139959","University of Georgia","2010","Total full-time Instruction/research/public service, Non-tenured not on tenure track, Associate professors","11","8","3","0","0","0","0","0","0","0","0","0","0","0","0","0","0","0","11","8","3","0","0","0","0","0","0","0","0","0","-2"
"139959","University of Georgia","2010","Total full-time Instruction/research/public servicey, Non-tenured not on tenure track, Assistant professors","36","14","22","0","0","0","4","0","4","4","1","3","0","0","0","0","0","0","27","12","15","0","0","0","1","1","0","0","0","0","-2"
"139959","University of Georgia","2010","Total full-time Instruction/research/public service, Non-tenured not on tenure track, Instructors","50","19","31","1","0","1","0","0","0","0","0","0","5","2","3","0","0","0","43","17","26","1","0","1","0","0","0","0","0","0","-2"
"139959","University of Georgia","2010","Total full-time Instruction/research/public service, Non-tenured not on tenure track, Lecturers","107","48","59","0","0","0","6","1","5","6","3","3","4","1","3","0","0","0","87","40","47","1","0","1","1","1","0","2","2","0","-2"
"139959","University of Georgia","2010","Total full-time Instruction/research/public service, Non-tenured not on tenure track, No academic rank","553","284","269","0","0","0","46","35","11","36","16","20","13","6","7","0","0","0","453","226","227","1","0","1","4","1","3","0","0","0","-2"
"139959","University of Georgia","2010","Total full-time Instruction/research/public service, Non-tenured not on tenure track total","762","377","385","1","0","1","56","36","20","46","20","26","22","9","13","0","0","0","626","307","319","3","0","3","6","3","3","2","2","0","-2"
"140960","Savannah State University","2010","Total full-time Instruction/research/public service, Tenured, Professors","24","19","5","0","0","0","8","7","1","13","9","4","0","0","0","0","0","0","3","3","0","0","0","0","0","0","0","0","0","0","-2"
"140960","Savannah State University","2010","Total full-time Instruction/research/public service, Tenured, Associate professors","25","16","9","0","0","0","9","7","2","12","7","5","0","0","0","0","0","0","4","2","2","0","0","0","0","0","0","0","0","0","-2"
"140960","Savannah State University","2010","Total full-time Instruction/research/public service, Tenured, Assistant professors","8","3","5","0","0","0","1","0","1","4","1","3","0","0","0","0","0","0","3","2","1","0","0","0","0","0","0","0","0","0","-2"
"140960","Savannah State University","2010","Total full-time Instruction/research/public service, Tenured, Instructors","1","0","1","0","0","0","0","0","0","1","0","1","0","0","0","0","0","0","0","0","0","0","0","0","0","0","0","0","0","0","-2"
"140960","Savannah State University","2010","Total full-time Instruction/research/public service, Tenured total","58","38","20","0","0","0","18","14","4","30","17","13","0","0","0","0","0","0","10","7","3","0","0","0","0","0","0","0","0","0","-2"
"140960","Savannah State University","2010","Total full-time Instruction/research/public service, Non-tenured on tenure track, Professors","2","2","0","0","0","0","0","0","0","1","1","0","0","0","0","0","0","0","1","1","0","0","0","0","0","0","0","0","0","0","-2"
"140960","Savannah State University","2010","Total full-time Instruction/research/public service, Non-tenured on tenure track, Associate professors","10","8","2","0","0","0","3","3","0","5","4","1","0","0","0","0","0","0","2","1","1","0","0","0","0","0","0","0","0","0","-2"
"140960","Savannah State University","2010","Total full-time Instruction/research/public service, Non-tenured on tenure track, Assistant professors","38","15","23","0","0","0","8","3","5","13","7","6","1","0","1","0","0","0","11","4","7","2","0","2","3","1","2","0","0","0","-2"
"140960","Savannah State University","2010","Total full-time Instruction/research/public service, Non-tenured on tenure track total","50","25","25","0","0","0","11","6","5","19","12","7","1","0","1","0","0","0","14","6","8","2","0","2","3","1","2","0","0","0","-2"
"140960","Savannah State University","2010","Total full-time Instruction/research/public service, Non-tenured not on tenure track, Professors","2","1","1","0","0","0","0","0","0","2","1","1","0","0","0","0","0","0","0","0","0","0","0","0","0","0","0","0","0","0","-2"
"140960","Savannah State University","2010","Total full-time Instruction/research/public service, Non-tenured not on tenure track, Associate professors","2","2","0","0","0","0","1","1","0","0","0","0","0","0","0","0","0","0","1","1","0","0","0","0","0","0","0","0","0","0","-2"
"140960","Savannah State University","2010","Total full-time Instruction/research/public servicey, Non-tenured not on tenure track, Assistant professors","7","4","3","0","0","0","2","2","0","1","0","1","0","0","0","0","0","0","4","2","2","0","0","0","0","0","0","0","0","0","-2"
"140960","Savannah State University","2010","Total full-time Instruction/research/public service, Non-tenured not on tenure track, Instructors","23","8","15","0","0","0","1","0","1","15","4","11","0","0","0","0","0","0","7","4","3","0","0","0","0","0","0","0","0","0","-2"
"140960","Savannah State University","2010","Total full-time Instruction/research/public service, Non-tenured not on tenure track, Lecturers","15","8","7","0","0","0","0","0","0","8","4","4","0","0","0","0","0","0","6","3","3","0","0","0","1","1","0","0","0","0","-2"
"140960","Savannah State University","2010","Total full-time Instruction/research/public service, Non-tenured not on tenure track total","49","23","26","0","0","0","4","3","1","26","9","17","0","0","0","0","0","0","18","10","8","0","0","0","1","1","0","0","0","0","-2"
"141060","Spelman College","2010","Total full-time Instruction/research/public service, Tenured, Professors","28","10","18","0","0","0","4","1","3","15","5","10","0","0","0","0","0","0","9","4","5","0","0","0","0","0","0","0","0","0","-2"
"141060","Spelman College","2010","Total full-time Instruction/research/public service, Tenured, Associate professors","63","26","37","0","0","0","4","3","1","40","13","27","4","3","1","0","0","0","13","7","6","2","0","2","0","0","0","0","0","0","-2"
"141060","Spelman College","2010","Total full-time Instruction/research/public service, Tenured total","91","36","55","0","0","0","8","4","4","55","18","37","4","3","1","0","0","0","22","11","11","2","0","2","0","0","0","0","0","0","-2"
"141060","Spelman College","2010","Total full-time Instruction/research/public service, Non-tenured on tenure track, Associate professors","1","0","1","0","0","0","0","0","0","0","0","0","1","0","1","0","0","0","0","0","0","0","0","0","0","0","0","0","0","0","-2"
"141060","Spelman College","2010","Total full-time Instruction/research/public service, Non-tenured on tenure track, Assistant professors","30","9","21","1","1","0","4","2","2","17","5","12","1","0","1","0","0","0","6","1","5","1","0","1","0","0","0","0","0","0","-2"
"141060","Spelman College","2010","Total full-time Instruction/research/public service, Non-tenured on tenure track total","31","9","22","1","1","0","4","2","2","17","5","12","2","0","2","0","0","0","6","1","5","1","0","1","0","0","0","0","0","0","-2"
"141060","Spelman College","2010","Total full-time Instruction/research/public service, Non-tenured not on tenure track, Instructors","25","6","19","0","0","0","0","0","0","21","5","16","1","0","1","0","0","0","3","1","2","0","0","0","0","0","0","0","0","0","-2"
"141060","Spelman College","2010","Total full-time Instruction/research/public service, Non-tenured not on tenure track, Lecturers","36","10","26","0","0","0","3","1","2","27","8","19","1","0","1","0","0","0","4","0","4","0","0","0","1","1","0","0","0","0","-2"
"141060","Spelman College","2010","Total full-time Instruction/research/public service, Non-tenured not on tenure track total","61","16","45","0","0","0","3","1","2","48","13","35","2","0","2","0","0","0","7","1","6","0","0","0","1","1","0","0","0","0","-2"
"142115","Boise State University","2010","Total full-time Instruction/research/public service, Tenured, Professors","156","111","45","1","1","0","4","3","1","0","0","0","2","2","0","0","0","0","145","102","43","2","2","0","0","0","0","2","1","1","-2"
"142115","Boise State University","2010","Total full-time Instruction/research/public service, Tenured, Associate professors","163","85","78","1","0","1","6","5","1","2","2","0","1","0","1","0","0","0","148","74","74","2","1","1","0","0","0","3","3","0","-2"
"142115","Boise State University","2010","Total full-time Instruction/research/public service, Tenured, Assistant professors","13","5","8","0","0","0","0","0","0","0","0","0","0","0","0","0","0","0","12","4","8","0","0","0","0","0","0","1","1","0","-2"
"142115","Boise State University","2010","Total full-time Instruction/research/public service, Tenured total","332","201","131","2","1","1","10","8","2","2","2","0","3","2","1","0","0","0","305","180","125","4","3","1","0","0","0","6","5","1","-2"
"142115","Boise State University","2010","Total full-time Instruction/research/public service, Non-tenured on tenure track, Professors","1","1","0","0","0","0","0","0","0","0","0","0","0","0","0","0","0","0","1","1","0","0","0","0","0","0","0","0","0","0","-2"
"142115","Boise State University","2010","Total full-time Instruction/research/public service, Non-tenured on tenure track, Associate professors","7","3","4","1","0","1","0","0","0","0","0","0","0","0","0","0","0","0","6","3","3","0","0","0","0","0","0","0","0","0","-2"
"142115","Boise State University","2010","Total full-time Instruction/research/public service, Non-tenured on tenure track, Assistant professors","125","67","58","2","1","1","6","6","0","1","0","1","8","2","6","0","0","0","91","46","45","0","0","0","0","0","0","17","12","5","-2"
"142115","Boise State University","2010","Total full-time Instruction/research/public service, Non-tenured on tenure track, Instructors","1","0","1","0","0","0","0","0","0","0","0","0","0","0","0","0","0","0","1","0","1","0","0","0","0","0","0","0","0","0","-2"
"142115","Boise State University","2010","Total full-time Instruction/research/public service, Non-tenured on tenure track total","134","71","63","3","1","2","6","6","0","1","0","1","8","2","6","0","0","0","99","50","49","0","0","0","0","0","0","17","12","5","-2"
"142115","Boise State University","2010","Total full-time Instruction/research/public service, Non-tenured not on tenure track, Professors","2","1","1","0","0","0","0","0","0","0","0","0","0","0","0","0","0","0","2","1","1","0","0","0","0","0","0","0","0","0","-2"
"142115","Boise State University","2010","Total full-time Instruction/research/public service, Non-tenured not on tenure track, Associate professors","3","2","1","0","0","0","1","1","0","0","0","0","0","0","0","0","0","0","2","1","1","0","0","0","0","0","0","0","0","0","-2"
"142115","Boise State University","2010","Total full-time Instruction/research/public servicey, Non-tenured not on tenure track, Assistant professors","7","6","1","1","1","0","0","0","0","0","0","0","0","0","0","0","0","0","5","4","1","0","0","0","0","0","0","1","1","0","-2"
"142115","Boise State University","2010","Total full-time Instruction/research/public service, Non-tenured not on tenure track, Instructors","5","1","4","0","0","0","0","0","0","0","0","0","0","0","0","0","0","0","4","1","3","0","0","0","0","0","0","1","0","1","-2"
"142115","Boise State University","2010","Total full-time Instruction/research/public service, Non-tenured not on tenure track, Lecturers","89","38","51","2","1","1","2","2","0","0","0","0","1","1","0","0","0","0","81","33","48","1","0","1","0","0","0","2","1","1","-2"
"142115","Boise State University","2010","Total full-time Instruction/research/public service, Non-tenured not on tenure track, No academic rank","22","16","6","0","0","0","0","0","0","0","0","0","2","1","1","0","0","0","13","10","3","0","0","0","0","0","0","7","5","2","-2"
"142115","Boise State University","2010","Total full-time Instruction/research/public service, Non-tenured not on tenure track total","128","64","64","3","2","1","3","3","0","0","0","0","3","2","1","0","0","0","107","50","57","1","0","1","0","0","0","11","7","4","-2"
"144050","University of Chicago","2010","Total full-time Instruction/research/public service, Tenured, Professors","588","479","109","0","0","0","53","49","4","11","8","3","20","17","3","0","0","0","499","400","99","4","4","0","0","0","0","1","1","0","-2"
"144050","University of Chicago","2010","Total full-time Instruction/research/public service, Tenured, Associate professors","158","104","54","0","0","0","23","16","7","10","8","2","5","4","1","0","0","0","118","75","43","2","1","1","0","0","0","0","0","0","-2"
"144050","University of Chicago","2010","Total full-time Instruction/research/public service, Tenured total","746","583","163","0","0","0","76","65","11","21","16","5","25","21","4","0","0","0","617","475","142","6","5","1","0","0","0","1","1","0","-2"
"144050","University of Chicago","2010","Total full-time Instruction/research/public service, Non-tenured on tenure track, Professors","2","2","0","0","0","0","0","0","0","0","0","0","0","0","0","0","0","0","0","0","0","0","0","0","0","0","0","2","2","0","-2"
"144050","University of Chicago","2010","Total full-time Instruction/research/public service, Non-tenured on tenure track, Associate professors","21","15","6","0","0","0","7","6","1","0","0","0","2","1","1","0","0","0","10","7","3","0","0","0","0","0","0","2","1","1","-2"
"144050","University of Chicago","2010","Total full-time Instruction/research/public service, Non-tenured on tenure track, Assistant professors","308","198","110","0","0","0","43","24","19","11","8","3","11","7","4","0","0","0","197","124","73","4","3","1","0","0","0","42","32","10","-2"
"144050","University of Chicago","2010","Total full-time Instruction/research/public service, Non-tenured on tenure track, Instructors","28","17","11","0","0","0","4","2","2","2","0","2","0","0","0","0","0","0","20","14","6","0","0","0","0","0","0","2","1","1","-2"
"144050","University of Chicago","2010","Total full-time Instruction/research/public service, Non-tenured on tenure track total","359","232","127","0","0","0","54","32","22","13","8","5","13","8","5","0","0","0","227","145","82","4","3","1","0","0","0","48","36","12","-2"
"144050","University of Chicago","2010","Total full-time Instruction/research/public service, Non-tenured not on tenure track, Professors","168","139","29","0","0","0","17","13","4","4","3","1","0","0","0","0","0","0","142","118","24","0","0","0","0","0","0","5","5","0","-2"
"144050","University of Chicago","2010","Total full-time Instruction/research/public service, Non-tenured not on tenure track, Associate professors","252","170","82","0","0","0","38","26","12","5","3","2","5","1","4","0","0","0","197","135","62","4","3","1","0","0","0","3","2","1","-2"
"144050","University of Chicago","2010","Total full-time Instruction/research/public servicey, Non-tenured not on tenure track, Assistant professors","377","205","172","0","0","0","122","69","53","15","4","11","5","2","3","0","0","0","188","100","88","3","2","1","0","0","0","44","28","16","-2"
"144050","University of Chicago","2010","Total full-time Instruction/research/public service, Non-tenured not on tenure track, Instructors","87","49","38","0","0","0","11","5","6","1","0","1","0","0","0","0","0","0","46","24","22","1","1","0","0","0","0","28","19","9","-2"
"144050","University of Chicago","2010","Total full-time Instruction/research/public service, Non-tenured not on tenure track, Lecturers","135","67","68","0","0","0","14","6","8","4","3","1","5","3","2","0","0","0","95","46","49","0","0","0","0","0","0","17","9","8","-2"
"144050","University of Chicago","2010","Total full-time Instruction/research/public service, Non-tenured not on tenure track, No academic rank","49","21","28","0","0","0","14","3","11","6","0","6","0","0","0","0","0","0","29","18","11","0","0","0","0","0","0","0","0","0","-2"
"144050","University of Chicago","2010","Total full-time Instruction/research/public service, Non-tenured not on tenure track total","1068","651","417","0","0","0","216","122","94","35","13","22","15","6","9","0","0","0","697","441","256","8","6","2","0","0","0","97","63","34","-2"
"144865","College of DuPage","2010","Total full-time Instruction/research/public service, Tenured, Professors","164","72","92","2","2","0","13","7","6","6","2","4","1","0","1","0","0","0","140","61","79","2","0","2","0","0","0","0","0","0","-2"
"144865","College of DuPage","2010","Total full-time Instruction/research/public service, Tenured, Associate professors","51","25","26","0","0","0","4","0","4","1","1","0","1","1","0","0","0","0","45","23","22","0","0","0","0","0","0","0","0","0","-2"
"144865","College of DuPage","2010","Total full-time Instruction/research/public service, Tenured, Assistant professors","31","16","15","0","0","0","0","0","0","1","0","1","3","2","1","0","0","0","26","13","13","1","1","0","0","0","0","0","0","0","-2"
"144865","College of DuPage","2010","Total full-time Instruction/research/public service, Tenured total","246","113","133","2","2","0","17","7","10","8","3","5","5","3","2","0","0","0","211","97","114","3","1","2","0","0","0","0","0","0","-2"
"144865","College of DuPage","2010","Total full-time Instruction/research/public service, Non-tenured on tenure track, Professors","3","2","1","0","0","0","0","0","0","1","1","0","0","0","0","0","0","0","2","1","1","0","0","0","0","0","0","0","0","0","-2"
"144865","College of DuPage","2010","Total full-time Instruction/research/public service, Non-tenured on tenure track, Associate professors","3","3","0","0","0","0","1","1","0","0","0","0","1","1","0","0","0","0","1","1","0","0","0","0","0","0","0","0","0","0","-2"
"144865","College of DuPage","2010","Total full-time Instruction/research/public service, Non-tenured on tenure track, Assistant professors","7","4","3","0","0","0","1","0","1","0","0","0","0","0","0","0","0","0","6","4","2","0","0","0","0","0","0","0","0","0","-2"
"144865","College of DuPage","2010","Total full-time Instruction/research/public service, Non-tenured on tenure track, Instructors","6","2","4","0","0","0","0","0","0","0","0","0","0","0","0","0","0","0","4","1","3","1","1","0","1","0","1","0","0","0","-2"
"144865","College of DuPage","2010","Total full-time Instruction/research/public service, Non-tenured on tenure track total","19","11","8","0","0","0","2","1","1","1","1","0","1","1","0","0","0","0","13","7","6","1","1","0","1","0","1","0","0","0","-2"
"144865","College of DuPage","2010","Total full-time Instruction/research/public service, Non-tenured not on tenure track, Associate professors","1","1","0","0","0","0","0","0","0","0","0","0","0","0","0","0","0","0","1","1","0","0","0","0","0","0","0","0","0","0","-2"
"144865","College of DuPage","2010","Total full-time Instruction/research/public servicey, Non-tenured not on tenure track, Assistant professors","2","1","1","0","0","0","0","0","0","0","0","0","0","0","0","0","0","0","2","1","1","0","0","0","0","0","0","0","0","0","-2"
"144865","College of DuPage","2010","Total full-time Instruction/research/public service, Non-tenured not on tenure track, Instructors","2","1","1","0","0","0","0","0","0","0","0","0","0","0","0","0","0","0","1","1","0","0","0","0","1","0","1","0","0","0","-2"
"144865","College of DuPage","2010","Total full-time Instruction/research/public service, Non-tenured not on tenure track total","5","3","2","0","0","0","0","0","0","0","0","0","0","0","0","0","0","0","4","3","1","0","0","0","1","0","1","0","0","0","-2"
"145637","University of Illinois at Urbana-Champaign","2010","Total full-time Instruction/research/public service, Tenured, Professors","800","638","162","1","1","0","87","76","11","21","15","6","27","19","8","0","0","0","651","517","134","5","3","2","4","4","0","4","3","1","-2"
"145637","University of Illinois at Urbana-Champaign","2010","Total full-time Instruction/research/public service, Tenured, Associate professors","493","318","175","2","1","1","60","38","22","27","14","13","27","16","11","0","0","0","370","245","125","4","2","2","1","1","0","2","1","1","-2"
"145637","University of Illinois at Urbana-Champaign","2010","Total full-time Instruction/research/public service, Tenured, Assistant professors","5","3","2","0","0","0","0","0","0","0","0","0","0","0","0","0","0","0","5","3","2","0","0","0","0","0","0","0","0","0","-2"
"145637","University of Illinois at Urbana-Champaign","2010","Total full-time Instruction/research/public service, Tenured, No academic rank","1","1","0","0","0","0","0","0","0","0","0","0","0","0","0","0","0","0","1","1","0","0","0","0","0","0","0","0","0","0","-2"
"145637","University of Illinois at Urbana-Champaign","2010","Total full-time Instruction/research/public service, Tenured total","1299","960","339","3","2","1","147","114","33","48","29","19","54","35","19","0","0","0","1027","766","261","9","5","4","5","5","0","6","4","2","-2"
"145637","University of Illinois at Urbana-Champaign","2010","Total full-time Instruction/research/public service, Non-tenured on tenure track, Professors","1","1","0","0","0","0","0","0","0","0","0","0","0","0","0","0","0","0","1","1","0","0","0","0","0","0","0","0","0","0","-2"
"145637","University of Illinois at Urbana-Champaign","2010","Total full-time Instruction/research/public service, Non-tenured on tenure track, Associate professors","10","6","4","0","0","0","3","2","1","0","0","0","2","1","1","0","0","0","4","3","1","0","0","0","1","0","1","0","0","0","-2"
"145637","University of Illinois at Urbana-Champaign","2010","Total full-time Instruction/research/public service, Non-tenured on tenure track, Assistant professors","427","260","167","3","2","1","83","56","27","31","16","15","25","16","9","0","0","0","226","132","94","0","0","0","3","2","1","56","36","20","-2"
"145637","University of Illinois at Urbana-Champaign","2010","Total full-time Instruction/research/public service, Non-tenured on tenure track, Lecturers","1","1","0","0","0","0","0","0","0","0","0","0","0","0","0","0","0","0","0","0","0","0","0","0","1","1","0","0","0","0","-2"
"145637","University of Illinois at Urbana-Champaign","2010","Total full-time Instruction/research/public service, Non-tenured on tenure track total","439","268","171","3","2","1","86","58","28","31","16","15","27","17","10","0","0","0","231","136","95","0","0","0","5","3","2","56","36","20","-2"
"145637","University of Illinois at Urbana-Champaign","2010","Total full-time Instruction/research/public service, Non-tenured not on tenure track, Professors","20","15","5","0","0","0","3","3","0","0","0","0","0","0","0","0","0","0","17","12","5","0","0","0","0","0","0","0","0","0","-2"
"145637","University of Illinois at Urbana-Champaign","2010","Total full-time Instruction/research/public service, Non-tenured not on tenure track, Associate professors","25","14","11","0","0","0","1","0","1","1","1","0","1","0","1","0","0","0","22","13","9","0","0","0","0","0","0","0","0","0","-2"
"145637","University of Illinois at Urbana-Champaign","2010","Total full-time Instruction/research/public servicey, Non-tenured not on tenure track, Assistant professors","123","58","65","1","0","1","19","10","9","3","0","3","6","3","3","0","0","0","78","33","45","1","1","0","1","1","0","14","10","4","-2"
"145637","University of Illinois at Urbana-Champaign","2010","Total full-time Instruction/research/public service, Non-tenured not on tenure track, Instructors","53","31","22","0","0","0","1","1","0","3","1","2","0","0","0","0","0","0","40","24","16","0","0","0","5","3","2","4","2","2","-2"
"145637","University of Illinois at Urbana-Champaign","2010","Total full-time Instruction/research/public service, Non-tenured not on tenure track, Lecturers","158","79","79","0","0","0","8","3","5","5","3","2","3","3","0","0","0","0","127","62","65","1","1","0","6","2","4","8","5","3","-2"
"145637","University of Illinois at Urbana-Champaign","2010","Total full-time Instruction/research/public service, Non-tenured not on tenure track, No academic rank","88","42","46","0","0","0","7","3","4","2","2","0","0","0","0","0","0","0","67","29","38","1","1","0","0","0","0","11","7","4","-2"
"145637","University of Illinois at Urbana-Champaign","2010","Total full-time Instruction/research/public service, Non-tenured not on tenure track total","467","239","228","1","0","1","39","20","19","14","7","7","10","6","4","0","0","0","351","173","178","3","3","0","12","6","6","37","24","13","-2"
"147767","Northwestern University","2010","Total full-time Instruction/research/public service, Tenured, Professors","666","524","142","0","0","0","67","61","6","15","7","8","13","10","3","0","0","0","566","442","124","0","0","0","1","1","0","4","3","1","-2"
"147767","Northwestern University","2010","Total full-time Instruction/research/public service, Tenured, Associate professors","273","186","87","0","0","0","36","25","11","17","10","7","12","9","3","0","0","0","203","140","63","2","0","2","2","1","1","1","1","0","-2"
"147767","Northwestern University","2010","Total full-time Instruction/research/public service, Tenured, Assistant professors","1","1","0","0","0","0","0","0","0","0","0","0","0","0","0","0","0","0","1","1","0","0","0","0","0","0","0","0","0","0","-2"
"147767","Northwestern University","2010","Total full-time Instruction/research/public service, Tenured total","940","711","229","0","0","0","103","86","17","32","17","15","25","19","6","0","0","0","770","583","187","2","0","2","3","2","1","5","4","1","-2"
"147767","Northwestern University","2010","Total full-time Instruction/research/public service, Non-tenured on tenure track, Associate professors","29","21","8","0","0","0","10","8","2","1","0","1","0","0","0","0","0","0","16","12","4","0","0","0","1","0","1","1","1","0","-2"
"147767","Northwestern University","2010","Total full-time Instruction/research/public service, Non-tenured on tenure track, Assistant professors","288","189","99","0","0","0","46","30","16","12","8","4","15","8","7","0","0","0","171","111","60","1","0","1","2","0","2","41","32","9","-2"
"147767","Northwestern University","2010","Total full-time Instruction/research/public service, Non-tenured on tenure track total","317","210","107","0","0","0","56","38","18","13","8","5","15","8","7","0","0","0","187","123","64","1","0","1","3","0","3","42","33","9","-2"
"147767","Northwestern University","2010","Total full-time Instruction/research/public service, Non-tenured not on tenure track, Professors","130","101","29","1","0","1","13","8","5","1","1","0","1","1","0","0","0","0","113","91","22","0","0","0","0","0","0","1","0","1","-2"
"147767","Northwestern University","2010","Total full-time Instruction/research/public service, Non-tenured not on tenure track, Associate professors","184","111","73","0","0","0","31","20","11","5","2","3","7","3","4","0","0","0","137","83","54","0","0","0","2","1","1","2","2","0","-2"
"147767","Northwestern University","2010","Total full-time Instruction/research/public servicey, Non-tenured not on tenure track, Assistant professors","430","207","223","0","0","0","94","46","48","14","6","8","12","5","7","0","0","0","273","127","146","2","1","1","2","1","1","33","21","12","-2"
"147767","Northwestern University","2010","Total full-time Instruction/research/public service, Non-tenured not on tenure track, Instructors","39","20","19","0","0","0","8","4","4","2","1","1","1","1","0","0","0","0","25","12","13","0","0","0","0","0","0","3","2","1","-2"
"147767","Northwestern University","2010","Total full-time Instruction/research/public service, Non-tenured not on tenure track, Lecturers","283","116","167","0","0","0","24","7","17","6","3","3","9","4","5","0","0","0","228","99","129","0","0","0","4","2","2","12","1","11","-2"
"147767","Northwestern University","2010","Total full-time Instruction/research/public service, Non-tenured not on tenure track total","1066","555","511","1","0","1","170","85","85","28","13","15","30","14","16","0","0","0","776","412","364","2","1","1","8","4","4","51","26","25","-2"
"149772","Western Illinois University","2010","Total full-time Instruction/research/public service, Tenured, Professors","196","133","63","2","2","0","16","13","3","7","4","3","2","2","0","0","0","0","166","110","56","2","1","1","0","0","0","1","1","0","-2"
"149772","Western Illinois University","2010","Total full-time Instruction/research/public service, Tenured, Associate professors","156","95","61","1","0","1","13","5","8","10","6","4","3","0","3","0","0","0","126","82","44","2","2","0","0","0","0","1","0","1","-2"
"149772","Western Illinois University","2010","Total full-time Instruction/research/public service, Tenured, Assistant professors","5","3","2","0","0","0","0","0","0","0","0","0","0","0","0","0","0","0","4","2","2","0","0","0","0","0","0","1","1","0","-2"
"149772","Western Illinois University","2010","Total full-time Instruction/research/public service, Tenured total","357","231","126","3","2","1","29","18","11","17","10","7","5","2","3","0","0","0","296","194","102","4","3","1","0","0","0","3","2","1","-2"
"149772","Western Illinois University","2010","Total full-time Instruction/research/public service, Non-tenured on tenure track, Associate professors","28","16","12","1","0","1","4","4","0","1","1","0","0","0","0","0","0","0","18","9","9","0","0","0","1","1","0","3","1","2","-2"
"149772","Western Illinois University","2010","Total full-time Instruction/research/public service, Non-tenured on tenure track, Assistant professors","139","76","63","0","0","0","14","8","6","7","6","1","1","1","0","0","0","0","89","45","44","0","0","0","3","3","0","25","13","12","-2"
"149772","Western Illinois University","2010","Total full-time Instruction/research/public service, Non-tenured on tenure track total","167","92","75","1","0","1","18","12","6","8","7","1","1","1","0","0","0","0","107","54","53","0","0","0","4","4","0","28","14","14","-2"
"149772","Western Illinois University","2010","Total full-time Instruction/research/public servicey, Non-tenured not on tenure track, Assistant professors","23","8","15","0","0","0","2","0","2","0","0","0","0","0","0","0","0","0","20","7","13","0","0","0","0","0","0","1","1","0","-2"
"149772","Western Illinois University","2010","Total full-time Instruction/research/public service, Non-tenured not on tenure track, Instructors","105","36","69","0","0","0","4","1","3","3","1","2","0","0","0","0","0","0","96","34","62","0","0","0","1","0","1","1","0","1","-2"
"149772","Western Illinois University","2010","Total full-time Instruction/research/public service, Non-tenured not on tenure track, Lecturers","8","2","6","0","0","0","0","0","0","0","0","0","0","0","0","0","0","0","7","2","5","0","0","0","0","0","0","1","0","1","-2"
"149772","Western Illinois University","2010","Total full-time Instruction/research/public service, Non-tenured not on tenure track total","136","46","90","0","0","0","6","1","5","3","1","2","0","0","0","0","0","0","123","43","80","0","0","0","1","0","1","3","1","2","-2"
"150136","Ball State University","2010","Total full-time Instruction/research/public service, Tenured, Professors","226","175","51","0","0","0","21","16","5","4","3","1","3","3","0","0","0","0","196","151","45","2","2","0","0","0","0","0","0","0","-2"
"150136","Ball State University","2010","Total full-time Instruction/research/public service, Tenured, Associate professors","200","107","93","0","0","0","12","6","6","8","3","5","3","2","1","0","0","0","174","94","80","3","2","1","0","0","0","0","0","0","-2"
"150136","Ball State University","2010","Total full-time Instruction/research/public service, Tenured, Assistant professors","39","21","18","0","0","0","1","1","0","1","1","0","0","0","0","0","0","0","37","19","18","0","0","0","0","0","0","0","0","0","-2"
"150136","Ball State University","2010","Total full-time Instruction/research/public service, Tenured total","465","303","162","0","0","0","34","23","11","13","7","6","6","5","1","0","0","0","407","264","143","5","4","1","0","0","0","0","0","0","-2"
"150136","Ball State University","2010","Total full-time Instruction/research/public service, Non-tenured on tenure track, Professors","1","1","0","0","0","0","0","0","0","0","0","0","0","0","0","0","0","0","1","1","0","0","0","0","0","0","0","0","0","0","-2"
"150136","Ball State University","2010","Total full-time Instruction/research/public service, Non-tenured on tenure track, Associate professors","32","20","12","0","0","0","6","4","2","0","0","0","1","1","0","0","0","0","25","15","10","0","0","0","0","0","0","0","0","0","-2"
"150136","Ball State University","2010","Total full-time Instruction/research/public service, Non-tenured on tenure track, Assistant professors","166","89","77","0","0","0","26","14","12","4","0","4","4","3","1","0","0","0","130","71","59","2","1","1","0","0","0","0","0","0","-2"
"150136","Ball State University","2010","Total full-time Instruction/research/public service, Non-tenured on tenure track total","199","110","89","0","0","0","32","18","14","4","0","4","5","4","1","0","0","0","156","87","69","2","1","1","0","0","0","0","0","0","-2"
"150136","Ball State University","2010","Total full-time Instruction/research/public service, Non-tenured not on tenure track, Associate professors","4","3","1","0","0","0","0","0","0","0","0","0","1","0","1","0","0","0","3","3","0","0","0","0","0","0","0","0","0","0","-2"
"150136","Ball State University","2010","Total full-time Instruction/research/public servicey, Non-tenured not on tenure track, Assistant professors","114","57","57","0","0","0","6","3","3","5","2","3","7","5","2","0","0","0","92","45","47","2","0","2","2","2","0","0","0","0","-2"
"150136","Ball State University","2010","Total full-time Instruction/research/public service, Non-tenured not on tenure track, Instructors","211","82","129","0","0","0","6","1","5","1","0","1","4","3","1","0","0","0","193","75","118","4","2","2","3","1","2","0","0","0","-2"
"150136","Ball State University","2010","Total full-time Instruction/research/public service, Non-tenured not on tenure track total","329","142","187","0","0","0","12","4","8","6","2","4","12","8","4","0","0","0","288","123","165","6","2","4","5","3","2","0","0","0","-2"
"151351","Indiana University-Bloomington","2010","Total full-time Instruction/research/public service, Tenured, Professors","645","486","159","0","0","0","31","25","6","15","8","7","20","15","5","0","0","0","575","434","141","3","3","0","1","1","0","0","0","0","-2"
"151351","Indiana University-Bloomington","2010","Total full-time Instruction/research/public service, Tenured, Associate professors","336","208","128","1","1","0","33","22","11","17","11","6","16","11","5","0","0","0","267","161","106","2","2","0","0","0","0","0","0","0","-2"
"151351","Indiana University-Bloomington","2010","Total full-time Instruction/research/public service, Tenured total","981","694","287","1","1","0","64","47","17","32","19","13","36","26","10","0","0","0","842","595","247","5","5","0","1","1","0","0","0","0","-2"
"151351","Indiana University-Bloomington","2010","Total full-time Instruction/research/public service, Non-tenured on tenure track, Associate professors","69","46","23","0","0","0","9","6","3","2","1","1","4","2","2","0","0","0","54","37","17","0","0","0","0","0","0","0","0","0","-2"
"151351","Indiana University-Bloomington","2010","Total full-time Instruction/research/public service, Non-tenured on tenure track, Assistant professors","301","160","141","3","1","2","50","21","29","22","11","11","13","9","4","0","0","0","208","116","92","5","2","3","0","0","0","0","0","0","-2"
"151351","Indiana University-Bloomington","2010","Total full-time Instruction/research/public service, Non-tenured on tenure track total","370","206","164","3","1","2","59","27","32","24","12","12","17","11","6","0","0","0","262","153","109","5","2","3","0","0","0","0","0","0","-2"
"151351","Indiana University-Bloomington","2010","Total full-time Instruction/research/public service, Non-tenured not on tenure track, Professors","27","19","8","0","0","0","1","0","1","2","2","0","0","0","0","0","0","0","24","17","7","0","0","0","0","0","0","0","0","0","-2"
"151351","Indiana University-Bloomington","2010","Total full-time Instruction/research/public service, Non-tenured not on tenure track, Associate professors","46","26","20","0","0","0","2","1","1","1","0","1","1","1","0","0","0","0","42","24","18","0","0","0","0","0","0","0","0","0","-2"
"151351","Indiana University-Bloomington","2010","Total full-time Instruction/research/public servicey, Non-tenured not on tenure track, Assistant professors","93","38","55","0","0","0","4","1","3","5","2","3","0","0","0","0","0","0","83","34","49","1","1","0","0","0","0","0","0","0","-2"
"151351","Indiana University-Bloomington","2010","Total full-time Instruction/research/public service, Non-tenured not on tenure track, Lecturers","346","164","182","2","1","1","28","11","17","13","9","4","22","12","10","0","0","0","279","131","148","2","0","2","0","0","0","0","0","0","-2"
"151351","Indiana University-Bloomington","2010","Total full-time Instruction/research/public service, Non-tenured not on tenure track, No academic rank","555","323","232","3","3","0","121","84","37","12","6","6","18","11","7","0","0","0","397","218","179","4","1","3","0","0","0","0","0","0","-2"
"151351","Indiana University-Bloomington","2010","Total full-time Instruction/research/public service, Non-tenured not on tenure track total","1067","570","497","5","4","1","156","97","59","33","19","14","41","24","17","0","0","0","825","424","401","7","2","5","0","0","0","0","0","0","-2"
"153603","Iowa State University","2010","Total full-time Instruction/research/public service, Tenured, Professors","439","365","74","2","2","0","57","53","4","4","2","2","9","7","2","0","0","0","367","301","66","0","0","0","0","0","0","0","0","0","-2"
"153603","Iowa State University","2010","Total full-time Instruction/research/public service, Tenured, Associate professors","370","247","123","3","3","0","66","57","9","10","7","3","5","3","2","0","0","0","283","174","109","1","1","0","0","0","0","2","2","0","-2"
"153603","Iowa State University","2010","Total full-time Instruction/research/public service, Tenured, Assistant professors","6","5","1","0","0","0","0","0","0","0","0","0","0","0","0","0","0","0","6","5","1","0","0","0","0","0","0","0","0","0","-2"
"153603","Iowa State University","2010","Total full-time Instruction/research/public service, Tenured total","815","617","198","5","5","0","123","110","13","14","9","5","14","10","4","0","0","0","656","480","176","1","1","0","0","0","0","2","2","0","-2"
"153603","Iowa State University","2010","Total full-time Instruction/research/public service, Non-tenured on tenure track, Professors","1","1","0","0","0","0","0","0","0","0","0","0","0","0","0","0","0","0","1","1","0","0","0","0","0","0","0","0","0","0","-2"
"153603","Iowa State University","2010","Total full-time Instruction/research/public service, Non-tenured on tenure track, Associate professors","8","4","4","0","0","0","0","0","0","0","0","0","0","0","0","0","0","0","7","4","3","0","0","0","0","0","0","1","0","1","-2"
"153603","Iowa State University","2010","Total full-time Instruction/research/public service, Non-tenured on tenure track, Assistant professors","281","170","111","0","0","0","39","29","10","7","3","4","10","4","6","1","1","0","184","106","78","1","1","0","0","0","0","39","26","13","-2"
"153603","Iowa State University","2010","Total full-time Instruction/research/public service, Non-tenured on tenure track total","290","175","115","0","0","0","39","29","10","7","3","4","10","4","6","1","1","0","192","111","81","1","1","0","0","0","0","40","26","14","-2"
"153603","Iowa State University","2010","Total full-time Instruction/research/public service, Non-tenured not on tenure track, Professors","11","9","2","0","0","0","3","3","0","0","0","0","1","1","0","0","0","0","7","5","2","0","0","0","0","0","0","0","0","0","-2"
"153603","Iowa State University","2010","Total full-time Instruction/research/public service, Non-tenured not on tenure track, Associate professors","12","9","3","0","0","0","1","1","0","0","0","0","0","0","0","0","0","0","10","7","3","0","0","0","0","0","0","1","1","0","-2"
"153603","Iowa State University","2010","Total full-time Instruction/research/public servicey, Non-tenured not on tenure track, Assistant professors","33","18","15","0","0","0","1","0","1","0","0","0","1","1","0","0","0","0","25","13","12","0","0","0","0","0","0","6","4","2","-2"
"153603","Iowa State University","2010","Total full-time Instruction/research/public service, Non-tenured not on tenure track, Instructors","30","8","22","0","0","0","0","0","0","0","0","0","2","0","2","0","0","0","25","7","18","0","0","0","0","0","0","3","1","2","-2"
"153603","Iowa State University","2010","Total full-time Instruction/research/public service, Non-tenured not on tenure track, Lecturers","157","73","84","1","0","1","10","4","6","4","2","2","5","2","3","0","0","0","134","63","71","1","0","1","0","0","0","2","2","0","-2"
"153603","Iowa State University","2010","Total full-time Instruction/research/public service, Non-tenured not on tenure track total","243","117","126","1","0","1","15","8","7","4","2","2","9","4","5","0","0","0","201","95","106","1","0","1","0","0","0","12","8","4","-2"
"153658","University of Iowa","2010","Total full-time Instruction/research/public service, Tenured, Professors","662","513","149","2","1","1","52","46","6","10","6","4","13","7","6","0","0","0","576","444","132","1","1","0","8","8","0","0","0","0","-2"
"153658","University of Iowa","2010","Total full-time Instruction/research/public service, Tenured, Associate professors","405","254","151","3","0","3","42","30","12","10","3","7","17","8","9","0","0","0","327","209","118","3","1","2","3","3","0","0","0","0","-2"
"153658","University of Iowa","2010","Total full-time Instruction/research/public service, Tenured total","1067","767","300","5","1","4","94","76","18","20","9","11","30","15","15","0","0","0","903","653","250","4","2","2","11","11","0","0","0","0","-2"
"153658","University of Iowa","2010","Total full-time Instruction/research/public service, Non-tenured on tenure track, Professors","3","2","1","0","0","0","0","0","0","0","0","0","0","0","0","0","0","0","3","2","1","0","0","0","0","0","0","0","0","0","-2"
"153658","University of Iowa","2010","Total full-time Instruction/research/public service, Non-tenured on tenure track, Associate professors","20","14","6","0","0","0","4","4","0","1","0","1","1","1","0","0","0","0","12","8","4","1","0","1","1","1","0","0","0","0","-2"
"153658","University of Iowa","2010","Total full-time Instruction/research/public service, Non-tenured on tenure track, Assistant professors","340","192","148","2","0","2","47","34","13","16","7","9","20","16","4","0","0","0","223","116","107","1","0","1","7","3","4","24","16","8","-2"
"153658","University of Iowa","2010","Total full-time Instruction/research/public service, Non-tenured on tenure track total","363","208","155","2","0","2","51","38","13","17","7","10","21","17","4","0","0","0","238","126","112","2","0","2","8","4","4","24","16","8","-2"
"153658","University of Iowa","2010","Total full-time Instruction/research/public service, Non-tenured not on tenure track, Professors","89","61","28","0","0","0","5","3","2","1","1","0","1","1","0","0","0","0","80","54","26","0","0","0","2","2","0","0","0","0","-2"
"153658","University of Iowa","2010","Total full-time Instruction/research/public service, Non-tenured not on tenure track, Associate professors","153","89","64","1","1","0","15","12","3","6","5","1","2","2","0","0","0","0","120","65","55","0","0","0","3","2","1","6","2","4","-2"
"153658","University of Iowa","2010","Total full-time Instruction/research/public servicey, Non-tenured not on tenure track, Assistant professors","251","131","120","0","0","0","24","16","8","4","2","2","13","8","5","0","0","0","168","77","91","1","0","1","11","5","6","30","23","7","-2"
"153658","University of Iowa","2010","Total full-time Instruction/research/public service, Non-tenured not on tenure track, Instructors","12","5","7","0","0","0","0","0","0","0","0","0","1","0","1","0","0","0","9","4","5","0","0","0","1","0","1","1","1","0","-2"
"153658","University of Iowa","2010","Total full-time Instruction/research/public service, Non-tenured not on tenure track, Lecturers","120","47","73","1","0","1","3","0","3","1","1","0","3","0","3","0","0","0","101","43","58","0","0","0","4","0","4","7","3","4","-2"
"153658","University of Iowa","2010","Total full-time Instruction/research/public service, Non-tenured not on tenure track, No academic rank","54","30","24","0","0","0","10","7","3","3","3","0","0","0","0","0","0","0","30","13","17","0","0","0","3","2","1","8","5","3","-2"
"153658","University of Iowa","2010","Total full-time Instruction/research/public service, Non-tenured not on tenure track total","679","363","316","2","1","1","57","38","19","15","12","3","20","11","9","0","0","0","508","256","252","1","0","1","24","11","13","52","34","18","-2"
"155317","University of Kansas","2010","Total full-time Instruction/research/public service, Tenured, Professors","543","422","121","2","1","1","38","34","4","10","6","4","12","10","2","0","0","0","475","367","108","1","0","1","4","3","1","1","1","0","-2"
"155317","University of Kansas","2010","Total full-time Instruction/research/public service, Tenured, Associate professors","458","282","176","1","1","0","47","35","12","16","11","5","20","12","8","0","0","0","366","221","145","3","0","3","5","2","3","0","0","0","-2"
"155317","University of Kansas","2010","Total full-time Instruction/research/public service, Tenured, Assistant professors","4","0","4","0","0","0","0","0","0","0","0","0","0","0","0","0","0","0","4","0","4","0","0","0","0","0","0","0","0","0","-2"
"155317","University of Kansas","2010","Total full-time Instruction/research/public service, Tenured total","1005","704","301","3","2","1","85","69","16","26","17","9","32","22","10","0","0","0","845","588","257","4","0","4","9","5","4","1","1","0","-2"
"155317","University of Kansas","2010","Total full-time Instruction/research/public service, Non-tenured on tenure track, Professors","1","1","0","0","0","0","0","0","0","0","0","0","0","0","0","0","0","0","1","1","0","0","0","0","0","0","0","0","0","0","-2"
"155317","University of Kansas","2010","Total full-time Instruction/research/public service, Non-tenured on tenure track, Associate professors","26","18","8","1","1","0","4","3","1","1","0","1","1","1","0","0","0","0","16","11","5","1","0","1","1","1","0","1","1","0","-2"
"155317","University of Kansas","2010","Total full-time Instruction/research/public service, Non-tenured on tenure track, Assistant professors","300","167","133","3","1","2","45","27","18","11","4","7","9","3","6","0","0","0","181","104","77","6","2","4","2","0","2","43","26","17","-2"
"155317","University of Kansas","2010","Total full-time Instruction/research/public service, Non-tenured on tenure track total","327","186","141","4","2","2","49","30","19","12","4","8","10","4","6","0","0","0","198","116","82","7","2","5","3","1","2","44","27","17","-2"
"155317","University of Kansas","2010","Total full-time Instruction/research/public service, Non-tenured not on tenure track, Professors","51","35","16","2","2","0","6","6","0","0","0","0","0","0","0","0","0","0","42","27","15","1","0","1","0","0","0","0","0","0","-2"
"155317","University of Kansas","2010","Total full-time Instruction/research/public service, Non-tenured not on tenure track, Associate professors","93","51","42","0","0","0","11","6","5","0","0","0","3","1","2","0","0","0","79","44","35","0","0","0","0","0","0","0","0","0","-2"
"155317","University of Kansas","2010","Total full-time Instruction/research/public servicey, Non-tenured not on tenure track, Assistant professors","327","164","163","1","0","1","43","22","21","10","6","4","9","5","4","0","0","0","217","97","120","1","0","1","7","5","2","39","29","10","-2"
"155317","University of Kansas","2010","Total full-time Instruction/research/public service, Non-tenured not on tenure track, Instructors","63","20","43","0","0","0","6","2","4","3","1","2","3","1","2","0","0","0","45","13","32","2","1","1","0","0","0","4","2","2","-2"
"155317","University of Kansas","2010","Total full-time Instruction/research/public service, Non-tenured not on tenure track, Lecturers","88","30","58","0","0","0","2","0","2","2","1","1","5","2","3","0","0","0","75","27","48","1","0","1","0","0","0","3","0","3","-2"
"155317","University of Kansas","2010","Total full-time Instruction/research/public service, Non-tenured not on tenure track, No academic rank","35","16","19","1","0","1","4","3","1","1","0","1","0","0","0","0","0","0","27","11","16","0","0","0","0","0","0","2","2","0","-2"
"155317","University of Kansas","2010","Total full-time Instruction/research/public service, Non-tenured not on tenure track total","657","316","341","4","2","2","72","39","33","16","8","8","20","9","11","0","0","0","485","219","266","5","1","4","7","5","2","48","33","15","-2"
"157447","Northern Kentucky University","2010","Total full-time Instruction/research/public service, Tenured, Professors","88","55","33","0","0","0","6","3","3","3","2","1","1","1","0","0","0","0","78","49","29","0","0","0","0","0","0","0","0","0","-2"
"157447","Northern Kentucky University","2010","Total full-time Instruction/research/public service, Tenured, Associate professors","146","80","66","0","0","0","5","2","3","10","6","4","2","2","0","0","0","0","128","69","59","0","0","0","0","0","0","1","1","0","-2"
"157447","Northern Kentucky University","2010","Total full-time Instruction/research/public service, Tenured, Assistant professors","3","1","2","0","0","0","0","0","0","0","0","0","0","0","0","0","0","0","3","1","2","0","0","0","0","0","0","0","0","0","-2"
"157447","Northern Kentucky University","2010","Total full-time Instruction/research/public service, Tenured total","237","136","101","0","0","0","11","5","6","13","8","5","3","3","0","0","0","0","209","119","90","0","0","0","0","0","0","1","1","0","-2"
"157447","Northern Kentucky University","2010","Total full-time Instruction/research/public service, Non-tenured on tenure track, Associate professors","2","1","1","0","0","0","0","0","0","0","0","0","0","0","0","0","0","0","2","1","1","0","0","0","0","0","0","0","0","0","-2"
"157447","Northern Kentucky University","2010","Total full-time Instruction/research/public service, Non-tenured on tenure track, Assistant professors","134","55","79","2","2","0","6","4","2","10","1","9","2","1","1","0","0","0","101","42","59","2","0","2","0","0","0","11","5","6","-2"
"157447","Northern Kentucky University","2010","Total full-time Instruction/research/public service, Non-tenured on tenure track, Lecturers","1","0","1","0","0","0","0","0","0","0","0","0","0","0","0","0","0","0","1","0","1","0","0","0","0","0","0","0","0","0","-2"
"157447","Northern Kentucky University","2010","Total full-time Instruction/research/public service, Non-tenured on tenure track total","137","56","81","2","2","0","6","4","2","10","1","9","2","1","1","0","0","0","104","43","61","2","0","2","0","0","0","11","5","6","-2"
"157447","Northern Kentucky University","2010","Total full-time Instruction/research/public service, Non-tenured not on tenure track, Professors","4","4","0","0","0","0","0","0","0","1","1","0","0","0","0","0","0","0","3","3","0","0","0","0","0","0","0","0","0","0","-2"
"157447","Northern Kentucky University","2010","Total full-time Instruction/research/public servicey, Non-tenured not on tenure track, Assistant professors","5","1","4","0","0","0","0","0","0","1","0","1","0","0","0","0","0","0","4","1","3","0","0","0","0","0","0","0","0","0","-2"
"157447","Northern Kentucky University","2010","Total full-time Instruction/research/public service, Non-tenured not on tenure track, Instructors","3","2","1","0","0","0","0","0","0","0","0","0","0","0","0","0","0","0","3","2","1","0","0","0","0","0","0","0","0","0","-2"
"157447","Northern Kentucky University","2010","Total full-time Instruction/research/public service, Non-tenured not on tenure track, Lecturers","146","63","83","1","1","0","2","2","0","3","1","2","1","0","1","0","0","0","136","58","78","1","0","1","0","0","0","2","1","1","-2"
"157447","Northern Kentucky University","2010","Total full-time Instruction/research/public service, Non-tenured not on tenure track total","158","70","88","1","1","0","2","2","0","5","2","3","1","0","1","0","0","0","146","64","82","1","0","1","0","0","0","2","1","1","-2"
"157951","Western Kentucky University","2010","Total full-time Instruction/research/public service, Tenured, Professors","158","111","47","2","2","0","10","9","1","5","2","3","0","0","0","0","0","0","134","93","41","6","4","2","1","1","0","0","0","0","-2"
"157951","Western Kentucky University","2010","Total full-time Instruction/research/public service, Tenured, Associate professors","179","107","72","0","0","0","6","6","0","14","7","7","5","4","1","0","0","0","148","86","62","4","3","1","2","1","1","0","0","0","-2"
"157951","Western Kentucky University","2010","Total full-time Instruction/research/public service, Tenured, Assistant professors","23","9","14","0","0","0","0","0","0","0","0","0","0","0","0","0","0","0","23","9","14","0","0","0","0","0","0","0","0","0","-2"
"157951","Western Kentucky University","2010","Total full-time Instruction/research/public service, Tenured total","360","227","133","2","2","0","16","15","1","19","9","10","5","4","1","0","0","0","305","188","117","10","7","3","3","2","1","0","0","0","-2"
"157951","Western Kentucky University","2010","Total full-time Instruction/research/public service, Non-tenured on tenure track, Professors","1","0","1","0","0","0","0","0","0","0","0","0","0","0","0","0","0","0","1","0","1","0","0","0","0","0","0","0","0","0","-2"
"157951","Western Kentucky University","2010","Total full-time Instruction/research/public service, Non-tenured on tenure track, Associate professors","15","11","4","1","0","1","1","1","0","2","1","1","0","0","0","0","0","0","10","8","2","1","1","0","0","0","0","0","0","0","-2"
"157951","Western Kentucky University","2010","Total full-time Instruction/research/public service, Non-tenured on tenure track, Assistant professors","189","90","99","1","0","1","30","15","15","11","5","6","2","1","1","0","0","0","142","67","75","3","2","1","0","0","0","0","0","0","-2"
"157951","Western Kentucky University","2010","Total full-time Instruction/research/public service, Non-tenured on tenure track total","205","101","104","2","0","2","31","16","15","13","6","7","2","1","1","0","0","0","153","75","78","4","3","1","0","0","0","0","0","0","-2"
"157951","Western Kentucky University","2010","Total full-time Instruction/research/public service, Non-tenured not on tenure track, Professors","1","1","0","0","0","0","0","0","0","0","0","0","0","0","0","0","0","0","1","1","0","0","0","0","0","0","0","0","0","0","-2"
"157951","Western Kentucky University","2010","Total full-time Instruction/research/public servicey, Non-tenured not on tenure track, Assistant professors","14","4","10","0","0","0","0","0","0","1","0","1","0","0","0","0","0","0","13","4","9","0","0","0","0","0","0","0","0","0","-2"
"157951","Western Kentucky University","2010","Total full-time Instruction/research/public service, Non-tenured not on tenure track, Instructors","145","44","101","0","0","0","5","1","4","6","2","4","6","6","0","0","0","0","125","32","93","1","1","0","1","1","0","1","1","0","-2"
"157951","Western Kentucky University","2010","Total full-time Instruction/research/public service, Non-tenured not on tenure track, No academic rank","22","10","12","0","0","0","1","0","1","3","0","3","0","0","0","0","0","0","17","10","7","1","0","1","0","0","0","0","0","0","-2"
"157951","Western Kentucky University","2010","Total full-time Instruction/research/public service, Non-tenured not on tenure track total","182","59","123","0","0","0","6","1","5","10","2","8","6","6","0","0","0","0","156","47","109","2","1","1","1","1","0","1","1","0","-2"
"159993","University of Louisiana at Monroe","2010","Total full-time Instruction/research/public service, Tenured, Professors","56","36","20","0","0","0","3","2","1","3","0","3","0","0","0","0","0","0","49","34","15","0","0","0","1","0","1","0","0","0","-2"
"159993","University of Louisiana at Monroe","2010","Total full-time Instruction/research/public service, Tenured, Associate professors","71","42","29","0","0","0","1","0","1","4","2","2","1","1","0","0","0","0","64","39","25","0","0","0","1","0","1","0","0","0","-2"
"159993","University of Louisiana at Monroe","2010","Total full-time Instruction/research/public service, Tenured, Assistant professors","18","3","15","0","0","0","0","0","0","0","0","0","0","0","0","0","0","0","17","3","14","0","0","0","1","0","1","0","0","0","-2"
"159993","University of Louisiana at Monroe","2010","Total full-time Instruction/research/public service, Tenured total","145","81","64","0","0","0","4","2","2","7","2","5","1","1","0","0","0","0","130","76","54","0","0","0","3","0","3","0","0","0","-2"
"159993","University of Louisiana at Monroe","2010","Total full-time Instruction/research/public service, Non-tenured on tenure track, Professors","2","1","1","0","0","0","0","0","0","0","0","0","0","0","0","0","0","0","2","1","1","0","0","0","0","0","0","0","0","0","-2"
"159993","University of Louisiana at Monroe","2010","Total full-time Instruction/research/public service, Non-tenured on tenure track, Associate professors","18","9","9","0","0","0","0","0","0","2","0","2","1","1","0","0","0","0","14","7","7","0","0","0","1","1","0","0","0","0","-2"
"159993","University of Louisiana at Monroe","2010","Total full-time Instruction/research/public service, Non-tenured on tenure track, Assistant professors","90","46","44","0","0","0","6","5","1","8","4","4","3","1","2","0","0","0","72","35","37","0","0","0","1","1","0","0","0","0","-2"
"159993","University of Louisiana at Monroe","2010","Total full-time Instruction/research/public service, Non-tenured on tenure track, Instructors","2","0","2","0","0","0","0","0","0","0","0","0","0","0","0","0","0","0","2","0","2","0","0","0","0","0","0","0","0","0","-2"
"159993","University of Louisiana at Monroe","2010","Total full-time Instruction/research/public service, Non-tenured on tenure track total","112","56","56","0","0","0","6","5","1","10","4","6","4","2","2","0","0","0","90","43","47","0","0","0","2","2","0","0","0","0","-2"
"159993","University of Louisiana at Monroe","2010","Total full-time Instruction/research/public service, Non-tenured not on tenure track, Associate professors","4","0","4","0","0","0","0","0","0","1","0","1","0","0","0","0","0","0","3","0","3","0","0","0","0","0","0","0","0","0","-2"
"159993","University of Louisiana at Monroe","2010","Total full-time Instruction/research/public servicey, Non-tenured not on tenure track, Assistant professors","25","8","17","0","0","0","0","0","0","2","1","1","0","0","0","0","0","0","23","7","16","0","0","0","0","0","0","0","0","0","-2"
"159993","University of Louisiana at Monroe","2010","Total full-time Instruction/research/public service, Non-tenured not on tenure track, Instructors","53","18","35","1","1","0","0","0","0","3","0","3","2","0","2","0","0","0","47","17","30","0","0","0","0","0","0","0","0","0","-2"
"159993","University of Louisiana at Monroe","2010","Total full-time Instruction/research/public service, Non-tenured not on tenure track, No academic rank","5","4","1","0","0","0","0","0","0","0","0","0","0","0","0","0","0","0","5","4","1","0","0","0","0","0","0","0","0","0","-2"
"159993","University of Louisiana at Monroe","2010","Total full-time Instruction/research/public service, Non-tenured not on tenure track total","87","30","57","1","1","0","0","0","0","6","1","5","2","0","2","0","0","0","78","28","50","0","0","0","0","0","0","0","0","0","-2"
"162928","Johns Hopkins University","2010","Total full-time Instruction/research/public service, Tenured, Professors","789","627","162","1","1","0","66","53","13","15","12","3","14","13","1","0","0","0","689","545","144","0","0","0","0","0","0","4","3","1","-2"
"162928","Johns Hopkins University","2010","Total full-time Instruction/research/public service, Tenured, Associate professors","52","38","14","0","0","0","5","5","0","4","2","2","1","1","0","0","0","0","39","28","11","0","0","0","0","0","0","3","2","1","-2"
"162928","Johns Hopkins University","2010","Total full-time Instruction/research/public service, Tenured, Assistant professors","2","0","2","0","0","0","1","0","1","0","0","0","0","0","0","0","0","0","0","0","0","0","0","0","0","0","0","1","0","1","-2"
"162928","Johns Hopkins University","2010","Total full-time Instruction/research/public service, Tenured, No academic rank","4","4","0","0","0","0","0","0","0","0","0","0","0","0","0","0","0","0","4","4","0","0","0","0","0","0","0","0","0","0","-2"
"162928","Johns Hopkins University","2010","Total full-time Instruction/research/public service, Tenured total","847","669","178","1","1","0","72","58","14","19","14","5","15","14","1","0","0","0","732","577","155","0","0","0","0","0","0","8","5","3","-2"
"162928","Johns Hopkins University","2010","Total full-time Instruction/research/public service, Non-tenured on tenure track, Professors","15","12","3","0","0","0","2","2","0","0","0","0","1","1","0","0","0","0","11","8","3","0","0","0","0","0","0","1","1","0","-2"
"162928","Johns Hopkins University","2010","Total full-time Instruction/research/public service, Non-tenured on tenure track, Associate professors","502","347","155","1","1","0","78","51","27","11","6","5","9","8","1","0","0","0","395","274","121","0","0","0","0","0","0","8","7","1","-2"
"162928","Johns Hopkins University","2010","Total full-time Instruction/research/public service, Non-tenured on tenure track, Assistant professors","959","527","432","2","1","1","176","112","64","53","19","34","22","12","10","0","0","0","636","334","302","0","0","0","0","0","0","70","49","21","-2"
"162928","Johns Hopkins University","2010","Total full-time Instruction/research/public service, Non-tenured on tenure track, Instructors","213","115","98","1","1","0","44","23","21","13","4","9","9","6","3","0","0","0","121","64","57","0","0","0","0","0","0","25","17","8","-2"
"162928","Johns Hopkins University","2010","Total full-time Instruction/research/public service, Non-tenured on tenure track, No academic rank","5","3","2","0","0","0","3","2","1","0","0","0","0","0","0","0","0","0","2","1","1","0","0","0","0","0","0","0","0","0","-2"
"162928","Johns Hopkins University","2010","Total full-time Instruction/research/public service, Non-tenured on tenure track total","1694","1004","690","4","3","1","303","190","113","77","29","48","41","27","14","0","0","0","1165","681","484","0","0","0","0","0","0","104","74","30","-2"
"162928","Johns Hopkins University","2010","Total full-time Instruction/research/public service, Non-tenured not on tenure track, Professors","32","24","8","0","0","0","1","1","0","2","0","2","0","0","0","0","0","0","28","22","6","0","0","0","0","0","0","1","1","0","-2"
"162928","Johns Hopkins University","2010","Total full-time Instruction/research/public service, Non-tenured not on tenure track, Associate professors","50","24","26","0","0","0","7","6","1","3","2","1","1","0","1","0","0","0","37","15","22","0","0","0","0","0","0","2","1","1","-2"
"162928","Johns Hopkins University","2010","Total full-time Instruction/research/public servicey, Non-tenured not on tenure track, Assistant professors","54","20","34","0","0","0","4","4","0","4","0","4","1","1","0","0","0","0","42","13","29","0","0","0","0","0","0","3","2","1","-2"
"162928","Johns Hopkins University","2010","Total full-time Instruction/research/public service, Non-tenured not on tenure track, Instructors","100","31","69","0","0","0","6","1","5","8","3","5","3","1","2","0","0","0","82","25","57","0","0","0","0","0","0","1","1","0","-2"
"162928","Johns Hopkins University","2010","Total full-time Instruction/research/public service, Non-tenured not on tenure track, Lecturers","136","50","86","1","1","0","11","2","9","2","2","0","5","1","4","0","0","0","107","40","67","0","0","0","0","0","0","10","4","6","-2"
"162928","Johns Hopkins University","2010","Total full-time Instruction/research/public service, Non-tenured not on tenure track, No academic rank","733","399","334","0","0","0","147","88","59","31","17","14","10","5","5","0","0","0","411","207","204","0","0","0","0","0","0","134","82","52","-2"
"162928","Johns Hopkins University","2010","Total full-time Instruction/research/public service, Non-tenured not on tenure track total","1105","548","557","1","1","0","176","102","74","50","24","26","20","8","12","0","0","0","707","322","385","0","0","0","0","0","0","151","91","60","-2"
"163268","University of Maryland-Baltimore County","2010","Total full-time Instruction/research/public service, Tenured, Professors","145","119","26","0","0","0","23","21","2","3","3","0","0","0","0","1","1","0","118","94","24","0","0","0","0","0","0","0","0","0","-2"
"163268","University of Maryland-Baltimore County","2010","Total full-time Instruction/research/public service, Tenured, Associate professors","144","78","66","0","0","0","16","7","9","11","5","6","5","3","2","0","0","0","108","62","46","0","0","0","0","0","0","4","1","3","-2"
"163268","University of Maryland-Baltimore County","2010","Total full-time Instruction/research/public service, Tenured, Assistant professors","3","3","0","0","0","0","1","1","0","1","1","0","0","0","0","0","0","0","1","1","0","0","0","0","0","0","0","0","0","0","-2"
"163268","University of Maryland-Baltimore County","2010","Total full-time Instruction/research/public service, Tenured total","292","200","92","0","0","0","40","29","11","15","9","6","5","3","2","1","1","0","227","157","70","0","0","0","0","0","0","4","1","3","-2"
"163268","University of Maryland-Baltimore County","2010","Total full-time Instruction/research/public service, Non-tenured on tenure track, Professors","1","1","0","0","0","0","0","0","0","0","0","0","0","0","0","0","0","0","0","0","0","0","0","0","0","0","0","1","1","0","-2"
"163268","University of Maryland-Baltimore County","2010","Total full-time Instruction/research/public service, Non-tenured on tenure track, Associate professors","2","2","0","0","0","0","0","0","0","0","0","0","0","0","0","0","0","0","2","2","0","0","0","0","0","0","0","0","0","0","-2"
"163268","University of Maryland-Baltimore County","2010","Total full-time Instruction/research/public service, Non-tenured on tenure track, Assistant professors","78","26","52","0","0","0","9","2","7","5","3","2","3","0","3","1","0","1","47","14","33","1","0","1","0","0","0","12","7","5","-2"
"163268","University of Maryland-Baltimore County","2010","Total full-time Instruction/research/public service, Non-tenured on tenure track, No academic rank","1","1","0","0","0","0","0","0","0","0","0","0","0","0","0","0","0","0","0","0","0","0","0","0","0","0","0","1","1","0","-2"
"163268","University of Maryland-Baltimore County","2010","Total full-time Instruction/research/public service, Non-tenured on tenure track total","82","30","52","0","0","0","9","2","7","5","3","2","3","0","3","1","0","1","49","16","33","1","0","1","0","0","0","14","9","5","-2"
"163268","University of Maryland-Baltimore County","2010","Total full-time Instruction/research/public service, Non-tenured not on tenure track, Professors","25","20","5","0","0","0","1","1","0","0","0","0","0","0","0","0","0","0","22","17","5","0","0","0","0","0","0","2","2","0","-2"
"163268","University of Maryland-Baltimore County","2010","Total full-time Instruction/research/public service, Non-tenured not on tenure track, Associate professors","65","50","15","1","1","0","24","17","7","1","0","1","0","0","0","0","0","0","34","28","6","0","0","0","0","0","0","5","4","1","-2"
"163268","University of Maryland-Baltimore County","2010","Total full-time Instruction/research/public servicey, Non-tenured not on tenure track, Assistant professors","95","57","38","0","0","0","18","13","5","2","0","2","2","1","1","0","0","0","50","29","21","0","0","0","0","0","0","23","14","9","-2"
"163268","University of Maryland-Baltimore County","2010","Total full-time Instruction/research/public service, Non-tenured not on tenure track, Instructors","12","4","8","0","0","0","1","0","1","2","1","1","0","0","0","0","0","0","9","3","6","0","0","0","0","0","0","0","0","0","-2"
"163268","University of Maryland-Baltimore County","2010","Total full-time Instruction/research/public service, Non-tenured not on tenure track, Lecturers","74","30","44","0","0","0","3","1","2","2","1","1","1","0","1","0","0","0","64","26","38","0","0","0","0","0","0","4","2","2","-2"
"163268","University of Maryland-Baltimore County","2010","Total full-time Instruction/research/public service, Non-tenured not on tenure track, No academic rank","119","64","55","0","0","0","13","6","7","3","0","3","1","1","0","0","0","0","41","20","21","0","0","0","0","0","0","61","37","24","-2"
"163268","University of Maryland-Baltimore County","2010","Total full-time Instruction/research/public service, Non-tenured not on tenure track total","390","225","165","1","1","0","60","38","22","10","2","8","4","2","2","0","0","0","220","123","97","0","0","0","0","0","0","95","59","36","-2"
"163286","University of Maryland-College Park","2010","Total full-time Instruction/research/public service, Tenured, Professors","659","518","141","0","0","0","65","53","12","17","9","8","18","10","8","0","0","0","544","435","109","1","1","0","14","10","4","0","0","0","-2"
"163286","University of Maryland-College Park","2010","Total full-time Instruction/research/public service, Tenured, Associate professors","436","282","154","2","2","0","64","45","19","23","9","14","16","7","9","0","0","0","319","209","110","0","0","0","10","9","1","2","1","1","-2"
"163286","University of Maryland-College Park","2010","Total full-time Instruction/research/public service, Tenured, Assistant professors","2","2","0","0","0","0","0","0","0","0","0","0","0","0","0","0","0","0","2","2","0","0","0","0","0","0","0","0","0","0","-2"
"163286","University of Maryland-College Park","2010","Total full-time Instruction/research/public service, Tenured total","1097","802","295","2","2","0","129","98","31","40","18","22","34","17","17","0","0","0","865","646","219","1","1","0","24","19","5","2","1","1","-2"
"163286","University of Maryland-College Park","2010","Total full-time Instruction/research/public service, Non-tenured on tenure track, Associate professors","5","3","2","0","0","0","0","0","0","0","0","0","0","0","0","0","0","0","4","2","2","0","0","0","0","0","0","1","1","0","-2"
"163286","University of Maryland-College Park","2010","Total full-time Instruction/research/public service, Non-tenured on tenure track, Assistant professors","330","187","143","0","0","0","59","31","28","31","18","13","17","10","7","0","0","0","169","95","74","1","0","1","20","11","9","33","22","11","-2"
"163286","University of Maryland-College Park","2010","Total full-time Instruction/research/public service, Non-tenured on tenure track total","335","190","145","0","0","0","59","31","28","31","18","13","17","10","7","0","0","0","173","97","76","1","0","1","20","11","9","34","23","11","-2"
"163286","University of Maryland-College Park","2010","Total full-time Instruction/research/public service, Non-tenured not on tenure track, Professors","70","56","14","0","0","0","8","7","1","1","0","1","2","2","0","0","0","0","54","42","12","1","1","0","2","2","0","2","2","0","-2"
"163286","University of Maryland-College Park","2010","Total full-time Instruction/research/public service, Non-tenured not on tenure track, Associate professors","56","45","11","0","0","0","6","5","1","0","0","0","1","1","0","0","0","0","44","34","10","0","0","0","2","2","0","3","3","0","-2"
"163286","University of Maryland-College Park","2010","Total full-time Instruction/research/public servicey, Non-tenured not on tenure track, Assistant professors","48","34","14","0","0","0","16","13","3","0","0","0","2","1","1","0","0","0","24","14","10","0","0","0","0","0","0","6","6","0","-2"
"163286","University of Maryland-College Park","2010","Total full-time Instruction/research/public service, Non-tenured not on tenure track, Instructors","54","14","40","0","0","0","3","1","2","9","4","5","1","0","1","0","0","0","39","9","30","0","0","0","2","0","2","0","0","0","-2"
"163286","University of Maryland-College Park","2010","Total full-time Instruction/research/public service, Non-tenured not on tenure track, Lecturers","260","113","147","0","0","0","12","5","7","7","2","5","14","7","7","0","0","0","202","89","113","0","0","0","15","4","11","10","6","4","-2"
"163286","University of Maryland-College Park","2010","Total full-time Instruction/research/public service, Non-tenured not on tenure track, No academic rank","1163","723","440","0","0","0","138","90","48","42","19","23","20","8","12","0","0","0","541","301","240","2","1","1","48","25","23","372","279","93","-2"
"163286","University of Maryland-College Park","2010","Total full-time Instruction/research/public service, Non-tenured not on tenure track total","1651","985","666","0","0","0","183","121","62","59","25","34","40","19","21","0","0","0","904","489","415","3","2","1","69","33","36","393","296","97","-2"
"163338","University of Maryland Eastern Shore","2010","Total full-time Instruction/research/public service, Tenured, Professors","28","22","6","0","0","0","6","4","2","13","11","2","0","0","0","0","0","0","9","7","2","0","0","0","0","0","0","0","0","0","-2"
"163338","University of Maryland Eastern Shore","2010","Total full-time Instruction/research/public service, Tenured, Associate professors","34","16","18","0","0","0","5","1","4","10","4","6","0","0","0","0","0","0","17","10","7","0","0","0","1","0","1","1","1","0","-2"
"163338","University of Maryland Eastern Shore","2010","Total full-time Instruction/research/public service, Tenured, Assistant professors","6","3","3","0","0","0","0","0","0","4","1","3","0","0","0","0","0","0","2","2","0","0","0","0","0","0","0","0","0","0","-2"
"163338","University of Maryland Eastern Shore","2010","Total full-time Instruction/research/public service, Tenured total","68","41","27","0","0","0","11","5","6","27","16","11","0","0","0","0","0","0","28","19","9","0","0","0","1","0","1","1","1","0","-2"
"163338","University of Maryland Eastern Shore","2010","Total full-time Instruction/research/public service, Non-tenured on tenure track, Professors","2","1","1","0","0","0","0","0","0","0","0","0","0","0","0","0","0","0","2","1","1","0","0","0","0","0","0","0","0","0","-2"
"163338","University of Maryland Eastern Shore","2010","Total full-time Instruction/research/public service, Non-tenured on tenure track, Associate professors","17","13","4","1","1","0","3","1","2","9","8","1","0","0","0","0","0","0","3","2","1","1","1","0","0","0","0","0","0","0","-2"
"163338","University of Maryland Eastern Shore","2010","Total full-time Instruction/research/public service, Non-tenured on tenure track, Assistant professors","49","30","19","0","0","0","4","4","0","14","5","9","2","2","0","0","0","0","19","11","8","1","0","1","2","1","1","7","7","0","-2"
"163338","University of Maryland Eastern Shore","2010","Total full-time Instruction/research/public service, Non-tenured on tenure track, Instructors","2","2","0","0","0","0","0","0","0","1","1","0","0","0","0","0","0","0","0","0","0","0","0","0","0","0","0","1","1","0","-2"
"163338","University of Maryland Eastern Shore","2010","Total full-time Instruction/research/public service, Non-tenured on tenure track total","70","46","24","1","1","0","7","5","2","24","14","10","2","2","0","0","0","0","24","14","10","2","1","1","2","1","1","8","8","0","-2"
"163338","University of Maryland Eastern Shore","2010","Total full-time Instruction/research/public service, Non-tenured not on tenure track, Associate professors","1","0","1","0","0","0","0","0","0","1","0","1","0","0","0","0","0","0","0","0","0","0","0","0","0","0","0","0","0","0","-2"
"163338","University of Maryland Eastern Shore","2010","Total full-time Instruction/research/public servicey, Non-tenured not on tenure track, Assistant professors","5","1","4","0","0","0","0","0","0","3","1","2","0","0","0","0","0","0","1","0","1","0","0","0","0","0","0","1","0","1","-2"
"163338","University of Maryland Eastern Shore","2010","Total full-time Instruction/research/public service, Non-tenured not on tenure track, Instructors","7","7","0","0","0","0","0","0","0","4","4","0","0","0","0","0","0","0","3","3","0","0","0","0","0","0","0","0","0","0","-2"
"163338","University of Maryland Eastern Shore","2010","Total full-time Instruction/research/public service, Non-tenured not on tenure track, Lecturers","53","22","31","1","0","1","4","4","0","19","9","10","3","1","2","0","0","0","26","8","18","0","0","0","0","0","0","0","0","0","-2"
"163338","University of Maryland Eastern Shore","2010","Total full-time Instruction/research/public service, Non-tenured not on tenure track, No academic rank","2","2","0","0","0","0","0","0","0","0","0","0","0","0","0","0","0","0","1","1","0","0","0","0","0","0","0","1","1","0","-2"
"163338","University of Maryland Eastern Shore","2010","Total full-time Instruction/research/public service, Non-tenured not on tenure track total","68","32","36","1","0","1","4","4","0","27","14","13","3","1","2","0","0","0","31","12","19","0","0","0","0","0","0","2","1","1","-2"
"163851","Salisbury University","2010","Total full-time Instruction/research/public service, Tenured, Professors","88","59","29","0","0","0","4","3","1","3","1","2","0","0","0","0","0","0","81","55","26","0","0","0","0","0","0","0","0","0","-2"
"163851","Salisbury University","2010","Total full-time Instruction/research/public service, Tenured, Associate professors","102","58","44","0","0","0","8","4","4","6","5","1","2","2","0","0","0","0","85","47","38","0","0","0","1","0","1","0","0","0","-2"
"163851","Salisbury University","2010","Total full-time Instruction/research/public service, Tenured, Assistant professors","15","8","7","0","0","0","0","0","0","2","1","1","0","0","0","0","0","0","13","7","6","0","0","0","0","0","0","0","0","0","-2"
"163851","Salisbury University","2010","Total full-time Instruction/research/public service, Tenured total","205","125","80","0","0","0","12","7","5","11","7","4","2","2","0","0","0","0","179","109","70","0","0","0","1","0","1","0","0","0","-2"
"163851","Salisbury University","2010","Total full-time Instruction/research/public service, Non-tenured on tenure track, Associate professors","2","1","1","0","0","0","1","1","0","0","0","0","0","0","0","0","0","0","1","0","1","0","0","0","0","0","0","0","0","0","-2"
"163851","Salisbury University","2010","Total full-time Instruction/research/public service, Non-tenured on tenure track, Assistant professors","89","47","42","1","0","1","5","4","1","7","5","2","2","1","1","0","0","0","67","36","31","0","0","0","1","1","0","6","0","6","-2"
"163851","Salisbury University","2010","Total full-time Instruction/research/public service, Non-tenured on tenure track, Instructors","5","2","3","0","0","0","0","0","0","1","1","0","1","0","1","0","0","0","2","1","1","0","0","0","0","0","0","1","0","1","-2"
"163851","Salisbury University","2010","Total full-time Instruction/research/public service, Non-tenured on tenure track total","96","50","46","1","0","1","6","5","1","8","6","2","3","1","2","0","0","0","70","37","33","0","0","0","1","1","0","7","0","7","-2"
"163851","Salisbury University","2010","Total full-time Instruction/research/public service, Non-tenured not on tenure track, Lecturers","87","36","51","0","0","0","3","1","2","4","3","1","1","0","1","0","0","0","79","32","47","0","0","0","0","0","0","0","0","0","-2"
"163851","Salisbury University","2010","Total full-time Instruction/research/public service, Non-tenured not on tenure track, No academic rank","11","4","7","0","0","0","1","0","1","0","0","0","0","0","0","0","0","0","10","4","6","0","0","0","0","0","0","0","0","0","-2"
"163851","Salisbury University","2010","Total full-time Instruction/research/public service, Non-tenured not on tenure track total","98","40","58","0","0","0","4","1","3","4","3","1","1","0","1","0","0","0","89","36","53","0","0","0","0","0","0","0","0","0","-2"
"166513","University of Massachusetts-Lowell","2010","Total full-time Instruction/research/public service, Tenured, Professors","175","137","38","0","0","0","25","21","4","3","1","2","3","2","1","0","0","0","143","112","31","0","0","0","1","1","0","0","0","0","-2"
"166513","University of Massachusetts-Lowell","2010","Total full-time Instruction/research/public service, Tenured, Associate professors","93","49","44","1","1","0","15","9","6","2","2","0","2","1","1","0","0","0","73","36","37","0","0","0","0","0","0","0","0","0","-2"
"166513","University of Massachusetts-Lowell","2010","Total full-time Instruction/research/public service, Tenured total","268","186","82","1","1","0","40","30","10","5","3","2","5","3","2","0","0","0","216","148","68","0","0","0","1","1","0","0","0","0","-2"
"166513","University of Massachusetts-Lowell","2010","Total full-time Instruction/research/public service, Non-tenured on tenure track, Associate professors","9","5","4","0","0","0","3","3","0","0","0","0","0","0","0","0","0","0","6","2","4","0","0","0","0","0","0","0","0","0","-2"
"166513","University of Massachusetts-Lowell","2010","Total full-time Instruction/research/public service, Non-tenured on tenure track, Assistant professors","115","63","52","0","0","0","25","16","9","2","1","1","4","3","1","0","0","0","82","43","39","0","0","0","2","0","2","0","0","0","-2"
"166513","University of Massachusetts-Lowell","2010","Total full-time Instruction/research/public service, Non-tenured on tenure track total","124","68","56","0","0","0","28","19","9","2","1","1","4","3","1","0","0","0","88","45","43","0","0","0","2","0","2","0","0","0","-2"
"166513","University of Massachusetts-Lowell","2010","Total full-time Instruction/research/public service, Non-tenured not on tenure track, Professors","12","1","11","0","0","0","0","0","0","0","0","0","0","0","0","0","0","0","11","1","10","0","0","0","1","0","1","0","0","0","-2"
"166513","University of Massachusetts-Lowell","2010","Total full-time Instruction/research/public service, Non-tenured not on tenure track, Associate professors","1","1","0","0","0","0","0","0","0","0","0","0","0","0","0","0","0","0","1","1","0","0","0","0","0","0","0","0","0","0","-2"
"166513","University of Massachusetts-Lowell","2010","Total full-time Instruction/research/public servicey, Non-tenured not on tenure track, Assistant professors","16","5","11","0","0","0","0","0","0","0","0","0","0","0","0","0","0","0","14","4","10","0","0","0","2","1","1","0","0","0","-2"
"166513","University of Massachusetts-Lowell","2010","Total full-time Instruction/research/public service, Non-tenured not on tenure track, Instructors","5","3","2","0","0","0","1","1","0","0","0","0","0","0","0","0","0","0","4","2","2","0","0","0","0","0","0","0","0","0","-2"
"166513","University of Massachusetts-Lowell","2010","Total full-time Instruction/research/public service, Non-tenured not on tenure track, Lecturers","8","3","5","0","0","0","1","1","0","0","0","0","1","1","0","0","0","0","5","1","4","0","0","0","1","0","1","0","0","0","-2"
"166513","University of Massachusetts-Lowell","2010","Total full-time Instruction/research/public service, Non-tenured not on tenure track total","42","13","29","0","0","0","2","2","0","0","0","0","1","1","0","0","0","0","35","9","26","0","0","0","4","1","3","0","0","0","-2"
"166629","University of Massachusetts-Amherst","2010","Total full-time Instruction/research/public service, Tenured, Professors","446","329","117","1","1","0","31","28","3","13","8","5","11","7","4","0","0","0","379","278","101","3","1","2","8","6","2","0","0","0","-2"
"166629","University of Massachusetts-Amherst","2010","Total full-time Instruction/research/public service, Tenured, Associate professors","270","153","117","1","1","0","30","18","12","9","6","3","14","7","7","0","0","0","205","114","91","3","2","1","8","5","3","0","0","0","-2"
"166629","University of Massachusetts-Amherst","2010","Total full-time Instruction/research/public service, Tenured, Assistant professors","1","0","1","0","0","0","0","0","0","0","0","0","0","0","0","0","0","0","1","0","1","0","0","0","0","0","0","0","0","0","-2"
"166629","University of Massachusetts-Amherst","2010","Total full-time Instruction/research/public service, Tenured total","717","482","235","2","2","0","61","46","15","22","14","8","25","14","11","0","0","0","585","392","193","6","3","3","16","11","5","0","0","0","-2"
"166629","University of Massachusetts-Amherst","2010","Total full-time Instruction/research/public service, Non-tenured on tenure track, Professors","2","1","1","0","0","0","0","0","0","0","0","0","0","0","0","0","0","0","2","1","1","0","0","0","0","0","0","0","0","0","-2"
"166629","University of Massachusetts-Amherst","2010","Total full-time Instruction/research/public service, Non-tenured on tenure track, Associate professors","7","6","1","0","0","0","0","0","0","0","0","0","0","0","0","0","0","0","6","5","1","0","0","0","0","0","0","1","1","0","-2"
"166629","University of Massachusetts-Amherst","2010","Total full-time Instruction/research/public service, Non-tenured on tenure track, Assistant professors","249","136","113","1","0","1","26","12","14","23","9","14","17","10","7","0","0","0","132","73","59","2","2","0","10","4","6","38","26","12","-2"
"166629","University of Massachusetts-Amherst","2010","Total full-time Instruction/research/public service, Non-tenured on tenure track total","258","143","115","1","0","1","26","12","14","23","9","14","17","10","7","0","0","0","140","79","61","2","2","0","10","4","6","39","27","12","-2"
"166629","University of Massachusetts-Amherst","2010","Total full-time Instruction/research/public service, Non-tenured not on tenure track, Professors","6","4","2","0","0","0","0","0","0","0","0","0","0","0","0","0","0","0","6","4","2","0","0","0","0","0","0","0","0","0","-2"
"166629","University of Massachusetts-Amherst","2010","Total full-time Instruction/research/public service, Non-tenured not on tenure track, Associate professors","15","9","6","0","0","0","1","1","0","0","0","0","1","0","1","0","0","0","12","8","4","0","0","0","1","0","1","0","0","0","-2"
"166629","University of Massachusetts-Amherst","2010","Total full-time Instruction/research/public servicey, Non-tenured not on tenure track, Assistant professors","25","10","15","0","0","0","3","2","1","3","1","2","1","0","1","0","0","0","16","6","10","0","0","0","1","0","1","1","1","0","-2"
"166629","University of Massachusetts-Amherst","2010","Total full-time Instruction/research/public service, Non-tenured not on tenure track, Lecturers","208","109","99","3","0","3","7","4","3","7","4","3","3","0","3","0","0","0","160","83","77","3","2","1","7","6","1","18","10","8","-2"
"166629","University of Massachusetts-Amherst","2010","Total full-time Instruction/research/public service, Non-tenured not on tenure track total","254","132","122","3","0","3","11","7","4","10","5","5","5","0","5","0","0","0","194","101","93","3","2","1","9","6","3","19","11","8","-2"
"166683","Massachusetts Institute of Technology","2010","Total full-time Instruction/research/public service, Tenured, Professors","607","510","97","0","0","0","55","49","6","11","9","2","8","8","0","0","0","0","510","425","85","1","1","0","21","18","3","1","0","1","-2"
"166683","Massachusetts Institute of Technology","2010","Total full-time Instruction/research/public service, Tenured, Associate professors","130","101","29","0","0","0","23","16","7","6","5","1","3","3","0","0","0","0","88","72","16","2","0","2","4","3","1","4","2","2","-2"
"166683","Massachusetts Institute of Technology","2010","Total full-time Instruction/research/public service, Tenured total","737","611","126","0","0","0","78","65","13","17","14","3","11","11","0","0","0","0","598","497","101","3","1","2","25","21","4","5","2","3","-2"
"166683","Massachusetts Institute of Technology","2010","Total full-time Instruction/research/public service, Non-tenured on tenure track, Associate professors","70","52","18","0","0","0","8","5","3","5","3","2","5","5","0","0","0","0","43","31","12","2","2","0","3","2","1","4","4","0","-2"
"166683","Massachusetts Institute of Technology","2010","Total full-time Instruction/research/public service, Non-tenured on tenure track, Assistant professors","158","100","58","1","0","1","16","9","7","6","2","4","8","8","0","0","0","0","68","45","23","4","4","0","19","9","10","36","23","13","-2"
"166683","Massachusetts Institute of Technology","2010","Total full-time Instruction/research/public service, Non-tenured on tenure track total","228","152","76","1","0","1","24","14","10","11","5","6","13","13","0","0","0","0","111","76","35","6","6","0","22","11","11","40","27","13","-2"
"166683","Massachusetts Institute of Technology","2010","Total full-time Instruction/research/public service, Non-tenured not on tenure track, Professors","1","1","0","0","0","0","0","0","0","0","0","0","0","0","0","0","0","0","1","1","0","0","0","0","0","0","0","0","0","0","-2"
"166683","Massachusetts Institute of Technology","2010","Total full-time Instruction/research/public service, Non-tenured not on tenure track, Associate professors","8","4","4","0","0","0","1","0","1","1","1","0","0","0","0","0","0","0","6","3","3","0","0","0","0","0","0","0","0","0","-2"
"166683","Massachusetts Institute of Technology","2010","Total full-time Instruction/research/public service, Non-tenured not on tenure track total","9","5","4","0","0","0","1","0","1","1","1","0","0","0","0","0","0","0","7","4","3","0","0","0","0","0","0","0","0","0","-2"
"169248","Central Michigan University","2010","Total full-time Instruction/research/public service, Tenured, Professors","275","196","79","1","1","0","32","24","8","12","6","6","6","4","2","0","0","0","224","161","63","0","0","0","0","0","0","0","0","0","-2"
"169248","Central Michigan University","2010","Total full-time Instruction/research/public service, Tenured, Associate professors","133","73","60","1","1","0","10","6","4","2","1","1","7","4","3","0","0","0","111","59","52","1","1","0","0","0","0","1","1","0","-2"
"169248","Central Michigan University","2010","Total full-time Instruction/research/public service, Tenured, Assistant professors","16","7","9","0","0","0","0","0","0","2","2","0","0","0","0","0","0","0","14","5","9","0","0","0","0","0","0","0","0","0","-2"
"169248","Central Michigan University","2010","Total full-time Instruction/research/public service, Tenured total","424","276","148","2","2","0","42","30","12","16","9","7","13","8","5","0","0","0","349","225","124","1","1","0","0","0","0","1","1","0","-2"
"169248","Central Michigan University","2010","Total full-time Instruction/research/public service, Non-tenured on tenure track, Professors","3","3","0","0","0","0","0","0","0","0","0","0","0","0","0","0","0","0","3","3","0","0","0","0","0","0","0","0","0","0","-2"
"169248","Central Michigan University","2010","Total full-time Instruction/research/public service, Non-tenured on tenure track, Associate professors","8","5","3","0","0","0","1","1","0","0","0","0","0","0","0","0","0","0","7","4","3","0","0","0","0","0","0","0","0","0","-2"
"169248","Central Michigan University","2010","Total full-time Instruction/research/public service, Non-tenured on tenure track, Assistant professors","145","75","70","0","0","0","11","4","7","3","1","2","7","4","3","0","0","0","102","58","44","5","3","2","1","0","1","16","5","11","-2"
"169248","Central Michigan University","2010","Total full-time Instruction/research/public service, Non-tenured on tenure track, Instructors","2","0","2","0","0","0","0","0","0","0","0","0","0","0","0","0","0","0","2","0","2","0","0","0","0","0","0","0","0","0","-2"
"169248","Central Michigan University","2010","Total full-time Instruction/research/public service, Non-tenured on tenure track total","158","83","75","0","0","0","12","5","7","3","1","2","7","4","3","0","0","0","114","65","49","5","3","2","1","0","1","16","5","11","-2"
"169248","Central Michigan University","2010","Total full-time Instruction/research/public service, Non-tenured not on tenure track, Professors","3","2","1","0","0","0","1","1","0","0","0","0","1","0","1","0","0","0","1","1","0","0","0","0","0","0","0","0","0","0","-2"
"169248","Central Michigan University","2010","Total full-time Instruction/research/public service, Non-tenured not on tenure track, Associate professors","10","9","1","1","1","0","0","0","0","0","0","0","0","0","0","0","0","0","8","7","1","0","0","0","1","1","0","0","0","0","-2"
"169248","Central Michigan University","2010","Total full-time Instruction/research/public servicey, Non-tenured not on tenure track, Assistant professors","69","46","23","0","0","0","5","4","1","1","0","1","4","1","3","0","0","0","59","41","18","0","0","0","0","0","0","0","0","0","-2"
"169248","Central Michigan University","2010","Total full-time Instruction/research/public service, Non-tenured not on tenure track, Instructors","122","45","77","3","2","1","5","2","3","2","1","1","3","1","2","0","0","0","108","38","70","0","0","0","1","1","0","0","0","0","-2"
"169248","Central Michigan University","2010","Total full-time Instruction/research/public service, Non-tenured not on tenure track total","204","102","102","4","3","1","11","7","4","3","1","2","8","2","6","0","0","0","176","87","89","0","0","0","2","2","0","0","0","0","-2"
"170976","University of Michigan-Ann Arbor","2010","Total full-time Instruction/research/public service, Tenured, Professors","1288","1005","283","4","3","1","130","107","23","55","39","16","31","20","11","0","0","0","1039","815","224","8","4","4","7","6","1","14","11","3","-2"
"170976","University of Michigan-Ann Arbor","2010","Total full-time Instruction/research/public service, Tenured, Associate professors","649","403","246","3","1","2","88","55","33","38","17","21","35","22","13","2","1","1","453","290","163","7","4","3","4","3","1","19","10","9","-2"
"170976","University of Michigan-Ann Arbor","2010","Total full-time Instruction/research/public service, Tenured total","1937","1408","529","7","4","3","218","162","56","93","56","37","66","42","24","2","1","1","1492","1105","387","15","8","7","11","9","2","33","21","12","-2"
"170976","University of Michigan-Ann Arbor","2010","Total full-time Instruction/research/public service, Non-tenured on tenure track, Professors","6","5","1","0","0","0","0","0","0","0","0","0","0","0","0","0","0","0","6","5","1","0","0","0","0","0","0","0","0","0","-2"
"170976","University of Michigan-Ann Arbor","2010","Total full-time Instruction/research/public service, Non-tenured on tenure track, Associate professors","26","20","6","0","0","0","7","5","2","1","1","0","2","2","0","0","0","0","11","8","3","1","1","0","0","0","0","4","3","1","-2"
"170976","University of Michigan-Ann Arbor","2010","Total full-time Instruction/research/public service, Non-tenured on tenure track, Assistant professors","587","364","223","2","1","1","91","64","27","26","14","12","22","16","6","0","0","0","349","212","137","4","3","1","5","5","0","88","49","39","-2"
"170976","University of Michigan-Ann Arbor","2010","Total full-time Instruction/research/public service, Non-tenured on tenure track, Instructors","1","0","1","0","0","0","0","0","0","0","0","0","0","0","0","0","0","0","1","0","1","0","0","0","0","0","0","0","0","0","-2"
"170976","University of Michigan-Ann Arbor","2010","Total full-time Instruction/research/public service, Non-tenured on tenure track total","620","389","231","2","1","1","98","69","29","27","15","12","24","18","6","0","0","0","367","225","142","5","4","1","5","5","0","92","52","40","-2"
"170976","University of Michigan-Ann Arbor","2010","Total full-time Instruction/research/public service, Non-tenured not on tenure track, Professors","154","113","41","0","0","0","6","5","1","0","0","0","6","4","2","0","0","0","133","98","35","0","0","0","0","0","0","9","6","3","-2"
"170976","University of Michigan-Ann Arbor","2010","Total full-time Instruction/research/public service, Non-tenured not on tenure track, Associate professors","185","118","67","0","0","0","33","21","12","4","1","3","9","6","3","0","0","0","128","83","45","4","2","2","1","1","0","6","4","2","-2"
"170976","University of Michigan-Ann Arbor","2010","Total full-time Instruction/research/public servicey, Non-tenured not on tenure track, Assistant professors","585","329","256","1","1","0","115","70","45","17","6","11","12","4","8","0","0","0","362","200","162","10","3","7","10","6","4","58","39","19","-2"
"170976","University of Michigan-Ann Arbor","2010","Total full-time Instruction/research/public service, Non-tenured not on tenure track, Instructors","120","59","61","1","0","1","24","11","13","6","3","3","4","0","4","0","0","0","67","31","36","0","0","0","4","2","2","14","12","2","-2"
"170976","University of Michigan-Ann Arbor","2010","Total full-time Instruction/research/public service, Non-tenured not on tenure track, Lecturers","621","287","334","3","2","1","73","29","44","18","7","11","27","7","20","0","0","0","420","194","226","12","5","7","8","7","1","60","36","24","-2"
"170976","University of Michigan-Ann Arbor","2010","Total full-time Instruction/research/public service, Non-tenured not on tenure track, No academic rank","1471","918","553","0","0","0","154","89","65","28","10","18","31","15","16","1","0","1","475","264","211","15","6","9","7","5","2","760","529","231","-2"
"170976","University of Michigan-Ann Arbor","2010","Total full-time Instruction/research/public service, Non-tenured not on tenure track total","3136","1824","1312","5","3","2","405","225","180","73","27","46","89","36","53","1","0","1","1585","870","715","41","16","25","30","21","9","907","626","281","-2"
"171100","Michigan State University","2010","Total full-time Instruction/research/public service, Tenured, Professors","919","715","204","7","7","0","86","72","14","30","21","9","15","12","3","1","1","0","778","601","177","2","1","1","0","0","0","0","0","0","-2"
"171100","Michigan State University","2010","Total full-time Instruction/research/public service, Tenured, Associate professors","537","328","209","5","1","4","72","45","27","28","20","8","20","10","10","0","0","0","408","250","158","2","0","2","0","0","0","2","2","0","-2"
"171100","Michigan State University","2010","Total full-time Instruction/research/public service, Tenured, Assistant professors","1","0","1","0","0","0","0","0","0","0","0","0","0","0","0","0","0","0","1","0","1","0","0","0","0","0","0","0","0","0","-2"
"171100","Michigan State University","2010","Total full-time Instruction/research/public service, Tenured total","1457","1043","414","12","8","4","158","117","41","58","41","17","35","22","13","1","1","0","1187","851","336","4","1","3","0","0","0","2","2","0","-2"
"171100","Michigan State University","2010","Total full-time Instruction/research/public service, Non-tenured on tenure track, Associate professors","11","7","4","0","0","0","2","1","1","2","2","0","1","0","1","0","0","0","6","4","2","0","0","0","0","0","0","0","0","0","-2"
"171100","Michigan State University","2010","Total full-time Instruction/research/public service, Non-tenured on tenure track, Assistant professors","412","228","184","4","4","0","47","28","19","13","5","8","25","12","13","1","1","0","246","130","116","1","0","1","0","0","0","75","48","27","-2"
"171100","Michigan State University","2010","Total full-time Instruction/research/public service, Non-tenured on tenure track total","423","235","188","4","4","0","49","29","20","15","7","8","26","12","14","1","1","0","252","134","118","1","0","1","0","0","0","75","48","27","-2"
"171100","Michigan State University","2010","Total full-time Instruction/research/public service, Non-tenured not on tenure track, Professors","49","41","8","0","0","0","4","2","2","4","4","0","1","1","0","0","0","0","38","32","6","0","0","0","0","0","0","2","2","0","-2"
"171100","Michigan State University","2010","Total full-time Instruction/research/public service, Non-tenured not on tenure track, Associate professors","100","67","33","0","0","0","12","8","4","4","2","2","2","1","1","0","0","0","78","53","25","0","0","0","0","0","0","4","3","1","-2"
"171100","Michigan State University","2010","Total full-time Instruction/research/public servicey, Non-tenured not on tenure track, Assistant professors","334","184","150","2","1","1","47","27","20","16","9","7","11","6","5","0","0","0","208","104","104","0","0","0","0","0","0","50","37","13","-2"
"171100","Michigan State University","2010","Total full-time Instruction/research/public service, Non-tenured not on tenure track, Instructors","188","75","113","1","1","0","6","3","3","4","3","1","4","1","3","0","0","0","140","51","89","0","0","0","0","0","0","33","16","17","-2"
"171100","Michigan State University","2010","Total full-time Instruction/research/public service, Non-tenured not on tenure track total","671","367","304","3","2","1","69","40","29","28","18","10","18","9","9","0","0","0","464","240","224","0","0","0","0","0","0","89","58","31","-2"
"174066","University of Minnesota-Twin Cities","2010","Total full-time Instruction/research/public service, Tenured, Professors","1044","798","246","2","1","1","97","84","13","14","10","4","23","17","6","0","0","0","901","682","219","2","1","1","1","0","1","4","3","1","174066"
"174066","University of Minnesota-Twin Cities","2010","Total full-time Instruction/research/public service, Tenured, Associate professors","637","372","265","4","2","2","75","53","22","23","14","9","17","8","9","0","0","0","503","283","220","7","4","3","0","0","0","8","8","0","174066"
"174066","University of Minnesota-Twin Cities","2010","Total full-time Instruction/research/public service, Tenured, Assistant professors","7","3","4","0","0","0","0","0","0","0","0","0","0","0","0","0","0","0","7","3","4","0","0","0","0","0","0","0","0","0","174066"
"174066","University of Minnesota-Twin Cities","2010","Total full-time Instruction/research/public service, Tenured total","1688","1173","515","6","3","3","172","137","35","37","24","13","40","25","15","0","0","0","1411","968","443","9","5","4","1","0","1","12","11","1","174066"
"174066","University of Minnesota-Twin Cities","2010","Total full-time Instruction/research/public service, Non-tenured on tenure track, Professors","2","2","0","0","0","0","0","0","0","0","0","0","0","0","0","0","0","0","2","2","0","0","0","0","0","0","0","0","0","0","174066"
"174066","University of Minnesota-Twin Cities","2010","Total full-time Instruction/research/public service, Non-tenured on tenure track, Associate professors","21","13","8","0","0","0","1","1","0","0","0","0","1","0","1","0","0","0","18","11","7","0","0","0","0","0","0","1","1","0","174066"
"174066","University of Minnesota-Twin Cities","2010","Total full-time Instruction/research/public service, Non-tenured on tenure track, Assistant professors","413","238","175","1","0","1","57","33","24","17","5","12","12","5","7","1","0","1","263","153","110","4","3","1","2","1","1","56","38","18","174066"
"174066","University of Minnesota-Twin Cities","2010","Total full-time Instruction/research/public service, Non-tenured on tenure track, Instructors","1","1","0","0","0","0","0","0","0","0","0","0","0","0","0","0","0","0","1","1","0","0","0","0","0","0","0","0","0","0","174066"
"174066","University of Minnesota-Twin Cities","2010","Total full-time Instruction/research/public service, Non-tenured on tenure track total","437","254","183","1","0","1","58","34","24","17","5","12","13","5","8","1","0","1","284","167","117","4","3","1","2","1","1","57","39","18","174066"
"174066","University of Minnesota-Twin Cities","2010","Total full-time Instruction/research/public service, Non-tenured not on tenure track, Professors","32","26","6","0","0","0","3","2","1","0","0","0","1","1","0","0","0","0","25","20","5","0","0","0","1","1","0","2","2","0","174066"
"174066","University of Minnesota-Twin Cities","2010","Total full-time Instruction/research/public service, Non-tenured not on tenure track, Associate professors","95","68","27","0","0","0","13","13","0","4","3","1","1","0","1","0","0","0","71","50","21","0","0","0","0","0","0","6","2","4","174066"
"174066","University of Minnesota-Twin Cities","2010","Total full-time Instruction/research/public servicey, Non-tenured not on tenure track, Assistant professors","227","117","110","3","1","2","28","14","14","7","4","3","10","6","4","0","0","0","152","72","80","1","0","1","2","0","2","24","20","4","174066"
"174066","University of Minnesota-Twin Cities","2010","Total full-time Instruction/research/public service, Non-tenured not on tenure track, Instructors","23","11","12","1","0","1","2","1","1","1","1","0","0","0","0","0","0","0","17","7","10","0","0","0","0","0","0","2","2","0","174066"
"174066","University of Minnesota-Twin Cities","2010","Total full-time Instruction/research/public service, Non-tenured not on tenure track total","377","222","155","4","1","3","46","30","16","12","8","4","12","7","5","0","0","0","265","149","116","1","0","1","3","1","2","34","26","8","174066"
"174783","Saint Cloud State University","2010","Total full-time Instruction/research/public service, Tenured, Professors","241","145","96","2","2","0","27","19","8","11","10","1","8","4","4","0","0","0","188","106","82","1","1","0","2","1","1","2","2","0","-2"
"174783","Saint Cloud State University","2010","Total full-time Instruction/research/public service, Tenured, Associate professors","115","67","48","1","0","1","15","12","3","3","3","0","5","1","4","0","0","0","85","50","35","1","0","1","3","0","3","2","1","1","-2"
"174783","Saint Cloud State University","2010","Total full-time Instruction/research/public service, Tenured, Assistant professors","14","11","3","0","0","0","0","0","0","0","0","0","1","1","0","0","0","0","13","10","3","0","0","0","0","0","0","0","0","0","-2"
"174783","Saint Cloud State University","2010","Total full-time Instruction/research/public service, Tenured total","370","223","147","3","2","1","42","31","11","14","13","1","14","6","8","0","0","0","286","166","120","2","1","1","5","1","4","4","3","1","-2"
"174783","Saint Cloud State University","2010","Total full-time Instruction/research/public service, Non-tenured on tenure track, Professors","3","1","2","0","0","0","0","0","0","0","0","0","0","0","0","0","0","0","3","1","2","0","0","0","0","0","0","0","0","0","-2"
"174783","Saint Cloud State University","2010","Total full-time Instruction/research/public service, Non-tenured on tenure track, Associate professors","12","8","4","0","0","0","2","1","1","1","0","1","0","0","0","0","0","0","8","6","2","0","0","0","1","1","0","0","0","0","-2"
"174783","Saint Cloud State University","2010","Total full-time Instruction/research/public service, Non-tenured on tenure track, Assistant professors","87","35","52","1","0","1","15","4","11","2","2","0","3","1","2","0","0","0","48","18","30","0","0","0","3","1","2","15","9","6","-2"
"174783","Saint Cloud State University","2010","Total full-time Instruction/research/public service, Non-tenured on tenure track, Instructors","2","1","1","0","0","0","0","0","0","0","0","0","1","1","0","0","0","0","1","0","1","0","0","0","0","0","0","0","0","0","-2"
"174783","Saint Cloud State University","2010","Total full-time Instruction/research/public service, Non-tenured on tenure track total","104","45","59","1","0","1","17","5","12","3","2","1","4","2","2","0","0","0","60","25","35","0","0","0","4","2","2","15","9","6","-2"
"174783","Saint Cloud State University","2010","Total full-time Instruction/research/public service, Non-tenured not on tenure track, Professors","1","0","1","0","0","0","0","0","0","0","0","0","0","0","0","0","0","0","1","0","1","0","0","0","0","0","0","0","0","0","-2"
"174783","Saint Cloud State University","2010","Total full-time Instruction/research/public service, Non-tenured not on tenure track, Associate professors","11","4","7","0","0","0","0","0","0","0","0","0","0","0","0","0","0","0","11","4","7","0","0","0","0","0","0","0","0","0","-2"
"174783","Saint Cloud State University","2010","Total full-time Instruction/research/public servicey, Non-tenured not on tenure track, Assistant professors","34","14","20","0","0","0","3","2","1","1","0","1","1","1","0","0","0","0","28","10","18","0","0","0","1","1","0","0","0","0","-2"
"174783","Saint Cloud State University","2010","Total full-time Instruction/research/public service, Non-tenured not on tenure track, Instructors","16","5","11","1","0","1","1","1","0","0","0","0","1","0","1","0","0","0","13","4","9","0","0","0","0","0","0","0","0","0","-2"
"174783","Saint Cloud State University","2010","Total full-time Instruction/research/public service, Non-tenured not on tenure track total","62","23","39","1","0","1","4","3","1","1","0","1","2","1","1","0","0","0","53","18","35","0","0","0","1","1","0","0","0","0","-2"
"176017","University of Mississippi","2010","Total full-time Instruction/research/public service, Tenured, Professors","147","121","26","2","2","0","1","1","0","5","2","3","1","1","0","0","0","0","132","109","23","6","6","0","0","0","0","0","0","0","-2"
"176017","University of Mississippi","2010","Total full-time Instruction/research/public service, Tenured, Associate professors","195","116","79","0","0","0","2","1","1","13","6","7","1","1","0","0","0","0","165","95","70","10","9","1","0","0","0","4","4","0","-2"
"176017","University of Mississippi","2010","Total full-time Instruction/research/public service, Tenured, Assistant professors","4","2","2","0","0","0","0","0","0","0","0","0","0","0","0","0","0","0","2","2","0","1","0","1","0","0","0","1","0","1","-2"
"176017","University of Mississippi","2010","Total full-time Instruction/research/public service, Tenured total","346","239","107","2","2","0","3","2","1","18","8","10","2","2","0","0","0","0","299","206","93","17","15","2","0","0","0","5","4","1","-2"
"176017","University of Mississippi","2010","Total full-time Instruction/research/public service, Non-tenured on tenure track, Associate professors","4","1","3","0","0","0","0","0","0","1","0","1","0","0","0","0","0","0","3","1","2","0","0","0","0","0","0","0","0","0","-2"
"176017","University of Mississippi","2010","Total full-time Instruction/research/public service, Non-tenured on tenure track, Assistant professors","151","92","59","0","0","0","3","2","1","17","7","10","2","1","1","0","0","0","106","66","40","8","5","3","0","0","0","15","11","4","-2"
"176017","University of Mississippi","2010","Total full-time Instruction/research/public service, Non-tenured on tenure track total","155","93","62","0","0","0","3","2","1","18","7","11","2","1","1","0","0","0","109","67","42","8","5","3","0","0","0","15","11","4","-2"
"176017","University of Mississippi","2010","Total full-time Instruction/research/public service, Non-tenured not on tenure track, Professors","17","16","1","1","1","0","1","1","0","0","0","0","0","0","0","0","0","0","13","12","1","2","2","0","0","0","0","0","0","0","-2"
"176017","University of Mississippi","2010","Total full-time Instruction/research/public service, Non-tenured not on tenure track, Associate professors","11","6","5","0","0","0","2","2","0","0","0","0","0","0","0","0","0","0","7","3","4","1","0","1","0","0","0","1","1","0","-2"
"176017","University of Mississippi","2010","Total full-time Instruction/research/public servicey, Non-tenured not on tenure track, Assistant professors","53","30","23","0","0","0","2","2","0","2","1","1","0","0","0","0","0","0","42","22","20","0","0","0","0","0","0","7","5","2","-2"
"176017","University of Mississippi","2010","Total full-time Instruction/research/public service, Non-tenured not on tenure track, Instructors","139","50","89","0","0","0","3","1","2","4","0","4","6","0","6","0","0","0","113","42","71","4","2","2","0","0","0","9","5","4","-2"
"176017","University of Mississippi","2010","Total full-time Instruction/research/public service, Non-tenured not on tenure track, Lecturers","14","5","9","0","0","0","0","0","0","1","0","1","0","0","0","0","0","0","13","5","8","0","0","0","0","0","0","0","0","0","-2"
"176017","University of Mississippi","2010","Total full-time Instruction/research/public service, Non-tenured not on tenure track total","234","107","127","1","1","0","8","6","2","7","1","6","6","0","6","0","0","0","188","84","104","7","4","3","0","0","0","17","11","6","-2"
"176044","Mississippi Valley State University","2010","Total full-time Instruction/research/public service, Tenured, Professors","11","11","0","0","0","0","4","4","0","5","5","0","0","0","0","0","0","0","2","2","0","0","0","0","0","0","0","0","0","0","-2"
"176044","Mississippi Valley State University","2010","Total full-time Instruction/research/public service, Tenured, Associate professors","23","13","10","0","0","0","3","0","3","14","10","4","1","0","1","0","0","0","5","3","2","0","0","0","0","0","0","0","0","0","-2"
"176044","Mississippi Valley State University","2010","Total full-time Instruction/research/public service, Tenured, Assistant professors","15","5","10","0","0","0","1","1","0","14","4","10","0","0","0","0","0","0","0","0","0","0","0","0","0","0","0","0","0","0","-2"
"176044","Mississippi Valley State University","2010","Total full-time Instruction/research/public service, Tenured total","49","29","20","0","0","0","8","5","3","33","19","14","1","0","1","0","0","0","7","5","2","0","0","0","0","0","0","0","0","0","-2"
"176044","Mississippi Valley State University","2010","Total full-time Instruction/research/public service, Non-tenured on tenure track, Professors","5","3","2","0","0","0","1","1","0","3","2","1","0","0","0","0","0","0","1","0","1","0","0","0","0","0","0","0","0","0","-2"
"176044","Mississippi Valley State University","2010","Total full-time Instruction/research/public service, Non-tenured on tenure track, Associate professors","8","6","2","0","0","0","1","1","0","7","5","2","0","0","0","0","0","0","0","0","0","0","0","0","0","0","0","0","0","0","-2"
"176044","Mississippi Valley State University","2010","Total full-time Instruction/research/public service, Non-tenured on tenure track, Assistant professors","40","22","18","0","0","0","6","6","0","26","12","14","0","0","0","0","0","0","8","4","4","0","0","0","0","0","0","0","0","0","-2"
"176044","Mississippi Valley State University","2010","Total full-time Instruction/research/public service, Non-tenured on tenure track total","53","31","22","0","0","0","8","8","0","36","19","17","0","0","0","0","0","0","9","4","5","0","0","0","0","0","0","0","0","0","-2"
"176044","Mississippi Valley State University","2010","Total full-time Instruction/research/public service, Non-tenured not on tenure track, Instructors","24","9","15","0","0","0","1","0","1","20","7","13","0","0","0","0","0","0","3","2","1","0","0","0","0","0","0","0","0","0","-2"
"176044","Mississippi Valley State University","2010","Total full-time Instruction/research/public service, Non-tenured not on tenure track total","24","9","15","0","0","0","1","0","1","20","7","13","0","0","0","0","0","0","3","2","1","0","0","0","0","0","0","0","0","0","-2"
"176080","Mississippi State University","2010","Total full-time Instruction/research/public service, Tenured, Professors","221","182","39","0","0","0","15","15","0","7","5","2","6","6","0","0","0","0","193","156","37","0","0","0","0","0","0","0","0","0","-2"
"176080","Mississippi State University","2010","Total full-time Instruction/research/public service, Tenured, Associate professors","176","118","58","0","0","0","22","12","10","9","1","8","3","3","0","0","0","0","138","100","38","3","1","2","0","0","0","1","1","0","-2"
"176080","Mississippi State University","2010","Total full-time Instruction/research/public service, Tenured, Assistant professors","4","2","2","0","0","0","0","0","0","0","0","0","0","0","0","0","0","0","4","2","2","0","0","0","0","0","0","0","0","0","-2"
"176080","Mississippi State University","2010","Total full-time Instruction/research/public service, Tenured total","401","302","99","0","0","0","37","27","10","16","6","10","9","9","0","0","0","0","335","258","77","3","1","2","0","0","0","1","1","0","-2"
"176080","Mississippi State University","2010","Total full-time Instruction/research/public service, Non-tenured on tenure track, Professors","1","1","0","0","0","0","0","0","0","0","0","0","0","0","0","0","0","0","1","1","0","0","0","0","0","0","0","0","0","0","-2"
"176080","Mississippi State University","2010","Total full-time Instruction/research/public service, Non-tenured on tenure track, Associate professors","7","6","1","0","0","0","1","1","0","0","0","0","0","0","0","0","0","0","4","3","1","0","0","0","0","0","0","2","2","0","-2"
"176080","Mississippi State University","2010","Total full-time Instruction/research/public service, Non-tenured on tenure track, Assistant professors","255","170","85","1","0","1","21","19","2","15","5","10","2","2","0","0","0","0","190","122","68","3","2","1","0","0","0","23","20","3","-2"
"176080","Mississippi State University","2010","Total full-time Instruction/research/public service, Non-tenured on tenure track total","263","177","86","1","0","1","22","20","2","15","5","10","2","2","0","0","0","0","195","126","69","3","2","1","0","0","0","25","22","3","-2"
"176080","Mississippi State University","2010","Total full-time Instruction/research/public service, Non-tenured not on tenure track, Professors","57","43","14","0","0","0","6","6","0","2","1","1","1","1","0","0","0","0","48","35","13","0","0","0","0","0","0","0","0","0","-2"
"176080","Mississippi State University","2010","Total full-time Instruction/research/public service, Non-tenured not on tenure track, Associate professors","50","38","12","0","0","0","4","4","0","1","1","0","2","2","0","0","0","0","42","30","12","0","0","0","0","0","0","1","1","0","-2"
"176080","Mississippi State University","2010","Total full-time Instruction/research/public servicey, Non-tenured not on tenure track, Assistant professors","115","83","32","0","0","0","13","8","5","3","1","2","5","5","0","0","0","0","76","52","24","0","0","0","0","0","0","18","17","1","-2"
"176080","Mississippi State University","2010","Total full-time Instruction/research/public service, Non-tenured not on tenure track, Instructors","149","57","92","1","1","0","3","1","2","6","2","4","2","0","2","1","0","1","133","51","82","2","1","1","0","0","0","1","1","0","-2"
"176080","Mississippi State University","2010","Total full-time Instruction/research/public service, Non-tenured not on tenure track, Lecturers","49","18","31","0","0","0","2","0","2","0","0","0","3","0","3","0","0","0","42","17","25","0","0","0","0","0","0","2","1","1","-2"
"176080","Mississippi State University","2010","Total full-time Instruction/research/public service, Non-tenured not on tenure track total","420","239","181","1","1","0","28","19","9","12","5","7","13","8","5","1","0","1","341","185","156","2","1","1","0","0","0","22","20","2","-2"
"178396","University of Missouri-Columbia","2010","Total full-time Instruction/research/public service, Tenured, Professors","479","385","94","0","0","0","68","61","7","10","6","4","8","6","2","0","0","0","386","305","81","1","1","0","6","6","0","0","0","0","-2"
"178396","University of Missouri-Columbia","2010","Total full-time Instruction/research/public service, Tenured, Associate professors","374","253","121","0","0","0","37","31","6","10","5","5","12","8","4","1","1","0","314","208","106","0","0","0","0","0","0","0","0","0","-2"
"178396","University of Missouri-Columbia","2010","Total full-time Instruction/research/public service, Tenured, Assistant professors","3","0","3","0","0","0","1","0","1","0","0","0","0","0","0","0","0","0","1","0","1","0","0","0","0","0","0","1","0","1","-2"
"178396","University of Missouri-Columbia","2010","Total full-time Instruction/research/public service, Tenured total","856","638","218","0","0","0","106","92","14","20","11","9","20","14","6","1","1","0","701","513","188","1","1","0","6","6","0","1","0","1","-2"
"178396","University of Missouri-Columbia","2010","Total full-time Instruction/research/public service, Non-tenured on tenure track, Professors","3","2","1","0","0","0","1","0","1","0","0","0","0","0","0","0","0","0","2","2","0","0","0","0","0","0","0","0","0","0","-2"
"178396","University of Missouri-Columbia","2010","Total full-time Instruction/research/public service, Non-tenured on tenure track, Associate professors","30","22","8","0","0","0","3","3","0","1","1","0","2","1","1","0","0","0","22","16","6","0","0","0","1","1","0","1","0","1","-2"
"178396","University of Missouri-Columbia","2010","Total full-time Instruction/research/public service, Non-tenured on tenure track, Assistant professors","307","176","131","2","2","0","30","17","13","10","6","4","17","12","5","0","0","0","203","110","93","0","0","0","6","4","2","39","25","14","-2"
"178396","University of Missouri-Columbia","2010","Total full-time Instruction/research/public service, Non-tenured on tenure track, No academic rank","2","2","0","0","0","0","0","0","0","0","0","0","0","0","0","0","0","0","2","2","0","0","0","0","0","0","0","0","0","0","-2"
"178396","University of Missouri-Columbia","2010","Total full-time Instruction/research/public service, Non-tenured on tenure track total","342","202","140","2","2","0","34","20","14","11","7","4","19","13","6","0","0","0","229","130","99","0","0","0","7","5","2","40","25","15","-2"
"178396","University of Missouri-Columbia","2010","Total full-time Instruction/research/public service, Non-tenured not on tenure track, Professors","50","39","11","0","0","0","4","4","0","2","2","0","1","1","0","0","0","0","43","32","11","0","0","0","0","0","0","0","0","0","-2"
"178396","University of Missouri-Columbia","2010","Total full-time Instruction/research/public service, Non-tenured not on tenure track, Associate professors","152","85","67","0","0","0","9","5","4","2","1","1","2","0","2","0","0","0","134","75","59","0","0","0","1","1","0","4","3","1","-2"
"178396","University of Missouri-Columbia","2010","Total full-time Instruction/research/public servicey, Non-tenured not on tenure track, Assistant professors","404","225","179","2","1","1","49","31","18","7","3","4","9","5","4","0","0","0","300","159","141","2","1","1","0","0","0","35","25","10","-2"
"178396","University of Missouri-Columbia","2010","Total full-time Instruction/research/public service, Non-tenured not on tenure track, Instructors","126","44","82","2","0","2","5","2","3","1","1","0","3","0","3","0","0","0","113","40","73","0","0","0","0","0","0","2","1","1","-2"
"178396","University of Missouri-Columbia","2010","Total full-time Instruction/research/public service, Non-tenured not on tenure track, Lecturers","12","6","6","0","0","0","2","0","2","0","0","0","0","0","0","0","0","0","8","4","4","0","0","0","1","1","0","1","1","0","-2"
"178396","University of Missouri-Columbia","2010","Total full-time Instruction/research/public service, Non-tenured not on tenure track, No academic rank","1139","661","478","2","0","2","80","44","36","35","17","18","12","5","7","1","1","0","739","398","341","1","1","0","14","8","6","255","187","68","-2"
"178396","University of Missouri-Columbia","2010","Total full-time Instruction/research/public service, Non-tenured not on tenure track total","1883","1060","823","6","1","5","149","86","63","47","24","23","27","11","16","1","1","0","1337","708","629","3","2","1","16","10","6","297","217","80","-2"
"178411","Missouri University of Science and Technology","2010","Total full-time Instruction/research/public service, Tenured, Professors","119","106","13","0","0","0","24","23","1","3","2","1","2","2","0","0","0","0","84","73","11","1","1","0","0","0","0","5","5","0","-2"
"178411","Missouri University of Science and Technology","2010","Total full-time Instruction/research/public service, Tenured, Associate professors","87","75","12","0","0","0","17","15","2","1","1","0","1","1","0","0","0","0","64","55","9","2","2","0","0","0","0","2","1","1","-2"
"178411","Missouri University of Science and Technology","2010","Total full-time Instruction/research/public service, Tenured total","206","181","25","0","0","0","41","38","3","4","3","1","3","3","0","0","0","0","148","128","20","3","3","0","0","0","0","7","6","1","-2"
"178411","Missouri University of Science and Technology","2010","Total full-time Instruction/research/public service, Non-tenured on tenure track, Associate professors","4","4","0","0","0","0","1","1","0","0","0","0","0","0","0","0","0","0","3","3","0","0","0","0","0","0","0","0","0","0","-2"
"178411","Missouri University of Science and Technology","2010","Total full-time Instruction/research/public service, Non-tenured on tenure track, Assistant professors","68","45","23","0","0","0","14","11","3","0","0","0","4","3","1","0","0","0","28","16","12","0","0","0","0","0","0","22","15","7","-2"
"178411","Missouri University of Science and Technology","2010","Total full-time Instruction/research/public service, Non-tenured on tenure track total","72","49","23","0","0","0","15","12","3","0","0","0","4","3","1","0","0","0","31","19","12","0","0","0","0","0","0","22","15","7","-2"
"178411","Missouri University of Science and Technology","2010","Total full-time Instruction/research/public service, Non-tenured not on tenure track, Professors","2","1","1","0","0","0","1","0","1","0","0","0","0","0","0","0","0","0","1","1","0","0","0","0","0","0","0","0","0","0","-2"
"178411","Missouri University of Science and Technology","2010","Total full-time Instruction/research/public service, Non-tenured not on tenure track, Associate professors","11","9","2","0","0","0","2","2","0","0","0","0","0","0","0","0","0","0","8","6","2","0","0","0","0","0","0","1","1","0","-2"
"178411","Missouri University of Science and Technology","2010","Total full-time Instruction/research/public servicey, Non-tenured not on tenure track, Assistant professors","18","12","6","0","0","0","1","1","0","0","0","0","0","0","0","0","0","0","9","5","4","0","0","0","0","0","0","8","6","2","-2"
"178411","Missouri University of Science and Technology","2010","Total full-time Instruction/research/public service, Non-tenured not on tenure track, Instructors","7","2","5","0","0","0","0","0","0","0","0","0","0","0","0","0","0","0","7","2","5","0","0","0","0","0","0","0","0","0","-2"
"178411","Missouri University of Science and Technology","2010","Total full-time Instruction/research/public service, Non-tenured not on tenure track, Lecturers","23","13","10","0","0","0","0","0","0","0","0","0","1","0","1","0","0","0","21","12","9","0","0","0","0","0","0","1","1","0","-2"
"178411","Missouri University of Science and Technology","2010","Total full-time Instruction/research/public service, Non-tenured not on tenure track, No academic rank","29","25","4","0","0","0","1","1","0","0","0","0","0","0","0","0","0","0","11","8","3","0","0","0","0","0","0","17","16","1","-2"
"178411","Missouri University of Science and Technology","2010","Total full-time Instruction/research/public service, Non-tenured not on tenure track total","90","62","28","0","0","0","5","4","1","0","0","0","1","0","1","0","0","0","57","34","23","0","0","0","0","0","0","27","24","3","-2"
"179159","Saint Louis University","2010","Total full-time Instruction/research/public service, Tenured, Professors","292","237","55","0","0","0","19","16","3","3","2","1","5","4","1","0","0","0","251","204","47","3","3","0","0","0","0","11","8","3","-2"
"179159","Saint Louis University","2010","Total full-time Instruction/research/public service, Tenured, Associate professors","212","127","85","0","0","0","11","6","5","8","5","3","6","2","4","0","0","0","170","99","71","1","1","0","0","0","0","16","14","2","-2"
"179159","Saint Louis University","2010","Total full-time Instruction/research/public service, Tenured, Assistant professors","3","1","2","0","0","0","0","0","0","0","0","0","0","0","0","0","0","0","3","1","2","0","0","0","0","0","0","0","0","0","-2"
"179159","Saint Louis University","2010","Total full-time Instruction/research/public service, Tenured, Instructors","1","1","0","0","0","0","0","0","0","0","0","0","0","0","0","0","0","0","1","1","0","0","0","0","0","0","0","0","0","0","-2"
"179159","Saint Louis University","2010","Total full-time Instruction/research/public service, Tenured total","508","366","142","0","0","0","30","22","8","11","7","4","11","6","5","0","0","0","425","305","120","4","4","0","0","0","0","27","22","5","-2"
"179159","Saint Louis University","2010","Total full-time Instruction/research/public service, Non-tenured on tenure track, Professors","5","3","2","0","0","0","0","0","0","0","0","0","0","0","0","0","0","0","5","3","2","0","0","0","0","0","0","0","0","0","-2"
"179159","Saint Louis University","2010","Total full-time Instruction/research/public service, Non-tenured on tenure track, Associate professors","17","8","9","0","0","0","3","3","0","0","0","0","0","0","0","0","0","0","12","4","8","0","0","0","1","0","1","1","1","0","-2"
"179159","Saint Louis University","2010","Total full-time Instruction/research/public service, Non-tenured on tenure track, Assistant professors","190","101","89","0","0","0","13","7","6","6","3","3","11","6","5","0","0","0","123","63","60","3","2","1","7","4","3","27","16","11","-2"
"179159","Saint Louis University","2010","Total full-time Instruction/research/public service, Non-tenured on tenure track, Instructors","4","1","3","0","0","0","1","0","1","0","0","0","0","0","0","0","0","0","3","1","2","0","0","0","0","0","0","0","0","0","-2"
"179159","Saint Louis University","2010","Total full-time Instruction/research/public service, Non-tenured on tenure track total","216","113","103","0","0","0","17","10","7","6","3","3","11","6","5","0","0","0","143","71","72","3","2","1","8","4","4","28","17","11","-2"
"179159","Saint Louis University","2010","Total full-time Instruction/research/public service, Non-tenured not on tenure track, Professors","64","49","15","0","0","0","5","4","1","1","0","1","0","0","0","0","0","0","54","44","10","0","0","0","2","0","2","2","1","1","-2"
"179159","Saint Louis University","2010","Total full-time Instruction/research/public service, Non-tenured not on tenure track, Associate professors","131","62","69","0","0","0","13","6","7","3","1","2","2","1","1","0","0","0","105","48","57","0","0","0","0","0","0","8","6","2","-2"
"179159","Saint Louis University","2010","Total full-time Instruction/research/public servicey, Non-tenured not on tenure track, Assistant professors","225","100","125","0","0","0","28","10","18","5","3","2","5","3","2","1","1","0","158","66","92","0","0","0","5","3","2","23","14","9","-2"
"179159","Saint Louis University","2010","Total full-time Instruction/research/public service, Non-tenured not on tenure track, Instructors","91","36","55","0","0","0","6","1","5","4","0","4","5","4","1","0","0","0","66","24","42","1","0","1","2","1","1","7","6","1","-2"
"179159","Saint Louis University","2010","Total full-time Instruction/research/public service, Non-tenured not on tenure track, No academic rank","50","33","17","0","0","0","5","3","2","1","1","0","0","0","0","0","0","0","10","7","3","0","0","0","1","1","0","33","21","12","-2"
"179159","Saint Louis University","2010","Total full-time Instruction/research/public service, Non-tenured not on tenure track total","561","280","281","0","0","0","57","24","33","14","5","9","12","8","4","1","1","0","393","189","204","1","0","1","10","5","5","73","48","25","-2"
"179867","Washington University in St Louis","2010","Total full-time Instruction/research/public service, Tenured, Professors","649","542","107","0","0","0","42","36","6","12","7","5","13","12","1","0","0","0","581","486","95","1","1","0","0","0","0","0","0","0","-2"
"179867","Washington University in St Louis","2010","Total full-time Instruction/research/public service, Tenured, Associate professors","262","184","78","0","0","0","34","26","8","7","3","4","4","3","1","0","0","0","216","151","65","1","1","0","0","0","0","0","0","0","-2"
"179867","Washington University in St Louis","2010","Total full-time Instruction/research/public service, Tenured, Assistant professors","1","1","0","0","0","0","0","0","0","0","0","0","0","0","0","0","0","0","1","1","0","0","0","0","0","0","0","0","0","0","-2"
"179867","Washington University in St Louis","2010","Total full-time Instruction/research/public service, Tenured total","912","727","185","0","0","0","76","62","14","19","10","9","17","15","2","0","0","0","798","638","160","2","2","0","0","0","0","0","0","0","-2"
"179867","Washington University in St Louis","2010","Total full-time Instruction/research/public service, Non-tenured on tenure track, Professors","1","0","1","0","0","0","0","0","0","0","0","0","0","0","0","0","0","0","1","0","1","0","0","0","0","0","0","0","0","0","-2"
"179867","Washington University in St Louis","2010","Total full-time Instruction/research/public service, Non-tenured on tenure track, Associate professors","14","10","4","0","0","0","3","2","1","1","1","0","0","0","0","0","0","0","10","7","3","0","0","0","0","0","0","0","0","0","-2"
"179867","Washington University in St Louis","2010","Total full-time Instruction/research/public service, Non-tenured on tenure track, Assistant professors","327","202","125","0","0","0","78","42","36","9","3","6","13","10","3","1","0","1","226","147","79","0","0","0","0","0","0","0","0","0","-2"
"179867","Washington University in St Louis","2010","Total full-time Instruction/research/public service, Non-tenured on tenure track total","342","212","130","0","0","0","81","44","37","10","4","6","13","10","3","1","0","1","237","154","83","0","0","0","0","0","0","0","0","0","-2"
"179867","Washington University in St Louis","2010","Total full-time Instruction/research/public service, Non-tenured not on tenure track, Professors","128","96","32","0","0","0","11","7","4","1","1","0","1","1","0","0","0","0","115","87","28","0","0","0","0","0","0","0","0","0","-2"
"179867","Washington University in St Louis","2010","Total full-time Instruction/research/public service, Non-tenured not on tenure track, Associate professors","234","165","69","0","0","0","34","24","10","6","4","2","6","3","3","0","0","0","188","134","54","0","0","0","0","0","0","0","0","0","-2"
"179867","Washington University in St Louis","2010","Total full-time Instruction/research/public servicey, Non-tenured not on tenure track, Assistant professors","429","245","184","0","0","0","93","63","30","9","2","7","18","11","7","1","1","0","308","168","140","0","0","0","0","0","0","0","0","0","-2"
"179867","Washington University in St Louis","2010","Total full-time Instruction/research/public service, Non-tenured not on tenure track, Instructors","314","161","153","2","0","2","100","58","42","9","2","7","5","2","3","1","1","0","197","98","99","0","0","0","0","0","0","0","0","0","-2"
"179867","Washington University in St Louis","2010","Total full-time Instruction/research/public service, Non-tenured not on tenure track, Lecturers","153","71","82","0","0","0","22","8","14","6","5","1","6","1","5","0","0","0","118","57","61","1","0","1","0","0","0","0","0","0","-2"
"179867","Washington University in St Louis","2010","Total full-time Instruction/research/public service, Non-tenured not on tenure track, No academic rank","124","70","54","0","0","0","24","15","9","4","1","3","3","2","1","1","0","1","89","50","39","1","0","1","0","0","0","2","2","0","-2"
"179867","Washington University in St Louis","2010","Total full-time Instruction/research/public service, Non-tenured not on tenure track total","1382","808","574","2","0","2","284","175","109","35","15","20","39","20","19","3","2","1","1015","594","421","2","0","2","0","0","0","2","2","0","-2"
"181464","University of Nebraska-Lincoln","2010","Total full-time Instruction/research/public service, Tenured, Professors","476","393","83","0","0","0","33","30","3","3","2","1","10","9","1","0","0","0","429","351","78","0","0","0","0","0","0","1","1","0","-2"
"181464","University of Nebraska-Lincoln","2010","Total full-time Instruction/research/public service, Tenured, Associate professors","290","182","108","5","1","4","32","21","11","13","5","8","13","10","3","0","0","0","225","143","82","0","0","0","0","0","0","2","2","0","-2"
"181464","University of Nebraska-Lincoln","2010","Total full-time Instruction/research/public service, Tenured, Assistant professors","1","1","0","0","0","0","0","0","0","0","0","0","0","0","0","0","0","0","1","1","0","0","0","0","0","0","0","0","0","0","-2"
"181464","University of Nebraska-Lincoln","2010","Total full-time Instruction/research/public service, Tenured total","767","576","191","5","1","4","65","51","14","16","7","9","23","19","4","0","0","0","655","495","160","0","0","0","0","0","0","3","3","0","-2"
"181464","University of Nebraska-Lincoln","2010","Total full-time Instruction/research/public service, Non-tenured on tenure track, Associate professors","20","13","7","0","0","0","3","3","0","2","0","2","0","0","0","0","0","0","14","9","5","0","0","0","0","0","0","1","1","0","-2"
"181464","University of Nebraska-Lincoln","2010","Total full-time Instruction/research/public service, Non-tenured on tenure track, Assistant professors","243","149","94","1","0","1","27","18","9","5","2","3","10","7","3","0","0","0","155","96","59","1","0","1","0","0","0","44","26","18","-2"
"181464","University of Nebraska-Lincoln","2010","Total full-time Instruction/research/public service, Non-tenured on tenure track total","263","162","101","1","0","1","30","21","9","7","2","5","10","7","3","0","0","0","169","105","64","1","0","1","0","0","0","45","27","18","-2"
"181464","University of Nebraska-Lincoln","2010","Total full-time Instruction/research/public service, Non-tenured not on tenure track, Professors","93","54","39","0","0","0","2","2","0","0","0","0","0","0","0","0","0","0","91","52","39","0","0","0","0","0","0","0","0","0","-2"
"181464","University of Nebraska-Lincoln","2010","Total full-time Instruction/research/public service, Non-tenured not on tenure track, Associate professors","67","30","37","0","0","0","0","0","0","0","0","0","1","0","1","0","0","0","66","30","36","0","0","0","0","0","0","0","0","0","-2"
"181464","University of Nebraska-Lincoln","2010","Total full-time Instruction/research/public servicey, Non-tenured not on tenure track, Assistant professors","127","68","59","0","0","0","15","11","4","3","3","0","3","1","2","0","0","0","81","35","46","0","0","0","0","0","0","25","18","7","-2"
"181464","University of Nebraska-Lincoln","2010","Total full-time Instruction/research/public service, Non-tenured not on tenure track, Lecturers","152","62","90","0","0","0","8","4","4","2","0","2","7","3","4","0","0","0","130","53","77","0","0","0","0","0","0","5","2","3","-2"
"181464","University of Nebraska-Lincoln","2010","Total full-time Instruction/research/public service, Non-tenured not on tenure track, No academic rank","187","134","53","0","0","0","7","6","1","0","0","0","6","3","3","0","0","0","53","33","20","0","0","0","0","0","0","121","92","29","-2"
"181464","University of Nebraska-Lincoln","2010","Total full-time Instruction/research/public service, Non-tenured not on tenure track total","626","348","278","0","0","0","32","23","9","5","3","2","17","7","10","0","0","0","421","203","218","0","0","0","0","0","0","151","112","39","-2"
"182281","University of Nevada-Las Vegas","2010","Total full-time Instruction/research/public service, Tenured, Professors","264","203","61","1","0","1","36","31","5","8","8","0","8","5","3","0","0","0","210","158","52","0","0","0","0","0","0","1","1","0","-2"
"182281","University of Nevada-Las Vegas","2010","Total full-time Instruction/research/public service, Tenured, Associate professors","253","164","89","2","1","1","32","23","9","9","4","5","16","9","7","0","0","0","193","126","67","0","0","0","0","0","0","1","1","0","-2"
"182281","University of Nevada-Las Vegas","2010","Total full-time Instruction/research/public service, Tenured, Assistant professors","6","4","2","0","0","0","1","1","0","0","0","0","0","0","0","0","0","0","5","3","2","0","0","0","0","0","0","0","0","0","-2"
"182281","University of Nevada-Las Vegas","2010","Total full-time Instruction/research/public service, Tenured total","523","371","152","3","1","2","69","55","14","17","12","5","24","14","10","0","0","0","408","287","121","0","0","0","0","0","0","2","2","0","-2"
"182281","University of Nevada-Las Vegas","2010","Total full-time Instruction/research/public service, Non-tenured on tenure track, Associate professors","19","4","15","0","0","0","0","0","0","1","0","1","2","1","1","0","0","0","15","3","12","1","0","1","0","0","0","0","0","0","-2"
"182281","University of Nevada-Las Vegas","2010","Total full-time Instruction/research/public service, Non-tenured on tenure track, Assistant professors","127","61","66","1","0","1","15","8","7","5","3","2","6","2","4","0","0","0","81","36","45","1","0","1","0","0","0","18","12","6","-2"
"182281","University of Nevada-Las Vegas","2010","Total full-time Instruction/research/public service, Non-tenured on tenure track total","146","65","81","1","0","1","15","8","7","6","3","3","8","3","5","0","0","0","96","39","57","2","0","2","0","0","0","18","12","6","-2"
"182281","University of Nevada-Las Vegas","2010","Total full-time Instruction/research/public service, Non-tenured not on tenure track, Professors","9","8","1","0","0","0","0","0","0","0","0","0","0","0","0","0","0","0","9","8","1","0","0","0","0","0","0","0","0","0","-2"
"182281","University of Nevada-Las Vegas","2010","Total full-time Instruction/research/public service, Non-tenured not on tenure track, Associate professors","26","18","8","0","0","0","3","2","1","4","2","2","1","0","1","0","0","0","17","14","3","0","0","0","0","0","0","1","0","1","-2"
"182281","University of Nevada-Las Vegas","2010","Total full-time Instruction/research/public servicey, Non-tenured not on tenure track, Assistant professors","68","44","24","0","0","0","4","2","2","4","2","2","1","1","0","0","0","0","54","35","19","0","0","0","0","0","0","5","4","1","-2"
"182281","University of Nevada-Las Vegas","2010","Total full-time Instruction/research/public service, Non-tenured not on tenure track, Lecturers","70","34","36","0","0","0","9","5","4","1","0","1","2","1","1","0","0","0","55","28","27","1","0","1","0","0","0","2","0","2","-2"
"182281","University of Nevada-Las Vegas","2010","Total full-time Instruction/research/public service, Non-tenured not on tenure track total","173","104","69","0","0","0","16","9","7","9","4","5","4","2","2","0","0","0","135","85","50","1","0","1","0","0","0","8","4","4","-2"
"182670","Dartmouth College","2010","Total full-time Instruction/research/public service, Tenured, Professors","277","208","69","1","1","0","11","8","3","2","1","1","6","4","2","0","0","0","252","191","61","4","2","2","0","0","0","1","1","0","-2"
"182670","Dartmouth College","2010","Total full-time Instruction/research/public service, Tenured, Associate professors","128","76","52","1","1","0","9","6","3","6","4","2","7","3","4","0","0","0","100","60","40","4","2","2","0","0","0","1","0","1","-2"
"182670","Dartmouth College","2010","Total full-time Instruction/research/public service, Tenured total","405","284","121","2","2","0","20","14","6","8","5","3","13","7","6","0","0","0","352","251","101","8","4","4","0","0","0","2","1","1","-2"
"182670","Dartmouth College","2010","Total full-time Instruction/research/public service, Non-tenured on tenure track, Professors","9","8","1","0","0","0","1","1","0","0","0","0","0","0","0","0","0","0","8","7","1","0","0","0","0","0","0","0","0","0","-2"
"182670","Dartmouth College","2010","Total full-time Instruction/research/public service, Non-tenured on tenure track, Associate professors","44","29","15","0","0","0","1","0","1","0","0","0","1","0","1","0","0","0","40","27","13","0","0","0","0","0","0","2","2","0","-2"
"182670","Dartmouth College","2010","Total full-time Instruction/research/public service, Non-tenured on tenure track, Assistant professors","114","70","44","1","0","1","14","9","5","7","4","3","9","6","3","0","0","0","73","43","30","0","0","0","0","0","0","10","8","2","-2"
"182670","Dartmouth College","2010","Total full-time Instruction/research/public service, Non-tenured on tenure track, Instructors","1","0","1","0","0","0","0","0","0","1","0","1","0","0","0","0","0","0","0","0","0","0","0","0","0","0","0","0","0","0","-2"
"182670","Dartmouth College","2010","Total full-time Instruction/research/public service, Non-tenured on tenure track total","168","107","61","1","0","1","16","10","6","8","4","4","10","6","4","0","0","0","121","77","44","0","0","0","0","0","0","12","10","2","-2"
"182670","Dartmouth College","2010","Total full-time Instruction/research/public service, Non-tenured not on tenure track, Professors","26","22","4","0","0","0","1","1","0","0","0","0","0","0","0","0","0","0","23","19","4","1","1","0","0","0","0","1","1","0","-2"
"182670","Dartmouth College","2010","Total full-time Instruction/research/public service, Non-tenured not on tenure track, Associate professors","29","15","14","0","0","0","3","2","1","1","0","1","1","0","1","0","0","0","24","13","11","0","0","0","0","0","0","0","0","0","-2"
"182670","Dartmouth College","2010","Total full-time Instruction/research/public servicey, Non-tenured not on tenure track, Assistant professors","87","51","36","0","0","0","11","6","5","0","0","0","4","3","1","0","0","0","68","38","30","0","0","0","0","0","0","4","4","0","-2"
"182670","Dartmouth College","2010","Total full-time Instruction/research/public service, Non-tenured not on tenure track, Instructors","36","20","16","0","0","0","2","1","1","0","0","0","0","0","0","0","0","0","30","17","13","1","0","1","0","0","0","3","2","1","-2"
"182670","Dartmouth College","2010","Total full-time Instruction/research/public service, Non-tenured not on tenure track, Lecturers","44","17","27","1","0","1","3","1","2","1","1","0","5","1","4","0","0","0","29","11","18","1","1","0","0","0","0","4","2","2","-2"
"182670","Dartmouth College","2010","Total full-time Instruction/research/public service, Non-tenured not on tenure track, No academic rank","11","3","8","0","0","0","0","0","0","0","0","0","0","0","0","0","0","0","9","2","7","0","0","0","0","0","0","2","1","1","-2"
"182670","Dartmouth College","2010","Total full-time Instruction/research/public service, Non-tenured not on tenure track total","233","128","105","1","0","1","20","11","9","2","1","1","10","4","6","0","0","0","183","100","83","3","2","1","0","0","0","14","10","4","-2"
"183044","University of New Hampshire-Main Campus","2010","Total full-time Instruction/research/public service, Tenured, Professors","221","179","42","0","0","0","6","6","0","1","1","0","1","1","0","0","0","0","202","163","39","0","0","0","11","8","3","0","0","0","-2"
"183044","University of New Hampshire-Main Campus","2010","Total full-time Instruction/research/public service, Tenured, Associate professors","229","126","103","0","0","0","17","8","9","3","2","1","11","6","5","0","0","0","180","100","80","0","0","0","18","10","8","0","0","0","-2"
"183044","University of New Hampshire-Main Campus","2010","Total full-time Instruction/research/public service, Tenured total","450","305","145","0","0","0","23","14","9","4","3","1","12","7","5","0","0","0","382","263","119","0","0","0","29","18","11","0","0","0","-2"
"183044","University of New Hampshire-Main Campus","2010","Total full-time Instruction/research/public service, Non-tenured on tenure track, Professors","1","1","0","0","0","0","0","0","0","0","0","0","0","0","0","0","0","0","1","1","0","0","0","0","0","0","0","0","0","0","-2"
"183044","University of New Hampshire-Main Campus","2010","Total full-time Instruction/research/public service, Non-tenured on tenure track, Associate professors","11","9","2","0","0","0","0","0","0","0","0","0","1","1","0","0","0","0","4","4","0","0","0","0","5","3","2","1","1","0","-2"
"183044","University of New Hampshire-Main Campus","2010","Total full-time Instruction/research/public service, Non-tenured on tenure track, Assistant professors","112","55","57","0","0","0","2","1","1","0","0","0","0","0","0","0","0","0","15","5","10","0","0","0","88","46","42","7","3","4","-2"
"183044","University of New Hampshire-Main Campus","2010","Total full-time Instruction/research/public service, Non-tenured on tenure track, Instructors","2","0","2","0","0","0","0","0","0","0","0","0","0","0","0","0","0","0","0","0","0","0","0","0","1","0","1","1","0","1","-2"
"183044","University of New Hampshire-Main Campus","2010","Total full-time Instruction/research/public service, Non-tenured on tenure track total","126","65","61","0","0","0","2","1","1","0","0","0","1","1","0","0","0","0","20","10","10","0","0","0","94","49","45","9","4","5","-2"
"183044","University of New Hampshire-Main Campus","2010","Total full-time Instruction/research/public service, Non-tenured not on tenure track, Professors","18","16","2","0","0","0","1","1","0","0","0","0","0","0","0","0","0","0","12","11","1","0","0","0","5","4","1","0","0","0","-2"
"183044","University of New Hampshire-Main Campus","2010","Total full-time Instruction/research/public service, Non-tenured not on tenure track, Associate professors","29","19","10","0","0","0","1","0","1","0","0","0","0","0","0","0","0","0","25","17","8","0","0","0","3","2","1","0","0","0","-2"
"183044","University of New Hampshire-Main Campus","2010","Total full-time Instruction/research/public servicey, Non-tenured not on tenure track, Assistant professors","47","17","30","0","0","0","0","0","0","0","0","0","0","0","0","0","0","0","26","7","19","0","0","0","21","10","11","0","0","0","-2"
"183044","University of New Hampshire-Main Campus","2010","Total full-time Instruction/research/public service, Non-tenured not on tenure track, Instructors","2","2","0","0","0","0","0","0","0","0","0","0","0","0","0","0","0","0","2","2","0","0","0","0","0","0","0","0","0","0","-2"
"183044","University of New Hampshire-Main Campus","2010","Total full-time Instruction/research/public service, Non-tenured not on tenure track, Lecturers","5","3","2","0","0","0","0","0","0","0","0","0","0","0","0","0","0","0","3","2","1","0","0","0","2","1","1","0","0","0","-2"
"183044","University of New Hampshire-Main Campus","2010","Total full-time Instruction/research/public service, Non-tenured not on tenure track, No academic rank","19","7","12","0","0","0","0","0","0","0","0","0","0","0","0","0","0","0","0","0","0","0","0","0","19","7","12","0","0","0","-2"
"183044","University of New Hampshire-Main Campus","2010","Total full-time Instruction/research/public service, Non-tenured not on tenure track total","120","64","56","0","0","0","2","1","1","0","0","0","0","0","0","0","0","0","68","39","29","0","0","0","50","24","26","0","0","0","-2"
"183080","Plymouth State University","2010","Total full-time Instruction/research/public service, Tenured, Professors","81","57","24","0","0","0","5","4","1","0","0","0","0","0","0","0","0","0","73","52","21","0","0","0","3","1","2","0","0","0","-2"
"183080","Plymouth State University","2010","Total full-time Instruction/research/public service, Tenured, Associate professors","25","15","10","0","0","0","2","2","0","1","0","1","0","0","0","0","0","0","20","13","7","0","0","0","2","0","2","0","0","0","-2"
"183080","Plymouth State University","2010","Total full-time Instruction/research/public service, Tenured, Assistant professors","2","2","0","0","0","0","0","0","0","0","0","0","0","0","0","0","0","0","2","2","0","0","0","0","0","0","0","0","0","0","-2"
"183080","Plymouth State University","2010","Total full-time Instruction/research/public service, Tenured total","108","74","34","0","0","0","7","6","1","1","0","1","0","0","0","0","0","0","95","67","28","0","0","0","5","1","4","0","0","0","-2"
"183080","Plymouth State University","2010","Total full-time Instruction/research/public service, Non-tenured on tenure track, Professors","1","1","0","0","0","0","0","0","0","0","0","0","0","0","0","0","0","0","1","1","0","0","0","0","0","0","0","0","0","0","-2"
"183080","Plymouth State University","2010","Total full-time Instruction/research/public service, Non-tenured on tenure track, Associate professors","22","11","11","0","0","0","0","0","0","1","1","0","1","0","1","0","0","0","17","7","10","0","0","0","3","3","0","0","0","0","-2"
"183080","Plymouth State University","2010","Total full-time Instruction/research/public service, Non-tenured on tenure track, Assistant professors","31","10","21","0","0","0","1","1","0","0","0","0","0","0","0","0","0","0","25","6","19","0","0","0","2","1","1","3","2","1","-2"
"183080","Plymouth State University","2010","Total full-time Instruction/research/public service, Non-tenured on tenure track, Instructors","2","0","2","0","0","0","0","0","0","0","0","0","0","0","0","0","0","0","2","0","2","0","0","0","0","0","0","0","0","0","-2"
"183080","Plymouth State University","2010","Total full-time Instruction/research/public service, Non-tenured on tenure track total","56","22","34","0","0","0","1","1","0","1","1","0","1","0","1","0","0","0","45","14","31","0","0","0","5","4","1","3","2","1","-2"
"183080","Plymouth State University","2010","Total full-time Instruction/research/public servicey, Non-tenured not on tenure track, Assistant professors","3","2","1","0","0","0","0","0","0","0","0","0","0","0","0","0","0","0","3","2","1","0","0","0","0","0","0","0","0","0","-2"
"183080","Plymouth State University","2010","Total full-time Instruction/research/public service, Non-tenured not on tenure track, Lecturers","23","10","13","0","0","0","0","0","0","0","0","0","3","1","2","0","0","0","18","8","10","0","0","0","2","1","1","0","0","0","-2"
"183080","Plymouth State University","2010","Total full-time Instruction/research/public service, Non-tenured not on tenure track total","26","12","14","0","0","0","0","0","0","0","0","0","3","1","2","0","0","0","21","10","11","0","0","0","2","1","1","0","0","0","-2"
"185262","Kean University","2010","Total full-time Instruction/research/public service, Tenured, Professors","122","74","48","0","0","0","8","8","0","15","7","8","8","6","2","0","0","0","91","53","38","0","0","0","0","0","0","0","0","0","-2"
"185262","Kean University","2010","Total full-time Instruction/research/public service, Tenured, Associate professors","76","39","37","0","0","0","9","2","7","7","3","4","5","3","2","0","0","0","55","31","24","0","0","0","0","0","0","0","0","0","-2"
"185262","Kean University","2010","Total full-time Instruction/research/public service, Tenured, Assistant professors","67","34","33","0","0","0","10","6","4","8","3","5","7","2","5","0","0","0","42","23","19","0","0","0","0","0","0","0","0","0","-2"
"185262","Kean University","2010","Total full-time Instruction/research/public service, Tenured total","265","147","118","0","0","0","27","16","11","30","13","17","20","11","9","0","0","0","188","107","81","0","0","0","0","0","0","0","0","0","-2"
"185262","Kean University","2010","Total full-time Instruction/research/public service, Non-tenured on tenure track, Professors","1","1","0","0","0","0","0","0","0","0","0","0","0","0","0","0","0","0","1","1","0","0","0","0","0","0","0","0","0","0","-2"
"185262","Kean University","2010","Total full-time Instruction/research/public service, Non-tenured on tenure track, Associate professors","8","6","2","0","0","0","0","0","0","1","1","0","0","0","0","0","0","0","7","5","2","0","0","0","0","0","0","0","0","0","-2"
"185262","Kean University","2010","Total full-time Instruction/research/public service, Non-tenured on tenure track, Assistant professors","55","20","35","0","0","0","5","1","4","2","2","0","2","0","2","0","0","0","37","15","22","0","0","0","0","0","0","9","2","7","-2"
"185262","Kean University","2010","Total full-time Instruction/research/public service, Non-tenured on tenure track total","64","27","37","0","0","0","5","1","4","3","3","0","2","0","2","0","0","0","45","21","24","0","0","0","0","0","0","9","2","7","-2"
"185262","Kean University","2010","Total full-time Instruction/research/public service, Non-tenured not on tenure track, Associate professors","3","1","2","0","0","0","0","0","0","0","0","0","1","1","0","0","0","0","1","0","1","0","0","0","0","0","0","1","0","1","-2"
"185262","Kean University","2010","Total full-time Instruction/research/public servicey, Non-tenured not on tenure track, Assistant professors","3","0","3","0","0","0","0","0","0","0","0","0","0","0","0","0","0","0","3","0","3","0","0","0","0","0","0","0","0","0","-2"
"185262","Kean University","2010","Total full-time Instruction/research/public service, Non-tenured not on tenure track, Instructors","6","4","2","0","0","0","0","0","0","0","0","0","1","1","0","0","0","0","4","2","2","0","0","0","1","1","0","0","0","0","-2"
"185262","Kean University","2010","Total full-time Instruction/research/public service, Non-tenured not on tenure track total","12","5","7","0","0","0","0","0","0","0","0","0","2","2","0","0","0","0","8","2","6","0","0","0","1","1","0","1","0","1","-2"
"186131","Princeton University","2010","Total full-time Instruction/research/public service, Tenured, Professors","450","360","90","0","0","0","36","33","3","19","12","7","12","11","1","0","0","0","381","302","79","1","1","0","0","0","0","1","1","0","-2"
"186131","Princeton University","2010","Total full-time Instruction/research/public service, Tenured, Associate professors","88","60","28","0","0","0","13","10","3","3","0","3","1","1","0","0","0","0","69","48","21","1","0","1","0","0","0","1","1","0","-2"
"186131","Princeton University","2010","Total full-time Instruction/research/public service, Tenured, Lecturers","1","1","0","0","0","0","0","0","0","0","0","0","0","0","0","0","0","0","1","1","0","0","0","0","0","0","0","0","0","0","-2"
"186131","Princeton University","2010","Total full-time Instruction/research/public service, Tenured total","539","421","118","0","0","0","49","43","6","22","12","10","13","12","1","0","0","0","451","351","100","2","1","1","0","0","0","2","2","0","-2"
"186131","Princeton University","2010","Total full-time Instruction/research/public service, Non-tenured on tenure track, Assistant professors","170","104","66","0","0","0","11","6","5","4","3","1","8","4","4","0","0","0","98","59","39","0","0","0","0","0","0","49","32","17","-2"
"186131","Princeton University","2010","Total full-time Instruction/research/public service, Non-tenured on tenure track total","170","104","66","0","0","0","11","6","5","4","3","1","8","4","4","0","0","0","98","59","39","0","0","0","0","0","0","49","32","17","-2"
"186131","Princeton University","2010","Total full-time Instruction/research/public service, Non-tenured not on tenure track, Instructors","15","13","2","0","0","0","1","0","1","0","0","0","0","0","0","0","0","0","2","2","0","0","0","0","1","1","0","11","10","1","-2"
"186131","Princeton University","2010","Total full-time Instruction/research/public service, Non-tenured not on tenure track, Lecturers","120","61","59","0","0","0","7","3","4","3","3","0","3","2","1","0","0","0","76","41","35","1","0","1","3","2","1","27","10","17","-2"
"186131","Princeton University","2010","Total full-time Instruction/research/public service, Non-tenured not on tenure track total","135","74","61","0","0","0","8","3","5","3","3","0","3","2","1","0","0","0","78","43","35","1","0","1","4","3","1","38","20","18","-2"
"186380","Rutgers University-New Brunswick","2010","Total full-time Instruction/research/public service, Tenured, Professors","731","569","162","0","0","0","81","69","12","18","12","6","10","9","1","0","0","0","618","477","141","0","0","0","0","0","0","4","2","2","-2"
"186380","Rutgers University-New Brunswick","2010","Total full-time Instruction/research/public service, Tenured, Associate professors","456","247","209","2","1","1","50","31","19","18","5","13","14","9","5","0","0","0","359","193","166","0","0","0","1","0","1","12","8","4","-2"
"186380","Rutgers University-New Brunswick","2010","Total full-time Instruction/research/public service, Tenured total","1187","816","371","2","1","1","131","100","31","36","17","19","24","18","6","0","0","0","977","670","307","0","0","0","1","0","1","16","10","6","-2"
"186380","Rutgers University-New Brunswick","2010","Total full-time Instruction/research/public service, Non-tenured on tenure track, Professors","28","17","11","0","0","0","5","4","1","0","0","0","0","0","0","0","0","0","21","13","8","0","0","0","2","0","2","0","0","0","-2"
"186380","Rutgers University-New Brunswick","2010","Total full-time Instruction/research/public service, Non-tenured on tenure track, Associate professors","33","22","11","0","0","0","3","2","1","2","1","1","1","0","1","0","0","0","21","13","8","0","0","0","3","3","0","3","3","0","-2"
"186380","Rutgers University-New Brunswick","2010","Total full-time Instruction/research/public service, Non-tenured on tenure track, Assistant professors","250","118","132","2","1","1","27","13","14","10","5","5","13","5","8","0","0","0","135","58","77","0","0","0","19","8","11","44","28","16","-2"
"186380","Rutgers University-New Brunswick","2010","Total full-time Instruction/research/public service, Non-tenured on tenure track total","311","157","154","2","1","1","35","19","16","12","6","6","14","5","9","0","0","0","177","84","93","0","0","0","24","11","13","47","31","16","-2"
"186380","Rutgers University-New Brunswick","2010","Total full-time Instruction/research/public service, Non-tenured not on tenure track, Professors","8","4","4","0","0","0","1","0","1","0","0","0","0","0","0","0","0","0","4","3","1","0","0","0","0","0","0","3","1","2","-2"
"186380","Rutgers University-New Brunswick","2010","Total full-time Instruction/research/public service, Non-tenured not on tenure track, Associate professors","33","21","12","1","0","1","3","3","0","1","1","0","1","0","1","0","0","0","26","16","10","0","0","0","1","1","0","0","0","0","-2"
"186380","Rutgers University-New Brunswick","2010","Total full-time Instruction/research/public servicey, Non-tenured not on tenure track, Assistant professors","130","61","69","0","0","0","37","19","18","1","1","0","3","1","2","0","0","0","70","31","39","0","0","0","5","0","5","14","9","5","-2"
"186380","Rutgers University-New Brunswick","2010","Total full-time Instruction/research/public service, Non-tenured not on tenure track, Instructors","342","183","159","0","0","0","38","22","16","3","1","2","7","1","6","0","0","0","188","87","101","0","0","0","3","1","2","103","71","32","-2"
"186380","Rutgers University-New Brunswick","2010","Total full-time Instruction/research/public service, Non-tenured not on tenure track, Lecturers","56","30","26","0","0","0","9","5","4","2","2","0","0","0","0","0","0","0","35","18","17","0","0","0","3","1","2","7","4","3","-2"
"186380","Rutgers University-New Brunswick","2010","Total full-time Instruction/research/public service, Non-tenured not on tenure track, No academic rank","319","181","138","0","0","0","51","20","31","1","0","1","3","3","0","0","0","0","82","44","38","0","0","0","51","16","35","131","98","33","-2"
"186380","Rutgers University-New Brunswick","2010","Total full-time Instruction/research/public service, Non-tenured not on tenure track total","888","480","408","1","0","1","139","69","70","8","5","3","14","5","9","0","0","0","405","199","206","0","0","0","63","19","44","258","183","75","-2"
"187967","New Mexico Institute of Mining and Technology","2010","Total full-time Instruction/research/public service, Tenured, Professors","35","33","2","0","0","0","4","4","0","0","0","0","2","2","0","0","0","0","29","27","2","0","0","0","0","0","0","0","0","0","-2"
"187967","New Mexico Institute of Mining and Technology","2010","Total full-time Instruction/research/public service, Tenured, Associate professors","33","25","8","0","0","0","3","3","0","0","0","0","0","0","0","0","0","0","30","22","8","0","0","0","0","0","0","0","0","0","-2"
"187967","New Mexico Institute of Mining and Technology","2010","Total full-time Instruction/research/public service, Tenured total","68","58","10","0","0","0","7","7","0","0","0","0","2","2","0","0","0","0","59","49","10","0","0","0","0","0","0","0","0","0","-2"
"187967","New Mexico Institute of Mining and Technology","2010","Total full-time Instruction/research/public service, Non-tenured on tenure track, Professors","1","1","0","0","0","0","0","0","0","0","0","0","0","0","0","0","0","0","1","1","0","0","0","0","0","0","0","0","0","0","-2"
"187967","New Mexico Institute of Mining and Technology","2010","Total full-time Instruction/research/public service, Non-tenured on tenure track, Associate professors","12","11","1","0","0","0","3","3","0","0","0","0","2","2","0","0","0","0","7","6","1","0","0","0","0","0","0","0","0","0","-2"
"187967","New Mexico Institute of Mining and Technology","2010","Total full-time Instruction/research/public service, Non-tenured on tenure track, Assistant professors","26","21","5","0","0","0","3","3","0","0","0","0","2","2","0","0","0","0","21","16","5","0","0","0","0","0","0","0","0","0","-2"
"187967","New Mexico Institute of Mining and Technology","2010","Total full-time Instruction/research/public service, Non-tenured on tenure track total","39","33","6","0","0","0","6","6","0","0","0","0","4","4","0","0","0","0","29","23","6","0","0","0","0","0","0","0","0","0","-2"
"187967","New Mexico Institute of Mining and Technology","2010","Total full-time Instruction/research/public service, Non-tenured not on tenure track, Associate professors","6","4","2","0","0","0","0","0","0","0","0","0","0","0","0","0","0","0","6","4","2","0","0","0","0","0","0","0","0","0","-2"
"187967","New Mexico Institute of Mining and Technology","2010","Total full-time Instruction/research/public servicey, Non-tenured not on tenure track, Assistant professors","2","2","0","0","0","0","0","0","0","0","0","0","0","0","0","0","0","0","2","2","0","0","0","0","0","0","0","0","0","0","-2"
"187967","New Mexico Institute of Mining and Technology","2010","Total full-time Instruction/research/public service, Non-tenured not on tenure track, Instructors","5","1","4","0","0","0","1","1","0","0","0","0","0","0","0","0","0","0","4","0","4","0","0","0","0","0","0","0","0","0","-2"
"187967","New Mexico Institute of Mining and Technology","2010","Total full-time Instruction/research/public service, Non-tenured not on tenure track, Lecturers","4","3","1","0","0","0","0","0","0","0","0","0","0","0","0","0","0","0","4","3","1","0","0","0","0","0","0","0","0","0","-2"
"187967","New Mexico Institute of Mining and Technology","2010","Total full-time Instruction/research/public service, Non-tenured not on tenure track total","17","10","7","0","0","0","1","1","0","0","0","0","0","0","0","0","0","0","16","9","7","0","0","0","0","0","0","0","0","0","-2"
"190150","Columbia University in the City of New York","2010","Total full-time Instruction/research/public service, Tenured, Professors","800","623","177","0","0","0","86","69","17","17","12","5","17","15","2","0","0","0","669","517","152","2","2","0","2","2","0","7","6","1","-2"
"190150","Columbia University in the City of New York","2010","Total full-time Instruction/research/public service, Tenured, Associate professors","155","106","49","0","0","0","21","14","7","7","5","2","5","2","3","0","0","0","119","83","36","0","0","0","0","0","0","3","2","1","-2"
"190150","Columbia University in the City of New York","2010","Total full-time Instruction/research/public service, Tenured total","955","729","226","0","0","0","107","83","24","24","17","7","22","17","5","0","0","0","788","600","188","2","2","0","2","2","0","10","8","2","-2"
"190150","Columbia University in the City of New York","2010","Total full-time Instruction/research/public service, Non-tenured on tenure track, Professors","55","44","11","0","0","0","4","3","1","0","0","0","2","2","0","0","0","0","44","34","10","0","0","0","1","1","0","4","4","0","-2"
"190150","Columbia University in the City of New York","2010","Total full-time Instruction/research/public service, Non-tenured on tenure track, Associate professors","105","71","34","0","0","0","11","7","4","10","5","5","6","5","1","0","0","0","70","46","24","0","0","0","0","0","0","8","8","0","-2"
"190150","Columbia University in the City of New York","2010","Total full-time Instruction/research/public service, Non-tenured on tenure track, Assistant professors","433","259","174","3","2","1","71","37","34","18","7","11","14","7","7","0","0","0","240","145","95","3","2","1","2","2","0","82","57","25","-2"
"190150","Columbia University in the City of New York","2010","Total full-time Instruction/research/public service, Non-tenured on tenure track, Instructors","5","3","2","0","0","0","2","2","0","0","0","0","1","0","1","0","0","0","2","1","1","0","0","0","0","0","0","0","0","0","-2"
"190150","Columbia University in the City of New York","2010","Total full-time Instruction/research/public service, Non-tenured on tenure track, Lecturers","85","55","30","0","0","0","6","3","3","7","6","1","0","0","0","0","0","0","67","43","24","0","0","0","0","0","0","5","3","2","-2"
"190150","Columbia University in the City of New York","2010","Total full-time Instruction/research/public service, Non-tenured on tenure track total","683","432","251","3","2","1","94","52","42","35","18","17","23","14","9","0","0","0","423","269","154","3","2","1","3","3","0","99","72","27","-2"
"190150","Columbia University in the City of New York","2010","Total full-time Instruction/research/public service, Non-tenured not on tenure track, Professors","379","272","107","0","0","0","18","11","7","17","10","7","9","6","3","0","0","0","328","242","86","0","0","0","1","0","1","6","3","3","-2"
"190150","Columbia University in the City of New York","2010","Total full-time Instruction/research/public service, Non-tenured not on tenure track, Associate professors","341","202","139","0","0","0","44","25","19","17","9","8","8","5","3","0","0","0","266","159","107","0","0","0","2","1","1","4","3","1","-2"
"190150","Columbia University in the City of New York","2010","Total full-time Instruction/research/public servicey, Non-tenured not on tenure track, Assistant professors","913","422","491","2","0","2","175","88","87","88","52","36","55","32","23","2","1","1","543","227","316","5","1","4","9","3","6","34","18","16","-2"
"190150","Columbia University in the City of New York","2010","Total full-time Instruction/research/public service, Non-tenured not on tenure track, Instructors","169","72","97","0","0","0","32","10","22","27","12","15","14","8","6","0","0","0","81","32","49","0","0","0","5","0","5","10","10","0","-2"
"190150","Columbia University in the City of New York","2010","Total full-time Instruction/research/public service, Non-tenured not on tenure track, Lecturers","242","107","135","0","0","0","30","14","16","6","6","0","11","4","7","0","0","0","140","57","83","0","0","0","2","1","1","53","25","28","-2"
"190150","Columbia University in the City of New York","2010","Total full-time Instruction/research/public service, Non-tenured not on tenure track total","2044","1075","969","2","0","2","299","148","151","155","89","66","97","55","42","2","1","1","1358","717","641","5","1","4","19","5","14","107","59","48","-2"
"190415","Cornell University","2010","Total full-time Instruction/research/public service, Tenured, Professors","771","612","159","2","2","0","47","40","7","21","14","7","15","10","5","0","0","0","676","537","139","0","0","0","4","3","1","6","6","0","-2"
"190415","Cornell University","2010","Total full-time Instruction/research/public service, Tenured, Associate professors","385","249","136","3","0","3","33","22","11","12","4","8","13","4","9","0","0","0","314","210","104","0","0","0","2","2","0","8","7","1","-2"
"190415","Cornell University","2010","Total full-time Instruction/research/public service, Tenured total","1156","861","295","5","2","3","80","62","18","33","18","15","28","14","14","0","0","0","990","747","243","0","0","0","6","5","1","14","13","1","-2"
"190415","Cornell University","2010","Total full-time Instruction/research/public service, Non-tenured on tenure track, Associate professors","13","9","4","1","1","0","1","1","0","1","0","1","0","0","0","0","0","0","7","5","2","0","0","0","1","0","1","2","2","0","-2"
"190415","Cornell University","2010","Total full-time Instruction/research/public service, Non-tenured on tenure track, Assistant professors","251","168","83","1","1","0","37","28","9","9","5","4","13","8","5","0","0","0","150","97","53","2","0","2","5","4","1","34","25","9","-2"
"190415","Cornell University","2010","Total full-time Instruction/research/public service, Non-tenured on tenure track total","264","177","87","2","2","0","38","29","9","10","5","5","13","8","5","0","0","0","157","102","55","2","0","2","6","4","2","36","27","9","-2"
"190415","Cornell University","2010","Total full-time Instruction/research/public service, Non-tenured not on tenure track, Professors","19","16","3","0","0","0","1","1","0","0","0","0","2","1","1","0","0","0","13","11","2","0","0","0","0","0","0","3","3","0","-2"
"190415","Cornell University","2010","Total full-time Instruction/research/public service, Non-tenured not on tenure track, Associate professors","16","10","6","0","0","0","2","0","2","0","0","0","0","0","0","0","0","0","13","9","4","0","0","0","0","0","0","1","1","0","-2"
"190415","Cornell University","2010","Total full-time Instruction/research/public servicey, Non-tenured not on tenure track, Assistant professors","46","24","22","0","0","0","2","1","1","0","0","0","4","2","2","0","0","0","33","16","17","0","0","0","0","0","0","7","5","2","-2"
"190415","Cornell University","2010","Total full-time Instruction/research/public service, Non-tenured not on tenure track, Instructors","7","4","3","0","0","0","0","0","0","0","0","0","0","0","0","0","0","0","5","2","3","0","0","0","0","0","0","2","2","0","-2"
"190415","Cornell University","2010","Total full-time Instruction/research/public service, Non-tenured not on tenure track, Lecturers","240","101","139","0","0","0","20","4","16","7","3","4","6","3","3","0","0","0","178","83","95","2","0","2","1","0","1","26","8","18","-2"
"190415","Cornell University","2010","Total full-time Instruction/research/public service, Non-tenured not on tenure track total","328","155","173","0","0","0","25","6","19","7","3","4","12","6","6","0","0","0","242","121","121","2","0","2","1","0","1","39","19","20","-2"
"190567","CUNY City College","2010","Total full-time Instruction/research/public service, Tenured, Professors","215","158","57","1","1","0","24","20","4","16","10","6","11","6","5","0","0","0","161","119","42","0","0","0","0","0","0","2","2","0","-2"
"190567","CUNY City College","2010","Total full-time Instruction/research/public service, Tenured, Associate professors","138","76","62","0","0","0","16","13","3","15","7","8","11","4","7","0","0","0","93","49","44","0","0","0","0","0","0","3","3","0","-2"
"190567","CUNY City College","2010","Total full-time Instruction/research/public service, Tenured, Assistant professors","23","14","9","0","0","0","4","3","1","2","2","0","2","2","0","0","0","0","15","7","8","0","0","0","0","0","0","0","0","0","-2"
"190567","CUNY City College","2010","Total full-time Instruction/research/public service, Tenured, Lecturers","5","3","2","0","0","0","0","0","0","3","1","2","1","1","0","0","0","0","1","1","0","0","0","0","0","0","0","0","0","0","-2"
"190567","CUNY City College","2010","Total full-time Instruction/research/public service, Tenured total","381","251","130","1","1","0","44","36","8","36","20","16","25","13","12","0","0","0","270","176","94","0","0","0","0","0","0","5","5","0","-2"
"190567","CUNY City College","2010","Total full-time Instruction/research/public service, Non-tenured on tenure track, Professors","7","3","4","0","0","0","1","0","1","0","0","0","2","1","1","0","0","0","4","2","2","0","0","0","0","0","0","0","0","0","-2"
"190567","CUNY City College","2010","Total full-time Instruction/research/public service, Non-tenured on tenure track, Associate professors","25","16","9","0","0","0","5","2","3","0","0","0","1","1","0","0","0","0","16","13","3","0","0","0","0","0","0","3","0","3","-2"
"190567","CUNY City College","2010","Total full-time Instruction/research/public service, Non-tenured on tenure track, Assistant professors","104","54","50","1","1","0","17","9","8","15","6","9","9","2","7","0","0","0","50","28","22","0","0","0","0","0","0","12","8","4","-2"
"190567","CUNY City College","2010","Total full-time Instruction/research/public service, Non-tenured on tenure track, Lecturers","45","20","25","0","0","0","5","4","1","3","1","2","5","3","2","0","0","0","31","12","19","0","0","0","0","0","0","1","0","1","-2"
"190567","CUNY City College","2010","Total full-time Instruction/research/public service, Non-tenured on tenure track total","181","93","88","1","1","0","28","15","13","18","7","11","17","7","10","0","0","0","101","55","46","0","0","0","0","0","0","16","8","8","-2"
"190567","CUNY City College","2010","Total full-time Instruction/research/public service, Non-tenured not on tenure track, Professors","11","8","3","0","0","0","0","0","0","3","0","3","1","1","0","0","0","0","7","7","0","0","0","0","0","0","0","0","0","0","-2"
"190567","CUNY City College","2010","Total full-time Instruction/research/public service, Non-tenured not on tenure track, Associate professors","1","1","0","0","0","0","1","1","0","0","0","0","0","0","0","0","0","0","0","0","0","0","0","0","0","0","0","0","0","0","-2"
"190567","CUNY City College","2010","Total full-time Instruction/research/public servicey, Non-tenured not on tenure track, Assistant professors","5","2","3","0","0","0","0","0","0","1","0","1","0","0","0","0","0","0","2","0","2","0","0","0","0","0","0","2","2","0","-2"
"190567","CUNY City College","2010","Total full-time Instruction/research/public service, Non-tenured not on tenure track, Instructors","5","0","5","0","0","0","0","0","0","1","0","1","0","0","0","0","0","0","3","0","3","0","0","0","0","0","0","1","0","1","-2"
"190567","CUNY City College","2010","Total full-time Instruction/research/public service, Non-tenured not on tenure track, Lecturers","4","3","1","0","0","0","0","0","0","1","0","1","0","0","0","0","0","0","3","3","0","0","0","0","0","0","0","0","0","0","-2"
"190567","CUNY City College","2010","Total full-time Instruction/research/public service, Non-tenured not on tenure track total","26","14","12","0","0","0","1","1","0","6","0","6","1","1","0","0","0","0","15","10","5","0","0","0","0","0","0","3","2","1","-2"
"190576","CUNY Graduate School and University Center","2010","Total full-time Instruction/research/public service, Tenured, Professors","127","76","51","1","0","1","2","1","1","9","7","2","6","3","3","0","0","0","109","65","44","0","0","0","0","0","0","0","0","0","-2"
"190576","CUNY Graduate School and University Center","2010","Total full-time Instruction/research/public service, Tenured, Associate professors","11","7","4","0","0","0","0","0","0","0","0","0","0","0","0","0","0","0","9","6","3","0","0","0","0","0","0","2","1","1","-2"
"190576","CUNY Graduate School and University Center","2010","Total full-time Instruction/research/public service, Tenured total","138","83","55","1","0","1","2","1","1","9","7","2","6","3","3","0","0","0","118","71","47","0","0","0","0","0","0","2","1","1","-2"
"190576","CUNY Graduate School and University Center","2010","Total full-time Instruction/research/public service, Non-tenured on tenure track, Associate professors","9","8","1","0","0","0","2","1","1","1","1","0","0","0","0","0","0","0","5","5","0","0","0","0","0","0","0","1","1","0","-2"
"190576","CUNY Graduate School and University Center","2010","Total full-time Instruction/research/public service, Non-tenured on tenure track, Assistant professors","6","1","5","0","0","0","0","0","0","0","0","0","1","0","1","0","0","0","4","1","3","0","0","0","0","0","0","1","0","1","-2"
"190576","CUNY Graduate School and University Center","2010","Total full-time Instruction/research/public service, Non-tenured on tenure track total","15","9","6","0","0","0","2","1","1","1","1","0","1","0","1","0","0","0","9","6","3","0","0","0","0","0","0","2","1","1","-2"
"190576","CUNY Graduate School and University Center","2010","Total full-time Instruction/research/public service, Non-tenured not on tenure track, Professors","22","14","8","0","0","0","1","1","0","1","1","0","2","1","1","0","0","0","17","10","7","0","0","0","0","0","0","1","1","0","-2"
"190576","CUNY Graduate School and University Center","2010","Total full-time Instruction/research/public service, Non-tenured not on tenure track, Associate professors","6","2","4","0","0","0","0","0","0","0","0","0","0","0","0","0","0","0","6","2","4","0","0","0","0","0","0","0","0","0","-2"
"190576","CUNY Graduate School and University Center","2010","Total full-time Instruction/research/public servicey, Non-tenured not on tenure track, Assistant professors","10","4","6","0","0","0","0","0","0","1","0","1","0","0","0","0","0","0","9","4","5","0","0","0","0","0","0","0","0","0","-2"
"190576","CUNY Graduate School and University Center","2010","Total full-time Instruction/research/public service, Non-tenured not on tenure track, Instructors","1","1","0","0","0","0","0","0","0","0","0","0","0","0","0","0","0","0","1","1","0","0","0","0","0","0","0","0","0","0","-2"
"190576","CUNY Graduate School and University Center","2010","Total full-time Instruction/research/public service, Non-tenured not on tenure track, Lecturers","14","9","5","0","0","0","1","1","0","3","1","2","0","0","0","0","0","0","10","7","3","0","0","0","0","0","0","0","0","0","-2"
"190576","CUNY Graduate School and University Center","2010","Total full-time Instruction/research/public service, Non-tenured not on tenure track total","53","30","23","0","0","0","2","2","0","5","2","3","2","1","1","0","0","0","43","24","19","0","0","0","0","0","0","1","1","0","-2"
"193900","New York University","2010","Total full-time Instruction/research/public service, Tenured, Professors","898","663","235","0","0","0","49","36","13","26","15","11","31","23","8","0","0","0","782","582","200","1","1","0","0","0","0","9","6","3","-2"
"193900","New York University","2010","Total full-time Instruction/research/public service, Tenured, Associate professors","440","275","165","0","0","0","49","27","22","21","10","11","22","11","11","0","0","0","339","222","117","1","1","0","0","0","0","8","4","4","-2"
"193900","New York University","2010","Total full-time Instruction/research/public service, Tenured, Instructors","1","0","1","0","0","0","0","0","0","0","0","0","0","0","0","0","0","0","0","0","0","1","0","1","0","0","0","0","0","0","-2"
"193900","New York University","2010","Total full-time Instruction/research/public service, Tenured, No academic rank","42","16","26","0","0","0","1","0","1","4","1","3","1","0","1","0","0","0","35","15","20","0","0","0","0","0","0","1","0","1","-2"
"193900","New York University","2010","Total full-time Instruction/research/public service, Tenured total","1381","954","427","0","0","0","99","63","36","51","26","25","54","34","20","0","0","0","1156","819","337","3","2","1","0","0","0","18","10","8","-2"
"193900","New York University","2010","Total full-time Instruction/research/public service, Non-tenured on tenure track, Professors","7","6","1","0","0","0","0","0","0","0","0","0","1","0","1","0","0","0","6","6","0","0","0","0","0","0","0","0","0","0","-2"
"193900","New York University","2010","Total full-time Instruction/research/public service, Non-tenured on tenure track, Associate professors","52","29","23","0","0","0","9","5","4","5","2","3","3","2","1","0","0","0","29","17","12","0","0","0","0","0","0","6","3","3","-2"
"193900","New York University","2010","Total full-time Instruction/research/public service, Non-tenured on tenure track, Assistant professors","382","225","157","0","0","0","64","39","25","13","9","4","17","10","7","1","0","1","220","123","97","3","2","1","0","0","0","64","42","22","-2"
"193900","New York University","2010","Total full-time Instruction/research/public service, Non-tenured on tenure track, No academic rank","17","6","11","0","0","0","0","0","0","2","2","0","0","0","0","0","0","0","15","4","11","0","0","0","0","0","0","0","0","0","-2"
"193900","New York University","2010","Total full-time Instruction/research/public service, Non-tenured on tenure track total","458","266","192","0","0","0","73","44","29","20","13","7","21","12","9","1","0","1","270","150","120","3","2","1","0","0","0","70","45","25","-2"
"193900","New York University","2010","Total full-time Instruction/research/public service, Non-tenured not on tenure track, Professors","282","181","101","0","0","0","49","29","20","32","17","15","28","18","10","0","0","0","159","107","52","0","0","0","0","0","0","14","10","4","-2"
"193900","New York University","2010","Total full-time Instruction/research/public service, Non-tenured not on tenure track, Associate professors","229","156","73","0","0","0","27","19","8","8","4","4","8","5","3","1","1","0","177","121","56","0","0","0","0","0","0","8","6","2","-2"
"193900","New York University","2010","Total full-time Instruction/research/public servicey, Non-tenured not on tenure track, Assistant professors","514","269","245","0","0","0","120","53","67","27","11","16","25","14","11","0","0","0","311","176","135","0","0","0","0","0","0","31","15","16","-2"
"193900","New York University","2010","Total full-time Instruction/research/public service, Non-tenured not on tenure track, Instructors","125","56","69","0","0","0","34","14","20","4","0","4","4","3","1","1","1","0","80","37","43","0","0","0","0","0","0","2","1","1","-2"
"193900","New York University","2010","Total full-time Instruction/research/public service, Non-tenured not on tenure track, Lecturers","157","62","95","0","0","0","14","2","12","1","0","1","10","7","3","0","0","0","114","46","68","1","1","0","0","0","0","17","6","11","-2"
"193900","New York University","2010","Total full-time Instruction/research/public service, Non-tenured not on tenure track, No academic rank","1402","714","688","1","0","1","113","51","62","75","23","52","57","20","37","2","1","1","910","468","442","14","5","9","0","0","0","230","146","84","-2"
"193900","New York University","2010","Total full-time Instruction/research/public service, Non-tenured not on tenure track total","2709","1438","1271","1","0","1","357","168","189","147","55","92","132","67","65","4","3","1","1751","955","796","15","6","9","0","0","0","302","184","118","-2"
"196060","SUNY at Albany","2010","Total full-time Instruction/research/public service, Tenured, Professors","196","158","38","0","0","0","15","14","1","3","3","0","4","2","2","0","0","0","172","137","35","0","0","0","2","2","0","0","0","0","-2"
"196060","SUNY at Albany","2010","Total full-time Instruction/research/public service, Tenured, Associate professors","219","134","85","1","0","1","23","14","9","12","5","7","10","5","5","0","0","0","171","109","62","0","0","0","0","0","0","2","1","1","-2"
"196060","SUNY at Albany","2010","Total full-time Instruction/research/public service, Tenured total","415","292","123","1","0","1","38","28","10","15","8","7","14","7","7","0","0","0","343","246","97","0","0","0","2","2","0","2","1","1","-2"
"196060","SUNY at Albany","2010","Total full-time Instruction/research/public service, Non-tenured on tenure track, Professors","7","7","0","0","0","0","2","2","0","0","0","0","0","0","0","0","0","0","4","4","0","0","0","0","1","1","0","0","0","0","-2"
"196060","SUNY at Albany","2010","Total full-time Instruction/research/public service, Non-tenured on tenure track, Associate professors","6","3","3","0","0","0","2","1","1","0","0","0","0","0","0","0","0","0","1","1","0","0","0","0","3","1","2","0","0","0","-2"
"196060","SUNY at Albany","2010","Total full-time Instruction/research/public service, Non-tenured on tenure track, Assistant professors","132","66","66","0","0","0","21","11","10","6","2","4","5","3","2","0","0","0","69","31","38","0","0","0","12","7","5","19","12","7","-2"
"196060","SUNY at Albany","2010","Total full-time Instruction/research/public service, Non-tenured on tenure track total","145","76","69","0","0","0","25","14","11","6","2","4","5","3","2","0","0","0","74","36","38","0","0","0","16","9","7","19","12","7","-2"
"196060","SUNY at Albany","2010","Total full-time Instruction/research/public service, Non-tenured not on tenure track, Professors","2","2","0","0","0","0","0","0","0","1","1","0","0","0","0","0","0","0","1","1","0","0","0","0","0","0","0","0","0","0","-2"
"196060","SUNY at Albany","2010","Total full-time Instruction/research/public service, Non-tenured not on tenure track, Associate professors","5","2","3","0","0","0","0","0","0","2","1","1","0","0","0","0","0","0","3","1","2","0","0","0","0","0","0","0","0","0","-2"
"196060","SUNY at Albany","2010","Total full-time Instruction/research/public servicey, Non-tenured not on tenure track, Assistant professors","20","8","12","1","0","1","1","0","1","2","0","2","0","0","0","0","0","0","12","6","6","0","0","0","3","2","1","1","0","1","-2"
"196060","SUNY at Albany","2010","Total full-time Instruction/research/public service, Non-tenured not on tenure track, Lecturers","38","11","27","0","0","0","1","0","1","1","0","1","3","0","3","0","0","0","30","11","19","0","0","0","0","0","0","3","0","3","-2"
"196060","SUNY at Albany","2010","Total full-time Instruction/research/public service, Non-tenured not on tenure track total","65","23","42","1","0","1","2","0","2","6","2","4","3","0","3","0","0","0","46","19","27","0","0","0","3","2","1","4","0","4","-2"
"196097","Stony Brook University","2010","Total full-time Instruction/research/public service, Tenured, Professors","450","358","92","0","0","0","42","34","8","9","7","2","8","6","2","0","0","0","389","309","80","0","0","0","0","0","0","2","2","0","-2"
"196097","Stony Brook University","2010","Total full-time Instruction/research/public service, Tenured, Associate professors","222","148","74","1","1","0","23","16","7","11","7","4","9","7","2","0","0","0","176","115","61","0","0","0","0","0","0","2","2","0","-2"
"196097","Stony Brook University","2010","Total full-time Instruction/research/public service, Tenured, Assistant professors","2","0","2","0","0","0","0","0","0","0","0","0","0","0","0","0","0","0","2","0","2","0","0","0","0","0","0","0","0","0","-2"
"196097","Stony Brook University","2010","Total full-time Instruction/research/public service, Tenured total","674","506","168","1","1","0","65","50","15","20","14","6","17","13","4","0","0","0","567","424","143","0","0","0","0","0","0","4","4","0","-2"
"196097","Stony Brook University","2010","Total full-time Instruction/research/public service, Non-tenured on tenure track, Professors","8","6","2","0","0","0","1","1","0","0","0","0","0","0","0","0","0","0","4","2","2","0","0","0","0","0","0","3","3","0","-2"
"196097","Stony Brook University","2010","Total full-time Instruction/research/public service, Non-tenured on tenure track, Associate professors","7","3","4","0","0","0","1","1","0","0","0","0","0","0","0","0","0","0","3","1","2","0","0","0","0","0","0","3","1","2","-2"
"196097","Stony Brook University","2010","Total full-time Instruction/research/public service, Non-tenured on tenure track, Assistant professors","196","132","64","0","0","0","31","21","10","5","1","4","4","3","1","0","0","0","115","76","39","0","0","0","0","0","0","41","31","10","-2"
"196097","Stony Brook University","2010","Total full-time Instruction/research/public service, Non-tenured on tenure track total","211","141","70","0","0","0","33","23","10","5","1","4","4","3","1","0","0","0","122","79","43","0","0","0","0","0","0","47","35","12","-2"
"196097","Stony Brook University","2010","Total full-time Instruction/research/public service, Non-tenured not on tenure track, Professors","51","38","13","0","0","0","9","7","2","1","1","0","1","1","0","0","0","0","37","26","11","0","0","0","0","0","0","3","3","0","-2"
"196097","Stony Brook University","2010","Total full-time Instruction/research/public service, Non-tenured not on tenure track, Associate professors","127","80","47","0","0","0","18","7","11","4","1","3","1","1","0","0","0","0","103","70","33","0","0","0","0","0","0","1","1","0","-2"
"196097","Stony Brook University","2010","Total full-time Instruction/research/public servicey, Non-tenured not on tenure track, Assistant professors","306","160","146","0","0","0","49","35","14","15","6","9","10","3","7","0","0","0","202","99","103","0","0","0","0","0","0","30","17","13","-2"
"196097","Stony Brook University","2010","Total full-time Instruction/research/public service, Non-tenured not on tenure track, Instructors","30","11","19","0","0","0","4","0","4","3","1","2","1","0","1","0","0","0","20","8","12","0","0","0","0","0","0","2","2","0","-2"
"196097","Stony Brook University","2010","Total full-time Instruction/research/public service, Non-tenured not on tenure track, Lecturers","125","62","63","0","0","0","14","4","10","4","2","2","2","1","1","0","0","0","92","45","47","0","0","0","0","0","0","13","10","3","-2"
"196097","Stony Brook University","2010","Total full-time Instruction/research/public service, Non-tenured not on tenure track total","639","351","288","0","0","0","94","53","41","27","11","16","15","6","9","0","0","0","454","248","206","0","0","0","0","0","0","49","33","16","-2"
"196121","SUNY College at Brockport","2010","Total full-time Instruction/research/public service, Tenured, Professors","58","42","16","1","0","1","8","8","0","2","2","0","0","0","0","0","0","0","47","32","15","0","0","0","0","0","0","0","0","0","-2"
"196121","SUNY College at Brockport","2010","Total full-time Instruction/research/public service, Tenured, Associate professors","111","60","51","0","0","0","5","5","0","5","3","2","4","2","2","1","1","0","94","49","45","0","0","0","0","0","0","2","0","2","-2"
"196121","SUNY College at Brockport","2010","Total full-time Instruction/research/public service, Tenured, Assistant professors","12","0","12","0","0","0","1","0","1","1","0","1","2","0","2","0","0","0","8","0","8","0","0","0","0","0","0","0","0","0","-2"
"196121","SUNY College at Brockport","2010","Total full-time Instruction/research/public service, Tenured, Instructors","5","1","4","0","0","0","0","0","0","1","1","0","0","0","0","0","0","0","4","0","4","0","0","0","0","0","0","0","0","0","-2"
"196121","SUNY College at Brockport","2010","Total full-time Instruction/research/public service, Tenured total","186","103","83","1","0","1","14","13","1","9","6","3","6","2","4","1","1","0","153","81","72","0","0","0","0","0","0","2","0","2","-2"
"196121","SUNY College at Brockport","2010","Total full-time Instruction/research/public service, Non-tenured on tenure track, Associate professors","15","8","7","0","0","0","1","0","1","0","0","0","1","1","0","0","0","0","13","7","6","0","0","0","0","0","0","0","0","0","-2"
"196121","SUNY College at Brockport","2010","Total full-time Instruction/research/public service, Non-tenured on tenure track, Assistant professors","94","48","46","0","0","0","7","4","3","2","2","0","3","2","1","0","0","0","67","28","39","1","1","0","0","0","0","14","11","3","-2"
"196121","SUNY College at Brockport","2010","Total full-time Instruction/research/public service, Non-tenured on tenure track, Instructors","9","1","8","0","0","0","0","0","0","3","0","3","1","1","0","0","0","0","3","0","3","0","0","0","0","0","0","2","0","2","-2"
"196121","SUNY College at Brockport","2010","Total full-time Instruction/research/public service, Non-tenured on tenure track total","118","57","61","0","0","0","8","4","4","5","2","3","5","4","1","0","0","0","83","35","48","1","1","0","0","0","0","16","11","5","-2"
"196121","SUNY College at Brockport","2010","Total full-time Instruction/research/public service, Non-tenured not on tenure track, Professors","1","1","0","0","0","0","0","0","0","0","0","0","0","0","0","0","0","0","1","1","0","0","0","0","0","0","0","0","0","0","-2"
"196121","SUNY College at Brockport","2010","Total full-time Instruction/research/public service, Non-tenured not on tenure track, Associate professors","2","1","1","0","0","0","0","0","0","0","0","0","0","0","0","0","0","0","2","1","1","0","0","0","0","0","0","0","0","0","-2"
"196121","SUNY College at Brockport","2010","Total full-time Instruction/research/public servicey, Non-tenured not on tenure track, Assistant professors","31","16","15","0","0","0","1","1","0","3","1","2","1","1","0","0","0","0","25","12","13","0","0","0","0","0","0","1","1","0","-2"
"196121","SUNY College at Brockport","2010","Total full-time Instruction/research/public service, Non-tenured not on tenure track, Lecturers","24","8","16","0","0","0","0","0","0","4","1","3","1","0","1","0","0","0","19","7","12","0","0","0","0","0","0","0","0","0","-2"
"196121","SUNY College at Brockport","2010","Total full-time Instruction/research/public service, Non-tenured not on tenure track total","58","26","32","0","0","0","1","1","0","7","2","5","2","1","1","0","0","0","47","21","26","0","0","0","0","0","0","1","1","0","-2"
"196130","SUNY Buffalo State","2010","Total full-time Instruction/research/public service, Tenured, Professors","106","76","30","1","0","1","8","7","1","6","3","3","1","1","0","0","0","0","90","65","25","0","0","0","0","0","0","0","0","0","-2"
"196130","SUNY Buffalo State","2010","Total full-time Instruction/research/public service, Tenured, Associate professors","152","90","62","1","1","0","5","2","3","9","5","4","7","2","5","0","0","0","126","77","49","0","0","0","0","0","0","4","3","1","-2"
"196130","SUNY Buffalo State","2010","Total full-time Instruction/research/public service, Tenured, Assistant professors","5","2","3","1","1","0","1","0","1","0","0","0","0","0","0","0","0","0","3","1","2","0","0","0","0","0","0","0","0","0","-2"
"196130","SUNY Buffalo State","2010","Total full-time Instruction/research/public service, Tenured total","263","168","95","3","2","1","14","9","5","15","8","7","8","3","5","0","0","0","219","143","76","0","0","0","0","0","0","4","3","1","-2"
"196130","SUNY Buffalo State","2010","Total full-time Instruction/research/public service, Non-tenured on tenure track, Professors","1","1","0","0","0","0","0","0","0","0","0","0","0","0","0","0","0","0","1","1","0","0","0","0","0","0","0","0","0","0","-2"
"196130","SUNY Buffalo State","2010","Total full-time Instruction/research/public service, Non-tenured on tenure track, Associate professors","12","5","7","0","0","0","0","0","0","0","0","0","0","0","0","0","0","0","12","5","7","0","0","0","0","0","0","0","0","0","-2"
"196130","SUNY Buffalo State","2010","Total full-time Instruction/research/public service, Non-tenured on tenure track, Assistant professors","107","40","67","1","0","1","9","4","5","6","3","3","6","2","4","0","0","0","72","25","47","3","2","1","0","0","0","10","4","6","-2"
"196130","SUNY Buffalo State","2010","Total full-time Instruction/research/public service, Non-tenured on tenure track total","120","46","74","1","0","1","9","4","5","6","3","3","6","2","4","0","0","0","85","31","54","3","2","1","0","0","0","10","4","6","-2"
"196130","SUNY Buffalo State","2010","Total full-time Instruction/research/public service, Non-tenured not on tenure track, Professors","1","1","0","0","0","0","0","0","0","0","0","0","0","0","0","0","0","0","1","1","0","0","0","0","0","0","0","0","0","0","-2"
"196130","SUNY Buffalo State","2010","Total full-time Instruction/research/public service, Non-tenured not on tenure track, Associate professors","2","0","2","0","0","0","0","0","0","0","0","0","0","0","0","0","0","0","1","0","1","0","0","0","0","0","0","1","0","1","-2"
"196130","SUNY Buffalo State","2010","Total full-time Instruction/research/public service, Non-tenured not on tenure track, Lecturers","39","17","22","0","0","0","2","1","1","3","2","1","1","0","1","0","0","0","32","14","18","0","0","0","0","0","0","1","0","1","-2"
"196130","SUNY Buffalo State","2010","Total full-time Instruction/research/public service, Non-tenured not on tenure track total","42","18","24","0","0","0","2","1","1","3","2","1","1","0","1","0","0","0","34","15","19","0","0","0","0","0","0","2","0","2","-2"
"196185","SUNY Oneonta","2010","Total full-time Instruction/research/public service, Tenured, Professors","33","26","7","0","0","0","2","2","0","2","1","1","0","0","0","0","0","0","29","23","6","0","0","0","0","0","0","0","0","0","-2"
"196185","SUNY Oneonta","2010","Total full-time Instruction/research/public service, Tenured, Associate professors","70","41","29","0","0","0","10","6","4","1","0","1","0","0","0","0","0","0","59","35","24","0","0","0","0","0","0","0","0","0","-2"
"196185","SUNY Oneonta","2010","Total full-time Instruction/research/public service, Tenured, Assistant professors","15","7","8","0","0","0","2","1","1","0","0","0","0","0","0","0","0","0","13","6","7","0","0","0","0","0","0","0","0","0","-2"
"196185","SUNY Oneonta","2010","Total full-time Instruction/research/public service, Tenured total","118","74","44","0","0","0","14","9","5","3","1","2","0","0","0","0","0","0","101","64","37","0","0","0","0","0","0","0","0","0","-2"
"196185","SUNY Oneonta","2010","Total full-time Instruction/research/public service, Non-tenured on tenure track, Associate professors","6","4","2","0","0","0","1","1","0","0","0","0","1","1","0","0","0","0","4","2","2","0","0","0","0","0","0","0","0","0","-2"
"196185","SUNY Oneonta","2010","Total full-time Instruction/research/public service, Non-tenured on tenure track, Assistant professors","94","52","42","0","0","0","4","1","3","3","2","1","1","1","0","0","0","0","74","42","32","0","0","0","0","0","0","12","6","6","-2"
"196185","SUNY Oneonta","2010","Total full-time Instruction/research/public service, Non-tenured on tenure track total","100","56","44","0","0","0","5","2","3","3","2","1","2","2","0","0","0","0","78","44","34","0","0","0","0","0","0","12","6","6","-2"
"196185","SUNY Oneonta","2010","Total full-time Instruction/research/public service, Non-tenured not on tenure track, Lecturers","33","18","15","1","0","1","0","0","0","3","0","3","3","0","3","0","0","0","23","16","7","0","0","0","0","0","0","3","2","1","-2"
"196185","SUNY Oneonta","2010","Total full-time Instruction/research/public service, Non-tenured not on tenure track total","33","18","15","1","0","1","0","0","0","3","0","3","3","0","3","0","0","0","23","16","7","0","0","0","0","0","0","3","2","1","-2"
"196194","SUNY College at Oswego","2010","Total full-time Instruction/research/public service, Tenured, Professors","75","54","21","1","1","0","9","8","1","1","1","0","0","0","0","0","0","0","64","44","20","0","0","0","0","0","0","0","0","0","-2"
"196194","SUNY College at Oswego","2010","Total full-time Instruction/research/public service, Tenured, Associate professors","80","43","37","0","0","0","2","2","0","6","3","3","4","3","1","0","0","0","67","35","32","1","0","1","0","0","0","0","0","0","-2"
"196194","SUNY College at Oswego","2010","Total full-time Instruction/research/public service, Tenured, Assistant professors","14","8","6","0","0","0","1","1","0","0","0","0","0","0","0","0","0","0","12","7","5","1","0","1","0","0","0","0","0","0","-2"
"196194","SUNY College at Oswego","2010","Total full-time Instruction/research/public service, Tenured total","169","105","64","1","1","0","12","11","1","7","4","3","4","3","1","0","0","0","143","86","57","2","0","2","0","0","0","0","0","0","-2"
"196194","SUNY College at Oswego","2010","Total full-time Instruction/research/public service, Non-tenured on tenure track, Professors","2","2","0","0","0","0","1","1","0","1","1","0","0","0","0","0","0","0","0","0","0","0","0","0","0","0","0","0","0","0","-2"
"196194","SUNY College at Oswego","2010","Total full-time Instruction/research/public service, Non-tenured on tenure track, Associate professors","25","16","9","0","0","0","1","1","0","3","1","2","1","0","1","0","0","0","20","14","6","0","0","0","0","0","0","0","0","0","-2"
"196194","SUNY College at Oswego","2010","Total full-time Instruction/research/public service, Non-tenured on tenure track, Assistant professors","65","32","33","1","1","0","1","0","1","7","2","5","2","1","1","1","0","1","46","23","23","0","0","0","0","0","0","7","5","2","-2"
"196194","SUNY College at Oswego","2010","Total full-time Instruction/research/public service, Non-tenured on tenure track, Instructors","1","0","1","0","0","0","0","0","0","0","0","0","0","0","0","0","0","0","1","0","1","0","0","0","0","0","0","0","0","0","-2"
"196194","SUNY College at Oswego","2010","Total full-time Instruction/research/public service, Non-tenured on tenure track total","93","50","43","1","1","0","3","2","1","11","4","7","3","1","2","1","0","1","67","37","30","0","0","0","0","0","0","7","5","2","-2"
"196194","SUNY College at Oswego","2010","Total full-time Instruction/research/public service, Non-tenured not on tenure track, Professors","2","1","1","0","0","0","1","0","1","0","0","0","0","0","0","0","0","0","0","0","0","0","0","0","0","0","0","1","1","0","-2"
"196194","SUNY College at Oswego","2010","Total full-time Instruction/research/public service, Non-tenured not on tenure track, Associate professors","1","1","0","0","0","0","0","0","0","0","0","0","0","0","0","0","0","0","0","0","0","0","0","0","0","0","0","1","1","0","-2"
"196194","SUNY College at Oswego","2010","Total full-time Instruction/research/public servicey, Non-tenured not on tenure track, Assistant professors","34","20","14","1","1","0","0","0","0","0","0","0","2","1","1","0","0","0","29","18","11","0","0","0","0","0","0","2","0","2","-2"
"196194","SUNY College at Oswego","2010","Total full-time Instruction/research/public service, Non-tenured not on tenure track, Instructors","12","3","9","0","0","0","0","0","0","0","0","0","0","0","0","0","0","0","12","3","9","0","0","0","0","0","0","0","0","0","-2"
"196194","SUNY College at Oswego","2010","Total full-time Instruction/research/public service, Non-tenured not on tenure track, Lecturers","8","5","3","0","0","0","0","0","0","0","0","0","0","0","0","0","0","0","8","5","3","0","0","0","0","0","0","0","0","0","-2"
"196194","SUNY College at Oswego","2010","Total full-time Instruction/research/public service, Non-tenured not on tenure track total","57","30","27","1","1","0","1","0","1","0","0","0","2","1","1","0","0","0","49","26","23","0","0","0","0","0","0","4","2","2","-2"
"196291","SUNY Maritime College","2010","Total full-time Instruction/research/public service, Tenured, Professors","19","14","5","0","0","0","1","1","0","0","0","0","0","0","0","0","0","0","18","13","5","0","0","0","0","0","0","0","0","0","-2"
"196291","SUNY Maritime College","2010","Total full-time Instruction/research/public service, Tenured, Associate professors","7","7","0","0","0","0","0","0","0","0","0","0","0","0","0","0","0","0","7","7","0","0","0","0","0","0","0","0","0","0","-2"
"196291","SUNY Maritime College","2010","Total full-time Instruction/research/public service, Tenured, Assistant professors","3","3","0","0","0","0","0","0","0","0","0","0","0","0","0","0","0","0","3","3","0","0","0","0","0","0","0","0","0","0","-2"
"196291","SUNY Maritime College","2010","Total full-time Instruction/research/public service, Tenured total","29","24","5","0","0","0","1","1","0","0","0","0","0","0","0","0","0","0","28","23","5","0","0","0","0","0","0","0","0","0","-2"
"196291","SUNY Maritime College","2010","Total full-time Instruction/research/public service, Non-tenured on tenure track, Associate professors","2","2","0","0","0","0","0","0","0","0","0","0","0","0","0","0","0","0","2","2","0","0","0","0","0","0","0","0","0","0","-2"
"196291","SUNY Maritime College","2010","Total full-time Instruction/research/public service, Non-tenured on tenure track, Assistant professors","16","10","6","0","0","0","1","0","1","0","0","0","0","0","0","0","0","0","10","6","4","0","0","0","0","0","0","5","4","1","-2"
"196291","SUNY Maritime College","2010","Total full-time Instruction/research/public service, Non-tenured on tenure track, Instructors","1","0","1","0","0","0","0","0","0","0","0","0","0","0","0","0","0","0","1","0","1","0","0","0","0","0","0","0","0","0","-2"
"196291","SUNY Maritime College","2010","Total full-time Instruction/research/public service, Non-tenured on tenure track total","19","12","7","0","0","0","1","0","1","0","0","0","0","0","0","0","0","0","13","8","5","0","0","0","0","0","0","5","4","1","-2"
"196291","SUNY Maritime College","2010","Total full-time Instruction/research/public servicey, Non-tenured not on tenure track, Assistant professors","1","1","0","0","0","0","0","0","0","0","0","0","0","0","0","0","0","0","1","1","0","0","0","0","0","0","0","0","0","0","-2"
"196291","SUNY Maritime College","2010","Total full-time Instruction/research/public service, Non-tenured not on tenure track, Instructors","2","2","0","0","0","0","0","0","0","0","0","0","0","0","0","0","0","0","2","2","0","0","0","0","0","0","0","0","0","0","-2"
"196291","SUNY Maritime College","2010","Total full-time Instruction/research/public service, Non-tenured not on tenure track, Lecturers","25","21","4","0","0","0","1","0","1","2","1","1","0","0","0","0","0","0","22","20","2","0","0","0","0","0","0","0","0","0","-2"
"196291","SUNY Maritime College","2010","Total full-time Instruction/research/public service, Non-tenured not on tenure track total","28","24","4","0","0","0","1","0","1","2","1","1","0","0","0","0","0","0","25","23","2","0","0","0","0","0","0","0","0","0","-2"
"197869","Appalachian State University","2010","Total full-time Instruction/research/public service, Tenured, Professors","268","182","86","1","1","0","2","2","0","3","2","1","5","3","2","0","0","0","253","170","83","1","1","0","1","1","0","2","2","0","-2"
"197869","Appalachian State University","2010","Total full-time Instruction/research/public service, Tenured, Associate professors","147","80","67","1","0","1","3","3","0","5","3","2","1","0","1","0","0","0","132","70","62","1","1","0","1","1","0","3","2","1","-2"
"197869","Appalachian State University","2010","Total full-time Instruction/research/public service, Tenured total","415","262","153","2","1","1","5","5","0","8","5","3","6","3","3","0","0","0","385","240","145","2","2","0","2","2","0","5","4","1","-2"
"197869","Appalachian State University","2010","Total full-time Instruction/research/public service, Non-tenured on tenure track, Professors","2","2","0","0","0","0","0","0","0","0","0","0","0","0","0","0","0","0","2","2","0","0","0","0","0","0","0","0","0","0","-2"
"197869","Appalachian State University","2010","Total full-time Instruction/research/public service, Non-tenured on tenure track, Associate professors","44","19","25","1","0","1","1","0","1","2","2","0","2","1","1","0","0","0","35","16","19","0","0","0","0","0","0","3","0","3","-2"
"197869","Appalachian State University","2010","Total full-time Instruction/research/public service, Non-tenured on tenure track, Assistant professors","231","114","117","2","2","0","5","3","2","5","3","2","4","2","2","0","0","0","192","92","100","3","2","1","1","1","0","19","9","10","-2"
"197869","Appalachian State University","2010","Total full-time Instruction/research/public service, Non-tenured on tenure track total","277","135","142","3","2","1","6","3","3","7","5","2","6","3","3","0","0","0","229","110","119","3","2","1","1","1","0","22","9","13","-2"
"197869","Appalachian State University","2010","Total full-time Instruction/research/public servicey, Non-tenured not on tenure track, Assistant professors","2","2","0","0","0","0","0","0","0","0","0","0","0","0","0","0","0","0","2","2","0","0","0","0","0","0","0","0","0","0","-2"
"197869","Appalachian State University","2010","Total full-time Instruction/research/public service, Non-tenured not on tenure track, Instructors","7","4","3","0","0","0","0","0","0","0","0","0","1","1","0","0","0","0","6","3","3","0","0","0","0","0","0","0","0","0","-2"
"197869","Appalachian State University","2010","Total full-time Instruction/research/public service, Non-tenured not on tenure track, Lecturers","108","48","60","0","0","0","2","0","2","3","3","0","2","0","2","0","0","0","99","45","54","1","0","1","0","0","0","1","0","1","-2"
"197869","Appalachian State University","2010","Total full-time Instruction/research/public service, Non-tenured not on tenure track, No academic rank","53","24","29","0","0","0","1","0","1","0","0","0","1","0","1","0","0","0","50","24","26","1","0","1","0","0","0","0","0","0","-2"
"197869","Appalachian State University","2010","Total full-time Instruction/research/public service, Non-tenured not on tenure track total","170","78","92","0","0","0","3","0","3","3","3","0","4","1","3","0","0","0","157","74","83","2","0","2","0","0","0","1","0","1","-2"
"199102","North Carolina A & T State University","2010","Total full-time Instruction/research/public service, Tenured, Professors","107","82","25","3","2","1","18","16","2","43","31","12","1","1","0","0","0","0","34","25","9","0","0","0","2","2","0","6","5","1","-2"
"199102","North Carolina A & T State University","2010","Total full-time Instruction/research/public service, Tenured, Associate professors","156","91","65","0","0","0","19","15","4","93","46","47","1","0","1","0","0","0","41","29","12","0","0","0","0","0","0","2","1","1","-2"
"199102","North Carolina A & T State University","2010","Total full-time Instruction/research/public service, Tenured, Assistant professors","5","3","2","0","0","0","0","0","0","5","3","2","0","0","0","0","0","0","0","0","0","0","0","0","0","0","0","0","0","0","-2"
"199102","North Carolina A & T State University","2010","Total full-time Instruction/research/public service, Tenured total","268","176","92","3","2","1","37","31","6","141","80","61","2","1","1","0","0","0","75","54","21","0","0","0","2","2","0","8","6","2","-2"
"199102","North Carolina A & T State University","2010","Total full-time Instruction/research/public service, Non-tenured on tenure track, Professors","2","2","0","0","0","0","0","0","0","2","2","0","0","0","0","0","0","0","0","0","0","0","0","0","0","0","0","0","0","0","-2"
"199102","North Carolina A & T State University","2010","Total full-time Instruction/research/public service, Non-tenured on tenure track, Associate professors","25","15","10","0","0","0","5","4","1","13","6","7","1","1","0","0","0","0","6","4","2","0","0","0","0","0","0","0","0","0","-2"
"199102","North Carolina A & T State University","2010","Total full-time Instruction/research/public service, Non-tenured on tenure track, Assistant professors","97","46","51","0","0","0","12","7","5","46","14","32","1","1","0","0","0","0","31","18","13","0","0","0","0","0","0","7","6","1","-2"
"199102","North Carolina A & T State University","2010","Total full-time Instruction/research/public service, Non-tenured on tenure track total","124","63","61","0","0","0","17","11","6","61","22","39","2","2","0","0","0","0","37","22","15","0","0","0","0","0","0","7","6","1","-2"
"199102","North Carolina A & T State University","2010","Total full-time Instruction/research/public service, Non-tenured not on tenure track, Professors","2","2","0","0","0","0","0","0","0","2","2","0","0","0","0","0","0","0","0","0","0","0","0","0","0","0","0","0","0","0","-2"
"199102","North Carolina A & T State University","2010","Total full-time Instruction/research/public service, Non-tenured not on tenure track, Associate professors","1","1","0","0","0","0","0","0","0","0","0","0","0","0","0","0","0","0","1","1","0","0","0","0","0","0","0","0","0","0","-2"
"199102","North Carolina A & T State University","2010","Total full-time Instruction/research/public service, Non-tenured not on tenure track, Instructors","5","1","4","0","0","0","0","0","0","5","1","4","0","0","0","0","0","0","0","0","0","0","0","0","0","0","0","0","0","0","-2"
"199102","North Carolina A & T State University","2010","Total full-time Instruction/research/public service, Non-tenured not on tenure track, Lecturers","33","14","19","1","0","1","1","0","1","21","10","11","1","0","1","0","0","0","9","4","5","0","0","0","0","0","0","0","0","0","-2"
"199102","North Carolina A & T State University","2010","Total full-time Instruction/research/public service, Non-tenured not on tenure track, No academic rank","86","30","56","2","0","2","2","2","0","59","18","41","0","0","0","0","0","0","22","9","13","0","0","0","0","0","0","1","1","0","-2"
"199102","North Carolina A & T State University","2010","Total full-time Instruction/research/public service, Non-tenured not on tenure track total","127","48","79","3","0","3","3","2","1","87","31","56","1","0","1","0","0","0","32","14","18","0","0","0","0","0","0","1","1","0","-2"
"199111","University of North Carolina at Asheville","2010","Total full-time Instruction/research/public service, Tenured, Professors","62","45","17","1","1","0","1","1","0","2","1","1","1","1","0","0","0","0","56","40","16","1","1","0","0","0","0","0","0","0","-2"
"199111","University of North Carolina at Asheville","2010","Total full-time Instruction/research/public service, Tenured, Associate professors","63","35","28","0","0","0","4","2","2","3","2","1","1","0","1","0","0","0","55","31","24","0","0","0","0","0","0","0","0","0","-2"
"199111","University of North Carolina at Asheville","2010","Total full-time Instruction/research/public service, Tenured, Assistant professors","1","1","0","0","0","0","0","0","0","1","1","0","0","0","0","0","0","0","0","0","0","0","0","0","0","0","0","0","0","0","-2"
"199111","University of North Carolina at Asheville","2010","Total full-time Instruction/research/public service, Tenured total","126","81","45","1","1","0","5","3","2","6","4","2","2","1","1","0","0","0","111","71","40","1","1","0","0","0","0","0","0","0","-2"
"199111","University of North Carolina at Asheville","2010","Total full-time Instruction/research/public service, Non-tenured on tenure track, Associate professors","1","0","1","0","0","0","0","0","0","0","0","0","0","0","0","0","0","0","1","0","1","0","0","0","0","0","0","0","0","0","-2"
"199111","University of North Carolina at Asheville","2010","Total full-time Instruction/research/public service, Non-tenured on tenure track, Assistant professors","43","19","24","0","0","0","4","1","3","1","1","0","1","0","1","0","0","0","34","16","18","1","0","1","0","0","0","2","1","1","-2"
"199111","University of North Carolina at Asheville","2010","Total full-time Instruction/research/public service, Non-tenured on tenure track total","44","19","25","0","0","0","4","1","3","1","1","0","1","0","1","0","0","0","35","16","19","1","0","1","0","0","0","2","1","1","-2"
"199111","University of North Carolina at Asheville","2010","Total full-time Instruction/research/public service, Non-tenured not on tenure track, Lecturers","44","22","22","0","0","0","0","0","0","0","0","0","3","2","1","0","0","0","41","20","21","0","0","0","0","0","0","0","0","0","-2"
"199111","University of North Carolina at Asheville","2010","Total full-time Instruction/research/public service, Non-tenured not on tenure track, No academic rank","3","0","3","0","0","0","0","0","0","2","0","2","1","0","1","0","0","0","0","0","0","0","0","0","0","0","0","0","0","0","-2"
"199111","University of North Carolina at Asheville","2010","Total full-time Instruction/research/public service, Non-tenured not on tenure track total","47","22","25","0","0","0","0","0","0","2","0","2","4","2","2","0","0","0","41","20","21","0","0","0","0","0","0","0","0","0","-2"
"199120","University of North Carolina at Chapel Hill","2010","Total full-time Instruction/research/public service, Tenured, Professors","933","703","230","1","1","0","51","43","8","20","11","9","14","9","5","0","0","0","842","634","208","0","0","0","0","0","0","5","5","0","-2"
"199120","University of North Carolina at Chapel Hill","2010","Total full-time Instruction/research/public service, Tenured, Associate professors","467","280","187","2","1","1","48","33","15","33","11","22","13","9","4","0","0","0","359","219","140","4","4","0","0","0","0","8","3","5","-2"
"199120","University of North Carolina at Chapel Hill","2010","Total full-time Instruction/research/public service, Tenured, Assistant professors","1","1","0","0","0","0","0","0","0","0","0","0","0","0","0","0","0","0","1","1","0","0","0","0","0","0","0","0","0","0","-2"
"199120","University of North Carolina at Chapel Hill","2010","Total full-time Instruction/research/public service, Tenured total","1401","984","417","3","2","1","99","76","23","53","22","31","27","18","9","0","0","0","1202","854","348","4","4","0","0","0","0","13","8","5","-2"
"199120","University of North Carolina at Chapel Hill","2010","Total full-time Instruction/research/public service, Non-tenured on tenure track, Associate professors","20","11","9","0","0","0","3","2","1","4","4","0","1","0","1","0","0","0","11","5","6","0","0","0","0","0","0","1","0","1","-2"
"199120","University of North Carolina at Chapel Hill","2010","Total full-time Instruction/research/public service, Non-tenured on tenure track, Assistant professors","424","243","181","5","3","2","52","30","22","28","10","18","27","16","11","0","0","0","265","153","112","1","1","0","1","0","1","45","30","15","-2"
"199120","University of North Carolina at Chapel Hill","2010","Total full-time Instruction/research/public service, Non-tenured on tenure track total","444","254","190","5","3","2","55","32","23","32","14","18","28","16","12","0","0","0","276","158","118","1","1","0","1","0","1","46","30","16","-2"
"199120","University of North Carolina at Chapel Hill","2010","Total full-time Instruction/research/public service, Non-tenured not on tenure track, Professors","35","25","10","0","0","0","3","3","0","0","0","0","0","0","0","0","0","0","32","22","10","0","0","0","0","0","0","0","0","0","-2"
"199120","University of North Carolina at Chapel Hill","2010","Total full-time Instruction/research/public service, Non-tenured not on tenure track, Associate professors","71","34","37","0","0","0","13","7","6","2","1","1","2","1","1","0","0","0","52","24","28","0","0","0","0","0","0","2","1","1","-2"
"199120","University of North Carolina at Chapel Hill","2010","Total full-time Instruction/research/public servicey, Non-tenured not on tenure track, Assistant professors","194","106","88","0","0","0","36","24","12","3","0","3","7","3","4","0","0","0","119","63","56","1","1","0","0","0","0","28","15","13","-2"
"199120","University of North Carolina at Chapel Hill","2010","Total full-time Instruction/research/public service, Non-tenured not on tenure track, Instructors","29","17","12","0","0","0","6","3","3","1","0","1","1","0","1","0","0","0","16","9","7","0","0","0","0","0","0","5","5","0","-2"
"199120","University of North Carolina at Chapel Hill","2010","Total full-time Instruction/research/public service, Non-tenured not on tenure track, Lecturers","120","40","80","0","0","0","12","4","8","4","1","3","9","5","4","0","0","0","80","26","54","1","0","1","0","0","0","14","4","10","-2"
"199120","University of North Carolina at Chapel Hill","2010","Total full-time Instruction/research/public service, Non-tenured not on tenure track, No academic rank","783","347","436","2","1","1","44","21","23","48","19","29","23","11","12","0","0","0","646","283","363","1","0","1","4","3","1","15","9","6","-2"
"199120","University of North Carolina at Chapel Hill","2010","Total full-time Instruction/research/public service, Non-tenured not on tenure track total","1232","569","663","2","1","1","114","62","52","58","21","37","42","20","22","0","0","0","945","427","518","3","1","2","4","3","1","64","34","30","-2"
"199139","University of North Carolina at Charlotte","2010","Total full-time Instruction/research/public service, Tenured, Professors","204","163","41","0","0","0","22","21","1","6","5","1","5","3","2","0","0","0","171","134","37","0","0","0","0","0","0","0","0","0","-2"
"199139","University of North Carolina at Charlotte","2010","Total full-time Instruction/research/public service, Tenured, Associate professors","279","175","104","0","0","0","34","27","7","18","9","9","8","4","4","0","0","0","210","132","78","0","0","0","1","0","1","8","3","5","-2"
"199139","University of North Carolina at Charlotte","2010","Total full-time Instruction/research/public service, Tenured, Assistant professors","2","1","1","0","0","0","0","0","0","0","0","0","0","0","0","0","0","0","2","1","1","0","0","0","0","0","0","0","0","0","-2"
"199139","University of North Carolina at Charlotte","2010","Total full-time Instruction/research/public service, Tenured total","485","339","146","0","0","0","56","48","8","24","14","10","13","7","6","0","0","0","383","267","116","0","0","0","1","0","1","8","3","5","-2"
"199139","University of North Carolina at Charlotte","2010","Total full-time Instruction/research/public service, Non-tenured on tenure track, Associate professors","15","7","8","0","0","0","1","0","1","1","1","0","1","1","0","0","0","0","12","5","7","0","0","0","0","0","0","0","0","0","-2"
"199139","University of North Carolina at Charlotte","2010","Total full-time Instruction/research/public service, Non-tenured on tenure track, Assistant professors","229","117","112","0","0","0","19","15","4","18","8","10","5","1","4","0","0","0","142","72","70","0","0","0","3","0","3","42","21","21","-2"
"199139","University of North Carolina at Charlotte","2010","Total full-time Instruction/research/public service, Non-tenured on tenure track total","244","124","120","0","0","0","20","15","5","19","9","10","6","2","4","0","0","0","154","77","77","0","0","0","3","0","3","42","21","21","-2"
"199139","University of North Carolina at Charlotte","2010","Total full-time Instruction/research/public service, Non-tenured not on tenure track, Associate professors","1","1","0","0","0","0","0","0","0","0","0","0","0","0","0","0","0","0","0","0","0","0","0","0","0","0","0","1","1","0","-2"
"199139","University of North Carolina at Charlotte","2010","Total full-time Instruction/research/public servicey, Non-tenured not on tenure track, Assistant professors","1","1","0","0","0","0","0","0","0","0","0","0","0","0","0","0","0","0","0","0","0","0","0","0","0","0","0","1","1","0","-2"
"199139","University of North Carolina at Charlotte","2010","Total full-time Instruction/research/public service, Non-tenured not on tenure track, Lecturers","165","56","109","0","0","0","4","1","3","10","2","8","4","1","3","0","0","0","140","49","91","0","0","0","4","1","3","3","2","1","-2"
"199139","University of North Carolina at Charlotte","2010","Total full-time Instruction/research/public service, Non-tenured not on tenure track, No academic rank","53","20","33","0","0","0","0","0","0","2","0","2","0","0","0","0","0","0","44","15","29","0","0","0","3","2","1","4","3","1","-2"
"199139","University of North Carolina at Charlotte","2010","Total full-time Instruction/research/public service, Non-tenured not on tenure track total","220","78","142","0","0","0","4","1","3","12","2","10","4","1","3","0","0","0","184","64","120","0","0","0","7","3","4","9","7","2","-2"
"199157","North Carolina Central University","2010","Total full-time Instruction/research/public service, Tenured, Professors","61","42","19","0","0","0","5","3","2","36","23","13","0","0","0","0","0","0","18","15","3","0","0","0","1","0","1","1","1","0","-2"
"199157","North Carolina Central University","2010","Total full-time Instruction/research/public service, Tenured, Associate professors","55","34","21","0","0","0","4","3","1","32","20","12","0","0","0","0","0","0","15","8","7","0","0","0","2","2","0","2","1","1","-2"
"199157","North Carolina Central University","2010","Total full-time Instruction/research/public service, Tenured, Assistant professors","20","14","6","0","0","0","0","0","0","12","7","5","0","0","0","0","0","0","7","6","1","0","0","0","0","0","0","1","1","0","-2"
"199157","North Carolina Central University","2010","Total full-time Instruction/research/public service, Tenured total","136","90","46","0","0","0","9","6","3","80","50","30","0","0","0","0","0","0","40","29","11","0","0","0","3","2","1","4","3","1","-2"
"199157","North Carolina Central University","2010","Total full-time Instruction/research/public service, Non-tenured on tenure track, Professors","2","1","1","0","0","0","0","0","0","1","0","1","0","0","0","0","0","0","0","0","0","0","0","0","0","0","0","1","1","0","-2"
"199157","North Carolina Central University","2010","Total full-time Instruction/research/public service, Non-tenured on tenure track, Associate professors","36","18","18","0","0","0","4","1","3","21","13","8","2","1","1","0","0","0","6","2","4","0","0","0","1","0","1","2","1","1","-2"
"199157","North Carolina Central University","2010","Total full-time Instruction/research/public service, Non-tenured on tenure track, Assistant professors","111","45","66","0","0","0","8","3","5","53","15","38","1","1","0","0","0","0","33","16","17","0","0","0","4","2","2","12","8","4","-2"
"199157","North Carolina Central University","2010","Total full-time Instruction/research/public service, Non-tenured on tenure track total","149","64","85","0","0","0","12","4","8","75","28","47","3","2","1","0","0","0","39","18","21","0","0","0","5","2","3","15","10","5","-2"
"199157","North Carolina Central University","2010","Total full-time Instruction/research/public service, Non-tenured not on tenure track, Associate professors","1","1","0","0","0","0","0","0","0","0","0","0","0","0","0","0","0","0","1","1","0","0","0","0","0","0","0","0","0","0","-2"
"199157","North Carolina Central University","2010","Total full-time Instruction/research/public servicey, Non-tenured not on tenure track, Assistant professors","1","1","0","0","0","0","0","0","0","0","0","0","0","0","0","0","0","0","1","1","0","0","0","0","0","0","0","0","0","0","-2"
"199157","North Carolina Central University","2010","Total full-time Instruction/research/public service, Non-tenured not on tenure track, Instructors","3","1","2","0","0","0","0","0","0","3","1","2","0","0","0","0","0","0","0","0","0","0","0","0","0","0","0","0","0","0","-2"
"199157","North Carolina Central University","2010","Total full-time Instruction/research/public service, Non-tenured not on tenure track, Lecturers","3","1","2","0","0","0","0","0","0","1","0","1","0","0","0","0","0","0","2","1","1","0","0","0","0","0","0","0","0","0","-2"
"199157","North Carolina Central University","2010","Total full-time Instruction/research/public service, Non-tenured not on tenure track, No academic rank","119","45","74","1","1","0","5","2","3","75","24","51","3","1","2","0","0","0","28","14","14","0","0","0","2","2","0","5","1","4","-2"
"199157","North Carolina Central University","2010","Total full-time Instruction/research/public service, Non-tenured not on tenure track total","127","49","78","1","1","0","5","2","3","79","25","54","3","1","2","0","0","0","32","17","15","0","0","0","2","2","0","5","1","4","-2"
"199193","North Carolina State University at Raleigh","2010","Total full-time Instruction/research/public service, Tenured, Professors","670","561","109","0","0","0","41","39","2","12","10","2","12","6","6","0","0","0","565","473","92","4","2","2","3","2","1","33","29","4","-2"
"199193","North Carolina State University at Raleigh","2010","Total full-time Instruction/research/public service, Tenured, Associate professors","387","271","116","0","0","0","40","31","9","25","10","15","18","10","8","1","1","0","294","212","82","1","1","0","0","0","0","8","6","2","-2"
"199193","North Carolina State University at Raleigh","2010","Total full-time Instruction/research/public service, Tenured, Assistant professors","6","3","3","0","0","0","0","0","0","1","1","0","0","0","0","0","0","0","5","2","3","0","0","0","0","0","0","0","0","0","-2"
"199193","North Carolina State University at Raleigh","2010","Total full-time Instruction/research/public service, Tenured total","1063","835","228","0","0","0","81","70","11","38","21","17","30","16","14","1","1","0","864","687","177","5","3","2","3","2","1","41","35","6","-2"
"199193","North Carolina State University at Raleigh","2010","Total full-time Instruction/research/public service, Non-tenured on tenure track, Associate professors","19","15","4","0","0","0","5","5","0","0","0","0","1","0","1","0","0","0","12","9","3","0","0","0","0","0","0","1","1","0","-2"
"199193","North Carolina State University at Raleigh","2010","Total full-time Instruction/research/public service, Non-tenured on tenure track, Assistant professors","284","172","112","1","1","0","36","22","14","11","6","5","10","4","6","0","0","0","188","113","75","1","0","1","7","3","4","30","23","7","-2"
"199193","North Carolina State University at Raleigh","2010","Total full-time Instruction/research/public service, Non-tenured on tenure track total","303","187","116","1","1","0","41","27","14","11","6","5","11","4","7","0","0","0","200","122","78","1","0","1","7","3","4","31","24","7","-2"
"199193","North Carolina State University at Raleigh","2010","Total full-time Instruction/research/public service, Non-tenured not on tenure track, Professors","6","6","0","0","0","0","0","0","0","0","0","0","0","0","0","0","0","0","5","5","0","0","0","0","1","1","0","0","0","0","-2"
"199193","North Carolina State University at Raleigh","2010","Total full-time Instruction/research/public service, Non-tenured not on tenure track, Associate professors","22","18","4","0","0","0","2","2","0","0","0","0","1","0","1","0","0","0","19","16","3","0","0","0","0","0","0","0","0","0","-2"
"199193","North Carolina State University at Raleigh","2010","Total full-time Instruction/research/public servicey, Non-tenured not on tenure track, Assistant professors","48","31","17","0","0","0","7","6","1","0","0","0","2","0","2","0","0","0","33","21","12","0","0","0","0","0","0","6","4","2","-2"
"199193","North Carolina State University at Raleigh","2010","Total full-time Instruction/research/public service, Non-tenured not on tenure track, Instructors","5","4","1","0","0","0","0","0","0","0","0","0","0","0","0","0","0","0","3","3","0","1","0","1","0","0","0","1","1","0","-2"
"199193","North Carolina State University at Raleigh","2010","Total full-time Instruction/research/public service, Non-tenured not on tenure track, Lecturers","163","63","100","0","0","0","4","2","2","3","1","2","6","2","4","0","0","0","141","56","85","1","0","1","6","1","5","2","1","1","-2"
"199193","North Carolina State University at Raleigh","2010","Total full-time Instruction/research/public service, Non-tenured not on tenure track, No academic rank","145","66","79","1","0","1","4","2","2","7","2","5","4","0","4","0","0","0","126","60","66","0","0","0","1","1","0","2","1","1","-2"
"199193","North Carolina State University at Raleigh","2010","Total full-time Instruction/research/public service, Non-tenured not on tenure track total","389","188","201","1","0","1","17","12","5","10","3","7","13","2","11","0","0","0","327","161","166","2","0","2","8","3","5","11","7","4","-2"
"200280","University of North Dakota","2010","Total full-time Instruction/research/public service, Tenured, Professors","125","93","32","1","1","0","7","7","0","0","0","0","0","0","0","0","0","0","115","84","31","0","0","0","0","0","0","2","1","1","-2"
"200280","University of North Dakota","2010","Total full-time Instruction/research/public service, Tenured, Associate professors","172","112","60","2","1","1","7","6","1","3","3","0","0","0","0","0","0","0","135","81","54","0","0","0","3","3","0","22","18","4","-2"
"200280","University of North Dakota","2010","Total full-time Instruction/research/public service, Tenured, Assistant professors","20","15","5","0","0","0","1","1","0","0","0","0","1","1","0","0","0","0","16","11","5","0","0","0","0","0","0","2","2","0","-2"
"200280","University of North Dakota","2010","Total full-time Instruction/research/public service, Tenured total","317","220","97","3","2","1","15","14","1","3","3","0","1","1","0","0","0","0","266","176","90","0","0","0","3","3","0","26","21","5","-2"
"200280","University of North Dakota","2010","Total full-time Instruction/research/public service, Non-tenured on tenure track, Professors","1","1","0","0","0","0","0","0","0","0","0","0","0","0","0","0","0","0","0","0","0","0","0","0","0","0","0","1","1","0","-2"
"200280","University of North Dakota","2010","Total full-time Instruction/research/public service, Non-tenured on tenure track, Associate professors","18","10","8","0","0","0","1","0","1","0","0","0","0","0","0","0","0","0","12","7","5","0","0","0","0","0","0","5","3","2","-2"
"200280","University of North Dakota","2010","Total full-time Instruction/research/public service, Non-tenured on tenure track, Assistant professors","127","76","51","1","1","0","6","4","2","2","1","1","1","0","1","0","0","0","89","53","36","1","0","1","1","1","0","26","16","10","-2"
"200280","University of North Dakota","2010","Total full-time Instruction/research/public service, Non-tenured on tenure track total","146","87","59","1","1","0","7","4","3","2","1","1","1","0","1","0","0","0","101","60","41","1","0","1","1","1","0","32","20","12","-2"
"200280","University of North Dakota","2010","Total full-time Instruction/research/public service, Non-tenured not on tenure track, Professors","8","7","1","0","0","0","1","1","0","0","0","0","0","0","0","0","0","0","7","6","1","0","0","0","0","0","0","0","0","0","-2"
"200280","University of North Dakota","2010","Total full-time Instruction/research/public service, Non-tenured not on tenure track, Associate professors","35","20","15","0","0","0","0","0","0","0","0","0","0","0","0","0","0","0","35","20","15","0","0","0","0","0","0","0","0","0","-2"
"200280","University of North Dakota","2010","Total full-time Instruction/research/public servicey, Non-tenured not on tenure track, Assistant professors","77","33","44","3","1","2","6","1","5","2","2","0","0","0","0","0","0","0","55","20","35","3","1","2","1","1","0","7","7","0","-2"
"200280","University of North Dakota","2010","Total full-time Instruction/research/public service, Non-tenured not on tenure track, Instructors","33","10","23","0","0","0","1","0","1","1","1","0","0","0","0","0","0","0","30","8","22","0","0","0","0","0","0","1","1","0","-2"
"200280","University of North Dakota","2010","Total full-time Instruction/research/public service, Non-tenured not on tenure track, Lecturers","27","18","9","0","0","0","0","0","0","0","0","0","2","1","1","0","0","0","25","17","8","0","0","0","0","0","0","0","0","0","-2"
"200280","University of North Dakota","2010","Total full-time Instruction/research/public service, Non-tenured not on tenure track, No academic rank","10","7","3","0","0","0","0","0","0","0","0","0","1","0","1","0","0","0","8","6","2","0","0","0","0","0","0","1","1","0","-2"
"200280","University of North Dakota","2010","Total full-time Instruction/research/public service, Non-tenured not on tenure track total","190","95","95","3","1","2","8","2","6","3","3","0","3","1","2","0","0","0","160","77","83","3","1","2","1","1","0","9","9","0","-2"
"201885","University of Cincinnati-Main Campus","2010","Total full-time Instruction/research/public service, Tenured, Professors","548","421","127","1","1","0","62","54","8","23","12","11","8","6","2","0","0","0","446","342","104","0","0","0","7","5","2","1","1","0","-2"
"201885","University of Cincinnati-Main Campus","2010","Total full-time Instruction/research/public service, Tenured, Associate professors","306","182","124","0","0","0","38","25","13","15","7","8","8","6","2","0","0","0","233","137","96","0","0","0","9","5","4","3","2","1","-2"
"201885","University of Cincinnati-Main Campus","2010","Total full-time Instruction/research/public service, Tenured, Assistant professors","10","7","3","0","0","0","1","1","0","0","0","0","0","0","0","0","0","0","8","6","2","0","0","0","1","0","1","0","0","0","-2"
"201885","University of Cincinnati-Main Campus","2010","Total full-time Instruction/research/public service, Tenured, Instructors","1","1","0","0","0","0","0","0","0","0","0","0","0","0","0","0","0","0","1","1","0","0","0","0","0","0","0","0","0","0","-2"
"201885","University of Cincinnati-Main Campus","2010","Total full-time Instruction/research/public service, Tenured total","865","611","254","1","1","0","101","80","21","38","19","19","16","12","4","0","0","0","688","486","202","0","0","0","17","10","7","4","3","1","-2"
"201885","University of Cincinnati-Main Campus","2010","Total full-time Instruction/research/public service, Non-tenured on tenure track, Professors","11","10","1","0","0","0","1","1","0","0","0","0","0","0","0","0","0","0","9","8","1","0","0","0","1","1","0","0","0","0","-2"
"201885","University of Cincinnati-Main Campus","2010","Total full-time Instruction/research/public service, Non-tenured on tenure track, Associate professors","43","30","13","1","1","0","10","7","3","1","1","0","1","0","1","0","0","0","24","16","8","0","0","0","3","3","0","3","2","1","-2"
"201885","University of Cincinnati-Main Campus","2010","Total full-time Instruction/research/public service, Non-tenured on tenure track, Assistant professors","49","26","23","0","0","0","4","2","2","4","1","3","3","1","2","0","0","0","26","16","10","0","0","0","6","4","2","6","2","4","-2"
"201885","University of Cincinnati-Main Campus","2010","Total full-time Instruction/research/public service, Non-tenured on tenure track total","103","66","37","1","1","0","15","10","5","5","2","3","4","1","3","0","0","0","59","40","19","0","0","0","10","8","2","9","4","5","-2"
"201885","University of Cincinnati-Main Campus","2010","Total full-time Instruction/research/public service, Non-tenured not on tenure track, Professors","123","87","36","0","0","0","13","11","2","2","2","0","3","2","1","0","0","0","95","64","31","0","0","0","5","4","1","5","4","1","-2"
"201885","University of Cincinnati-Main Campus","2010","Total full-time Instruction/research/public service, Non-tenured not on tenure track, Associate professors","259","148","111","2","2","0","31","18","13","9","6","3","6","0","6","0","0","0","191","108","83","0","0","0","11","7","4","9","7","2","-2"
"201885","University of Cincinnati-Main Campus","2010","Total full-time Instruction/research/public servicey, Non-tenured not on tenure track, Assistant professors","551","291","260","3","3","0","58","38","20","15","6","9","13","6","7","1","0","1","342","169","173","1","1","0","61","33","28","57","35","22","-2"
"201885","University of Cincinnati-Main Campus","2010","Total full-time Instruction/research/public service, Non-tenured not on tenure track, Instructors","99","32","67","0","0","0","7","3","4","3","1","2","2","0","2","1","0","1","68","20","48","0","0","0","9","2","7","9","6","3","-2"
"201885","University of Cincinnati-Main Campus","2010","Total full-time Instruction/research/public service, Non-tenured not on tenure track, No academic rank","13","4","9","0","0","0","1","0","1","1","0","1","0","0","0","0","0","0","1","0","1","0","0","0","1","0","1","9","4","5","-2"
"201885","University of Cincinnati-Main Campus","2010","Total full-time Instruction/research/public service, Non-tenured not on tenure track total","1045","562","483","5","5","0","110","70","40","30","15","15","24","8","16","2","0","2","697","361","336","1","1","0","87","46","41","89","56","33","-2"
"204796","Ohio State University-Main Campus","2010","Total full-time Instruction/research/public service, Tenured, Professors","1067","839","228","1","0","1","113","101","12","29","19","10","21","16","5","0","0","0","846","656","190","0","0","0","19","19","0","38","28","10","-2"
"204796","Ohio State University-Main Campus","2010","Total full-time Instruction/research/public service, Tenured, Associate professors","816","518","298","1","1","0","72","49","23","43","25","18","30","20","10","0","0","0","609","378","231","6","4","2","10","7","3","45","34","11","-2"
"204796","Ohio State University-Main Campus","2010","Total full-time Instruction/research/public service, Tenured, Assistant professors","60","30","30","0","0","0","0","0","0","1","0","1","0","0","0","0","0","0","57","28","29","0","0","0","1","1","0","1","1","0","-2"
"204796","Ohio State University-Main Campus","2010","Total full-time Instruction/research/public service, Tenured, Instructors","3","2","1","0","0","0","0","0","0","0","0","0","0","0","0","0","0","0","3","2","1","0","0","0","0","0","0","0","0","0","-2"
"204796","Ohio State University-Main Campus","2010","Total full-time Instruction/research/public service, Tenured total","1946","1389","557","2","1","1","185","150","35","73","44","29","51","36","15","0","0","0","1515","1064","451","6","4","2","30","27","3","84","63","21","-2"
"204796","Ohio State University-Main Campus","2010","Total full-time Instruction/research/public service, Non-tenured on tenure track, Associate professors","18","13","5","0","0","0","4","3","1","0","0","0","2","2","0","0","0","0","9","6","3","0","0","0","2","1","1","1","1","0","-2"
"204796","Ohio State University-Main Campus","2010","Total full-time Instruction/research/public service, Non-tenured on tenure track, Assistant professors","588","345","243","0","0","0","69","47","22","28","12","16","16","7","9","0","0","0","360","202","158","3","1","2","31","23","8","81","53","28","-2"
"204796","Ohio State University-Main Campus","2010","Total full-time Instruction/research/public service, Non-tenured on tenure track, Instructors","6","4","2","0","0","0","1","1","0","0","0","0","0","0","0","0","0","0","2","0","2","0","0","0","1","1","0","2","2","0","-2"
"204796","Ohio State University-Main Campus","2010","Total full-time Instruction/research/public service, Non-tenured on tenure track total","612","362","250","0","0","0","74","51","23","28","12","16","18","9","9","0","0","0","371","208","163","3","1","2","34","25","9","84","56","28","-2"
"204796","Ohio State University-Main Campus","2010","Total full-time Instruction/research/public service, Non-tenured not on tenure track, Professors","83","65","18","0","0","0","6","6","0","2","1","1","0","0","0","0","0","0","70","53","17","0","0","0","3","3","0","2","2","0","-2"
"204796","Ohio State University-Main Campus","2010","Total full-time Instruction/research/public service, Non-tenured not on tenure track, Associate professors","203","120","83","1","0","1","13","6","7","4","2","2","5","4","1","0","0","0","157","88","69","1","1","0","14","12","2","8","7","1","-2"
"204796","Ohio State University-Main Campus","2010","Total full-time Instruction/research/public servicey, Non-tenured not on tenure track, Assistant professors","512","299","213","0","0","0","84","43","41","20","10","10","12","9","3","0","0","0","335","198","137","1","1","0","23","16","7","37","22","15","-2"
"204796","Ohio State University-Main Campus","2010","Total full-time Instruction/research/public service, Non-tenured not on tenure track, Instructors","3","1","2","0","0","0","0","0","0","0","0","0","0","0","0","0","0","0","3","1","2","0","0","0","0","0","0","0","0","0","-2"
"204796","Ohio State University-Main Campus","2010","Total full-time Instruction/research/public service, Non-tenured not on tenure track total","801","485","316","1","0","1","103","55","48","26","13","13","17","13","4","0","0","0","565","340","225","2","2","0","40","31","9","47","31","16","-2"
"204857","Ohio University-Main Campus","2010","Total full-time Instruction/research/public service, Tenured, Professors","236","177","59","3","2","1","17","16","1","6","5","1","7","6","1","0","0","0","190","137","53","0","0","0","2","2","0","11","9","2","-2"
"204857","Ohio University-Main Campus","2010","Total full-time Instruction/research/public service, Tenured, Associate professors","321","208","113","3","1","2","20","16","4","15","12","3","8","5","3","0","0","0","255","161","94","6","2","4","1","0","1","13","11","2","-2"
"204857","Ohio University-Main Campus","2010","Total full-time Instruction/research/public service, Tenured, Assistant professors","12","7","5","0","0","0","0","0","0","2","1","1","0","0","0","0","0","0","9","5","4","0","0","0","0","0","0","1","1","0","-2"
"204857","Ohio University-Main Campus","2010","Total full-time Instruction/research/public service, Tenured total","569","392","177","6","3","3","37","32","5","23","18","5","15","11","4","0","0","0","454","303","151","6","2","4","3","2","1","25","21","4","-2"
"204857","Ohio University-Main Campus","2010","Total full-time Instruction/research/public service, Non-tenured on tenure track, Professors","1","1","0","0","0","0","0","0","0","0","0","0","0","0","0","0","0","0","1","1","0","0","0","0","0","0","0","0","0","0","-2"
"204857","Ohio University-Main Campus","2010","Total full-time Instruction/research/public service, Non-tenured on tenure track, Associate professors","8","5","3","0","0","0","1","1","0","1","1","0","0","0","0","0","0","0","5","2","3","0","0","0","0","0","0","1","1","0","-2"
"204857","Ohio University-Main Campus","2010","Total full-time Instruction/research/public service, Non-tenured on tenure track, Assistant professors","204","122","82","0","0","0","15","8","7","17","9","8","9","6","3","0","0","0","120","67","53","0","0","0","19","11","8","24","21","3","-2"
"204857","Ohio University-Main Campus","2010","Total full-time Instruction/research/public service, Non-tenured on tenure track total","213","128","85","0","0","0","16","9","7","18","10","8","9","6","3","0","0","0","126","70","56","0","0","0","19","11","8","25","22","3","-2"
"204857","Ohio University-Main Campus","2010","Total full-time Instruction/research/public service, Non-tenured not on tenure track, Professors","6","1","5","0","0","0","1","0","1","1","0","1","0","0","0","0","0","0","3","1","2","0","0","0","1","0","1","0","0","0","-2"
"204857","Ohio University-Main Campus","2010","Total full-time Instruction/research/public service, Non-tenured not on tenure track, Associate professors","4","1","3","0","0","0","1","0","1","1","1","0","0","0","0","0","0","0","2","0","2","0","0","0","0","0","0","0","0","0","-2"
"204857","Ohio University-Main Campus","2010","Total full-time Instruction/research/public servicey, Non-tenured not on tenure track, Assistant professors","79","40","39","0","0","0","3","0","3","4","1","3","2","1","1","0","0","0","50","29","21","0","0","0","13","4","9","7","5","2","-2"
"204857","Ohio University-Main Campus","2010","Total full-time Instruction/research/public service, Non-tenured not on tenure track, Instructors","60","22","38","0","0","0","0","0","0","0","0","0","0","0","0","0","0","0","48","18","30","0","0","0","7","3","4","5","1","4","-2"
"204857","Ohio University-Main Campus","2010","Total full-time Instruction/research/public service, Non-tenured not on tenure track, Lecturers","15","8","7","0","0","0","0","0","0","0","0","0","0","0","0","0","0","0","13","7","6","0","0","0","1","0","1","1","1","0","-2"
"204857","Ohio University-Main Campus","2010","Total full-time Instruction/research/public service, Non-tenured not on tenure track, No academic rank","15","8","7","0","0","0","0","0","0","0","0","0","0","0","0","0","0","0","8","5","3","0","0","0","6","2","4","1","1","0","-2"
"204857","Ohio University-Main Campus","2010","Total full-time Instruction/research/public service, Non-tenured not on tenure track total","179","80","99","0","0","0","5","0","5","6","2","4","2","1","1","0","0","0","124","60","64","0","0","0","28","9","19","14","8","6","-2"
"207500","University of Oklahoma-Norman Campus","2010","Total full-time Instruction/research/public service, Tenured, Professors","380","311","69","4","2","2","43","37","6","3","2","1","14","11","3","0","0","0","311","254","57","0","0","0","3","3","0","2","2","0","-2"
"207500","University of Oklahoma-Norman Campus","2010","Total full-time Instruction/research/public service, Tenured, Associate professors","285","174","111","10","7","3","18","13","5","13","6","7","6","1","5","0","0","0","215","131","84","2","1","1","3","3","0","18","12","6","-2"
"207500","University of Oklahoma-Norman Campus","2010","Total full-time Instruction/research/public service, Tenured total","665","485","180","14","9","5","61","50","11","16","8","8","20","12","8","0","0","0","526","385","141","2","1","1","6","6","0","20","14","6","-2"
"207500","University of Oklahoma-Norman Campus","2010","Total full-time Instruction/research/public service, Non-tenured on tenure track, Professors","1","1","0","0","0","0","1","1","0","0","0","0","0","0","0","0","0","0","0","0","0","0","0","0","0","0","0","0","0","0","-2"
"207500","University of Oklahoma-Norman Campus","2010","Total full-time Instruction/research/public service, Non-tenured on tenure track, Associate professors","17","11","6","0","0","0","2","2","0","1","0","1","0","0","0","0","0","0","11","7","4","0","0","0","0","0","0","3","2","1","-2"
"207500","University of Oklahoma-Norman Campus","2010","Total full-time Instruction/research/public service, Non-tenured on tenure track, Assistant professors","208","130","78","6","2","4","18","10","8","7","4","3","5","3","2","1","0","1","131","82","49","2","0","2","11","9","2","27","20","7","-2"
"207500","University of Oklahoma-Norman Campus","2010","Total full-time Instruction/research/public service, Non-tenured on tenure track, Instructors","1","0","1","0","0","0","0","0","0","0","0","0","0","0","0","0","0","0","1","0","1","0","0","0","0","0","0","0","0","0","-2"
"207500","University of Oklahoma-Norman Campus","2010","Total full-time Instruction/research/public service, Non-tenured on tenure track total","227","142","85","6","2","4","21","13","8","8","4","4","5","3","2","1","0","1","143","89","54","2","0","2","11","9","2","30","22","8","-2"
"207500","University of Oklahoma-Norman Campus","2010","Total full-time Instruction/research/public service, Non-tenured not on tenure track, Professors","10","8","2","0","0","0","3","2","1","0","0","0","0","0","0","0","0","0","5","4","1","1","1","0","0","0","0","1","1","0","-2"
"207500","University of Oklahoma-Norman Campus","2010","Total full-time Instruction/research/public service, Non-tenured not on tenure track, Associate professors","16","5","11","0","0","0","1","0","1","3","0","3","0","0","0","0","0","0","10","4","6","0","0","0","1","1","0","1","0","1","-2"
"207500","University of Oklahoma-Norman Campus","2010","Total full-time Instruction/research/public servicey, Non-tenured not on tenure track, Assistant professors","54","26","28","2","2","0","1","0","1","4","1","3","0","0","0","0","0","0","45","22","23","0","0","0","1","1","0","1","0","1","-2"
"207500","University of Oklahoma-Norman Campus","2010","Total full-time Instruction/research/public service, Non-tenured not on tenure track, Instructors","103","41","62","12","6","6","4","1","3","2","0","2","12","3","9","0","0","0","63","28","35","0","0","0","1","0","1","9","3","6","-2"
"207500","University of Oklahoma-Norman Campus","2010","Total full-time Instruction/research/public service, Non-tenured not on tenure track, Lecturers","60","33","27","2","1","1","2","2","0","0","0","0","2","0","2","0","0","0","48","25","23","0","0","0","1","1","0","5","4","1","-2"
"207500","University of Oklahoma-Norman Campus","2010","Total full-time Instruction/research/public service, Non-tenured not on tenure track, No academic rank","260","183","77","4","1","3","61","46","15","2","2","0","8","5","3","0","0","0","139","97","42","1","0","1","3","3","0","42","29","13","-2"
"207500","University of Oklahoma-Norman Campus","2010","Total full-time Instruction/research/public service, Non-tenured not on tenure track total","503","296","207","20","10","10","72","51","21","11","3","8","22","8","14","0","0","0","310","180","130","2","1","1","7","6","1","59","37","22","-2"
"207971","University of Tulsa","2010","Total full-time Instruction/research/public service, Tenured, Professors","97","81","16","5","4","1","8","8","0","1","1","0","1","1","0","0","0","0","81","66","15","0","0","0","1","1","0","0","0","0","-2"
"207971","University of Tulsa","2010","Total full-time Instruction/research/public service, Tenured, Associate professors","82","57","25","4","2","2","3","2","1","1","0","1","2","2","0","0","0","0","69","48","21","0","0","0","1","1","0","2","2","0","-2"
"207971","University of Tulsa","2010","Total full-time Instruction/research/public service, Tenured total","179","138","41","9","6","3","11","10","1","2","1","1","3","3","0","0","0","0","150","114","36","0","0","0","2","2","0","2","2","0","-2"
"207971","University of Tulsa","2010","Total full-time Instruction/research/public service, Non-tenured on tenure track, Associate professors","2","1","1","0","0","0","0","0","0","0","0","0","0","0","0","0","0","0","1","0","1","0","0","0","0","0","0","1","1","0","-2"
"207971","University of Tulsa","2010","Total full-time Instruction/research/public service, Non-tenured on tenure track, Assistant professors","57","41","16","1","0","1","6","5","1","1","0","1","2","0","2","0","0","0","38","30","8","0","0","0","0","0","0","9","6","3","-2"
"207971","University of Tulsa","2010","Total full-time Instruction/research/public service, Non-tenured on tenure track total","59","42","17","1","0","1","6","5","1","1","0","1","2","0","2","0","0","0","39","30","9","0","0","0","0","0","0","10","7","3","-2"
"207971","University of Tulsa","2010","Total full-time Instruction/research/public service, Non-tenured not on tenure track, Professors","12","7","5","2","1","1","0","0","0","0","0","0","1","0","1","0","0","0","9","6","3","0","0","0","0","0","0","0","0","0","-2"
"207971","University of Tulsa","2010","Total full-time Instruction/research/public service, Non-tenured not on tenure track, Associate professors","14","6","8","2","2","0","0","0","0","0","0","0","0","0","0","0","0","0","12","4","8","0","0","0","0","0","0","0","0","0","-2"
"207971","University of Tulsa","2010","Total full-time Instruction/research/public servicey, Non-tenured not on tenure track, Assistant professors","26","10","16","4","1","3","0","0","0","1","0","1","0","0","0","0","0","0","21","9","12","0","0","0","0","0","0","0","0","0","-2"
"207971","University of Tulsa","2010","Total full-time Instruction/research/public service, Non-tenured not on tenure track, Instructors","21","8","13","1","0","1","0","0","0","0","0","0","4","0","4","0","0","0","16","8","8","0","0","0","0","0","0","0","0","0","-2"
"207971","University of Tulsa","2010","Total full-time Instruction/research/public service, Non-tenured not on tenure track, No academic rank","3","2","1","0","0","0","0","0","0","0","0","0","0","0","0","0","0","0","3","2","1","0","0","0","0","0","0","0","0","0","-2"
"207971","University of Tulsa","2010","Total full-time Instruction/research/public service, Non-tenured not on tenure track total","76","33","43","9","4","5","0","0","0","1","0","1","5","0","5","0","0","0","61","29","32","0","0","0","0","0","0","0","0","0","-2"
"209542","Oregon State University","2010","Total full-time Instruction/research/public service, Tenured, Professors","282","216","66","1","1","0","19","17","2","1","0","1","6","6","0","0","0","0","240","179","61","1","1","0","9","7","2","5","5","0","209542"
"209542","Oregon State University","2010","Total full-time Instruction/research/public service, Tenured, Associate professors","267","155","112","2","1","1","32","18","14","4","4","0","9","6","3","0","0","0","188","108","80","1","1","0","15","5","10","16","12","4","209542"
"209542","Oregon State University","2010","Total full-time Instruction/research/public service, Tenured, Assistant professors","7","6","1","0","0","0","0","0","0","0","0","0","1","1","0","0","0","0","6","5","1","0","0","0","0","0","0","0","0","0","209542"
"209542","Oregon State University","2010","Total full-time Instruction/research/public service, Tenured, Instructors","9","4","5","0","0","0","1","0","1","0","0","0","1","0","1","0","0","0","6","4","2","0","0","0","0","0","0","1","0","1","209542"
"209542","Oregon State University","2010","Total full-time Instruction/research/public service, Tenured total","565","381","184","3","2","1","52","35","17","5","4","1","17","13","4","0","0","0","440","296","144","2","2","0","24","12","12","22","17","5","209542"
"209542","Oregon State University","2010","Total full-time Instruction/research/public service, Non-tenured on tenure track, Professors","3","3","0","0","0","0","0","0","0","0","0","0","0","0","0","0","0","0","3","3","0","0","0","0","0","0","0","0","0","0","209542"
"209542","Oregon State University","2010","Total full-time Instruction/research/public service, Non-tenured on tenure track, Associate professors","24","16","8","0","0","0","0","0","0","0","0","0","1","0","1","0","0","0","20","14","6","0","0","0","2","1","1","1","1","0","209542"
"209542","Oregon State University","2010","Total full-time Instruction/research/public service, Non-tenured on tenure track, Assistant professors","200","119","81","1","0","1","15","9","6","2","2","0","12","5","7","0","0","0","135","77","58","0","0","0","5","3","2","30","23","7","209542"
"209542","Oregon State University","2010","Total full-time Instruction/research/public service, Non-tenured on tenure track total","227","138","89","1","0","1","15","9","6","2","2","0","13","5","8","0","0","0","158","94","64","0","0","0","7","4","3","31","24","7","209542"
"209542","Oregon State University","2010","Total full-time Instruction/research/public service, Non-tenured not on tenure track, Professors","14","11","3","0","0","0","0","0","0","0","0","0","0","0","0","0","0","0","13","11","2","0","0","0","1","0","1","0","0","0","209542"
"209542","Oregon State University","2010","Total full-time Instruction/research/public service, Non-tenured not on tenure track, Associate professors","25","13","12","0","0","0","1","0","1","0","0","0","1","1","0","0","0","0","20","10","10","0","0","0","2","1","1","1","1","0","209542"
"209542","Oregon State University","2010","Total full-time Instruction/research/public servicey, Non-tenured not on tenure track, Assistant professors","68","42","26","0","0","0","4","4","0","0","0","0","3","2","1","0","0","0","48","25","23","0","0","0","3","3","0","10","8","2","209542"
"209542","Oregon State University","2010","Total full-time Instruction/research/public service, Non-tenured not on tenure track, Instructors","244","114","130","2","1","1","5","1","4","5","1","4","10","4","6","0","0","0","205","97","108","0","0","0","9","5","4","8","5","3","209542"
"209542","Oregon State University","2010","Total full-time Instruction/research/public service, Non-tenured not on tenure track, No academic rank","480","271","209","4","2","2","16","4","12","2","1","1","11","8","3","1","0","1","360","203","157","3","2","1","8","6","2","75","45","30","209542"
"209542","Oregon State University","2010","Total full-time Instruction/research/public service, Non-tenured not on tenure track total","831","451","380","6","3","3","26","9","17","7","2","5","25","15","10","1","0","1","646","346","300","3","2","1","23","15","8","94","59","35","209542"
"211361","California University of Pennsylvania","2010","Total full-time Instruction/research/public service, Tenured, Professors","88","55","33","0","0","0","4","4","0","6","3","3","0","0","0","0","0","0","78","48","30","0","0","0","0","0","0","0","0","0","-2"
"211361","California University of Pennsylvania","2010","Total full-time Instruction/research/public service, Tenured, Associate professors","57","36","21","0","0","0","3","2","1","3","1","2","1","0","1","0","0","0","49","33","16","1","0","1","0","0","0","0","0","0","-2"
"211361","California University of Pennsylvania","2010","Total full-time Instruction/research/public service, Tenured, Assistant professors","21","12","9","0","0","0","0","0","0","0","0","0","1","1","0","0","0","0","20","11","9","0","0","0","0","0","0","0","0","0","-2"
"211361","California University of Pennsylvania","2010","Total full-time Instruction/research/public service, Tenured, Instructors","1","0","1","0","0","0","0","0","0","0","0","0","0","0","0","0","0","0","1","0","1","0","0","0","0","0","0","0","0","0","-2"
"211361","California University of Pennsylvania","2010","Total full-time Instruction/research/public service, Tenured total","167","103","64","0","0","0","7","6","1","9","4","5","2","1","1","0","0","0","148","92","56","1","0","1","0","0","0","0","0","0","-2"
"211361","California University of Pennsylvania","2010","Total full-time Instruction/research/public service, Non-tenured on tenure track, Professors","3","0","3","0","0","0","0","0","0","0","0","0","0","0","0","0","0","0","3","0","3","0","0","0","0","0","0","0","0","0","-2"
"211361","California University of Pennsylvania","2010","Total full-time Instruction/research/public service, Non-tenured on tenure track, Associate professors","22","8","14","0","0","0","0","0","0","3","2","1","0","0","0","0","0","0","18","6","12","0","0","0","0","0","0","1","0","1","-2"
"211361","California University of Pennsylvania","2010","Total full-time Instruction/research/public service, Non-tenured on tenure track, Assistant professors","59","26","33","0","0","0","3","1","2","6","3","3","1","0","1","0","0","0","47","21","26","0","0","0","1","1","0","1","0","1","-2"
"211361","California University of Pennsylvania","2010","Total full-time Instruction/research/public service, Non-tenured on tenure track, Instructors","4","0","4","0","0","0","0","0","0","0","0","0","0","0","0","0","0","0","4","0","4","0","0","0","0","0","0","0","0","0","-2"
"211361","California University of Pennsylvania","2010","Total full-time Instruction/research/public service, Non-tenured on tenure track total","88","34","54","0","0","0","3","1","2","9","5","4","1","0","1","0","0","0","72","27","45","0","0","0","1","1","0","2","0","2","-2"
"211361","California University of Pennsylvania","2010","Total full-time Instruction/research/public servicey, Non-tenured not on tenure track, Assistant professors","6","2","4","0","0","0","1","1","0","1","0","1","0","0","0","0","0","0","4","1","3","0","0","0","0","0","0","0","0","0","-2"
"211361","California University of Pennsylvania","2010","Total full-time Instruction/research/public service, Non-tenured not on tenure track, Instructors","19","4","15","0","0","0","0","0","0","1","0","1","0","0","0","0","0","0","17","4","13","0","0","0","0","0","0","1","0","1","-2"
"211361","California University of Pennsylvania","2010","Total full-time Instruction/research/public service, Non-tenured not on tenure track total","25","6","19","0","0","0","1","1","0","2","0","2","0","0","0","0","0","0","21","5","16","0","0","0","0","0","0","1","0","1","-2"
"214041","Millersville University of Pennsylvania","2010","Total full-time Instruction/research/public service, Tenured, Professors","99","58","41","0","0","0","7","5","2","4","2","2","3","1","2","0","0","0","85","50","35","0","0","0","0","0","0","0","0","0","-2"
"214041","Millersville University of Pennsylvania","2010","Total full-time Instruction/research/public service, Tenured, Associate professors","98","47","51","0","0","0","6","3","3","5","1","4","5","0","5","0","0","0","81","43","38","1","0","1","0","0","0","0","0","0","-2"
"214041","Millersville University of Pennsylvania","2010","Total full-time Instruction/research/public service, Tenured, Assistant professors","34","19","15","0","0","0","2","2","0","2","2","0","4","2","2","0","0","0","26","13","13","0","0","0","0","0","0","0","0","0","-2"
"214041","Millersville University of Pennsylvania","2010","Total full-time Instruction/research/public service, Tenured total","231","124","107","0","0","0","15","10","5","11","5","6","12","3","9","0","0","0","192","106","86","1","0","1","0","0","0","0","0","0","-2"
"214041","Millersville University of Pennsylvania","2010","Total full-time Instruction/research/public service, Non-tenured on tenure track, Associate professors","3","2","1","0","0","0","0","0","0","1","1","0","0","0","0","0","0","0","2","1","1","0","0","0","0","0","0","0","0","0","-2"
"214041","Millersville University of Pennsylvania","2010","Total full-time Instruction/research/public service, Non-tenured on tenure track, Assistant professors","60","29","31","0","0","0","2","1","1","2","2","0","3","2","1","0","0","0","48","22","26","0","0","0","0","0","0","5","2","3","-2"
"214041","Millersville University of Pennsylvania","2010","Total full-time Instruction/research/public service, Non-tenured on tenure track, Instructors","2","1","1","0","0","0","0","0","0","0","0","0","0","0","0","0","0","0","2","1","1","0","0","0","0","0","0","0","0","0","-2"
"214041","Millersville University of Pennsylvania","2010","Total full-time Instruction/research/public service, Non-tenured on tenure track total","65","32","33","0","0","0","2","1","1","3","3","0","3","2","1","0","0","0","52","24","28","0","0","0","0","0","0","5","2","3","-2"
"214041","Millersville University of Pennsylvania","2010","Total full-time Instruction/research/public servicey, Non-tenured not on tenure track, Assistant professors","4","2","2","0","0","0","0","0","0","0","0","0","0","0","0","0","0","0","3","2","1","0","0","0","0","0","0","1","0","1","-2"
"214041","Millersville University of Pennsylvania","2010","Total full-time Instruction/research/public service, Non-tenured not on tenure track, Instructors","7","3","4","0","0","0","0","0","0","0","0","0","1","1","0","0","0","0","6","2","4","0","0","0","0","0","0","0","0","0","-2"
"214041","Millersville University of Pennsylvania","2010","Total full-time Instruction/research/public service, Non-tenured not on tenure track total","11","5","6","0","0","0","0","0","0","0","0","0","1","1","0","0","0","0","9","4","5","0","0","0","0","0","0","1","0","1","-2"
"214777","Pennsylvania State University-Main Campus","2010","Total full-time Instruction/research/public service, Tenured, Professors","845","668","177","2","2","0","96","88","8","26","19","7","12","9","3","0","0","0","669","519","150","1","0","1","32","26","6","7","5","2","-2"
"214777","Pennsylvania State University-Main Campus","2010","Total full-time Instruction/research/public service, Tenured, Associate professors","505","311","194","3","2","1","49","32","17","26","14","12","19","7","12","0","0","0","380","233","147","3","2","1","19","15","4","6","6","0","-2"
"214777","Pennsylvania State University-Main Campus","2010","Total full-time Instruction/research/public service, Tenured, Assistant professors","1","0","1","0","0","0","0","0","0","0","0","0","0","0","0","0","0","0","1","0","1","0","0","0","0","0","0","0","0","0","-2"
"214777","Pennsylvania State University-Main Campus","2010","Total full-time Instruction/research/public service, Tenured, Instructors","1","1","0","0","0","0","0","0","0","0","0","0","0","0","0","0","0","0","0","0","0","0","0","0","1","1","0","0","0","0","-2"
"214777","Pennsylvania State University-Main Campus","2010","Total full-time Instruction/research/public service, Tenured total","1352","980","372","5","4","1","145","120","25","52","33","19","31","16","15","0","0","0","1050","752","298","4","2","2","52","42","10","13","11","2","-2"
"214777","Pennsylvania State University-Main Campus","2010","Total full-time Instruction/research/public service, Non-tenured on tenure track, Associate professors","23","16","7","0","0","0","3","2","1","0","0","0","3","2","1","0","0","0","15","11","4","0","0","0","1","1","0","1","0","1","-2"
"214777","Pennsylvania State University-Main Campus","2010","Total full-time Instruction/research/public service, Non-tenured on tenure track, Assistant professors","383","217","166","1","0","1","27","17","10","21","8","13","25","12","13","0","0","0","234","134","100","4","1","3","12","6","6","59","39","20","-2"
"214777","Pennsylvania State University-Main Campus","2010","Total full-time Instruction/research/public service, Non-tenured on tenure track, Lecturers","1","0","1","0","0","0","0","0","0","0","0","0","0","0","0","0","0","0","0","0","0","0","0","0","1","0","1","0","0","0","-2"
"214777","Pennsylvania State University-Main Campus","2010","Total full-time Instruction/research/public service, Non-tenured on tenure track total","407","233","174","1","0","1","30","19","11","21","8","13","28","14","14","0","0","0","249","145","104","4","1","3","14","7","7","60","39","21","-2"
"214777","Pennsylvania State University-Main Campus","2010","Total full-time Instruction/research/public service, Non-tenured not on tenure track, Professors","63","53","10","0","0","0","3","2","1","1","1","0","0","0","0","0","0","0","52","45","7","0","0","0","4","3","1","3","2","1","-2"
"214777","Pennsylvania State University-Main Campus","2010","Total full-time Instruction/research/public service, Non-tenured not on tenure track, Associate professors","132","101","31","0","0","0","16","13","3","0","0","0","0","0","0","0","0","0","108","80","28","0","0","0","5","5","0","3","3","0","-2"
"214777","Pennsylvania State University-Main Campus","2010","Total full-time Instruction/research/public servicey, Non-tenured not on tenure track, Assistant professors","413","255","158","1","1","0","34","16","18","9","4","5","9","2","7","0","0","0","281","171","110","2","1","1","15","11","4","62","49","13","-2"
"214777","Pennsylvania State University-Main Campus","2010","Total full-time Instruction/research/public service, Non-tenured not on tenure track, Instructors","415","210","205","2","1","1","17","8","9","8","3","5","7","2","5","0","0","0","347","179","168","2","0","2","13","9","4","19","8","11","-2"
"214777","Pennsylvania State University-Main Campus","2010","Total full-time Instruction/research/public service, Non-tenured not on tenure track, Lecturers","405","199","206","0","0","0","17","6","11","10","7","3","18","6","12","0","0","0","316","161","155","3","1","2","11","7","4","30","11","19","-2"
"214777","Pennsylvania State University-Main Campus","2010","Total full-time Instruction/research/public service, Non-tenured not on tenure track total","1428","818","610","3","2","1","87","45","42","28","15","13","34","10","24","0","0","0","1104","636","468","7","2","5","48","35","13","117","73","44","-2"
"217484","University of Rhode Island","2010","Total full-time Instruction/research/public service, Tenured, Professors","295","215","80","1","1","0","27","24","3","7","6","1","6","6","0","0","0","0","250","174","76","0","0","0","0","0","0","4","4","0","-2"
"217484","University of Rhode Island","2010","Total full-time Instruction/research/public service, Tenured, Associate professors","138","69","69","2","0","2","8","5","3","8","2","6","4","0","4","0","0","0","109","58","51","0","0","0","0","0","0","7","4","3","-2"
"217484","University of Rhode Island","2010","Total full-time Instruction/research/public service, Tenured total","433","284","149","3","1","2","35","29","6","15","8","7","10","6","4","0","0","0","359","232","127","0","0","0","0","0","0","11","8","3","-2"
"217484","University of Rhode Island","2010","Total full-time Instruction/research/public service, Non-tenured on tenure track, Professors","4","3","1","0","0","0","0","0","0","0","0","0","0","0","0","0","0","0","4","3","1","0","0","0","0","0","0","0","0","0","-2"
"217484","University of Rhode Island","2010","Total full-time Instruction/research/public service, Non-tenured on tenure track, Associate professors","3","1","2","0","0","0","1","1","0","0","0","0","1","0","1","0","0","0","1","0","1","0","0","0","0","0","0","0","0","0","-2"
"217484","University of Rhode Island","2010","Total full-time Instruction/research/public service, Non-tenured on tenure track, Assistant professors","95","41","54","1","0","1","12","5","7","0","0","0","3","2","1","0","0","0","69","26","43","0","0","0","0","0","0","10","8","2","-2"
"217484","University of Rhode Island","2010","Total full-time Instruction/research/public service, Non-tenured on tenure track, Instructors","4","2","2","0","0","0","0","0","0","0","0","0","0","0","0","0","0","0","4","2","2","0","0","0","0","0","0","0","0","0","-2"
"217484","University of Rhode Island","2010","Total full-time Instruction/research/public service, Non-tenured on tenure track total","106","47","59","1","0","1","13","6","7","0","0","0","4","2","2","0","0","0","78","31","47","0","0","0","0","0","0","10","8","2","-2"
"217484","University of Rhode Island","2010","Total full-time Instruction/research/public service, Non-tenured not on tenure track, Professors","7","3","4","0","0","0","1","0","1","0","0","0","0","0","0","0","0","0","6","3","3","0","0","0","0","0","0","0","0","0","-2"
"217484","University of Rhode Island","2010","Total full-time Instruction/research/public service, Non-tenured not on tenure track, Associate professors","19","5","14","0","0","0","0","0","0","0","0","0","0","0","0","0","0","0","19","5","14","0","0","0","0","0","0","0","0","0","-2"
"217484","University of Rhode Island","2010","Total full-time Instruction/research/public servicey, Non-tenured not on tenure track, Assistant professors","34","8","26","0","0","0","4","3","1","1","1","0","2","0","2","0","0","0","27","4","23","0","0","0","0","0","0","0","0","0","-2"
"217484","University of Rhode Island","2010","Total full-time Instruction/research/public service, Non-tenured not on tenure track, Instructors","3","2","1","0","0","0","0","0","0","0","0","0","0","0","0","0","0","0","3","2","1","0","0","0","0","0","0","0","0","0","-2"
"217484","University of Rhode Island","2010","Total full-time Instruction/research/public service, Non-tenured not on tenure track, Lecturers","80","37","43","0","0","0","4","1","3","0","0","0","4","3","1","0","0","0","68","30","38","0","0","0","0","0","0","4","3","1","-2"
"217484","University of Rhode Island","2010","Total full-time Instruction/research/public service, Non-tenured not on tenure track total","143","55","88","0","0","0","9","4","5","1","1","0","6","3","3","0","0","0","123","44","79","0","0","0","0","0","0","4","3","1","-2"
"217819","College of Charleston","2010","Total full-time Instruction/research/public service, Tenured, Professors","126","92","34","0","0","0","3","3","0","4","3","1","1","1","0","0","0","0","115","83","32","2","2","0","1","0","1","0","0","0","-2"
"217819","College of Charleston","2010","Total full-time Instruction/research/public service, Tenured, Associate professors","148","82","66","0","0","0","2","1","1","10","4","6","13","8","5","0","0","0","119","68","51","0","0","0","3","1","2","1","0","1","-2"
"217819","College of Charleston","2010","Total full-time Instruction/research/public service, Tenured, Assistant professors","5","2","3","0","0","0","0","0","0","0","0","0","0","0","0","0","0","0","5","2","3","0","0","0","0","0","0","0","0","0","-2"
"217819","College of Charleston","2010","Total full-time Instruction/research/public service, Tenured total","279","176","103","0","0","0","5","4","1","14","7","7","14","9","5","0","0","0","239","153","86","2","2","0","4","1","3","1","0","1","-2"
"217819","College of Charleston","2010","Total full-time Instruction/research/public service, Non-tenured on tenure track, Associate professors","2","0","2","0","0","0","0","0","0","0","0","0","0","0","0","0","0","0","2","0","2","0","0","0","0","0","0","0","0","0","-2"
"217819","College of Charleston","2010","Total full-time Instruction/research/public service, Non-tenured on tenure track, Assistant professors","139","81","58","0","0","0","4","3","1","5","2","3","3","2","1","0","0","0","107","60","47","1","1","0","6","5","1","13","8","5","-2"
"217819","College of Charleston","2010","Total full-time Instruction/research/public service, Non-tenured on tenure track total","141","81","60","0","0","0","4","3","1","5","2","3","3","2","1","0","0","0","109","60","49","1","1","0","6","5","1","13","8","5","-2"
"217819","College of Charleston","2010","Total full-time Instruction/research/public service, Non-tenured not on tenure track, Professors","1","1","0","0","0","0","0","0","0","0","0","0","0","0","0","0","0","0","1","1","0","0","0","0","0","0","0","0","0","0","-2"
"217819","College of Charleston","2010","Total full-time Instruction/research/public service, Non-tenured not on tenure track, Associate professors","1","0","1","0","0","0","0","0","0","1","0","1","0","0","0","0","0","0","0","0","0","0","0","0","0","0","0","0","0","0","-2"
"217819","College of Charleston","2010","Total full-time Instruction/research/public servicey, Non-tenured not on tenure track, Assistant professors","27","15","12","0","0","0","0","0","0","2","0","2","1","1","0","0","0","0","19","12","7","0","0","0","1","1","0","4","1","3","-2"
"217819","College of Charleston","2010","Total full-time Instruction/research/public service, Non-tenured not on tenure track, Instructors","61","22","39","0","0","0","1","1","0","1","0","1","2","1","1","0","0","0","52","17","35","1","0","1","4","3","1","0","0","0","-2"
"217819","College of Charleston","2010","Total full-time Instruction/research/public service, Non-tenured not on tenure track total","90","38","52","0","0","0","1","1","0","4","0","4","3","2","1","0","0","0","72","30","42","1","0","1","5","4","1","4","1","3","-2"
"217882","Clemson University","2010","Total full-time Instruction/research/public service, Tenured, Professors","346","280","66","0","0","0","27","26","1","7","6","1","4","2","2","0","0","0","307","246","61","1","0","1","0","0","0","0","0","0","-2"
"217882","Clemson University","2010","Total full-time Instruction/research/public service, Tenured, Associate professors","223","150","73","0","0","0","24","17","7","10","7","3","6","4","2","0","0","0","182","121","61","0","0","0","1","1","0","0","0","0","-2"
"217882","Clemson University","2010","Total full-time Instruction/research/public service, Tenured total","569","430","139","0","0","0","51","43","8","17","13","4","10","6","4","0","0","0","489","367","122","1","0","1","1","1","0","0","0","0","-2"
"217882","Clemson University","2010","Total full-time Instruction/research/public service, Non-tenured on tenure track, Associate professors","23","19","4","0","0","0","3","3","0","0","0","0","0","0","0","0","0","0","19","15","4","0","0","0","1","1","0","0","0","0","-2"
"217882","Clemson University","2010","Total full-time Instruction/research/public service, Non-tenured on tenure track, Assistant professors","258","158","100","0","0","0","41","29","12","12","6","6","5","0","5","0","0","0","198","121","77","0","0","0","2","2","0","0","0","0","-2"
"217882","Clemson University","2010","Total full-time Instruction/research/public service, Non-tenured on tenure track total","281","177","104","0","0","0","44","32","12","12","6","6","5","0","5","0","0","0","217","136","81","0","0","0","3","3","0","0","0","0","-2"
"217882","Clemson University","2010","Total full-time Instruction/research/public service, Non-tenured not on tenure track, Professors","4","1","3","0","0","0","0","0","0","0","0","0","0","0","0","0","0","0","4","1","3","0","0","0","0","0","0","0","0","0","-2"
"217882","Clemson University","2010","Total full-time Instruction/research/public service, Non-tenured not on tenure track, Associate professors","8","8","0","0","0","0","0","0","0","0","0","0","0","0","0","0","0","0","8","8","0","0","0","0","0","0","0","0","0","0","-2"
"217882","Clemson University","2010","Total full-time Instruction/research/public servicey, Non-tenured not on tenure track, Assistant professors","11","10","1","0","0","0","0","0","0","0","0","0","0","0","0","0","0","0","11","10","1","0","0","0","0","0","0","0","0","0","-2"
"217882","Clemson University","2010","Total full-time Instruction/research/public service, Non-tenured not on tenure track, Instructors","3","2","1","0","0","0","0","0","0","0","0","0","0","0","0","0","0","0","3","2","1","0","0","0","0","0","0","0","0","0","-2"
"217882","Clemson University","2010","Total full-time Instruction/research/public service, Non-tenured not on tenure track, Lecturers","210","95","115","1","0","1","2","1","1","7","3","4","6","3","3","0","0","0","193","87","106","0","0","0","1","1","0","0","0","0","-2"
"217882","Clemson University","2010","Total full-time Instruction/research/public service, Non-tenured not on tenure track total","236","116","120","1","0","1","2","1","1","7","3","4","6","3","3","0","0","0","219","108","111","0","0","0","1","1","0","0","0","0","-2"
"218724","Coastal Carolina University","2010","Total full-time Instruction/research/public service, Tenured, Professors","58","43","15","1","1","0","1","1","0","0","0","0","2","1","1","0","0","0","52","38","14","1","1","0","0","0","0","1","1","0","-2"
"218724","Coastal Carolina University","2010","Total full-time Instruction/research/public service, Tenured, Associate professors","78","51","27","0","0","0","0","0","0","3","2","1","4","2","2","0","0","0","70","46","24","0","0","0","0","0","0","1","1","0","-2"
"218724","Coastal Carolina University","2010","Total full-time Instruction/research/public service, Tenured, Assistant professors","4","2","2","1","1","0","0","0","0","1","0","1","0","0","0","0","0","0","2","1","1","0","0","0","0","0","0","0","0","0","-2"
"218724","Coastal Carolina University","2010","Total full-time Instruction/research/public service, Tenured total","140","96","44","2","2","0","1","1","0","4","2","2","6","3","3","0","0","0","124","85","39","1","1","0","0","0","0","2","2","0","-2"
"218724","Coastal Carolina University","2010","Total full-time Instruction/research/public service, Non-tenured on tenure track, Associate professors","5","2","3","0","0","0","0","0","0","0","0","0","0","0","0","0","0","0","5","2","3","0","0","0","0","0","0","0","0","0","-2"
"218724","Coastal Carolina University","2010","Total full-time Instruction/research/public service, Non-tenured on tenure track, Assistant professors","108","61","47","0","0","0","12","7","5","5","2","3","1","1","0","0","0","0","88","49","39","1","1","0","0","0","0","1","1","0","-2"
"218724","Coastal Carolina University","2010","Total full-time Instruction/research/public service, Non-tenured on tenure track total","113","63","50","0","0","0","12","7","5","5","2","3","1","1","0","0","0","0","93","51","42","1","1","0","0","0","0","1","1","0","-2"
"218724","Coastal Carolina University","2010","Total full-time Instruction/research/public service, Non-tenured not on tenure track, Associate professors","1","0","1","0","0","0","0","0","0","0","0","0","0","0","0","0","0","0","1","0","1","0","0","0","0","0","0","0","0","0","-2"
"218724","Coastal Carolina University","2010","Total full-time Instruction/research/public servicey, Non-tenured not on tenure track, Assistant professors","3","1","2","0","0","0","0","0","0","0","0","0","0","0","0","0","0","0","3","1","2","0","0","0","0","0","0","0","0","0","-2"
"218724","Coastal Carolina University","2010","Total full-time Instruction/research/public service, Non-tenured not on tenure track, Instructors","16","9","7","0","0","0","1","0","1","0","0","0","2","2","0","0","0","0","13","7","6","0","0","0","0","0","0","0","0","0","-2"
"218724","Coastal Carolina University","2010","Total full-time Instruction/research/public service, Non-tenured not on tenure track, Lecturers","73","33","40","0","0","0","2","1","1","2","1","1","2","1","1","0","0","0","67","30","37","0","0","0","0","0","0","0","0","0","-2"
"218724","Coastal Carolina University","2010","Total full-time Instruction/research/public service, Non-tenured not on tenure track total","93","43","50","0","0","0","3","1","2","2","1","1","4","3","1","0","0","0","84","38","46","0","0","0","0","0","0","0","0","0","-2"
"221759","The University of Tennessee-Knoxville","2010","Total full-time Instruction/research/public service, Tenured, Professors","729","577","152","1","1","0","52","44","8","16","9","7","13","12","1","0","0","0","644","508","136","2","2","0","0","0","0","1","1","0","-2"
"221759","The University of Tennessee-Knoxville","2010","Total full-time Instruction/research/public service, Tenured, Associate professors","449","274","175","2","2","0","52","40","12","26","14","12","11","10","1","0","0","0","355","205","150","0","0","0","0","0","0","3","3","0","-2"
"221759","The University of Tennessee-Knoxville","2010","Total full-time Instruction/research/public service, Tenured, Assistant professors","15","8","7","0","0","0","2","1","1","2","1","1","1","1","0","0","0","0","9","4","5","0","0","0","0","0","0","1","1","0","-2"
"221759","The University of Tennessee-Knoxville","2010","Total full-time Instruction/research/public service, Tenured, Instructors","2","0","2","0","0","0","0","0","0","0","0","0","0","0","0","0","0","0","2","0","2","0","0","0","0","0","0","0","0","0","-2"
"221759","The University of Tennessee-Knoxville","2010","Total full-time Instruction/research/public service, Tenured total","1195","859","336","3","3","0","106","85","21","44","24","20","25","23","2","0","0","0","1010","717","293","2","2","0","0","0","0","5","5","0","-2"
"221759","The University of Tennessee-Knoxville","2010","Total full-time Instruction/research/public service, Non-tenured on tenure track, Professors","11","9","2","0","0","0","2","2","0","0","0","0","0","0","0","0","0","0","9","7","2","0","0","0","0","0","0","0","0","0","-2"
"221759","The University of Tennessee-Knoxville","2010","Total full-time Instruction/research/public service, Non-tenured on tenure track, Associate professors","47","32","15","2","2","0","12","9","3","1","0","1","1","1","0","0","0","0","28","17","11","0","0","0","0","0","0","3","3","0","-2"
"221759","The University of Tennessee-Knoxville","2010","Total full-time Instruction/research/public service, Non-tenured on tenure track, Assistant professors","348","193","155","1","1","0","39","28","11","23","9","14","8","5","3","0","0","0","223","119","104","2","1","1","0","0","0","52","30","22","-2"
"221759","The University of Tennessee-Knoxville","2010","Total full-time Instruction/research/public service, Non-tenured on tenure track, Instructors","1","1","0","0","0","0","0","0","0","0","0","0","0","0","0","0","0","0","1","1","0","0","0","0","0","0","0","0","0","0","-2"
"221759","The University of Tennessee-Knoxville","2010","Total full-time Instruction/research/public service, Non-tenured on tenure track total","407","235","172","3","3","0","53","39","14","24","9","15","9","6","3","0","0","0","261","144","117","2","1","1","0","0","0","55","33","22","-2"
"221759","The University of Tennessee-Knoxville","2010","Total full-time Instruction/research/public service, Non-tenured not on tenure track, Professors","24","20","4","0","0","0","0","0","0","1","1","0","0","0","0","0","0","0","23","19","4","0","0","0","0","0","0","0","0","0","-2"
"221759","The University of Tennessee-Knoxville","2010","Total full-time Instruction/research/public service, Non-tenured not on tenure track, Associate professors","76","46","30","0","0","0","10","9","1","2","2","0","0","0","0","0","0","0","60","32","28","0","0","0","0","0","0","4","3","1","-2"
"221759","The University of Tennessee-Knoxville","2010","Total full-time Instruction/research/public servicey, Non-tenured not on tenure track, Assistant professors","179","100","79","1","0","1","31","23","8","8","4","4","4","2","2","0","0","0","114","54","60","1","1","0","0","0","0","20","16","4","-2"
"221759","The University of Tennessee-Knoxville","2010","Total full-time Instruction/research/public service, Non-tenured not on tenure track, Instructors","63","20","43","0","0","0","10","6","4","8","3","5","1","0","1","0","0","0","41","9","32","0","0","0","0","0","0","3","2","1","-2"
"221759","The University of Tennessee-Knoxville","2010","Total full-time Instruction/research/public service, Non-tenured not on tenure track, Lecturers","244","107","137","0","0","0","6","1","5","5","3","2","10","0","10","0","0","0","218","100","118","0","0","0","0","0","0","5","3","2","-2"
"221759","The University of Tennessee-Knoxville","2010","Total full-time Instruction/research/public service, Non-tenured not on tenure track, No academic rank","20","13","7","1","1","0","0","0","0","0","0","0","0","0","0","0","0","0","9","6","3","0","0","0","0","0","0","10","6","4","-2"
"221759","The University of Tennessee-Knoxville","2010","Total full-time Instruction/research/public service, Non-tenured not on tenure track total","606","306","300","2","1","1","57","39","18","24","13","11","15","2","13","0","0","0","465","220","245","1","1","0","0","0","0","42","30","12","-2"
"221768","The University of Tennessee-Martin","2010","Total full-time Instruction/research/public service, Tenured, Professors","78","57","21","0","0","0","1","1","0","3","1","2","0","0","0","0","0","0","74","55","19","0","0","0","0","0","0","0","0","0","-2"
"221768","The University of Tennessee-Martin","2010","Total full-time Instruction/research/public service, Tenured, Associate professors","51","27","24","1","0","1","2","1","1","4","1","3","2","1","1","0","0","0","40","23","17","0","0","0","0","0","0","2","1","1","-2"
"221768","The University of Tennessee-Martin","2010","Total full-time Instruction/research/public service, Tenured, Assistant professors","13","3","10","1","0","1","0","0","0","1","1","0","0","0","0","0","0","0","11","2","9","0","0","0","0","0","0","0","0","0","-2"
"221768","The University of Tennessee-Martin","2010","Total full-time Instruction/research/public service, Tenured, Instructors","12","5","7","0","0","0","0","0","0","1","0","1","0","0","0","0","0","0","11","5","6","0","0","0","0","0","0","0","0","0","-2"
"221768","The University of Tennessee-Martin","2010","Total full-time Instruction/research/public service, Tenured total","154","92","62","2","0","2","3","2","1","9","3","6","2","1","1","0","0","0","136","85","51","0","0","0","0","0","0","2","1","1","-2"
"221768","The University of Tennessee-Martin","2010","Total full-time Instruction/research/public service, Non-tenured on tenure track, Associate professors","6","2","4","0","0","0","0","0","0","1","0","1","0","0","0","0","0","0","4","1","3","0","0","0","0","0","0","1","1","0","-2"
"221768","The University of Tennessee-Martin","2010","Total full-time Instruction/research/public service, Non-tenured on tenure track, Assistant professors","67","38","29","0","0","0","3","2","1","3","1","2","0","0","0","0","0","0","57","32","25","0","0","0","0","0","0","4","3","1","-2"
"221768","The University of Tennessee-Martin","2010","Total full-time Instruction/research/public service, Non-tenured on tenure track, Instructors","4","2","2","0","0","0","0","0","0","0","0","0","0","0","0","0","0","0","4","2","2","0","0","0","0","0","0","0","0","0","-2"
"221768","The University of Tennessee-Martin","2010","Total full-time Instruction/research/public service, Non-tenured on tenure track total","77","42","35","0","0","0","3","2","1","4","1","3","0","0","0","0","0","0","65","35","30","0","0","0","0","0","0","5","4","1","-2"
"221768","The University of Tennessee-Martin","2010","Total full-time Instruction/research/public servicey, Non-tenured not on tenure track, Assistant professors","1","1","0","0","0","0","0","0","0","0","0","0","0","0","0","0","0","0","1","1","0","0","0","0","0","0","0","0","0","0","-2"
"221768","The University of Tennessee-Martin","2010","Total full-time Instruction/research/public service, Non-tenured not on tenure track, Instructors","11","8","3","0","0","0","0","0","0","0","0","0","0","0","0","0","0","0","11","8","3","0","0","0","0","0","0","0","0","0","-2"
"221768","The University of Tennessee-Martin","2010","Total full-time Instruction/research/public service, Non-tenured not on tenure track, Lecturers","45","22","23","1","1","0","3","1","2","2","0","2","1","0","1","0","0","0","38","20","18","0","0","0","0","0","0","0","0","0","-2"
"221768","The University of Tennessee-Martin","2010","Total full-time Instruction/research/public service, Non-tenured not on tenure track total","57","31","26","1","1","0","3","1","2","2","0","2","1","0","1","0","0","0","50","29","21","0","0","0","0","0","0","0","0","0","-2"
"221838","Tennessee State University","2010","Total full-time Instruction/research/public service, Tenured, Professors","109","75","34","0","0","0","21","17","4","47","28","19","3","2","1","1","1","0","34","24","10","3","3","0","0","0","0","0","0","0","-2"
"221838","Tennessee State University","2010","Total full-time Instruction/research/public service, Tenured, Associate professors","94","54","40","0","0","0","4","0","4","35","16","19","0","0","0","0","0","0","42","26","16","1","1","0","8","7","1","4","4","0","-2"
"221838","Tennessee State University","2010","Total full-time Instruction/research/public service, Tenured, Assistant professors","44","18","26","0","0","0","2","2","0","8","8","0","0","0","0","0","0","0","34","8","26","0","0","0","0","0","0","0","0","0","-2"
"221838","Tennessee State University","2010","Total full-time Instruction/research/public service, Tenured, Instructors","6","2","4","0","0","0","1","0","1","4","2","2","0","0","0","0","0","0","1","0","1","0","0","0","0","0","0","0","0","0","-2"
"221838","Tennessee State University","2010","Total full-time Instruction/research/public service, Tenured total","253","149","104","0","0","0","28","19","9","94","54","40","3","2","1","1","1","0","111","58","53","4","4","0","8","7","1","4","4","0","-2"
"221838","Tennessee State University","2010","Total full-time Instruction/research/public service, Non-tenured on tenure track, Professors","8","6","2","0","0","0","1","1","0","3","1","2","0","0","0","0","0","0","4","4","0","0","0","0","0","0","0","0","0","0","-2"
"221838","Tennessee State University","2010","Total full-time Instruction/research/public service, Non-tenured on tenure track, Associate professors","17","7","10","0","0","0","0","0","0","7","2","5","3","2","1","0","0","0","7","3","4","0","0","0","0","0","0","0","0","0","-2"
"221838","Tennessee State University","2010","Total full-time Instruction/research/public service, Non-tenured on tenure track, Assistant professors","63","33","30","3","0","3","5","5","0","12","4","8","0","0","0","0","0","0","27","11","16","1","0","1","0","0","0","15","13","2","-2"
"221838","Tennessee State University","2010","Total full-time Instruction/research/public service, Non-tenured on tenure track, Instructors","6","3","3","0","0","0","1","1","0","1","1","0","0","0","0","0","0","0","4","1","3","0","0","0","0","0","0","0","0","0","-2"
"221838","Tennessee State University","2010","Total full-time Instruction/research/public service, Non-tenured on tenure track total","94","49","45","3","0","3","7","7","0","23","8","15","3","2","1","0","0","0","42","19","23","1","0","1","0","0","0","15","13","2","-2"
"221838","Tennessee State University","2010","Total full-time Instruction/research/public service, Non-tenured not on tenure track, Professors","3","1","2","0","0","0","0","0","0","1","0","1","0","0","0","0","0","0","2","1","1","0","0","0","0","0","0","0","0","0","-2"
"221838","Tennessee State University","2010","Total full-time Instruction/research/public service, Non-tenured not on tenure track, Associate professors","15","7","8","0","0","0","3","1","2","7","3","4","0","0","0","0","0","0","3","2","1","1","0","1","0","0","0","1","1","0","-2"
"221838","Tennessee State University","2010","Total full-time Instruction/research/public servicey, Non-tenured not on tenure track, Assistant professors","40","19","21","0","0","0","2","2","0","19","5","14","0","0","0","0","0","0","10","5","5","1","0","1","0","0","0","8","7","1","-2"
"221838","Tennessee State University","2010","Total full-time Instruction/research/public service, Non-tenured not on tenure track, Instructors","19","10","9","1","0","1","1","1","0","3","2","1","1","1","0","0","0","0","10","5","5","2","1","1","0","0","0","1","0","1","-2"
"221838","Tennessee State University","2010","Total full-time Instruction/research/public service, Non-tenured not on tenure track, No academic rank","6","3","3","0","0","0","0","0","0","3","2","1","0","0","0","0","0","0","2","1","1","0","0","0","0","0","0","1","0","1","-2"
"221838","Tennessee State University","2010","Total full-time Instruction/research/public service, Non-tenured not on tenure track total","83","40","43","1","0","1","6","4","2","33","12","21","1","1","0","0","0","0","27","14","13","4","1","3","0","0","0","11","8","3","-2"
"225511","University of Houston","2010","Total full-time Instruction/research/public service, Tenured, Professors","392","331","61","0","0","0","64","56","8","5","4","1","16","12","4","0","0","0","306","258","48","1","1","0","0","0","0","0","0","0","-2"
"225511","University of Houston","2010","Total full-time Instruction/research/public service, Tenured, Associate professors","280","180","100","2","2","0","37","25","12","14","9","5","29","16","13","0","0","0","198","128","70","0","0","0","0","0","0","0","0","0","-2"
"225511","University of Houston","2010","Total full-time Instruction/research/public service, Tenured total","672","511","161","2","2","0","101","81","20","19","13","6","45","28","17","0","0","0","504","386","118","1","1","0","0","0","0","0","0","0","-2"
"225511","University of Houston","2010","Total full-time Instruction/research/public service, Non-tenured on tenure track, Professors","5","4","1","0","0","0","0","0","0","0","0","0","0","0","0","0","0","0","2","2","0","0","0","0","0","0","0","3","2","1","-2"
"225511","University of Houston","2010","Total full-time Instruction/research/public service, Non-tenured on tenure track, Associate professors","15","9","6","1","1","0","2","1","1","0","0","0","1","0","1","0","0","0","9","5","4","0","0","0","0","0","0","2","2","0","-2"
"225511","University of Houston","2010","Total full-time Instruction/research/public service, Non-tenured on tenure track, Assistant professors","205","112","93","0","0","0","45","19","26","5","1","4","13","7","6","0","0","0","112","67","45","2","1","1","0","0","0","28","17","11","-2"
"225511","University of Houston","2010","Total full-time Instruction/research/public service, Non-tenured on tenure track total","225","125","100","1","1","0","47","20","27","5","1","4","14","7","7","0","0","0","123","74","49","2","1","1","0","0","0","33","21","12","-2"
"225511","University of Houston","2010","Total full-time Instruction/research/public service, Non-tenured not on tenure track, Lecturers","107","42","65","0","0","0","3","2","1","2","1","1","10","2","8","0","0","0","89","36","53","1","0","1","0","0","0","2","1","1","-2"
"225511","University of Houston","2010","Total full-time Instruction/research/public service, Non-tenured not on tenure track, No academic rank","156","79","77","1","0","1","16","8","8","8","4","4","4","2","2","0","0","0","120","61","59","0","0","0","0","0","0","7","4","3","-2"
"225511","University of Houston","2010","Total full-time Instruction/research/public service, Non-tenured not on tenure track total","263","121","142","1","0","1","19","10","9","10","5","5","14","4","10","0","0","0","209","97","112","1","0","1","0","0","0","9","5","4","-2"
"227757","Rice University","2010","Total full-time Instruction/research/public service, Tenured, Professors","276","224","52","0","0","0","20","17","3","3","3","0","9","8","1","0","0","0","244","196","48","0","0","0","0","0","0","0","0","0","-2"
"227757","Rice University","2010","Total full-time Instruction/research/public service, Tenured, Associate professors","112","78","34","0","0","0","18","11","7","4","3","1","6","5","1","0","0","0","84","59","25","0","0","0","0","0","0","0","0","0","-2"
"227757","Rice University","2010","Total full-time Instruction/research/public service, Tenured total","388","302","86","0","0","0","38","28","10","7","6","1","15","13","2","0","0","0","328","255","73","0","0","0","0","0","0","0","0","0","-2"
"227757","Rice University","2010","Total full-time Instruction/research/public service, Non-tenured on tenure track, Professors","2","2","0","0","0","0","0","0","0","0","0","0","0","0","0","0","0","0","2","2","0","0","0","0","0","0","0","0","0","0","-2"
"227757","Rice University","2010","Total full-time Instruction/research/public service, Non-tenured on tenure track, Assistant professors","126","77","49","0","0","0","16","8","8","5","3","2","7","7","0","0","0","0","85","51","34","0","0","0","0","0","0","13","8","5","-2"
"227757","Rice University","2010","Total full-time Instruction/research/public service, Non-tenured on tenure track total","128","79","49","0","0","0","16","8","8","5","3","2","7","7","0","0","0","0","87","53","34","0","0","0","0","0","0","13","8","5","-2"
"227757","Rice University","2010","Total full-time Instruction/research/public service, Non-tenured not on tenure track, Instructors","20","11","9","1","0","1","0","0","0","0","0","0","2","2","0","0","0","0","12","5","7","0","0","0","0","0","0","5","4","1","-2"
"227757","Rice University","2010","Total full-time Instruction/research/public service, Non-tenured not on tenure track, Lecturers","77","38","39","0","0","0","6","1","5","0","0","0","8","2","6","0","0","0","60","34","26","0","0","0","0","0","0","3","1","2","-2"
"227757","Rice University","2010","Total full-time Instruction/research/public service, Non-tenured not on tenure track, No academic rank","25","20","5","0","0","0","0","0","0","1","1","0","0","0","0","0","0","0","17","13","4","0","0","0","1","0","1","6","6","0","-2"
"227757","Rice University","2010","Total full-time Instruction/research/public service, Non-tenured not on tenure track total","122","69","53","1","0","1","6","1","5","1","1","0","10","4","6","0","0","0","89","52","37","0","0","0","1","0","1","14","11","3","-2"
"228459","Texas State University","2010","Total full-time Instruction/research/public service, Tenured, Professors","280","193","87","1","1","0","14","10","4","3","3","0","17","9","8","0","0","0","212","141","71","2","2","0","30","26","4","1","1","0","-2"
"228459","Texas State University","2010","Total full-time Instruction/research/public service, Tenured, Associate professors","191","103","88","2","0","2","13","9","4","5","1","4","26","16","10","0","0","0","127","63","64","2","1","1","15","13","2","1","0","1","-2"
"228459","Texas State University","2010","Total full-time Instruction/research/public service, Tenured, Assistant professors","10","5","5","0","0","0","0","0","0","1","0","1","2","1","1","0","0","0","7","4","3","0","0","0","0","0","0","0","0","0","-2"
"228459","Texas State University","2010","Total full-time Instruction/research/public service, Tenured, Instructors","1","1","0","0","0","0","0","0","0","0","0","0","0","0","0","0","0","0","1","1","0","0","0","0","0","0","0","0","0","0","-2"
"228459","Texas State University","2010","Total full-time Instruction/research/public service, Tenured total","482","302","180","3","1","2","27","19","8","9","4","5","45","26","19","0","0","0","347","209","138","4","3","1","45","39","6","2","1","1","-2"
"228459","Texas State University","2010","Total full-time Instruction/research/public service, Non-tenured on tenure track, Professors","2","2","0","0","0","0","1","1","0","0","0","0","0","0","0","0","0","0","0","0","0","0","0","0","1","1","0","0","0","0","-2"
"228459","Texas State University","2010","Total full-time Instruction/research/public service, Non-tenured on tenure track, Associate professors","13","6","7","0","0","0","0","0","0","1","0","1","0","0","0","0","0","0","12","6","6","0","0","0","0","0","0","0","0","0","-2"
"228459","Texas State University","2010","Total full-time Instruction/research/public service, Non-tenured on tenure track, Assistant professors","253","137","116","2","2","0","35","25","10","19","10","9","40","22","18","0","0","0","126","60","66","5","3","2","25","14","11","1","1","0","-2"
"228459","Texas State University","2010","Total full-time Instruction/research/public service, Non-tenured on tenure track total","268","145","123","2","2","0","36","26","10","20","10","10","40","22","18","0","0","0","138","66","72","5","3","2","26","15","11","1","1","0","-2"
"228459","Texas State University","2010","Total full-time Instruction/research/public service, Non-tenured not on tenure track, Professors","2","2","0","0","0","0","0","0","0","0","0","0","0","0","0","0","0","0","2","2","0","0","0","0","0","0","0","0","0","0","-2"
"228459","Texas State University","2010","Total full-time Instruction/research/public service, Non-tenured not on tenure track, Associate professors","4","0","4","0","0","0","0","0","0","0","0","0","0","0","0","0","0","0","4","0","4","0","0","0","0","0","0","0","0","0","-2"
"228459","Texas State University","2010","Total full-time Instruction/research/public servicey, Non-tenured not on tenure track, Assistant professors","15","3","12","0","0","0","1","0","1","1","0","1","2","1","1","0","0","0","11","2","9","0","0","0","0","0","0","0","0","0","-2"
"228459","Texas State University","2010","Total full-time Instruction/research/public service, Non-tenured not on tenure track, Instructors","4","1","3","0","0","0","0","0","0","0","0","0","1","0","1","0","0","0","3","1","2","0","0","0","0","0","0","0","0","0","-2"
"228459","Texas State University","2010","Total full-time Instruction/research/public service, Non-tenured not on tenure track, Lecturers","305","132","173","0","0","0","8","3","5","4","1","3","21","10","11","0","0","0","247","105","142","6","4","2","18","9","9","1","0","1","-2"
"228459","Texas State University","2010","Total full-time Instruction/research/public service, Non-tenured not on tenure track, No academic rank","9","8","1","0","0","0","5","4","1","1","1","0","0","0","0","1","1","0","1","1","0","0","0","0","1","1","0","0","0","0","-2"
"228459","Texas State University","2010","Total full-time Instruction/research/public service, Non-tenured not on tenure track total","339","146","193","0","0","0","14","7","7","6","2","4","24","11","13","1","1","0","268","111","157","6","4","2","19","10","9","1","0","1","-2"
"228723","Texas A & M University-College Station","2010","Total full-time Instruction/research/public service, Tenured, Professors","862","758","104","2","1","1","91","84","7","17","14","3","33","26","7","0","0","0","716","630","86","0","0","0","0","0","0","3","3","0","-2"
"228723","Texas A & M University-College Station","2010","Total full-time Instruction/research/public service, Tenured, Associate professors","477","328","149","3","3","0","60","49","11","17","10","7","31","20","11","0","0","0","356","237","119","0","0","0","0","0","0","10","9","1","-2"
"228723","Texas A & M University-College Station","2010","Total full-time Instruction/research/public service, Tenured, Assistant professors","2","1","1","0","0","0","0","0","0","0","0","0","0","0","0","0","0","0","2","1","1","0","0","0","0","0","0","0","0","0","-2"
"228723","Texas A & M University-College Station","2010","Total full-time Instruction/research/public service, Tenured total","1341","1087","254","5","4","1","151","133","18","34","24","10","64","46","18","0","0","0","1074","868","206","0","0","0","0","0","0","13","12","1","-2"
"228723","Texas A & M University-College Station","2010","Total full-time Instruction/research/public service, Non-tenured on tenure track, Professors","3","3","0","0","0","0","0","0","0","0","0","0","0","0","0","0","0","0","3","3","0","0","0","0","0","0","0","0","0","0","-2"
"228723","Texas A & M University-College Station","2010","Total full-time Instruction/research/public service, Non-tenured on tenure track, Associate professors","56","30","26","0","0","0","7","4","3","2","1","1","3","1","2","0","0","0","41","22","19","0","0","0","0","0","0","3","2","1","-2"
"228723","Texas A & M University-College Station","2010","Total full-time Instruction/research/public service, Non-tenured on tenure track, Assistant professors","468","286","182","1","1","0","63","41","22","33","16","17","33","18","15","0","0","0","253","153","100","1","1","0","2","1","1","82","55","27","-2"
"228723","Texas A & M University-College Station","2010","Total full-time Instruction/research/public service, Non-tenured on tenure track, Instructors","1","1","0","0","0","0","0","0","0","0","0","0","0","0","0","0","0","0","1","1","0","0","0","0","0","0","0","0","0","0","-2"
"228723","Texas A & M University-College Station","2010","Total full-time Instruction/research/public service, Non-tenured on tenure track, Lecturers","2","0","2","0","0","0","1","0","1","0","0","0","0","0","0","0","0","0","1","0","1","0","0","0","0","0","0","0","0","0","-2"
"228723","Texas A & M University-College Station","2010","Total full-time Instruction/research/public service, Non-tenured on tenure track total","530","320","210","1","1","0","71","45","26","35","17","18","36","19","17","0","0","0","299","179","120","1","1","0","2","1","1","85","57","28","-2"
"228723","Texas A & M University-College Station","2010","Total full-time Instruction/research/public service, Non-tenured not on tenure track, Professors","65","49","16","0","0","0","1","1","0","1","0","1","1","1","0","0","0","0","60","45","15","0","0","0","2","2","0","0","0","0","-2"
"228723","Texas A & M University-College Station","2010","Total full-time Instruction/research/public service, Non-tenured not on tenure track, Associate professors","57","35","22","0","0","0","8","5","3","2","0","2","2","1","1","0","0","0","45","29","16","0","0","0","0","0","0","0","0","0","-2"
"228723","Texas A & M University-College Station","2010","Total full-time Instruction/research/public servicey, Non-tenured not on tenure track, Assistant professors","177","101","76","0","0","0","16","11","5","7","1","6","5","2","3","0","0","0","112","61","51","1","0","1","3","1","2","33","25","8","-2"
"228723","Texas A & M University-College Station","2010","Total full-time Instruction/research/public service, Non-tenured not on tenure track, Instructors","110","43","67","0","0","0","1","0","1","0","0","0","3","3","0","0","0","0","103","39","64","1","0","1","0","0","0","2","1","1","-2"
"228723","Texas A & M University-College Station","2010","Total full-time Instruction/research/public service, Non-tenured not on tenure track, Lecturers","345","135","210","2","2","0","18","6","12","9","6","3","9","5","4","0","0","0","287","106","181","1","0","1","1","1","0","18","9","9","-2"
"228723","Texas A & M University-College Station","2010","Total full-time Instruction/research/public service, Non-tenured not on tenure track total","754","363","391","2","2","0","44","23","21","19","7","12","20","12","8","0","0","0","607","280","327","3","0","3","6","4","2","53","35","18","-2"
"228778","The University of Texas at Austin","2010","Total full-time Instruction/research/public service, Tenured, Professors","981","776","205","6","3","3","40","35","5","22","16","6","32","23","9","0","0","0","754","593","161","3","2","1","0","0","0","124","104","20","-2"
"228778","The University of Texas at Austin","2010","Total full-time Instruction/research/public service, Tenured, Associate professors","477","298","179","4","2","2","15","9","6","27","10","17","28","15","13","0","0","0","308","198","110","3","0","3","0","0","0","92","64","28","-2"
"228778","The University of Texas at Austin","2010","Total full-time Instruction/research/public service, Tenured total","1458","1074","384","10","5","5","55","44","11","49","26","23","60","38","22","0","0","0","1062","791","271","6","2","4","0","0","0","216","168","48","-2"
"228778","The University of Texas at Austin","2010","Total full-time Instruction/research/public service, Non-tenured on tenure track, Professors","4","3","1","0","0","0","0","0","0","0","0","0","0","0","0","0","0","0","2","1","1","0","0","0","0","0","0","2","2","0","-2"
"228778","The University of Texas at Austin","2010","Total full-time Instruction/research/public service, Non-tenured on tenure track, Associate professors","53","33","20","0","0","0","1","0","1","3","2","1","3","3","0","0","0","0","32","18","14","0","0","0","0","0","0","14","10","4","-2"
"228778","The University of Texas at Austin","2010","Total full-time Instruction/research/public service, Non-tenured on tenure track, Assistant professors","439","252","187","0","0","0","17","8","9","25","12","13","18","11","7","0","0","0","217","117","100","4","1","3","0","0","0","158","103","55","-2"
"228778","The University of Texas at Austin","2010","Total full-time Instruction/research/public service, Non-tenured on tenure track total","496","288","208","0","0","0","18","8","10","28","14","14","21","14","7","0","0","0","251","136","115","4","1","3","0","0","0","174","115","59","-2"
"228778","The University of Texas at Austin","2010","Total full-time Instruction/research/public service, Non-tenured not on tenure track, Lecturers","354","173","181","0","0","0","11","6","5","6","3","3","13","4","9","0","0","0","272","141","131","0","0","0","0","0","0","52","19","33","-2"
"228778","The University of Texas at Austin","2010","Total full-time Instruction/research/public service, Non-tenured not on tenure track, No academic rank","187","56","131","0","0","0","5","3","2","6","1","5","15","3","12","0","0","0","148","43","105","0","0","0","0","0","0","13","6","7","-2"
"228778","The University of Texas at Austin","2010","Total full-time Instruction/research/public service, Non-tenured not on tenure track total","541","229","312","0","0","0","16","9","7","12","4","8","28","7","21","0","0","0","420","184","236","0","0","0","0","0","0","65","25","40","-2"
"228796","The University of Texas at El Paso","2010","Total full-time Instruction/research/public service, Tenured, Professors","142","109","33","0","0","0","11","8","3","1","1","0","31","21","10","0","0","0","98","78","20","0","0","0","0","0","0","1","1","0","-2"
"228796","The University of Texas at El Paso","2010","Total full-time Instruction/research/public service, Tenured, Associate professors","180","131","49","0","0","0","18","15","3","1","1","0","47","31","16","0","0","0","113","83","30","0","0","0","0","0","0","1","1","0","-2"
"228796","The University of Texas at El Paso","2010","Total full-time Instruction/research/public service, Tenured, Assistant professors","2","1","1","1","1","0","0","0","0","0","0","0","0","0","0","0","0","0","1","0","1","0","0","0","0","0","0","0","0","0","-2"
"228796","The University of Texas at El Paso","2010","Total full-time Instruction/research/public service, Tenured total","324","241","83","1","1","0","29","23","6","2","2","0","78","52","26","0","0","0","212","161","51","0","0","0","0","0","0","2","2","0","-2"
"228796","The University of Texas at El Paso","2010","Total full-time Instruction/research/public service, Non-tenured on tenure track, Associate professors","17","14","3","0","0","0","3","2","1","1","1","0","8","7","1","0","0","0","5","4","1","0","0","0","0","0","0","0","0","0","-2"
"228796","The University of Texas at El Paso","2010","Total full-time Instruction/research/public service, Non-tenured on tenure track, Assistant professors","148","78","70","1","0","1","14","8","6","1","1","0","44","25","19","0","0","0","62","30","32","1","1","0","0","0","0","25","13","12","-2"
"228796","The University of Texas at El Paso","2010","Total full-time Instruction/research/public service, Non-tenured on tenure track total","165","92","73","1","0","1","17","10","7","2","2","0","52","32","20","0","0","0","67","34","33","1","1","0","0","0","0","25","13","12","-2"
"228796","The University of Texas at El Paso","2010","Total full-time Instruction/research/public service, Non-tenured not on tenure track, Lecturers","201","81","120","2","0","2","12","7","5","2","0","2","62","22","40","0","0","0","102","38","64","0","0","0","0","0","0","21","14","7","-2"
"228796","The University of Texas at El Paso","2010","Total full-time Instruction/research/public service, Non-tenured not on tenure track total","201","81","120","2","0","2","12","7","5","2","0","2","62","22","40","0","0","0","102","38","64","0","0","0","0","0","0","21","14","7","-2"
"229063","Texas Southern University","2010","Total full-time Instruction/research/public service, Tenured, Professors","77","62","15","0","0","0","7","6","1","48","39","9","1","1","0","0","0","0","17","13","4","0","0","0","0","0","0","4","3","1","-2"
"229063","Texas Southern University","2010","Total full-time Instruction/research/public service, Tenured, Associate professors","74","31","43","0","0","0","11","5","6","44","17","27","1","0","1","0","0","0","11","4","7","0","0","0","0","0","0","7","5","2","-2"
"229063","Texas Southern University","2010","Total full-time Instruction/research/public service, Tenured, Assistant professors","16","9","7","0","0","0","0","0","0","13","8","5","0","0","0","0","0","0","2","0","2","0","0","0","0","0","0","1","1","0","-2"
"229063","Texas Southern University","2010","Total full-time Instruction/research/public service, Tenured, Instructors","3","1","2","0","0","0","0","0","0","3","1","2","0","0","0","0","0","0","0","0","0","0","0","0","0","0","0","0","0","0","-2"
"229063","Texas Southern University","2010","Total full-time Instruction/research/public service, Tenured total","170","103","67","0","0","0","18","11","7","108","65","43","2","1","1","0","0","0","30","17","13","0","0","0","0","0","0","12","9","3","-2"
"229063","Texas Southern University","2010","Total full-time Instruction/research/public service, Non-tenured on tenure track, Professors","6","4","2","0","0","0","0","0","0","4","2","2","1","1","0","0","0","0","1","1","0","0","0","0","0","0","0","0","0","0","-2"
"229063","Texas Southern University","2010","Total full-time Instruction/research/public service, Non-tenured on tenure track, Associate professors","12","4","8","0","0","0","0","0","0","9","3","6","0","0","0","0","0","0","2","1","1","0","0","0","0","0","0","1","0","1","-2"
"229063","Texas Southern University","2010","Total full-time Instruction/research/public service, Non-tenured on tenure track, Assistant professors","71","34","37","0","0","0","17","11","6","40","15","25","2","1","1","0","0","0","8","4","4","0","0","0","0","0","0","4","3","1","-2"
"229063","Texas Southern University","2010","Total full-time Instruction/research/public service, Non-tenured on tenure track, Instructors","2","1","1","0","0","0","0","0","0","1","0","1","0","0","0","0","0","0","1","1","0","0","0","0","0","0","0","0","0","0","-2"
"229063","Texas Southern University","2010","Total full-time Instruction/research/public service, Non-tenured on tenure track total","91","43","48","0","0","0","17","11","6","54","20","34","3","2","1","0","0","0","12","7","5","0","0","0","0","0","0","5","3","2","-2"
"229063","Texas Southern University","2010","Total full-time Instruction/research/public service, Non-tenured not on tenure track, Lecturers","87","44","43","0","0","0","5","2","3","66","34","32","5","2","3","0","0","0","7","5","2","0","0","0","0","0","0","4","1","3","-2"
"229063","Texas Southern University","2010","Total full-time Instruction/research/public service, Non-tenured not on tenure track total","87","44","43","0","0","0","5","2","3","66","34","32","5","2","3","0","0","0","7","5","2","0","0","0","0","0","0","4","1","3","-2"
"229115","Texas Tech University","2010","Total full-time Instruction/research/public service, Tenured, Professors","302","230","72","2","1","1","32","23","9","5","4","1","12","9","3","0","0","0","251","193","58","0","0","0","0","0","0","0","0","0","-2"
"229115","Texas Tech University","2010","Total full-time Instruction/research/public service, Tenured, Associate professors","329","219","110","1","1","0","32","25","7","4","2","2","20","12","8","0","0","0","271","179","92","0","0","0","0","0","0","1","0","1","-2"
"229115","Texas Tech University","2010","Total full-time Instruction/research/public service, Tenured, Assistant professors","7","5","2","0","0","0","0","0","0","0","0","0","1","0","1","0","0","0","6","5","1","0","0","0","0","0","0","0","0","0","-2"
"229115","Texas Tech University","2010","Total full-time Instruction/research/public service, Tenured total","638","454","184","3","2","1","64","48","16","9","6","3","33","21","12","0","0","0","528","377","151","0","0","0","0","0","0","1","0","1","-2"
"229115","Texas Tech University","2010","Total full-time Instruction/research/public service, Non-tenured on tenure track, Professors","7","6","1","0","0","0","0","0","0","0","0","0","1","0","1","0","0","0","6","6","0","0","0","0","0","0","0","0","0","0","-2"
"229115","Texas Tech University","2010","Total full-time Instruction/research/public service, Non-tenured on tenure track, Associate professors","35","23","12","0","0","0","5","3","2","2","1","1","1","1","0","0","0","0","27","18","9","0","0","0","0","0","0","0","0","0","-2"
"229115","Texas Tech University","2010","Total full-time Instruction/research/public service, Non-tenured on tenure track, Assistant professors","282","170","112","1","1","0","58","41","17","7","2","5","27","15","12","0","0","0","187","110","77","0","0","0","0","0","0","2","1","1","-2"
"229115","Texas Tech University","2010","Total full-time Instruction/research/public service, Non-tenured on tenure track total","324","199","125","1","1","0","63","44","19","9","3","6","29","16","13","0","0","0","220","134","86","0","0","0","0","0","0","2","1","1","-2"
"229115","Texas Tech University","2010","Total full-time Instruction/research/public service, Non-tenured not on tenure track, Professors","3","3","0","0","0","0","0","0","0","0","0","0","1","1","0","0","0","0","2","2","0","0","0","0","0","0","0","0","0","0","-2"
"229115","Texas Tech University","2010","Total full-time Instruction/research/public service, Non-tenured not on tenure track, Associate professors","1","1","0","0","0","0","0","0","0","0","0","0","0","0","0","0","0","0","1","1","0","0","0","0","0","0","0","0","0","0","-2"
"229115","Texas Tech University","2010","Total full-time Instruction/research/public servicey, Non-tenured not on tenure track, Assistant professors","18","16","2","0","0","0","3","3","0","1","1","0","0","0","0","0","0","0","14","12","2","0","0","0","0","0","0","0","0","0","-2"
"229115","Texas Tech University","2010","Total full-time Instruction/research/public service, Non-tenured not on tenure track, Instructors","192","80","112","1","1","0","9","4","5","3","1","2","11","7","4","0","0","0","166","66","100","0","0","0","0","0","0","2","1","1","-2"
"229115","Texas Tech University","2010","Total full-time Instruction/research/public service, Non-tenured not on tenure track total","214","100","114","1","1","0","12","7","5","4","2","2","12","8","4","0","0","0","183","81","102","0","0","0","0","0","0","2","1","1","-2"
"230728","Utah State University","2010","Total full-time Instruction/research/public service, Tenured, Professors","203","173","30","0","0","0","8","8","0","0","0","0","1","1","0","0","0","0","180","151","29","1","1","0","2","2","0","11","10","1","-2"
"230728","Utah State University","2010","Total full-time Instruction/research/public service, Tenured, Associate professors","217","141","76","0","0","0","3","2","1","2","1","1","8","5","3","0","0","0","182","120","62","0","0","0","3","1","2","19","12","7","-2"
"230728","Utah State University","2010","Total full-time Instruction/research/public service, Tenured total","420","314","106","0","0","0","11","10","1","2","1","1","9","6","3","0","0","0","362","271","91","1","1","0","5","3","2","30","22","8","-2"
"230728","Utah State University","2010","Total full-time Instruction/research/public service, Non-tenured on tenure track, Professors","1","1","0","0","0","0","0","0","0","0","0","0","0","0","0","0","0","0","1","1","0","0","0","0","0","0","0","0","0","0","-2"
"230728","Utah State University","2010","Total full-time Instruction/research/public service, Non-tenured on tenure track, Associate professors","8","7","1","0","0","0","1","1","0","0","0","0","0","0","0","0","0","0","6","6","0","1","0","1","0","0","0","0","0","0","-2"
"230728","Utah State University","2010","Total full-time Instruction/research/public service, Non-tenured on tenure track, Assistant professors","151","93","58","2","1","1","10","9","1","1","1","0","6","2","4","0","0","0","104","67","37","0","0","0","7","4","3","21","9","12","-2"
"230728","Utah State University","2010","Total full-time Instruction/research/public service, Non-tenured on tenure track, Instructors","1","0","1","0","0","0","0","0","0","0","0","0","0","0","0","0","0","0","1","0","1","0","0","0","0","0","0","0","0","0","-2"
"230728","Utah State University","2010","Total full-time Instruction/research/public service, Non-tenured on tenure track total","161","101","60","2","1","1","11","10","1","1","1","0","6","2","4","0","0","0","112","74","38","1","0","1","7","4","3","21","9","12","-2"
"230728","Utah State University","2010","Total full-time Instruction/research/public service, Non-tenured not on tenure track, Professors","4","4","0","0","0","0","0","0","0","0","0","0","0","0","0","0","0","0","4","4","0","0","0","0","0","0","0","0","0","0","-2"
"230728","Utah State University","2010","Total full-time Instruction/research/public service, Non-tenured not on tenure track, Associate professors","16","11","5","0","0","0","2","2","0","0","0","0","1","1","0","0","0","0","10","5","5","0","0","0","1","1","0","2","2","0","-2"
"230728","Utah State University","2010","Total full-time Instruction/research/public servicey, Non-tenured not on tenure track, Assistant professors","38","20","18","0","0","0","2","0","2","0","0","0","1","1","0","0","0","0","27","14","13","0","0","0","5","2","3","3","3","0","-2"
"230728","Utah State University","2010","Total full-time Instruction/research/public service, Non-tenured not on tenure track, Instructors","19","6","13","0","0","0","0","0","0","0","0","0","0","0","0","0","0","0","17","6","11","0","0","0","1","0","1","1","0","1","-2"
"230728","Utah State University","2010","Total full-time Instruction/research/public service, Non-tenured not on tenure track, Lecturers","81","43","38","0","0","0","3","1","2","2","1","1","2","1","1","0","0","0","67","36","31","0","0","0","6","3","3","1","1","0","-2"
"230728","Utah State University","2010","Total full-time Instruction/research/public service, Non-tenured not on tenure track total","158","84","74","0","0","0","7","3","4","2","1","1","4","3","1","0","0","0","125","65","60","0","0","0","13","6","7","7","6","1","-2"
"230764","University of Utah","2010","Total full-time Instruction/research/public service, Tenured, Professors","616","482","134","5","2","3","42","36","6","3","2","1","14","11","3","0","0","0","513","401","112","0","0","0","37","28","9","2","2","0","-2"
"230764","University of Utah","2010","Total full-time Instruction/research/public service, Tenured, Associate professors","323","221","102","0","0","0","24","16","8","7","5","2","16","12","4","0","0","0","244","164","80","2","0","2","22","18","4","8","6","2","-2"
"230764","University of Utah","2010","Total full-time Instruction/research/public service, Tenured, Assistant professors","2","1","1","0","0","0","0","0","0","0","0","0","0","0","0","0","0","0","2","1","1","0","0","0","0","0","0","0","0","0","-2"
"230764","University of Utah","2010","Total full-time Instruction/research/public service, Tenured, Lecturers","3","1","2","0","0","0","0","0","0","0","0","0","0","0","0","0","0","0","3","1","2","0","0","0","0","0","0","0","0","0","-2"
"230764","University of Utah","2010","Total full-time Instruction/research/public service, Tenured total","944","705","239","5","2","3","66","52","14","10","7","3","30","23","7","0","0","0","762","567","195","2","0","2","59","46","13","10","8","2","-2"
"230764","University of Utah","2010","Total full-time Instruction/research/public service, Non-tenured on tenure track, Professors","9","8","1","0","0","0","0","0","0","0","0","0","0","0","0","0","0","0","4","3","1","0","0","0","5","5","0","0","0","0","-2"
"230764","University of Utah","2010","Total full-time Instruction/research/public service, Non-tenured on tenure track, Associate professors","44","24","20","0","0","0","5","5","0","0","0","0","0","0","0","0","0","0","23","10","13","0","0","0","16","9","7","0","0","0","-2"
"230764","University of Utah","2010","Total full-time Instruction/research/public service, Non-tenured on tenure track, Assistant professors","317","178","139","3","0","3","20","14","6","2","1","1","9","3","6","0","0","0","166","89","77","1","1","0","90","55","35","26","15","11","-2"
"230764","University of Utah","2010","Total full-time Instruction/research/public service, Non-tenured on tenure track, Instructors","8","4","4","0","0","0","2","1","1","0","0","0","0","0","0","0","0","0","3","1","2","0","0","0","3","2","1","0","0","0","-2"
"230764","University of Utah","2010","Total full-time Instruction/research/public service, Non-tenured on tenure track total","378","214","164","3","0","3","27","20","7","2","1","1","9","3","6","0","0","0","196","103","93","1","1","0","114","71","43","26","15","11","-2"
"230764","University of Utah","2010","Total full-time Instruction/research/public service, Non-tenured not on tenure track, Lecturers","1094","617","477","3","1","2","67","41","26","8","4","4","13","7","6","1","0","1","802","442","360","4","3","1","135","83","52","61","36","25","-2"
"230764","University of Utah","2010","Total full-time Instruction/research/public service, Non-tenured not on tenure track, No academic rank","575","334","241","2","0","2","36","17","19","4","3","1","6","5","1","1","0","1","280","149","131","1","0","1","86","54","32","159","106","53","-2"
"230764","University of Utah","2010","Total full-time Instruction/research/public service, Non-tenured not on tenure track total","1669","951","718","5","1","4","103","58","45","12","7","5","19","12","7","2","0","2","1082","591","491","5","3","2","221","137","84","220","142","78","-2"
"230913","Northern Vermont University","2010","Total full-time Instruction/research/public service, Tenured, Professors","27","17","10","0","0","0","0","0","0","0","0","0","0","0","0","0","0","0","27","17","10","0","0","0","0","0","0","0","0","0","-2"
"230913","Northern Vermont University","2010","Total full-time Instruction/research/public service, Tenured, Associate professors","8","7","1","0","0","0","0","0","0","1","1","0","0","0","0","0","0","0","7","6","1","0","0","0","0","0","0","0","0","0","-2"
"230913","Northern Vermont University","2010","Total full-time Instruction/research/public service, Tenured total","35","24","11","0","0","0","0","0","0","1","1","0","0","0","0","0","0","0","34","23","11","0","0","0","0","0","0","0","0","0","-2"
"230913","Northern Vermont University","2010","Total full-time Instruction/research/public service, Non-tenured on tenure track, Professors","1","1","0","0","0","0","0","0","0","0","0","0","0","0","0","0","0","0","1","1","0","0","0","0","0","0","0","0","0","0","-2"
"230913","Northern Vermont University","2010","Total full-time Instruction/research/public service, Non-tenured on tenure track, Assistant professors","9","4","5","0","0","0","0","0","0","0","0","0","0","0","0","0","0","0","8","3","5","0","0","0","1","1","0","0","0","0","-2"
"230913","Northern Vermont University","2010","Total full-time Instruction/research/public service, Non-tenured on tenure track total","10","5","5","0","0","0","0","0","0","0","0","0","0","0","0","0","0","0","9","4","5","0","0","0","1","1","0","0","0","0","-2"
"230913","Northern Vermont University","2010","Total full-time Instruction/research/public service, Non-tenured not on tenure track, Associate professors","1","1","0","0","0","0","0","0","0","0","0","0","0","0","0","0","0","0","1","1","0","0","0","0","0","0","0","0","0","0","-2"
"230913","Northern Vermont University","2010","Total full-time Instruction/research/public servicey, Non-tenured not on tenure track, Assistant professors","4","2","2","0","0","0","0","0","0","0","0","0","0","0","0","0","0","0","1","0","1","0","0","0","3","2","1","0","0","0","-2"
"230913","Northern Vermont University","2010","Total full-time Instruction/research/public service, Non-tenured not on tenure track total","5","3","2","0","0","0","0","0","0","0","0","0","0","0","0","0","0","0","2","1","1","0","0","0","3","2","1","0","0","0","-2"
"232186","George Mason University","2010","Total full-time Instruction/research/public service, Tenured, Professors","327","259","68","1","1","0","22","19","3","6","4","2","5","4","1","0","0","0","275","217","58","0","0","0","16","12","4","2","2","0","-2"
"232186","George Mason University","2010","Total full-time Instruction/research/public service, Tenured, Associate professors","311","183","128","1","0","1","37","29","8","14","5","9","9","5","4","0","0","0","239","137","102","0","0","0","11","7","4","0","0","0","-2"
"232186","George Mason University","2010","Total full-time Instruction/research/public service, Tenured total","638","442","196","2","1","1","59","48","11","20","9","11","14","9","5","0","0","0","514","354","160","0","0","0","27","19","8","2","2","0","-2"
"232186","George Mason University","2010","Total full-time Instruction/research/public service, Non-tenured on tenure track, Associate professors","20","11","9","0","0","0","3","3","0","2","1","1","0","0","0","0","0","0","12","7","5","0","0","0","2","0","2","1","0","1","-2"
"232186","George Mason University","2010","Total full-time Instruction/research/public service, Non-tenured on tenure track, Assistant professors","224","114","110","1","0","1","29","12","17","7","3","4","12","6","6","0","0","0","115","60","55","0","0","0","37","19","18","23","14","9","-2"
"232186","George Mason University","2010","Total full-time Instruction/research/public service, Non-tenured on tenure track total","244","125","119","1","0","1","32","15","17","9","4","5","12","6","6","0","0","0","127","67","60","0","0","0","39","19","20","24","14","10","-2"
"232186","George Mason University","2010","Total full-time Instruction/research/public service, Non-tenured not on tenure track, Professors","38","30","8","0","0","0","6","5","1","0","0","0","1","1","0","0","0","0","27","20","7","0","0","0","2","2","0","2","2","0","-2"
"232186","George Mason University","2010","Total full-time Instruction/research/public service, Non-tenured not on tenure track, Associate professors","60","34","26","1","1","0","6","6","0","3","1","2","1","0","1","0","0","0","43","21","22","0","0","0","3","3","0","3","2","1","-2"
"232186","George Mason University","2010","Total full-time Instruction/research/public servicey, Non-tenured not on tenure track, Assistant professors","191","93","98","0","0","0","13","8","5","8","4","4","5","2","3","0","0","0","125","55","70","1","1","0","18","9","9","21","14","7","-2"
"232186","George Mason University","2010","Total full-time Instruction/research/public service, Non-tenured not on tenure track, Instructors","142","67","75","0","0","0","12","9","3","5","2","3","2","0","2","0","0","0","96","41","55","0","0","0","13","6","7","14","9","5","-2"
"232186","George Mason University","2010","Total full-time Instruction/research/public service, Non-tenured not on tenure track total","431","224","207","1","1","0","37","28","9","16","7","9","9","3","6","0","0","0","291","137","154","1","1","0","36","20","16","40","27","13","-2"
"232982","Old Dominion University","2010","Total full-time Instruction/research/public service, Tenured, Professors","195","158","37","1","0","1","23","22","1","7","6","1","3","2","1","0","0","0","115","89","26","0","0","0","31","25","6","15","14","1","-2"
"232982","Old Dominion University","2010","Total full-time Instruction/research/public service, Tenured, Associate professors","183","110","73","1","1","0","13","7","6","15","7","8","6","4","2","0","0","0","117","70","47","0","0","0","27","19","8","4","2","2","-2"
"232982","Old Dominion University","2010","Total full-time Instruction/research/public service, Tenured total","378","268","110","2","1","1","36","29","7","22","13","9","9","6","3","0","0","0","232","159","73","0","0","0","58","44","14","19","16","3","-2"
"232982","Old Dominion University","2010","Total full-time Instruction/research/public service, Non-tenured on tenure track, Professors","3","2","1","0","0","0","0","0","0","0","0","0","0","0","0","0","0","0","2","2","0","0","0","0","1","0","1","0","0","0","-2"
"232982","Old Dominion University","2010","Total full-time Instruction/research/public service, Non-tenured on tenure track, Associate professors","15","8","7","0","0","0","1","0","1","2","1","1","0","0","0","0","0","0","7","4","3","0","0","0","4","2","2","1","1","0","-2"
"232982","Old Dominion University","2010","Total full-time Instruction/research/public service, Non-tenured on tenure track, Assistant professors","142","81","61","1","0","1","17","11","6","6","2","4","5","3","2","0","0","0","73","41","32","1","1","0","15","7","8","24","16","8","-2"
"232982","Old Dominion University","2010","Total full-time Instruction/research/public service, Non-tenured on tenure track, Instructors","1","0","1","0","0","0","0","0","0","0","0","0","0","0","0","0","0","0","1","0","1","0","0","0","0","0","0","0","0","0","-2"
"232982","Old Dominion University","2010","Total full-time Instruction/research/public service, Non-tenured on tenure track total","161","91","70","1","0","1","18","11","7","8","3","5","5","3","2","0","0","0","83","47","36","1","1","0","20","9","11","25","17","8","-2"
"232982","Old Dominion University","2010","Total full-time Instruction/research/public service, Non-tenured not on tenure track, Professors","5","5","0","0","0","0","0","0","0","0","0","0","0","0","0","0","0","0","4","4","0","0","0","0","1","1","0","0","0","0","-2"
"232982","Old Dominion University","2010","Total full-time Instruction/research/public service, Non-tenured not on tenure track, Associate professors","5","3","2","0","0","0","0","0","0","0","0","0","0","0","0","0","0","0","5","3","2","0","0","0","0","0","0","0","0","0","-2"
"232982","Old Dominion University","2010","Total full-time Instruction/research/public servicey, Non-tenured not on tenure track, Assistant professors","15","9","6","0","0","0","0","0","0","1","0","1","1","1","0","0","0","0","6","3","3","0","0","0","3","2","1","4","3","1","-2"
"232982","Old Dominion University","2010","Total full-time Instruction/research/public service, Non-tenured not on tenure track, Instructors","34","9","25","0","0","0","0","0","0","3","2","1","1","0","1","0","0","0","21","4","17","0","0","0","8","3","5","1","0","1","-2"
"232982","Old Dominion University","2010","Total full-time Instruction/research/public service, Non-tenured not on tenure track, Lecturers","142","46","96","1","1","0","6","2","4","6","1","5","5","4","1","0","0","0","96","29","67","2","0","2","24","7","17","2","2","0","-2"
"232982","Old Dominion University","2010","Total full-time Instruction/research/public service, Non-tenured not on tenure track total","201","72","129","1","1","0","6","2","4","10","3","7","7","5","2","0","0","0","132","43","89","2","0","2","36","13","23","7","5","2","-2"
"233921","Virginia Polytechnic Institute and State University","2010","Total full-time Instruction/research/public service, Tenured, Professors","518","430","88","2","0","2","57","53","4","13","11","2","8","7","1","0","0","0","436","357","79","1","1","0","0","0","0","1","1","0","-2"
"233921","Virginia Polytechnic Institute and State University","2010","Total full-time Instruction/research/public service, Tenured, Associate professors","428","302","126","3","2","1","39","33","6","17","9","8","14","13","1","0","0","0","349","242","107","1","0","1","0","0","0","5","3","2","-2"
"233921","Virginia Polytechnic Institute and State University","2010","Total full-time Instruction/research/public service, Tenured total","946","732","214","5","2","3","96","86","10","30","20","10","22","20","2","0","0","0","785","599","186","2","1","1","0","0","0","6","4","2","-2"
"233921","Virginia Polytechnic Institute and State University","2010","Total full-time Instruction/research/public service, Non-tenured on tenure track, Professors","2","2","0","0","0","0","0","0","0","0","0","0","0","0","0","0","0","0","1","1","0","0","0","0","0","0","0","1","1","0","-2"
"233921","Virginia Polytechnic Institute and State University","2010","Total full-time Instruction/research/public service, Non-tenured on tenure track, Associate professors","35","28","7","0","0","0","4","4","0","0","0","0","0","0","0","0","0","0","29","22","7","0","0","0","0","0","0","2","2","0","-2"
"233921","Virginia Polytechnic Institute and State University","2010","Total full-time Instruction/research/public service, Non-tenured on tenure track, Assistant professors","279","156","123","0","0","0","32","17","15","12","7","5","11","10","1","0","0","0","177","95","82","2","1","1","0","0","0","45","26","19","-2"
"233921","Virginia Polytechnic Institute and State University","2010","Total full-time Instruction/research/public service, Non-tenured on tenure track total","316","186","130","0","0","0","36","21","15","12","7","5","11","10","1","0","0","0","207","118","89","2","1","1","0","0","0","48","29","19","-2"
"233921","Virginia Polytechnic Institute and State University","2010","Total full-time Instruction/research/public service, Non-tenured not on tenure track, Professors","11","11","0","0","0","0","1","1","0","0","0","0","0","0","0","0","0","0","10","10","0","0","0","0","0","0","0","0","0","0","-2"
"233921","Virginia Polytechnic Institute and State University","2010","Total full-time Instruction/research/public service, Non-tenured not on tenure track, Associate professors","24","19","5","0","0","0","1","1","0","0","0","0","1","1","0","0","0","0","19","14","5","1","1","0","0","0","0","2","2","0","-2"
"233921","Virginia Polytechnic Institute and State University","2010","Total full-time Instruction/research/public servicey, Non-tenured not on tenure track, Assistant professors","80","50","30","0","0","0","4","3","1","1","1","0","2","1","1","0","0","0","59","34","25","1","1","0","0","0","0","13","10","3","-2"
"233921","Virginia Polytechnic Institute and State University","2010","Total full-time Instruction/research/public service, Non-tenured not on tenure track, Instructors","189","84","105","1","1","0","8","2","6","7","5","2","6","1","5","0","0","0","160","69","91","0","0","0","0","0","0","7","6","1","-2"
"233921","Virginia Polytechnic Institute and State University","2010","Total full-time Instruction/research/public service, Non-tenured not on tenure track, Lecturers","513","345","168","1","0","1","45","30","15","5","4","1","11","5","6","1","0","1","297","183","114","4","1","3","0","0","0","149","122","27","-2"
"233921","Virginia Polytechnic Institute and State University","2010","Total full-time Instruction/research/public service, Non-tenured not on tenure track total","817","509","308","2","1","1","59","37","22","13","10","3","20","8","12","1","0","1","545","310","235","6","3","3","0","0","0","171","140","31","-2"
"234076","University of Virginia-Main Campus","2010","Total full-time Instruction/research/public service, Tenured, Professors","745","618","127","0","0","0","46","40","6","14","10","4","4","4","0","0","0","0","670","555","115","1","0","1","6","6","0","4","3","1","-2"
"234076","University of Virginia-Main Campus","2010","Total full-time Instruction/research/public service, Tenured, Associate professors","321","215","106","0","0","0","18","11","7","20","14","6","5","5","0","0","0","0","278","185","93","0","0","0","0","0","0","0","0","0","-2"
"234076","University of Virginia-Main Campus","2010","Total full-time Instruction/research/public service, Tenured total","1066","833","233","0","0","0","64","51","13","34","24","10","9","9","0","0","0","0","948","740","208","1","0","1","6","6","0","4","3","1","-2"
"234076","University of Virginia-Main Campus","2010","Total full-time Instruction/research/public service, Non-tenured on tenure track, Professors","1","1","0","0","0","0","0","0","0","0","0","0","0","0","0","0","0","0","1","1","0","0","0","0","0","0","0","0","0","0","-2"
"234076","University of Virginia-Main Campus","2010","Total full-time Instruction/research/public service, Non-tenured on tenure track, Associate professors","56","38","18","0","0","0","8","5","3","1","1","0","1","1","0","0","0","0","42","27","15","0","0","0","2","2","0","2","2","0","-2"
"234076","University of Virginia-Main Campus","2010","Total full-time Instruction/research/public service, Non-tenured on tenure track, Assistant professors","283","175","108","2","2","0","41","24","17","14","7","7","14","6","8","0","0","0","185","118","67","1","1","0","0","0","0","26","17","9","-2"
"234076","University of Virginia-Main Campus","2010","Total full-time Instruction/research/public service, Non-tenured on tenure track total","340","214","126","2","2","0","49","29","20","15","8","7","15","7","8","0","0","0","228","146","82","1","1","0","2","2","0","28","19","9","-2"
"234076","University of Virginia-Main Campus","2010","Total full-time Instruction/research/public service, Non-tenured not on tenure track, Professors","68","44","24","0","0","0","2","1","1","2","2","0","1","0","1","0","0","0","63","41","22","0","0","0","0","0","0","0","0","0","-2"
"234076","University of Virginia-Main Campus","2010","Total full-time Instruction/research/public service, Non-tenured not on tenure track, Associate professors","242","148","94","0","0","0","14","11","3","9","4","5","3","2","1","1","1","0","209","126","83","0","0","0","0","0","0","6","4","2","-2"
"234076","University of Virginia-Main Campus","2010","Total full-time Instruction/research/public servicey, Non-tenured not on tenure track, Assistant professors","257","133","124","1","1","0","31","19","12","9","3","6","4","4","0","0","0","0","198","96","102","1","0","1","2","1","1","11","9","2","-2"
"234076","University of Virginia-Main Campus","2010","Total full-time Instruction/research/public service, Non-tenured not on tenure track, Instructors","65","38","27","3","1","2","16","7","9","1","0","1","3","3","0","0","0","0","29","17","12","1","1","0","0","0","0","12","9","3","-2"
"234076","University of Virginia-Main Campus","2010","Total full-time Instruction/research/public service, Non-tenured not on tenure track, Lecturers","87","40","47","0","0","0","7","0","7","3","1","2","2","1","1","0","0","0","66","35","31","0","0","0","0","0","0","9","3","6","-2"
"234076","University of Virginia-Main Campus","2010","Total full-time Instruction/research/public service, Non-tenured not on tenure track total","719","403","316","4","2","2","70","38","32","24","10","14","13","10","3","1","1","0","565","315","250","2","1","1","2","1","1","38","25","13","-2"
"236939","Washington State University","2010","Total full-time Instruction/research/public service, Tenured, Professors","395","298","97","1","1","0","39","35","4","1","1","0","13","9","4","4","3","1","309","229","80","5","2","3","22","18","4","1","0","1","-2"
"236939","Washington State University","2010","Total full-time Instruction/research/public service, Tenured, Associate professors","334","197","137","1","0","1","21","16","5","4","2","2","9","4","5","1","0","1","235","132","103","5","2","3","58","41","17","0","0","0","-2"
"236939","Washington State University","2010","Total full-time Instruction/research/public service, Tenured, Assistant professors","1","1","0","0","0","0","0","0","0","0","0","0","0","0","0","0","0","0","1","1","0","0","0","0","0","0","0","0","0","0","-2"
"236939","Washington State University","2010","Total full-time Instruction/research/public service, Tenured total","730","496","234","2","1","1","60","51","9","5","3","2","22","13","9","5","3","2","545","362","183","10","4","6","80","59","21","1","0","1","-2"
"236939","Washington State University","2010","Total full-time Instruction/research/public service, Non-tenured on tenure track, Associate professors","11","6","5","0","0","0","2","1","1","0","0","0","0","0","0","0","0","0","3","1","2","0","0","0","4","3","1","2","1","1","-2"
"236939","Washington State University","2010","Total full-time Instruction/research/public service, Non-tenured on tenure track, Assistant professors","267","160","107","0","0","0","24","15","9","3","2","1","5","3","2","0","0","0","111","59","52","3","2","1","86","51","35","35","28","7","-2"
"236939","Washington State University","2010","Total full-time Instruction/research/public service, Non-tenured on tenure track total","278","166","112","0","0","0","26","16","10","3","2","1","5","3","2","0","0","0","114","60","54","3","2","1","90","54","36","37","29","8","-2"
"236939","Washington State University","2010","Total full-time Instruction/research/public service, Non-tenured not on tenure track, Professors","9","5","4","0","0","0","1","1","0","0","0","0","0","0","0","0","0","0","6","2","4","0","0","0","2","2","0","0","0","0","-2"
"236939","Washington State University","2010","Total full-time Instruction/research/public service, Non-tenured not on tenure track, Associate professors","10","7","3","0","0","0","0","0","0","0","0","0","0","0","0","0","0","0","9","7","2","0","0","0","1","0","1","0","0","0","-2"
"236939","Washington State University","2010","Total full-time Instruction/research/public servicey, Non-tenured not on tenure track, Assistant professors","24","13","11","1","0","1","1","1","0","0","0","0","2","2","0","0","0","0","13","6","7","0","0","0","5","3","2","2","1","1","-2"
"236939","Washington State University","2010","Total full-time Instruction/research/public service, Non-tenured not on tenure track, Instructors","143","61","82","0","0","0","3","1","2","0","0","0","4","2","2","0","0","0","98","42","56","0","0","0","31","11","20","7","5","2","-2"
"236939","Washington State University","2010","Total full-time Instruction/research/public service, Non-tenured not on tenure track, Lecturers","7","2","5","0","0","0","1","0","1","0","0","0","0","0","0","0","0","0","5","1","4","0","0","0","1","1","0","0","0","0","-2"
"236939","Washington State University","2010","Total full-time Instruction/research/public service, Non-tenured not on tenure track, No academic rank","475","286","189","0","0","0","22","12","10","2","2","0","11","9","2","0","0","0","196","100","96","2","0","2","74","50","24","168","113","55","-2"
"236939","Washington State University","2010","Total full-time Instruction/research/public service, Non-tenured not on tenure track total","668","374","294","1","0","1","28","15","13","2","2","0","17","13","4","0","0","0","327","158","169","2","0","2","114","67","47","177","119","58","-2"
"236948","University of Washington-Seattle Campus","2010","Total full-time Instruction/research/public service, Tenured, Professors","716","547","169","0","0","0","59","48","11","15","12","3","16","15","1","0","0","0","592","447","145","4","2","2","30","23","7","0","0","0","-2"
"236948","University of Washington-Seattle Campus","2010","Total full-time Instruction/research/public service, Tenured, Associate professors","377","207","170","3","1","2","38","18","20","11","3","8","20","14","6","0","0","0","272","154","118","5","1","4","28","16","12","0","0","0","-2"
"236948","University of Washington-Seattle Campus","2010","Total full-time Instruction/research/public service, Tenured total","1093","754","339","3","1","2","97","66","31","26","15","11","36","29","7","0","0","0","864","601","263","9","3","6","58","39","19","0","0","0","-2"
"236948","University of Washington-Seattle Campus","2010","Total full-time Instruction/research/public service, Non-tenured on tenure track, Associate professors","2","1","1","0","0","0","0","0","0","0","0","0","0","0","0","0","0","0","2","1","1","0","0","0","0","0","0","0","0","0","-2"
"236948","University of Washington-Seattle Campus","2010","Total full-time Instruction/research/public service, Non-tenured on tenure track, Assistant professors","288","157","131","2","0","2","39","19","20","10","3","7","18","13","5","0","0","0","146","79","67","7","2","5","40","25","15","26","16","10","-2"
"236948","University of Washington-Seattle Campus","2010","Total full-time Instruction/research/public service, Non-tenured on tenure track total","290","158","132","2","0","2","39","19","20","10","3","7","18","13","5","0","0","0","148","80","68","7","2","5","40","25","15","26","16","10","-2"
"236948","University of Washington-Seattle Campus","2010","Total full-time Instruction/research/public service, Non-tenured not on tenure track, Professors","532","389","143","1","1","0","36","28","8","2","2","0","8","6","2","0","0","0","445","322","123","3","3","0","31","22","9","6","5","1","-2"
"236948","University of Washington-Seattle Campus","2010","Total full-time Instruction/research/public service, Non-tenured not on tenure track, Associate professors","438","271","167","0","0","0","51","35","16","2","1","1","17","10","7","0","0","0","326","196","130","7","5","2","29","19","10","6","5","1","-2"
"236948","University of Washington-Seattle Campus","2010","Total full-time Instruction/research/public servicey, Non-tenured not on tenure track, Assistant professors","549","309","240","2","2","0","110","67","43","10","6","4","20","11","9","0","0","0","319","176","143","4","1","3","53","24","29","31","22","9","-2"
"236948","University of Washington-Seattle Campus","2010","Total full-time Instruction/research/public service, Non-tenured not on tenure track, Instructors","207","106","101","0","0","0","21","13","8","4","3","1","10","6","4","0","0","0","86","39","47","2","0","2","53","24","29","31","21","10","-2"
"236948","University of Washington-Seattle Campus","2010","Total full-time Instruction/research/public service, Non-tenured not on tenure track, Lecturers","281","121","160","2","0","2","30","14","16","5","2","3","12","4","8","0","0","0","194","86","108","3","0","3","26","8","18","9","7","2","-2"
"236948","University of Washington-Seattle Campus","2010","Total full-time Instruction/research/public service, Non-tenured not on tenure track, No academic rank","118","39","79","1","0","1","5","1","4","6","1","5","2","2","0","0","0","0","75","24","51","3","1","2","25","9","16","1","1","0","-2"
"236948","University of Washington-Seattle Campus","2010","Total full-time Instruction/research/public service, Non-tenured not on tenure track total","2125","1235","890","6","3","3","253","158","95","29","15","14","69","39","30","0","0","0","1445","843","602","22","10","12","217","106","111","84","61","23","-2"
"237525","Marshall University","2010","Total full-time Instruction/research/public service, Tenured, Professors","238","160","78","1","0","1","11","9","2","7","7","0","7","3","4","0","0","0","209","141","68","0","0","0","0","0","0","3","0","3","-2"
"237525","Marshall University","2010","Total full-time Instruction/research/public service, Tenured, Associate professors","119","79","40","1","0","1","8","7","1","2","1","1","1","1","0","0","0","0","102","67","35","0","0","0","0","0","0","5","3","2","-2"
"237525","Marshall University","2010","Total full-time Instruction/research/public service, Tenured, Assistant professors","10","2","8","0","0","0","0","0","0","0","0","0","0","0","0","0","0","0","10","2","8","0","0","0","0","0","0","0","0","0","-2"
"237525","Marshall University","2010","Total full-time Instruction/research/public service, Tenured total","367","241","126","2","0","2","19","16","3","9","8","1","8","4","4","0","0","0","321","210","111","0","0","0","0","0","0","8","3","5","-2"
"237525","Marshall University","2010","Total full-time Instruction/research/public service, Non-tenured on tenure track, Professors","7","7","0","0","0","0","1","1","0","0","0","0","0","0","0","0","0","0","6","6","0","0","0","0","0","0","0","0","0","0","-2"
"237525","Marshall University","2010","Total full-time Instruction/research/public service, Non-tenured on tenure track, Associate professors","42","22","20","0","0","0","6","4","2","1","0","1","1","0","1","0","0","0","33","18","15","0","0","0","0","0","0","1","0","1","-2"
"237525","Marshall University","2010","Total full-time Instruction/research/public service, Non-tenured on tenure track, Assistant professors","152","90","62","0","0","0","14","7","7","9","6","3","3","2","1","0","0","0","118","70","48","0","0","0","0","0","0","8","5","3","-2"
"237525","Marshall University","2010","Total full-time Instruction/research/public service, Non-tenured on tenure track, Instructors","1","1","0","0","0","0","0","0","0","0","0","0","0","0","0","0","0","0","1","1","0","0","0","0","0","0","0","0","0","0","-2"
"237525","Marshall University","2010","Total full-time Instruction/research/public service, Non-tenured on tenure track total","202","120","82","0","0","0","21","12","9","10","6","4","4","2","2","0","0","0","158","95","63","0","0","0","0","0","0","9","5","4","-2"
"237525","Marshall University","2010","Total full-time Instruction/research/public service, Non-tenured not on tenure track, Professors","2","2","0","0","0","0","0","0","0","0","0","0","0","0","0","0","0","0","2","2","0","0","0","0","0","0","0","0","0","0","-2"
"237525","Marshall University","2010","Total full-time Instruction/research/public service, Non-tenured not on tenure track, Associate professors","11","10","1","0","0","0","1","1","0","0","0","0","0","0","0","0","0","0","10","9","1","0","0","0","0","0","0","0","0","0","-2"
"237525","Marshall University","2010","Total full-time Instruction/research/public servicey, Non-tenured not on tenure track, Assistant professors","60","35","25","0","0","0","6","5","1","0","0","0","2","2","0","0","0","0","52","28","24","0","0","0","0","0","0","0","0","0","-2"
"237525","Marshall University","2010","Total full-time Instruction/research/public service, Non-tenured not on tenure track, Instructors","55","21","34","0","0","0","3","1","2","0","0","0","1","1","0","0","0","0","51","19","32","0","0","0","0","0","0","0","0","0","-2"
"237525","Marshall University","2010","Total full-time Instruction/research/public service, Non-tenured not on tenure track total","128","68","60","0","0","0","10","7","3","0","0","0","3","3","0","0","0","0","115","58","57","0","0","0","0","0","0","0","0","0","-2"
"240444","University of Wisconsin-Madison","2010","Total full-time Instruction/research/public service, Tenured, Professors","1141","854","287","1","0","1","103","85","18","19","10","9","31","20","11","0","0","0","967","724","243","5","3","2","14","11","3","1","1","0","-2"
"240444","University of Wisconsin-Madison","2010","Total full-time Instruction/research/public service, Tenured, Associate professors","403","257","146","5","2","3","49","27","22","8","6","2","16","9","7","0","0","0","309","198","111","2","2","0","10","10","0","4","3","1","-2"
"240444","University of Wisconsin-Madison","2010","Total full-time Instruction/research/public service, Tenured total","1544","1111","433","6","2","4","152","112","40","27","16","11","47","29","18","0","0","0","1276","922","354","7","5","2","24","21","3","5","4","1","-2"
"240444","University of Wisconsin-Madison","2010","Total full-time Instruction/research/public service, Non-tenured on tenure track, Assistant professors","408","234","174","3","1","2","48","28","20","16","6","10","20","10","10","0","0","0","262","145","117","4","3","1","17","16","1","38","25","13","-2"
"240444","University of Wisconsin-Madison","2010","Total full-time Instruction/research/public service, Non-tenured on tenure track, Instructors","1","0","1","0","0","0","0","0","0","0","0","0","0","0","0","0","0","0","0","0","0","0","0","0","0","0","0","1","0","1","-2"
"240444","University of Wisconsin-Madison","2010","Total full-time Instruction/research/public service, Non-tenured on tenure track total","409","234","175","3","1","2","48","28","20","16","6","10","20","10","10","0","0","0","262","145","117","4","3","1","17","16","1","39","25","14","-2"
"240444","University of Wisconsin-Madison","2010","Total full-time Instruction/research/public service, Non-tenured not on tenure track, Professors","294","190","104","0","0","0","11","6","5","2","2","0","8","4","4","0","0","0","263","169","94","0","0","0","5","4","1","5","5","0","-2"
"240444","University of Wisconsin-Madison","2010","Total full-time Instruction/research/public service, Non-tenured not on tenure track, Associate professors","315","189","126","0","0","0","18","9","9","5","4","1","5","2","3","0","0","0","279","170","109","1","0","1","4","2","2","3","2","1","-2"
"240444","University of Wisconsin-Madison","2010","Total full-time Instruction/research/public servicey, Non-tenured not on tenure track, Assistant professors","429","256","173","1","0","1","41","26","15","6","4","2","6","4","2","0","0","0","330","196","134","1","0","1","24","13","11","20","13","7","-2"
"240444","University of Wisconsin-Madison","2010","Total full-time Instruction/research/public service, Non-tenured not on tenure track, Instructors","88","50","38","0","0","0","12","8","4","1","0","1","1","1","0","0","0","0","54","28","26","0","0","0","10","6","4","10","7","3","-2"
"240444","University of Wisconsin-Madison","2010","Total full-time Instruction/research/public service, Non-tenured not on tenure track, Lecturers","77","38","39","0","0","0","4","3","1","4","3","1","2","0","2","0","0","0","65","31","34","0","0","0","1","0","1","1","1","0","-2"
"240444","University of Wisconsin-Madison","2010","Total full-time Instruction/research/public service, Non-tenured not on tenure track, No academic rank","7","4","3","0","0","0","0","0","0","1","1","0","2","2","0","0","0","0","4","1","3","0","0","0","0","0","0","0","0","0","-2"
"240444","University of Wisconsin-Madison","2010","Total full-time Instruction/research/public service, Non-tenured not on tenure track total","1210","727","483","1","0","1","86","52","34","19","14","5","24","13","11","0","0","0","995","595","400","2","0","2","44","25","19","39","28","11","-2"
"240453","University of Wisconsin-Milwaukee","2010","Total full-time Instruction/research/public service, Tenured, Professors","241","168","73","4","2","2","28","25","3","11","9","2","6","4","2","0","0","0","190","127","63","2","1","1","0","0","0","0","0","0","-2"
"240453","University of Wisconsin-Milwaukee","2010","Total full-time Instruction/research/public service, Tenured, Associate professors","328","203","125","3","2","1","45","32","13","19","11","8","15","12","3","0","0","0","246","146","100","0","0","0","0","0","0","0","0","0","-2"
"240453","University of Wisconsin-Milwaukee","2010","Total full-time Instruction/research/public service, Tenured, Assistant professors","3","2","1","0","0","0","1","0","1","0","0","0","0","0","0","0","0","0","2","2","0","0","0","0","0","0","0","0","0","0","-2"
"240453","University of Wisconsin-Milwaukee","2010","Total full-time Instruction/research/public service, Tenured total","572","373","199","7","4","3","74","57","17","30","20","10","21","16","5","0","0","0","438","275","163","2","1","1","0","0","0","0","0","0","-2"
"240453","University of Wisconsin-Milwaukee","2010","Total full-time Instruction/research/public service, Non-tenured on tenure track, Professors","2","2","0","0","0","0","0","0","0","0","0","0","0","0","0","0","0","0","2","2","0","0","0","0","0","0","0","0","0","0","-2"
"240453","University of Wisconsin-Milwaukee","2010","Total full-time Instruction/research/public service, Non-tenured on tenure track, Associate professors","3","1","2","0","0","0","1","0","1","0","0","0","0","0","0","0","0","0","2","1","1","0","0","0","0","0","0","0","0","0","-2"
"240453","University of Wisconsin-Milwaukee","2010","Total full-time Instruction/research/public service, Non-tenured on tenure track, Assistant professors","225","113","112","1","1","0","31","18","13","17","8","9","17","4","13","0","0","0","121","57","64","3","2","1","0","0","0","35","23","12","-2"
"240453","University of Wisconsin-Milwaukee","2010","Total full-time Instruction/research/public service, Non-tenured on tenure track, Instructors","1","1","0","0","0","0","0","0","0","0","0","0","0","0","0","0","0","0","1","1","0","0","0","0","0","0","0","0","0","0","-2"
"240453","University of Wisconsin-Milwaukee","2010","Total full-time Instruction/research/public service, Non-tenured on tenure track total","231","117","114","1","1","0","32","18","14","17","8","9","17","4","13","0","0","0","126","61","65","3","2","1","0","0","0","35","23","12","-2"
"240453","University of Wisconsin-Milwaukee","2010","Total full-time Instruction/research/public service, Non-tenured not on tenure track, Professors","21","11","10","0","0","0","1","1","0","0","0","0","0","0","0","0","0","0","18","9","9","0","0","0","0","0","0","2","1","1","-2"
"240453","University of Wisconsin-Milwaukee","2010","Total full-time Instruction/research/public service, Non-tenured not on tenure track, Associate professors","15","2","13","0","0","0","0","0","0","0","0","0","0","0","0","0","0","0","15","2","13","0","0","0","0","0","0","0","0","0","-2"
"240453","University of Wisconsin-Milwaukee","2010","Total full-time Instruction/research/public servicey, Non-tenured not on tenure track, Assistant professors","45","14","31","0","0","0","1","1","0","3","1","2","3","1","2","0","0","0","38","11","27","0","0","0","0","0","0","0","0","0","-2"
"240453","University of Wisconsin-Milwaukee","2010","Total full-time Instruction/research/public service, Non-tenured not on tenure track, Instructors","9","1","8","0","0","0","0","0","0","1","0","1","0","0","0","0","0","0","7","0","7","0","0","0","0","0","0","1","1","0","-2"
"240453","University of Wisconsin-Milwaukee","2010","Total full-time Instruction/research/public service, Non-tenured not on tenure track, Lecturers","210","98","112","0","0","0","5","0","5","6","4","2","4","0","4","0","0","0","187","91","96","0","0","0","0","0","0","8","3","5","-2"
"240453","University of Wisconsin-Milwaukee","2010","Total full-time Instruction/research/public service, Non-tenured not on tenure track total","300","126","174","0","0","0","7","2","5","10","5","5","7","1","6","0","0","0","265","113","152","0","0","0","0","0","0","11","5","6","-2"
"243665","University of the Virgin Islands","2010","Total full-time Instruction/research/public service, Tenured, Professors","25","15","10","0","0","0","0","0","0","14","6","8","0","0","0","1","1","0","9","7","2","0","0","0","1","1","0","0","0","0","-2"
"243665","University of the Virgin Islands","2010","Total full-time Instruction/research/public service, Tenured, Associate professors","26","19","7","0","0","0","1","1","0","12","8","4","0","0","0","0","0","0","13","10","3","0","0","0","0","0","0","0","0","0","-2"
"243665","University of the Virgin Islands","2010","Total full-time Instruction/research/public service, Tenured, Assistant professors","10","5","5","0","0","0","0","0","0","3","3","0","1","0","1","0","0","0","6","2","4","0","0","0","0","0","0","0","0","0","-2"
"243665","University of the Virgin Islands","2010","Total full-time Instruction/research/public service, Tenured total","61","39","22","0","0","0","1","1","0","29","17","12","1","0","1","1","1","0","28","19","9","0","0","0","1","1","0","0","0","0","-2"
"243665","University of the Virgin Islands","2010","Total full-time Instruction/research/public service, Non-tenured on tenure track, Professors","1","1","0","0","0","0","0","0","0","0","0","0","0","0","0","0","0","0","1","1","0","0","0","0","0","0","0","0","0","0","-2"
"243665","University of the Virgin Islands","2010","Total full-time Instruction/research/public service, Non-tenured on tenure track, Associate professors","13","5","8","0","0","0","0","0","0","9","5","4","0","0","0","0","0","0","4","0","4","0","0","0","0","0","0","0","0","0","-2"
"243665","University of the Virgin Islands","2010","Total full-time Instruction/research/public service, Non-tenured on tenure track, Assistant professors","9","2","7","0","0","0","0","0","0","6","1","5","0","0","0","0","0","0","3","1","2","0","0","0","0","0","0","0","0","0","-2"
"243665","University of the Virgin Islands","2010","Total full-time Instruction/research/public service, Non-tenured on tenure track, Lecturers","1","0","1","0","0","0","0","0","0","1","0","1","0","0","0","0","0","0","0","0","0","0","0","0","0","0","0","0","0","0","-2"
"243665","University of the Virgin Islands","2010","Total full-time Instruction/research/public service, Non-tenured on tenure track total","24","8","16","0","0","0","0","0","0","16","6","10","0","0","0","0","0","0","8","2","6","0","0","0","0","0","0","0","0","0","-2"
"243665","University of the Virgin Islands","2010","Total full-time Instruction/research/public service, Non-tenured not on tenure track, Associate professors","9","3","6","0","0","0","0","0","0","3","0","3","0","0","0","0","0","0","6","3","3","0","0","0","0","0","0","0","0","0","-2"
"243665","University of the Virgin Islands","2010","Total full-time Instruction/research/public servicey, Non-tenured not on tenure track, Assistant professors","32","15","17","0","0","0","2","2","0","6","4","2","6","3","3","0","0","0","18","6","12","0","0","0","0","0","0","0","0","0","-2"
"243665","University of the Virgin Islands","2010","Total full-time Instruction/research/public service, Non-tenured not on tenure track, Instructors","3","2","1","0","0","0","0","0","0","1","1","0","0","0","0","0","0","0","2","1","1","0","0","0","0","0","0","0","0","0","-2"
"243665","University of the Virgin Islands","2010","Total full-time Instruction/research/public service, Non-tenured not on tenure track, Lecturers","1","1","0","0","0","0","0","0","0","1","1","0","0","0","0","0","0","0","0","0","0","0","0","0","0","0","0","0","0","0","-2"
"243665","University of the Virgin Islands","2010","Total full-time Instruction/research/public service, Non-tenured not on tenure track total","45","21","24","0","0","0","2","2","0","11","6","5","6","3","3","0","0","0","26","10","16","0","0","0","0","0","0","0","0","0","-2"
"243780","Purdue University-Main Campus","2010","Total full-time Instruction/research/public service, Tenured, Professors","797","664","133","1","1","0","132","119","13","12","11","1","10","8","2","0","0","0","641","525","116","1","0","1","0","0","0","0","0","0","-2"
"243780","Purdue University-Main Campus","2010","Total full-time Instruction/research/public service, Tenured, Associate professors","546","376","170","0","0","0","73","50","23","16","11","5","22","15","7","1","1","0","427","294","133","4","2","2","0","0","0","3","3","0","-2"
"243780","Purdue University-Main Campus","2010","Total full-time Instruction/research/public service, Tenured, Assistant professors","9","6","3","0","0","0","0","0","0","1","0","1","0","0","0","0","0","0","8","6","2","0","0","0","0","0","0","0","0","0","-2"
"243780","Purdue University-Main Campus","2010","Total full-time Instruction/research/public service, Tenured total","1352","1046","306","1","1","0","205","169","36","29","22","7","32","23","9","1","1","0","1076","825","251","5","2","3","0","0","0","3","3","0","-2"
"243780","Purdue University-Main Campus","2010","Total full-time Instruction/research/public service, Non-tenured on tenure track, Professors","1","1","0","0","0","0","1","1","0","0","0","0","0","0","0","0","0","0","0","0","0","0","0","0","0","0","0","0","0","0","-2"
"243780","Purdue University-Main Campus","2010","Total full-time Instruction/research/public service, Non-tenured on tenure track, Associate professors","7","6","1","0","0","0","2","2","0","0","0","0","0","0","0","0","0","0","2","1","1","0","0","0","0","0","0","3","3","0","-2"
"243780","Purdue University-Main Campus","2010","Total full-time Instruction/research/public service, Non-tenured on tenure track, Assistant professors","415","241","174","1","1","0","73","53","20","18","7","11","19","10","9","0","0","0","244","138","106","3","1","2","0","0","0","57","31","26","-2"
"243780","Purdue University-Main Campus","2010","Total full-time Instruction/research/public service, Non-tenured on tenure track, Instructors","1","1","0","0","0","0","1","1","0","0","0","0","0","0","0","0","0","0","0","0","0","0","0","0","0","0","0","0","0","0","-2"
"243780","Purdue University-Main Campus","2010","Total full-time Instruction/research/public service, Non-tenured on tenure track total","424","249","175","1","1","0","77","57","20","18","7","11","19","10","9","0","0","0","246","139","107","3","1","2","0","0","0","60","34","26","-2"
"243780","Purdue University-Main Campus","2010","Total full-time Instruction/research/public service, Non-tenured not on tenure track, Professors","10","6","4","0","0","0","0","0","0","0","0","0","0","0","0","0","0","0","9","5","4","0","0","0","0","0","0","1","1","0","-2"
"243780","Purdue University-Main Campus","2010","Total full-time Instruction/research/public service, Non-tenured not on tenure track, Associate professors","30","13","17","0","0","0","5","2","3","0","0","0","0","0","0","0","0","0","25","11","14","0","0","0","0","0","0","0","0","0","-2"
"243780","Purdue University-Main Campus","2010","Total full-time Instruction/research/public servicey, Non-tenured not on tenure track, Assistant professors","124","66","58","0","0","0","14","9","5","4","1","3","3","2","1","0","0","0","74","34","40","1","0","1","0","0","0","28","20","8","-2"
"243780","Purdue University-Main Campus","2010","Total full-time Instruction/research/public service, Non-tenured not on tenure track, Instructors","7","3","4","0","0","0","0","0","0","1","1","0","0","0","0","0","0","0","6","2","4","0","0","0","0","0","0","0","0","0","-2"
"243780","Purdue University-Main Campus","2010","Total full-time Instruction/research/public service, Non-tenured not on tenure track, Lecturers","110","47","63","0","0","0","7","2","5","2","1","1","4","1","3","0","0","0","90","41","49","0","0","0","1","1","0","6","1","5","-2"
"243780","Purdue University-Main Campus","2010","Total full-time Instruction/research/public service, Non-tenured not on tenure track, No academic rank","357","251","106","0","0","0","26","14","12","3","1","2","2","1","1","0","0","0","68","42","26","1","0","1","0","0","0","257","193","64","-2"
"243780","Purdue University-Main Campus","2010","Total full-time Instruction/research/public service, Non-tenured not on tenure track total","638","386","252","0","0","0","52","27","25","10","4","6","9","4","5","0","0","0","272","135","137","2","0","2","1","1","0","292","215","77","-2"
"409698","California State University-Monterey Bay","2010","Total full-time Instruction/research/public service, Tenured, Professors","44","29","15","1","1","0","12","7","5","2","1","1","9","6","3","0","0","0","20","14","6","0","0","0","0","0","0","0","0","0","-2"
"409698","California State University-Monterey Bay","2010","Total full-time Instruction/research/public service, Tenured, Associate professors","28","13","15","0","0","0","3","1","2","3","2","1","5","2","3","0","0","0","15","6","9","0","0","0","2","2","0","0","0","0","-2"
"409698","California State University-Monterey Bay","2010","Total full-time Instruction/research/public service, Tenured, No academic rank","2","1","1","0","0","0","0","0","0","0","0","0","0","0","0","0","0","0","2","1","1","0","0","0","0","0","0","0","0","0","-2"
"409698","California State University-Monterey Bay","2010","Total full-time Instruction/research/public service, Tenured total","74","43","31","1","1","0","15","8","7","5","3","2","14","8","6","0","0","0","37","21","16","0","0","0","2","2","0","0","0","0","-2"
"409698","California State University-Monterey Bay","2010","Total full-time Instruction/research/public service, Non-tenured on tenure track, Associate professors","3","1","2","0","0","0","0","0","0","1","1","0","0","0","0","1","0","1","1","0","1","0","0","0","0","0","0","0","0","0","-2"
"409698","California State University-Monterey Bay","2010","Total full-time Instruction/research/public service, Non-tenured on tenure track, Assistant professors","35","16","19","0","0","0","6","1","5","2","2","0","8","4","4","0","0","0","14","6","8","0","0","0","5","3","2","0","0","0","-2"
"409698","California State University-Monterey Bay","2010","Total full-time Instruction/research/public service, Non-tenured on tenure track, No academic rank","1","1","0","0","0","0","0","0","0","0","0","0","0","0","0","0","0","0","1","1","0","0","0","0","0","0","0","0","0","0","-2"
"409698","California State University-Monterey Bay","2010","Total full-time Instruction/research/public service, Non-tenured on tenure track total","39","18","21","0","0","0","6","1","5","3","3","0","8","4","4","1","0","1","16","7","9","0","0","0","5","3","2","0","0","0","-2"
"409698","California State University-Monterey Bay","2010","Total full-time Instruction/research/public service, Non-tenured not on tenure track, Lecturers","45","16","29","0","0","0","5","3","2","2","0","2","6","1","5","0","0","0","30","11","19","0","0","0","2","1","1","0","0","0","-2"
"409698","California State University-Monterey Bay","2010","Total full-time Instruction/research/public service, Non-tenured not on tenure track total","45","16","29","0","0","0","5","3","2","2","0","2","6","1","5","0","0","0","30","11","19","0","0","0","2","1","1","0","0","0","-2"
"445188","University of California-Merced","2010","Total full-time Instruction/research/public service, Tenured, Professors","29","23","6","0","0","0","1","1","0","0","0","0","4","4","0","0","0","0","24","18","6","0","0","0","0","0","0","0","0","0","-2"
"445188","University of California-Merced","2010","Total full-time Instruction/research/public service, Tenured, Associate professors","23","16","7","1","0","1","2","2","0","0","0","0","4","3","1","0","0","0","16","11","5","0","0","0","0","0","0","0","0","0","-2"
"445188","University of California-Merced","2010","Total full-time Instruction/research/public service, Tenured, Lecturers","1","0","1","0","0","0","0","0","0","0","0","0","1","0","1","0","0","0","0","0","0","0","0","0","0","0","0","0","0","0","-2"
"445188","University of California-Merced","2010","Total full-time Instruction/research/public service, Tenured total","53","39","14","1","0","1","3","3","0","0","0","0","9","7","2","0","0","0","40","29","11","0","0","0","0","0","0","0","0","0","-2"
"445188","University of California-Merced","2010","Total full-time Instruction/research/public service, Non-tenured on tenure track, Assistant professors","71","45","26","1","0","1","20","14","6","2","2","0","7","6","1","0","0","0","39","22","17","0","0","0","2","1","1","0","0","0","-2"
"445188","University of California-Merced","2010","Total full-time Instruction/research/public service, Non-tenured on tenure track, Lecturers","1","0","1","0","0","0","1","0","1","0","0","0","0","0","0","0","0","0","0","0","0","0","0","0","0","0","0","0","0","0","-2"
"445188","University of California-Merced","2010","Total full-time Instruction/research/public service, Non-tenured on tenure track total","72","45","27","1","0","1","21","14","7","2","2","0","7","6","1","0","0","0","39","22","17","0","0","0","2","1","1","0","0","0","-2"
"445188","University of California-Merced","2010","Total full-time Instruction/research/public servicey, Non-tenured not on tenure track, Assistant professors","2","2","0","0","0","0","0","0","0","0","0","0","1","1","0","0","0","0","1","1","0","0","0","0","0","0","0","0","0","0","-2"
"445188","University of California-Merced","2010","Total full-time Instruction/research/public service, Non-tenured not on tenure track, Lecturers","78","39","39","1","1","0","4","2","2","1","1","0","7","5","2","0","0","0","56","24","32","0","0","0","9","6","3","0","0","0","-2"
"445188","University of California-Merced","2010","Total full-time Instruction/research/public service, Non-tenured not on tenure track total","80","41","39","1","1","0","4","2","2","1","1","0","8","6","2","0","0","0","57","25","32","0","0","0","9","6","3","0","0","0","-2"
