"unitid","institution name","year","S2012_IS.Instructional staff category","S2012_IS_RV.Grand total","S2012_IS_RV.Grand total men","S2012_IS_RV.Grand total women","S2012_IS_RV.American Indian or Alaska Native total","S2012_IS_RV.American Indian or Alaska Native men","S2012_IS_RV.American Indian or Alaska Native women","S2012_IS_RV.Asian total","S2012_IS_RV.Asian men","S2012_IS_RV.Asian women","S2012_IS_RV.Black or African American total","S2012_IS_RV.Black or African American men","S2012_IS_RV.Black or African American women","S2012_IS_RV.Hispanic or Latino total","S2012_IS_RV.Hispanic or Latino men","S2012_IS_RV.Hispanic or Latino women","S2012_IS_RV.Native Hawaiian or Other Pacific Islander total","S2012_IS_RV.Native Hawaiian or Other Pacific Islander men","S2012_IS_RV.Native Hawaiian or Other Pacific Islander women","S2012_IS_RV.White total","S2012_IS_RV.White men","S2012_IS_RV.White women","S2012_IS_RV.Two or more races total","S2012_IS_RV.Two or more races men","S2012_IS_RV.Two or more races women","S2012_IS_RV.Race/ethnicity unknown total","S2012_IS_RV.Race/ethnicity unknown men","S2012_IS_RV.Race/ethnicity unknown women","S2012_IS_RV.Nonresident alien total","S2012_IS_RV.Nonresident alien men","S2012_IS_RV.Nonresident alien women","IDX_HR"
"100706","University of Alabama in Huntsville","2012","Tenured total","156","121","35","0","0","0","32","31","1","6","4","2","4","3","1","0","0","0","114","83","31","0","0","0","0","0","0","0","0","0","-2"
"100706","University of Alabama in Huntsville","2012","Tenured, professors","77","65","12","0","0","0","13","13","0","1","1","0","2","2","0","0","0","0","61","49","12","0","0","0","0","0","0","0","0","0","-2"
"100706","University of Alabama in Huntsville","2012","Tenured, associate professors","78","56","22","0","0","0","19","18","1","5","3","2","1","1","0","0","0","0","53","34","19","0","0","0","0","0","0","0","0","0","-2"
"100706","University of Alabama in Huntsville","2012","Tenured, assistant professors","1","0","1","0","0","0","0","0","0","0","0","0","1","0","1","0","0","0","0","0","0","0","0","0","0","0","0","0","0","0","-2"
"100706","University of Alabama in Huntsville","2012","On-Tenure track total","67","52","15","0","0","0","10","9","1","4","1","3","2","2","0","0","0","0","47","36","11","0","0","0","0","0","0","4","4","0","-2"
"100706","University of Alabama in Huntsville","2012","On-tenure track, professors","1","1","0","0","0","0","0","0","0","0","0","0","0","0","0","0","0","0","1","1","0","0","0","0","0","0","0","0","0","0","-2"
"100706","University of Alabama in Huntsville","2012","On-tenure track, associate professors","8","5","3","0","0","0","0","0","0","1","0","1","0","0","0","0","0","0","7","5","2","0","0","0","0","0","0","0","0","0","-2"
"100706","University of Alabama in Huntsville","2012","On-tenure track, assistant professors","58","46","12","0","0","0","10","9","1","3","1","2","2","2","0","0","0","0","39","30","9","0","0","0","0","0","0","4","4","0","-2"
"100706","University of Alabama in Huntsville","2012","Not on tenure track/No tenure system system total","91","19","72","0","0","0","3","1","2","5","1","4","2","0","2","0","0","0","80","17","63","0","0","0","0","0","0","1","0","1","-2"
"100706","University of Alabama in Huntsville","2012","Not on tenure/no tenure system, professors","2","2","0","0","0","0","0","0","0","0","0","0","0","0","0","0","0","0","2","2","0","0","0","0","0","0","0","0","0","0","-2"
"100706","University of Alabama in Huntsville","2012","Not on tenure/no tenure system, associate professors","9","3","6","0","0","0","0","0","0","0","0","0","1","0","1","0","0","0","8","3","5","0","0","0","0","0","0","0","0","0","-2"
"100706","University of Alabama in Huntsville","2012","Not on tenure/no tenure system, assistant professors","25","2","23","0","0","0","0","0","0","1","0","1","0","0","0","0","0","0","23","2","21","0","0","0","0","0","0","1","0","1","-2"
"100706","University of Alabama in Huntsville","2012","Not on tenure/no tenure system, instructors","14","1","13","0","0","0","0","0","0","2","0","2","0","0","0","0","0","0","12","1","11","0","0","0","0","0","0","0","0","0","-2"
"100706","University of Alabama in Huntsville","2012","Not on tenure/no tenure system, lecturers","41","11","30","0","0","0","3","1","2","2","1","1","1","0","1","0","0","0","35","9","26","0","0","0","0","0","0","0","0","0","-2"
"100751","The University of Alabama","2012","Tenured total","595","403","192","0","0","0","45","38","7","35","13","22","11","7","4","0","0","0","497","343","154","1","0","1","0","0","0","6","2","4","-2"
"100751","The University of Alabama","2012","Tenured, professors","322","244","78","0","0","0","27","24","3","11","6","5","5","4","1","0","0","0","277","210","67","1","0","1","0","0","0","1","0","1","-2"
"100751","The University of Alabama","2012","Tenured, associate professors","265","156","109","0","0","0","18","14","4","24","7","17","6","3","3","0","0","0","212","130","82","0","0","0","0","0","0","5","2","3","-2"
"100751","The University of Alabama","2012","Tenured, assistant professors","8","3","5","0","0","0","0","0","0","0","0","0","0","0","0","0","0","0","8","3","5","0","0","0","0","0","0","0","0","0","-2"
"100751","The University of Alabama","2012","On-Tenure track total","270","142","128","0","0","0","24","13","11","14","3","11","10","5","5","0","0","0","193","104","89","1","0","1","0","0","0","28","17","11","-2"
"100751","The University of Alabama","2012","On-tenure track, professors","1","0","1","0","0","0","0","0","0","0","0","0","0","0","0","0","0","0","1","0","1","0","0","0","0","0","0","0","0","0","-2"
"100751","The University of Alabama","2012","On-tenure track, associate professors","18","7","11","0","0","0","1","0","1","1","0","1","0","0","0","0","0","0","16","7","9","0","0","0","0","0","0","0","0","0","-2"
"100751","The University of Alabama","2012","On-tenure track, assistant professors","251","135","116","0","0","0","23","13","10","13","3","10","10","5","5","0","0","0","176","97","79","1","0","1","0","0","0","28","17","11","-2"
"100751","The University of Alabama","2012","Not on tenure track/No tenure system system total","374","152","222","1","0","1","9","3","6","19","7","12","7","5","2","1","1","0","329","133","196","1","0","1","0","0","0","7","3","4","-2"
"100751","The University of Alabama","2012","Not on tenure/no tenure system, professors","15","11","4","0","0","0","0","0","0","1","1","0","0","0","0","0","0","0","13","9","4","0","0","0","0","0","0","1","1","0","-2"
"100751","The University of Alabama","2012","Not on tenure/no tenure system, associate professors","26","11","15","0","0","0","1","0","1","3","0","3","0","0","0","0","0","0","22","11","11","0","0","0","0","0","0","0","0","0","-2"
"100751","The University of Alabama","2012","Not on tenure/no tenure system, assistant professors","68","17","51","1","0","1","3","1","2","4","1","3","0","0","0","1","1","0","59","14","45","0","0","0","0","0","0","0","0","0","-2"
"100751","The University of Alabama","2012","Not on tenure/no tenure system, instructors","253","104","149","0","0","0","5","2","3","10","4","6","7","5","2","0","0","0","224","91","133","1","0","1","0","0","0","6","2","4","-2"
"100751","The University of Alabama","2012","Not on tenure/no tenure system, lecturers","12","9","3","0","0","0","0","0","0","1","1","0","0","0","0","0","0","0","11","8","3","0","0","0","0","0","0","0","0","0","-2"
"101675","Miles College","2012","Tenured total","5","4","1","0","0","0","3","2","1","2","2","0","0","0","0","0","0","0","0","0","0","0","0","0","0","0","0","0","0","0","-2"
"101675","Miles College","2012","Tenured, professors","5","4","1","0","0","0","3","2","1","2","2","0","0","0","0","0","0","0","0","0","0","0","0","0","0","0","0","0","0","0","-2"
"101675","Miles College","2012","On-Tenure track total","95","37","58","0","0","0","6","3","3","70","23","47","1","0","1","0","0","0","16","9","7","0","0","0","2","2","0","0","0","0","-2"
"101675","Miles College","2012","On-tenure track, professors","4","3","1","0","0","0","2","2","0","2","1","1","0","0","0","0","0","0","0","0","0","0","0","0","0","0","0","0","0","0","-2"
"101675","Miles College","2012","On-tenure track, associate professors","10","7","3","0","0","0","1","1","0","5","3","2","0","0","0","0","0","0","4","3","1","0","0","0","0","0","0","0","0","0","-2"
"101675","Miles College","2012","On-tenure track, assistant professors","24","6","18","0","0","0","2","0","2","15","1","14","0","0","0","0","0","0","5","3","2","0","0","0","2","2","0","0","0","0","-2"
"101675","Miles College","2012","On-tenure track, instructors","57","21","36","0","0","0","1","0","1","48","18","30","1","0","1","0","0","0","7","3","4","0","0","0","0","0","0","0","0","0","-2"
"102094","University of South Alabama","2012","Tenured total","297","216","81","0","0","0","19","16","3","7","5","2","2","2","0","0","0","0","269","193","76","0","0","0","0","0","0","0","0","0","-2"
"102094","University of South Alabama","2012","Tenured, professors","162","129","33","0","0","0","9","8","1","2","2","0","0","0","0","0","0","0","151","119","32","0","0","0","0","0","0","0","0","0","-2"
"102094","University of South Alabama","2012","Tenured, associate professors","127","84","43","0","0","0","9","8","1","4","2","2","2","2","0","0","0","0","112","72","40","0","0","0","0","0","0","0","0","0","-2"
"102094","University of South Alabama","2012","Tenured, assistant professors","8","3","5","0","0","0","1","0","1","1","1","0","0","0","0","0","0","0","6","2","4","0","0","0","0","0","0","0","0","0","-2"
"102094","University of South Alabama","2012","On-Tenure track total","122","62","60","2","0","2","18","14","4","8","2","6","1","1","0","0","0","0","91","45","46","2","0","2","0","0","0","0","0","0","-2"
"102094","University of South Alabama","2012","On-tenure track, professors","5","4","1","0","0","0","1","1","0","1","1","0","0","0","0","0","0","0","3","2","1","0","0","0","0","0","0","0","0","0","-2"
"102094","University of South Alabama","2012","On-tenure track, associate professors","7","3","4","0","0","0","0","0","0","0","0","0","0","0","0","0","0","0","7","3","4","0","0","0","0","0","0","0","0","0","-2"
"102094","University of South Alabama","2012","On-tenure track, assistant professors","110","55","55","2","0","2","17","13","4","7","1","6","1","1","0","0","0","0","81","40","41","2","0","2","0","0","0","0","0","0","-2"
"102094","University of South Alabama","2012","Not on tenure track/No tenure system system total","321","151","170","1","1","0","29","21","8","18","1","17","8","5","3","0","0","0","264","123","141","0","0","0","1","0","1","0","0","0","-2"
"102094","University of South Alabama","2012","Not on tenure/no tenure system, professors","34","24","10","0","0","0","2","2","0","2","0","2","3","2","1","0","0","0","27","20","7","0","0","0","0","0","0","0","0","0","-2"
"102094","University of South Alabama","2012","Not on tenure/no tenure system, associate professors","43","32","11","0","0","0","5","5","0","1","0","1","0","0","0","0","0","0","37","27","10","0","0","0","0","0","0","0","0","0","-2"
"102094","University of South Alabama","2012","Not on tenure/no tenure system, assistant professors","115","52","63","1","1","0","17","12","5","7","1","6","3","2","1","0","0","0","86","36","50","0","0","0","1","0","1","0","0","0","-2"
"102094","University of South Alabama","2012","Not on tenure/no tenure system, instructors","127","41","86","0","0","0","5","2","3","8","0","8","2","1","1","0","0","0","112","38","74","0","0","0","0","0","0","0","0","0","-2"
"102094","University of South Alabama","2012","Not on tenure/no tenure system, lecturers","2","2","0","0","0","0","0","0","0","0","0","0","0","0","0","0","0","0","2","2","0","0","0","0","0","0","0","0","0","0","-2"
"102614","University of Alaska Fairbanks","2012","Tenured total","195","135","60","2","1","1","26","20","6","1","0","1","3","3","0","0","0","0","157","107","50","3","2","1","3","2","1","0","0","0","-2"
"102614","University of Alaska Fairbanks","2012","Tenured, professors","86","74","12","0","0","0","14","13","1","0","0","0","2","2","0","0","0","0","66","56","10","2","1","1","2","2","0","0","0","0","-2"
"102614","University of Alaska Fairbanks","2012","Tenured, associate professors","109","61","48","2","1","1","12","7","5","1","0","1","1","1","0","0","0","0","91","51","40","1","1","0","1","0","1","0","0","0","-2"
"102614","University of Alaska Fairbanks","2012","On-Tenure track total","97","53","44","6","3","3","4","3","1","0","0","0","3","0","3","0","0","0","75","41","34","1","1","0","3","1","2","5","4","1","-2"
"102614","University of Alaska Fairbanks","2012","On-tenure track, associate professors","3","3","0","0","0","0","0","0","0","0","0","0","0","0","0","0","0","0","2","2","0","0","0","0","0","0","0","1","1","0","-2"
"102614","University of Alaska Fairbanks","2012","On-tenure track, assistant professors","94","50","44","6","3","3","4","3","1","0","0","0","3","0","3","0","0","0","73","39","34","1","1","0","3","1","2","4","3","1","-2"
"102614","University of Alaska Fairbanks","2012","Not on tenure track/No tenure system system total","114","46","68","12","3","9","1","0","1","2","0","2","3","1","2","1","0","1","84","37","47","2","0","2","9","5","4","0","0","0","-2"
"102614","University of Alaska Fairbanks","2012","Not on tenure/no tenure system, professors","1","1","0","0","0","0","0","0","0","0","0","0","0","0","0","0","0","0","1","1","0","0","0","0","0","0","0","0","0","0","-2"
"102614","University of Alaska Fairbanks","2012","Not on tenure/no tenure system, associate professors","4","2","2","0","0","0","0","0","0","0","0","0","0","0","0","0","0","0","4","2","2","0","0","0","0","0","0","0","0","0","-2"
"102614","University of Alaska Fairbanks","2012","Not on tenure/no tenure system, assistant professors","68","28","40","6","2","4","0","0","0","0","0","0","1","1","0","1","0","1","53","22","31","1","0","1","6","3","3","0","0","0","-2"
"102614","University of Alaska Fairbanks","2012","Not on tenure/no tenure system, instructors","40","14","26","6","1","5","1","0","1","2","0","2","2","0","2","0","0","0","25","11","14","1","0","1","3","2","1","0","0","0","-2"
"102614","University of Alaska Fairbanks","2012","Not on tenure/no tenure system, no academic rank","1","1","0","0","0","0","0","0","0","0","0","0","0","0","0","0","0","0","1","1","0","0","0","0","0","0","0","0","0","0","-2"
"104151","Arizona State University-Tempe","2012","Tenured total","1223","821","402","13","7","6","125","91","34","31","19","12","88","58","30","0","0","0","928","619","309","7","3","4","6","3","3","25","21","4","-2"
"104151","Arizona State University-Tempe","2012","Tenured, professors","665","498","167","7","5","2","57","48","9","12","9","3","43","34","9","0","0","0","529","389","140","4","2","2","4","2","2","9","9","0","-2"
"104151","Arizona State University-Tempe","2012","Tenured, associate professors","556","323","233","6","2","4","68","43","25","19","10","9","45","24","21","0","0","0","397","230","167","3","1","2","2","1","1","16","12","4","-2"
"104151","Arizona State University-Tempe","2012","Tenured, assistant professors","2","0","2","0","0","0","0","0","0","0","0","0","0","0","0","0","0","0","2","0","2","0","0","0","0","0","0","0","0","0","-2"
"104151","Arizona State University-Tempe","2012","On-Tenure track total","413","222","191","4","2","2","49","28","21","6","2","4","49","26","23","0","0","0","237","125","112","2","0","2","12","7","5","54","32","22","-2"
"104151","Arizona State University-Tempe","2012","On-tenure track, associate professors","20","11","9","0","0","0","4","3","1","1","0","1","1","1","0","0","0","0","11","5","6","0","0","0","0","0","0","3","2","1","-2"
"104151","Arizona State University-Tempe","2012","On-tenure track, assistant professors","393","211","182","4","2","2","45","25","20","5","2","3","48","25","23","0","0","0","226","120","106","2","0","2","12","7","5","51","30","21","-2"
"104151","Arizona State University-Tempe","2012","Not on tenure track/No tenure system system total","774","310","464","3","1","2","32","8","24","20","4","16","42","20","22","2","0","2","635","254","381","6","2","4","5","3","2","29","18","11","-2"
"104151","Arizona State University-Tempe","2012","Not on tenure/no tenure system, professors","50","36","14","0","0","0","0","0","0","3","0","3","1","1","0","0","0","0","42","31","11","1","1","0","1","1","0","2","2","0","-2"
"104151","Arizona State University-Tempe","2012","Not on tenure/no tenure system, associate professors","66","18","48","0","0","0","3","1","2","4","1","3","7","3","4","0","0","0","49","12","37","2","1","1","0","0","0","1","0","1","-2"
"104151","Arizona State University-Tempe","2012","Not on tenure/no tenure system, assistant professors","90","35","55","1","1","0","2","0","2","2","0","2","6","4","2","0","0","0","70","24","46","0","0","0","1","0","1","8","6","2","-2"
"104151","Arizona State University-Tempe","2012","Not on tenure/no tenure system, instructors","163","56","107","1","0","1","2","0","2","7","3","4","8","2","6","0","0","0","139","48","91","0","0","0","2","1","1","4","2","2","-2"
"104151","Arizona State University-Tempe","2012","Not on tenure/no tenure system, lecturers","370","153","217","1","0","1","23","7","16","3","0","3","19","10","9","2","0","2","305","127","178","3","0","3","1","1","0","13","8","5","-2"
"104151","Arizona State University-Tempe","2012","Not on tenure/no tenure system, no academic rank","35","12","23","0","0","0","2","0","2","1","0","1","1","0","1","0","0","0","30","12","18","0","0","0","0","0","0","1","0","1","-2"
"104179","University of Arizona","2012","Tenured total","1123","786","337","7","3","4","95","65","30","13","8","5","75","45","30","0","0","0","875","622","253","2","1","1","53","40","13","3","2","1","-2"
"104179","University of Arizona","2012","Tenured, professors","716","541","175","4","3","1","53","39","14","8","5","3","40","33","7","0","0","0","591","443","148","1","0","1","18","17","1","1","1","0","-2"
"104179","University of Arizona","2012","Tenured, associate professors","407","245","162","3","0","3","42","26","16","5","3","2","35","12","23","0","0","0","284","179","105","1","1","0","35","23","12","2","1","1","-2"
"104179","University of Arizona","2012","On-Tenure track total","332","195","137","4","1","3","55","38","17","5","3","2","26","12","14","0","0","0","174","99","75","1","1","0","39","21","18","28","20","8","-2"
"104179","University of Arizona","2012","On-tenure track, professors","6","6","0","0","0","0","1","1","0","0","0","0","0","0","0","0","0","0","5","5","0","0","0","0","0","0","0","0","0","0","-2"
"104179","University of Arizona","2012","On-tenure track, associate professors","38","29","9","0","0","0","7","7","0","0","0","0","2","2","0","0","0","0","23","16","7","0","0","0","2","0","2","4","4","0","-2"
"104179","University of Arizona","2012","On-tenure track, assistant professors","288","160","128","4","1","3","47","30","17","5","3","2","24","10","14","0","0","0","146","78","68","1","1","0","37","21","16","24","16","8","-2"
"104179","University of Arizona","2012","Not on tenure track/No tenure system system total","311","158","153","2","2","0","12","4","8","5","3","2","27","11","16","0","0","0","233","119","114","3","1","2","17","12","5","12","6","6","-2"
"104179","University of Arizona","2012","Not on tenure/no tenure system, professors","27","17","10","0","0","0","1","1","0","0","0","0","0","0","0","0","0","0","24","15","9","0","0","0","1","0","1","1","1","0","-2"
"104179","University of Arizona","2012","Not on tenure/no tenure system, associate professors","22","7","15","0","0","0","0","0","0","0","0","0","1","1","0","0","0","0","20","5","15","0","0","0","1","1","0","0","0","0","-2"
"104179","University of Arizona","2012","Not on tenure/no tenure system, assistant professors","68","34","34","0","0","0","4","1","3","1","0","1","3","1","2","0","0","0","50","23","27","0","0","0","8","7","1","2","2","0","-2"
"104179","University of Arizona","2012","Not on tenure/no tenure system, instructors","50","28","22","2","2","0","2","0","2","0","0","0","10","6","4","0","0","0","29","17","12","0","0","0","1","1","0","6","2","4","-2"
"104179","University of Arizona","2012","Not on tenure/no tenure system, lecturers","138","71","67","0","0","0","4","1","3","4","3","1","13","3","10","0","0","0","107","59","48","3","1","2","6","3","3","1","1","0","-2"
"104179","University of Arizona","2012","Not on tenure/no tenure system, no academic rank","6","1","5","0","0","0","1","1","0","0","0","0","0","0","0","0","0","0","3","0","3","0","0","0","0","0","0","2","0","2","-2"
"104586","Embry-Riddle Aeronautical University-Prescott","2012","Tenured total","22","18","4","0","0","0","4","2","2","0","0","0","1","1","0","0","0","0","17","15","2","0","0","0","0","0","0","0","0","0","-2"
"104586","Embry-Riddle Aeronautical University-Prescott","2012","Tenured, professors","9","8","1","0","0","0","0","0","0","0","0","0","0","0","0","0","0","0","9","8","1","0","0","0","0","0","0","0","0","0","-2"
"104586","Embry-Riddle Aeronautical University-Prescott","2012","Tenured, associate professors","13","10","3","0","0","0","4","2","2","0","0","0","1","1","0","0","0","0","8","7","1","0","0","0","0","0","0","0","0","0","-2"
"104586","Embry-Riddle Aeronautical University-Prescott","2012","On-Tenure track total","30","25","5","1","1","0","1","0","1","0","0","0","1","1","0","0","0","0","25","21","4","0","0","0","2","2","0","0","0","0","-2"
"104586","Embry-Riddle Aeronautical University-Prescott","2012","On-tenure track, associate professors","11","9","2","0","0","0","0","0","0","0","0","0","0","0","0","0","0","0","10","8","2","0","0","0","1","1","0","0","0","0","-2"
"104586","Embry-Riddle Aeronautical University-Prescott","2012","On-tenure track, assistant professors","19","16","3","1","1","0","1","0","1","0","0","0","1","1","0","0","0","0","15","13","2","0","0","0","1","1","0","0","0","0","-2"
"104586","Embry-Riddle Aeronautical University-Prescott","2012","Not on tenure track/No tenure system system total","24","19","5","0","0","0","1","0","1","0","0","0","0","0","0","0","0","0","20","17","3","1","0","1","2","2","0","0","0","0","-2"
"104586","Embry-Riddle Aeronautical University-Prescott","2012","Not on tenure/no tenure system, professors","1","1","0","0","0","0","0","0","0","0","0","0","0","0","0","0","0","0","0","0","0","0","0","0","1","1","0","0","0","0","-2"
"104586","Embry-Riddle Aeronautical University-Prescott","2012","Not on tenure/no tenure system, associate professors","4","3","1","0","0","0","0","0","0","0","0","0","0","0","0","0","0","0","3","3","0","1","0","1","0","0","0","0","0","0","-2"
"104586","Embry-Riddle Aeronautical University-Prescott","2012","Not on tenure/no tenure system, assistant professors","16","14","2","0","0","0","0","0","0","0","0","0","0","0","0","0","0","0","15","13","2","0","0","0","1","1","0","0","0","0","-2"
"104586","Embry-Riddle Aeronautical University-Prescott","2012","Not on tenure/no tenure system, instructors","3","1","2","0","0","0","1","0","1","0","0","0","0","0","0","0","0","0","2","1","1","0","0","0","0","0","0","0","0","0","-2"
"105330","Northern Arizona University","2012","Tenured total","428","260","168","12","4","8","9","6","3","6","5","1","22","9","13","1","1","0","355","222","133","1","1","0","8","5","3","14","7","7","-2"
"105330","Northern Arizona University","2012","Tenured, professors","258","163","95","6","2","4","5","2","3","2","2","0","11","5","6","0","0","0","222","146","76","1","1","0","6","4","2","5","1","4","-2"
"105330","Northern Arizona University","2012","Tenured, associate professors","170","97","73","6","2","4","4","4","0","4","3","1","11","4","7","1","1","0","133","76","57","0","0","0","2","1","1","9","6","3","-2"
"105330","Northern Arizona University","2012","On-Tenure track total","85","40","45","4","0","4","3","1","2","2","1","1","3","2","1","1","1","0","60","28","32","1","1","0","7","4","3","4","2","2","-2"
"105330","Northern Arizona University","2012","On-tenure track, associate professors","3","0","3","0","0","0","0","0","0","0","0","0","0","0","0","0","0","0","3","0","3","0","0","0","0","0","0","0","0","0","-2"
"105330","Northern Arizona University","2012","On-tenure track, assistant professors","82","40","42","4","0","4","3","1","2","2","1","1","3","2","1","1","1","0","57","28","29","1","1","0","7","4","3","4","2","2","-2"
"105330","Northern Arizona University","2012","Not on tenure track/No tenure system system total","372","153","219","5","1","4","6","3","3","5","0","5","22","7","15","1","0","1","301","129","172","3","0","3","15","8","7","14","5","9","-2"
"105330","Northern Arizona University","2012","Not on tenure/no tenure system, professors","5","3","2","0","0","0","0","0","0","0","0","0","0","0","0","0","0","0","5","3","2","0","0","0","0","0","0","0","0","0","-2"
"105330","Northern Arizona University","2012","Not on tenure/no tenure system, associate professors","32","8","24","0","0","0","0","0","0","0","0","0","4","1","3","0","0","0","26","7","19","1","0","1","1","0","1","0","0","0","-2"
"105330","Northern Arizona University","2012","Not on tenure/no tenure system, assistant professors","93","31","62","1","0","1","1","0","1","1","0","1","6","1","5","1","0","1","81","30","51","0","0","0","2","0","2","0","0","0","-2"
"105330","Northern Arizona University","2012","Not on tenure/no tenure system, instructors","83","41","42","2","1","1","2","1","1","3","0","3","4","1","3","0","0","0","63","34","29","1","0","1","4","2","2","4","2","2","-2"
"105330","Northern Arizona University","2012","Not on tenure/no tenure system, lecturers","159","70","89","2","0","2","3","2","1","1","0","1","8","4","4","0","0","0","126","55","71","1","0","1","8","6","2","10","3","7","-2"
"110404","California Institute of Technology","2012","Tenured total","237","200","37","0","0","0","23","21","2","3","2","1","4","4","0","0","0","0","206","172","34","0","0","0","0","0","0","1","1","0","-2"
"110404","California Institute of Technology","2012","Tenured, professors","237","200","37","0","0","0","23","21","2","3","2","1","4","4","0","0","0","0","206","172","34","0","0","0","0","0","0","1","1","0","-2"
"110404","California Institute of Technology","2012","On-Tenure track total","50","36","14","0","0","0","9","6","3","3","3","0","3","3","0","0","0","0","27","16","11","0","0","0","0","0","0","8","8","0","-2"
"110404","California Institute of Technology","2012","On-tenure track, associate professors","4","4","0","0","0","0","0","0","0","0","0","0","2","2","0","0","0","0","1","1","0","0","0","0","0","0","0","1","1","0","-2"
"110404","California Institute of Technology","2012","On-tenure track, assistant professors","46","32","14","0","0","0","9","6","3","3","3","0","1","1","0","0","0","0","26","15","11","0","0","0","0","0","0","7","7","0","-2"
"110404","California Institute of Technology","2012","Not on tenure track/No tenure system system total","35","24","11","0","0","0","3","1","2","0","0","0","3","2","1","0","0","0","19","13","6","0","0","0","0","0","0","10","8","2","-2"
"110404","California Institute of Technology","2012","Not on tenure/no tenure system, instructors","14","12","2","0","0","0","0","0","0","0","0","0","0","0","0","0","0","0","5","4","1","0","0","0","0","0","0","9","8","1","-2"
"110404","California Institute of Technology","2012","Not on tenure/no tenure system, lecturers","15","8","7","0","0","0","3","1","2","0","0","0","2","1","1","0","0","0","9","6","3","0","0","0","0","0","0","1","0","1","-2"
"110404","California Institute of Technology","2012","Not on tenure/no tenure system, no academic rank","6","4","2","0","0","0","0","0","0","0","0","0","1","1","0","0","0","0","5","3","2","0","0","0","0","0","0","0","0","0","-2"
"110538","California State University-Chico","2012","Tenured total","339","206","133","2","2","0","30","18","12","4","2","2","15","9","6","0","0","0","280","171","109","2","2","0","5","2","3","1","0","1","-2"
"110538","California State University-Chico","2012","Tenured, professors","231","146","85","2","2","0","21","15","6","3","2","1","10","6","4","0","0","0","194","121","73","0","0","0","1","0","1","0","0","0","-2"
"110538","California State University-Chico","2012","Tenured, associate professors","103","58","45","0","0","0","9","3","6","1","0","1","5","3","2","0","0","0","81","48","33","2","2","0","4","2","2","1","0","1","-2"
"110538","California State University-Chico","2012","Tenured, assistant professors","3","2","1","0","0","0","0","0","0","0","0","0","0","0","0","0","0","0","3","2","1","0","0","0","0","0","0","0","0","0","-2"
"110538","California State University-Chico","2012","Tenured, no academic rank","2","0","2","0","0","0","0","0","0","0","0","0","0","0","0","0","0","0","2","0","2","0","0","0","0","0","0","0","0","0","-2"
"110538","California State University-Chico","2012","On-Tenure track total","78","40","38","0","0","0","10","8","2","1","0","1","2","2","0","0","0","0","57","26","31","0","0","0","4","2","2","4","2","2","-2"
"110538","California State University-Chico","2012","On-tenure track, professors","1","0","1","0","0","0","0","0","0","1","0","1","0","0","0","0","0","0","0","0","0","0","0","0","0","0","0","0","0","0","-2"
"110538","California State University-Chico","2012","On-tenure track, associate professors","4","4","0","0","0","0","1","1","0","0","0","0","0","0","0","0","0","0","2","2","0","0","0","0","0","0","0","1","1","0","-2"
"110538","California State University-Chico","2012","On-tenure track, assistant professors","73","36","37","0","0","0","9","7","2","0","0","0","2","2","0","0","0","0","55","24","31","0","0","0","4","2","2","3","1","2","-2"
"110538","California State University-Chico","2012","Not on tenure track/No tenure system system total","64","35","29","0","0","0","3","1","2","0","0","0","1","0","1","0","0","0","55","31","24","1","1","0","3","2","1","1","0","1","-2"
"110538","California State University-Chico","2012","Not on tenure/no tenure system, lecturers","64","35","29","0","0","0","3","1","2","0","0","0","1","0","1","0","0","0","55","31","24","1","1","0","3","2","1","1","0","1","-2"
"110635","University of California-Berkeley","2012","Tenured total","1158","827","331","0","0","0","139","95","44","34","23","11","60","44","16","0","0","0","884","639","245","2","0","2","29","21","8","10","5","5","-2"
"110635","University of California-Berkeley","2012","Tenured, professors","840","640","200","0","0","0","93","68","25","17","15","2","39","30","9","0","0","0","675","517","158","0","0","0","13","10","3","3","0","3","-2"
"110635","University of California-Berkeley","2012","Tenured, associate professors","299","176","123","0","0","0","44","26","18","17","8","9","20","13","7","0","0","0","193","113","80","2","0","2","16","11","5","7","5","2","-2"
"110635","University of California-Berkeley","2012","Tenured, lecturers","19","11","8","0","0","0","2","1","1","0","0","0","1","1","0","0","0","0","16","9","7","0","0","0","0","0","0","0","0","0","-2"
"110635","University of California-Berkeley","2012","On-Tenure track total","204","124","80","1","0","1","23","9","14","5","1","4","14","6","8","0","0","0","90","59","31","1","0","1","38","28","10","32","21","11","-2"
"110635","University of California-Berkeley","2012","On-tenure track, professors","12","7","5","0","0","0","2","1","1","0","0","0","0","0","0","0","0","0","3","2","1","0","0","0","5","2","3","2","2","0","-2"
"110635","University of California-Berkeley","2012","On-tenure track, associate professors","2","1","1","0","0","0","0","0","0","0","0","0","1","0","1","0","0","0","0","0","0","0","0","0","1","1","0","0","0","0","-2"
"110635","University of California-Berkeley","2012","On-tenure track, assistant professors","188","114","74","1","0","1","21","8","13","5","1","4","13","6","7","0","0","0","85","55","30","1","0","1","32","25","7","30","19","11","-2"
"110635","University of California-Berkeley","2012","On-tenure track, lecturers","2","2","0","0","0","0","0","0","0","0","0","0","0","0","0","0","0","0","2","2","0","0","0","0","0","0","0","0","0","0","-2"
"110635","University of California-Berkeley","2012","Not on tenure track/No tenure system system total","244","100","144","1","1","0","41","14","27","7","3","4","7","2","5","1","1","0","144","64","80","2","1","1","18","7","11","23","7","16","-2"
"110635","University of California-Berkeley","2012","Not on tenure/no tenure system, professors","36","18","18","0","0","0","0","0","0","0","0","0","0","0","0","0","0","0","29","15","14","0","0","0","2","2","0","5","1","4","-2"
"110635","University of California-Berkeley","2012","Not on tenure/no tenure system, associate professors","18","6","12","0","0","0","7","4","3","1","0","1","2","1","1","0","0","0","7","1","6","0","0","0","1","0","1","0","0","0","-2"
"110635","University of California-Berkeley","2012","Not on tenure/no tenure system, assistant professors","37","20","17","0","0","0","5","1","4","0","0","0","1","0","1","1","1","0","18","12","6","0","0","0","6","2","4","6","4","2","-2"
"110635","University of California-Berkeley","2012","Not on tenure/no tenure system, instructors","5","1","4","1","1","0","2","0","2","1","0","1","0","0","0","0","0","0","0","0","0","0","0","0","0","0","0","1","0","1","-2"
"110635","University of California-Berkeley","2012","Not on tenure/no tenure system, lecturers","139","52","87","0","0","0","27","9","18","5","3","2","3","1","2","0","0","0","84","34","50","1","0","1","8","3","5","11","2","9","-2"
"110635","University of California-Berkeley","2012","Not on tenure/no tenure system, no academic rank","9","3","6","0","0","0","0","0","0","0","0","0","1","0","1","0","0","0","6","2","4","1","1","0","1","0","1","0","0","0","-2"
"110644","University of California-Davis","2012","Tenured total","1196","842","354","8","2","6","165","112","53","21","11","10","48","31","17","0","0","0","893","639","254","1","1","0","32","25","7","28","21","7","-2"
"110644","University of California-Davis","2012","Tenured, professors","904","677","227","3","1","2","115","90","25","13","8","5","33","22","11","0","0","0","707","531","176","1","1","0","14","10","4","18","14","4","-2"
"110644","University of California-Davis","2012","Tenured, associate professors","278","156","122","5","1","4","49","22","27","8","3","5","15","9","6","0","0","0","173","99","74","0","0","0","18","15","3","10","7","3","-2"
"110644","University of California-Davis","2012","Tenured, lecturers","14","9","5","0","0","0","1","0","1","0","0","0","0","0","0","0","0","0","13","9","4","0","0","0","0","0","0","0","0","0","-2"
"110644","University of California-Davis","2012","On-Tenure track total","177","102","75","0","0","0","27","10","17","5","2","3","11","6","5","0","0","0","92","55","37","1","0","1","16","12","4","25","17","8","-2"
"110644","University of California-Davis","2012","On-tenure track, professors","2","2","0","0","0","0","0","0","0","0","0","0","0","0","0","0","0","0","2","2","0","0","0","0","0","0","0","0","0","0","-2"
"110644","University of California-Davis","2012","On-tenure track, assistant professors","175","100","75","0","0","0","27","10","17","5","2","3","11","6","5","0","0","0","90","53","37","1","0","1","16","12","4","25","17","8","-2"
"110644","University of California-Davis","2012","Not on tenure track/No tenure system system total","711","432","279","2","0","2","165","97","68","11","6","5","29","20","9","0","0","0","441","270","171","2","1","1","27","15","12","34","23","11","-2"
"110644","University of California-Davis","2012","Not on tenure/no tenure system, professors","210","158","52","1","0","1","40","32","8","2","2","0","9","7","2","0","0","0","152","112","40","0","0","0","2","2","0","4","3","1","-2"
"110644","University of California-Davis","2012","Not on tenure/no tenure system, associate professors","156","98","58","1","0","1","50","32","18","3","1","2","6","6","0","0","0","0","83","51","32","0","0","0","11","7","4","2","1","1","-2"
"110644","University of California-Davis","2012","Not on tenure/no tenure system, assistant professors","242","125","117","0","0","0","71","31","40","5","2","3","9","5","4","0","0","0","121","63","58","2","1","1","10","5","5","24","18","6","-2"
"110644","University of California-Davis","2012","Not on tenure/no tenure system, lecturers","103","51","52","0","0","0","4","2","2","1","1","0","5","2","3","0","0","0","85","44","41","0","0","0","4","1","3","4","1","3","-2"
"110653","University of California-Irvine","2012","Tenured total","873","608","265","1","1","0","162","111","51","19","13","6","49","35","14","0","0","0","632","441","191","1","1","0","5","3","2","4","3","1","-2"
"110653","University of California-Irvine","2012","Tenured, professors","607","454","153","1","1","0","101","73","28","12","8","4","31","23","8","0","0","0","456","345","111","0","0","0","3","2","1","3","2","1","-2"
"110653","University of California-Irvine","2012","Tenured, associate professors","239","138","101","0","0","0","58","35","23","7","5","2","17","11","6","0","0","0","153","84","69","1","1","0","2","1","1","1","1","0","-2"
"110653","University of California-Irvine","2012","Tenured, lecturers","27","16","11","0","0","0","3","3","0","0","0","0","1","1","0","0","0","0","23","12","11","0","0","0","0","0","0","0","0","0","-2"
"110653","University of California-Irvine","2012","On-Tenure track total","211","118","93","2","1","1","39","22","17","4","1","3","12","4","8","1","1","0","121","70","51","1","0","1","3","1","2","28","18","10","-2"
"110653","University of California-Irvine","2012","On-tenure track, professors","4","4","0","0","0","0","2","2","0","1","1","0","0","0","0","0","0","0","0","0","0","0","0","0","1","1","0","0","0","0","-2"
"110653","University of California-Irvine","2012","On-tenure track, associate professors","2","1","1","0","0","0","0","0","0","0","0","0","0","0","0","0","0","0","0","0","0","0","0","0","0","0","0","2","1","1","-2"
"110653","University of California-Irvine","2012","On-tenure track, assistant professors","183","105","78","2","1","1","36","19","17","3","0","3","11","4","7","1","1","0","103","64","39","1","0","1","2","0","2","24","16","8","-2"
"110653","University of California-Irvine","2012","On-tenure track, lecturers","22","8","14","0","0","0","1","1","0","0","0","0","1","0","1","0","0","0","18","6","12","0","0","0","0","0","0","2","1","1","-2"
"110653","University of California-Irvine","2012","Not on tenure track/No tenure system system total","425","253","172","3","1","2","117","74","43","13","8","5","21","10","11","2","2","0","243","139","104","0","0","0","4","4","0","22","15","7","-2"
"110653","University of California-Irvine","2012","Not on tenure/no tenure system, professors","117","82","35","1","1","0","35","25","10","3","2","1","3","1","2","0","0","0","73","52","21","0","0","0","0","0","0","2","1","1","-2"
"110653","University of California-Irvine","2012","Not on tenure/no tenure system, associate professors","80","43","37","1","0","1","24","15","9","1","1","0","3","2","1","0","0","0","50","24","26","0","0","0","0","0","0","1","1","0","-2"
"110653","University of California-Irvine","2012","Not on tenure/no tenure system, assistant professors","129","82","47","1","0","1","41","26","15","7","4","3","6","5","1","1","1","0","57","35","22","0","0","0","2","2","0","14","9","5","-2"
"110653","University of California-Irvine","2012","Not on tenure/no tenure system, instructors","39","24","15","0","0","0","10","6","4","2","1","1","4","2","2","1","1","0","18","10","8","0","0","0","1","1","0","3","3","0","-2"
"110653","University of California-Irvine","2012","Not on tenure/no tenure system, lecturers","60","22","38","0","0","0","7","2","5","0","0","0","5","0","5","0","0","0","45","18","27","0","0","0","1","1","0","2","1","1","-2"
"110662","University of California-Los Angeles","2012","Tenured total","1458","1061","397","5","3","2","230","171","59","44","25","19","87","60","27","0","0","0","1082","794","288","1","0","1","1","1","0","8","7","1","-2"
"110662","University of California-Los Angeles","2012","Tenured, professors","1158","878","280","5","3","2","163","132","31","27","18","9","64","42","22","0","0","0","894","678","216","0","0","0","1","1","0","4","4","0","-2"
"110662","University of California-Los Angeles","2012","Tenured, associate professors","293","178","115","0","0","0","67","39","28","17","7","10","23","18","5","0","0","0","181","111","70","1","0","1","0","0","0","4","3","1","-2"
"110662","University of California-Los Angeles","2012","Tenured, lecturers","7","5","2","0","0","0","0","0","0","0","0","0","0","0","0","0","0","0","7","5","2","0","0","0","0","0","0","0","0","0","-2"
"110662","University of California-Los Angeles","2012","On-Tenure track total","225","129","96","2","0","2","44","23","21","10","4","6","16","11","5","0","0","0","129","73","56","0","0","0","2","1","1","22","17","5","-2"
"110662","University of California-Los Angeles","2012","On-tenure track, professors","9","4","5","0","0","0","2","1","1","0","0","0","0","0","0","0","0","0","6","3","3","0","0","0","1","0","1","0","0","0","-2"
"110662","University of California-Los Angeles","2012","On-tenure track, assistant professors","216","125","91","2","0","2","42","22","20","10","4","6","16","11","5","0","0","0","123","70","53","0","0","0","1","1","0","22","17","5","-2"
"110662","University of California-Los Angeles","2012","Not on tenure track/No tenure system system total","1351","804","547","1","1","0","361","194","167","24","11","13","51","29","22","0","0","0","805","499","306","0","0","0","38","22","16","71","48","23","-2"
"110662","University of California-Los Angeles","2012","Not on tenure/no tenure system, professors","315","226","89","0","0","0","61","43","18","4","2","2","10","6","4","0","0","0","234","169","65","0","0","0","2","2","0","4","4","0","-2"
"110662","University of California-Los Angeles","2012","Not on tenure/no tenure system, associate professors","227","141","86","0","0","0","65","41","24","4","2","2","5","1","4","0","0","0","144","90","54","0","0","0","5","5","0","4","2","2","-2"
"110662","University of California-Los Angeles","2012","Not on tenure/no tenure system, assistant professors","456","271","185","1","1","0","135","71","64","9","2","7","22","15","7","0","0","0","237","146","91","0","0","0","7","3","4","45","33","12","-2"
"110662","University of California-Los Angeles","2012","Not on tenure/no tenure system, instructors","202","102","100","0","0","0","74","32","42","5","3","2","10","5","5","0","0","0","90","49","41","0","0","0","15","9","6","8","4","4","-2"
"110662","University of California-Los Angeles","2012","Not on tenure/no tenure system, lecturers","144","61","83","0","0","0","25","6","19","1","1","0","4","2","2","0","0","0","97","45","52","0","0","0","7","2","5","10","5","5","-2"
"110662","University of California-Los Angeles","2012","Not on tenure/no tenure system, no academic rank","7","3","4","0","0","0","1","1","0","1","1","0","0","0","0","0","0","0","3","0","3","0","0","0","2","1","1","0","0","0","-2"
"110680","University of California-San Diego","2012","Tenured total","962","745","217","2","2","0","133","106","27","18","7","11","52","38","14","0","0","0","726","565","161","0","0","0","3","3","0","28","24","4","-2"
"110680","University of California-San Diego","2012","Tenured, professors","717","591","126","1","1","0","95","85","10","6","2","4","31","23","8","0","0","0","564","460","104","0","0","0","1","1","0","19","19","0","-2"
"110680","University of California-San Diego","2012","Tenured, associate professors","220","143","77","1","1","0","35","21","14","12","5","7","20","15","5","0","0","0","141","94","47","0","0","0","2","2","0","9","5","4","-2"
"110680","University of California-San Diego","2012","Tenured, lecturers","25","11","14","0","0","0","3","0","3","0","0","0","1","0","1","0","0","0","21","11","10","0","0","0","0","0","0","0","0","0","-2"
"110680","University of California-San Diego","2012","On-Tenure track total","177","120","57","0","0","0","30","19","11","6","4","2","14","10","4","0","0","0","102","68","34","0","0","0","2","2","0","23","17","6","-2"
"110680","University of California-San Diego","2012","On-tenure track, assistant professors","155","107","48","0","0","0","29","19","10","5","4","1","14","10","4","0","0","0","83","56","27","0","0","0","1","1","0","23","17","6","-2"
"110680","University of California-San Diego","2012","On-tenure track, lecturers","22","13","9","0","0","0","1","0","1","1","0","1","0","0","0","0","0","0","19","12","7","0","0","0","1","1","0","0","0","0","-2"
"110680","University of California-San Diego","2012","Not on tenure track/No tenure system system total","849","509","340","4","3","1","169","88","81","14","7","7","37","23","14","1","1","0","566","348","218","0","0","0","7","5","2","51","34","17","-2"
"110680","University of California-San Diego","2012","Not on tenure/no tenure system, professors","288","204","84","1","1","0","28","19","9","5","3","2","10","8","2","0","0","0","235","166","69","0","0","0","0","0","0","9","7","2","-2"
"110680","University of California-San Diego","2012","Not on tenure/no tenure system, associate professors","207","120","87","1","0","1","46","25","21","4","3","1","10","6","4","0","0","0","137","80","57","0","0","0","0","0","0","9","6","3","-2"
"110680","University of California-San Diego","2012","Not on tenure/no tenure system, assistant professors","273","153","120","2","2","0","77","40","37","3","1","2","14","9","5","1","1","0","150","82","68","0","0","0","5","4","1","21","14","7","-2"
"110680","University of California-San Diego","2012","Not on tenure/no tenure system, lecturers","80","32","48","0","0","0","18","4","14","2","0","2","3","0","3","0","0","0","43","20","23","0","0","0","2","1","1","12","7","5","-2"
"110680","University of California-San Diego","2012","Not on tenure/no tenure system, no academic rank","1","0","1","0","0","0","0","0","0","0","0","0","0","0","0","0","0","0","1","0","1","0","0","0","0","0","0","0","0","0","-2"
"115755","Humboldt State University","2012","Tenured total","180","110","70","4","3","1","8","7","1","3","2","1","5","3","2","0","0","0","156","94","62","0","0","0","3","1","2","1","0","1","-2"
"115755","Humboldt State University","2012","Tenured, professors","120","72","48","2","1","1","7","6","1","3","2","1","4","2","2","0","0","0","103","60","43","0","0","0","1","1","0","0","0","0","-2"
"115755","Humboldt State University","2012","Tenured, associate professors","59","37","22","2","2","0","1","1","0","0","0","0","1","1","0","0","0","0","52","33","19","0","0","0","2","0","2","1","0","1","-2"
"115755","Humboldt State University","2012","Tenured, assistant professors","1","1","0","0","0","0","0","0","0","0","0","0","0","0","0","0","0","0","1","1","0","0","0","0","0","0","0","0","0","0","-2"
"115755","Humboldt State University","2012","On-Tenure track total","31","18","13","1","0","1","4","3","1","1","0","1","1","0","1","0","0","0","20","12","8","0","0","0","3","2","1","1","1","0","-2"
"115755","Humboldt State University","2012","On-tenure track, associate professors","3","2","1","0","0","0","1","1","0","0","0","0","0","0","0","0","0","0","2","1","1","0","0","0","0","0","0","0","0","0","-2"
"115755","Humboldt State University","2012","On-tenure track, assistant professors","28","16","12","1","0","1","3","2","1","1","0","1","1","0","1","0","0","0","18","11","7","0","0","0","3","2","1","1","1","0","-2"
"115755","Humboldt State University","2012","Not on tenure track/No tenure system system total","54","28","26","2","1","1","1","1","0","0","0","0","3","3","0","1","0","1","41","20","21","1","0","1","5","3","2","0","0","0","-2"
"115755","Humboldt State University","2012","Not on tenure/no tenure system, lecturers","54","28","26","2","1","1","1","1","0","0","0","0","3","3","0","1","0","1","41","20","21","1","0","1","5","3","2","0","0","0","-2"
"122409","San Diego State University","2012","Tenured total","589","364","225","4","3","1","74","38","36","18","12","6","48","27","21","0","0","0","431","274","157","0","0","0","7","4","3","7","6","1","122409"
"122409","San Diego State University","2012","Tenured, professors","331","219","112","4","3","1","36","20","16","2","2","0","25","15","10","0","0","0","261","177","84","0","0","0","3","2","1","0","0","0","122409"
"122409","San Diego State University","2012","Tenured, associate professors","236","135","101","0","0","0","38","18","20","15","10","5","19","11","8","0","0","0","155","89","66","0","0","0","3","2","1","6","5","1","122409"
"122409","San Diego State University","2012","Tenured, assistant professors","10","4","6","0","0","0","0","0","0","1","0","1","2","0","2","0","0","0","6","4","2","0","0","0","1","0","1","0","0","0","122409"
"122409","San Diego State University","2012","Tenured, no academic rank","12","6","6","0","0","0","0","0","0","0","0","0","2","1","1","0","0","0","9","4","5","0","0","0","0","0","0","1","1","0","122409"
"122409","San Diego State University","2012","On-Tenure track total","93","48","45","1","1","0","7","5","2","5","2","3","6","4","2","0","0","0","46","25","21","1","0","1","10","4","6","17","7","10","122409"
"122409","San Diego State University","2012","On-tenure track, professors","2","2","0","0","0","0","0","0","0","0","0","0","0","0","0","0","0","0","2","2","0","0","0","0","0","0","0","0","0","0","122409"
"122409","San Diego State University","2012","On-tenure track, associate professors","2","2","0","0","0","0","0","0","0","0","0","0","0","0","0","0","0","0","1","1","0","0","0","0","1","1","0","0","0","0","122409"
"122409","San Diego State University","2012","On-tenure track, assistant professors","89","44","45","1","1","0","7","5","2","5","2","3","6","4","2","0","0","0","43","22","21","1","0","1","9","3","6","17","7","10","122409"
"122409","San Diego State University","2012","Not on tenure track/No tenure system system total","131","42","89","0","0","0","4","0","4","0","0","0","12","3","9","1","0","1","112","37","75","0","0","0","1","1","0","1","1","0","122409"
"122409","San Diego State University","2012","Not on tenure/no tenure system, lecturers","131","42","89","0","0","0","4","0","4","0","0","0","12","3","9","1","0","1","112","37","75","0","0","0","1","1","0","1","1","0","122409"
"122597","San Francisco State University","2012","Tenured total","509","281","228","6","3","3","107","55","52","27","13","14","43","22","21","0","0","0","296","170","126","9","5","4","21","13","8","0","0","0","-2"
"122597","San Francisco State University","2012","Tenured, professors","298","195","103","3","2","1","63","43","20","16","8","8","19","14","5","0","0","0","185","118","67","2","2","0","10","8","2","0","0","0","-2"
"122597","San Francisco State University","2012","Tenured, associate professors","200","82","118","3","1","2","43","12","31","10","4","6","23","8","15","0","0","0","104","49","55","7","3","4","10","5","5","0","0","0","-2"
"122597","San Francisco State University","2012","Tenured, assistant professors","7","3","4","0","0","0","1","0","1","1","1","0","1","0","1","0","0","0","3","2","1","0","0","0","1","0","1","0","0","0","-2"
"122597","San Francisco State University","2012","Tenured, no academic rank","4","1","3","0","0","0","0","0","0","0","0","0","0","0","0","0","0","0","4","1","3","0","0","0","0","0","0","0","0","0","-2"
"122597","San Francisco State University","2012","On-Tenure track total","186","85","101","3","2","1","46","18","28","6","4","2","11","6","5","0","0","0","98","47","51","1","0","1","16","6","10","5","2","3","-2"
"122597","San Francisco State University","2012","On-tenure track, professors","5","3","2","0","0","0","2","1","1","0","0","0","0","0","0","0","0","0","2","2","0","0","0","0","1","0","1","0","0","0","-2"
"122597","San Francisco State University","2012","On-tenure track, associate professors","19","7","12","0","0","0","3","1","2","0","0","0","2","2","0","0","0","0","12","4","8","0","0","0","1","0","1","1","0","1","-2"
"122597","San Francisco State University","2012","On-tenure track, assistant professors","162","75","87","3","2","1","41","16","25","6","4","2","9","4","5","0","0","0","84","41","43","1","0","1","14","6","8","4","2","2","-2"
"122597","San Francisco State University","2012","Not on tenure track/No tenure system system total","99","43","56","1","0","1","10","2","8","5","2","3","6","3","3","0","0","0","71","33","38","0","0","0","6","3","3","0","0","0","-2"
"122597","San Francisco State University","2012","Not on tenure/no tenure system, lecturers","99","43","56","1","0","1","10","2","8","5","2","3","6","3","3","0","0","0","71","33","38","0","0","0","6","3","3","0","0","0","-2"
"122755","San Jose State University","2012","Tenured total","476","280","196","4","2","2","102","67","35","15","9","6","31","20","11","0","0","0","294","169","125","4","1","3","24","11","13","2","1","1","-2"
"122755","San Jose State University","2012","Tenured, professors","323","203","120","3","2","1","68","47","21","8","4","4","20","13","7","0","0","0","215","134","81","1","0","1","8","3","5","0","0","0","-2"
"122755","San Jose State University","2012","Tenured, associate professors","140","71","69","1","0","1","32","18","14","7","5","2","8","5","3","0","0","0","73","34","39","3","1","2","15","7","8","1","1","0","-2"
"122755","San Jose State University","2012","Tenured, assistant professors","12","6","6","0","0","0","2","2","0","0","0","0","3","2","1","0","0","0","5","1","4","0","0","0","1","1","0","1","0","1","-2"
"122755","San Jose State University","2012","Tenured, no academic rank","1","0","1","0","0","0","0","0","0","0","0","0","0","0","0","0","0","0","1","0","1","0","0","0","0","0","0","0","0","0","-2"
"122755","San Jose State University","2012","On-Tenure track total","144","55","89","1","1","0","28","6","22","2","0","2","5","2","3","0","0","0","82","34","48","1","0","1","13","7","6","12","5","7","-2"
"122755","San Jose State University","2012","On-tenure track, associate professors","23","8","15","0","0","0","2","0","2","0","0","0","0","0","0","0","0","0","16","5","11","1","0","1","3","2","1","1","1","0","-2"
"122755","San Jose State University","2012","On-tenure track, assistant professors","120","46","74","1","1","0","26","6","20","2","0","2","5","2","3","0","0","0","65","28","37","0","0","0","10","5","5","11","4","7","-2"
"122755","San Jose State University","2012","On-tenure track, no academic rank","1","1","0","0","0","0","0","0","0","0","0","0","0","0","0","0","0","0","1","1","0","0","0","0","0","0","0","0","0","0","-2"
"122755","San Jose State University","2012","Not on tenure track/No tenure system system total","77","30","47","0","0","0","4","0","4","3","0","3","3","1","2","0","0","0","60","25","35","1","0","1","6","4","2","0","0","0","-2"
"122755","San Jose State University","2012","Not on tenure/no tenure system, lecturers","77","30","47","0","0","0","4","0","4","3","0","3","3","1","2","0","0","0","60","25","35","1","0","1","6","4","2","0","0","0","-2"
"123961","University of Southern California","2012","Tenured total","1131","871","260","1","1","0","163","136","27","28","17","11","38","23","15","0","0","0","855","654","201","11","9","2","30","26","4","5","5","0","-2"
"123961","University of Southern California","2012","Tenured, professors","799","640","159","1","1","0","102","85","17","14","14","0","23","16","7","0","0","0","626","494","132","8","7","1","21","19","2","4","4","0","-2"
"123961","University of Southern California","2012","Tenured, associate professors","327","226","101","0","0","0","61","51","10","14","3","11","15","7","8","0","0","0","224","155","69","3","2","1","9","7","2","1","1","0","-2"
"123961","University of Southern California","2012","Tenured, assistant professors","4","4","0","0","0","0","0","0","0","0","0","0","0","0","0","0","0","0","4","4","0","0","0","0","0","0","0","0","0","0","-2"
"123961","University of Southern California","2012","Tenured, lecturers","1","1","0","0","0","0","0","0","0","0","0","0","0","0","0","0","0","0","1","1","0","0","0","0","0","0","0","0","0","0","-2"
"123961","University of Southern California","2012","On-Tenure track total","297","179","118","1","1","0","61","33","28","12","5","7","21","13","8","0","0","0","142","84","58","7","5","2","23","17","6","30","21","9","-2"
"123961","University of Southern California","2012","On-tenure track, professors","4","1","3","0","0","0","0","0","0","1","0","1","1","0","1","0","0","0","2","1","1","0","0","0","0","0","0","0","0","0","-2"
"123961","University of Southern California","2012","On-tenure track, associate professors","18","10","8","0","0","0","7","6","1","2","0","2","0","0","0","0","0","0","9","4","5","0","0","0","0","0","0","0","0","0","-2"
"123961","University of Southern California","2012","On-tenure track, assistant professors","274","167","107","1","1","0","54","27","27","9","5","4","20","13","7","0","0","0","130","78","52","7","5","2","23","17","6","30","21","9","-2"
"123961","University of Southern California","2012","On-tenure track, instructors","1","1","0","0","0","0","0","0","0","0","0","0","0","0","0","0","0","0","1","1","0","0","0","0","0","0","0","0","0","0","-2"
"123961","University of Southern California","2012","Not on tenure track/No tenure system system total","659","335","324","0","0","0","79","31","48","23","7","16","33","15","18","0","0","0","456","244","212","12","7","5","30","17","13","26","14","12","-2"
"123961","University of Southern California","2012","Not on tenure/no tenure system, professors","83","52","31","0","0","0","6","4","2","4","1","3","4","3","1","0","0","0","66","42","24","1","1","0","2","1","1","0","0","0","-2"
"123961","University of Southern California","2012","Not on tenure/no tenure system, associate professors","115","72","43","0","0","0","17","8","9","8","2","6","4","1","3","0","0","0","79","55","24","3","2","1","4","4","0","0","0","0","-2"
"123961","University of Southern California","2012","Not on tenure/no tenure system, assistant professors","128","58","70","0","0","0","20","5","15","4","1","3","9","6","3","0","0","0","78","35","43","1","1","0","7","4","3","9","6","3","-2"
"123961","University of Southern California","2012","Not on tenure/no tenure system, instructors","41","15","26","0","0","0","10","3","7","2","1","1","2","1","1","0","0","0","27","10","17","0","0","0","0","0","0","0","0","0","-2"
"123961","University of Southern California","2012","Not on tenure/no tenure system, lecturers","292","138","154","0","0","0","26","11","15","5","2","3","14","4","10","0","0","0","206","102","104","7","3","4","17","8","9","17","8","9","-2"
"126614","University of Colorado Boulder","2012","Tenured total","803","570","233","4","2","2","73","41","32","11","6","5","43","30","13","0","0","0","637","461","176","0","0","0","31","27","4","4","3","1","-2"
"126614","University of Colorado Boulder","2012","Tenured, professors","449","344","105","2","2","0","34","23","11","4","3","1","22","18","4","0","0","0","375","288","87","0","0","0","10","8","2","2","2","0","-2"
"126614","University of Colorado Boulder","2012","Tenured, associate professors","342","220","122","2","0","2","36","16","20","6","3","3","20","11","9","0","0","0","255","170","85","0","0","0","21","19","2","2","1","1","-2"
"126614","University of Colorado Boulder","2012","Tenured, assistant professors","12","6","6","0","0","0","3","2","1","1","0","1","1","1","0","0","0","0","7","3","4","0","0","0","0","0","0","0","0","0","-2"
"126614","University of Colorado Boulder","2012","On-Tenure track total","272","155","117","3","0","3","41","22","19","9","3","6","16","8","8","0","0","0","165","96","69","2","0","2","22","14","8","14","12","2","-2"
"126614","University of Colorado Boulder","2012","On-tenure track, associate professors","14","9","5","0","0","0","2","1","1","1","0","1","1","0","1","0","0","0","8","7","1","0","0","0","2","1","1","0","0","0","-2"
"126614","University of Colorado Boulder","2012","On-tenure track, assistant professors","258","146","112","3","0","3","39","21","18","8","3","5","15","8","7","0","0","0","157","89","68","2","0","2","20","13","7","14","12","2","-2"
"126614","University of Colorado Boulder","2012","Not on tenure track/No tenure system system total","312","148","164","0","0","0","16","7","9","3","2","1","12","3","9","0","0","0","257","124","133","0","0","0","17","8","9","7","4","3","-2"
"126614","University of Colorado Boulder","2012","Not on tenure/no tenure system, instructors","312","148","164","0","0","0","16","7","9","3","2","1","12","3","9","0","0","0","257","124","133","0","0","0","17","8","9","7","4","3","-2"
"126818","Colorado State University-Fort Collins","2012","Tenured total","709","488","221","2","1","1","47","36","11","7","6","1","30","19","11","0","0","0","615","421","194","4","3","1","0","0","0","4","2","2","-2"
"126818","Colorado State University-Fort Collins","2012","Tenured, professors","383","285","98","1","1","0","22","18","4","2","2","0","13","10","3","0","0","0","343","253","90","1","1","0","0","0","0","1","0","1","-2"
"126818","Colorado State University-Fort Collins","2012","Tenured, associate professors","323","200","123","1","0","1","25","18","7","5","4","1","17","9","8","0","0","0","269","165","104","3","2","1","0","0","0","3","2","1","-2"
"126818","Colorado State University-Fort Collins","2012","Tenured, assistant professors","3","3","0","0","0","0","0","0","0","0","0","0","0","0","0","0","0","0","3","3","0","0","0","0","0","0","0","0","0","0","-2"
"126818","Colorado State University-Fort Collins","2012","On-Tenure track total","244","134","110","0","0","0","26","15","11","3","2","1","22","10","12","0","0","0","176","96","80","2","0","2","0","0","0","15","11","4","-2"
"126818","Colorado State University-Fort Collins","2012","On-tenure track, professors","5","5","0","0","0","0","1","1","0","0","0","0","0","0","0","0","0","0","4","4","0","0","0","0","0","0","0","0","0","0","-2"
"126818","Colorado State University-Fort Collins","2012","On-tenure track, associate professors","15","9","6","0","0","0","0","0","0","0","0","0","0","0","0","0","0","0","15","9","6","0","0","0","0","0","0","0","0","0","-2"
"126818","Colorado State University-Fort Collins","2012","On-tenure track, assistant professors","224","120","104","0","0","0","25","14","11","3","2","1","22","10","12","0","0","0","157","83","74","2","0","2","0","0","0","15","11","4","-2"
"126818","Colorado State University-Fort Collins","2012","Not on tenure track/No tenure system system total","261","93","168","1","1","0","13","6","7","2","1","1","15","3","12","0","0","0","219","77","142","2","0","2","3","1","2","6","4","2","-2"
"126818","Colorado State University-Fort Collins","2012","Not on tenure/no tenure system, professors","3","2","1","0","0","0","1","0","1","0","0","0","0","0","0","0","0","0","2","2","0","0","0","0","0","0","0","0","0","0","-2"
"126818","Colorado State University-Fort Collins","2012","Not on tenure/no tenure system, associate professors","14","8","6","0","0","0","1","1","0","0","0","0","4","2","2","0","0","0","9","5","4","0","0","0","0","0","0","0","0","0","-2"
"126818","Colorado State University-Fort Collins","2012","Not on tenure/no tenure system, assistant professors","84","27","57","1","1","0","5","3","2","2","1","1","3","1","2","0","0","0","67","17","50","1","0","1","0","0","0","5","4","1","-2"
"126818","Colorado State University-Fort Collins","2012","Not on tenure/no tenure system, instructors","160","56","104","0","0","0","6","2","4","0","0","0","8","0","8","0","0","0","141","53","88","1","0","1","3","1","2","1","0","1","-2"
"127060","University of Denver","2012","Tenured total","304","193","111","0","0","0","18","11","7","5","2","3","18","13","5","0","0","0","234","153","81","1","1","0","25","12","13","3","1","2","-2"
"127060","University of Denver","2012","Tenured, professors","155","118","37","0","0","0","7","6","1","1","1","0","6","6","0","0","0","0","126","95","31","1","1","0","13","8","5","1","1","0","-2"
"127060","University of Denver","2012","Tenured, associate professors","149","75","74","0","0","0","11","5","6","4","1","3","12","7","5","0","0","0","108","58","50","0","0","0","12","4","8","2","0","2","-2"
"127060","University of Denver","2012","On-Tenure track total","125","74","51","0","0","0","8","6","2","5","1","4","6","4","2","0","0","0","56","33","23","3","2","1","32","18","14","15","10","5","-2"
"127060","University of Denver","2012","On-tenure track, associate professors","4","3","1","0","0","0","1","1","0","0","0","0","1","1","0","0","0","0","2","1","1","0","0","0","0","0","0","0","0","0","-2"
"127060","University of Denver","2012","On-tenure track, assistant professors","120","71","49","0","0","0","7","5","2","5","1","4","5","3","2","0","0","0","54","32","22","3","2","1","31","18","13","15","10","5","-2"
"127060","University of Denver","2012","On-tenure track, instructors","1","0","1","0","0","0","0","0","0","0","0","0","0","0","0","0","0","0","0","0","0","0","0","0","1","0","1","0","0","0","-2"
"127060","University of Denver","2012","Not on tenure track/No tenure system system total","212","101","111","3","3","0","7","2","5","5","2","3","7","2","5","0","0","0","145","68","77","1","0","1","38","20","18","6","4","2","-2"
"127060","University of Denver","2012","Not on tenure/no tenure system, professors","14","13","1","0","0","0","0","0","0","1","1","0","0","0","0","0","0","0","11","10","1","0","0","0","2","2","0","0","0","0","-2"
"127060","University of Denver","2012","Not on tenure/no tenure system, associate professors","11","5","6","0","0","0","0","0","0","1","1","0","0","0","0","0","0","0","9","4","5","0","0","0","1","0","1","0","0","0","-2"
"127060","University of Denver","2012","Not on tenure/no tenure system, assistant professors","16","3","13","0","0","0","2","1","1","0","0","0","1","0","1","0","0","0","11","1","10","1","0","1","1","1","0","0","0","0","-2"
"127060","University of Denver","2012","Not on tenure/no tenure system, lecturers","171","80","91","3","3","0","5","1","4","3","0","3","6","2","4","0","0","0","114","53","61","0","0","0","34","17","17","6","4","2","-2"
"127565","Metropolitan State University of Denver","2012","Tenured total","255","151","104","3","1","2","19","12","7","11","9","2","25","20","5","0","0","0","189","105","84","6","3","3","2","1","1","0","0","0","-2"
"127565","Metropolitan State University of Denver","2012","Tenured, professors","134","85","49","1","0","1","8","5","3","5","4","1","9","9","0","0","0","0","107","65","42","3","1","2","1","1","0","0","0","0","-2"
"127565","Metropolitan State University of Denver","2012","Tenured, associate professors","119","66","53","2","1","1","11","7","4","6","5","1","15","11","4","0","0","0","81","40","41","3","2","1","1","0","1","0","0","0","-2"
"127565","Metropolitan State University of Denver","2012","Tenured, assistant professors","2","0","2","0","0","0","0","0","0","0","0","0","1","0","1","0","0","0","1","0","1","0","0","0","0","0","0","0","0","0","-2"
"127565","Metropolitan State University of Denver","2012","On-Tenure track total","200","89","111","1","0","1","16","11","5","9","6","3","19","5","14","0","0","0","152","65","87","1","1","0","2","1","1","0","0","0","-2"
"127565","Metropolitan State University of Denver","2012","On-tenure track, professors","1","1","0","0","0","0","0","0","0","0","0","0","0","0","0","0","0","0","1","1","0","0","0","0","0","0","0","0","0","0","-2"
"127565","Metropolitan State University of Denver","2012","On-tenure track, associate professors","4","1","3","0","0","0","0","0","0","1","0","1","0","0","0","0","0","0","3","1","2","0","0","0","0","0","0","0","0","0","-2"
"127565","Metropolitan State University of Denver","2012","On-tenure track, assistant professors","195","87","108","1","0","1","16","11","5","8","6","2","19","5","14","0","0","0","148","63","85","1","1","0","2","1","1","0","0","0","-2"
"127565","Metropolitan State University of Denver","2012","Not on tenure track/No tenure system system total","85","44","41","1","0","1","2","1","1","5","2","3","5","4","1","0","0","0","71","36","35","0","0","0","1","1","0","0","0","0","-2"
"127565","Metropolitan State University of Denver","2012","Not on tenure/no tenure system, instructors","10","7","3","0","0","0","0","0","0","0","0","0","0","0","0","0","0","0","10","7","3","0","0","0","0","0","0","0","0","0","-2"
"127565","Metropolitan State University of Denver","2012","Not on tenure/no tenure system, lecturers","69","35","34","1","0","1","2","1","1","4","1","3","5","4","1","0","0","0","56","28","28","0","0","0","1","1","0","0","0","0","-2"
"127565","Metropolitan State University of Denver","2012","Not on tenure/no tenure system, no academic rank","6","2","4","0","0","0","0","0","0","1","1","0","0","0","0","0","0","0","5","1","4","0","0","0","0","0","0","0","0","0","-2"
"127741","University of Northern Colorado","2012","Tenured total","261","149","112","3","2","1","6","4","2","5","3","2","14","6","8","0","0","0","225","129","96","7","5","2","1","0","1","0","0","0","-2"
"127741","University of Northern Colorado","2012","Tenured, professors","160","97","63","3","2","1","4","3","1","5","3","2","10","4","6","0","0","0","132","81","51","6","4","2","0","0","0","0","0","0","-2"
"127741","University of Northern Colorado","2012","Tenured, associate professors","99","51","48","0","0","0","2","1","1","0","0","0","4","2","2","0","0","0","91","47","44","1","1","0","1","0","1","0","0","0","-2"
"127741","University of Northern Colorado","2012","Tenured, assistant professors","2","1","1","0","0","0","0","0","0","0","0","0","0","0","0","0","0","0","2","1","1","0","0","0","0","0","0","0","0","0","-2"
"127741","University of Northern Colorado","2012","On-Tenure track total","97","45","52","0","0","0","9","5","4","3","3","0","3","2","1","0","0","0","76","34","42","1","1","0","2","0","2","3","0","3","-2"
"127741","University of Northern Colorado","2012","On-tenure track, professors","3","3","0","0","0","0","0","0","0","0","0","0","0","0","0","0","0","0","3","3","0","0","0","0","0","0","0","0","0","0","-2"
"127741","University of Northern Colorado","2012","On-tenure track, associate professors","13","7","6","0","0","0","2","0","2","0","0","0","1","1","0","0","0","0","10","6","4","0","0","0","0","0","0","0","0","0","-2"
"127741","University of Northern Colorado","2012","On-tenure track, assistant professors","81","35","46","0","0","0","7","5","2","3","3","0","2","1","1","0","0","0","63","25","38","1","1","0","2","0","2","3","0","3","-2"
"127741","University of Northern Colorado","2012","Not on tenure track/No tenure system system total","125","44","81","0","0","0","0","0","0","0","0","0","10","5","5","0","0","0","110","37","73","1","0","1","3","2","1","1","0","1","-2"
"127741","University of Northern Colorado","2012","Not on tenure/no tenure system, professors","2","2","0","0","0","0","0","0","0","0","0","0","0","0","0","0","0","0","2","2","0","0","0","0","0","0","0","0","0","0","-2"
"127741","University of Northern Colorado","2012","Not on tenure/no tenure system, associate professors","1","1","0","0","0","0","0","0","0","0","0","0","1","1","0","0","0","0","0","0","0","0","0","0","0","0","0","0","0","0","-2"
"127741","University of Northern Colorado","2012","Not on tenure/no tenure system, assistant professors","49","13","36","0","0","0","0","0","0","0","0","0","2","0","2","0","0","0","46","13","33","0","0","0","0","0","0","1","0","1","-2"
"127741","University of Northern Colorado","2012","Not on tenure/no tenure system, instructors","41","12","29","0","0","0","0","0","0","0","0","0","4","3","1","0","0","0","35","9","26","1","0","1","1","0","1","0","0","0","-2"
"127741","University of Northern Colorado","2012","Not on tenure/no tenure system, lecturers","32","16","16","0","0","0","0","0","0","0","0","0","3","1","2","0","0","0","27","13","14","0","0","0","2","2","0","0","0","0","-2"
"128328","United States Air Force Academy","2012","Not on tenure track/No tenure system system total","164","114","50","0","0","0","6","3","3","0","0","0","4","2","2","0","0","0","154","109","45","0","0","0","0","0","0","0","0","0","-2"
"128328","United States Air Force Academy","2012","Not on tenure/no tenure system, professors","61","53","8","0","0","0","1","1","0","0","0","0","0","0","0","0","0","0","60","52","8","0","0","0","0","0","0","0","0","0","-2"
"128328","United States Air Force Academy","2012","Not on tenure/no tenure system, associate professors","37","26","11","0","0","0","1","1","0","0","0","0","1","1","0","0","0","0","35","24","11","0","0","0","0","0","0","0","0","0","-2"
"128328","United States Air Force Academy","2012","Not on tenure/no tenure system, assistant professors","45","27","18","0","0","0","3","1","2","0","0","0","3","1","2","0","0","0","39","25","14","0","0","0","0","0","0","0","0","0","-2"
"128328","United States Air Force Academy","2012","Not on tenure/no tenure system, instructors","21","8","13","0","0","0","1","0","1","0","0","0","0","0","0","0","0","0","20","8","12","0","0","0","0","0","0","0","0","0","-2"
"130776","Western Connecticut State University","2012","Tenured total","152","86","66","0","0","0","12","7","5","5","3","2","7","4","3","0","0","0","119","67","52","0","0","0","9","5","4","0","0","0","-2"
"130776","Western Connecticut State University","2012","Tenured, professors","98","57","41","0","0","0","7","3","4","3","2","1","3","1","2","0","0","0","82","50","32","0","0","0","3","1","2","0","0","0","-2"
"130776","Western Connecticut State University","2012","Tenured, associate professors","44","24","20","0","0","0","5","4","1","2","1","1","4","3","1","0","0","0","28","13","15","0","0","0","5","3","2","0","0","0","-2"
"130776","Western Connecticut State University","2012","Tenured, assistant professors","10","5","5","0","0","0","0","0","0","0","0","0","0","0","0","0","0","0","9","4","5","0","0","0","1","1","0","0","0","0","-2"
"130776","Western Connecticut State University","2012","On-Tenure track total","55","18","37","0","0","0","4","2","2","3","2","1","3","2","1","0","0","0","37","10","27","0","0","0","8","2","6","0","0","0","-2"
"130776","Western Connecticut State University","2012","On-tenure track, professors","1","1","0","0","0","0","0","0","0","0","0","0","0","0","0","0","0","0","1","1","0","0","0","0","0","0","0","0","0","0","-2"
"130776","Western Connecticut State University","2012","On-tenure track, associate professors","11","4","7","0","0","0","0","0","0","0","0","0","0","0","0","0","0","0","9","3","6","0","0","0","2","1","1","0","0","0","-2"
"130776","Western Connecticut State University","2012","On-tenure track, assistant professors","43","13","30","0","0","0","4","2","2","3","2","1","3","2","1","0","0","0","27","6","21","0","0","0","6","1","5","0","0","0","-2"
"130776","Western Connecticut State University","2012","Not on tenure track/No tenure system system total","21","6","15","0","0","0","0","0","0","0","0","0","0","0","0","0","0","0","18","4","14","0","0","0","3","2","1","0","0","0","-2"
"130776","Western Connecticut State University","2012","Not on tenure/no tenure system, assistant professors","14","3","11","0","0","0","0","0","0","0","0","0","0","0","0","0","0","0","12","2","10","0","0","0","2","1","1","0","0","0","-2"
"130776","Western Connecticut State University","2012","Not on tenure/no tenure system, instructors","7","3","4","0","0","0","0","0","0","0","0","0","0","0","0","0","0","0","6","2","4","0","0","0","1","1","0","0","0","0","-2"
"130794","Yale University","2012","Tenured total","959","731","228","1","1","0","76","56","20","24","17","7","21","16","5","1","1","0","782","600","182","2","0","2","40","32","8","12","8","4","-2"
"130794","Yale University","2012","Tenured, professors","884","686","198","1","1","0","63","45","18","23","16","7","20","16","4","1","1","0","730","571","159","1","0","1","35","29","6","10","7","3","-2"
"130794","Yale University","2012","Tenured, associate professors","75","45","30","0","0","0","13","11","2","1","1","0","1","0","1","0","0","0","52","29","23","1","0","1","5","3","2","2","1","1","-2"
"130794","Yale University","2012","On-Tenure track total","1012","593","419","3","1","2","151","90","61","40","19","21","33","16","17","2","0","2","593","351","242","1","1","0","106","63","43","83","52","31","-2"
"130794","Yale University","2012","On-tenure track, associate professors","327","200","127","2","1","1","57","33","24","12","1","11","11","7","4","1","0","1","222","146","76","1","1","0","14","7","7","7","4","3","-2"
"130794","Yale University","2012","On-tenure track, assistant professors","685","393","292","1","0","1","94","57","37","28","18","10","22","9","13","1","0","1","371","205","166","0","0","0","92","56","36","76","48","28","-2"
"130794","Yale University","2012","Not on tenure track/No tenure system system total","456","208","248","0","0","0","40","19","21","11","6","5","18","4","14","0","0","0","253","115","138","0","0","0","80","41","39","54","23","31","-2"
"130794","Yale University","2012","Not on tenure/no tenure system, professors","65","46","19","0","0","0","4","3","1","1","1","0","0","0","0","0","0","0","57","39","18","0","0","0","2","2","0","1","1","0","-2"
"130794","Yale University","2012","Not on tenure/no tenure system, associate professors","23","14","9","0","0","0","1","1","0","0","0","0","0","0","0","0","0","0","17","10","7","0","0","0","2","1","1","3","2","1","-2"
"130794","Yale University","2012","Not on tenure/no tenure system, assistant professors","7","2","5","0","0","0","0","0","0","0","0","0","0","0","0","0","0","0","6","1","5","0","0","0","1","1","0","0","0","0","-2"
"130794","Yale University","2012","Not on tenure/no tenure system, lecturers","361","146","215","0","0","0","35","15","20","10","5","5","18","4","14","0","0","0","173","65","108","0","0","0","75","37","38","50","20","30","-2"
"130934","Delaware State University","2012","Tenured total","109","68","41","1","1","0","20","16","4","44","22","22","3","2","1","0","0","0","37","23","14","2","2","0","2","2","0","0","0","0","-2"
"130934","Delaware State University","2012","Tenured, professors","37","28","9","1","1","0","9","8","1","14","10","4","0","0","0","0","0","0","12","8","4","0","0","0","1","1","0","0","0","0","-2"
"130934","Delaware State University","2012","Tenured, associate professors","66","38","28","0","0","0","11","8","3","26","12","14","3","2","1","0","0","0","23","13","10","2","2","0","1","1","0","0","0","0","-2"
"130934","Delaware State University","2012","Tenured, assistant professors","6","2","4","0","0","0","0","0","0","4","0","4","0","0","0","0","0","0","2","2","0","0","0","0","0","0","0","0","0","0","-2"
"130934","Delaware State University","2012","On-Tenure track total","73","45","28","1","0","1","17","11","6","17","10","7","3","3","0","0","0","0","28","14","14","6","6","0","1","1","0","0","0","0","-2"
"130934","Delaware State University","2012","On-tenure track, professors","4","4","0","0","0","0","1","1","0","1","1","0","0","0","0","0","0","0","2","2","0","0","0","0","0","0","0","0","0","0","-2"
"130934","Delaware State University","2012","On-tenure track, associate professors","29","14","15","0","0","0","2","0","2","8","2","6","1","1","0","0","0","0","12","5","7","6","6","0","0","0","0","0","0","0","-2"
"130934","Delaware State University","2012","On-tenure track, assistant professors","40","27","13","1","0","1","14","10","4","8","7","1","2","2","0","0","0","0","14","7","7","0","0","0","1","1","0","0","0","0","-2"
"130934","Delaware State University","2012","Not on tenure track/No tenure system system total","33","13","20","0","0","0","7","4","3","16","6","10","1","0","1","0","0","0","8","3","5","0","0","0","1","0","1","0","0","0","-2"
"130934","Delaware State University","2012","Not on tenure/no tenure system, professors","1","1","0","0","0","0","0","0","0","1","1","0","0","0","0","0","0","0","0","0","0","0","0","0","0","0","0","0","0","0","-2"
"130934","Delaware State University","2012","Not on tenure/no tenure system, associate professors","1","1","0","0","0","0","0","0","0","0","0","0","0","0","0","0","0","0","1","1","0","0","0","0","0","0","0","0","0","0","-2"
"130934","Delaware State University","2012","Not on tenure/no tenure system, assistant professors","16","7","9","0","0","0","4","2","2","10","4","6","0","0","0","0","0","0","2","1","1","0","0","0","0","0","0","0","0","0","-2"
"130934","Delaware State University","2012","Not on tenure/no tenure system, instructors","12","2","10","0","0","0","2","1","1","5","1","4","1","0","1","0","0","0","3","0","3","0","0","0","1","0","1","0","0","0","-2"
"130934","Delaware State University","2012","Not on tenure/no tenure system, lecturers","3","2","1","0","0","0","1","1","0","0","0","0","0","0","0","0","0","0","2","1","1","0","0","0","0","0","0","0","0","0","-2"
"130943","University of Delaware","2012","Tenured total","679","471","208","0","0","0","80","64","16","27","16","11","20","12","8","0","0","0","549","378","171","0","0","0","0","0","0","3","1","2","-2"
"130943","University of Delaware","2012","Tenured, professors","378","285","93","0","0","0","43","38","5","11","6","5","9","8","1","0","0","0","315","233","82","0","0","0","0","0","0","0","0","0","-2"
"130943","University of Delaware","2012","Tenured, associate professors","301","186","115","0","0","0","37","26","11","16","10","6","11","4","7","0","0","0","234","145","89","0","0","0","0","0","0","3","1","2","-2"
"130943","University of Delaware","2012","On-Tenure track total","176","89","87","0","0","0","34","16","18","10","2","8","7","6","1","0","0","0","114","57","57","1","0","1","2","1","1","8","7","1","-2"
"130943","University of Delaware","2012","On-tenure track, associate professors","4","2","2","0","0","0","0","0","0","0","0","0","1","1","0","0","0","0","3","1","2","0","0","0","0","0","0","0","0","0","-2"
"130943","University of Delaware","2012","On-tenure track, assistant professors","172","87","85","0","0","0","34","16","18","10","2","8","6","5","1","0","0","0","111","56","55","1","0","1","2","1","1","8","7","1","-2"
"130943","University of Delaware","2012","Not on tenure track/No tenure system system total","273","121","152","3","1","2","18","12","6","8","4","4","9","1","8","0","0","0","233","101","132","0","0","0","0","0","0","2","2","0","-2"
"130943","University of Delaware","2012","Not on tenure/no tenure system, professors","7","5","2","0","0","0","1","1","0","0","0","0","0","0","0","0","0","0","6","4","2","0","0","0","0","0","0","0","0","0","-2"
"130943","University of Delaware","2012","Not on tenure/no tenure system, associate professors","44","23","21","0","0","0","3","3","0","2","1","1","0","0","0","0","0","0","39","19","20","0","0","0","0","0","0","0","0","0","-2"
"130943","University of Delaware","2012","Not on tenure/no tenure system, assistant professors","125","63","62","1","0","1","11","8","3","4","2","2","5","1","4","0","0","0","102","50","52","0","0","0","0","0","0","2","2","0","-2"
"130943","University of Delaware","2012","Not on tenure/no tenure system, instructors","97","30","67","2","1","1","3","0","3","2","1","1","4","0","4","0","0","0","86","28","58","0","0","0","0","0","0","0","0","0","-2"
"131520","Howard University","2012","Tenured total","410","266","144","0","0","0","0","0","0","256","161","95","9","2","7","0","0","0","71","49","22","0","0","0","74","54","20","0","0","0","-2"
"131520","Howard University","2012","Tenured, professors","183","135","48","0","0","0","0","0","0","110","79","31","2","1","1","0","0","0","34","24","10","0","0","0","37","31","6","0","0","0","-2"
"131520","Howard University","2012","Tenured, associate professors","221","128","93","0","0","0","0","0","0","142","80","62","6","1","5","0","0","0","37","25","12","0","0","0","36","22","14","0","0","0","-2"
"131520","Howard University","2012","Tenured, assistant professors","5","3","2","0","0","0","0","0","0","3","2","1","1","0","1","0","0","0","0","0","0","0","0","0","1","1","0","0","0","0","-2"
"131520","Howard University","2012","Tenured, instructors","1","0","1","0","0","0","0","0","0","1","0","1","0","0","0","0","0","0","0","0","0","0","0","0","0","0","0","0","0","0","-2"
"131520","Howard University","2012","On-Tenure track total","140","63","77","0","0","0","10","7","3","81","31","50","5","0","5","2","0","2","19","10","9","0","0","0","23","15","8","0","0","0","-2"
"131520","Howard University","2012","On-tenure track, associate professors","17","8","9","0","0","0","1","0","1","10","5","5","0","0","0","0","0","0","3","1","2","0","0","0","3","2","1","0","0","0","-2"
"131520","Howard University","2012","On-tenure track, assistant professors","120","55","65","0","0","0","9","7","2","68","26","42","5","0","5","2","0","2","16","9","7","0","0","0","20","13","7","0","0","0","-2"
"131520","Howard University","2012","On-tenure track, instructors","3","0","3","0","0","0","0","0","0","3","0","3","0","0","0","0","0","0","0","0","0","0","0","0","0","0","0","0","0","0","-2"
"131520","Howard University","2012","Not on tenure track/No tenure system system total","465","244","221","0","0","0","17","9","8","300","145","155","8","4","4","3","1","2","54","33","21","0","0","0","83","52","31","0","0","0","-2"
"131520","Howard University","2012","Not on tenure/no tenure system, professors","67","45","22","0","0","0","0","0","0","43","27","16","0","0","0","0","0","0","13","10","3","0","0","0","11","8","3","0","0","0","-2"
"131520","Howard University","2012","Not on tenure/no tenure system, associate professors","67","36","31","0","0","0","1","1","0","40","18","22","1","1","0","0","0","0","8","6","2","0","0","0","17","10","7","0","0","0","-2"
"131520","Howard University","2012","Not on tenure/no tenure system, assistant professors","164","82","82","0","0","0","12","7","5","108","50","58","2","1","1","3","1","2","13","9","4","0","0","0","26","14","12","0","0","0","-2"
"131520","Howard University","2012","Not on tenure/no tenure system, instructors","79","31","48","0","0","0","2","1","1","55","17","38","0","0","0","0","0","0","11","5","6","0","0","0","11","8","3","0","0","0","-2"
"131520","Howard University","2012","Not on tenure/no tenure system, lecturers","88","50","38","0","0","0","2","0","2","54","33","21","5","2","3","0","0","0","9","3","6","0","0","0","18","12","6","0","0","0","-2"
"133553","Embry-Riddle Aeronautical University-Daytona Beach","2012","Tenured total","106","92","14","0","0","0","14","12","2","2","1","1","0","0","0","0","0","0","88","77","11","0","0","0","2","2","0","0","0","0","-2"
"133553","Embry-Riddle Aeronautical University-Daytona Beach","2012","Tenured, professors","55","50","5","0","0","0","8","6","2","0","0","0","0","0","0","0","0","0","45","42","3","0","0","0","2","2","0","0","0","0","-2"
"133553","Embry-Riddle Aeronautical University-Daytona Beach","2012","Tenured, associate professors","51","42","9","0","0","0","6","6","0","2","1","1","0","0","0","0","0","0","43","35","8","0","0","0","0","0","0","0","0","0","-2"
"133553","Embry-Riddle Aeronautical University-Daytona Beach","2012","On-Tenure track total","61","39","22","0","0","0","3","3","0","0","0","0","2","0","2","0","0","0","41","27","14","2","0","2","6","6","0","7","3","4","-2"
"133553","Embry-Riddle Aeronautical University-Daytona Beach","2012","On-tenure track, professors","2","2","0","0","0","0","0","0","0","0","0","0","0","0","0","0","0","0","2","2","0","0","0","0","0","0","0","0","0","0","-2"
"133553","Embry-Riddle Aeronautical University-Daytona Beach","2012","On-tenure track, associate professors","16","12","4","0","0","0","2","2","0","0","0","0","0","0","0","0","0","0","12","9","3","0","0","0","1","1","0","1","0","1","-2"
"133553","Embry-Riddle Aeronautical University-Daytona Beach","2012","On-tenure track, assistant professors","43","25","18","0","0","0","1","1","0","0","0","0","2","0","2","0","0","0","27","16","11","2","0","2","5","5","0","6","3","3","-2"
"133553","Embry-Riddle Aeronautical University-Daytona Beach","2012","Not on tenure track/No tenure system system total","99","71","28","1","1","0","3","1","2","2","2","0","5","4","1","1","1","0","82","59","23","0","0","0","3","2","1","2","1","1","-2"
"133553","Embry-Riddle Aeronautical University-Daytona Beach","2012","Not on tenure/no tenure system, professors","5","4","1","0","0","0","0","0","0","0","0","0","0","0","0","0","0","0","5","4","1","0","0","0","0","0","0","0","0","0","-2"
"133553","Embry-Riddle Aeronautical University-Daytona Beach","2012","Not on tenure/no tenure system, associate professors","26","20","6","0","0","0","2","1","1","2","2","0","0","0","0","0","0","0","22","17","5","0","0","0","0","0","0","0","0","0","-2"
"133553","Embry-Riddle Aeronautical University-Daytona Beach","2012","Not on tenure/no tenure system, assistant professors","51","40","11","1","1","0","1","0","1","0","0","0","5","4","1","1","1","0","38","31","7","0","0","0","3","2","1","2","1","1","-2"
"133553","Embry-Riddle Aeronautical University-Daytona Beach","2012","Not on tenure/no tenure system, instructors","17","7","10","0","0","0","0","0","0","0","0","0","0","0","0","0","0","0","17","7","10","0","0","0","0","0","0","0","0","0","-2"
"133650","Florida Agricultural and Mechanical University","2012","Tenured total","268","176","92","0","0","0","15","11","4","190","120","70","6","3","3","0","0","0","49","36","13","1","0","1","0","0","0","7","6","1","-2"
"133650","Florida Agricultural and Mechanical University","2012","Tenured, professors","139","104","35","0","0","0","13","10","3","95","70","25","1","0","1","0","0","0","25","20","5","0","0","0","0","0","0","5","4","1","-2"
"133650","Florida Agricultural and Mechanical University","2012","Tenured, associate professors","120","66","54","0","0","0","2","1","1","86","44","42","5","3","2","0","0","0","24","16","8","1","0","1","0","0","0","2","2","0","-2"
"133650","Florida Agricultural and Mechanical University","2012","Tenured, assistant professors","9","6","3","0","0","0","0","0","0","9","6","3","0","0","0","0","0","0","0","0","0","0","0","0","0","0","0","0","0","0","-2"
"133650","Florida Agricultural and Mechanical University","2012","On-Tenure track total","130","52","78","0","0","0","4","4","0","81","28","53","4","1","3","0","0","0","24","10","14","2","1","1","0","0","0","15","8","7","-2"
"133650","Florida Agricultural and Mechanical University","2012","On-tenure track, professors","3","2","1","0","0","0","0","0","0","2","1","1","0","0","0","0","0","0","0","0","0","0","0","0","0","0","0","1","1","0","-2"
"133650","Florida Agricultural and Mechanical University","2012","On-tenure track, associate professors","56","20","36","0","0","0","3","3","0","32","8","24","3","1","2","0","0","0","12","4","8","1","1","0","0","0","0","5","3","2","-2"
"133650","Florida Agricultural and Mechanical University","2012","On-tenure track, assistant professors","68","30","38","0","0","0","1","1","0","44","19","25","1","0","1","0","0","0","12","6","6","1","0","1","0","0","0","9","4","5","-2"
"133650","Florida Agricultural and Mechanical University","2012","On-tenure track, instructors","3","0","3","0","0","0","0","0","0","3","0","3","0","0","0","0","0","0","0","0","0","0","0","0","0","0","0","0","0","0","-2"
"133650","Florida Agricultural and Mechanical University","2012","Not on tenure track/No tenure system system total","154","72","82","0","0","0","4","3","1","112","47","65","3","1","2","0","0","0","23","13","10","4","2","2","0","0","0","8","6","2","-2"
"133650","Florida Agricultural and Mechanical University","2012","Not on tenure/no tenure system, professors","4","3","1","0","0","0","0","0","0","2","1","1","0","0","0","0","0","0","2","2","0","0","0","0","0","0","0","0","0","0","-2"
"133650","Florida Agricultural and Mechanical University","2012","Not on tenure/no tenure system, associate professors","10","5","5","0","0","0","0","0","0","4","2","2","0","0","0","0","0","0","4","2","2","2","1","1","0","0","0","0","0","0","-2"
"133650","Florida Agricultural and Mechanical University","2012","Not on tenure/no tenure system, assistant professors","63","35","28","0","0","0","4","3","1","48","26","22","1","1","0","0","0","0","4","2","2","2","1","1","0","0","0","4","2","2","-2"
"133650","Florida Agricultural and Mechanical University","2012","Not on tenure/no tenure system, instructors","76","28","48","0","0","0","0","0","0","58","18","40","2","0","2","0","0","0","12","6","6","0","0","0","0","0","0","4","4","0","-2"
"133650","Florida Agricultural and Mechanical University","2012","Not on tenure/no tenure system, lecturers","1","1","0","0","0","0","0","0","0","0","0","0","0","0","0","0","0","0","1","1","0","0","0","0","0","0","0","0","0","0","-2"
"133881","Florida Institute of Technology","2012","Not on tenure track/No tenure system system total","246","189","57","0","0","0","20","19","1","4","2","2","11","6","5","0","0","0","158","122","36","0","0","0","22","15","7","31","25","6","-2"
"133881","Florida Institute of Technology","2012","Not on tenure/no tenure system, professors","79","70","9","0","0","0","10","10","0","0","0","0","2","1","1","0","0","0","55","49","6","0","0","0","3","3","0","9","7","2","-2"
"133881","Florida Institute of Technology","2012","Not on tenure/no tenure system, associate professors","86","73","13","0","0","0","5","5","0","1","1","0","4","3","1","0","0","0","60","50","10","0","0","0","7","5","2","9","9","0","-2"
"133881","Florida Institute of Technology","2012","Not on tenure/no tenure system, assistant professors","67","40","27","0","0","0","5","4","1","2","1","1","5","2","3","0","0","0","33","19","14","0","0","0","11","6","5","11","8","3","-2"
"133881","Florida Institute of Technology","2012","Not on tenure/no tenure system, instructors","14","6","8","0","0","0","0","0","0","1","0","1","0","0","0","0","0","0","10","4","6","0","0","0","1","1","0","2","1","1","-2"
"133951","Florida International University","2012","Tenured total","447","317","130","2","1","1","79","69","10","27","15","12","60","48","12","0","0","0","270","176","94","0","0","0","0","0","0","9","8","1","-2"
"133951","Florida International University","2012","Tenured, professors","216","167","49","1","0","1","34","31","3","7","6","1","38","31","7","0","0","0","133","96","37","0","0","0","0","0","0","3","3","0","-2"
"133951","Florida International University","2012","Tenured, associate professors","231","150","81","1","1","0","45","38","7","20","9","11","22","17","5","0","0","0","137","80","57","0","0","0","0","0","0","6","5","1","-2"
"133951","Florida International University","2012","On-Tenure track total","240","136","104","2","1","1","45","28","17","11","4","7","19","7","12","0","0","0","120","72","48","0","0","0","0","0","0","43","24","19","-2"
"133951","Florida International University","2012","On-tenure track, professors","1","1","0","0","0","0","0","0","0","0","0","0","1","1","0","0","0","0","0","0","0","0","0","0","0","0","0","0","0","0","-2"
"133951","Florida International University","2012","On-tenure track, associate professors","17","10","7","0","0","0","6","4","2","0","0","0","2","1","1","0","0","0","7","3","4","0","0","0","0","0","0","2","2","0","-2"
"133951","Florida International University","2012","On-tenure track, assistant professors","220","123","97","2","1","1","39","24","15","11","4","7","16","5","11","0","0","0","111","67","44","0","0","0","0","0","0","41","22","19","-2"
"133951","Florida International University","2012","On-tenure track, instructors","2","2","0","0","0","0","0","0","0","0","0","0","0","0","0","0","0","0","2","2","0","0","0","0","0","0","0","0","0","0","-2"
"133951","Florida International University","2012","Not on tenure track/No tenure system system total","429","205","224","0","0","0","25","14","11","32","14","18","96","34","62","0","0","0","241","122","119","1","1","0","0","0","0","34","20","14","-2"
"133951","Florida International University","2012","Not on tenure/no tenure system, professors","24","18","6","0","0","0","5","4","1","0","0","0","2","1","1","0","0","0","14","10","4","0","0","0","0","0","0","3","3","0","-2"
"133951","Florida International University","2012","Not on tenure/no tenure system, associate professors","28","15","13","0","0","0","1","1","0","6","2","4","6","3","3","0","0","0","15","9","6","0","0","0","0","0","0","0","0","0","-2"
"133951","Florida International University","2012","Not on tenure/no tenure system, assistant professors","115","46","69","0","0","0","5","2","3","9","2","7","26","9","17","0","0","0","54","17","37","1","1","0","0","0","0","20","15","5","-2"
"133951","Florida International University","2012","Not on tenure/no tenure system, instructors","196","97","99","0","0","0","12","6","6","17","10","7","43","15","28","0","0","0","114","64","50","0","0","0","0","0","0","10","2","8","-2"
"133951","Florida International University","2012","Not on tenure/no tenure system, lecturers","46","22","24","0","0","0","2","1","1","0","0","0","12","4","8","0","0","0","31","17","14","0","0","0","0","0","0","1","0","1","-2"
"133951","Florida International University","2012","Not on tenure/no tenure system, no academic rank","20","7","13","0","0","0","0","0","0","0","0","0","7","2","5","0","0","0","13","5","8","0","0","0","0","0","0","0","0","0","-2"
"134097","Florida State University","2012","Tenured total","781","548","233","1","1","0","81","64","17","32","16","16","29","20","9","0","0","0","625","439","186","2","0","2","0","0","0","11","8","3","-2"
"134097","Florida State University","2012","Tenured, professors","432","330","102","0","0","0","35","29","6","13","7","6","14","10","4","0","0","0","362","278","84","0","0","0","0","0","0","8","6","2","-2"
"134097","Florida State University","2012","Tenured, associate professors","325","198","127","1","1","0","42","31","11","19","9","10","14","9","5","0","0","0","244","146","98","2","0","2","0","0","0","3","2","1","-2"
"134097","Florida State University","2012","Tenured, assistant professors","1","0","1","0","0","0","0","0","0","0","0","0","0","0","0","0","0","0","1","0","1","0","0","0","0","0","0","0","0","0","-2"
"134097","Florida State University","2012","Tenured, no academic rank","23","20","3","0","0","0","4","4","0","0","0","0","1","1","0","0","0","0","18","15","3","0","0","0","0","0","0","0","0","0","-2"
"134097","Florida State University","2012","On-Tenure track total","238","150","88","1","1","0","37","22","15","11","4","7","11","8","3","0","0","0","152","97","55","5","1","4","0","0","0","21","17","4","-2"
"134097","Florida State University","2012","On-tenure track, professors","1","1","0","0","0","0","0","0","0","0","0","0","0","0","0","0","0","0","1","1","0","0","0","0","0","0","0","0","0","0","-2"
"134097","Florida State University","2012","On-tenure track, associate professors","14","8","6","0","0","0","3","0","3","0","0","0","2","1","1","0","0","0","9","7","2","0","0","0","0","0","0","0","0","0","-2"
"134097","Florida State University","2012","On-tenure track, assistant professors","222","140","82","1","1","0","33","21","12","11","4","7","9","7","2","0","0","0","142","89","53","5","1","4","0","0","0","21","17","4","-2"
"134097","Florida State University","2012","On-tenure track, no academic rank","1","1","0","0","0","0","1","1","0","0","0","0","0","0","0","0","0","0","0","0","0","0","0","0","0","0","0","0","0","0","-2"
"134097","Florida State University","2012","Not on tenure track/No tenure system system total","317","139","178","0","0","0","12","5","7","22","8","14","14","7","7","0","0","0","260","115","145","1","0","1","0","0","0","8","4","4","-2"
"134097","Florida State University","2012","Not on tenure/no tenure system, professors","14","10","4","0","0","0","0","0","0","2","1","1","0","0","0","0","0","0","11","8","3","0","0","0","0","0","0","1","1","0","-2"
"134097","Florida State University","2012","Not on tenure/no tenure system, associate professors","15","9","6","0","0","0","1","0","1","2","1","1","1","1","0","0","0","0","11","7","4","0","0","0","0","0","0","0","0","0","-2"
"134097","Florida State University","2012","Not on tenure/no tenure system, assistant professors","37","16","21","0","0","0","2","1","1","7","3","4","2","2","0","0","0","0","22","8","14","0","0","0","0","0","0","4","2","2","-2"
"134097","Florida State University","2012","Not on tenure/no tenure system, instructors","8","3","5","0","0","0","0","0","0","0","0","0","0","0","0","0","0","0","8","3","5","0","0","0","0","0","0","0","0","0","-2"
"134097","Florida State University","2012","Not on tenure/no tenure system, lecturers","6","3","3","0","0","0","1","0","1","0","0","0","0","0","0","0","0","0","5","3","2","0","0","0","0","0","0","0","0","0","-2"
"134097","Florida State University","2012","Not on tenure/no tenure system, no academic rank","237","98","139","0","0","0","8","4","4","11","3","8","11","4","7","0","0","0","203","86","117","1","0","1","0","0","0","3","1","2","-2"
"135726","University of Miami","2012","Tenured total","867","670","197","3","3","0","95","78","17","19","11","8","95","69","26","0","0","0","649","503","146","2","2","0","2","2","0","2","2","0","-2"
"135726","University of Miami","2012","Tenured, professors","598","495","103","1","1","0","60","50","10","8","6","2","65","51","14","0","0","0","460","383","77","2","2","0","2","2","0","0","0","0","-2"
"135726","University of Miami","2012","Tenured, associate professors","267","173","94","2","2","0","35","28","7","11","5","6","30","18","12","0","0","0","187","118","69","0","0","0","0","0","0","2","2","0","-2"
"135726","University of Miami","2012","Tenured, assistant professors","2","2","0","0","0","0","0","0","0","0","0","0","0","0","0","0","0","0","2","2","0","0","0","0","0","0","0","0","0","0","-2"
"135726","University of Miami","2012","On-Tenure track total","257","166","91","1","1","0","46","33","13","8","4","4","29","22","7","1","0","1","140","84","56","1","0","1","0","0","0","31","22","9","-2"
"135726","University of Miami","2012","On-tenure track, professors","12","12","0","1","1","0","1","1","0","0","0","0","0","0","0","0","0","0","10","10","0","0","0","0","0","0","0","0","0","0","-2"
"135726","University of Miami","2012","On-tenure track, associate professors","53","35","18","0","0","0","9","8","1","3","1","2","9","8","1","1","0","1","28","16","12","1","0","1","0","0","0","2","2","0","-2"
"135726","University of Miami","2012","On-tenure track, assistant professors","192","119","73","0","0","0","36","24","12","5","3","2","20","14","6","0","0","0","102","58","44","0","0","0","0","0","0","29","20","9","-2"
"135726","University of Miami","2012","Not on tenure track/No tenure system system total","457","216","241","1","0","1","40","17","23","21","8","13","81","34","47","0","0","0","284","139","145","7","3","4","2","1","1","21","14","7","-2"
"135726","University of Miami","2012","Not on tenure/no tenure system, professors","10","7","3","0","0","0","1","1","0","1","0","1","1","1","0","0","0","0","7","5","2","0","0","0","0","0","0","0","0","0","-2"
"135726","University of Miami","2012","Not on tenure/no tenure system, associate professors","19","8","11","1","0","1","2","1","1","1","0","1","2","2","0","0","0","0","13","5","8","0","0","0","0","0","0","0","0","0","-2"
"135726","University of Miami","2012","Not on tenure/no tenure system, assistant professors","64","29","35","0","0","0","2","1","1","8","3","5","10","4","6","0","0","0","34","14","20","1","0","1","0","0","0","9","7","2","-2"
"135726","University of Miami","2012","Not on tenure/no tenure system, instructors","80","43","37","0","0","0","22","11","11","2","1","1","16","7","9","0","0","0","33","19","14","0","0","0","2","1","1","5","4","1","-2"
"135726","University of Miami","2012","Not on tenure/no tenure system, lecturers","284","129","155","0","0","0","13","3","10","9","4","5","52","20","32","0","0","0","197","96","101","6","3","3","0","0","0","7","3","4","-2"
"137351","University of South Florida-Main Campus","2012","Tenured total","661","443","218","4","2","2","69","59","10","34","17","17","30","17","13","0","0","0","518","343","175","1","1","0","4","4","0","1","0","1","-2"
"137351","University of South Florida-Main Campus","2012","Tenured, professors","362","269","93","4","2","2","40","38","2","11","9","2","14","10","4","0","0","0","289","207","82","1","1","0","2","2","0","1","0","1","-2"
"137351","University of South Florida-Main Campus","2012","Tenured, associate professors","294","170","124","0","0","0","29","21","8","23","8","15","15","6","9","0","0","0","225","133","92","0","0","0","2","2","0","0","0","0","-2"
"137351","University of South Florida-Main Campus","2012","Tenured, assistant professors","4","3","1","0","0","0","0","0","0","0","0","0","1","1","0","0","0","0","3","2","1","0","0","0","0","0","0","0","0","0","-2"
"137351","University of South Florida-Main Campus","2012","Tenured, lecturers","1","1","0","0","0","0","0","0","0","0","0","0","0","0","0","0","0","0","1","1","0","0","0","0","0","0","0","0","0","0","-2"
"137351","University of South Florida-Main Campus","2012","On-Tenure track total","329","174","155","0","0","0","49","27","22","20","9","11","11","6","5","0","0","0","166","94","72","2","0","2","40","13","27","41","25","16","-2"
"137351","University of South Florida-Main Campus","2012","On-tenure track, professors","16","15","1","0","0","0","0","0","0","1","1","0","1","1","0","0","0","0","13","12","1","0","0","0","1","1","0","0","0","0","-2"
"137351","University of South Florida-Main Campus","2012","On-tenure track, associate professors","65","44","21","0","0","0","11","6","5","7","3","4","1","1","0","0","0","0","39","30","9","0","0","0","4","2","2","3","2","1","-2"
"137351","University of South Florida-Main Campus","2012","On-tenure track, assistant professors","246","113","133","0","0","0","37","20","17","12","5","7","9","4","5","0","0","0","113","51","62","2","0","2","35","10","25","38","23","15","-2"
"137351","University of South Florida-Main Campus","2012","On-tenure track, instructors","2","2","0","0","0","0","1","1","0","0","0","0","0","0","0","0","0","0","1","1","0","0","0","0","0","0","0","0","0","0","-2"
"137351","University of South Florida-Main Campus","2012","Not on tenure track/No tenure system system total","138","70","68","0","0","0","8","3","5","6","3","3","15","9","6","1","1","0","91","44","47","1","0","1","10","7","3","6","3","3","-2"
"137351","University of South Florida-Main Campus","2012","Not on tenure/no tenure system, professors","5","5","0","0","0","0","0","0","0","0","0","0","1","1","0","0","0","0","4","4","0","0","0","0","0","0","0","0","0","0","-2"
"137351","University of South Florida-Main Campus","2012","Not on tenure/no tenure system, associate professors","13","7","6","0","0","0","1","0","1","0","0","0","1","1","0","0","0","0","10","5","5","0","0","0","0","0","0","1","1","0","-2"
"137351","University of South Florida-Main Campus","2012","Not on tenure/no tenure system, assistant professors","47","27","20","0","0","0","4","2","2","2","1","1","7","5","2","1","1","0","26","14","12","1","0","1","4","3","1","2","1","1","-2"
"137351","University of South Florida-Main Campus","2012","Not on tenure/no tenure system, instructors","72","30","42","0","0","0","3","1","2","4","2","2","6","2","4","0","0","0","50","20","30","0","0","0","6","4","2","3","1","2","-2"
"137351","University of South Florida-Main Campus","2012","Not on tenure/no tenure system, lecturers","1","1","0","0","0","0","0","0","0","0","0","0","0","0","0","0","0","0","1","1","0","0","0","0","0","0","0","0","0","0","-2"
"139755","Georgia Institute of Technology-Main Campus","2012","Tenured total","662","543","119","0","0","0","142","118","24","18","13","5","16","13","3","0","0","0","483","397","86","0","0","0","1","0","1","2","2","0","-2"
"139755","Georgia Institute of Technology-Main Campus","2012","Tenured, professors","425","366","59","0","0","0","95","85","10","6","4","2","10","9","1","0","0","0","313","267","46","0","0","0","0","0","0","1","1","0","-2"
"139755","Georgia Institute of Technology-Main Campus","2012","Tenured, associate professors","236","176","60","0","0","0","47","33","14","12","9","3","6","4","2","0","0","0","169","129","40","0","0","0","1","0","1","1","1","0","-2"
"139755","Georgia Institute of Technology-Main Campus","2012","Tenured, no academic rank","1","1","0","0","0","0","0","0","0","0","0","0","0","0","0","0","0","0","1","1","0","0","0","0","0","0","0","0","0","0","-2"
"139755","Georgia Institute of Technology-Main Campus","2012","On-Tenure track total","245","173","72","0","0","0","65","49","16","10","6","4","15","9","6","0","0","0","147","101","46","1","1","0","2","2","0","5","5","0","-2"
"139755","Georgia Institute of Technology-Main Campus","2012","On-tenure track, professors","4","2","2","0","0","0","0","0","0","0","0","0","0","0","0","0","0","0","4","2","2","0","0","0","0","0","0","0","0","0","-2"
"139755","Georgia Institute of Technology-Main Campus","2012","On-tenure track, associate professors","26","21","5","0","0","0","11","10","1","1","1","0","2","1","1","0","0","0","12","9","3","0","0","0","0","0","0","0","0","0","-2"
"139755","Georgia Institute of Technology-Main Campus","2012","On-tenure track, assistant professors","215","150","65","0","0","0","54","39","15","9","5","4","13","8","5","0","0","0","131","90","41","1","1","0","2","2","0","5","5","0","-2"
"139755","Georgia Institute of Technology-Main Campus","2012","Not on tenure track/No tenure system system total","93","36","57","0","0","0","10","6","4","0","0","0","2","0","2","0","0","0","78","29","49","0","0","0","1","0","1","2","1","1","-2"
"139755","Georgia Institute of Technology-Main Campus","2012","Not on tenure/no tenure system, associate professors","1","1","0","0","0","0","1","1","0","0","0","0","0","0","0","0","0","0","0","0","0","0","0","0","0","0","0","0","0","0","-2"
"139755","Georgia Institute of Technology-Main Campus","2012","Not on tenure/no tenure system, assistant professors","1","1","0","0","0","0","0","0","0","0","0","0","0","0","0","0","0","0","1","1","0","0","0","0","0","0","0","0","0","0","-2"
"139755","Georgia Institute of Technology-Main Campus","2012","Not on tenure/no tenure system, instructors","48","16","32","0","0","0","3","2","1","0","0","0","0","0","0","0","0","0","44","14","30","0","0","0","0","0","0","1","0","1","-2"
"139755","Georgia Institute of Technology-Main Campus","2012","Not on tenure/no tenure system, lecturers","42","18","24","0","0","0","6","3","3","0","0","0","2","0","2","0","0","0","32","14","18","0","0","0","1","0","1","1","1","0","-2"
"139755","Georgia Institute of Technology-Main Campus","2012","Not on tenure/no tenure system, no academic rank","1","0","1","0","0","0","0","0","0","0","0","0","0","0","0","0","0","0","1","0","1","0","0","0","0","0","0","0","0","0","-2"
"139959","University of Georgia","2012","Tenured total","1192","826","366","3","2","1","94","66","28","71","39","32","39","26","13","0","0","0","974","685","289","5","3","2","6","5","1","0","0","0","-2"
"139959","University of Georgia","2012","Tenured, professors","716","545","171","3","2","1","45","37","8","41","25","16","22","14","8","0","0","0","598","461","137","2","2","0","5","4","1","0","0","0","-2"
"139959","University of Georgia","2012","Tenured, associate professors","474","280","194","0","0","0","49","29","20","30","14","16","17","12","5","0","0","0","374","223","151","3","1","2","1","1","0","0","0","0","-2"
"139959","University of Georgia","2012","Tenured, assistant professors","2","1","1","0","0","0","0","0","0","0","0","0","0","0","0","0","0","0","2","1","1","0","0","0","0","0","0","0","0","0","-2"
"139959","University of Georgia","2012","On-Tenure track total","386","222","164","0","0","0","61","43","18","17","7","10","21","10","11","0","0","0","255","143","112","2","0","2","14","8","6","16","11","5","-2"
"139959","University of Georgia","2012","On-tenure track, professors","2","1","1","0","0","0","0","0","0","0","0","0","0","0","0","0","0","0","2","1","1","0","0","0","0","0","0","0","0","0","-2"
"139959","University of Georgia","2012","On-tenure track, associate professors","20","14","6","0","0","0","3","3","0","1","1","0","1","1","0","0","0","0","13","9","4","2","0","2","0","0","0","0","0","0","-2"
"139959","University of Georgia","2012","On-tenure track, assistant professors","363","206","157","0","0","0","58","40","18","16","6","10","20","9","11","0","0","0","239","132","107","0","0","0","14","8","6","16","11","5","-2"
"139959","University of Georgia","2012","On-tenure track, instructors","1","1","0","0","0","0","0","0","0","0","0","0","0","0","0","0","0","0","1","1","0","0","0","0","0","0","0","0","0","0","-2"
"139959","University of Georgia","2012","Not on tenure track/No tenure system system total","263","109","154","2","0","2","15","4","11","16","6","10","7","1","6","0","0","0","215","95","120","2","0","2","2","1","1","4","2","2","-2"
"139959","University of Georgia","2012","Not on tenure/no tenure system, professors","9","6","3","0","0","0","0","0","0","0","0","0","0","0","0","0","0","0","9","6","3","0","0","0","0","0","0","0","0","0","-2"
"139959","University of Georgia","2012","Not on tenure/no tenure system, associate professors","21","12","9","0","0","0","0","0","0","1","0","1","0","0","0","0","0","0","20","12","8","0","0","0","0","0","0","0","0","0","-2"
"139959","University of Georgia","2012","Not on tenure/no tenure system, assistant professors","38","9","29","1","0","1","7","1","6","1","0","1","1","0","1","0","0","0","25","7","18","1","0","1","1","0","1","1","1","0","-2"
"139959","University of Georgia","2012","Not on tenure/no tenure system, instructors","44","16","28","1","0","1","2","2","0","1","1","0","1","0","1","0","0","0","36","11","25","1","0","1","1","1","0","1","1","0","-2"
"139959","University of Georgia","2012","Not on tenure/no tenure system, lecturers","151","66","85","0","0","0","6","1","5","13","5","8","5","1","4","0","0","0","125","59","66","0","0","0","0","0","0","2","0","2","-2"
"140720","Paine College","2012","Tenured total","5","5","0","0","0","0","0","0","0","1","1","0","0","0","0","3","3","0","1","1","0","0","0","0","0","0","0","0","0","0","-2"
"140720","Paine College","2012","Tenured, professors","5","5","0","0","0","0","0","0","0","1","1","0","0","0","0","3","3","0","1","1","0","0","0","0","0","0","0","0","0","0","-2"
"140720","Paine College","2012","On-Tenure track total","33","14","19","0","0","0","3","2","1","27","10","17","2","1","1","0","0","0","0","0","0","0","0","0","0","0","0","1","1","0","-2"
"140720","Paine College","2012","On-tenure track, assistant professors","33","14","19","0","0","0","3","2","1","27","10","17","2","1","1","0","0","0","0","0","0","0","0","0","0","0","0","1","1","0","-2"
"140720","Paine College","2012","Not on tenure track/No tenure system system total","16","3","13","0","0","0","0","0","0","14","2","12","0","0","0","0","0","0","0","0","0","0","0","0","1","0","1","1","1","0","-2"
"140720","Paine College","2012","Not on tenure/no tenure system, associate professors","2","1","1","0","0","0","0","0","0","2","1","1","0","0","0","0","0","0","0","0","0","0","0","0","0","0","0","0","0","0","-2"
"140720","Paine College","2012","Not on tenure/no tenure system, assistant professors","10","2","8","0","0","0","0","0","0","8","1","7","0","0","0","0","0","0","0","0","0","0","0","0","1","0","1","1","1","0","-2"
"140720","Paine College","2012","Not on tenure/no tenure system, instructors","4","0","4","0","0","0","0","0","0","4","0","4","0","0","0","0","0","0","0","0","0","0","0","0","0","0","0","0","0","0","-2"
"140960","Savannah State University","2012","Tenured total","44","30","14","0","0","0","16","12","4","21","14","7","0","0","0","0","0","0","6","3","3","0","0","0","0","0","0","1","1","0","-2"
"140960","Savannah State University","2012","Tenured, professors","19","15","4","0","0","0","8","7","1","10","7","3","0","0","0","0","0","0","1","1","0","0","0","0","0","0","0","0","0","0","-2"
"140960","Savannah State University","2012","Tenured, associate professors","19","11","8","0","0","0","7","5","2","9","6","3","0","0","0","0","0","0","3","0","3","0","0","0","0","0","0","0","0","0","-2"
"140960","Savannah State University","2012","Tenured, assistant professors","6","4","2","0","0","0","1","0","1","2","1","1","0","0","0","0","0","0","2","2","0","0","0","0","0","0","0","1","1","0","-2"
"140960","Savannah State University","2012","On-Tenure track total","56","33","23","0","0","0","4","4","0","17","11","6","0","0","0","0","0","0","13","7","6","0","0","0","4","1","3","18","10","8","-2"
"140960","Savannah State University","2012","On-tenure track, professors","2","2","0","0","0","0","1","1","0","1","1","0","0","0","0","0","0","0","0","0","0","0","0","0","0","0","0","0","0","0","-2"
"140960","Savannah State University","2012","On-tenure track, associate professors","14","9","5","0","0","0","1","1","0","3","3","0","0","0","0","0","0","0","6","3","3","0","0","0","0","0","0","4","2","2","-2"
"140960","Savannah State University","2012","On-tenure track, assistant professors","40","22","18","0","0","0","2","2","0","13","7","6","0","0","0","0","0","0","7","4","3","0","0","0","4","1","3","14","8","6","-2"
"140960","Savannah State University","2012","Not on tenure track/No tenure system system total","54","23","31","0","0","0","5","4","1","22","5","17","0","0","0","0","0","0","21","12","9","1","0","1","2","0","2","3","2","1","-2"
"140960","Savannah State University","2012","Not on tenure/no tenure system, professors","1","1","0","0","0","0","1","1","0","0","0","0","0","0","0","0","0","0","0","0","0","0","0","0","0","0","0","0","0","0","-2"
"140960","Savannah State University","2012","Not on tenure/no tenure system, associate professors","1","1","0","0","0","0","0","0","0","0","0","0","0","0","0","0","0","0","1","1","0","0","0","0","0","0","0","0","0","0","-2"
"140960","Savannah State University","2012","Not on tenure/no tenure system, assistant professors","5","2","3","0","0","0","1","1","0","1","0","1","0","0","0","0","0","0","3","1","2","0","0","0","0","0","0","0","0","0","-2"
"140960","Savannah State University","2012","Not on tenure/no tenure system, instructors","31","12","19","0","0","0","3","2","1","10","0","10","0","0","0","0","0","0","12","8","4","1","0","1","2","0","2","3","2","1","-2"
"140960","Savannah State University","2012","Not on tenure/no tenure system, lecturers","8","3","5","0","0","0","0","0","0","4","2","2","0","0","0","0","0","0","4","1","3","0","0","0","0","0","0","0","0","0","-2"
"140960","Savannah State University","2012","Not on tenure/no tenure system, no academic rank","8","4","4","0","0","0","0","0","0","7","3","4","0","0","0","0","0","0","1","1","0","0","0","0","0","0","0","0","0","0","-2"
"141060","Spelman College","2012","Tenured total","88","31","57","0","0","0","10","4","6","51","15","36","6","2","4","0","0","0","19","10","9","0","0","0","2","0","2","0","0","0","-2"
"141060","Spelman College","2012","Tenured, professors","31","11","20","0","0","0","4","1","3","19","6","13","1","0","1","0","0","0","7","4","3","0","0","0","0","0","0","0","0","0","-2"
"141060","Spelman College","2012","Tenured, associate professors","57","20","37","0","0","0","6","3","3","32","9","23","5","2","3","0","0","0","12","6","6","0","0","0","2","0","2","0","0","0","-2"
"141060","Spelman College","2012","On-Tenure track total","36","12","24","2","1","1","3","2","1","26","7","19","1","0","1","0","0","0","3","1","2","1","1","0","0","0","0","0","0","0","-2"
"141060","Spelman College","2012","On-tenure track, assistant professors","36","12","24","2","1","1","3","2","1","26","7","19","1","0","1","0","0","0","3","1","2","1","1","0","0","0","0","0","0","0","-2"
"141060","Spelman College","2012","Not on tenure track/No tenure system system total","50","9","41","0","0","0","2","0","2","38","8","30","4","1","3","0","0","0","4","0","4","0","0","0","2","0","2","0","0","0","-2"
"141060","Spelman College","2012","Not on tenure/no tenure system, instructors","21","3","18","0","0","0","0","0","0","17","3","14","2","0","2","0","0","0","1","0","1","0","0","0","1","0","1","0","0","0","-2"
"141060","Spelman College","2012","Not on tenure/no tenure system, lecturers","29","6","23","0","0","0","2","0","2","21","5","16","2","1","1","0","0","0","3","0","3","0","0","0","1","0","1","0","0","0","-2"
"141574","University of Hawaii at Manoa","2012","Tenured total","749","486","263","1","1","0","192","116","76","5","0","5","12","6","6","26","7","19","493","345","148","3","0","3","0","0","0","17","11","6","-2"
"141574","University of Hawaii at Manoa","2012","Tenured, professors","462","332","130","1","1","0","106","76","30","2","0","2","4","2","2","10","3","7","334","247","87","2","0","2","0","0","0","3","3","0","-2"
"141574","University of Hawaii at Manoa","2012","Tenured, associate professors","285","153","132","0","0","0","85","40","45","3","0","3","8","4","4","16","4","12","159","98","61","1","0","1","0","0","0","13","7","6","-2"
"141574","University of Hawaii at Manoa","2012","Tenured, assistant professors","2","1","1","0","0","0","1","0","1","0","0","0","0","0","0","0","0","0","0","0","0","0","0","0","0","0","0","1","1","0","-2"
"141574","University of Hawaii at Manoa","2012","On-Tenure track total","274","136","138","2","0","2","66","36","30","3","2","1","6","4","2","24","12","12","122","61","61","9","3","6","0","0","0","42","18","24","-2"
"141574","University of Hawaii at Manoa","2012","On-tenure track, professors","8","6","2","1","0","1","3","3","0","1","1","0","0","0","0","0","0","0","3","2","1","0","0","0","0","0","0","0","0","0","-2"
"141574","University of Hawaii at Manoa","2012","On-tenure track, associate professors","17","10","7","0","0","0","3","3","0","0","0","0","0","0","0","2","2","0","8","3","5","0","0","0","0","0","0","4","2","2","-2"
"141574","University of Hawaii at Manoa","2012","On-tenure track, assistant professors","249","120","129","1","0","1","60","30","30","2","1","1","6","4","2","22","10","12","111","56","55","9","3","6","0","0","0","38","16","22","-2"
"141574","University of Hawaii at Manoa","2012","Not on tenure track/No tenure system system total","255","96","159","1","0","1","77","27","50","5","1","4","9","4","5","28","8","20","117","51","66","6","1","5","0","0","0","12","4","8","-2"
"141574","University of Hawaii at Manoa","2012","Not on tenure/no tenure system, professors","17","12","5","0","0","0","5","3","2","0","0","0","0","0","0","1","1","0","10","7","3","0","0","0","0","0","0","1","1","0","-2"
"141574","University of Hawaii at Manoa","2012","Not on tenure/no tenure system, associate professors","28","16","12","0","0","0","9","5","4","0","0","0","0","0","0","1","0","1","18","11","7","0","0","0","0","0","0","0","0","0","-2"
"141574","University of Hawaii at Manoa","2012","Not on tenure/no tenure system, assistant professors","78","29","49","1","0","1","25","10","15","3","1","2","3","1","2","5","2","3","35","14","21","0","0","0","0","0","0","6","1","5","-2"
"141574","University of Hawaii at Manoa","2012","Not on tenure/no tenure system, instructors","132","39","93","0","0","0","38","9","29","2","0","2","6","3","3","21","5","16","54","19","35","6","1","5","0","0","0","5","2","3","-2"
"141644","Hawaii Pacific University","2012","Tenured total","4","4","0","0","0","0","1","1","0","0","0","0","0","0","0","0","0","0","3","3","0","0","0","0","0","0","0","0","0","0","-2"
"141644","Hawaii Pacific University","2012","Tenured, professors","3","3","0","0","0","0","1","1","0","0","0","0","0","0","0","0","0","0","2","2","0","0","0","0","0","0","0","0","0","0","-2"
"141644","Hawaii Pacific University","2012","Tenured, associate professors","1","1","0","0","0","0","0","0","0","0","0","0","0","0","0","0","0","0","1","1","0","0","0","0","0","0","0","0","0","0","-2"
"141644","Hawaii Pacific University","2012","Not on tenure track/No tenure system system total","235","123","112","1","0","1","45","19","26","1","0","1","3","0","3","4","1","3","164","97","67","16","6","10","1","0","1","0","0","0","-2"
"141644","Hawaii Pacific University","2012","Not on tenure/no tenure system, professors","25","18","7","0","0","0","1","1","0","0","0","0","0","0","0","0","0","0","24","17","7","0","0","0","0","0","0","0","0","0","-2"
"141644","Hawaii Pacific University","2012","Not on tenure/no tenure system, associate professors","63","37","26","1","0","1","11","7","4","0","0","0","0","0","0","1","0","1","42","27","15","8","3","5","0","0","0","0","0","0","-2"
"141644","Hawaii Pacific University","2012","Not on tenure/no tenure system, assistant professors","109","45","64","0","0","0","26","7","19","1","0","1","2","0","2","1","0","1","73","37","36","5","1","4","1","0","1","0","0","0","-2"
"141644","Hawaii Pacific University","2012","Not on tenure/no tenure system, instructors","38","23","15","0","0","0","7","4","3","0","0","0","1","0","1","2","1","1","25","16","9","3","2","1","0","0","0","0","0","0","-2"
"142115","Boise State University","2012","Tenured total","355","208","147","2","1","1","13","11","2","2","2","0","9","5","4","0","0","0","317","180","137","3","2","1","0","0","0","9","7","2","-2"
"142115","Boise State University","2012","Tenured, professors","157","109","48","1","1","0","5","4","1","0","0","0","2","2","0","0","0","0","145","99","46","1","1","0","0","0","0","3","2","1","-2"
"142115","Boise State University","2012","Tenured, associate professors","183","94","89","1","0","1","8","7","1","2","2","0","7","3","4","0","0","0","158","77","81","2","1","1","0","0","0","5","4","1","-2"
"142115","Boise State University","2012","Tenured, assistant professors","15","5","10","0","0","0","0","0","0","0","0","0","0","0","0","0","0","0","14","4","10","0","0","0","0","0","0","1","1","0","-2"
"142115","Boise State University","2012","On-Tenure track total","125","65","60","2","1","1","10","7","3","0","0","0","5","1","4","0","0","0","96","46","50","0","0","0","0","0","0","12","10","2","-2"
"142115","Boise State University","2012","On-tenure track, associate professors","4","2","2","1","0","1","0","0","0","0","0","0","1","0","1","0","0","0","2","2","0","0","0","0","0","0","0","0","0","0","-2"
"142115","Boise State University","2012","On-tenure track, assistant professors","121","63","58","1","1","0","10","7","3","0","0","0","4","1","3","0","0","0","94","44","50","0","0","0","0","0","0","12","10","2","-2"
"142115","Boise State University","2012","Not on tenure track/No tenure system system total","132","49","83","1","1","0","4","1","3","1","0","1","1","1","0","0","0","0","121","45","76","1","0","1","0","0","0","3","1","2","-2"
"142115","Boise State University","2012","Not on tenure/no tenure system, professors","1","0","1","0","0","0","0","0","0","0","0","0","0","0","0","0","0","0","1","0","1","0","0","0","0","0","0","0","0","0","-2"
"142115","Boise State University","2012","Not on tenure/no tenure system, associate professors","1","1","0","0","0","0","0","0","0","0","0","0","0","0","0","0","0","0","1","1","0","0","0","0","0","0","0","0","0","0","-2"
"142115","Boise State University","2012","Not on tenure/no tenure system, assistant professors","2","0","2","0","0","0","0","0","0","0","0","0","0","0","0","0","0","0","2","0","2","0","0","0","0","0","0","0","0","0","-2"
"142115","Boise State University","2012","Not on tenure/no tenure system, no academic rank","128","48","80","1","1","0","4","1","3","1","0","1","1","1","0","0","0","0","117","44","73","1","0","1","0","0","0","3","1","2","-2"
"142294","The College of Idaho","2012","Tenured total","37","23","14","0","0","0","2","0","2","0","0","0","0","0","0","0","0","0","34","23","11","0","0","0","0","0","0","1","0","1","-2"
"142294","The College of Idaho","2012","Tenured, professors","30","20","10","0","0","0","2","0","2","0","0","0","0","0","0","0","0","0","28","20","8","0","0","0","0","0","0","0","0","0","-2"
"142294","The College of Idaho","2012","Tenured, associate professors","6","3","3","0","0","0","0","0","0","0","0","0","0","0","0","0","0","0","5","3","2","0","0","0","0","0","0","1","0","1","-2"
"142294","The College of Idaho","2012","Tenured, no academic rank","1","0","1","0","0","0","0","0","0","0","0","0","0","0","0","0","0","0","1","0","1","0","0","0","0","0","0","0","0","0","-2"
"142294","The College of Idaho","2012","On-Tenure track total","19","12","7","0","0","0","0","0","0","0","0","0","0","0","0","1","1","0","17","11","6","0","0","0","1","0","1","0","0","0","-2"
"142294","The College of Idaho","2012","On-tenure track, professors","1","1","0","0","0","0","0","0","0","0","0","0","0","0","0","0","0","0","1","1","0","0","0","0","0","0","0","0","0","0","-2"
"142294","The College of Idaho","2012","On-tenure track, associate professors","1","0","1","0","0","0","0","0","0","0","0","0","0","0","0","0","0","0","0","0","0","0","0","0","1","0","1","0","0","0","-2"
"142294","The College of Idaho","2012","On-tenure track, assistant professors","17","11","6","0","0","0","0","0","0","0","0","0","0","0","0","1","1","0","16","10","6","0","0","0","0","0","0","0","0","0","-2"
"142294","The College of Idaho","2012","Not on tenure track/No tenure system system total","23","12","11","0","0","0","0","0","0","0","0","0","0","0","0","1","1","0","21","10","11","0","0","0","0","0","0","1","1","0","-2"
"142294","The College of Idaho","2012","Not on tenure/no tenure system, assistant professors","5","3","2","0","0","0","0","0","0","0","0","0","0","0","0","0","0","0","5","3","2","0","0","0","0","0","0","0","0","0","-2"
"142294","The College of Idaho","2012","Not on tenure/no tenure system, instructors","15","6","9","0","0","0","0","0","0","0","0","0","0","0","0","1","1","0","14","5","9","0","0","0","0","0","0","0","0","0","-2"
"142294","The College of Idaho","2012","Not on tenure/no tenure system, no academic rank","3","3","0","0","0","0","0","0","0","0","0","0","0","0","0","0","0","0","2","2","0","0","0","0","0","0","0","1","1","0","-2"
"144050","University of Chicago","2012","Tenured total","772","595","177","0","0","0","86","72","14","21","16","5","25","21","4","0","0","0","632","480","152","6","5","1","0","0","0","2","1","1","-2"
"144050","University of Chicago","2012","Tenured, professors","605","484","121","0","0","0","61","56","5","11","8","3","19","16","3","0","0","0","509","400","109","3","3","0","0","0","0","2","1","1","-2"
"144050","University of Chicago","2012","Tenured, associate professors","167","111","56","0","0","0","25","16","9","10","8","2","6","5","1","0","0","0","123","80","43","3","2","1","0","0","0","0","0","0","-2"
"144050","University of Chicago","2012","On-Tenure track total","329","219","110","0","0","0","48","28","20","11","7","4","9","8","1","0","0","0","213","142","71","4","3","1","0","0","0","44","31","13","-2"
"144050","University of Chicago","2012","On-tenure track, professors","2","2","0","0","0","0","0","0","0","0","0","0","0","0","0","0","0","0","0","0","0","0","0","0","0","0","0","2","2","0","-2"
"144050","University of Chicago","2012","On-tenure track, associate professors","40","30","10","0","0","0","5","5","0","1","0","1","2","2","0","0","0","0","29","20","9","0","0","0","0","0","0","3","3","0","-2"
"144050","University of Chicago","2012","On-tenure track, assistant professors","280","182","98","0","0","0","42","23","19","10","7","3","7","6","1","0","0","0","181","120","61","4","3","1","0","0","0","36","23","13","-2"
"144050","University of Chicago","2012","On-tenure track, instructors","7","5","2","0","0","0","1","0","1","0","0","0","0","0","0","0","0","0","3","2","1","0","0","0","0","0","0","3","3","0","-2"
"144050","University of Chicago","2012","Not on tenure track/No tenure system system total","864","503","361","0","0","0","158","88","70","36","13","23","13","7","6","0","0","0","592","357","235","3","0","3","2","1","1","60","37","23","-2"
"144050","University of Chicago","2012","Not on tenure/no tenure system, professors","167","132","35","0","0","0","16","10","6","5","3","2","0","0","0","0","0","0","141","115","26","0","0","0","0","0","0","5","4","1","-2"
"144050","University of Chicago","2012","Not on tenure/no tenure system, associate professors","180","114","66","0","0","0","34","23","11","8","4","4","3","1","2","0","0","0","133","85","48","1","0","1","0","0","0","1","1","0","-2"
"144050","University of Chicago","2012","Not on tenure/no tenure system, assistant professors","248","122","126","0","0","0","67","36","31","16","3","13","4","2","2","0","0","0","154","78","76","1","0","1","0","0","0","6","3","3","-2"
"144050","University of Chicago","2012","Not on tenure/no tenure system, instructors","87","47","40","0","0","0","10","5","5","2","1","1","0","0","0","0","0","0","44","20","24","0","0","0","1","1","0","30","20","10","-2"
"144050","University of Chicago","2012","Not on tenure/no tenure system, lecturers","138","66","72","0","0","0","17","8","9","2","2","0","4","2","2","0","0","0","101","48","53","0","0","0","0","0","0","14","6","8","-2"
"144050","University of Chicago","2012","Not on tenure/no tenure system, no academic rank","44","22","22","0","0","0","14","6","8","3","0","3","2","2","0","0","0","0","19","11","8","1","0","1","1","0","1","4","3","1","-2"
"145637","University of Illinois at Urbana-Champaign","2012","Tenured total","1269","926","343","4","1","3","173","142","31","46","27","19","65","43","22","2","1","1","967","702","265","6","4","2","3","3","0","3","3","0","-2"
"145637","University of Illinois at Urbana-Champaign","2012","Tenured, professors","754","600","154","2","1","1","84","75","9","22","16","6","33","23","10","0","0","0","605","477","128","2","2","0","3","3","0","3","3","0","-2"
"145637","University of Illinois at Urbana-Champaign","2012","Tenured, associate professors","480","304","176","2","0","2","81","60","21","24","11","13","28","18","10","1","1","0","340","212","128","4","2","2","0","0","0","0","0","0","-2"
"145637","University of Illinois at Urbana-Champaign","2012","Tenured, assistant professors","35","22","13","0","0","0","8","7","1","0","0","0","4","2","2","1","0","1","22","13","9","0","0","0","0","0","0","0","0","0","-2"
"145637","University of Illinois at Urbana-Champaign","2012","On-Tenure track total","399","234","165","2","2","0","68","38","30","34","16","18","23","13","10","0","0","0","217","130","87","5","2","3","8","5","3","42","28","14","-2"
"145637","University of Illinois at Urbana-Champaign","2012","On-tenure track, professors","6","4","2","0","0","0","0","0","0","2","2","0","0","0","0","0","0","0","1","0","1","0","0","0","0","0","0","3","2","1","-2"
"145637","University of Illinois at Urbana-Champaign","2012","On-tenure track, associate professors","10","7","3","0","0","0","3","2","1","1","0","1","0","0","0","0","0","0","5","4","1","0","0","0","1","1","0","0","0","0","-2"
"145637","University of Illinois at Urbana-Champaign","2012","On-tenure track, assistant professors","381","223","158","2","2","0","65","36","29","31","14","17","23","13","10","0","0","0","209","126","83","5","2","3","7","4","3","39","26","13","-2"
"145637","University of Illinois at Urbana-Champaign","2012","On-tenure track, lecturers","2","0","2","0","0","0","0","0","0","0","0","0","0","0","0","0","0","0","2","0","2","0","0","0","0","0","0","0","0","0","-2"
"145637","University of Illinois at Urbana-Champaign","2012","Not on tenure track/No tenure system system total","427","218","209","0","0","0","21","14","7","12","5","7","14","10","4","0","0","0","351","168","183","3","3","0","5","5","0","21","13","8","-2"
"145637","University of Illinois at Urbana-Champaign","2012","Not on tenure/no tenure system, professors","21","16","5","0","0","0","1","1","0","0","0","0","1","1","0","0","0","0","18","14","4","0","0","0","0","0","0","1","0","1","-2"
"145637","University of Illinois at Urbana-Champaign","2012","Not on tenure/no tenure system, associate professors","19","6","13","0","0","0","1","1","0","1","0","1","0","0","0","0","0","0","17","5","12","0","0","0","0","0","0","0","0","0","-2"
"145637","University of Illinois at Urbana-Champaign","2012","Not on tenure/no tenure system, assistant professors","90","46","44","0","0","0","5","3","2","3","0","3","3","3","0","0","0","0","66","30","36","1","1","0","3","3","0","9","6","3","-2"
"145637","University of Illinois at Urbana-Champaign","2012","Not on tenure/no tenure system, instructors","71","29","42","0","0","0","3","3","0","3","1","2","3","1","2","0","0","0","60","23","37","0","0","0","0","0","0","2","1","1","-2"
"145637","University of Illinois at Urbana-Champaign","2012","Not on tenure/no tenure system, lecturers","176","98","78","0","0","0","8","4","4","4","3","1","7","5","2","0","0","0","145","77","68","1","1","0","2","2","0","9","6","3","-2"
"145637","University of Illinois at Urbana-Champaign","2012","Not on tenure/no tenure system, no academic rank","50","23","27","0","0","0","3","2","1","1","1","0","0","0","0","0","0","0","45","19","26","1","1","0","0","0","0","0","0","0","-2"
"147703","Northern Illinois University","2012","Tenured total","501","305","196","0","0","0","40","31","9","15","8","7","12","4","8","0","0","0","383","234","149","4","2","2","5","4","1","42","22","20","-2"
"147703","Northern Illinois University","2012","Tenured, professors","207","150","57","0","0","0","25","21","4","4","3","1","5","1","4","0","0","0","163","117","46","3","1","2","2","2","0","5","5","0","-2"
"147703","Northern Illinois University","2012","Tenured, associate professors","289","153","136","0","0","0","15","10","5","10","5","5","7","3","4","0","0","0","216","115","101","1","1","0","3","2","1","37","17","20","-2"
"147703","Northern Illinois University","2012","Tenured, assistant professors","5","2","3","0","0","0","0","0","0","1","0","1","0","0","0","0","0","0","4","2","2","0","0","0","0","0","0","0","0","0","-2"
"147703","Northern Illinois University","2012","On-Tenure track total","214","109","105","2","0","2","17","12","5","7","3","4","5","4","1","0","0","0","132","66","66","1","1","0","2","0","2","48","23","25","-2"
"147703","Northern Illinois University","2012","On-tenure track, professors","3","2","1","0","0","0","0","0","0","0","0","0","0","0","0","0","0","0","3","2","1","0","0","0","0","0","0","0","0","0","-2"
"147703","Northern Illinois University","2012","On-tenure track, associate professors","8","6","2","0","0","0","1","1","0","0","0","0","1","1","0","0","0","0","4","2","2","0","0","0","0","0","0","2","2","0","-2"
"147703","Northern Illinois University","2012","On-tenure track, assistant professors","195","99","96","1","0","1","15","11","4","7","3","4","4","3","1","0","0","0","121","62","59","0","0","0","2","0","2","45","20","25","-2"
"147703","Northern Illinois University","2012","On-tenure track, instructors","7","2","5","1","0","1","1","0","1","0","0","0","0","0","0","0","0","0","3","0","3","1","1","0","0","0","0","1","1","0","-2"
"147703","Northern Illinois University","2012","On-tenure track, no academic rank","1","0","1","0","0","0","0","0","0","0","0","0","0","0","0","0","0","0","1","0","1","0","0","0","0","0","0","0","0","0","-2"
"147703","Northern Illinois University","2012","Not on tenure track/No tenure system system total","218","93","125","0","0","0","7","2","5","5","4","1","7","3","4","0","0","0","178","72","106","0","0","0","1","0","1","20","12","8","-2"
"147703","Northern Illinois University","2012","Not on tenure/no tenure system, professors","1","0","1","0","0","0","0","0","0","0","0","0","0","0","0","0","0","0","0","0","0","0","0","0","0","0","0","1","0","1","-2"
"147703","Northern Illinois University","2012","Not on tenure/no tenure system, associate professors","2","2","0","0","0","0","0","0","0","0","0","0","0","0","0","0","0","0","2","2","0","0","0","0","0","0","0","0","0","0","-2"
"147703","Northern Illinois University","2012","Not on tenure/no tenure system, assistant professors","16","9","7","0","0","0","0","0","0","1","1","0","1","1","0","0","0","0","12","5","7","0","0","0","0","0","0","2","2","0","-2"
"147703","Northern Illinois University","2012","Not on tenure/no tenure system, instructors","167","65","102","0","0","0","7","2","5","4","3","1","6","2","4","0","0","0","147","57","90","0","0","0","1","0","1","2","1","1","-2"
"147703","Northern Illinois University","2012","Not on tenure/no tenure system, no academic rank","32","17","15","0","0","0","0","0","0","0","0","0","0","0","0","0","0","0","17","8","9","0","0","0","0","0","0","15","9","6","-2"
"147767","Northwestern University","2012","Tenured total","958","711","247","0","0","0","111","89","22","33","20","13","29","22","7","0","0","0","775","576","199","3","0","3","5","3","2","2","1","1","-2"
"147767","Northwestern University","2012","Tenured, professors","670","520","150","0","0","0","73","64","9","14","7","7","15","11","4","0","0","0","564","435","129","0","0","0","2","2","0","2","1","1","-2"
"147767","Northwestern University","2012","Tenured, associate professors","288","191","97","0","0","0","38","25","13","19","13","6","14","11","3","0","0","0","211","141","70","3","0","3","3","1","2","0","0","0","-2"
"147767","Northwestern University","2012","On-Tenure track total","301","188","113","0","0","0","53","33","20","18","7","11","14","8","6","0","0","0","182","118","64","1","1","0","1","0","1","32","21","11","-2"
"147767","Northwestern University","2012","On-tenure track, associate professors","32","23","9","0","0","0","11","8","3","0","0","0","1","1","0","0","0","0","19","14","5","0","0","0","0","0","0","1","0","1","-2"
"147767","Northwestern University","2012","On-tenure track, assistant professors","269","165","104","0","0","0","42","25","17","18","7","11","13","7","6","0","0","0","163","104","59","1","1","0","1","0","1","31","21","10","-2"
"147767","Northwestern University","2012","Not on tenure track/No tenure system system total","798","423","375","0","0","0","101","45","56","21","12","9","25","17","8","0","0","0","611","328","283","0","0","0","9","3","6","31","18","13","-2"
"147767","Northwestern University","2012","Not on tenure/no tenure system, professors","119","91","28","0","0","0","10","6","4","3","2","1","2","2","0","0","0","0","103","80","23","0","0","0","0","0","0","1","1","0","-2"
"147767","Northwestern University","2012","Not on tenure/no tenure system, associate professors","144","87","57","0","0","0","25","13","12","4","3","1","5","4","1","0","0","0","107","65","42","0","0","0","1","0","1","2","2","0","-2"
"147767","Northwestern University","2012","Not on tenure/no tenure system, assistant professors","218","108","110","0","0","0","39","16","23","7","3","4","9","5","4","0","0","0","156","80","76","0","0","0","1","0","1","6","4","2","-2"
"147767","Northwestern University","2012","Not on tenure/no tenure system, instructors","37","19","18","0","0","0","7","6","1","1","1","0","0","0","0","0","0","0","27","10","17","0","0","0","1","1","0","1","1","0","-2"
"147767","Northwestern University","2012","Not on tenure/no tenure system, lecturers","280","118","162","0","0","0","20","4","16","6","3","3","9","6","3","0","0","0","218","93","125","0","0","0","6","2","4","21","10","11","-2"
"149772","Western Illinois University","2012","Tenured total","356","230","126","4","2","2","32","23","9","18","11","7","7","2","5","0","0","0","290","188","102","4","3","1","0","0","0","1","1","0","-2"
"149772","Western Illinois University","2012","Tenured, professors","204","142","62","2","2","0","18","16","2","10","6","4","5","2","3","0","0","0","167","115","52","2","1","1","0","0","0","0","0","0","-2"
"149772","Western Illinois University","2012","Tenured, associate professors","146","84","62","2","0","2","14","7","7","8","5","3","2","0","2","0","0","0","118","70","48","2","2","0","0","0","0","0","0","0","-2"
"149772","Western Illinois University","2012","Tenured, assistant professors","6","4","2","0","0","0","0","0","0","0","0","0","0","0","0","0","0","0","5","3","2","0","0","0","0","0","0","1","1","0","-2"
"149772","Western Illinois University","2012","On-Tenure track total","170","92","78","0","0","0","21","10","11","11","9","2","5","3","2","0","0","0","112","57","55","1","1","0","3","3","0","17","9","8","-2"
"149772","Western Illinois University","2012","On-tenure track, associate professors","14","12","2","0","0","0","3","2","1","1","1","0","0","0","0","0","0","0","9","8","1","1","1","0","0","0","0","0","0","0","-2"
"149772","Western Illinois University","2012","On-tenure track, assistant professors","155","80","75","0","0","0","18","8","10","10","8","2","5","3","2","0","0","0","102","49","53","0","0","0","3","3","0","17","9","8","-2"
"149772","Western Illinois University","2012","On-tenure track, instructors","1","0","1","0","0","0","0","0","0","0","0","0","0","0","0","0","0","0","1","0","1","0","0","0","0","0","0","0","0","0","-2"
"149772","Western Illinois University","2012","Not on tenure track/No tenure system system total","138","50","88","0","0","0","5","1","4","4","1","3","0","0","0","0","0","0","121","42","79","0","0","0","5","4","1","3","2","1","-2"
"149772","Western Illinois University","2012","Not on tenure/no tenure system, assistant professors","22","11","11","0","0","0","1","0","1","0","0","0","0","0","0","0","0","0","19","9","10","0","0","0","0","0","0","2","2","0","-2"
"149772","Western Illinois University","2012","Not on tenure/no tenure system, instructors","107","37","70","0","0","0","4","1","3","4","1","3","0","0","0","0","0","0","94","31","63","0","0","0","5","4","1","0","0","0","-2"
"149772","Western Illinois University","2012","Not on tenure/no tenure system, lecturers","9","2","7","0","0","0","0","0","0","0","0","0","0","0","0","0","0","0","8","2","6","0","0","0","0","0","0","1","0","1","-2"
"151351","Indiana University-Bloomington","2012","Tenured total","987","690","297","1","1","0","71","50","21","33","17","16","37","25","12","0","0","0","837","589","248","7","7","0","1","1","0","0","0","0","-2"
"151351","Indiana University-Bloomington","2012","Tenured, professors","627","472","155","0","0","0","32","26","6","15","6","9","17","12","5","0","0","0","558","423","135","4","4","0","1","1","0","0","0","0","-2"
"151351","Indiana University-Bloomington","2012","Tenured, associate professors","360","218","142","1","1","0","39","24","15","18","11","7","20","13","7","0","0","0","279","166","113","3","3","0","0","0","0","0","0","0","-2"
"151351","Indiana University-Bloomington","2012","On-Tenure track total","357","205","152","0","0","0","58","29","29","21","12","9","15","8","7","1","1","0","254","150","104","6","3","3","0","0","0","2","2","0","-2"
"151351","Indiana University-Bloomington","2012","On-tenure track, professors","1","1","0","0","0","0","0","0","0","0","0","0","0","0","0","0","0","0","1","1","0","0","0","0","0","0","0","0","0","0","-2"
"151351","Indiana University-Bloomington","2012","On-tenure track, associate professors","74","43","31","0","0","0","9","5","4","6","3","3","3","0","3","0","0","0","53","35","18","3","0","3","0","0","0","0","0","0","-2"
"151351","Indiana University-Bloomington","2012","On-tenure track, assistant professors","282","161","121","0","0","0","49","24","25","15","9","6","12","8","4","1","1","0","200","114","86","3","3","0","0","0","0","2","2","0","-2"
"151351","Indiana University-Bloomington","2012","Not on tenure track/No tenure system system total","534","260","274","1","0","1","35","15","20","25","17","8","24","13","11","0","0","0","442","212","230","5","1","4","0","0","0","2","2","0","-2"
"151351","Indiana University-Bloomington","2012","Not on tenure/no tenure system, professors","42","28","14","0","0","0","5","2","3","4","2","2","1","1","0","0","0","0","31","22","9","0","0","0","0","0","0","1","1","0","-2"
"151351","Indiana University-Bloomington","2012","Not on tenure/no tenure system, associate professors","49","25","24","0","0","0","4","1","3","2","1","1","1","1","0","0","0","0","42","22","20","0","0","0","0","0","0","0","0","0","-2"
"151351","Indiana University-Bloomington","2012","Not on tenure/no tenure system, assistant professors","92","44","48","0","0","0","6","5","1","2","2","0","1","0","1","0","0","0","82","36","46","1","1","0","0","0","0","0","0","0","-2"
"151351","Indiana University-Bloomington","2012","Not on tenure/no tenure system, instructors","1","1","0","0","0","0","0","0","0","0","0","0","0","0","0","0","0","0","1","1","0","0","0","0","0","0","0","0","0","0","-2"
"151351","Indiana University-Bloomington","2012","Not on tenure/no tenure system, lecturers","348","162","186","1","0","1","20","7","13","17","12","5","21","11","10","0","0","0","286","131","155","2","0","2","0","0","0","1","1","0","-2"
"151351","Indiana University-Bloomington","2012","Not on tenure/no tenure system, no academic rank","2","0","2","0","0","0","0","0","0","0","0","0","0","0","0","0","0","0","0","0","0","2","0","2","0","0","0","0","0","0","-2"
"152600","Valparaiso University","2012","Tenured total","157","105","52","2","2","0","5","5","0","3","2","1","2","1","1","0","0","0","140","92","48","0","0","0","2","0","2","3","3","0","-2"
"152600","Valparaiso University","2012","Tenured, professors","63","46","17","2","2","0","2","2","0","0","0","0","1","1","0","0","0","0","58","41","17","0","0","0","0","0","0","0","0","0","-2"
"152600","Valparaiso University","2012","Tenured, associate professors","84","52","32","0","0","0","3","3","0","2","1","1","1","0","1","0","0","0","74","46","28","0","0","0","2","0","2","2","2","0","-2"
"152600","Valparaiso University","2012","Tenured, assistant professors","10","7","3","0","0","0","0","0","0","1","1","0","0","0","0","0","0","0","8","5","3","0","0","0","0","0","0","1","1","0","-2"
"152600","Valparaiso University","2012","On-Tenure track total","58","27","31","0","0","0","1","0","1","4","2","2","0","0","0","0","0","0","45","21","24","0","0","0","6","3","3","2","1","1","-2"
"152600","Valparaiso University","2012","On-tenure track, professors","1","0","1","0","0","0","0","0","0","1","0","1","0","0","0","0","0","0","0","0","0","0","0","0","0","0","0","0","0","0","-2"
"152600","Valparaiso University","2012","On-tenure track, associate professors","4","3","1","0","0","0","0","0","0","0","0","0","0","0","0","0","0","0","3","2","1","0","0","0","1","1","0","0","0","0","-2"
"152600","Valparaiso University","2012","On-tenure track, assistant professors","52","24","28","0","0","0","1","0","1","3","2","1","0","0","0","0","0","0","41","19","22","0","0","0","5","2","3","2","1","1","-2"
"152600","Valparaiso University","2012","On-tenure track, instructors","1","0","1","0","0","0","0","0","0","0","0","0","0","0","0","0","0","0","1","0","1","0","0","0","0","0","0","0","0","0","-2"
"152600","Valparaiso University","2012","Not on tenure track/No tenure system system total","52","25","27","0","0","0","3","2","1","0","0","0","0","0","0","0","0","0","41","18","23","0","0","0","6","3","3","2","2","0","-2"
"152600","Valparaiso University","2012","Not on tenure/no tenure system, professors","5","3","2","0","0","0","0","0","0","0","0","0","0","0","0","0","0","0","5","3","2","0","0","0","0","0","0","0","0","0","-2"
"152600","Valparaiso University","2012","Not on tenure/no tenure system, assistant professors","23","9","14","0","0","0","2","1","1","0","0","0","0","0","0","0","0","0","19","7","12","0","0","0","1","0","1","1","1","0","-2"
"152600","Valparaiso University","2012","Not on tenure/no tenure system, instructors","5","4","1","0","0","0","1","1","0","0","0","0","0","0","0","0","0","0","3","2","1","0","0","0","1","1","0","0","0","0","-2"
"152600","Valparaiso University","2012","Not on tenure/no tenure system, lecturers","19","9","10","0","0","0","0","0","0","0","0","0","0","0","0","0","0","0","14","6","8","0","0","0","4","2","2","1","1","0","-2"
"153603","Iowa State University","2012","Tenured total","881","653","228","5","5","0","145","124","21","18","11","7","16","11","5","0","0","0","692","497","195","0","0","0","0","0","0","5","5","0","-2"
"153603","Iowa State University","2012","Tenured, professors","500","406","94","2","2","0","73","64","9","8","6","2","9","8","1","0","0","0","406","324","82","0","0","0","0","0","0","2","2","0","-2"
"153603","Iowa State University","2012","Tenured, associate professors","377","244","133","3","3","0","72","60","12","10","5","5","7","3","4","0","0","0","282","170","112","0","0","0","0","0","0","3","3","0","-2"
"153603","Iowa State University","2012","Tenured, assistant professors","4","3","1","0","0","0","0","0","0","0","0","0","0","0","0","0","0","0","4","3","1","0","0","0","0","0","0","0","0","0","-2"
"153603","Iowa State University","2012","On-Tenure track total","295","168","127","0","0","0","41","30","11","8","3","5","12","6","6","1","1","0","191","105","86","2","1","1","0","0","0","40","22","18","-2"
"153603","Iowa State University","2012","On-tenure track, associate professors","8","5","3","0","0","0","0","0","0","0","0","0","0","0","0","0","0","0","8","5","3","0","0","0","0","0","0","0","0","0","-2"
"153603","Iowa State University","2012","On-tenure track, assistant professors","287","163","124","0","0","0","41","30","11","8","3","5","12","6","6","1","1","0","183","100","83","2","1","1","0","0","0","40","22","18","-2"
"153603","Iowa State University","2012","Not on tenure track/No tenure system system total","224","96","128","2","0","2","15","6","9","7","4","3","7","2","5","0","0","0","181","79","102","2","1","1","0","0","0","10","4","6","-2"
"153603","Iowa State University","2012","Not on tenure/no tenure system, professors","6","6","0","0","0","0","1","1","0","0","0","0","0","0","0","0","0","0","4","4","0","0","0","0","0","0","0","1","1","0","-2"
"153603","Iowa State University","2012","Not on tenure/no tenure system, associate professors","3","2","1","0","0","0","0","0","0","0","0","0","0","0","0","0","0","0","3","2","1","0","0","0","0","0","0","0","0","0","-2"
"153603","Iowa State University","2012","Not on tenure/no tenure system, assistant professors","22","7","15","0","0","0","4","1","3","1","0","1","1","1","0","0","0","0","14","5","9","0","0","0","0","0","0","2","0","2","-2"
"153603","Iowa State University","2012","Not on tenure/no tenure system, lecturers","193","81","112","2","0","2","10","4","6","6","4","2","6","1","5","0","0","0","160","68","92","2","1","1","0","0","0","7","3","4","-2"
"153658","University of Iowa","2012","Tenured total","1102","785","317","4","1","3","101","81","20","23","11","12","36","21","15","0","0","0","917","655","262","6","3","3","12","11","1","3","2","1","-2"
"153658","University of Iowa","2012","Tenured, professors","664","515","149","1","1","0","53","45","8","11","7","4","15","6","9","0","0","0","572","446","126","3","2","1","9","8","1","0","0","0","-2"
"153658","University of Iowa","2012","Tenured, associate professors","438","270","168","3","0","3","48","36","12","12","4","8","21","15","6","0","0","0","345","209","136","3","1","2","3","3","0","3","2","1","-2"
"153658","University of Iowa","2012","On-Tenure track total","379","211","168","3","0","3","53","37","16","16","5","11","16","11","5","0","0","0","242","127","115","3","2","1","9","6","3","37","23","14","-2"
"153658","University of Iowa","2012","On-tenure track, professors","1","1","0","0","0","0","0","0","0","0","0","0","0","0","0","0","0","0","0","0","0","0","0","0","0","0","0","1","1","0","-2"
"153658","University of Iowa","2012","On-tenure track, associate professors","23","13","10","0","0","0","2","2","0","1","0","1","1","1","0","0","0","0","14","6","8","1","1","0","3","2","1","1","1","0","-2"
"153658","University of Iowa","2012","On-tenure track, assistant professors","354","197","157","3","0","3","51","35","16","15","5","10","15","10","5","0","0","0","228","121","107","2","1","1","6","4","2","34","21","13","-2"
"153658","University of Iowa","2012","On-tenure track, instructors","1","0","1","0","0","0","0","0","0","0","0","0","0","0","0","0","0","0","0","0","0","0","0","0","0","0","0","1","0","1","-2"
"153658","University of Iowa","2012","Not on tenure track/No tenure system system total","732","401","331","3","2","1","60","36","24","19","12","7","23","12","11","2","2","0","525","269","256","1","0","1","28","17","11","71","51","20","-2"
"153658","University of Iowa","2012","Not on tenure/no tenure system, professors","87","62","25","0","0","0","4","2","2","2","2","0","1","1","0","0","0","0","77","54","23","0","0","0","3","3","0","0","0","0","-2"
"153658","University of Iowa","2012","Not on tenure/no tenure system, associate professors","164","100","64","1","1","0","18","14","4","3","2","1","6","5","1","0","0","0","129","71","58","0","0","0","1","1","0","6","6","0","-2"
"153658","University of Iowa","2012","Not on tenure/no tenure system, assistant professors","271","137","134","0","0","0","24","13","11","11","5","6","9","5","4","1","1","0","180","84","96","1","0","1","17","10","7","28","19","9","-2"
"153658","University of Iowa","2012","Not on tenure/no tenure system, instructors","6","2","4","0","0","0","0","0","0","0","0","0","1","0","1","0","0","0","4","1","3","0","0","0","1","1","0","0","0","0","-2"
"153658","University of Iowa","2012","Not on tenure/no tenure system, lecturers","129","54","75","2","1","1","2","1","1","1","1","0","3","0","3","0","0","0","110","48","62","0","0","0","3","0","3","8","3","5","-2"
"153658","University of Iowa","2012","Not on tenure/no tenure system, no academic rank","75","46","29","0","0","0","12","6","6","2","2","0","3","1","2","1","1","0","25","11","14","0","0","0","3","2","1","29","23","6","-2"
"155317","University of Kansas","2012","Tenured total","988","691","297","4","3","1","100","82","18","30","19","11","34","22","12","0","0","0","810","562","248","8","1","7","1","1","0","1","1","0","-2"
"155317","University of Kansas","2012","Tenured, professors","529","413","116","2","1","1","47","42","5","15","8","7","15","13","2","0","0","0","449","348","101","0","0","0","1","1","0","0","0","0","-2"
"155317","University of Kansas","2012","Tenured, associate professors","454","277","177","2","2","0","53","40","13","15","11","4","19","9","10","0","0","0","356","213","143","8","1","7","0","0","0","1","1","0","-2"
"155317","University of Kansas","2012","Tenured, assistant professors","5","1","4","0","0","0","0","0","0","0","0","0","0","0","0","0","0","0","5","1","4","0","0","0","0","0","0","0","0","0","-2"
"155317","University of Kansas","2012","On-Tenure track total","314","179","135","3","1","2","54","32","22","12","5","7","10","6","4","0","0","0","192","113","79","6","3","3","3","1","2","34","18","16","-2"
"155317","University of Kansas","2012","On-tenure track, professors","3","1","2","0","0","0","1","1","0","1","0","1","0","0","0","0","0","0","1","0","1","0","0","0","0","0","0","0","0","0","-2"
"155317","University of Kansas","2012","On-tenure track, associate professors","24","17","7","0","0","0","4","3","1","0","0","0","2","2","0","0","0","0","17","12","5","1","0","1","0","0","0","0","0","0","-2"
"155317","University of Kansas","2012","On-tenure track, assistant professors","287","161","126","3","1","2","49","28","21","11","5","6","8","4","4","0","0","0","174","101","73","5","3","2","3","1","2","34","18","16","-2"
"155317","University of Kansas","2012","Not on tenure track/No tenure system system total","704","341","363","2","0","2","75","38","37","18","8","10","16","9","7","0","0","0","536","249","287","5","2","3","4","3","1","48","32","16","-2"
"155317","University of Kansas","2012","Not on tenure/no tenure system, professors","33","18","15","0","0","0","3","2","1","0","0","0","1","0","1","0","0","0","27","16","11","1","0","1","0","0","0","1","0","1","-2"
"155317","University of Kansas","2012","Not on tenure/no tenure system, associate professors","96","47","49","0","0","0","14","8","6","0","0","0","2","1","1","0","0","0","78","36","42","0","0","0","0","0","0","2","2","0","-2"
"155317","University of Kansas","2012","Not on tenure/no tenure system, assistant professors","400","212","188","2","0","2","47","26","21","11","5","6","8","5","3","0","0","0","284","143","141","3","2","1","4","3","1","41","28","13","-2"
"155317","University of Kansas","2012","Not on tenure/no tenure system, instructors","58","18","40","0","0","0","6","2","4","5","2","3","2","0","2","0","0","0","43","13","30","1","0","1","0","0","0","1","1","0","-2"
"155317","University of Kansas","2012","Not on tenure/no tenure system, lecturers","117","46","71","0","0","0","5","0","5","2","1","1","3","3","0","0","0","0","104","41","63","0","0","0","0","0","0","3","1","2","-2"
"157447","Northern Kentucky University","2012","Tenured total","247","140","107","0","0","0","13","6","7","11","8","3","2","2","0","0","0","0","219","122","97","0","0","0","1","1","0","1","1","0","-2"
"157447","Northern Kentucky University","2012","Tenured, professors","87","57","30","0","0","0","5","2","3","3","2","1","0","0","0","0","0","0","78","52","26","0","0","0","1","1","0","0","0","0","-2"
"157447","Northern Kentucky University","2012","Tenured, associate professors","159","82","77","0","0","0","8","4","4","8","6","2","2","2","0","0","0","0","140","69","71","0","0","0","0","0","0","1","1","0","-2"
"157447","Northern Kentucky University","2012","Tenured, assistant professors","1","1","0","0","0","0","0","0","0","0","0","0","0","0","0","0","0","0","1","1","0","0","0","0","0","0","0","0","0","0","-2"
"157447","Northern Kentucky University","2012","On-Tenure track total","123","56","67","1","1","0","6","4","2","9","5","4","2","1","1","0","0","0","95","40","55","2","0","2","2","1","1","6","4","2","-2"
"157447","Northern Kentucky University","2012","On-tenure track, associate professors","3","2","1","0","0","0","0","0","0","0","0","0","1","1","0","0","0","0","2","1","1","0","0","0","0","0","0","0","0","0","-2"
"157447","Northern Kentucky University","2012","On-tenure track, assistant professors","120","54","66","1","1","0","6","4","2","9","5","4","1","0","1","0","0","0","93","39","54","2","0","2","2","1","1","6","4","2","-2"
"157447","Northern Kentucky University","2012","Not on tenure track/No tenure system system total","178","77","101","2","2","0","4","2","2","5","0","5","3","1","2","0","0","0","159","70","89","0","0","0","3","1","2","2","1","1","-2"
"157447","Northern Kentucky University","2012","Not on tenure/no tenure system, professors","3","2","1","0","0","0","0","0","0","0","0","0","0","0","0","0","0","0","3","2","1","0","0","0","0","0","0","0","0","0","-2"
"157447","Northern Kentucky University","2012","Not on tenure/no tenure system, assistant professors","7","2","5","0","0","0","0","0","0","1","0","1","0","0","0","0","0","0","6","2","4","0","0","0","0","0","0","0","0","0","-2"
"157447","Northern Kentucky University","2012","Not on tenure/no tenure system, instructors","3","2","1","0","0","0","0","0","0","0","0","0","0","0","0","0","0","0","3","2","1","0","0","0","0","0","0","0","0","0","-2"
"157447","Northern Kentucky University","2012","Not on tenure/no tenure system, lecturers","165","71","94","2","2","0","4","2","2","4","0","4","3","1","2","0","0","0","147","64","83","0","0","0","3","1","2","2","1","1","-2"
"162928","Johns Hopkins University","2012","Tenured total","908","721","187","1","1","0","77","63","14","17","13","4","22","20","2","0","0","0","786","620","166","0","0","0","0","0","0","5","4","1","-2"
"162928","Johns Hopkins University","2012","Tenured, professors","843","668","175","1","1","0","69","55","14","15","12","3","21","19","2","0","0","0","734","579","155","0","0","0","0","0","0","3","2","1","-2"
"162928","Johns Hopkins University","2012","Tenured, associate professors","65","53","12","0","0","0","8","8","0","2","1","1","1","1","0","0","0","0","52","41","11","0","0","0","0","0","0","2","2","0","-2"
"162928","Johns Hopkins University","2012","On-Tenure track total","1677","976","701","5","2","3","333","214","119","77","29","48","46","26","20","3","2","1","1122","640","482","0","0","0","0","0","0","91","63","28","-2"
"162928","Johns Hopkins University","2012","On-tenure track, professors","3","2","1","0","0","0","0","0","0","0","0","0","1","1","0","0","0","0","2","1","1","0","0","0","0","0","0","0","0","0","-2"
"162928","Johns Hopkins University","2012","On-tenure track, associate professors","501","326","175","1","1","0","94","60","34","17","8","9","10","9","1","1","0","1","372","243","129","0","0","0","0","0","0","6","5","1","-2"
"162928","Johns Hopkins University","2012","On-tenure track, assistant professors","1019","565","454","3","1","2","200","133","67","54","19","35","35","16","19","2","2","0","657","348","309","0","0","0","0","0","0","68","46","22","-2"
"162928","Johns Hopkins University","2012","On-tenure track, instructors","154","83","71","1","0","1","39","21","18","6","2","4","0","0","0","0","0","0","91","48","43","0","0","0","0","0","0","17","12","5","-2"
"162928","Johns Hopkins University","2012","Not on tenure track/No tenure system system total","850","431","419","6","4","2","136","77","59","30","18","12","17","5","12","0","0","0","561","261","300","0","0","0","0","0","0","100","66","34","-2"
"162928","Johns Hopkins University","2012","Not on tenure/no tenure system, professors","27","20","7","0","0","0","2","2","0","0","0","0","0","0","0","0","0","0","25","18","7","0","0","0","0","0","0","0","0","0","-2"
"162928","Johns Hopkins University","2012","Not on tenure/no tenure system, associate professors","32","17","15","0","0","0","3","2","1","2","2","0","0","0","0","0","0","0","26","12","14","0","0","0","0","0","0","1","1","0","-2"
"162928","Johns Hopkins University","2012","Not on tenure/no tenure system, assistant professors","43","17","26","1","1","0","2","2","0","3","1","2","0","0","0","0","0","0","34","11","23","0","0","0","0","0","0","3","2","1","-2"
"162928","Johns Hopkins University","2012","Not on tenure/no tenure system, instructors","60","17","43","2","2","0","6","4","2","5","2","3","2","1","1","0","0","0","45","8","37","0","0","0","0","0","0","0","0","0","-2"
"162928","Johns Hopkins University","2012","Not on tenure/no tenure system, lecturers","165","68","97","0","0","0","17","5","12","5","3","2","5","1","4","0","0","0","126","52","74","0","0","0","0","0","0","12","7","5","-2"
"162928","Johns Hopkins University","2012","Not on tenure/no tenure system, no academic rank","523","292","231","3","1","2","106","62","44","15","10","5","10","3","7","0","0","0","305","160","145","0","0","0","0","0","0","84","56","28","-2"
"163268","University of Maryland-Baltimore County","2012","Tenured total","284","188","96","0","0","0","41","28","13","15","9","6","6","3","3","1","1","0","219","146","73","0","0","0","0","0","0","2","1","1","-2"
"163268","University of Maryland-Baltimore County","2012","Tenured, professors","145","113","32","0","0","0","22","21","1","5","4","1","1","1","0","1","1","0","116","86","30","0","0","0","0","0","0","0","0","0","-2"
"163268","University of Maryland-Baltimore County","2012","Tenured, associate professors","139","75","64","0","0","0","19","7","12","10","5","5","5","2","3","0","0","0","103","60","43","0","0","0","0","0","0","2","1","1","-2"
"163268","University of Maryland-Baltimore County","2012","On-Tenure track total","90","39","51","1","1","0","12","5","7","7","5","2","7","1","6","1","0","1","49","20","29","1","0","1","0","0","0","12","7","5","-2"
"163268","University of Maryland-Baltimore County","2012","On-tenure track, professors","1","0","1","0","0","0","0","0","0","0","0","0","0","0","0","0","0","0","1","0","1","0","0","0","0","0","0","0","0","0","-2"
"163268","University of Maryland-Baltimore County","2012","On-tenure track, associate professors","4","3","1","0","0","0","1","1","0","0","0","0","0","0","0","0","0","0","3","2","1","0","0","0","0","0","0","0","0","0","-2"
"163268","University of Maryland-Baltimore County","2012","On-tenure track, assistant professors","85","36","49","1","1","0","11","4","7","7","5","2","7","1","6","1","0","1","45","18","27","1","0","1","0","0","0","12","7","5","-2"
"163268","University of Maryland-Baltimore County","2012","Not on tenure track/No tenure system system total","127","54","73","0","0","0","6","3","3","7","3","4","4","2","2","0","0","0","105","44","61","0","0","0","0","0","0","5","2","3","-2"
"163268","University of Maryland-Baltimore County","2012","Not on tenure/no tenure system, professors","9","5","4","0","0","0","0","0","0","0","0","0","0","0","0","0","0","0","9","5","4","0","0","0","0","0","0","0","0","0","-2"
"163268","University of Maryland-Baltimore County","2012","Not on tenure/no tenure system, associate professors","5","2","3","0","0","0","0","0","0","1","1","0","0","0","0","0","0","0","4","1","3","0","0","0","0","0","0","0","0","0","-2"
"163268","University of Maryland-Baltimore County","2012","Not on tenure/no tenure system, assistant professors","15","7","8","0","0","0","2","1","1","2","1","1","2","2","0","0","0","0","8","3","5","0","0","0","0","0","0","1","0","1","-2"
"163268","University of Maryland-Baltimore County","2012","Not on tenure/no tenure system, instructors","12","2","10","0","0","0","0","0","0","0","0","0","0","0","0","0","0","0","12","2","10","0","0","0","0","0","0","0","0","0","-2"
"163268","University of Maryland-Baltimore County","2012","Not on tenure/no tenure system, lecturers","86","38","48","0","0","0","4","2","2","4","1","3","2","0","2","0","0","0","72","33","39","0","0","0","0","0","0","4","2","2","-2"
"163286","University of Maryland-College Park","2012","Tenured total","1072","786","286","1","1","0","144","107","37","41","21","20","39","21","18","0","0","0","811","607","204","4","3","1","26","21","5","6","5","1","-2"
"163286","University of Maryland-College Park","2012","Tenured, professors","642","499","143","0","0","0","71","54","17","18","11","7","21","13","8","0","0","0","512","406","106","2","2","0","13","9","4","5","4","1","-2"
"163286","University of Maryland-College Park","2012","Tenured, associate professors","428","285","143","1","1","0","73","53","20","23","10","13","18","8","10","0","0","0","297","199","98","2","1","1","13","12","1","1","1","0","-2"
"163286","University of Maryland-College Park","2012","Tenured, assistant professors","2","2","0","0","0","0","0","0","0","0","0","0","0","0","0","0","0","0","2","2","0","0","0","0","0","0","0","0","0","0","-2"
"163286","University of Maryland-College Park","2012","On-Tenure track total","318","175","143","0","0","0","48","24","24","26","15","11","18","10","8","0","0","0","140","76","64","2","1","1","42","21","21","42","28","14","-2"
"163286","University of Maryland-College Park","2012","On-tenure track, associate professors","3","3","0","0","0","0","1","1","0","0","0","0","0","0","0","0","0","0","2","2","0","0","0","0","0","0","0","0","0","0","-2"
"163286","University of Maryland-College Park","2012","On-tenure track, assistant professors","315","172","143","0","0","0","47","23","24","26","15","11","18","10","8","0","0","0","138","74","64","2","1","1","42","21","21","42","28","14","-2"
"163286","University of Maryland-College Park","2012","Not on tenure track/No tenure system system total","287","120","167","1","1","0","14","5","9","16","7","9","19","10","9","0","0","0","210","87","123","3","0","3","14","7","7","10","3","7","-2"
"163286","University of Maryland-College Park","2012","Not on tenure/no tenure system, professors","11","7","4","0","0","0","0","0","0","1","0","1","1","1","0","0","0","0","9","6","3","0","0","0","0","0","0","0","0","0","-2"
"163286","University of Maryland-College Park","2012","Not on tenure/no tenure system, instructors","12","5","7","0","0","0","1","0","1","4","3","1","0","0","0","0","0","0","7","2","5","0","0","0","0","0","0","0","0","0","-2"
"163286","University of Maryland-College Park","2012","Not on tenure/no tenure system, lecturers","263","107","156","1","1","0","13","5","8","11","4","7","18","9","9","0","0","0","194","79","115","3","0","3","13","6","7","10","3","7","-2"
"163286","University of Maryland-College Park","2012","Not on tenure/no tenure system, no academic rank","1","1","0","0","0","0","0","0","0","0","0","0","0","0","0","0","0","0","0","0","0","0","0","0","1","1","0","0","0","0","-2"
"163338","University of Maryland Eastern Shore","2012","Tenured total","88","58","30","0","0","0","15","8","7","37","26","11","1","1","0","0","0","0","33","22","11","0","0","0","1","0","1","1","1","0","-2"
"163338","University of Maryland Eastern Shore","2012","Tenured, professors","29","22","7","0","0","0","6","4","2","13","12","1","0","0","0","0","0","0","10","6","4","0","0","0","0","0","0","0","0","0","-2"
"163338","University of Maryland Eastern Shore","2012","Tenured, associate professors","51","30","21","0","0","0","9","4","5","20","12","8","1","1","0","0","0","0","20","13","7","0","0","0","1","0","1","0","0","0","-2"
"163338","University of Maryland Eastern Shore","2012","Tenured, assistant professors","8","6","2","0","0","0","0","0","0","4","2","2","0","0","0","0","0","0","3","3","0","0","0","0","0","0","0","1","1","0","-2"
"163338","University of Maryland Eastern Shore","2012","On-Tenure track total","65","41","24","3","1","2","6","5","1","18","11","7","2","1","1","0","0","0","22","12","10","2","2","0","1","1","0","11","8","3","-2"
"163338","University of Maryland Eastern Shore","2012","On-tenure track, professors","1","1","0","0","0","0","0","0","0","0","0","0","0","0","0","0","0","0","1","1","0","0","0","0","0","0","0","0","0","0","-2"
"163338","University of Maryland Eastern Shore","2012","On-tenure track, associate professors","12","9","3","2","1","1","1","0","1","4","3","1","0","0","0","0","0","0","3","3","0","1","1","0","0","0","0","1","1","0","-2"
"163338","University of Maryland Eastern Shore","2012","On-tenure track, assistant professors","51","30","21","1","0","1","5","5","0","13","7","6","2","1","1","0","0","0","18","8","10","1","1","0","1","1","0","10","7","3","-2"
"163338","University of Maryland Eastern Shore","2012","On-tenure track, instructors","1","1","0","0","0","0","0","0","0","1","1","0","0","0","0","0","0","0","0","0","0","0","0","0","0","0","0","0","0","0","-2"
"163338","University of Maryland Eastern Shore","2012","Not on tenure track/No tenure system system total","64","27","37","0","0","0","5","4","1","20","9","11","3","1","2","0","0","0","35","13","22","0","0","0","0","0","0","1","0","1","-2"
"163338","University of Maryland Eastern Shore","2012","Not on tenure/no tenure system, professors","1","1","0","0","0","0","0","0","0","0","0","0","0","0","0","0","0","0","1","1","0","0","0","0","0","0","0","0","0","0","-2"
"163338","University of Maryland Eastern Shore","2012","Not on tenure/no tenure system, associate professors","1","1","0","0","0","0","0","0","0","0","0","0","0","0","0","0","0","0","1","1","0","0","0","0","0","0","0","0","0","0","-2"
"163338","University of Maryland Eastern Shore","2012","Not on tenure/no tenure system, assistant professors","5","3","2","0","0","0","1","1","0","1","1","0","0","0","0","0","0","0","3","1","2","0","0","0","0","0","0","0","0","0","-2"
"163338","University of Maryland Eastern Shore","2012","Not on tenure/no tenure system, instructors","2","2","0","0","0","0","0","0","0","1","1","0","0","0","0","0","0","0","1","1","0","0","0","0","0","0","0","0","0","0","-2"
"163338","University of Maryland Eastern Shore","2012","Not on tenure/no tenure system, lecturers","55","20","35","0","0","0","4","3","1","18","7","11","3","1","2","0","0","0","29","9","20","0","0","0","0","0","0","1","0","1","-2"
"163851","Salisbury University","2012","Tenured total","233","145","88","0","0","0","16","9","7","12","8","4","2","2","0","0","0","0","201","125","76","0","0","0","2","1","1","0","0","0","-2"
"163851","Salisbury University","2012","Tenured, professors","99","71","28","0","0","0","5","3","2","3","2","1","0","0","0","0","0","0","91","66","25","0","0","0","0","0","0","0","0","0","-2"
"163851","Salisbury University","2012","Tenured, associate professors","113","66","47","0","0","0","11","6","5","6","5","1","2","2","0","0","0","0","92","52","40","0","0","0","2","1","1","0","0","0","-2"
"163851","Salisbury University","2012","Tenured, assistant professors","21","8","13","0","0","0","0","0","0","3","1","2","0","0","0","0","0","0","18","7","11","0","0","0","0","0","0","0","0","0","-2"
"163851","Salisbury University","2012","On-Tenure track total","79","34","45","0","0","0","3","1","2","10","7","3","3","1","2","0","0","0","58","23","35","0","0","0","0","0","0","5","2","3","-2"
"163851","Salisbury University","2012","On-tenure track, assistant professors","71","32","39","0","0","0","3","1","2","9","6","3","2","1","1","0","0","0","52","22","30","0","0","0","0","0","0","5","2","3","-2"
"163851","Salisbury University","2012","On-tenure track, instructors","8","2","6","0","0","0","0","0","0","1","1","0","1","0","1","0","0","0","6","1","5","0","0","0","0","0","0","0","0","0","-2"
"163851","Salisbury University","2012","Not on tenure track/No tenure system system total","91","30","61","0","0","0","5","0","5","3","2","1","3","1","2","0","0","0","79","27","52","0","0","0","1","0","1","0","0","0","-2"
"163851","Salisbury University","2012","Not on tenure/no tenure system, lecturers","91","30","61","0","0","0","5","0","5","3","2","1","3","1","2","0","0","0","79","27","52","0","0","0","1","0","1","0","0","0","-2"
"166027","Harvard University","2012","Tenured total","1123","881","242","1","0","1","80","62","18","33","20","13","20","16","4","0","0","0","885","695","190","7","4","3","5","5","0","92","79","13","-2"
"166027","Harvard University","2012","Tenured, professors","1123","881","242","1","0","1","80","62","18","33","20","13","20","16","4","0","0","0","885","695","190","7","4","3","5","5","0","92","79","13","-2"
"166027","Harvard University","2012","On-Tenure track total","539","334","205","0","0","0","63","37","26","13","4","9","14","7","7","0","0","0","272","173","99","4","2","2","2","0","2","171","111","60","-2"
"166027","Harvard University","2012","On-tenure track, associate professors","226","137","89","0","0","0","17","7","10","5","2","3","7","3","4","0","0","0","121","79","42","0","0","0","1","0","1","75","46","29","-2"
"166027","Harvard University","2012","On-tenure track, no academic rank","313","197","116","0","0","0","46","30","16","8","2","6","7","4","3","0","0","0","151","94","57","4","2","2","1","0","1","96","65","31","-2"
"166027","Harvard University","2012","Not on tenure track/No tenure system system total","471","247","224","1","1","0","28","12","16","16","8","8","12","9","3","0","0","0","305","165","140","6","2","4","3","3","0","100","47","53","-2"
"166027","Harvard University","2012","Not on tenure/no tenure system, professors","84","59","25","1","1","0","3","2","1","6","4","2","3","3","0","0","0","0","57","40","17","2","2","0","1","1","0","11","6","5","-2"
"166027","Harvard University","2012","Not on tenure/no tenure system, associate professors","7","5","2","0","0","0","0","0","0","0","0","0","0","0","0","0","0","0","4","2","2","0","0","0","0","0","0","3","3","0","-2"
"166027","Harvard University","2012","Not on tenure/no tenure system, instructors","4","1","3","0","0","0","0","0","0","1","0","1","0","0","0","0","0","0","3","1","2","0","0","0","0","0","0","0","0","0","-2"
"166027","Harvard University","2012","Not on tenure/no tenure system, lecturers","9","6","3","0","0","0","1","1","0","0","0","0","0","0","0","0","0","0","4","2","2","0","0","0","0","0","0","4","3","1","-2"
"166027","Harvard University","2012","Not on tenure/no tenure system, no academic rank","367","176","191","0","0","0","24","9","15","9","4","5","9","6","3","0","0","0","237","120","117","4","0","4","2","2","0","82","35","47","-2"
"166513","University of Massachusetts-Lowell","2012","Tenured total","313","216","97","0","0","0","56","42","14","6","4","2","4","3","1","0","0","0","243","165","78","0","0","0","0","0","0","4","2","2","-2"
"166513","University of Massachusetts-Lowell","2012","Tenured, professors","178","137","41","0","0","0","33","26","7","3","1","2","1","1","0","0","0","0","141","109","32","0","0","0","0","0","0","0","0","0","-2"
"166513","University of Massachusetts-Lowell","2012","Tenured, associate professors","135","79","56","0","0","0","23","16","7","3","3","0","3","2","1","0","0","0","102","56","46","0","0","0","0","0","0","4","2","2","-2"
"166513","University of Massachusetts-Lowell","2012","On-Tenure track total","93","45","48","0","0","0","19","11","8","2","1","1","5","4","1","0","0","0","52","19","33","0","0","0","4","3","1","11","7","4","-2"
"166513","University of Massachusetts-Lowell","2012","On-tenure track, professors","1","1","0","0","0","0","0","0","0","0","0","0","0","0","0","0","0","0","1","1","0","0","0","0","0","0","0","0","0","0","-2"
"166513","University of Massachusetts-Lowell","2012","On-tenure track, associate professors","11","6","5","0","0","0","3","2","1","0","0","0","2","2","0","0","0","0","6","2","4","0","0","0","0","0","0","0","0","0","-2"
"166513","University of Massachusetts-Lowell","2012","On-tenure track, assistant professors","81","38","43","0","0","0","16","9","7","2","1","1","3","2","1","0","0","0","45","16","29","0","0","0","4","3","1","11","7","4","-2"
"166513","University of Massachusetts-Lowell","2012","Not on tenure track/No tenure system system total","124","53","71","0","0","0","4","2","2","1","1","0","2","1","1","0","0","0","109","43","66","0","0","0","0","0","0","8","6","2","-2"
"166513","University of Massachusetts-Lowell","2012","Not on tenure/no tenure system, associate professors","3","1","2","0","0","0","0","0","0","0","0","0","0","0","0","0","0","0","3","1","2","0","0","0","0","0","0","0","0","0","-2"
"166513","University of Massachusetts-Lowell","2012","Not on tenure/no tenure system, assistant professors","9","0","9","0","0","0","0","0","0","0","0","0","0","0","0","0","0","0","9","0","9","0","0","0","0","0","0","0","0","0","-2"
"166513","University of Massachusetts-Lowell","2012","Not on tenure/no tenure system, lecturers","81","37","44","0","0","0","3","1","2","1","1","0","1","1","0","0","0","0","72","32","40","0","0","0","0","0","0","4","2","2","-2"
"166513","University of Massachusetts-Lowell","2012","Not on tenure/no tenure system, no academic rank","31","15","16","0","0","0","1","1","0","0","0","0","1","0","1","0","0","0","25","10","15","0","0","0","0","0","0","4","4","0","-2"
"166629","University of Massachusetts-Amherst","2012","Tenured total","731","484","247","3","2","1","71","54","17","23","16","7","25","11","14","0","0","0","585","384","201","7","4","3","15","11","4","2","2","0","-2"
"166629","University of Massachusetts-Amherst","2012","Tenured, professors","460","339","121","1","1","0","38","32","6","15","9","6","12","8","4","0","0","0","382","281","101","3","1","2","9","7","2","0","0","0","-2"
"166629","University of Massachusetts-Amherst","2012","Tenured, associate professors","270","145","125","2","1","1","33","22","11","8","7","1","13","3","10","0","0","0","202","103","99","4","3","1","6","4","2","2","2","0","-2"
"166629","University of Massachusetts-Amherst","2012","Tenured, assistant professors","1","0","1","0","0","0","0","0","0","0","0","0","0","0","0","0","0","0","1","0","1","0","0","0","0","0","0","0","0","0","-2"
"166629","University of Massachusetts-Amherst","2012","On-Tenure track total","271","136","135","1","0","1","32","16","16","20","6","14","17","12","5","0","0","0","142","73","69","1","1","0","20","9","11","38","19","19","-2"
"166629","University of Massachusetts-Amherst","2012","On-tenure track, professors","3","2","1","0","0","0","0","0","0","0","0","0","0","0","0","0","0","0","2","1","1","0","0","0","1","1","0","0","0","0","-2"
"166629","University of Massachusetts-Amherst","2012","On-tenure track, associate professors","6","3","3","0","0","0","2","1","1","1","0","1","0","0","0","0","0","0","1","0","1","0","0","0","0","0","0","2","2","0","-2"
"166629","University of Massachusetts-Amherst","2012","On-tenure track, assistant professors","262","131","131","1","0","1","30","15","15","19","6","13","17","12","5","0","0","0","139","72","67","1","1","0","19","8","11","36","17","19","-2"
"166629","University of Massachusetts-Amherst","2012","Not on tenure track/No tenure system system total","232","107","125","3","0","3","6","2","4","7","3","4","4","1","3","0","0","0","185","87","98","5","3","2","7","5","2","15","6","9","-2"
"166629","University of Massachusetts-Amherst","2012","Not on tenure/no tenure system, associate professors","2","0","2","0","0","0","0","0","0","0","0","0","1","0","1","0","0","0","1","0","1","0","0","0","0","0","0","0","0","0","-2"
"166629","University of Massachusetts-Amherst","2012","Not on tenure/no tenure system, assistant professors","15","2","13","0","0","0","0","0","0","0","0","0","0","0","0","0","0","0","15","2","13","0","0","0","0","0","0","0","0","0","-2"
"166629","University of Massachusetts-Amherst","2012","Not on tenure/no tenure system, instructors","2","0","2","0","0","0","0","0","0","0","0","0","0","0","0","0","0","0","2","0","2","0","0","0","0","0","0","0","0","0","-2"
"166629","University of Massachusetts-Amherst","2012","Not on tenure/no tenure system, lecturers","213","105","108","3","0","3","6","2","4","7","3","4","3","1","2","0","0","0","167","85","82","5","3","2","7","5","2","15","6","9","-2"
"166683","Massachusetts Institute of Technology","2012","Tenured total","760","621","139","0","0","0","79","65","14","20","17","3","17","16","1","0","0","0","603","492","111","5","3","2","31","26","5","5","2","3","-2"
"166683","Massachusetts Institute of Technology","2012","Tenured, professors","637","528","109","0","0","0","61","54","7","15","12","3","12","11","1","0","0","0","520","428","92","1","1","0","24","21","3","4","1","3","-2"
"166683","Massachusetts Institute of Technology","2012","Tenured, associate professors","123","93","30","0","0","0","18","11","7","5","5","0","5","5","0","0","0","0","83","64","19","4","2","2","7","5","2","1","1","0","-2"
"166683","Massachusetts Institute of Technology","2012","On-Tenure track total","221","151","70","1","0","1","27","16","11","8","3","5","18","15","3","0","0","0","95","67","28","4","4","0","46","27","19","22","19","3","-2"
"166683","Massachusetts Institute of Technology","2012","On-tenure track, associate professors","67","44","23","0","0","0","13","6","7","5","1","4","7","7","0","0","0","0","31","22","9","2","2","0","8","5","3","1","1","0","-2"
"166683","Massachusetts Institute of Technology","2012","On-tenure track, assistant professors","154","107","47","1","0","1","14","10","4","3","2","1","11","8","3","0","0","0","64","45","19","2","2","0","38","22","16","21","18","3","-2"
"166683","Massachusetts Institute of Technology","2012","Not on tenure track/No tenure system system total","11","7","4","0","0","0","1","0","1","1","1","0","0","0","0","0","0","0","9","6","3","0","0","0","0","0","0","0","0","0","-2"
"166683","Massachusetts Institute of Technology","2012","Not on tenure/no tenure system, professors","1","1","0","0","0","0","0","0","0","0","0","0","0","0","0","0","0","0","1","1","0","0","0","0","0","0","0","0","0","0","-2"
"166683","Massachusetts Institute of Technology","2012","Not on tenure/no tenure system, associate professors","8","4","4","0","0","0","1","0","1","1","1","0","0","0","0","0","0","0","6","3","3","0","0","0","0","0","0","0","0","0","-2"
"166683","Massachusetts Institute of Technology","2012","Not on tenure/no tenure system, assistant professors","2","2","0","0","0","0","0","0","0","0","0","0","0","0","0","0","0","0","2","2","0","0","0","0","0","0","0","0","0","0","-2"
"170976","University of Michigan-Ann Arbor","2012","Tenured total","2032","1449","583","10","7","3","255","186","69","91","58","33","79","47","32","2","0","2","1549","1119","430","16","10","6","11","9","2","19","13","6","-2"
"170976","University of Michigan-Ann Arbor","2012","Tenured, professors","1377","1032","345","5","3","2","148","116","32","60","37","23","41","24","17","1","0","1","1095","832","263","8","5","3","8","6","2","11","9","2","-2"
"170976","University of Michigan-Ann Arbor","2012","Tenured, associate professors","655","417","238","5","4","1","107","70","37","31","21","10","38","23","15","1","0","1","454","287","167","8","5","3","3","3","0","8","4","4","-2"
"170976","University of Michigan-Ann Arbor","2012","On-Tenure track total","636","394","242","1","0","1","107","76","31","27","15","12","25","17","8","0","0","0","388","228","160","10","8","2","8","5","3","70","45","25","-2"
"170976","University of Michigan-Ann Arbor","2012","On-tenure track, professors","4","4","0","0","0","0","0","0","0","0","0","0","0","0","0","0","0","0","4","4","0","0","0","0","0","0","0","0","0","0","-2"
"170976","University of Michigan-Ann Arbor","2012","On-tenure track, associate professors","18","15","3","0","0","0","1","1","0","1","1","0","0","0","0","0","0","0","13","11","2","0","0","0","0","0","0","3","2","1","-2"
"170976","University of Michigan-Ann Arbor","2012","On-tenure track, assistant professors","614","375","239","1","0","1","106","75","31","26","14","12","25","17","8","0","0","0","371","213","158","10","8","2","8","5","3","67","43","24","-2"
"170976","University of Michigan-Ann Arbor","2012","Not on tenure track/No tenure system system total","3279","1903","1376","6","4","2","454","268","186","82","34","48","103","41","62","2","0","2","1721","941","780","31","10","21","31","22","9","849","583","266","-2"
"170976","University of Michigan-Ann Arbor","2012","Not on tenure/no tenure system, professors","163","120","43","0","0","0","9","7","2","2","1","1","4","4","0","0","0","0","144","105","39","0","0","0","0","0","0","4","3","1","-2"
"170976","University of Michigan-Ann Arbor","2012","Not on tenure/no tenure system, associate professors","234","145","89","0","0","0","45","31","14","6","3","3","10","6","4","0","0","0","165","101","64","3","2","1","1","0","1","4","2","2","-2"
"170976","University of Michigan-Ann Arbor","2012","Not on tenure/no tenure system, assistant professors","591","317","274","1","1","0","120","65","55","17","6","11","12","3","9","0","0","0","389","207","182","10","4","6","11","8","3","31","23","8","-2"
"170976","University of Michigan-Ann Arbor","2012","Not on tenure/no tenure system, instructors","136","61","75","0","0","0","19","9","10","6","4","2","5","0","5","1","0","1","87","37","50","1","0","1","2","2","0","15","9","6","-2"
"170976","University of Michigan-Ann Arbor","2012","Not on tenure/no tenure system, lecturers","640","298","342","5","3","2","69","30","39","21","10","11","37","12","25","0","0","0","445","210","235","11","3","8","10","9","1","42","21","21","-2"
"170976","University of Michigan-Ann Arbor","2012","Not on tenure/no tenure system, no academic rank","1515","962","553","0","0","0","192","126","66","30","10","20","35","16","19","1","0","1","491","281","210","6","1","5","7","3","4","753","525","228","-2"
"171100","Michigan State University","2012","Tenured total","1319","913","406","11","7","4","155","109","46","53","36","17","33","18","15","1","1","0","1060","739","321","4","1","3","0","0","0","2","2","0","-2"
"171100","Michigan State University","2012","Tenured, professors","779","594","185","6","5","1","75","58","17","25","18","7","12","8","4","0","0","0","659","504","155","2","1","1","0","0","0","0","0","0","-2"
"171100","Michigan State University","2012","Tenured, associate professors","540","319","221","5","2","3","80","51","29","28","18","10","21","10","11","1","1","0","401","235","166","2","0","2","0","0","0","2","2","0","-2"
"171100","Michigan State University","2012","On-Tenure track total","392","217","175","3","3","0","64","35","29","24","8","16","27","15","12","0","0","0","235","132","103","4","3","1","0","0","0","35","21","14","-2"
"171100","Michigan State University","2012","On-tenure track, associate professors","11","9","2","0","0","0","2","1","1","0","0","0","0","0","0","0","0","0","8","7","1","1","1","0","0","0","0","0","0","0","-2"
"171100","Michigan State University","2012","On-tenure track, assistant professors","381","208","173","3","3","0","62","34","28","24","8","16","27","15","12","0","0","0","227","125","102","3","2","1","0","0","0","35","21","14","-2"
"171100","Michigan State University","2012","Not on tenure track/No tenure system system total","745","382","363","4","1","3","81","42","39","28","18","10","21","11","10","0","0","0","527","261","266","0","0","0","0","0","0","84","49","35","-2"
"171100","Michigan State University","2012","Not on tenure/no tenure system, professors","63","51","12","0","0","0","9","5","4","5","5","0","0","0","0","0","0","0","43","35","8","0","0","0","0","0","0","6","6","0","-2"
"171100","Michigan State University","2012","Not on tenure/no tenure system, associate professors","110","72","38","0","0","0","12","8","4","4","3","1","2","1","1","0","0","0","90","58","32","0","0","0","0","0","0","2","2","0","-2"
"171100","Michigan State University","2012","Not on tenure/no tenure system, assistant professors","374","196","178","3","1","2","50","26","24","13","8","5","13","9","4","0","0","0","243","118","125","0","0","0","0","0","0","52","34","18","-2"
"171100","Michigan State University","2012","Not on tenure/no tenure system, instructors","191","61","130","0","0","0","10","3","7","6","2","4","5","0","5","0","0","0","146","49","97","0","0","0","0","0","0","24","7","17","-2"
"171100","Michigan State University","2012","Not on tenure/no tenure system, lecturers","7","2","5","1","0","1","0","0","0","0","0","0","1","1","0","0","0","0","5","1","4","0","0","0","0","0","0","0","0","0","-2"
"174066","University of Minnesota-Twin Cities","2012","Tenured total","1785","1225","560","6","2","4","203","154","49","40","24","16","38","23","15","0","0","0","1471","1000","471","12","8","4","2","2","0","13","12","1","174066"
"174066","University of Minnesota-Twin Cities","2012","Tenured, professors","1105","837","268","2","1","1","116","100","16","17","13","4","19","15","4","0","0","0","940","699","241","3","2","1","0","0","0","8","7","1","174066"
"174066","University of Minnesota-Twin Cities","2012","Tenured, associate professors","670","385","285","4","1","3","85","54","31","23","11","12","19","8","11","0","0","0","523","298","225","9","6","3","2","2","0","5","5","0","174066"
"174066","University of Minnesota-Twin Cities","2012","Tenured, assistant professors","4","2","2","0","0","0","0","0","0","0","0","0","0","0","0","0","0","0","4","2","2","0","0","0","0","0","0","0","0","0","174066"
"174066","University of Minnesota-Twin Cities","2012","Tenured, no academic rank","6","1","5","0","0","0","2","0","2","0","0","0","0","0","0","0","0","0","4","1","3","0","0","0","0","0","0","0","0","0","174066"
"174066","University of Minnesota-Twin Cities","2012","On-Tenure track total","433","256","177","3","1","2","75","48","27","17","7","10","18","9","9","1","0","1","269","160","109","8","5","3","2","2","0","40","24","16","174066"
"174066","University of Minnesota-Twin Cities","2012","On-tenure track, professors","2","2","0","0","0","0","0","0","0","0","0","0","0","0","0","0","0","0","1","1","0","0","0","0","0","0","0","1","1","0","174066"
"174066","University of Minnesota-Twin Cities","2012","On-tenure track, associate professors","31","17","14","0","0","0","9","5","4","1","1","0","1","0","1","0","0","0","18","10","8","1","1","0","0","0","0","1","0","1","174066"
"174066","University of Minnesota-Twin Cities","2012","On-tenure track, assistant professors","396","234","162","3","1","2","66","43","23","16","6","10","16","8","8","1","0","1","247","147","100","7","4","3","2","2","0","38","23","15","174066"
"174066","University of Minnesota-Twin Cities","2012","On-tenure track, instructors","3","3","0","0","0","0","0","0","0","0","0","0","1","1","0","0","0","0","2","2","0","0","0","0","0","0","0","0","0","0","174066"
"174066","University of Minnesota-Twin Cities","2012","On-tenure track, lecturers","1","0","1","0","0","0","0","0","0","0","0","0","0","0","0","0","0","0","1","0","1","0","0","0","0","0","0","0","0","0","174066"
"174066","University of Minnesota-Twin Cities","2012","Not on tenure track/No tenure system system total","655","380","275","5","1","4","102","67","35","15","8","7","15","9","6","1","1","0","458","251","207","5","3","2","13","8","5","41","32","9","174066"
"174066","University of Minnesota-Twin Cities","2012","Not on tenure/no tenure system, professors","54","41","13","0","0","0","6","5","1","0","0","0","1","1","0","0","0","0","44","33","11","0","0","0","2","1","1","1","1","0","174066"
"174066","University of Minnesota-Twin Cities","2012","Not on tenure/no tenure system, associate professors","134","97","37","1","0","1","13","11","2","5","4","1","1","1","0","0","0","0","106","74","32","0","0","0","3","3","0","5","4","1","174066"
"174066","University of Minnesota-Twin Cities","2012","Not on tenure/no tenure system, assistant professors","441","230","211","4","1","3","81","50","31","10","4","6","12","7","5","1","1","0","289","136","153","5","3","2","6","3","3","33","25","8","174066"
"174066","University of Minnesota-Twin Cities","2012","Not on tenure/no tenure system, instructors","26","12","14","0","0","0","2","1","1","0","0","0","1","0","1","0","0","0","19","8","11","0","0","0","2","1","1","2","2","0","174066"
"174783","Saint Cloud State University","2012","Tenured total","331","196","135","3","1","2","41","28","13","16","13","3","15","8","7","0","0","0","243","142","101","1","0","1","6","1","5","6","3","3","-2"
"174783","Saint Cloud State University","2012","Tenured, professors","198","119","79","2","1","1","24","15","9","10","9","1","9","5","4","0","0","0","150","87","63","0","0","0","1","0","1","2","2","0","-2"
"174783","Saint Cloud State University","2012","Tenured, associate professors","121","68","53","1","0","1","16","13","3","6","4","2","5","3","2","0","0","0","83","46","37","1","0","1","5","1","4","4","1","3","-2"
"174783","Saint Cloud State University","2012","Tenured, assistant professors","12","9","3","0","0","0","1","0","1","0","0","0","1","0","1","0","0","0","10","9","1","0","0","0","0","0","0","0","0","0","-2"
"174783","Saint Cloud State University","2012","On-Tenure track total","42","18","24","1","0","1","5","2","3","1","1","0","2","1","1","0","0","0","27","10","17","0","0","0","1","1","0","5","3","2","-2"
"174783","Saint Cloud State University","2012","On-tenure track, professors","1","1","0","0","0","0","0","0","0","0","0","0","0","0","0","0","0","0","1","1","0","0","0","0","0","0","0","0","0","0","-2"
"174783","Saint Cloud State University","2012","On-tenure track, associate professors","5","2","3","0","0","0","0","0","0","0","0","0","0","0","0","0","0","0","5","2","3","0","0","0","0","0","0","0","0","0","-2"
"174783","Saint Cloud State University","2012","On-tenure track, assistant professors","36","15","21","1","0","1","5","2","3","1","1","0","2","1","1","0","0","0","21","7","14","0","0","0","1","1","0","5","3","2","-2"
"174783","Saint Cloud State University","2012","Not on tenure track/No tenure system system total","72","32","40","1","0","1","4","3","1","5","3","2","2","1","1","0","0","0","56","22","34","0","0","0","0","0","0","4","3","1","-2"
"174783","Saint Cloud State University","2012","Not on tenure/no tenure system, associate professors","9","4","5","0","0","0","0","0","0","0","0","0","0","0","0","0","0","0","9","4","5","0","0","0","0","0","0","0","0","0","-2"
"174783","Saint Cloud State University","2012","Not on tenure/no tenure system, assistant professors","47","25","22","0","0","0","3","2","1","5","3","2","1","1","0","0","0","0","34","16","18","0","0","0","0","0","0","4","3","1","-2"
"174783","Saint Cloud State University","2012","Not on tenure/no tenure system, instructors","16","3","13","1","0","1","1","1","0","0","0","0","1","0","1","0","0","0","13","2","11","0","0","0","0","0","0","0","0","0","-2"
"175856","Jackson State University","2012","Tenured total","176","109","67","0","0","0","38","33","5","100","54","46","2","0","2","0","0","0","36","22","14","0","0","0","0","0","0","0","0","0","-2"
"175856","Jackson State University","2012","Tenured, professors","72","48","24","0","0","0","17","15","2","34","21","13","2","0","2","0","0","0","19","12","7","0","0","0","0","0","0","0","0","0","-2"
"175856","Jackson State University","2012","Tenured, associate professors","86","49","37","0","0","0","17","14","3","55","26","29","0","0","0","0","0","0","14","9","5","0","0","0","0","0","0","0","0","0","-2"
"175856","Jackson State University","2012","Tenured, assistant professors","18","12","6","0","0","0","4","4","0","11","7","4","0","0","0","0","0","0","3","1","2","0","0","0","0","0","0","0","0","0","-2"
"175856","Jackson State University","2012","On-Tenure track total","83","47","36","1","1","0","7","6","1","51","21","30","1","1","0","0","0","0","23","18","5","0","0","0","0","0","0","0","0","0","-2"
"175856","Jackson State University","2012","On-tenure track, professors","1","1","0","0","0","0","0","0","0","1","1","0","0","0","0","0","0","0","0","0","0","0","0","0","0","0","0","0","0","0","-2"
"175856","Jackson State University","2012","On-tenure track, associate professors","12","8","4","1","1","0","2","2","0","6","3","3","0","0","0","0","0","0","3","2","1","0","0","0","0","0","0","0","0","0","-2"
"175856","Jackson State University","2012","On-tenure track, assistant professors","70","38","32","0","0","0","5","4","1","44","17","27","1","1","0","0","0","0","20","16","4","0","0","0","0","0","0","0","0","0","-2"
"175856","Jackson State University","2012","Not on tenure track/No tenure system system total","36","16","20","0","0","0","3","2","1","29","12","17","0","0","0","0","0","0","4","2","2","0","0","0","0","0","0","0","0","0","-2"
"175856","Jackson State University","2012","Not on tenure/no tenure system, professors","3","2","1","0","0","0","0","0","0","2","1","1","0","0","0","0","0","0","1","1","0","0","0","0","0","0","0","0","0","0","-2"
"175856","Jackson State University","2012","Not on tenure/no tenure system, associate professors","1","1","0","0","0","0","0","0","0","1","1","0","0","0","0","0","0","0","0","0","0","0","0","0","0","0","0","0","0","0","-2"
"175856","Jackson State University","2012","Not on tenure/no tenure system, assistant professors","9","4","5","0","0","0","1","1","0","7","2","5","0","0","0","0","0","0","1","1","0","0","0","0","0","0","0","0","0","0","-2"
"175856","Jackson State University","2012","Not on tenure/no tenure system, instructors","21","8","13","0","0","0","2","1","1","17","7","10","0","0","0","0","0","0","2","0","2","0","0","0","0","0","0","0","0","0","-2"
"175856","Jackson State University","2012","Not on tenure/no tenure system, lecturers","2","1","1","0","0","0","0","0","0","2","1","1","0","0","0","0","0","0","0","0","0","0","0","0","0","0","0","0","0","0","-2"
"176017","University of Mississippi","2012","Tenured total","361","245","116","2","2","0","4","2","2","22","11","11","2","2","0","0","0","0","306","207","99","20","17","3","0","0","0","5","4","1","-2"
"176017","University of Mississippi","2012","Tenured, professors","150","117","33","2","2","0","1","1","0","5","2","3","1","1","0","0","0","0","135","105","30","6","6","0","0","0","0","0","0","0","-2"
"176017","University of Mississippi","2012","Tenured, associate professors","207","125","82","0","0","0","3","1","2","17","9","8","1","1","0","0","0","0","168","100","68","14","11","3","0","0","0","4","3","1","-2"
"176017","University of Mississippi","2012","Tenured, assistant professors","4","3","1","0","0","0","0","0","0","0","0","0","0","0","0","0","0","0","3","2","1","0","0","0","0","0","0","1","1","0","-2"
"176017","University of Mississippi","2012","On-Tenure track total","172","98","74","0","0","0","4","2","2","12","4","8","2","1","1","1","0","1","131","77","54","0","0","0","3","1","2","19","13","6","-2"
"176017","University of Mississippi","2012","On-tenure track, professors","1","1","0","0","0","0","1","1","0","0","0","0","0","0","0","0","0","0","0","0","0","0","0","0","0","0","0","0","0","0","-2"
"176017","University of Mississippi","2012","On-tenure track, associate professors","4","3","1","0","0","0","0","0","0","0","0","0","0","0","0","0","0","0","4","3","1","0","0","0","0","0","0","0","0","0","-2"
"176017","University of Mississippi","2012","On-tenure track, assistant professors","167","94","73","0","0","0","3","1","2","12","4","8","2","1","1","1","0","1","127","74","53","0","0","0","3","1","2","19","13","6","-2"
"176017","University of Mississippi","2012","Not on tenure track/No tenure system system total","265","119","146","1","1","0","7","5","2","14","4","10","10","3","7","0","0","0","215","96","119","4","2","2","3","3","0","11","5","6","-2"
"176017","University of Mississippi","2012","Not on tenure/no tenure system, professors","15","13","2","1","1","0","2","2","0","0","0","0","0","0","0","0","0","0","10","8","2","2","2","0","0","0","0","0","0","0","-2"
"176017","University of Mississippi","2012","Not on tenure/no tenure system, associate professors","9","5","4","0","0","0","2","2","0","0","0","0","0","0","0","0","0","0","6","3","3","1","0","1","0","0","0","0","0","0","-2"
"176017","University of Mississippi","2012","Not on tenure/no tenure system, assistant professors","67","38","29","0","0","0","0","0","0","6","1","5","3","2","1","0","0","0","55","32","23","0","0","0","1","1","0","2","2","0","-2"
"176017","University of Mississippi","2012","Not on tenure/no tenure system, instructors","145","54","91","0","0","0","3","1","2","6","3","3","6","1","5","0","0","0","127","47","80","1","0","1","2","2","0","0","0","0","-2"
"176017","University of Mississippi","2012","Not on tenure/no tenure system, lecturers","29","9","20","0","0","0","0","0","0","2","0","2","1","0","1","0","0","0","17","6","11","0","0","0","0","0","0","9","3","6","-2"
"176044","Mississippi Valley State University","2012","Tenured total","58","33","25","0","0","0","9","6","3","38","21","17","1","0","1","0","0","0","10","6","4","0","0","0","0","0","0","0","0","0","-2"
"176044","Mississippi Valley State University","2012","Tenured, professors","13","11","2","0","0","0","4","4","0","6","5","1","0","0","0","0","0","0","3","2","1","0","0","0","0","0","0","0","0","0","-2"
"176044","Mississippi Valley State University","2012","Tenured, associate professors","26","15","11","0","0","0","4","1","3","14","10","4","1","0","1","0","0","0","7","4","3","0","0","0","0","0","0","0","0","0","-2"
"176044","Mississippi Valley State University","2012","Tenured, assistant professors","19","7","12","0","0","0","1","1","0","18","6","12","0","0","0","0","0","0","0","0","0","0","0","0","0","0","0","0","0","0","-2"
"176044","Mississippi Valley State University","2012","On-Tenure track total","48","23","25","0","0","0","6","6","0","32","11","21","0","0","0","0","0","0","10","6","4","0","0","0","0","0","0","0","0","0","-2"
"176044","Mississippi Valley State University","2012","On-tenure track, professors","4","2","2","0","0","0","0","0","0","2","1","1","0","0","0","0","0","0","2","1","1","0","0","0","0","0","0","0","0","0","-2"
"176044","Mississippi Valley State University","2012","On-tenure track, associate professors","10","5","5","0","0","0","1","1","0","8","4","4","0","0","0","0","0","0","1","0","1","0","0","0","0","0","0","0","0","0","-2"
"176044","Mississippi Valley State University","2012","On-tenure track, assistant professors","34","16","18","0","0","0","5","5","0","22","6","16","0","0","0","0","0","0","7","5","2","0","0","0","0","0","0","0","0","0","-2"
"176044","Mississippi Valley State University","2012","Not on tenure track/No tenure system system total","28","10","18","0","0","0","0","0","0","25","8","17","0","0","0","0","0","0","3","2","1","0","0","0","0","0","0","0","0","0","-2"
"176044","Mississippi Valley State University","2012","Not on tenure/no tenure system, instructors","28","10","18","0","0","0","0","0","0","25","8","17","0","0","0","0","0","0","3","2","1","0","0","0","0","0","0","0","0","0","-2"
"176080","Mississippi State University","2012","Tenured total","445","325","120","0","0","0","38","30","8","18","5","13","10","10","0","0","0","0","374","277","97","3","1","2","0","0","0","2","2","0","-2"
"176080","Mississippi State University","2012","Tenured, professors","235","188","47","0","0","0","15","14","1","7","4","3","6","6","0","0","0","0","207","164","43","0","0","0","0","0","0","0","0","0","-2"
"176080","Mississippi State University","2012","Tenured, associate professors","205","135","70","0","0","0","23","16","7","11","1","10","4","4","0","0","0","0","162","111","51","3","1","2","0","0","0","2","2","0","-2"
"176080","Mississippi State University","2012","Tenured, assistant professors","5","2","3","0","0","0","0","0","0","0","0","0","0","0","0","0","0","0","5","2","3","0","0","0","0","0","0","0","0","0","-2"
"176080","Mississippi State University","2012","On-Tenure track total","283","181","102","1","1","0","20","17","3","16","8","8","6","5","1","0","0","0","211","133","78","3","0","3","0","0","0","26","17","9","-2"
"176080","Mississippi State University","2012","On-tenure track, professors","1","1","0","0","0","0","0","0","0","0","0","0","0","0","0","0","0","0","1","1","0","0","0","0","0","0","0","0","0","0","-2"
"176080","Mississippi State University","2012","On-tenure track, associate professors","19","14","5","0","0","0","3","3","0","0","0","0","0","0","0","0","0","0","13","9","4","0","0","0","0","0","0","3","2","1","-2"
"176080","Mississippi State University","2012","On-tenure track, assistant professors","263","166","97","1","1","0","17","14","3","16","8","8","6","5","1","0","0","0","197","123","74","3","0","3","0","0","0","23","15","8","-2"
"176080","Mississippi State University","2012","Not on tenure track/No tenure system system total","203","71","132","2","1","1","4","1","3","10","2","8","4","0","4","2","1","1","178","64","114","1","1","0","0","0","0","2","1","1","-2"
"176080","Mississippi State University","2012","Not on tenure/no tenure system, assistant professors","5","2","3","0","0","0","0","0","0","1","0","1","1","0","1","0","0","0","3","2","1","0","0","0","0","0","0","0","0","0","-2"
"176080","Mississippi State University","2012","Not on tenure/no tenure system, instructors","146","49","97","1","1","0","3","1","2","8","2","6","3","0","3","1","0","1","127","43","84","1","1","0","0","0","0","2","1","1","-2"
"176080","Mississippi State University","2012","Not on tenure/no tenure system, lecturers","52","20","32","1","0","1","1","0","1","1","0","1","0","0","0","1","1","0","48","19","29","0","0","0","0","0","0","0","0","0","-2"
"178396","University of Missouri-Columbia","2012","Tenured total","788","571","217","1","1","0","103","88","15","23","14","9","22","15","7","1","1","0","623","441","182","2","1","1","13","10","3","0","0","0","-2"
"178396","University of Missouri-Columbia","2012","Tenured, professors","432","338","94","1","1","0","64","56","8","9","5","4","9","7","2","0","0","0","341","262","79","2","1","1","6","6","0","0","0","0","-2"
"178396","University of Missouri-Columbia","2012","Tenured, associate professors","354","232","122","0","0","0","39","32","7","14","9","5","13","8","5","1","1","0","280","178","102","0","0","0","7","4","3","0","0","0","-2"
"178396","University of Missouri-Columbia","2012","Tenured, assistant professors","2","1","1","0","0","0","0","0","0","0","0","0","0","0","0","0","0","0","2","1","1","0","0","0","0","0","0","0","0","0","-2"
"178396","University of Missouri-Columbia","2012","On-Tenure track total","292","158","134","2","2","0","32","19","13","15","7","8","16","7","9","1","0","1","192","102","90","2","0","2","0","0","0","32","21","11","-2"
"178396","University of Missouri-Columbia","2012","On-tenure track, professors","2","2","0","0","0","0","1","1","0","0","0","0","0","0","0","0","0","0","1","1","0","0","0","0","0","0","0","0","0","0","-2"
"178396","University of Missouri-Columbia","2012","On-tenure track, associate professors","24","19","5","0","0","0","6","5","1","0","0","0","1","1","0","0","0","0","17","13","4","0","0","0","0","0","0","0","0","0","-2"
"178396","University of Missouri-Columbia","2012","On-tenure track, assistant professors","266","137","129","2","2","0","25","13","12","15","7","8","15","6","9","1","0","1","174","88","86","2","0","2","0","0","0","32","21","11","-2"
"178396","University of Missouri-Columbia","2012","Not on tenure track/No tenure system system total","740","392","348","1","1","0","48","25","23","18","11","7","17","8","9","1","0","1","591","303","288","5","2","3","3","3","0","56","39","17","-2"
"178396","University of Missouri-Columbia","2012","Not on tenure/no tenure system, professors","54","39","15","0","0","0","3","3","0","1","1","0","0","0","0","0","0","0","50","35","15","0","0","0","0","0","0","0","0","0","-2"
"178396","University of Missouri-Columbia","2012","Not on tenure/no tenure system, associate professors","148","77","71","0","0","0","13","8","5","3","2","1","4","2","2","0","0","0","127","65","62","0","0","0","0","0","0","1","0","1","-2"
"178396","University of Missouri-Columbia","2012","Not on tenure/no tenure system, assistant professors","363","193","170","1","1","0","24","9","15","10","6","4","10","5","5","1","0","1","279","145","134","4","2","2","1","1","0","33","24","9","-2"
"178396","University of Missouri-Columbia","2012","Not on tenure/no tenure system, instructors","102","35","67","0","0","0","3","3","0","2","1","1","2","0","2","0","0","0","92","29","63","0","0","0","1","1","0","2","1","1","-2"
"178396","University of Missouri-Columbia","2012","Not on tenure/no tenure system, lecturers","11","4","7","0","0","0","2","0","2","0","0","0","1","1","0","0","0","0","6","2","4","1","0","1","1","1","0","0","0","0","-2"
"178396","University of Missouri-Columbia","2012","Not on tenure/no tenure system, no academic rank","62","44","18","0","0","0","3","2","1","2","1","1","0","0","0","0","0","0","37","27","10","0","0","0","0","0","0","20","14","6","-2"
"178411","Missouri University of Science and Technology","2012","Tenured total","199","168","31","0","0","0","42","36","6","4","3","1","3","3","0","0","0","0","141","119","22","2","2","0","1","1","0","6","4","2","-2"
"178411","Missouri University of Science and Technology","2012","Tenured, professors","114","101","13","0","0","0","25","23","2","3","2","1","2","2","0","0","0","0","80","70","10","0","0","0","1","1","0","3","3","0","-2"
"178411","Missouri University of Science and Technology","2012","Tenured, associate professors","85","67","18","0","0","0","17","13","4","1","1","0","1","1","0","0","0","0","61","49","12","2","2","0","0","0","0","3","1","2","-2"
"178411","Missouri University of Science and Technology","2012","On-Tenure track total","78","54","24","0","0","0","14","11","3","0","0","0","3","3","0","0","0","0","36","22","14","0","0","0","0","0","0","25","18","7","-2"
"178411","Missouri University of Science and Technology","2012","On-tenure track, associate professors","3","3","0","0","0","0","2","2","0","0","0","0","0","0","0","0","0","0","1","1","0","0","0","0","0","0","0","0","0","0","-2"
"178411","Missouri University of Science and Technology","2012","On-tenure track, assistant professors","75","51","24","0","0","0","12","9","3","0","0","0","3","3","0","0","0","0","35","21","14","0","0","0","0","0","0","25","18","7","-2"
"178411","Missouri University of Science and Technology","2012","Not on tenure track/No tenure system system total","52","28","24","0","0","0","2","2","0","0","0","0","1","0","1","0","0","0","41","20","21","0","0","0","0","0","0","8","6","2","-2"
"178411","Missouri University of Science and Technology","2012","Not on tenure/no tenure system, associate professors","11","5","6","0","0","0","1","1","0","0","0","0","0","0","0","0","0","0","10","4","6","0","0","0","0","0","0","0","0","0","-2"
"178411","Missouri University of Science and Technology","2012","Not on tenure/no tenure system, assistant professors","23","13","10","0","0","0","1","1","0","0","0","0","1","0","1","0","0","0","15","7","8","0","0","0","0","0","0","6","5","1","-2"
"178411","Missouri University of Science and Technology","2012","Not on tenure/no tenure system, instructors","1","0","1","0","0","0","0","0","0","0","0","0","0","0","0","0","0","0","1","0","1","0","0","0","0","0","0","0","0","0","-2"
"178411","Missouri University of Science and Technology","2012","Not on tenure/no tenure system, lecturers","13","7","6","0","0","0","0","0","0","0","0","0","0","0","0","0","0","0","13","7","6","0","0","0","0","0","0","0","0","0","-2"
"178411","Missouri University of Science and Technology","2012","Not on tenure/no tenure system, no academic rank","4","3","1","0","0","0","0","0","0","0","0","0","0","0","0","0","0","0","2","2","0","0","0","0","0","0","0","2","1","1","-2"
"179159","Saint Louis University","2012","Tenured total","538","380","158","0","0","0","42","33","9","15","10","5","14","8","6","0","0","0","450","314","136","7","7","0","1","1","0","9","7","2","-2"
"179159","Saint Louis University","2012","Tenured, professors","314","248","66","0","0","0","24","20","4","3","2","1","7","5","2","0","0","0","272","214","58","5","5","0","0","0","0","3","2","1","-2"
"179159","Saint Louis University","2012","Tenured, associate professors","220","130","90","0","0","0","18","13","5","12","8","4","7","3","4","0","0","0","174","98","76","2","2","0","1","1","0","6","5","1","-2"
"179159","Saint Louis University","2012","Tenured, assistant professors","3","1","2","0","0","0","0","0","0","0","0","0","0","0","0","0","0","0","3","1","2","0","0","0","0","0","0","0","0","0","-2"
"179159","Saint Louis University","2012","Tenured, instructors","1","1","0","0","0","0","0","0","0","0","0","0","0","0","0","0","0","0","1","1","0","0","0","0","0","0","0","0","0","0","-2"
"179159","Saint Louis University","2012","On-Tenure track total","249","134","115","0","0","0","24","17","7","10","5","5","13","6","7","0","0","0","165","84","81","7","2","5","5","2","3","25","18","7","-2"
"179159","Saint Louis University","2012","On-tenure track, professors","9","5","4","0","0","0","1","1","0","0","0","0","0","0","0","0","0","0","8","4","4","0","0","0","0","0","0","0","0","0","-2"
"179159","Saint Louis University","2012","On-tenure track, associate professors","18","10","8","0","0","0","5","4","1","0","0","0","0","0","0","0","0","0","12","5","7","0","0","0","0","0","0","1","1","0","-2"
"179159","Saint Louis University","2012","On-tenure track, assistant professors","221","119","102","0","0","0","18","12","6","10","5","5","13","6","7","0","0","0","144","75","69","7","2","5","5","2","3","24","17","7","-2"
"179159","Saint Louis University","2012","On-tenure track, instructors","1","0","1","0","0","0","0","0","0","0","0","0","0","0","0","0","0","0","1","0","1","0","0","0","0","0","0","0","0","0","-2"
"179159","Saint Louis University","2012","Not on tenure track/No tenure system system total","528","260","268","0","0","0","56","25","31","15","6","9","18","10","8","0","0","0","398","196","202","9","2","7","11","8","3","21","13","8","-2"
"179159","Saint Louis University","2012","Not on tenure/no tenure system, professors","68","51","17","0","0","0","5","3","2","2","0","2","0","0","0","0","0","0","59","47","12","1","1","0","1","0","1","0","0","0","-2"
"179159","Saint Louis University","2012","Not on tenure/no tenure system, associate professors","120","61","59","0","0","0","16","10","6","2","1","1","4","2","2","0","0","0","96","46","50","0","0","0","0","0","0","2","2","0","-2"
"179159","Saint Louis University","2012","Not on tenure/no tenure system, assistant professors","234","103","131","0","0","0","29","10","19","5","3","2","8","4","4","0","0","0","166","73","93","5","1","4","7","5","2","14","7","7","-2"
"179159","Saint Louis University","2012","Not on tenure/no tenure system, instructors","105","44","61","0","0","0","6","2","4","6","2","4","6","4","2","0","0","0","76","29","47","3","0","3","3","3","0","5","4","1","-2"
"179159","Saint Louis University","2012","Not on tenure/no tenure system, no academic rank","1","1","0","0","0","0","0","0","0","0","0","0","0","0","0","0","0","0","1","1","0","0","0","0","0","0","0","0","0","0","-2"
"179867","Washington University in St Louis","2012","Tenured total","932","724","208","0","0","0","88","71","17","21","9","12","17","15","2","0","0","0","804","627","177","2","2","0","0","0","0","0","0","0","-2"
"179867","Washington University in St Louis","2012","Tenured, professors","668","542","126","0","0","0","44","37","7","12","7","5","12","11","1","0","0","0","599","486","113","1","1","0","0","0","0","0","0","0","-2"
"179867","Washington University in St Louis","2012","Tenured, associate professors","264","182","82","0","0","0","44","34","10","9","2","7","5","4","1","0","0","0","205","141","64","1","1","0","0","0","0","0","0","0","-2"
"179867","Washington University in St Louis","2012","On-Tenure track total","360","230","130","1","1","0","82","51","31","17","9","8","14","12","2","1","0","1","244","156","88","1","1","0","0","0","0","0","0","0","-2"
"179867","Washington University in St Louis","2012","On-tenure track, professors","1","0","1","0","0","0","0","0","0","1","0","1","0","0","0","0","0","0","0","0","0","0","0","0","0","0","0","0","0","0","-2"
"179867","Washington University in St Louis","2012","On-tenure track, associate professors","16","12","4","0","0","0","2","1","1","2","2","0","0","0","0","0","0","0","11","8","3","1","1","0","0","0","0","0","0","0","-2"
"179867","Washington University in St Louis","2012","On-tenure track, assistant professors","343","218","125","1","1","0","80","50","30","14","7","7","14","12","2","1","0","1","233","148","85","0","0","0","0","0","0","0","0","0","-2"
"179867","Washington University in St Louis","2012","Not on tenure track/No tenure system system total","255","122","133","0","0","0","31","12","19","5","3","2","9","2","7","0","0","0","206","104","102","2","0","2","0","0","0","2","1","1","-2"
"179867","Washington University in St Louis","2012","Not on tenure/no tenure system, professors","25","15","10","0","0","0","1","0","1","0","0","0","0","0","0","0","0","0","23","14","9","0","0","0","0","0","0","1","1","0","-2"
"179867","Washington University in St Louis","2012","Not on tenure/no tenure system, assistant professors","10","6","4","0","0","0","3","2","1","0","0","0","0","0","0","0","0","0","7","4","3","0","0","0","0","0","0","0","0","0","-2"
"179867","Washington University in St Louis","2012","Not on tenure/no tenure system, instructors","42","24","18","0","0","0","10","5","5","0","0","0","0","0","0","0","0","0","32","19","13","0","0","0","0","0","0","0","0","0","-2"
"179867","Washington University in St Louis","2012","Not on tenure/no tenure system, lecturers","156","69","87","0","0","0","17","5","12","5","3","2","8","2","6","0","0","0","124","59","65","1","0","1","0","0","0","1","0","1","-2"
"179867","Washington University in St Louis","2012","Not on tenure/no tenure system, no academic rank","22","8","14","0","0","0","0","0","0","0","0","0","1","0","1","0","0","0","20","8","12","1","0","1","0","0","0","0","0","0","-2"
"181464","University of Nebraska-Lincoln","2012","Tenured total","774","570","204","5","1","4","71","54","17","18","9","9","24","20","4","0","0","0","652","482","170","0","0","0","0","0","0","4","4","0","-2"
"181464","University of Nebraska-Lincoln","2012","Tenured, professors","481","388","93","0","0","0","31","29","2","5","3","2","11","10","1","0","0","0","433","345","88","0","0","0","0","0","0","1","1","0","-2"
"181464","University of Nebraska-Lincoln","2012","Tenured, associate professors","291","181","110","5","1","4","40","25","15","13","6","7","13","10","3","0","0","0","217","136","81","0","0","0","0","0","0","3","3","0","-2"
"181464","University of Nebraska-Lincoln","2012","Tenured, assistant professors","2","1","1","0","0","0","0","0","0","0","0","0","0","0","0","0","0","0","2","1","1","0","0","0","0","0","0","0","0","0","-2"
"181464","University of Nebraska-Lincoln","2012","On-Tenure track total","255","162","93","1","0","1","41","29","12","8","1","7","10","8","2","0","0","0","171","107","64","1","0","1","0","0","0","23","17","6","-2"
"181464","University of Nebraska-Lincoln","2012","On-tenure track, professors","1","1","0","0","0","0","0","0","0","0","0","0","0","0","0","0","0","0","1","1","0","0","0","0","0","0","0","0","0","0","-2"
"181464","University of Nebraska-Lincoln","2012","On-tenure track, associate professors","21","13","8","0","0","0","3","3","0","2","0","2","0","0","0","0","0","0","16","10","6","0","0","0","0","0","0","0","0","0","-2"
"181464","University of Nebraska-Lincoln","2012","On-tenure track, assistant professors","233","148","85","1","0","1","38","26","12","6","1","5","10","8","2","0","0","0","154","96","58","1","0","1","0","0","0","23","17","6","-2"
"181464","University of Nebraska-Lincoln","2012","Not on tenure track/No tenure system system total","178","76","102","0","0","0","9","5","4","4","1","3","6","3","3","0","0","0","155","65","90","0","0","0","0","0","0","4","2","2","-2"
"181464","University of Nebraska-Lincoln","2012","Not on tenure/no tenure system, professors","2","1","1","0","0","0","0","0","0","0","0","0","0","0","0","0","0","0","2","1","1","0","0","0","0","0","0","0","0","0","-2"
"181464","University of Nebraska-Lincoln","2012","Not on tenure/no tenure system, lecturers","176","75","101","0","0","0","9","5","4","4","1","3","6","3","3","0","0","0","153","64","89","0","0","0","0","0","0","4","2","2","-2"
"182281","University of Nevada-Las Vegas","2012","Tenured total","504","365","139","4","2","2","72","57","15","14","9","5","23","14","9","0","0","0","389","281","108","1","1","0","0","0","0","1","1","0","-2"
"182281","University of Nevada-Las Vegas","2012","Tenured, professors","273","215","58","2","1","1","41","35","6","7","6","1","10","8","2","0","0","0","213","165","48","0","0","0","0","0","0","0","0","0","-2"
"182281","University of Nevada-Las Vegas","2012","Tenured, associate professors","226","146","80","2","1","1","30","21","9","7","3","4","13","6","7","0","0","0","172","113","59","1","1","0","0","0","0","1","1","0","-2"
"182281","University of Nevada-Las Vegas","2012","Tenured, assistant professors","5","4","1","0","0","0","1","1","0","0","0","0","0","0","0","0","0","0","4","3","1","0","0","0","0","0","0","0","0","0","-2"
"182281","University of Nevada-Las Vegas","2012","On-Tenure track total","144","70","74","2","0","2","25","12","13","10","4","6","8","3","5","1","1","0","82","39","43","3","1","2","0","0","0","13","10","3","-2"
"182281","University of Nevada-Las Vegas","2012","On-tenure track, associate professors","22","9","13","0","0","0","3","2","1","1","0","1","1","0","1","1","1","0","14","5","9","1","0","1","0","0","0","1","1","0","-2"
"182281","University of Nevada-Las Vegas","2012","On-tenure track, assistant professors","121","61","60","2","0","2","22","10","12","8","4","4","7","3","4","0","0","0","68","34","34","2","1","1","0","0","0","12","9","3","-2"
"182281","University of Nevada-Las Vegas","2012","On-tenure track, instructors","1","0","1","0","0","0","0","0","0","1","0","1","0","0","0","0","0","0","0","0","0","0","0","0","0","0","0","0","0","0","-2"
"182281","University of Nevada-Las Vegas","2012","Not on tenure track/No tenure system system total","182","94","88","2","2","0","21","12","9","7","1","6","7","2","5","0","0","0","138","74","64","1","0","1","0","0","0","6","3","3","-2"
"182281","University of Nevada-Las Vegas","2012","Not on tenure/no tenure system, professors","6","5","1","0","0","0","1","1","0","0","0","0","0","0","0","0","0","0","5","4","1","0","0","0","0","0","0","0","0","0","-2"
"182281","University of Nevada-Las Vegas","2012","Not on tenure/no tenure system, associate professors","31","23","8","0","0","0","4","3","1","1","0","1","1","0","1","0","0","0","25","20","5","0","0","0","0","0","0","0","0","0","-2"
"182281","University of Nevada-Las Vegas","2012","Not on tenure/no tenure system, assistant professors","71","34","37","2","2","0","9","5","4","4","1","3","2","0","2","0","0","0","50","24","26","0","0","0","0","0","0","4","2","2","-2"
"182281","University of Nevada-Las Vegas","2012","Not on tenure/no tenure system, lecturers","73","32","41","0","0","0","7","3","4","2","0","2","4","2","2","0","0","0","57","26","31","1","0","1","0","0","0","2","1","1","-2"
"182281","University of Nevada-Las Vegas","2012","Not on tenure/no tenure system, no academic rank","1","0","1","0","0","0","0","0","0","0","0","0","0","0","0","0","0","0","1","0","1","0","0","0","0","0","0","0","0","0","-2"
"182670","Dartmouth College","2012","Tenured total","405","289","116","3","2","1","22","15","7","9","6","3","15","9","6","0","0","0","346","251","95","8","4","4","0","0","0","2","2","0","-2"
"182670","Dartmouth College","2012","Tenured, professors","279","212","67","1","1","0","13","9","4","2","2","0","6","4","2","0","0","0","252","193","59","4","2","2","0","0","0","1","1","0","-2"
"182670","Dartmouth College","2012","Tenured, associate professors","126","77","49","2","1","1","9","6","3","7","4","3","9","5","4","0","0","0","94","58","36","4","2","2","0","0","0","1","1","0","-2"
"182670","Dartmouth College","2012","On-Tenure track total","158","94","64","1","0","1","15","11","4","9","4","5","10","3","7","0","0","0","105","64","41","3","2","1","0","0","0","15","10","5","-2"
"182670","Dartmouth College","2012","On-tenure track, professors","1","1","0","0","0","0","0","0","0","0","0","0","0","0","0","0","0","0","1","1","0","0","0","0","0","0","0","0","0","0","-2"
"182670","Dartmouth College","2012","On-tenure track, associate professors","35","24","11","0","0","0","3","2","1","1","1","0","1","0","1","0","0","0","28","19","9","0","0","0","0","0","0","2","2","0","-2"
"182670","Dartmouth College","2012","On-tenure track, assistant professors","120","68","52","1","0","1","12","9","3","8","3","5","9","3","6","0","0","0","75","44","31","3","2","1","0","0","0","12","7","5","-2"
"182670","Dartmouth College","2012","On-tenure track, instructors","2","1","1","0","0","0","0","0","0","0","0","0","0","0","0","0","0","0","1","0","1","0","0","0","0","0","0","1","1","0","-2"
"182670","Dartmouth College","2012","Not on tenure track/No tenure system system total","199","107","92","1","0","1","11","7","4","1","0","1","4","0","4","0","0","0","169","92","77","3","3","0","0","0","0","10","5","5","-2"
"182670","Dartmouth College","2012","Not on tenure/no tenure system, professors","28","23","5","0","0","0","2","2","0","0","0","0","0","0","0","0","0","0","24","20","4","1","1","0","0","0","0","1","0","1","-2"
"182670","Dartmouth College","2012","Not on tenure/no tenure system, associate professors","31","19","12","0","0","0","1","1","0","1","0","1","1","0","1","0","0","0","28","18","10","0","0","0","0","0","0","0","0","0","-2"
"182670","Dartmouth College","2012","Not on tenure/no tenure system, assistant professors","51","28","23","0","0","0","3","2","1","0","0","0","0","0","0","0","0","0","46","24","22","0","0","0","0","0","0","2","2","0","-2"
"182670","Dartmouth College","2012","Not on tenure/no tenure system, instructors","38","17","21","0","0","0","2","1","1","0","0","0","0","0","0","0","0","0","34","16","18","0","0","0","0","0","0","2","0","2","-2"
"182670","Dartmouth College","2012","Not on tenure/no tenure system, lecturers","45","18","27","1","0","1","3","1","2","0","0","0","3","0","3","0","0","0","32","13","19","2","2","0","0","0","0","4","2","2","-2"
"182670","Dartmouth College","2012","Not on tenure/no tenure system, no academic rank","6","2","4","0","0","0","0","0","0","0","0","0","0","0","0","0","0","0","5","1","4","0","0","0","0","0","0","1","1","0","-2"
"183044","University of New Hampshire-Main Campus","2012","Tenured total","436","288","148","0","0","0","19","10","9","5","4","1","12","7","5","0","0","0","374","249","125","3","3","0","23","15","8","0","0","0","-2"
"183044","University of New Hampshire-Main Campus","2012","Tenured, professors","219","170","49","0","0","0","6","3","3","1","1","0","1","1","0","0","0","0","201","158","43","1","1","0","9","6","3","0","0","0","-2"
"183044","University of New Hampshire-Main Campus","2012","Tenured, associate professors","217","118","99","0","0","0","13","7","6","4","3","1","11","6","5","0","0","0","173","91","82","2","2","0","14","9","5","0","0","0","-2"
"183044","University of New Hampshire-Main Campus","2012","On-Tenure track total","115","63","52","1","1","0","16","7","9","3","2","1","1","1","0","0","0","0","57","33","24","0","0","0","34","18","16","3","1","2","-2"
"183044","University of New Hampshire-Main Campus","2012","On-tenure track, professors","1","1","0","0","0","0","0","0","0","0","0","0","0","0","0","0","0","0","1","1","0","0","0","0","0","0","0","0","0","0","-2"
"183044","University of New Hampshire-Main Campus","2012","On-tenure track, associate professors","9","7","2","0","0","0","0","0","0","0","0","0","0","0","0","0","0","0","7","6","1","0","0","0","2","1","1","0","0","0","-2"
"183044","University of New Hampshire-Main Campus","2012","On-tenure track, assistant professors","105","55","50","1","1","0","16","7","9","3","2","1","1","1","0","0","0","0","49","26","23","0","0","0","32","17","15","3","1","2","-2"
"183044","University of New Hampshire-Main Campus","2012","Not on tenure track/No tenure system system total","45","10","35","0","0","0","0","0","0","0","0","0","0","0","0","0","0","0","38","9","29","0","0","0","7","1","6","0","0","0","-2"
"183044","University of New Hampshire-Main Campus","2012","Not on tenure/no tenure system, professors","3","2","1","0","0","0","0","0","0","0","0","0","0","0","0","0","0","0","3","2","1","0","0","0","0","0","0","0","0","0","-2"
"183044","University of New Hampshire-Main Campus","2012","Not on tenure/no tenure system, associate professors","10","3","7","0","0","0","0","0","0","0","0","0","0","0","0","0","0","0","9","3","6","0","0","0","1","0","1","0","0","0","-2"
"183044","University of New Hampshire-Main Campus","2012","Not on tenure/no tenure system, assistant professors","29","4","25","0","0","0","0","0","0","0","0","0","0","0","0","0","0","0","23","3","20","0","0","0","6","1","5","0","0","0","-2"
"183044","University of New Hampshire-Main Campus","2012","Not on tenure/no tenure system, no academic rank","3","1","2","0","0","0","0","0","0","0","0","0","0","0","0","0","0","0","3","1","2","0","0","0","0","0","0","0","0","0","-2"
"183080","Plymouth State University","2012","Tenured total","125","74","51","0","0","0","8","7","1","2","1","1","1","0","1","0","0","0","107","62","45","0","0","0","6","3","3","1","1","0","-2"
"183080","Plymouth State University","2012","Tenured, professors","78","49","29","0","0","0","5","4","1","0","0","0","0","0","0","0","0","0","71","44","27","0","0","0","2","1","1","0","0","0","-2"
"183080","Plymouth State University","2012","Tenured, associate professors","46","24","22","0","0","0","3","3","0","2","1","1","1","0","1","0","0","0","35","17","18","0","0","0","4","2","2","1","1","0","-2"
"183080","Plymouth State University","2012","Tenured, assistant professors","1","1","0","0","0","0","0","0","0","0","0","0","0","0","0","0","0","0","1","1","0","0","0","0","0","0","0","0","0","0","-2"
"183080","Plymouth State University","2012","On-Tenure track total","32","11","21","0","0","0","2","1","1","0","0","0","0","0","0","0","0","0","26","8","18","0","0","0","3","1","2","1","1","0","-2"
"183080","Plymouth State University","2012","On-tenure track, associate professors","3","0","3","0","0","0","0","0","0","0","0","0","0","0","0","0","0","0","2","0","2","0","0","0","1","0","1","0","0","0","-2"
"183080","Plymouth State University","2012","On-tenure track, assistant professors","29","11","18","0","0","0","2","1","1","0","0","0","0","0","0","0","0","0","24","8","16","0","0","0","2","1","1","1","1","0","-2"
"183080","Plymouth State University","2012","Not on tenure track/No tenure system system total","32","13","19","0","0","0","1","0","1","0","0","0","2","1","1","0","0","0","27","11","16","0","0","0","2","1","1","0","0","0","-2"
"183080","Plymouth State University","2012","Not on tenure/no tenure system, associate professors","1","0","1","0","0","0","0","0","0","0","0","0","0","0","0","0","0","0","1","0","1","0","0","0","0","0","0","0","0","0","-2"
"183080","Plymouth State University","2012","Not on tenure/no tenure system, assistant professors","4","0","4","0","0","0","0","0","0","0","0","0","0","0","0","0","0","0","4","0","4","0","0","0","0","0","0","0","0","0","-2"
"183080","Plymouth State University","2012","Not on tenure/no tenure system, no academic rank","27","13","14","0","0","0","1","0","1","0","0","0","2","1","1","0","0","0","22","11","11","0","0","0","2","1","1","0","0","0","-2"
"185262","Kean University","2012","Tenured total","257","141","116","1","1","0","26","14","12","28","13","15","20","12","8","0","0","0","180","101","79","0","0","0","0","0","0","2","0","2","-2"
"185262","Kean University","2012","Tenured, professors","105","67","38","1","1","0","6","6","0","14","7","7","7","6","1","0","0","0","77","47","30","0","0","0","0","0","0","0","0","0","-2"
"185262","Kean University","2012","Tenured, associate professors","78","37","41","0","0","0","11","2","9","5","2","3","6","3","3","0","0","0","56","30","26","0","0","0","0","0","0","0","0","0","-2"
"185262","Kean University","2012","Tenured, assistant professors","74","37","37","0","0","0","9","6","3","9","4","5","7","3","4","0","0","0","47","24","23","0","0","0","0","0","0","2","0","2","-2"
"185262","Kean University","2012","On-Tenure track total","55","19","36","0","0","0","9","1","8","2","0","2","2","0","2","0","0","0","33","14","19","0","0","0","0","0","0","9","4","5","-2"
"185262","Kean University","2012","On-tenure track, professors","1","1","0","0","0","0","0","0","0","0","0","0","0","0","0","0","0","0","1","1","0","0","0","0","0","0","0","0","0","0","-2"
"185262","Kean University","2012","On-tenure track, associate professors","6","4","2","0","0","0","0","0","0","0","0","0","0","0","0","0","0","0","6","4","2","0","0","0","0","0","0","0","0","0","-2"
"185262","Kean University","2012","On-tenure track, assistant professors","48","14","34","0","0","0","9","1","8","2","0","2","2","0","2","0","0","0","26","9","17","0","0","0","0","0","0","9","4","5","-2"
"185262","Kean University","2012","Not on tenure track/No tenure system system total","32","8","24","0","0","0","1","0","1","2","1","1","0","0","0","0","0","0","27","5","22","0","0","0","1","1","0","1","1","0","-2"
"185262","Kean University","2012","Not on tenure/no tenure system, assistant professors","7","1","6","0","0","0","0","0","0","1","0","1","0","0","0","0","0","0","6","1","5","0","0","0","0","0","0","0","0","0","-2"
"185262","Kean University","2012","Not on tenure/no tenure system, lecturers","25","7","18","0","0","0","1","0","1","1","1","0","0","0","0","0","0","0","21","4","17","0","0","0","1","1","0","1","1","0","-2"
"186131","Princeton University","2012","Tenured total","548","425","123","0","0","0","53","47","6","19","12","7","14","12","2","0","0","0","458","352","106","2","1","1","0","0","0","2","1","1","-2"
"186131","Princeton University","2012","Tenured, professors","470","374","96","0","0","0","45","40","5","18","12","6","10","9","1","0","0","0","393","311","82","2","1","1","0","0","0","2","1","1","-2"
"186131","Princeton University","2012","Tenured, associate professors","77","50","27","0","0","0","8","7","1","1","0","1","4","3","1","0","0","0","64","40","24","0","0","0","0","0","0","0","0","0","-2"
"186131","Princeton University","2012","Tenured, lecturers","1","1","0","0","0","0","0","0","0","0","0","0","0","0","0","0","0","0","1","1","0","0","0","0","0","0","0","0","0","0","-2"
"186131","Princeton University","2012","On-Tenure track total","177","110","67","0","0","0","10","4","6","4","3","1","7","3","4","0","0","0","113","71","42","1","0","1","2","2","0","40","27","13","-2"
"186131","Princeton University","2012","On-tenure track, assistant professors","177","110","67","0","0","0","10","4","6","4","3","1","7","3","4","0","0","0","113","71","42","1","0","1","2","2","0","40","27","13","-2"
"186131","Princeton University","2012","Not on tenure track/No tenure system system total","146","77","69","0","0","0","12","3","9","3","3","0","4","0","4","0","0","0","73","40","33","1","0","1","6","2","4","47","29","18","-2"
"186131","Princeton University","2012","Not on tenure/no tenure system, instructors","19","16","3","0","0","0","0","0","0","0","0","0","0","0","0","0","0","0","2","2","0","0","0","0","0","0","0","17","14","3","-2"
"186131","Princeton University","2012","Not on tenure/no tenure system, lecturers","127","61","66","0","0","0","12","3","9","3","3","0","4","0","4","0","0","0","71","38","33","1","0","1","6","2","4","30","15","15","-2"
"186380","Rutgers University-New Brunswick","2012","Tenured total","1068","742","326","1","1","0","128","98","30","35","16","19","29","22","7","1","1","0","849","591","258","3","2","1","7","3","4","15","8","7","-2"
"186380","Rutgers University-New Brunswick","2012","Tenured, professors","714","542","172","0","0","0","85","71","14","19","13","6","16","13","3","1","1","0","585","441","144","2","2","0","4","1","3","2","0","2","-2"
"186380","Rutgers University-New Brunswick","2012","Tenured, associate professors","354","200","154","1","1","0","43","27","16","16","3","13","13","9","4","0","0","0","264","150","114","1","0","1","3","2","1","13","8","5","-2"
"186380","Rutgers University-New Brunswick","2012","On-Tenure track total","326","168","158","1","1","0","25","15","10","8","3","5","15","5","10","0","0","0","116","59","57","2","0","2","104","51","53","55","34","21","-2"
"186380","Rutgers University-New Brunswick","2012","On-tenure track, professors","15","11","4","0","0","0","1","0","1","1","0","1","0","0","0","0","0","0","7","6","1","0","0","0","6","5","1","0","0","0","-2"
"186380","Rutgers University-New Brunswick","2012","On-tenure track, associate professors","69","35","34","0","0","0","5","3","2","2","1","1","3","2","1","0","0","0","35","17","18","0","0","0","18","7","11","6","5","1","-2"
"186380","Rutgers University-New Brunswick","2012","On-tenure track, assistant professors","242","122","120","1","1","0","19","12","7","5","2","3","12","3","9","0","0","0","74","36","38","2","0","2","80","39","41","49","29","20","-2"
"186380","Rutgers University-New Brunswick","2012","Not on tenure track/No tenure system system total","320","140","180","0","0","0","29","12","17","9","4","5","6","1","5","0","0","0","199","84","115","1","1","0","56","25","31","20","13","7","-2"
"186380","Rutgers University-New Brunswick","2012","Not on tenure/no tenure system, professors","4","1","3","0","0","0","1","0","1","0","0","0","0","0","0","0","0","0","1","0","1","0","0","0","1","0","1","1","1","0","-2"
"186380","Rutgers University-New Brunswick","2012","Not on tenure/no tenure system, associate professors","11","5","6","0","0","0","1","0","1","1","1","0","1","0","1","0","0","0","8","4","4","0","0","0","0","0","0","0","0","0","-2"
"186380","Rutgers University-New Brunswick","2012","Not on tenure/no tenure system, assistant professors","64","22","42","0","0","0","11","3","8","1","0","1","1","0","1","0","0","0","31","10","21","1","1","0","13","3","10","6","5","1","-2"
"186380","Rutgers University-New Brunswick","2012","Not on tenure/no tenure system, instructors","167","74","93","0","0","0","10","5","5","4","1","3","3","1","2","0","0","0","116","50","66","0","0","0","28","14","14","6","3","3","-2"
"186380","Rutgers University-New Brunswick","2012","Not on tenure/no tenure system, lecturers","74","38","36","0","0","0","6","4","2","3","2","1","1","0","1","0","0","0","43","20","23","0","0","0","14","8","6","7","4","3","-2"
"187967","New Mexico Institute of Mining and Technology","2012","Tenured total","77","66","11","0","0","0","10","10","0","0","0","0","3","3","0","0","0","0","64","53","11","0","0","0","0","0","0","0","0","0","-2"
"187967","New Mexico Institute of Mining and Technology","2012","Tenured, professors","40","37","3","0","0","0","4","4","0","0","0","0","2","2","0","0","0","0","34","31","3","0","0","0","0","0","0","0","0","0","-2"
"187967","New Mexico Institute of Mining and Technology","2012","Tenured, associate professors","36","28","8","0","0","0","6","6","0","0","0","0","1","1","0","0","0","0","29","21","8","0","0","0","0","0","0","0","0","0","-2"
"187967","New Mexico Institute of Mining and Technology","2012","Tenured, assistant professors","1","1","0","0","0","0","0","0","0","0","0","0","0","0","0","0","0","0","1","1","0","0","0","0","0","0","0","0","0","0","-2"
"187967","New Mexico Institute of Mining and Technology","2012","On-Tenure track total","26","20","6","0","0","0","5","5","0","0","0","0","2","2","0","0","0","0","18","12","6","0","0","0","1","1","0","0","0","0","-2"
"187967","New Mexico Institute of Mining and Technology","2012","On-tenure track, associate professors","7","5","2","0","0","0","0","0","0","0","0","0","2","2","0","0","0","0","5","3","2","0","0","0","0","0","0","0","0","0","-2"
"187967","New Mexico Institute of Mining and Technology","2012","On-tenure track, assistant professors","19","15","4","0","0","0","5","5","0","0","0","0","0","0","0","0","0","0","13","9","4","0","0","0","1","1","0","0","0","0","-2"
"187967","New Mexico Institute of Mining and Technology","2012","Not on tenure track/No tenure system system total","19","12","7","0","0","0","5","3","2","0","0","0","0","0","0","0","0","0","14","9","5","0","0","0","0","0","0","0","0","0","-2"
"187967","New Mexico Institute of Mining and Technology","2012","Not on tenure/no tenure system, professors","4","4","0","0","0","0","0","0","0","0","0","0","0","0","0","0","0","0","4","4","0","0","0","0","0","0","0","0","0","0","-2"
"187967","New Mexico Institute of Mining and Technology","2012","Not on tenure/no tenure system, associate professors","1","1","0","0","0","0","0","0","0","0","0","0","0","0","0","0","0","0","1","1","0","0","0","0","0","0","0","0","0","0","-2"
"187967","New Mexico Institute of Mining and Technology","2012","Not on tenure/no tenure system, assistant professors","7","5","2","0","0","0","5","3","2","0","0","0","0","0","0","0","0","0","2","2","0","0","0","0","0","0","0","0","0","0","-2"
"187967","New Mexico Institute of Mining and Technology","2012","Not on tenure/no tenure system, instructors","5","2","3","0","0","0","0","0","0","0","0","0","0","0","0","0","0","0","5","2","3","0","0","0","0","0","0","0","0","0","-2"
"187967","New Mexico Institute of Mining and Technology","2012","Not on tenure/no tenure system, lecturers","2","0","2","0","0","0","0","0","0","0","0","0","0","0","0","0","0","0","2","0","2","0","0","0","0","0","0","0","0","0","-2"
"190150","Columbia University in the City of New York","2012","Tenured total","1019","767","252","1","1","0","119","92","27","29","18","11","23","18","5","0","0","0","824","617","207","2","2","0","9","7","2","12","12","0","-2"
"190150","Columbia University in the City of New York","2012","Tenured, professors","846","650","196","0","0","0","91","73","18","21","13","8","15","13","2","0","0","0","699","532","167","2","2","0","8","7","1","10","10","0","-2"
"190150","Columbia University in the City of New York","2012","Tenured, associate professors","172","117","55","1","1","0","28","19","9","7","5","2","8","5","3","0","0","0","125","85","40","0","0","0","1","0","1","2","2","0","-2"
"190150","Columbia University in the City of New York","2012","Tenured, lecturers","1","0","1","0","0","0","0","0","0","1","0","1","0","0","0","0","0","0","0","0","0","0","0","0","0","0","0","0","0","0","-2"
"190150","Columbia University in the City of New York","2012","On-Tenure track total","625","399","226","2","1","1","91","60","31","31","15","16","24","12","12","0","0","0","353","217","136","8","3","5","13","11","2","103","80","23","-2"
"190150","Columbia University in the City of New York","2012","On-tenure track, professors","44","36","8","0","0","0","8","7","1","1","1","0","0","0","0","0","0","0","32","25","7","0","0","0","1","1","0","2","2","0","-2"
"190150","Columbia University in the City of New York","2012","On-tenure track, associate professors","118","75","43","0","0","0","12","9","3","10","7","3","4","4","0","0","0","0","85","50","35","0","0","0","1","1","0","6","4","2","-2"
"190150","Columbia University in the City of New York","2012","On-tenure track, assistant professors","409","247","162","2","1","1","62","35","27","17","5","12","17","7","10","0","0","0","219","130","89","6","3","3","9","7","2","77","59","18","-2"
"190150","Columbia University in the City of New York","2012","On-tenure track, instructors","11","10","1","0","0","0","4","4","0","0","0","0","0","0","0","0","0","0","2","2","0","1","0","1","0","0","0","4","4","0","-2"
"190150","Columbia University in the City of New York","2012","On-tenure track, lecturers","43","31","12","0","0","0","5","5","0","3","2","1","3","1","2","0","0","0","15","10","5","1","0","1","2","2","0","14","11","3","-2"
"190150","Columbia University in the City of New York","2012","Not on tenure track/No tenure system system total","1994","1024","970","0","0","0","300","148","152","97","46","51","100","44","56","1","0","1","1365","727","638","14","6","8","34","14","20","83","39","44","-2"
"190150","Columbia University in the City of New York","2012","Not on tenure/no tenure system, professors","359","258","101","0","0","0","23","15","8","14","7","7","13","11","2","0","0","0","299","220","79","3","2","1","4","1","3","3","2","1","-2"
"190150","Columbia University in the City of New York","2012","Not on tenure/no tenure system, associate professors","347","201","146","0","0","0","45","26","19","14","8","6","10","4","6","0","0","0","267","156","111","0","0","0","5","4","1","6","3","3","-2"
"190150","Columbia University in the City of New York","2012","Not on tenure/no tenure system, assistant professors","891","403","488","0","0","0","179","84","95","49","23","26","56","22","34","1","0","1","553","251","302","9","4","5","20","6","14","24","13","11","-2"
"190150","Columbia University in the City of New York","2012","Not on tenure/no tenure system, instructors","147","50","97","0","0","0","26","10","16","15","4","11","9","2","7","0","0","0","78","30","48","0","0","0","1","1","0","18","3","15","-2"
"190150","Columbia University in the City of New York","2012","Not on tenure/no tenure system, lecturers","250","112","138","0","0","0","27","13","14","5","4","1","12","5","7","0","0","0","168","70","98","2","0","2","4","2","2","32","18","14","-2"
"190415","Cornell University","2012","Tenured total","1153","851","302","6","3","3","89","72","17","35","18","17","33","18","15","0","0","0","968","721","247","1","0","1","8","7","1","13","12","1","-2"
"190415","Cornell University","2012","Tenured, professors","747","585","162","2","2","0","48","43","5","21","15","6","17","11","6","0","0","0","645","502","143","0","0","0","6","5","1","8","7","1","-2"
"190415","Cornell University","2012","Tenured, associate professors","406","266","140","4","1","3","41","29","12","14","3","11","16","7","9","0","0","0","323","219","104","1","0","1","2","2","0","5","5","0","-2"
"190415","Cornell University","2012","On-Tenure track total","271","168","103","0","0","0","34","19","15","13","9","4","11","5","6","0","0","0","165","102","63","4","1","3","6","5","1","38","27","11","-2"
"190415","Cornell University","2012","On-tenure track, professors","3","3","0","0","0","0","0","0","0","0","0","0","0","0","0","0","0","0","2","2","0","0","0","0","1","1","0","0","0","0","-2"
"190415","Cornell University","2012","On-tenure track, associate professors","13","9","4","0","0","0","3","0","3","1","0","1","0","0","0","0","0","0","6","6","0","0","0","0","1","1","0","2","2","0","-2"
"190415","Cornell University","2012","On-tenure track, assistant professors","255","156","99","0","0","0","31","19","12","12","9","3","11","5","6","0","0","0","157","94","63","4","1","3","4","3","1","36","25","11","-2"
"190415","Cornell University","2012","Not on tenure track/No tenure system system total","329","163","166","2","2","0","30","10","20","7","4","3","13","9","4","0","0","0","235","123","112","2","0","2","3","0","3","37","15","22","-2"
"190415","Cornell University","2012","Not on tenure/no tenure system, professors","26","16","10","0","0","0","4","2","2","0","0","0","0","0","0","0","0","0","17","11","6","0","0","0","0","0","0","5","3","2","-2"
"190415","Cornell University","2012","Not on tenure/no tenure system, associate professors","14","11","3","0","0","0","4","2","2","1","1","0","0","0","0","0","0","0","7","6","1","0","0","0","0","0","0","2","2","0","-2"
"190415","Cornell University","2012","Not on tenure/no tenure system, assistant professors","33","16","17","0","0","0","1","1","0","0","0","0","2","1","1","0","0","0","23","10","13","0","0","0","0","0","0","7","4","3","-2"
"190415","Cornell University","2012","Not on tenure/no tenure system, instructors","6","3","3","0","0","0","0","0","0","0","0","0","0","0","0","0","0","0","5","3","2","0","0","0","0","0","0","1","0","1","-2"
"190415","Cornell University","2012","Not on tenure/no tenure system, lecturers","250","117","133","2","2","0","21","5","16","6","3","3","11","8","3","0","0","0","183","93","90","2","0","2","3","0","3","22","6","16","-2"
"190567","CUNY City College","2012","Tenured total","399","259","140","1","1","0","46","37","9","30","15","15","31","17","14","0","0","0","288","186","102","0","0","0","0","0","0","3","3","0","-2"
"190567","CUNY City College","2012","Tenured, professors","225","166","59","1","1","0","27","22","5","14","8","6","15","8","7","0","0","0","166","125","41","0","0","0","0","0","0","2","2","0","-2"
"190567","CUNY City College","2012","Tenured, associate professors","129","71","58","0","0","0","13","12","1","12","6","6","12","6","6","0","0","0","91","46","45","0","0","0","0","0","0","1","1","0","-2"
"190567","CUNY City College","2012","Tenured, assistant professors","23","12","11","0","0","0","5","3","2","1","0","1","3","2","1","0","0","0","14","7","7","0","0","0","0","0","0","0","0","0","-2"
"190567","CUNY City College","2012","Tenured, lecturers","22","10","12","0","0","0","1","0","1","3","1","2","1","1","0","0","0","0","17","8","9","0","0","0","0","0","0","0","0","0","-2"
"190567","CUNY City College","2012","On-Tenure track total","173","87","86","1","1","0","25","12","13","24","8","16","15","6","9","0","0","0","96","54","42","0","0","0","0","0","0","12","6","6","-2"
"190567","CUNY City College","2012","On-tenure track, professors","9","5","4","0","0","0","1","0","1","2","1","1","1","1","0","0","0","0","5","3","2","0","0","0","0","0","0","0","0","0","-2"
"190567","CUNY City College","2012","On-tenure track, associate professors","24","13","11","0","0","0","5","1","4","0","0","0","0","0","0","0","0","0","17","12","5","0","0","0","0","0","0","2","0","2","-2"
"190567","CUNY City College","2012","On-tenure track, assistant professors","108","54","54","1","1","0","16","8","8","18","6","12","10","3","7","0","0","0","54","30","24","0","0","0","0","0","0","9","6","3","-2"
"190567","CUNY City College","2012","On-tenure track, lecturers","32","15","17","0","0","0","3","3","0","4","1","3","4","2","2","0","0","0","20","9","11","0","0","0","0","0","0","1","0","1","-2"
"190567","CUNY City College","2012","Not on tenure track/No tenure system system total","20","10","10","0","0","0","1","1","0","1","0","1","3","2","1","0","0","0","13","7","6","0","0","0","0","0","0","2","0","2","-2"
"190567","CUNY City College","2012","Not on tenure/no tenure system, professors","10","7","3","0","0","0","1","1","0","1","0","1","2","2","0","0","0","0","5","4","1","0","0","0","0","0","0","1","0","1","-2"
"190567","CUNY City College","2012","Not on tenure/no tenure system, associate professors","1","0","1","0","0","0","0","0","0","0","0","0","0","0","0","0","0","0","1","0","1","0","0","0","0","0","0","0","0","0","-2"
"190567","CUNY City College","2012","Not on tenure/no tenure system, assistant professors","4","2","2","0","0","0","0","0","0","0","0","0","0","0","0","0","0","0","4","2","2","0","0","0","0","0","0","0","0","0","-2"
"190567","CUNY City College","2012","Not on tenure/no tenure system, instructors","4","1","3","0","0","0","0","0","0","0","0","0","0","0","0","0","0","0","3","1","2","0","0","0","0","0","0","1","0","1","-2"
"190567","CUNY City College","2012","Not on tenure/no tenure system, lecturers","1","0","1","0","0","0","0","0","0","0","0","0","1","0","1","0","0","0","0","0","0","0","0","0","0","0","0","0","0","0","-2"
"190576","CUNY Graduate School and University Center","2012","Tenured total","134","80","54","1","0","1","3","2","1","8","6","2","5","3","2","0","0","0","116","69","47","0","0","0","0","0","0","1","0","1","-2"
"190576","CUNY Graduate School and University Center","2012","Tenured, professors","120","70","50","1","0","1","2","1","1","8","6","2","5","3","2","0","0","0","104","60","44","0","0","0","0","0","0","0","0","0","-2"
"190576","CUNY Graduate School and University Center","2012","Tenured, associate professors","14","10","4","0","0","0","1","1","0","0","0","0","0","0","0","0","0","0","12","9","3","0","0","0","0","0","0","1","0","1","-2"
"190576","CUNY Graduate School and University Center","2012","On-Tenure track total","6","4","2","0","0","0","1","0","1","0","0","0","0","0","0","0","0","0","4","3","1","0","0","0","0","0","0","1","1","0","-2"
"190576","CUNY Graduate School and University Center","2012","On-tenure track, associate professors","4","3","1","0","0","0","1","0","1","0","0","0","0","0","0","0","0","0","2","2","0","0","0","0","0","0","0","1","1","0","-2"
"190576","CUNY Graduate School and University Center","2012","On-tenure track, assistant professors","2","1","1","0","0","0","0","0","0","0","0","0","0","0","0","0","0","0","2","1","1","0","0","0","0","0","0","0","0","0","-2"
"190576","CUNY Graduate School and University Center","2012","Not on tenure track/No tenure system system total","54","28","26","0","0","0","2","1","1","7","1","6","2","0","2","0","0","0","42","25","17","0","0","0","0","0","0","1","1","0","-2"
"190576","CUNY Graduate School and University Center","2012","Not on tenure/no tenure system, professors","20","12","8","0","0","0","0","0","0","2","1","1","1","0","1","0","0","0","17","11","6","0","0","0","0","0","0","0","0","0","-2"
"190576","CUNY Graduate School and University Center","2012","Not on tenure/no tenure system, associate professors","4","3","1","0","0","0","0","0","0","0","0","0","0","0","0","0","0","0","4","3","1","0","0","0","0","0","0","0","0","0","-2"
"190576","CUNY Graduate School and University Center","2012","Not on tenure/no tenure system, assistant professors","18","8","10","0","0","0","1","0","1","3","0","3","0","0","0","0","0","0","13","7","6","0","0","0","0","0","0","1","1","0","-2"
"190576","CUNY Graduate School and University Center","2012","Not on tenure/no tenure system, instructors","1","0","1","0","0","0","0","0","0","0","0","0","1","0","1","0","0","0","0","0","0","0","0","0","0","0","0","0","0","0","-2"
"190576","CUNY Graduate School and University Center","2012","Not on tenure/no tenure system, lecturers","11","5","6","0","0","0","1","1","0","2","0","2","0","0","0","0","0","0","8","4","4","0","0","0","0","0","0","0","0","0","-2"
"191630","Hobart William Smith Colleges","2012","Tenured total","112","71","41","0","0","0","8","5","3","4","2","2","2","2","0","0","0","0","94","61","33","0","0","0","4","1","3","0","0","0","-2"
"191630","Hobart William Smith Colleges","2012","Tenured, professors","57","41","16","0","0","0","2","1","1","0","0","0","0","0","0","0","0","0","53","40","13","0","0","0","2","0","2","0","0","0","-2"
"191630","Hobart William Smith Colleges","2012","Tenured, associate professors","55","30","25","0","0","0","6","4","2","4","2","2","2","2","0","0","0","0","41","21","20","0","0","0","2","1","1","0","0","0","-2"
"191630","Hobart William Smith Colleges","2012","On-Tenure track total","68","33","35","0","0","0","4","2","2","4","2","2","2","1","1","0","0","0","46","23","23","0","0","0","5","2","3","7","3","4","-2"
"191630","Hobart William Smith Colleges","2012","On-tenure track, assistant professors","68","33","35","0","0","0","4","2","2","4","2","2","2","1","1","0","0","0","46","23","23","0","0","0","5","2","3","7","3","4","-2"
"191630","Hobart William Smith Colleges","2012","Not on tenure track/No tenure system system total","21","13","8","0","0","0","1","0","1","0","0","0","0","0","0","0","0","0","18","13","5","0","0","0","1","0","1","1","0","1","-2"
"191630","Hobart William Smith Colleges","2012","Not on tenure/no tenure system, associate professors","2","1","1","0","0","0","0","0","0","0","0","0","0","0","0","0","0","0","2","1","1","0","0","0","0","0","0","0","0","0","-2"
"191630","Hobart William Smith Colleges","2012","Not on tenure/no tenure system, assistant professors","16","10","6","0","0","0","1","0","1","0","0","0","0","0","0","0","0","0","13","10","3","0","0","0","1","0","1","1","0","1","-2"
"191630","Hobart William Smith Colleges","2012","Not on tenure/no tenure system, instructors","3","2","1","0","0","0","0","0","0","0","0","0","0","0","0","0","0","0","3","2","1","0","0","0","0","0","0","0","0","0","-2"
"196060","SUNY at Albany","2012","Tenured total","391","267","124","0","0","0","24","15","9","13","6","7","0","0","0","0","0","0","280","195","85","0","0","0","33","19","14","41","32","9","-2"
"196060","SUNY at Albany","2012","Tenured, professors","169","136","33","0","0","0","12","11","1","3","3","0","0","0","0","0","0","0","137","109","28","0","0","0","9","6","3","8","7","1","-2"
"196060","SUNY at Albany","2012","Tenured, associate professors","221","130","91","0","0","0","12","4","8","10","3","7","0","0","0","0","0","0","143","86","57","0","0","0","23","12","11","33","25","8","-2"
"196060","SUNY at Albany","2012","Tenured, assistant professors","1","1","0","0","0","0","0","0","0","0","0","0","0","0","0","0","0","0","0","0","0","0","0","0","1","1","0","0","0","0","-2"
"196060","SUNY at Albany","2012","On-Tenure track total","134","71","63","1","0","1","12","6","6","6","3","3","0","0","0","0","0","0","46","22","24","0","0","0","31","16","15","38","24","14","-2"
"196060","SUNY at Albany","2012","On-tenure track, professors","13","10","3","0","0","0","1","1","0","0","0","0","0","0","0","0","0","0","9","7","2","0","0","0","2","1","1","1","1","0","-2"
"196060","SUNY at Albany","2012","On-tenure track, associate professors","7","4","3","0","0","0","1","1","0","0","0","0","0","0","0","0","0","0","1","1","0","0","0","0","4","1","3","1","1","0","-2"
"196060","SUNY at Albany","2012","On-tenure track, assistant professors","114","57","57","1","0","1","10","4","6","6","3","3","0","0","0","0","0","0","36","14","22","0","0","0","25","14","11","36","22","14","-2"
"196060","SUNY at Albany","2012","Not on tenure track/No tenure system system total","58","24","34","0","0","0","0","0","0","4","2","2","0","0","0","0","0","0","40","18","22","0","0","0","4","1","3","10","3","7","-2"
"196060","SUNY at Albany","2012","Not on tenure/no tenure system, professors","4","4","0","0","0","0","0","0","0","1","1","0","0","0","0","0","0","0","2","2","0","0","0","0","0","0","0","1","1","0","-2"
"196060","SUNY at Albany","2012","Not on tenure/no tenure system, associate professors","4","2","2","0","0","0","0","0","0","1","1","0","0","0","0","0","0","0","2","0","2","0","0","0","0","0","0","1","1","0","-2"
"196060","SUNY at Albany","2012","Not on tenure/no tenure system, assistant professors","24","11","13","0","0","0","0","0","0","1","0","1","0","0","0","0","0","0","16","9","7","0","0","0","3","1","2","4","1","3","-2"
"196060","SUNY at Albany","2012","Not on tenure/no tenure system, lecturers","26","7","19","0","0","0","0","0","0","1","0","1","0","0","0","0","0","0","20","7","13","0","0","0","1","0","1","4","0","4","-2"
"196097","Stony Brook University","2012","Tenured total","602","444","158","1","1","0","37","28","9","17","13","4","13","10","3","0","0","0","413","299","114","0","0","0","0","0","0","121","93","28","-2"
"196097","Stony Brook University","2012","Tenured, professors","391","306","85","0","0","0","23","18","5","9","7","2","8","6","2","0","0","0","278","214","64","0","0","0","0","0","0","73","61","12","-2"
"196097","Stony Brook University","2012","Tenured, associate professors","209","138","71","1","1","0","14","10","4","8","6","2","5","4","1","0","0","0","133","85","48","0","0","0","0","0","0","48","32","16","-2"
"196097","Stony Brook University","2012","Tenured, assistant professors","2","0","2","0","0","0","0","0","0","0","0","0","0","0","0","0","0","0","2","0","2","0","0","0","0","0","0","0","0","0","-2"
"196097","Stony Brook University","2012","On-Tenure track total","182","103","79","0","0","0","18","10","8","2","0","2","4","3","1","0","0","0","53","25","28","0","0","0","0","0","0","105","65","40","-2"
"196097","Stony Brook University","2012","On-tenure track, professors","8","7","1","0","0","0","0","0","0","0","0","0","0","0","0","0","0","0","1","1","0","0","0","0","0","0","0","7","6","1","-2"
"196097","Stony Brook University","2012","On-tenure track, associate professors","8","4","4","0","0","0","0","0","0","0","0","0","0","0","0","0","0","0","2","0","2","0","0","0","0","0","0","6","4","2","-2"
"196097","Stony Brook University","2012","On-tenure track, assistant professors","166","92","74","0","0","0","18","10","8","2","0","2","4","3","1","0","0","0","50","24","26","0","0","0","0","0","0","92","55","37","-2"
"196097","Stony Brook University","2012","Not on tenure track/No tenure system system total","462","214","248","0","0","0","43","20","23","14","6","8","8","0","8","0","0","0","284","130","154","0","0","0","0","0","0","113","58","55","-2"
"196097","Stony Brook University","2012","Not on tenure/no tenure system, professors","27","19","8","0","0","0","3","3","0","0","0","0","0","0","0","0","0","0","19","11","8","0","0","0","0","0","0","5","5","0","-2"
"196097","Stony Brook University","2012","Not on tenure/no tenure system, associate professors","97","44","53","0","0","0","10","6","4","2","1","1","1","0","1","0","0","0","69","33","36","0","0","0","0","0","0","15","4","11","-2"
"196097","Stony Brook University","2012","Not on tenure/no tenure system, assistant professors","191","84","107","0","0","0","16","10","6","6","2","4","7","0","7","0","0","0","109","47","62","0","0","0","0","0","0","53","25","28","-2"
"196097","Stony Brook University","2012","Not on tenure/no tenure system, instructors","18","7","11","0","0","0","1","0","1","2","1","1","0","0","0","0","0","0","8","2","6","0","0","0","0","0","0","7","4","3","-2"
"196097","Stony Brook University","2012","Not on tenure/no tenure system, lecturers","129","60","69","0","0","0","13","1","12","4","2","2","0","0","0","0","0","0","79","37","42","0","0","0","0","0","0","33","20","13","-2"
"196121","SUNY College at Brockport","2012","Tenured total","177","99","78","1","0","1","16","15","1","6","5","1","6","3","3","1","1","0","147","75","72","0","0","0","0","0","0","0","0","0","-2"
"196121","SUNY College at Brockport","2012","Tenured, professors","56","39","17","1","0","1","8","8","0","2","2","0","3","2","1","0","0","0","42","27","15","0","0","0","0","0","0","0","0","0","-2"
"196121","SUNY College at Brockport","2012","Tenured, associate professors","117","60","57","0","0","0","8","7","1","4","3","1","2","1","1","1","1","0","102","48","54","0","0","0","0","0","0","0","0","0","-2"
"196121","SUNY College at Brockport","2012","Tenured, assistant professors","4","0","4","0","0","0","0","0","0","0","0","0","1","0","1","0","0","0","3","0","3","0","0","0","0","0","0","0","0","0","-2"
"196121","SUNY College at Brockport","2012","On-Tenure track total","99","46","53","0","0","0","13","7","6","2","1","1","4","2","2","0","0","0","72","31","41","1","1","0","0","0","0","7","4","3","-2"
"196121","SUNY College at Brockport","2012","On-tenure track, associate professors","11","4","7","0","0","0","1","1","0","0","0","0","0","0","0","0","0","0","10","3","7","0","0","0","0","0","0","0","0","0","-2"
"196121","SUNY College at Brockport","2012","On-tenure track, assistant professors","87","42","45","0","0","0","12","6","6","2","1","1","4","2","2","0","0","0","61","28","33","1","1","0","0","0","0","7","4","3","-2"
"196121","SUNY College at Brockport","2012","On-tenure track, instructors","1","0","1","0","0","0","0","0","0","0","0","0","0","0","0","0","0","0","1","0","1","0","0","0","0","0","0","0","0","0","-2"
"196121","SUNY College at Brockport","2012","Not on tenure track/No tenure system system total","47","16","31","0","0","0","2","0","2","1","1","0","1","0","1","0","0","0","41","15","26","0","0","0","0","0","0","2","0","2","-2"
"196121","SUNY College at Brockport","2012","Not on tenure/no tenure system, professors","1","1","0","0","0","0","0","0","0","0","0","0","0","0","0","0","0","0","1","1","0","0","0","0","0","0","0","0","0","0","-2"
"196121","SUNY College at Brockport","2012","Not on tenure/no tenure system, associate professors","2","0","2","0","0","0","0","0","0","0","0","0","0","0","0","0","0","0","2","0","2","0","0","0","0","0","0","0","0","0","-2"
"196121","SUNY College at Brockport","2012","Not on tenure/no tenure system, assistant professors","29","12","17","0","0","0","1","0","1","1","1","0","1","0","1","0","0","0","24","11","13","0","0","0","0","0","0","2","0","2","-2"
"196121","SUNY College at Brockport","2012","Not on tenure/no tenure system, lecturers","15","3","12","0","0","0","1","0","1","0","0","0","0","0","0","0","0","0","14","3","11","0","0","0","0","0","0","0","0","0","-2"
"196130","SUNY Buffalo State","2012","Tenured total","264","166","98","3","2","1","14","9","5","14","8","6","11","6","5","0","0","0","217","138","79","0","0","0","0","0","0","5","3","2","-2"
"196130","SUNY Buffalo State","2012","Tenured, professors","101","74","27","1","0","1","7","6","1","7","4","3","1","1","0","0","0","0","85","63","22","0","0","0","0","0","0","0","0","0","-2"
"196130","SUNY Buffalo State","2012","Tenured, associate professors","158","90","68","1","1","0","6","3","3","7","4","3","10","5","5","0","0","0","129","74","55","0","0","0","0","0","0","5","3","2","-2"
"196130","SUNY Buffalo State","2012","Tenured, assistant professors","5","2","3","1","1","0","1","0","1","0","0","0","0","0","0","0","0","0","3","1","2","0","0","0","0","0","0","0","0","0","-2"
"196130","SUNY Buffalo State","2012","On-Tenure track total","102","36","66","0","0","0","14","5","9","5","3","2","6","0","6","0","0","0","69","23","46","1","1","0","0","0","0","7","4","3","-2"
"196130","SUNY Buffalo State","2012","On-tenure track, associate professors","14","4","10","0","0","0","0","0","0","0","0","0","0","0","0","0","0","0","13","4","9","0","0","0","0","0","0","1","0","1","-2"
"196130","SUNY Buffalo State","2012","On-tenure track, assistant professors","88","32","56","0","0","0","14","5","9","5","3","2","6","0","6","0","0","0","56","19","37","1","1","0","0","0","0","6","4","2","-2"
"196130","SUNY Buffalo State","2012","Not on tenure track/No tenure system system total","46","20","26","0","0","0","2","0","2","1","1","0","1","1","0","0","0","0","41","18","23","0","0","0","0","0","0","1","0","1","-2"
"196130","SUNY Buffalo State","2012","Not on tenure/no tenure system, professors","1","1","0","0","0","0","0","0","0","0","0","0","0","0","0","0","0","0","1","1","0","0","0","0","0","0","0","0","0","0","-2"
"196130","SUNY Buffalo State","2012","Not on tenure/no tenure system, associate professors","1","0","1","0","0","0","0","0","0","0","0","0","0","0","0","0","0","0","1","0","1","0","0","0","0","0","0","0","0","0","-2"
"196130","SUNY Buffalo State","2012","Not on tenure/no tenure system, assistant professors","1","1","0","0","0","0","0","0","0","0","0","0","0","0","0","0","0","0","1","1","0","0","0","0","0","0","0","0","0","0","-2"
"196130","SUNY Buffalo State","2012","Not on tenure/no tenure system, lecturers","43","18","25","0","0","0","2","0","2","1","1","0","1","1","0","0","0","0","38","16","22","0","0","0","0","0","0","1","0","1","-2"
"196185","SUNY Oneonta","2012","Tenured total","128","77","51","0","0","0","18","12","6","4","1","3","2","1","1","0","0","0","104","63","41","0","0","0","0","0","0","0","0","0","-2"
"196185","SUNY Oneonta","2012","Tenured, professors","34","23","11","0","0","0","3","3","0","3","1","2","1","0","1","0","0","0","27","19","8","0","0","0","0","0","0","0","0","0","-2"
"196185","SUNY Oneonta","2012","Tenured, associate professors","77","48","29","0","0","0","13","8","5","1","0","1","1","1","0","0","0","0","62","39","23","0","0","0","0","0","0","0","0","0","-2"
"196185","SUNY Oneonta","2012","Tenured, assistant professors","17","6","11","0","0","0","2","1","1","0","0","0","0","0","0","0","0","0","15","5","10","0","0","0","0","0","0","0","0","0","-2"
"196185","SUNY Oneonta","2012","On-Tenure track total","86","48","38","0","0","0","7","3","4","4","1","3","2","1","1","0","0","0","65","39","26","0","0","0","0","0","0","8","4","4","-2"
"196185","SUNY Oneonta","2012","On-tenure track, associate professors","10","7","3","0","0","0","1","0","1","0","0","0","0","0","0","0","0","0","9","7","2","0","0","0","0","0","0","0","0","0","-2"
"196185","SUNY Oneonta","2012","On-tenure track, assistant professors","76","41","35","0","0","0","6","3","3","4","1","3","2","1","1","0","0","0","56","32","24","0","0","0","0","0","0","8","4","4","-2"
"196185","SUNY Oneonta","2012","Not on tenure track/No tenure system system total","43","20","23","1","0","1","0","0","0","5","2","3","1","0","1","0","0","0","31","17","14","0","0","0","0","0","0","5","1","4","-2"
"196185","SUNY Oneonta","2012","Not on tenure/no tenure system, professors","1","1","0","0","0","0","0","0","0","0","0","0","0","0","0","0","0","0","1","1","0","0","0","0","0","0","0","0","0","0","-2"
"196185","SUNY Oneonta","2012","Not on tenure/no tenure system, assistant professors","2","1","1","0","0","0","0","0","0","1","0","1","0","0","0","0","0","0","0","0","0","0","0","0","0","0","0","1","1","0","-2"
"196185","SUNY Oneonta","2012","Not on tenure/no tenure system, lecturers","40","18","22","1","0","1","0","0","0","4","2","2","1","0","1","0","0","0","30","16","14","0","0","0","0","0","0","4","0","4","-2"
"196194","SUNY College at Oswego","2012","Tenured total","180","113","67","0","0","0","13","12","1","8","3","5","5","3","2","0","0","0","152","95","57","2","0","2","0","0","0","0","0","0","-2"
"196194","SUNY College at Oswego","2012","Tenured, professors","74","52","22","0","0","0","9","8","1","3","2","1","0","0","0","0","0","0","61","42","19","1","0","1","0","0","0","0","0","0","-2"
"196194","SUNY College at Oswego","2012","Tenured, associate professors","88","47","41","0","0","0","3","3","0","4","1","3","5","3","2","0","0","0","75","40","35","1","0","1","0","0","0","0","0","0","-2"
"196194","SUNY College at Oswego","2012","Tenured, assistant professors","18","14","4","0","0","0","1","1","0","1","0","1","0","0","0","0","0","0","16","13","3","0","0","0","0","0","0","0","0","0","-2"
"196194","SUNY College at Oswego","2012","On-Tenure track total","80","42","38","1","1","0","5","3","2","8","4","4","3","1","2","0","0","0","60","31","29","0","0","0","0","0","0","3","2","1","-2"
"196194","SUNY College at Oswego","2012","On-tenure track, professors","2","1","1","0","0","0","1","1","0","0","0","0","0","0","0","0","0","0","1","0","1","0","0","0","0","0","0","0","0","0","-2"
"196194","SUNY College at Oswego","2012","On-tenure track, associate professors","9","6","3","0","0","0","2","2","0","2","1","1","0","0","0","0","0","0","5","3","2","0","0","0","0","0","0","0","0","0","-2"
"196194","SUNY College at Oswego","2012","On-tenure track, assistant professors","69","35","34","1","1","0","2","0","2","6","3","3","3","1","2","0","0","0","54","28","26","0","0","0","0","0","0","3","2","1","-2"
"196194","SUNY College at Oswego","2012","Not on tenure track/No tenure system system total","58","22","36","0","0","0","0","0","0","3","1","2","3","1","2","0","0","0","50","20","30","0","0","0","0","0","0","2","0","2","-2"
"196194","SUNY College at Oswego","2012","Not on tenure/no tenure system, assistant professors","51","22","29","0","0","0","0","0","0","3","1","2","2","1","1","0","0","0","44","20","24","0","0","0","0","0","0","2","0","2","-2"
"196194","SUNY College at Oswego","2012","Not on tenure/no tenure system, instructors","6","0","6","0","0","0","0","0","0","0","0","0","1","0","1","0","0","0","5","0","5","0","0","0","0","0","0","0","0","0","-2"
"196194","SUNY College at Oswego","2012","Not on tenure/no tenure system, lecturers","1","0","1","0","0","0","0","0","0","0","0","0","0","0","0","0","0","0","1","0","1","0","0","0","0","0","0","0","0","0","-2"
"196291","SUNY Maritime College","2012","Tenured total","32","25","7","0","0","0","0","0","0","0","0","0","0","0","0","0","0","0","31","25","6","0","0","0","0","0","0","1","0","1","-2"
"196291","SUNY Maritime College","2012","Tenured, professors","18","13","5","0","0","0","0","0","0","0","0","0","0","0","0","0","0","0","18","13","5","0","0","0","0","0","0","0","0","0","-2"
"196291","SUNY Maritime College","2012","Tenured, associate professors","11","9","2","0","0","0","0","0","0","0","0","0","0","0","0","0","0","0","10","9","1","0","0","0","0","0","0","1","0","1","-2"
"196291","SUNY Maritime College","2012","Tenured, assistant professors","3","3","0","0","0","0","0","0","0","0","0","0","0","0","0","0","0","0","3","3","0","0","0","0","0","0","0","0","0","0","-2"
"196291","SUNY Maritime College","2012","On-Tenure track total","19","13","6","0","0","0","2","1","1","0","0","0","0","0","0","0","0","0","16","11","5","0","0","0","0","0","0","1","1","0","-2"
"196291","SUNY Maritime College","2012","On-tenure track, associate professors","2","2","0","0","0","0","0","0","0","0","0","0","0","0","0","0","0","0","2","2","0","0","0","0","0","0","0","0","0","0","-2"
"196291","SUNY Maritime College","2012","On-tenure track, assistant professors","17","11","6","0","0","0","2","1","1","0","0","0","0","0","0","0","0","0","14","9","5","0","0","0","0","0","0","1","1","0","-2"
"196291","SUNY Maritime College","2012","Not on tenure track/No tenure system system total","53","45","8","0","0","0","0","0","0","3","2","1","1","1","0","0","0","0","48","42","6","0","0","0","0","0","0","1","0","1","-2"
"196291","SUNY Maritime College","2012","Not on tenure/no tenure system, professors","1","1","0","0","0","0","0","0","0","0","0","0","0","0","0","0","0","0","1","1","0","0","0","0","0","0","0","0","0","0","-2"
"196291","SUNY Maritime College","2012","Not on tenure/no tenure system, instructors","8","8","0","0","0","0","0","0","0","0","0","0","0","0","0","0","0","0","8","8","0","0","0","0","0","0","0","0","0","0","-2"
"196291","SUNY Maritime College","2012","Not on tenure/no tenure system, lecturers","44","36","8","0","0","0","0","0","0","3","2","1","1","1","0","0","0","0","39","33","6","0","0","0","0","0","0","1","0","1","-2"
"197869","Appalachian State University","2012","Tenured total","467","276","191","4","2","2","6","5","1","11","8","3","7","3","4","0","0","0","421","246","175","3","3","0","4","3","1","11","6","5","-2"
"197869","Appalachian State University","2012","Tenured, professors","276","181","95","1","1","0","3","3","0","4","3","1","4","2","2","0","0","0","258","167","91","1","1","0","3","2","1","2","2","0","-2"
"197869","Appalachian State University","2012","Tenured, associate professors","191","95","96","3","1","2","3","2","1","7","5","2","3","1","2","0","0","0","163","79","84","2","2","0","1","1","0","9","4","5","-2"
"197869","Appalachian State University","2012","On-Tenure track total","228","110","118","1","1","0","8","5","3","5","3","2","5","3","2","0","0","0","194","92","102","1","0","1","1","0","1","13","6","7","-2"
"197869","Appalachian State University","2012","On-tenure track, associate professors","12","7","5","0","0","0","1","0","1","0","0","0","0","0","0","0","0","0","11","7","4","0","0","0","0","0","0","0","0","0","-2"
"197869","Appalachian State University","2012","On-tenure track, assistant professors","216","103","113","1","1","0","7","5","2","5","3","2","5","3","2","0","0","0","183","85","98","1","0","1","1","0","1","13","6","7","-2"
"197869","Appalachian State University","2012","Not on tenure track/No tenure system system total","206","92","114","0","0","0","2","1","1","4","4","0","5","1","4","0","0","0","185","83","102","3","0","3","1","0","1","6","3","3","-2"
"197869","Appalachian State University","2012","Not on tenure/no tenure system, professors","1","1","0","0","0","0","1","1","0","0","0","0","0","0","0","0","0","0","0","0","0","0","0","0","0","0","0","0","0","0","-2"
"197869","Appalachian State University","2012","Not on tenure/no tenure system, assistant professors","2","2","0","0","0","0","0","0","0","0","0","0","0","0","0","0","0","0","2","2","0","0","0","0","0","0","0","0","0","0","-2"
"197869","Appalachian State University","2012","Not on tenure/no tenure system, instructors","7","4","3","0","0","0","0","0","0","1","1","0","0","0","0","0","0","0","5","2","3","0","0","0","0","0","0","1","1","0","-2"
"197869","Appalachian State University","2012","Not on tenure/no tenure system, lecturers","128","54","74","0","0","0","1","0","1","3","3","0","2","0","2","0","0","0","119","51","68","1","0","1","0","0","0","2","0","2","-2"
"197869","Appalachian State University","2012","Not on tenure/no tenure system, no academic rank","68","31","37","0","0","0","0","0","0","0","0","0","3","1","2","0","0","0","59","28","31","2","0","2","1","0","1","3","2","1","-2"
"199102","North Carolina A & T State University","2012","Tenured total","248","155","93","2","2","0","32","27","5","135","71","64","3","2","1","0","0","0","68","46","22","0","0","0","1","1","0","7","6","1","-2"
"199102","North Carolina A & T State University","2012","Tenured, professors","85","62","23","2","2","0","15","13","2","37","23","14","1","1","0","0","0","0","24","18","6","0","0","0","1","1","0","5","4","1","-2"
"199102","North Carolina A & T State University","2012","Tenured, associate professors","157","88","69","0","0","0","16","13","3","93","44","49","2","1","1","0","0","0","44","28","16","0","0","0","0","0","0","2","2","0","-2"
"199102","North Carolina A & T State University","2012","Tenured, assistant professors","6","5","1","0","0","0","1","1","0","5","4","1","0","0","0","0","0","0","0","0","0","0","0","0","0","0","0","0","0","0","-2"
"199102","North Carolina A & T State University","2012","On-Tenure track total","122","66","56","0","0","0","23","15","8","56","22","34","1","1","0","0","0","0","36","22","14","0","0","0","1","1","0","5","5","0","-2"
"199102","North Carolina A & T State University","2012","On-tenure track, professors","1","1","0","0","0","0","0","0","0","1","1","0","0","0","0","0","0","0","0","0","0","0","0","0","0","0","0","0","0","0","-2"
"199102","North Carolina A & T State University","2012","On-tenure track, associate professors","21","11","10","0","0","0","3","1","2","11","5","6","0","0","0","0","0","0","7","5","2","0","0","0","0","0","0","0","0","0","-2"
"199102","North Carolina A & T State University","2012","On-tenure track, assistant professors","100","54","46","0","0","0","20","14","6","44","16","28","1","1","0","0","0","0","29","17","12","0","0","0","1","1","0","5","5","0","-2"
"199102","North Carolina A & T State University","2012","Not on tenure track/No tenure system system total","100","36","64","1","0","1","2","1","1","70","20","50","1","0","1","0","0","0","23","13","10","0","0","0","0","0","0","3","2","1","-2"
"199102","North Carolina A & T State University","2012","Not on tenure/no tenure system, associate professors","1","1","0","0","0","0","0","0","0","0","0","0","0","0","0","0","0","0","1","1","0","0","0","0","0","0","0","0","0","0","-2"
"199102","North Carolina A & T State University","2012","Not on tenure/no tenure system, instructors","3","1","2","0","0","0","0","0","0","2","0","2","0","0","0","0","0","0","1","1","0","0","0","0","0","0","0","0","0","0","-2"
"199102","North Carolina A & T State University","2012","Not on tenure/no tenure system, lecturers","28","7","21","1","0","1","1","0","1","21","6","15","1","0","1","0","0","0","3","1","2","0","0","0","0","0","0","1","0","1","-2"
"199102","North Carolina A & T State University","2012","Not on tenure/no tenure system, no academic rank","68","27","41","0","0","0","1","1","0","47","14","33","0","0","0","0","0","0","18","10","8","0","0","0","0","0","0","2","2","0","-2"
"199111","University of North Carolina at Asheville","2012","Tenured total","123","78","45","1","1","0","6","4","2","7","4","3","4","1","3","0","0","0","105","68","37","0","0","0","0","0","0","0","0","0","-2"
"199111","University of North Carolina at Asheville","2012","Tenured, professors","60","44","16","1","1","0","1","1","0","2","1","1","1","1","0","0","0","0","55","40","15","0","0","0","0","0","0","0","0","0","-2"
"199111","University of North Carolina at Asheville","2012","Tenured, associate professors","62","33","29","0","0","0","5","3","2","4","2","2","3","0","3","0","0","0","50","28","22","0","0","0","0","0","0","0","0","0","-2"
"199111","University of North Carolina at Asheville","2012","Tenured, assistant professors","1","1","0","0","0","0","0","0","0","1","1","0","0","0","0","0","0","0","0","0","0","0","0","0","0","0","0","0","0","0","-2"
"199111","University of North Carolina at Asheville","2012","On-Tenure track total","41","17","24","0","0","0","4","1","3","3","1","2","0","0","0","1","0","1","31","14","17","1","0","1","0","0","0","1","1","0","-2"
"199111","University of North Carolina at Asheville","2012","On-tenure track, associate professors","2","0","2","0","0","0","0","0","0","1","0","1","0","0","0","0","0","0","1","0","1","0","0","0","0","0","0","0","0","0","-2"
"199111","University of North Carolina at Asheville","2012","On-tenure track, assistant professors","39","17","22","0","0","0","4","1","3","2","1","1","0","0","0","1","0","1","30","14","16","1","0","1","0","0","0","1","1","0","-2"
"199111","University of North Carolina at Asheville","2012","Not on tenure track/No tenure system system total","49","22","27","1","1","0","0","0","0","1","1","0","2","2","0","0","0","0","43","17","26","0","0","0","1","1","0","1","0","1","-2"
"199111","University of North Carolina at Asheville","2012","Not on tenure/no tenure system, lecturers","43","18","25","0","0","0","0","0","0","1","1","0","1","1","0","0","0","0","39","15","24","0","0","0","1","1","0","1","0","1","-2"
"199111","University of North Carolina at Asheville","2012","Not on tenure/no tenure system, no academic rank","6","4","2","1","1","0","0","0","0","0","0","0","1","1","0","0","0","0","4","2","2","0","0","0","0","0","0","0","0","0","-2"
"199120","University of North Carolina at Chapel Hill","2012","Tenured total","1022","685","337","4","2","2","73","56","17","55","26","29","29","18","11","0","0","0","853","576","277","3","3","0","0","0","0","5","4","1","-2"
"199120","University of North Carolina at Chapel Hill","2012","Tenured, professors","664","478","186","1","1","0","42","37","5","20","10","10","15","7","8","0","0","0","584","421","163","0","0","0","0","0","0","2","2","0","-2"
"199120","University of North Carolina at Chapel Hill","2012","Tenured, associate professors","358","207","151","3","1","2","31","19","12","35","16","19","14","11","3","0","0","0","269","155","114","3","3","0","0","0","0","3","2","1","-2"
"199120","University of North Carolina at Chapel Hill","2012","On-Tenure track total","334","180","154","4","2","2","40","17","23","32","8","24","26","12","14","0","0","0","193","111","82","1","0","1","0","0","0","38","30","8","-2"
"199120","University of North Carolina at Chapel Hill","2012","On-tenure track, associate professors","16","8","8","0","0","0","2","1","1","1","1","0","3","1","2","0","0","0","10","5","5","0","0","0","0","0","0","0","0","0","-2"
"199120","University of North Carolina at Chapel Hill","2012","On-tenure track, assistant professors","318","172","146","4","2","2","38","16","22","31","7","24","23","11","12","0","0","0","183","106","77","1","0","1","0","0","0","38","30","8","-2"
"199120","University of North Carolina at Chapel Hill","2012","Not on tenure track/No tenure system system total","588","221","367","0","0","0","34","11","23","25","7","18","28","16","12","0","0","0","461","172","289","1","0","1","1","0","1","38","15","23","-2"
"199120","University of North Carolina at Chapel Hill","2012","Not on tenure/no tenure system, professors","10","8","2","0","0","0","1","1","0","0","0","0","0","0","0","0","0","0","9","7","2","0","0","0","0","0","0","0","0","0","-2"
"199120","University of North Carolina at Chapel Hill","2012","Not on tenure/no tenure system, associate professors","18","9","9","0","0","0","4","2","2","0","0","0","0","0","0","0","0","0","12","6","6","0","0","0","0","0","0","2","1","1","-2"
"199120","University of North Carolina at Chapel Hill","2012","Not on tenure/no tenure system, assistant professors","58","27","31","0","0","0","8","4","4","1","1","0","3","1","2","0","0","0","40","19","21","0","0","0","0","0","0","6","2","4","-2"
"199120","University of North Carolina at Chapel Hill","2012","Not on tenure/no tenure system, instructors","8","4","4","0","0","0","1","1","0","0","0","0","0","0","0","0","0","0","4","3","1","0","0","0","0","0","0","3","0","3","-2"
"199120","University of North Carolina at Chapel Hill","2012","Not on tenure/no tenure system, lecturers","161","60","101","0","0","0","11","3","8","5","1","4","12","5","7","0","0","0","112","43","69","0","0","0","0","0","0","21","8","13","-2"
"199120","University of North Carolina at Chapel Hill","2012","Not on tenure/no tenure system, no academic rank","333","113","220","0","0","0","9","0","9","19","5","14","13","10","3","0","0","0","284","94","190","1","0","1","1","0","1","6","4","2","-2"
"199139","University of North Carolina at Charlotte","2012","Tenured total","492","339","153","0","0","0","63","53","10","25","14","11","10","5","5","0","0","0","370","253","117","0","0","0","7","6","1","17","8","9","-2"
"199139","University of North Carolina at Charlotte","2012","Tenured, professors","191","154","37","0","0","0","21","20","1","4","4","0","3","1","2","0","0","0","155","123","32","0","0","0","5","4","1","3","2","1","-2"
"199139","University of North Carolina at Charlotte","2012","Tenured, associate professors","299","184","115","0","0","0","42","33","9","21","10","11","7","4","3","0","0","0","213","129","84","0","0","0","2","2","0","14","6","8","-2"
"199139","University of North Carolina at Charlotte","2012","Tenured, assistant professors","2","1","1","0","0","0","0","0","0","0","0","0","0","0","0","0","0","0","2","1","1","0","0","0","0","0","0","0","0","0","-2"
"199139","University of North Carolina at Charlotte","2012","On-Tenure track total","191","94","97","0","0","0","17","12","5","18","8","10","6","2","4","0","0","0","99","47","52","0","0","0","25","11","14","26","14","12","-2"
"199139","University of North Carolina at Charlotte","2012","On-tenure track, professors","1","1","0","0","0","0","0","0","0","1","1","0","0","0","0","0","0","0","0","0","0","0","0","0","0","0","0","0","0","0","-2"
"199139","University of North Carolina at Charlotte","2012","On-tenure track, associate professors","11","7","4","0","0","0","2","1","1","0","0","0","1","1","0","0","0","0","4","2","2","0","0","0","4","3","1","0","0","0","-2"
"199139","University of North Carolina at Charlotte","2012","On-tenure track, assistant professors","179","86","93","0","0","0","15","11","4","17","7","10","5","1","4","0","0","0","95","45","50","0","0","0","21","8","13","26","14","12","-2"
"199139","University of North Carolina at Charlotte","2012","Not on tenure track/No tenure system system total","269","90","179","0","0","0","8","2","6","13","1","12","7","2","5","0","0","0","214","73","141","0","0","0","20","9","11","7","3","4","-2"
"199139","University of North Carolina at Charlotte","2012","Not on tenure/no tenure system, assistant professors","1","0","1","0","0","0","0","0","0","0","0","0","0","0","0","0","0","0","1","0","1","0","0","0","0","0","0","0","0","0","-2"
"199139","University of North Carolina at Charlotte","2012","Not on tenure/no tenure system, lecturers","224","75","149","0","0","0","6","1","5","11","1","10","6","2","4","0","0","0","185","65","120","0","0","0","15","6","9","1","0","1","-2"
"199139","University of North Carolina at Charlotte","2012","Not on tenure/no tenure system, no academic rank","44","15","29","0","0","0","2","1","1","2","0","2","1","0","1","0","0","0","28","8","20","0","0","0","5","3","2","6","3","3","-2"
"199157","North Carolina Central University","2012","Tenured total","152","86","66","0","0","0","15","7","8","88","49","39","3","2","1","0","0","0","39","24","15","0","0","0","5","2","3","2","2","0","-2"
"199157","North Carolina Central University","2012","Tenured, professors","55","36","19","0","0","0","5","2","3","36","24","12","0","0","0","0","0","0","13","10","3","0","0","0","1","0","1","0","0","0","-2"
"199157","North Carolina Central University","2012","Tenured, associate professors","85","42","43","0","0","0","9","4","5","44","21","23","3","2","1","0","0","0","23","11","12","0","0","0","4","2","2","2","2","0","-2"
"199157","North Carolina Central University","2012","Tenured, assistant professors","12","8","4","0","0","0","1","1","0","8","4","4","0","0","0","0","0","0","3","3","0","0","0","0","0","0","0","0","0","0","-2"
"199157","North Carolina Central University","2012","On-Tenure track total","110","51","59","0","0","0","7","6","1","52","16","36","1","1","0","0","0","0","34","16","18","0","0","0","4","2","2","12","10","2","-2"
"199157","North Carolina Central University","2012","On-tenure track, professors","1","1","0","0","0","0","1","1","0","0","0","0","0","0","0","0","0","0","0","0","0","0","0","0","0","0","0","0","0","0","-2"
"199157","North Carolina Central University","2012","On-tenure track, associate professors","11","8","3","0","0","0","2","2","0","7","4","3","0","0","0","0","0","0","1","1","0","0","0","0","0","0","0","1","1","0","-2"
"199157","North Carolina Central University","2012","On-tenure track, assistant professors","98","42","56","0","0","0","4","3","1","45","12","33","1","1","0","0","0","0","33","15","18","0","0","0","4","2","2","11","9","2","-2"
"199157","North Carolina Central University","2012","Not on tenure track/No tenure system system total","124","51","73","0","0","0","4","1","3","80","28","52","3","1","2","0","0","0","31","18","13","0","0","0","4","1","3","2","2","0","-2"
"199157","North Carolina Central University","2012","Not on tenure/no tenure system, instructors","11","3","8","0","0","0","0","0","0","7","0","7","1","0","1","0","0","0","2","2","0","0","0","0","0","0","0","1","1","0","-2"
"199157","North Carolina Central University","2012","Not on tenure/no tenure system, lecturers","3","2","1","0","0","0","0","0","0","1","1","0","1","1","0","0","0","0","1","0","1","0","0","0","0","0","0","0","0","0","-2"
"199157","North Carolina Central University","2012","Not on tenure/no tenure system, no academic rank","110","46","64","0","0","0","4","1","3","72","27","45","1","0","1","0","0","0","28","16","12","0","0","0","4","1","3","1","1","0","-2"
"199193","North Carolina State University at Raleigh","2012","Tenured total","778","592","186","1","0","1","69","59","10","38","22","16","26","15","11","0","0","0","608","465","143","4","3","1","4","3","1","28","25","3","-2"
"199193","North Carolina State University at Raleigh","2012","Tenured, professors","445","367","78","0","0","0","38","34","4","12","9","3","11","5","6","0","0","0","355","293","62","3","2","1","3","3","0","23","21","2","-2"
"199193","North Carolina State University at Raleigh","2012","Tenured, associate professors","330","224","106","1","0","1","31","25","6","26","13","13","15","10","5","0","0","0","250","171","79","1","1","0","1","0","1","5","4","1","-2"
"199193","North Carolina State University at Raleigh","2012","Tenured, assistant professors","3","1","2","0","0","0","0","0","0","0","0","0","0","0","0","0","0","0","3","1","2","0","0","0","0","0","0","0","0","0","-2"
"199193","North Carolina State University at Raleigh","2012","On-Tenure track total","252","147","105","1","1","0","38","25","13","10","5","5","9","4","5","1","1","0","165","96","69","2","1","1","8","2","6","18","12","6","-2"
"199193","North Carolina State University at Raleigh","2012","On-tenure track, associate professors","25","19","6","0","0","0","8","7","1","1","0","1","0","0","0","0","0","0","15","12","3","0","0","0","1","0","1","0","0","0","-2"
"199193","North Carolina State University at Raleigh","2012","On-tenure track, assistant professors","227","128","99","1","1","0","30","18","12","9","5","4","9","4","5","1","1","0","150","84","66","2","1","1","7","2","5","18","12","6","-2"
"199193","North Carolina State University at Raleigh","2012","Not on tenure track/No tenure system system total","317","153","164","2","1","1","13","5","8","8","3","5","10","5","5","0","0","0","273","135","138","1","0","1","2","1","1","8","3","5","-2"
"199193","North Carolina State University at Raleigh","2012","Not on tenure/no tenure system, professors","4","4","0","1","1","0","0","0","0","0","0","0","0","0","0","0","0","0","3","3","0","0","0","0","0","0","0","0","0","0","-2"
"199193","North Carolina State University at Raleigh","2012","Not on tenure/no tenure system, associate professors","3","2","1","0","0","0","1","1","0","0","0","0","0","0","0","0","0","0","2","1","1","0","0","0","0","0","0","0","0","0","-2"
"199193","North Carolina State University at Raleigh","2012","Not on tenure/no tenure system, assistant professors","7","4","3","0","0","0","1","0","1","0","0","0","0","0","0","0","0","0","5","3","2","0","0","0","0","0","0","1","1","0","-2"
"199193","North Carolina State University at Raleigh","2012","Not on tenure/no tenure system, instructors","1","1","0","0","0","0","0","0","0","0","0","0","0","0","0","0","0","0","1","1","0","0","0","0","0","0","0","0","0","0","-2"
"199193","North Carolina State University at Raleigh","2012","Not on tenure/no tenure system, lecturers","169","76","93","0","0","0","4","2","2","3","1","2","6","3","3","0","0","0","150","68","82","1","0","1","1","1","0","4","1","3","-2"
"199193","North Carolina State University at Raleigh","2012","Not on tenure/no tenure system, no academic rank","133","66","67","1","0","1","7","2","5","5","2","3","4","2","2","0","0","0","112","59","53","0","0","0","1","0","1","3","1","2","-2"
"199847","Wake Forest University","2012","Tenured total","479","335","144","2","2","0","29","22","7","13","9","4","20","13","7","0","0","0","411","286","125","0","0","0","2","2","0","2","1","1","-2"
"199847","Wake Forest University","2012","Tenured, professors","324","241","83","1","1","0","14","12","2","9","6","3","7","7","0","0","0","0","293","215","78","0","0","0","0","0","0","0","0","0","-2"
"199847","Wake Forest University","2012","Tenured, associate professors","153","93","60","1","1","0","15","10","5","4","3","1","13","6","7","0","0","0","117","71","46","0","0","0","1","1","0","2","1","1","-2"
"199847","Wake Forest University","2012","Tenured, no academic rank","2","1","1","0","0","0","0","0","0","0","0","0","0","0","0","0","0","0","1","0","1","0","0","0","1","1","0","0","0","0","-2"
"199847","Wake Forest University","2012","On-Tenure track total","716","470","246","4","3","1","93","60","33","32","12","20","15","7","8","0","0","0","552","376","176","2","0","2","3","2","1","15","10","5","-2"
"199847","Wake Forest University","2012","On-tenure track, professors","94","83","11","0","0","0","11","10","1","2","1","1","2","1","1","0","0","0","78","70","8","0","0","0","0","0","0","1","1","0","-2"
"199847","Wake Forest University","2012","On-tenure track, associate professors","199","138","61","1","0","1","22","17","5","5","3","2","3","0","3","0","0","0","166","117","49","0","0","0","0","0","0","2","1","1","-2"
"199847","Wake Forest University","2012","On-tenure track, assistant professors","399","239","160","3","3","0","52","28","24","24","8","16","10","6","4","0","0","0","295","186","109","2","0","2","3","2","1","10","6","4","-2"
"199847","Wake Forest University","2012","On-tenure track, instructors","24","10","14","0","0","0","8","5","3","1","0","1","0","0","0","0","0","0","13","3","10","0","0","0","0","0","0","2","2","0","-2"
"199847","Wake Forest University","2012","Not on tenure track/No tenure system system total","382","215","167","1","0","1","44","30","14","20","13","7","16","6","10","0","0","0","275","151","124","4","2","2","4","2","2","18","11","7","-2"
"199847","Wake Forest University","2012","Not on tenure/no tenure system, professors","8","8","0","0","0","0","0","0","0","0","0","0","1","1","0","0","0","0","5","5","0","0","0","0","0","0","0","2","2","0","-2"
"199847","Wake Forest University","2012","Not on tenure/no tenure system, associate professors","17","11","6","1","0","1","2","1","1","0","0","0","0","0","0","0","0","0","14","10","4","0","0","0","0","0","0","0","0","0","-2"
"199847","Wake Forest University","2012","Not on tenure/no tenure system, assistant professors","125","72","53","0","0","0","24","15","9","6","4","2","4","2","2","0","0","0","85","47","38","4","2","2","1","1","0","1","1","0","-2"
"199847","Wake Forest University","2012","Not on tenure/no tenure system, instructors","49","29","20","0","0","0","13","11","2","3","3","0","2","1","1","0","0","0","29","13","16","0","0","0","0","0","0","2","1","1","-2"
"199847","Wake Forest University","2012","Not on tenure/no tenure system, lecturers","98","46","52","0","0","0","5","3","2","6","3","3","6","1","5","0","0","0","75","36","39","0","0","0","2","1","1","4","2","2","-2"
"199847","Wake Forest University","2012","Not on tenure/no tenure system, no academic rank","85","49","36","0","0","0","0","0","0","5","3","2","3","1","2","0","0","0","67","40","27","0","0","0","1","0","1","9","5","4","-2"
"200280","University of North Dakota","2012","Tenured total","352","241","111","2","1","1","17","16","1","4","3","1","1","1","0","0","0","0","286","188","98","1","1","0","5","5","0","36","26","10","-2"
"200280","University of North Dakota","2012","Tenured, professors","138","104","34","1","1","0","10","9","1","0","0","0","0","0","0","0","0","0","122","90","32","1","1","0","0","0","0","4","3","1","-2"
"200280","University of North Dakota","2012","Tenured, associate professors","201","128","73","1","0","1","6","6","0","4","3","1","0","0","0","0","0","0","153","91","62","0","0","0","5","5","0","32","23","9","-2"
"200280","University of North Dakota","2012","Tenured, assistant professors","13","9","4","0","0","0","1","1","0","0","0","0","1","1","0","0","0","0","11","7","4","0","0","0","0","0","0","0","0","0","-2"
"200280","University of North Dakota","2012","On-Tenure track total","134","78","56","2","1","1","7","3","4","1","1","0","2","1","1","0","0","0","81","45","36","2","0","2","3","2","1","36","25","11","-2"
"200280","University of North Dakota","2012","On-tenure track, professors","2","1","1","0","0","0","0","0","0","0","0","0","0","0","0","0","0","0","1","0","1","0","0","0","0","0","0","1","1","0","-2"
"200280","University of North Dakota","2012","On-tenure track, associate professors","6","5","1","0","0","0","0","0","0","0","0","0","0","0","0","0","0","0","3","3","0","0","0","0","0","0","0","3","2","1","-2"
"200280","University of North Dakota","2012","On-tenure track, assistant professors","126","72","54","2","1","1","7","3","4","1","1","0","2","1","1","0","0","0","77","42","35","2","0","2","3","2","1","32","22","10","-2"
"200280","University of North Dakota","2012","Not on tenure track/No tenure system system total","238","109","129","7","2","5","8","3","5","2","1","1","1","0","1","0","0","0","201","90","111","3","1","2","2","1","1","14","11","3","-2"
"200280","University of North Dakota","2012","Not on tenure/no tenure system, professors","12","8","4","0","0","0","1","1","0","0","0","0","0","0","0","0","0","0","10","6","4","0","0","0","0","0","0","1","1","0","-2"
"200280","University of North Dakota","2012","Not on tenure/no tenure system, associate professors","45","22","23","2","0","2","1","0","1","0","0","0","0","0","0","0","0","0","39","21","18","1","0","1","2","1","1","0","0","0","-2"
"200280","University of North Dakota","2012","Not on tenure/no tenure system, assistant professors","109","39","70","5","2","3","6","2","4","2","1","1","0","0","0","0","0","0","85","27","58","2","1","1","0","0","0","9","6","3","-2"
"200280","University of North Dakota","2012","Not on tenure/no tenure system, instructors","28","9","19","0","0","0","0","0","0","0","0","0","0","0","0","0","0","0","28","9","19","0","0","0","0","0","0","0","0","0","-2"
"200280","University of North Dakota","2012","Not on tenure/no tenure system, lecturers","43","30","13","0","0","0","0","0","0","0","0","0","1","0","1","0","0","0","39","27","12","0","0","0","0","0","0","3","3","0","-2"
"200280","University of North Dakota","2012","Not on tenure/no tenure system, no academic rank","1","1","0","0","0","0","0","0","0","0","0","0","0","0","0","0","0","0","0","0","0","0","0","0","0","0","0","1","1","0","-2"
"201885","University of Cincinnati-Main Campus","2012","Tenured total","719","499","220","1","1","0","89","66","23","40","21","19","17","11","6","0","0","0","543","379","164","0","0","0","21","13","8","8","8","0","-2"
"201885","University of Cincinnati-Main Campus","2012","Tenured, professors","424","327","97","1","1","0","54","43","11","23","12","11","8","6","2","0","0","0","327","256","71","0","0","0","9","7","2","2","2","0","-2"
"201885","University of Cincinnati-Main Campus","2012","Tenured, associate professors","287","167","120","0","0","0","34","22","12","17","9","8","9","5","4","0","0","0","210","119","91","0","0","0","11","6","5","6","6","0","-2"
"201885","University of Cincinnati-Main Campus","2012","Tenured, assistant professors","8","5","3","0","0","0","1","1","0","0","0","0","0","0","0","0","0","0","6","4","2","0","0","0","1","0","1","0","0","0","-2"
"201885","University of Cincinnati-Main Campus","2012","On-Tenure track total","41","25","16","0","0","0","4","3","1","2","1","1","1","0","1","0","0","0","22","15","7","0","0","0","6","4","2","6","2","4","-2"
"201885","University of Cincinnati-Main Campus","2012","On-tenure track, professors","5","4","1","0","0","0","1","0","1","0","0","0","0","0","0","0","0","0","3","3","0","0","0","0","1","1","0","0","0","0","-2"
"201885","University of Cincinnati-Main Campus","2012","On-tenure track, associate professors","13","10","3","0","0","0","3","3","0","1","1","0","0","0","0","0","0","0","7","4","3","0","0","0","2","2","0","0","0","0","-2"
"201885","University of Cincinnati-Main Campus","2012","On-tenure track, assistant professors","22","10","12","0","0","0","0","0","0","1","0","1","1","0","1","0","0","0","11","7","4","0","0","0","3","1","2","6","2","4","-2"
"201885","University of Cincinnati-Main Campus","2012","On-tenure track, instructors","1","1","0","0","0","0","0","0","0","0","0","0","0","0","0","0","0","0","1","1","0","0","0","0","0","0","0","0","0","0","-2"
"201885","University of Cincinnati-Main Campus","2012","Not on tenure track/No tenure system system total","909","464","445","2","2","0","69","36","33","37","15","22","23","4","19","1","0","1","627","317","310","4","3","1","80","43","37","66","44","22","-2"
"201885","University of Cincinnati-Main Campus","2012","Not on tenure/no tenure system, professors","95","60","35","0","0","0","4","3","1","3","1","2","2","1","1","0","0","0","83","53","30","0","0","0","3","2","1","0","0","0","-2"
"201885","University of Cincinnati-Main Campus","2012","Not on tenure/no tenure system, associate professors","228","121","107","1","1","0","27","16","11","7","4","3","6","0","6","0","0","0","159","85","74","1","1","0","19","8","11","8","6","2","-2"
"201885","University of Cincinnati-Main Campus","2012","Not on tenure/no tenure system, assistant professors","505","259","246","1","1","0","36","17","19","24","10","14","13","3","10","1","0","1","326","163","163","2","2","0","50","29","21","52","34","18","-2"
"201885","University of Cincinnati-Main Campus","2012","Not on tenure/no tenure system, instructors","81","24","57","0","0","0","2","0","2","3","0","3","2","0","2","0","0","0","59","16","43","1","0","1","8","4","4","6","4","2","-2"
"204796","Ohio State University-Main Campus","2012","Tenured total","1850","1278","572","1","0","1","197","160","37","74","42","32","52","34","18","0","0","0","1389","937","452","8","6","2","38","30","8","91","69","22","-2"
"204796","Ohio State University-Main Campus","2012","Tenured, professors","957","738","219","1","0","1","110","96","14","26","18","8","20","14","6","0","0","0","739","557","182","2","2","0","22","21","1","37","30","7","-2"
"204796","Ohio State University-Main Campus","2012","Tenured, associate professors","844","519","325","0","0","0","87","64","23","45","24","21","32","20","12","0","0","0","605","360","245","6","4","2","15","8","7","54","39","15","-2"
"204796","Ohio State University-Main Campus","2012","Tenured, assistant professors","47","20","27","0","0","0","0","0","0","3","0","3","0","0","0","0","0","0","43","19","24","0","0","0","1","1","0","0","0","0","-2"
"204796","Ohio State University-Main Campus","2012","Tenured, instructors","2","1","1","0","0","0","0","0","0","0","0","0","0","0","0","0","0","0","2","1","1","0","0","0","0","0","0","0","0","0","-2"
"204796","Ohio State University-Main Campus","2012","On-Tenure track total","614","354","260","0","0","0","82","56","26","23","12","11","17","9","8","1","0","1","392","218","174","4","0","4","26","17","9","69","42","27","-2"
"204796","Ohio State University-Main Campus","2012","On-tenure track, professors","2","2","0","0","0","0","0","0","0","0","0","0","0","0","0","0","0","0","1","1","0","0","0","0","0","0","0","1","1","0","-2"
"204796","Ohio State University-Main Campus","2012","On-tenure track, associate professors","20","13","7","0","0","0","5","4","1","0","0","0","1","1","0","0","0","0","11","7","4","0","0","0","2","1","1","1","0","1","-2"
"204796","Ohio State University-Main Campus","2012","On-tenure track, assistant professors","586","335","251","0","0","0","76","51","25","23","12","11","16","8","8","1","0","1","378","208","170","4","0","4","24","16","8","64","40","24","-2"
"204796","Ohio State University-Main Campus","2012","On-tenure track, instructors","6","4","2","0","0","0","1","1","0","0","0","0","0","0","0","0","0","0","2","2","0","0","0","0","0","0","0","3","1","2","-2"
"204796","Ohio State University-Main Campus","2012","Not on tenure track/No tenure system system total","817","457","360","2","0","2","95","41","54","31","15","16","26","15","11","0","0","0","594","336","258","0","0","0","38","31","7","31","19","12","-2"
"204796","Ohio State University-Main Campus","2012","Not on tenure/no tenure system, professors","56","34","22","0","0","0","3","2","1","2","1","1","1","1","0","0","0","0","49","29","20","0","0","0","1","1","0","0","0","0","-2"
"204796","Ohio State University-Main Campus","2012","Not on tenure/no tenure system, associate professors","221","134","87","1","0","1","15","6","9","7","4","3","5","4","1","0","0","0","168","99","69","0","0","0","15","13","2","10","8","2","-2"
"204796","Ohio State University-Main Campus","2012","Not on tenure/no tenure system, assistant professors","537","287","250","1","0","1","77","33","44","22","10","12","20","10","10","0","0","0","374","206","168","0","0","0","22","17","5","21","11","10","-2"
"204796","Ohio State University-Main Campus","2012","Not on tenure/no tenure system, instructors","3","2","1","0","0","0","0","0","0","0","0","0","0","0","0","0","0","0","3","2","1","0","0","0","0","0","0","0","0","0","-2"
"204857","Ohio University-Main Campus","2012","Tenured total","554","374","180","5","3","2","46","40","6","26","18","8","16","11","5","0","0","0","437","286","151","5","2","3","2","1","1","17","13","4","-2"
"204857","Ohio University-Main Campus","2012","Tenured, professors","223","166","57","3","2","1","20","18","2","8","6","2","6","4","2","0","0","0","180","131","49","0","0","0","0","0","0","6","5","1","-2"
"204857","Ohio University-Main Campus","2012","Tenured, associate professors","322","202","120","2","1","1","26","22","4","16","11","5","10","7","3","0","0","0","250","150","100","5","2","3","2","1","1","11","8","3","-2"
"204857","Ohio University-Main Campus","2012","Tenured, assistant professors","9","6","3","0","0","0","0","0","0","2","1","1","0","0","0","0","0","0","7","5","2","0","0","0","0","0","0","0","0","0","-2"
"204857","Ohio University-Main Campus","2012","On-Tenure track total","168","100","68","1","1","0","12","8","4","12","7","5","9","5","4","0","0","0","97","56","41","0","0","0","14","10","4","23","13","10","-2"
"204857","Ohio University-Main Campus","2012","On-tenure track, associate professors","13","7","6","0","0","0","2","2","0","1","1","0","1","0","1","0","0","0","7","3","4","0","0","0","2","1","1","0","0","0","-2"
"204857","Ohio University-Main Campus","2012","On-tenure track, assistant professors","155","93","62","1","1","0","10","6","4","11","6","5","8","5","3","0","0","0","90","53","37","0","0","0","12","9","3","23","13","10","-2"
"204857","Ohio University-Main Campus","2012","Not on tenure track/No tenure system system total","192","87","105","0","0","0","6","3","3","1","1","0","4","3","1","0","0","0","130","62","68","0","0","0","32","12","20","19","6","13","-2"
"204857","Ohio University-Main Campus","2012","Not on tenure/no tenure system, professors","5","2","3","0","0","0","0","0","0","0","0","0","0","0","0","0","0","0","4","2","2","0","0","0","0","0","0","1","0","1","-2"
"204857","Ohio University-Main Campus","2012","Not on tenure/no tenure system, associate professors","4","3","1","0","0","0","1","0","1","1","1","0","0","0","0","0","0","0","2","2","0","0","0","0","0","0","0","0","0","0","-2"
"204857","Ohio University-Main Campus","2012","Not on tenure/no tenure system, assistant professors","76","37","39","0","0","0","4","2","2","0","0","0","3","2","1","0","0","0","43","23","20","0","0","0","21","7","14","5","3","2","-2"
"204857","Ohio University-Main Campus","2012","Not on tenure/no tenure system, instructors","73","30","43","0","0","0","0","0","0","0","0","0","1","1","0","0","0","0","55","24","31","0","0","0","9","5","4","8","0","8","-2"
"204857","Ohio University-Main Campus","2012","Not on tenure/no tenure system, lecturers","16","8","8","0","0","0","1","1","0","0","0","0","0","0","0","0","0","0","12","6","6","0","0","0","1","0","1","2","1","1","-2"
"204857","Ohio University-Main Campus","2012","Not on tenure/no tenure system, no academic rank","18","7","11","0","0","0","0","0","0","0","0","0","0","0","0","0","0","0","14","5","9","0","0","0","1","0","1","3","2","1","-2"
"207500","University of Oklahoma-Norman Campus","2012","Tenured total","687","493","194","13","8","5","65","52","13","12","5","7","17","11","6","0","0","0","530","378","152","3","1","2","10","10","0","37","28","9","-2"
"207500","University of Oklahoma-Norman Campus","2012","Tenured, professors","388","314","74","4","3","1","49","42","7","5","3","2","13","10","3","0","0","0","305","245","60","1","1","0","3","3","0","8","7","1","-2"
"207500","University of Oklahoma-Norman Campus","2012","Tenured, associate professors","299","179","120","9","5","4","16","10","6","7","2","5","4","1","3","0","0","0","225","133","92","2","0","2","7","7","0","29","21","8","-2"
"207500","University of Oklahoma-Norman Campus","2012","On-Tenure track total","224","123","101","6","3","3","15","8","7","9","7","2","6","3","3","1","0","1","139","72","67","2","0","2","8","6","2","38","24","14","-2"
"207500","University of Oklahoma-Norman Campus","2012","On-tenure track, associate professors","12","5","7","0","0","0","3","3","0","1","0","1","0","0","0","0","0","0","7","1","6","0","0","0","0","0","0","1","1","0","-2"
"207500","University of Oklahoma-Norman Campus","2012","On-tenure track, assistant professors","212","118","94","6","3","3","12","5","7","8","7","1","6","3","3","1","0","1","132","71","61","2","0","2","8","6","2","37","23","14","-2"
"207500","University of Oklahoma-Norman Campus","2012","Not on tenure track/No tenure system system total","241","123","118","12","8","4","6","3","3","6","1","5","13","2","11","0","0","0","178","95","83","1","0","1","7","5","2","18","9","9","-2"
"207500","University of Oklahoma-Norman Campus","2012","Not on tenure/no tenure system, professors","7","5","2","0","0","0","1","1","0","1","0","1","0","0","0","0","0","0","5","4","1","0","0","0","0","0","0","0","0","0","-2"
"207500","University of Oklahoma-Norman Campus","2012","Not on tenure/no tenure system, associate professors","23","11","12","0","0","0","1","0","1","2","0","2","0","0","0","0","0","0","19","11","8","0","0","0","0","0","0","1","0","1","-2"
"207500","University of Oklahoma-Norman Campus","2012","Not on tenure/no tenure system, assistant professors","57","30","27","2","2","0","0","0","0","2","1","1","1","0","1","0","0","0","49","26","23","0","0","0","2","1","1","1","0","1","-2"
"207500","University of Oklahoma-Norman Campus","2012","Not on tenure/no tenure system, instructors","99","44","55","10","6","4","3","1","2","1","0","1","10","2","8","0","0","0","66","32","34","0","0","0","2","1","1","7","2","5","-2"
"207500","University of Oklahoma-Norman Campus","2012","Not on tenure/no tenure system, lecturers","55","33","22","0","0","0","1","1","0","0","0","0","2","0","2","0","0","0","39","22","17","1","0","1","3","3","0","9","7","2","-2"
"207971","University of Tulsa","2012","Tenured total","179","139","40","10","7","3","14","13","1","2","1","1","3","3","0","0","0","0","148","113","35","0","0","0","2","2","0","0","0","0","-2"
"207971","University of Tulsa","2012","Tenured, professors","102","85","17","6","5","1","8","8","0","1","1","0","1","1","0","0","0","0","85","69","16","0","0","0","1","1","0","0","0","0","-2"
"207971","University of Tulsa","2012","Tenured, associate professors","77","54","23","4","2","2","6","5","1","1","0","1","2","2","0","0","0","0","63","44","19","0","0","0","1","1","0","0","0","0","-2"
"207971","University of Tulsa","2012","On-Tenure track total","64","47","17","0","0","0","6","5","1","0","0","0","2","1","1","0","0","0","49","37","12","0","0","0","0","0","0","7","4","3","-2"
"207971","University of Tulsa","2012","On-tenure track, associate professors","3","3","0","0","0","0","0","0","0","0","0","0","0","0","0","0","0","0","3","3","0","0","0","0","0","0","0","0","0","0","-2"
"207971","University of Tulsa","2012","On-tenure track, assistant professors","61","44","17","0","0","0","6","5","1","0","0","0","2","1","1","0","0","0","46","34","12","0","0","0","0","0","0","7","4","3","-2"
"207971","University of Tulsa","2012","Not on tenure track/No tenure system system total","75","30","45","7","2","5","2","0","2","0","0","0","5","0","5","0","0","0","57","25","32","0","0","0","1","1","0","3","2","1","-2"
"207971","University of Tulsa","2012","Not on tenure/no tenure system, professors","13","5","8","1","0","1","0","0","0","0","0","0","1","0","1","0","0","0","11","5","6","0","0","0","0","0","0","0","0","0","-2"
"207971","University of Tulsa","2012","Not on tenure/no tenure system, associate professors","12","5","7","1","1","0","0","0","0","0","0","0","0","0","0","0","0","0","11","4","7","0","0","0","0","0","0","0","0","0","-2"
"207971","University of Tulsa","2012","Not on tenure/no tenure system, assistant professors","28","13","15","4","1","3","2","0","2","0","0","0","0","0","0","0","0","0","20","10","10","0","0","0","1","1","0","1","1","0","-2"
"207971","University of Tulsa","2012","Not on tenure/no tenure system, instructors","20","7","13","1","0","1","0","0","0","0","0","0","4","0","4","0","0","0","13","6","7","0","0","0","0","0","0","2","1","1","-2"
"207971","University of Tulsa","2012","Not on tenure/no tenure system, no academic rank","2","0","2","0","0","0","0","0","0","0","0","0","0","0","0","0","0","0","2","0","2","0","0","0","0","0","0","0","0","0","-2"
"209542","Oregon State University","2012","Tenured total","369","252","117","3","1","2","38","26","12","4","3","1","15","10","5","0","0","0","269","185","84","0","0","0","19","10","9","21","17","4","209542"
"209542","Oregon State University","2012","Tenured, professors","180","140","40","0","0","0","12","11","1","1","0","1","4","3","1","0","0","0","146","113","33","0","0","0","11","7","4","6","6","0","209542"
"209542","Oregon State University","2012","Tenured, associate professors","181","109","72","3","1","2","25","15","10","3","3","0","9","6","3","0","0","0","119","70","49","0","0","0","8","3","5","14","11","3","209542"
"209542","Oregon State University","2012","Tenured, assistant professors","2","1","1","0","0","0","0","0","0","0","0","0","1","1","0","0","0","0","1","0","1","0","0","0","0","0","0","0","0","0","209542"
"209542","Oregon State University","2012","Tenured, instructors","6","2","4","0","0","0","1","0","1","0","0","0","1","0","1","0","0","0","3","2","1","0","0","0","0","0","0","1","0","1","209542"
"209542","Oregon State University","2012","On-Tenure track total","209","130","79","0","0","0","15","6","9","1","1","0","12","6","6","0","0","0","125","79","46","2","2","0","24","12","12","30","24","6","209542"
"209542","Oregon State University","2012","On-tenure track, associate professors","21","17","4","0","0","0","1","0","1","0","0","0","0","0","0","0","0","0","14","13","1","0","0","0","4","2","2","2","2","0","209542"
"209542","Oregon State University","2012","On-tenure track, assistant professors","188","113","75","0","0","0","14","6","8","1","1","0","12","6","6","0","0","0","111","66","45","2","2","0","20","10","10","28","22","6","209542"
"209542","Oregon State University","2012","Not on tenure track/No tenure system system total","501","275","226","4","1","3","20","8","12","4","2","2","15","8","7","0","0","0","401","217","184","2","2","0","19","12","7","36","25","11","209542"
"209542","Oregon State University","2012","Not on tenure/no tenure system, professors","37","31","6","0","0","0","0","0","0","1","1","0","1","1","0","0","0","0","35","29","6","0","0","0","0","0","0","0","0","0","209542"
"209542","Oregon State University","2012","Not on tenure/no tenure system, associate professors","28","18","10","0","0","0","3","0","3","0","0","0","0","0","0","0","0","0","23","16","7","1","1","0","1","1","0","0","0","0","209542"
"209542","Oregon State University","2012","Not on tenure/no tenure system, assistant professors","34","18","16","0","0","0","2","1","1","0","0","0","3","2","1","0","0","0","22","10","12","0","0","0","2","1","1","5","4","1","209542"
"209542","Oregon State University","2012","Not on tenure/no tenure system, instructors","232","123","109","2","1","1","8","4","4","1","1","0","8","2","6","0","0","0","186","95","91","1","1","0","11","9","2","15","10","5","209542"
"209542","Oregon State University","2012","Not on tenure/no tenure system, lecturers","8","1","7","0","0","0","0","0","0","0","0","0","0","0","0","0","0","0","7","1","6","0","0","0","1","0","1","0","0","0","209542"
"209542","Oregon State University","2012","Not on tenure/no tenure system, no academic rank","162","84","78","2","0","2","7","3","4","2","0","2","3","3","0","0","0","0","128","66","62","0","0","0","4","1","3","16","11","5","209542"
"211361","California University of Pennsylvania","2012","Tenured total","179","104","75","0","0","0","5","4","1","13","7","6","3","1","2","0","0","0","157","92","65","1","0","1","0","0","0","0","0","0","-2"
"211361","California University of Pennsylvania","2012","Tenured, professors","86","50","36","0","0","0","2","2","0","6","3","3","0","0","0","0","0","0","78","45","33","0","0","0","0","0","0","0","0","0","-2"
"211361","California University of Pennsylvania","2012","Tenured, associate professors","71","42","29","0","0","0","3","2","1","6","3","3","1","0","1","0","0","0","60","37","23","1","0","1","0","0","0","0","0","0","-2"
"211361","California University of Pennsylvania","2012","Tenured, assistant professors","21","12","9","0","0","0","0","0","0","1","1","0","2","1","1","0","0","0","18","10","8","0","0","0","0","0","0","0","0","0","-2"
"211361","California University of Pennsylvania","2012","Tenured, instructors","1","0","1","0","0","0","0","0","0","0","0","0","0","0","0","0","0","0","1","0","1","0","0","0","0","0","0","0","0","0","-2"
"211361","California University of Pennsylvania","2012","On-Tenure track total","54","19","35","0","0","0","4","1","3","5","2","3","1","1","0","0","0","0","43","15","28","0","0","0","0","0","0","1","0","1","-2"
"211361","California University of Pennsylvania","2012","On-tenure track, associate professors","19","6","13","0","0","0","2","1","1","2","0","2","0","0","0","0","0","0","15","5","10","0","0","0","0","0","0","0","0","0","-2"
"211361","California University of Pennsylvania","2012","On-tenure track, assistant professors","33","13","20","0","0","0","2","0","2","3","2","1","1","1","0","0","0","0","26","10","16","0","0","0","0","0","0","1","0","1","-2"
"211361","California University of Pennsylvania","2012","On-tenure track, instructors","2","0","2","0","0","0","0","0","0","0","0","0","0","0","0","0","0","0","2","0","2","0","0","0","0","0","0","0","0","0","-2"
"211361","California University of Pennsylvania","2012","Not on tenure track/No tenure system system total","38","13","25","0","0","0","1","1","0","2","0","2","1","1","0","0","0","0","30","10","20","0","0","0","4","1","3","0","0","0","-2"
"211361","California University of Pennsylvania","2012","Not on tenure/no tenure system, professors","1","1","0","0","0","0","0","0","0","0","0","0","0","0","0","0","0","0","0","0","0","0","0","0","1","1","0","0","0","0","-2"
"211361","California University of Pennsylvania","2012","Not on tenure/no tenure system, assistant professors","6","2","4","0","0","0","1","1","0","1","0","1","0","0","0","0","0","0","4","1","3","0","0","0","0","0","0","0","0","0","-2"
"211361","California University of Pennsylvania","2012","Not on tenure/no tenure system, instructors","21","7","14","0","0","0","0","0","0","1","0","1","1","1","0","0","0","0","19","6","13","0","0","0","0","0","0","0","0","0","-2"
"211361","California University of Pennsylvania","2012","Not on tenure/no tenure system, no academic rank","10","3","7","0","0","0","0","0","0","0","0","0","0","0","0","0","0","0","7","3","4","0","0","0","3","0","3","0","0","0","-2"
"213598","Lincoln University","2012","Tenured total","50","38","12","0","0","0","7","6","1","25","21","4","0","0","0","0","0","0","18","11","7","0","0","0","0","0","0","0","0","0","-2"
"213598","Lincoln University","2012","Tenured, professors","26","22","4","0","0","0","2","2","0","14","13","1","0","0","0","0","0","0","10","7","3","0","0","0","0","0","0","0","0","0","-2"
"213598","Lincoln University","2012","Tenured, associate professors","21","14","7","0","0","0","5","4","1","9","7","2","0","0","0","0","0","0","7","3","4","0","0","0","0","0","0","0","0","0","-2"
"213598","Lincoln University","2012","Tenured, assistant professors","3","2","1","0","0","0","0","0","0","2","1","1","0","0","0","0","0","0","1","1","0","0","0","0","0","0","0","0","0","0","-2"
"213598","Lincoln University","2012","On-Tenure track total","34","17","17","1","0","1","6","3","3","14","7","7","1","0","1","0","0","0","12","7","5","0","0","0","0","0","0","0","0","0","-2"
"213598","Lincoln University","2012","On-tenure track, associate professors","11","5","6","0","0","0","1","1","0","5","2","3","1","0","1","0","0","0","4","2","2","0","0","0","0","0","0","0","0","0","-2"
"213598","Lincoln University","2012","On-tenure track, assistant professors","21","10","11","1","0","1","5","2","3","8","4","4","0","0","0","0","0","0","7","4","3","0","0","0","0","0","0","0","0","0","-2"
"213598","Lincoln University","2012","On-tenure track, instructors","2","2","0","0","0","0","0","0","0","1","1","0","0","0","0","0","0","0","1","1","0","0","0","0","0","0","0","0","0","0","-2"
"213598","Lincoln University","2012","Not on tenure track/No tenure system system total","11","5","6","0","0","0","0","0","0","5","3","2","1","1","0","0","0","0","5","1","4","0","0","0","0","0","0","0","0","0","-2"
"213598","Lincoln University","2012","Not on tenure/no tenure system, assistant professors","4","2","2","0","0","0","0","0","0","4","2","2","0","0","0","0","0","0","0","0","0","0","0","0","0","0","0","0","0","0","-2"
"213598","Lincoln University","2012","Not on tenure/no tenure system, instructors","3","0","3","0","0","0","0","0","0","0","0","0","0","0","0","0","0","0","3","0","3","0","0","0","0","0","0","0","0","0","-2"
"213598","Lincoln University","2012","Not on tenure/no tenure system, lecturers","4","3","1","0","0","0","0","0","0","1","1","0","1","1","0","0","0","0","2","1","1","0","0","0","0","0","0","0","0","0","-2"
"214041","Millersville University of Pennsylvania","2012","Tenured total","222","115","107","0","0","0","17","10","7","10","5","5","11","3","8","0","0","0","183","97","86","1","0","1","0","0","0","0","0","0","-2"
"214041","Millersville University of Pennsylvania","2012","Tenured, professors","91","52","39","0","0","0","7","4","3","4","2","2","3","1","2","0","0","0","77","45","32","0","0","0","0","0","0","0","0","0","-2"
"214041","Millersville University of Pennsylvania","2012","Tenured, associate professors","97","46","51","0","0","0","7","5","2","3","0","3","6","1","5","0","0","0","80","40","40","1","0","1","0","0","0","0","0","0","-2"
"214041","Millersville University of Pennsylvania","2012","Tenured, assistant professors","34","17","17","0","0","0","3","1","2","3","3","0","2","1","1","0","0","0","26","12","14","0","0","0","0","0","0","0","0","0","-2"
"214041","Millersville University of Pennsylvania","2012","On-Tenure track total","56","31","25","1","1","0","2","1","1","2","2","0","6","4","2","1","1","0","40","20","20","1","1","0","1","1","0","2","0","2","-2"
"214041","Millersville University of Pennsylvania","2012","On-tenure track, associate professors","2","1","1","0","0","0","0","0","0","1","1","0","0","0","0","0","0","0","1","0","1","0","0","0","0","0","0","0","0","0","-2"
"214041","Millersville University of Pennsylvania","2012","On-tenure track, assistant professors","53","30","23","1","1","0","2","1","1","1","1","0","6","4","2","1","1","0","38","20","18","1","1","0","1","1","0","2","0","2","-2"
"214041","Millersville University of Pennsylvania","2012","On-tenure track, instructors","1","0","1","0","0","0","0","0","0","0","0","0","0","0","0","0","0","0","1","0","1","0","0","0","0","0","0","0","0","0","-2"
"214041","Millersville University of Pennsylvania","2012","Not on tenure track/No tenure system system total","3","1","2","0","0","0","0","0","0","0","0","0","0","0","0","0","0","0","2","1","1","0","0","0","1","0","1","0","0","0","-2"
"214041","Millersville University of Pennsylvania","2012","Not on tenure/no tenure system, assistant professors","2","1","1","0","0","0","0","0","0","0","0","0","0","0","0","0","0","0","2","1","1","0","0","0","0","0","0","0","0","0","-2"
"214041","Millersville University of Pennsylvania","2012","Not on tenure/no tenure system, instructors","1","0","1","0","0","0","0","0","0","0","0","0","0","0","0","0","0","0","0","0","0","0","0","0","1","0","1","0","0","0","-2"
"214777","Pennsylvania State University-Main Campus","2012","Tenured total","1226","862","364","3","3","0","150","120","30","47","28","19","36","21","15","0","0","0","928","647","281","4","2","2","55","39","16","3","2","1","-2"
"214777","Pennsylvania State University-Main Campus","2012","Tenured, professors","771","593","178","1","1","0","90","81","9","24","18","6","14","10","4","0","0","0","612","463","149","0","0","0","28","19","9","2","1","1","-2"
"214777","Pennsylvania State University-Main Campus","2012","Tenured, associate professors","453","268","185","2","2","0","60","39","21","23","10","13","22","11","11","0","0","0","315","184","131","4","2","2","26","19","7","1","1","0","-2"
"214777","Pennsylvania State University-Main Campus","2012","Tenured, assistant professors","1","0","1","0","0","0","0","0","0","0","0","0","0","0","0","0","0","0","1","0","1","0","0","0","0","0","0","0","0","0","-2"
"214777","Pennsylvania State University-Main Campus","2012","Tenured, instructors","1","1","0","0","0","0","0","0","0","0","0","0","0","0","0","0","0","0","0","0","0","0","0","0","1","1","0","0","0","0","-2"
"214777","Pennsylvania State University-Main Campus","2012","On-Tenure track total","325","183","142","2","1","1","32","18","14","15","6","9","16","8","8","0","0","0","201","111","90","3","2","1","15","6","9","41","31","10","-2"
"214777","Pennsylvania State University-Main Campus","2012","On-tenure track, associate professors","16","11","5","0","0","0","2","2","0","1","0","1","1","1","0","0","0","0","11","8","3","0","0","0","0","0","0","1","0","1","-2"
"214777","Pennsylvania State University-Main Campus","2012","On-tenure track, assistant professors","309","172","137","2","1","1","30","16","14","14","6","8","15","7","8","0","0","0","190","103","87","3","2","1","15","6","9","40","31","9","-2"
"214777","Pennsylvania State University-Main Campus","2012","Not on tenure track/No tenure system system total","977","494","483","2","1","1","51","23","28","28","18","10","29","9","20","0","0","0","736","374","362","4","2","2","43","25","18","84","42","42","-2"
"214777","Pennsylvania State University-Main Campus","2012","Not on tenure/no tenure system, professors","27","21","6","0","0","0","0","0","0","1","1","0","1","0","1","0","0","0","21","17","4","0","0","0","3","2","1","1","1","0","-2"
"214777","Pennsylvania State University-Main Campus","2012","Not on tenure/no tenure system, associate professors","58","32","26","0","0","0","5","3","2","0","0","0","0","0","0","0","0","0","47","26","21","0","0","0","3","1","2","3","2","1","-2"
"214777","Pennsylvania State University-Main Campus","2012","Not on tenure/no tenure system, assistant professors","209","114","95","1","0","1","18","13","5","10","6","4","2","1","1","0","0","0","133","69","64","1","1","0","9","3","6","35","21","14","-2"
"214777","Pennsylvania State University-Main Campus","2012","Not on tenure/no tenure system, instructors","252","119","133","0","0","0","11","3","8","6","4","2","4","2","2","0","0","0","207","97","110","2","1","1","7","4","3","15","8","7","-2"
"214777","Pennsylvania State University-Main Campus","2012","Not on tenure/no tenure system, lecturers","431","208","223","1","1","0","17","4","13","11","7","4","22","6","16","0","0","0","328","165","163","1","0","1","21","15","6","30","10","20","-2"
"217156","Brown University","2012","Tenured total","485","351","134","0","0","0","52","38","14","18","17","1","14","10","4","0","0","0","392","279","113","4","2","2","1","1","0","4","4","0","-2"
"217156","Brown University","2012","Tenured, professors","362","274","88","0","0","0","32","26","6","10","9","1","7","4","3","0","0","0","306","230","76","4","2","2","1","1","0","2","2","0","-2"
"217156","Brown University","2012","Tenured, associate professors","123","77","46","0","0","0","20","12","8","8","8","0","7","6","1","0","0","0","86","49","37","0","0","0","0","0","0","2","2","0","-2"
"217156","Brown University","2012","On-Tenure track total","130","82","48","0","0","0","9","4","5","9","2","7","4","3","1","0","0","0","90","59","31","2","1","1","2","1","1","14","12","2","-2"
"217156","Brown University","2012","On-tenure track, professors","2","2","0","0","0","0","0","0","0","1","1","0","0","0","0","0","0","0","0","0","0","0","0","0","0","0","0","1","1","0","-2"
"217156","Brown University","2012","On-tenure track, associate professors","2","1","1","0","0","0","0","0","0","0","0","0","0","0","0","0","0","0","2","1","1","0","0","0","0","0","0","0","0","0","-2"
"217156","Brown University","2012","On-tenure track, assistant professors","126","79","47","0","0","0","9","4","5","8","1","7","4","3","1","0","0","0","88","58","30","2","1","1","2","1","1","13","11","2","-2"
"217156","Brown University","2012","Not on tenure track/No tenure system system total","186","83","103","1","0","1","19","7","12","6","3","3","6","2","4","0","0","0","125","59","66","2","0","2","8","3","5","19","9","10","-2"
"217156","Brown University","2012","Not on tenure/no tenure system, professors","22","14","8","0","0","0","1","1","0","0","0","0","0","0","0","0","0","0","20","12","8","0","0","0","1","1","0","0","0","0","-2"
"217156","Brown University","2012","Not on tenure/no tenure system, associate professors","9","6","3","0","0","0","1","1","0","0","0","0","0","0","0","0","0","0","8","5","3","0","0","0","0","0","0","0","0","0","-2"
"217156","Brown University","2012","Not on tenure/no tenure system, assistant professors","16","8","8","0","0","0","4","1","3","0","0","0","0","0","0","0","0","0","6","4","2","1","0","1","2","0","2","3","3","0","-2"
"217156","Brown University","2012","Not on tenure/no tenure system, lecturers","65","21","44","0","0","0","8","2","6","1","0","1","3","0","3","0","0","0","50","17","33","0","0","0","0","0","0","3","2","1","-2"
"217156","Brown University","2012","Not on tenure/no tenure system, no academic rank","74","34","40","1","0","1","5","2","3","5","3","2","3","2","1","0","0","0","41","21","20","1","0","1","5","2","3","13","4","9","-2"
"217484","University of Rhode Island","2012","Tenured total","439","278","161","3","1","2","43","33","10","14","7","7","11","6","5","0","0","0","362","226","136","0","0","0","0","0","0","6","5","1","-2"
"217484","University of Rhode Island","2012","Tenured, professors","287","203","84","2","1","1","28","24","4","6","5","1","7","6","1","0","0","0","241","165","76","0","0","0","0","0","0","3","2","1","-2"
"217484","University of Rhode Island","2012","Tenured, associate professors","152","75","77","1","0","1","15","9","6","8","2","6","4","0","4","0","0","0","121","61","60","0","0","0","0","0","0","3","3","0","-2"
"217484","University of Rhode Island","2012","On-Tenure track total","99","44","55","1","0","1","13","8","5","0","0","0","6","2","4","0","0","0","72","30","42","0","0","0","0","0","0","7","4","3","-2"
"217484","University of Rhode Island","2012","On-tenure track, associate professors","3","1","2","0","0","0","0","0","0","0","0","0","1","0","1","0","0","0","2","1","1","0","0","0","0","0","0","0","0","0","-2"
"217484","University of Rhode Island","2012","On-tenure track, assistant professors","94","43","51","1","0","1","13","8","5","0","0","0","5","2","3","0","0","0","68","29","39","0","0","0","0","0","0","7","4","3","-2"
"217484","University of Rhode Island","2012","On-tenure track, instructors","2","0","2","0","0","0","0","0","0","0","0","0","0","0","0","0","0","0","2","0","2","0","0","0","0","0","0","0","0","0","-2"
"217484","University of Rhode Island","2012","Not on tenure track/No tenure system system total","147","52","95","0","0","0","6","0","6","1","1","0","5","3","2","0","0","0","133","46","87","0","0","0","0","0","0","2","2","0","-2"
"217484","University of Rhode Island","2012","Not on tenure/no tenure system, professors","3","3","0","0","0","0","0","0","0","0","0","0","0","0","0","0","0","0","3","3","0","0","0","0","0","0","0","0","0","0","-2"
"217484","University of Rhode Island","2012","Not on tenure/no tenure system, associate professors","20","4","16","0","0","0","0","0","0","0","0","0","0","0","0","0","0","0","20","4","16","0","0","0","0","0","0","0","0","0","-2"
"217484","University of Rhode Island","2012","Not on tenure/no tenure system, assistant professors","27","4","23","0","0","0","0","0","0","1","1","0","0","0","0","0","0","0","26","3","23","0","0","0","0","0","0","0","0","0","-2"
"217484","University of Rhode Island","2012","Not on tenure/no tenure system, instructors","5","3","2","0","0","0","0","0","0","0","0","0","0","0","0","0","0","0","5","3","2","0","0","0","0","0","0","0","0","0","-2"
"217484","University of Rhode Island","2012","Not on tenure/no tenure system, lecturers","92","38","54","0","0","0","6","0","6","0","0","0","5","3","2","0","0","0","79","33","46","0","0","0","0","0","0","2","2","0","-2"
"217819","College of Charleston","2012","Tenured total","299","186","113","0","0","0","7","6","1","14","7","7","15","10","5","0","0","0","240","146","94","3","3","0","15","12","3","5","2","3","-2"
"217819","College of Charleston","2012","Tenured, professors","137","97","40","0","0","0","3","3","0","5","4","1","5","4","1","0","0","0","115","78","37","2","2","0","7","6","1","0","0","0","-2"
"217819","College of Charleston","2012","Tenured, associate professors","159","89","70","0","0","0","4","3","1","9","3","6","10","6","4","0","0","0","122","68","54","1","1","0","8","6","2","5","2","3","-2"
"217819","College of Charleston","2012","Tenured, assistant professors","3","0","3","0","0","0","0","0","0","0","0","0","0","0","0","0","0","0","3","0","3","0","0","0","0","0","0","0","0","0","-2"
"217819","College of Charleston","2012","On-Tenure track total","128","78","50","0","0","0","2","1","1","4","3","1","6","2","4","0","0","0","95","57","38","2","2","0","7","6","1","12","7","5","-2"
"217819","College of Charleston","2012","On-tenure track, assistant professors","128","78","50","0","0","0","2","1","1","4","3","1","6","2","4","0","0","0","95","57","38","2","2","0","7","6","1","12","7","5","-2"
"217819","College of Charleston","2012","Not on tenure track/No tenure system system total","92","36","56","0","0","0","2","2","0","2","0","2","3","1","2","1","1","0","78","29","49","2","1","1","3","1","2","1","1","0","-2"
"217819","College of Charleston","2012","Not on tenure/no tenure system, professors","1","1","0","0","0","0","0","0","0","0","0","0","0","0","0","0","0","0","1","1","0","0","0","0","0","0","0","0","0","0","-2"
"217819","College of Charleston","2012","Not on tenure/no tenure system, assistant professors","35","15","20","0","0","0","1","1","0","1","0","1","0","0","0","0","0","0","30","12","18","1","1","0","1","0","1","1","1","0","-2"
"217819","College of Charleston","2012","Not on tenure/no tenure system, instructors","56","20","36","0","0","0","1","1","0","1","0","1","3","1","2","1","1","0","47","16","31","1","0","1","2","1","1","0","0","0","-2"
"217873","Claflin University","2012","Tenured total","38","25","13","0","0","0","14","12","2","13","6","7","0","0","0","0","0","0","11","7","4","0","0","0","0","0","0","0","0","0","-2"
"217873","Claflin University","2012","Tenured, professors","16","9","7","0","0","0","6","5","1","7","3","4","0","0","0","0","0","0","3","1","2","0","0","0","0","0","0","0","0","0","-2"
"217873","Claflin University","2012","Tenured, associate professors","13","11","2","0","0","0","7","6","1","1","0","1","0","0","0","0","0","0","5","5","0","0","0","0","0","0","0","0","0","0","-2"
"217873","Claflin University","2012","Tenured, assistant professors","9","5","4","0","0","0","1","1","0","5","3","2","0","0","0","0","0","0","3","1","2","0","0","0","0","0","0","0","0","0","-2"
"217873","Claflin University","2012","On-Tenure track total","58","33","25","1","0","1","7","4","3","25","12","13","3","3","0","0","0","0","13","9","4","1","0","1","0","0","0","8","5","3","-2"
"217873","Claflin University","2012","On-tenure track, professors","2","1","1","0","0","0","0","0","0","2","1","1","0","0","0","0","0","0","0","0","0","0","0","0","0","0","0","0","0","0","-2"
"217873","Claflin University","2012","On-tenure track, associate professors","9","8","1","0","0","0","0","0","0","5","4","1","1","1","0","0","0","0","2","2","0","0","0","0","0","0","0","1","1","0","-2"
"217873","Claflin University","2012","On-tenure track, assistant professors","47","24","23","1","0","1","7","4","3","18","7","11","2","2","0","0","0","0","11","7","4","1","0","1","0","0","0","7","4","3","-2"
"217873","Claflin University","2012","Not on tenure track/No tenure system system total","25","12","13","0","0","0","0","0","0","17","7","10","1","0","1","0","0","0","4","3","1","0","0","0","0","0","0","3","2","1","-2"
"217873","Claflin University","2012","Not on tenure/no tenure system, professors","1","0","1","0","0","0","0","0","0","1","0","1","0","0","0","0","0","0","0","0","0","0","0","0","0","0","0","0","0","0","-2"
"217873","Claflin University","2012","Not on tenure/no tenure system, assistant professors","7","3","4","0","0","0","0","0","0","3","0","3","0","0","0","0","0","0","2","2","0","0","0","0","0","0","0","2","1","1","-2"
"217873","Claflin University","2012","Not on tenure/no tenure system, instructors","16","9","7","0","0","0","0","0","0","12","7","5","1","0","1","0","0","0","2","1","1","0","0","0","0","0","0","1","1","0","-2"
"217873","Claflin University","2012","Not on tenure/no tenure system, lecturers","1","0","1","0","0","0","0","0","0","1","0","1","0","0","0","0","0","0","0","0","0","0","0","0","0","0","0","0","0","0","-2"
"217882","Clemson University","2012","Tenured total","584","444","140","0","0","0","62","53","9","18","15","3","9","3","6","0","0","0","493","372","121","1","0","1","1","1","0","0","0","0","-2"
"217882","Clemson University","2012","Tenured, professors","335","270","65","0","0","0","34","32","2","6","5","1","2","1","1","0","0","0","292","232","60","1","0","1","0","0","0","0","0","0","-2"
"217882","Clemson University","2012","Tenured, associate professors","249","174","75","0","0","0","28","21","7","12","10","2","7","2","5","0","0","0","201","140","61","0","0","0","1","1","0","0","0","0","-2"
"217882","Clemson University","2012","On-Tenure track total","232","134","98","0","0","0","39","26","13","9","4","5","5","0","5","0","0","0","173","99","74","0","0","0","5","4","1","1","1","0","-2"
"217882","Clemson University","2012","On-tenure track, professors","1","1","0","0","0","0","0","0","0","0","0","0","0","0","0","0","0","0","1","1","0","0","0","0","0","0","0","0","0","0","-2"
"217882","Clemson University","2012","On-tenure track, associate professors","15","10","5","0","0","0","1","1","0","2","1","1","0","0","0","0","0","0","11","7","4","0","0","0","1","1","0","0","0","0","-2"
"217882","Clemson University","2012","On-tenure track, assistant professors","216","123","93","0","0","0","38","25","13","7","3","4","5","0","5","0","0","0","161","91","70","0","0","0","4","3","1","1","1","0","-2"
"217882","Clemson University","2012","Not on tenure track/No tenure system system total","50","23","27","0","0","0","1","0","1","2","1","1","2","1","1","0","0","0","45","21","24","0","0","0","0","0","0","0","0","0","-2"
"217882","Clemson University","2012","Not on tenure/no tenure system, assistant professors","3","2","1","0","0","0","0","0","0","1","1","0","0","0","0","0","0","0","2","1","1","0","0","0","0","0","0","0","0","0","-2"
"217882","Clemson University","2012","Not on tenure/no tenure system, lecturers","47","21","26","0","0","0","1","0","1","1","0","1","2","1","1","0","0","0","43","20","23","0","0","0","0","0","0","0","0","0","-2"
"218724","Coastal Carolina University","2012","Tenured total","156","102","54","2","2","0","4","2","2","6","3","3","6","3","3","0","0","0","135","89","46","1","1","0","0","0","0","2","2","0","-2"
"218724","Coastal Carolina University","2012","Tenured, professors","68","49","19","1","1","0","1","1","0","2","1","1","2","1","1","0","0","0","61","44","17","0","0","0","0","0","0","1","1","0","-2"
"218724","Coastal Carolina University","2012","Tenured, associate professors","86","52","34","0","0","0","3","1","2","3","2","1","4","2","2","0","0","0","74","45","29","1","1","0","0","0","0","1","1","0","-2"
"218724","Coastal Carolina University","2012","Tenured, assistant professors","2","1","1","1","1","0","0","0","0","1","0","1","0","0","0","0","0","0","0","0","0","0","0","0","0","0","0","0","0","0","-2"
"218724","Coastal Carolina University","2012","On-Tenure track total","121","61","60","0","0","0","8","4","4","6","2","4","1","1","0","0","0","0","103","52","51","1","0","1","0","0","0","2","2","0","-2"
"218724","Coastal Carolina University","2012","On-tenure track, associate professors","6","3","3","0","0","0","0","0","0","0","0","0","0","0","0","0","0","0","6","3","3","0","0","0","0","0","0","0","0","0","-2"
"218724","Coastal Carolina University","2012","On-tenure track, assistant professors","115","58","57","0","0","0","8","4","4","6","2","4","1","1","0","0","0","0","97","49","48","1","0","1","0","0","0","2","2","0","-2"
"218724","Coastal Carolina University","2012","Not on tenure track/No tenure system system total","106","50","56","0","0","0","2","1","1","4","2","2","4","3","1","0","0","0","96","44","52","0","0","0","0","0","0","0","0","0","-2"
"218724","Coastal Carolina University","2012","Not on tenure/no tenure system, associate professors","1","1","0","0","0","0","0","0","0","0","0","0","0","0","0","0","0","0","1","1","0","0","0","0","0","0","0","0","0","0","-2"
"218724","Coastal Carolina University","2012","Not on tenure/no tenure system, assistant professors","2","0","2","0","0","0","0","0","0","0","0","0","0","0","0","0","0","0","2","0","2","0","0","0","0","0","0","0","0","0","-2"
"218724","Coastal Carolina University","2012","Not on tenure/no tenure system, instructors","12","7","5","0","0","0","1","0","1","0","0","0","2","2","0","0","0","0","9","5","4","0","0","0","0","0","0","0","0","0","-2"
"218724","Coastal Carolina University","2012","Not on tenure/no tenure system, lecturers","91","42","49","0","0","0","1","1","0","4","2","2","2","1","1","0","0","0","84","38","46","0","0","0","0","0","0","0","0","0","-2"
"219347","South Dakota School of Mines and Technology","2012","Tenured total","71","59","12","0","0","0","7","6","1","0","0","0","2","2","0","0","0","0","62","51","11","0","0","0","0","0","0","0","0","0","-2"
"219347","South Dakota School of Mines and Technology","2012","Tenured, professors","48","39","9","0","0","0","3","2","1","0","0","0","1","1","0","0","0","0","44","36","8","0","0","0","0","0","0","0","0","0","-2"
"219347","South Dakota School of Mines and Technology","2012","Tenured, associate professors","23","20","3","0","0","0","4","4","0","0","0","0","1","1","0","0","0","0","18","15","3","0","0","0","0","0","0","0","0","0","-2"
"219347","South Dakota School of Mines and Technology","2012","On-Tenure track total","43","34","9","1","1","0","3","3","0","0","0","0","1","0","1","0","0","0","33","26","7","0","0","0","0","0","0","5","4","1","-2"
"219347","South Dakota School of Mines and Technology","2012","On-tenure track, professors","1","1","0","0","0","0","0","0","0","0","0","0","0","0","0","0","0","0","1","1","0","0","0","0","0","0","0","0","0","0","-2"
"219347","South Dakota School of Mines and Technology","2012","On-tenure track, associate professors","11","9","2","1","1","0","1","1","0","0","0","0","0","0","0","0","0","0","9","7","2","0","0","0","0","0","0","0","0","0","-2"
"219347","South Dakota School of Mines and Technology","2012","On-tenure track, assistant professors","31","24","7","0","0","0","2","2","0","0","0","0","1","0","1","0","0","0","23","18","5","0","0","0","0","0","0","5","4","1","-2"
"219347","South Dakota School of Mines and Technology","2012","Not on tenure track/No tenure system system total","28","17","11","1","1","0","1","1","0","0","0","0","0","0","0","0","0","0","26","15","11","0","0","0","0","0","0","0","0","0","-2"
"219347","South Dakota School of Mines and Technology","2012","Not on tenure/no tenure system, professors","3","3","0","0","0","0","0","0","0","0","0","0","0","0","0","0","0","0","3","3","0","0","0","0","0","0","0","0","0","0","-2"
"219347","South Dakota School of Mines and Technology","2012","Not on tenure/no tenure system, associate professors","1","0","1","0","0","0","0","0","0","0","0","0","0","0","0","0","0","0","1","0","1","0","0","0","0","0","0","0","0","0","-2"
"219347","South Dakota School of Mines and Technology","2012","Not on tenure/no tenure system, assistant professors","6","4","2","0","0","0","0","0","0","0","0","0","0","0","0","0","0","0","6","4","2","0","0","0","0","0","0","0","0","0","-2"
"219347","South Dakota School of Mines and Technology","2012","Not on tenure/no tenure system, instructors","17","9","8","1","1","0","1","1","0","0","0","0","0","0","0","0","0","0","15","7","8","0","0","0","0","0","0","0","0","0","-2"
"219347","South Dakota School of Mines and Technology","2012","Not on tenure/no tenure system, lecturers","1","1","0","0","0","0","0","0","0","0","0","0","0","0","0","0","0","0","1","1","0","0","0","0","0","0","0","0","0","0","-2"
"221759","The University of Tennessee-Knoxville","2012","Tenured total","1132","793","339","4","4","0","107","85","22","37","21","16","25","23","2","0","0","0","955","657","298","0","0","0","1","0","1","3","3","0","-2"
"221759","The University of Tennessee-Knoxville","2012","Tenured, professors","670","522","148","1","1","0","46","38","8","11","6","5","12","11","1","0","0","0","599","466","133","0","0","0","1","0","1","0","0","0","-2"
"221759","The University of Tennessee-Knoxville","2012","Tenured, associate professors","453","268","185","3","3","0","60","47","13","24","14","10","13","12","1","0","0","0","350","189","161","0","0","0","0","0","0","3","3","0","-2"
"221759","The University of Tennessee-Knoxville","2012","Tenured, assistant professors","8","3","5","0","0","0","1","0","1","2","1","1","0","0","0","0","0","0","5","2","3","0","0","0","0","0","0","0","0","0","-2"
"221759","The University of Tennessee-Knoxville","2012","Tenured, instructors","1","0","1","0","0","0","0","0","0","0","0","0","0","0","0","0","0","0","1","0","1","0","0","0","0","0","0","0","0","0","-2"
"221759","The University of Tennessee-Knoxville","2012","On-Tenure track total","372","220","152","2","1","1","56","37","19","19","4","15","9","4","5","0","0","0","236","140","96","3","1","2","0","0","0","47","33","14","-2"
"221759","The University of Tennessee-Knoxville","2012","On-tenure track, professors","10","9","1","0","0","0","1","1","0","0","0","0","0","0","0","0","0","0","9","8","1","0","0","0","0","0","0","0","0","0","-2"
"221759","The University of Tennessee-Knoxville","2012","On-tenure track, associate professors","47","29","18","0","0","0","14","9","5","1","0","1","0","0","0","0","0","0","28","17","11","1","0","1","0","0","0","3","3","0","-2"
"221759","The University of Tennessee-Knoxville","2012","On-tenure track, assistant professors","315","182","133","2","1","1","41","27","14","18","4","14","9","4","5","0","0","0","199","115","84","2","1","1","0","0","0","44","30","14","-2"
"221759","The University of Tennessee-Knoxville","2012","Not on tenure track/No tenure system system total","607","277","330","1","0","1","47","31","16","28","13","15","27","11","16","0","0","0","472","203","269","1","0","1","0","0","0","31","19","12","-2"
"221759","The University of Tennessee-Knoxville","2012","Not on tenure/no tenure system, professors","25","19","6","0","0","0","1","1","0","0","0","0","0","0","0","0","0","0","24","18","6","0","0","0","0","0","0","0","0","0","-2"
"221759","The University of Tennessee-Knoxville","2012","Not on tenure/no tenure system, associate professors","67","34","33","1","0","1","7","6","1","4","4","0","2","2","0","0","0","0","52","22","30","0","0","0","0","0","0","1","0","1","-2"
"221759","The University of Tennessee-Knoxville","2012","Not on tenure/no tenure system, assistant professors","182","91","91","0","0","0","27","22","5","13","5","8","9","4","5","0","0","0","120","51","69","0","0","0","0","0","0","13","9","4","-2"
"221759","The University of Tennessee-Knoxville","2012","Not on tenure/no tenure system, instructors","45","8","37","0","0","0","5","1","4","5","0","5","2","1","1","0","0","0","32","5","27","0","0","0","0","0","0","1","1","0","-2"
"221759","The University of Tennessee-Knoxville","2012","Not on tenure/no tenure system, lecturers","273","115","158","0","0","0","7","1","6","6","4","2","14","4","10","0","0","0","237","103","134","1","0","1","0","0","0","8","3","5","-2"
"221759","The University of Tennessee-Knoxville","2012","Not on tenure/no tenure system, no academic rank","15","10","5","0","0","0","0","0","0","0","0","0","0","0","0","0","0","0","7","4","3","0","0","0","0","0","0","8","6","2","-2"
"221768","The University of Tennessee-Martin","2012","Tenured total","148","85","63","1","0","1","3","2","1","9","3","6","2","1","1","0","0","0","131","78","53","0","0","0","0","0","0","2","1","1","-2"
"221768","The University of Tennessee-Martin","2012","Tenured, professors","69","48","21","0","0","0","1","1","0","3","1","2","0","0","0","0","0","0","65","46","19","0","0","0","0","0","0","0","0","0","-2"
"221768","The University of Tennessee-Martin","2012","Tenured, associate professors","54","27","27","1","0","1","2","1","1","4","1","3","2","1","1","0","0","0","43","23","20","0","0","0","0","0","0","2","1","1","-2"
"221768","The University of Tennessee-Martin","2012","Tenured, assistant professors","14","5","9","0","0","0","0","0","0","1","1","0","0","0","0","0","0","0","13","4","9","0","0","0","0","0","0","0","0","0","-2"
"221768","The University of Tennessee-Martin","2012","Tenured, instructors","11","5","6","0","0","0","0","0","0","1","0","1","0","0","0","0","0","0","10","5","5","0","0","0","0","0","0","0","0","0","-2"
"221768","The University of Tennessee-Martin","2012","On-Tenure track total","85","50","35","0","0","0","3","1","2","4","2","2","1","1","0","0","0","0","71","41","30","0","0","0","0","0","0","6","5","1","-2"
"221768","The University of Tennessee-Martin","2012","On-tenure track, associate professors","7","4","3","0","0","0","0","0","0","1","0","1","0","0","0","0","0","0","5","3","2","0","0","0","0","0","0","1","1","0","-2"
"221768","The University of Tennessee-Martin","2012","On-tenure track, assistant professors","71","41","30","0","0","0","3","1","2","3","2","1","0","0","0","0","0","0","61","35","26","0","0","0","0","0","0","4","3","1","-2"
"221768","The University of Tennessee-Martin","2012","On-tenure track, instructors","6","5","1","0","0","0","0","0","0","0","0","0","1","1","0","0","0","0","4","3","1","0","0","0","0","0","0","1","1","0","-2"
"221768","The University of Tennessee-Martin","2012","On-tenure track, lecturers","1","0","1","0","0","0","0","0","0","0","0","0","0","0","0","0","0","0","1","0","1","0","0","0","0","0","0","0","0","0","-2"
"221768","The University of Tennessee-Martin","2012","Not on tenure track/No tenure system system total","44","21","23","0","0","0","1","0","1","2","0","2","1","0","1","0","0","0","40","21","19","0","0","0","0","0","0","0","0","0","-2"
"221768","The University of Tennessee-Martin","2012","Not on tenure/no tenure system, assistant professors","2","1","1","0","0","0","0","0","0","1","0","1","0","0","0","0","0","0","1","1","0","0","0","0","0","0","0","0","0","0","-2"
"221768","The University of Tennessee-Martin","2012","Not on tenure/no tenure system, instructors","1","1","0","0","0","0","0","0","0","0","0","0","0","0","0","0","0","0","1","1","0","0","0","0","0","0","0","0","0","0","-2"
"221768","The University of Tennessee-Martin","2012","Not on tenure/no tenure system, lecturers","41","19","22","0","0","0","1","0","1","1","0","1","1","0","1","0","0","0","38","19","19","0","0","0","0","0","0","0","0","0","-2"
"221999","Vanderbilt University","2012","Tenured total","919","705","214","2","1","1","45","36","9","29","18","11","17","12","5","0","0","0","781","605","176","0","0","0","38","29","9","7","4","3","-2"
"221999","Vanderbilt University","2012","Tenured, professors","627","510","117","0","0","0","27","21","6","15","9","6","12","10","2","0","0","0","549","451","98","0","0","0","22","17","5","2","2","0","-2"
"221999","Vanderbilt University","2012","Tenured, associate professors","292","195","97","2","1","1","18","15","3","14","9","5","5","2","3","0","0","0","232","154","78","0","0","0","16","12","4","5","2","3","-2"
"221999","Vanderbilt University","2012","On-Tenure track total","342","214","128","0","0","0","46","28","18","13","5","8","14","10","4","0","0","0","226","145","81","0","0","0","20","12","8","23","14","9","-2"
"221999","Vanderbilt University","2012","On-tenure track, professors","1","1","0","0","0","0","0","0","0","0","0","0","1","1","0","0","0","0","0","0","0","0","0","0","0","0","0","0","0","0","-2"
"221999","Vanderbilt University","2012","On-tenure track, associate professors","17","12","5","0","0","0","1","1","0","0","0","0","0","0","0","0","0","0","13","10","3","0","0","0","2","0","2","1","1","0","-2"
"221999","Vanderbilt University","2012","On-tenure track, assistant professors","324","201","123","0","0","0","45","27","18","13","5","8","13","9","4","0","0","0","213","135","78","0","0","0","18","12","6","22","13","9","-2"
"221999","Vanderbilt University","2012","Not on tenure track/No tenure system system total","2010","942","1068","2","0","2","152","78","74","76","33","43","44","20","24","0","0","0","1625","745","880","3","3","0","66","40","26","42","23","19","-2"
"221999","Vanderbilt University","2012","Not on tenure/no tenure system, professors","160","116","44","0","0","0","8","7","1","5","3","2","0","0","0","0","0","0","143","102","41","0","0","0","3","3","0","1","1","0","-2"
"221999","Vanderbilt University","2012","Not on tenure/no tenure system, associate professors","286","180","106","1","0","1","23","15","8","18","12","6","5","3","2","0","0","0","228","143","85","0","0","0","10","6","4","1","1","0","-2"
"221999","Vanderbilt University","2012","Not on tenure/no tenure system, assistant professors","930","492","438","0","0","0","97","50","47","32","12","20","23","12","11","0","0","0","727","384","343","2","2","0","21","14","7","28","18","10","-2"
"221999","Vanderbilt University","2012","Not on tenure/no tenure system, instructors","480","101","379","1","0","1","19","6","13","17","4","13","9","3","6","0","0","0","415","75","340","1","1","0","14","10","4","4","2","2","-2"
"221999","Vanderbilt University","2012","Not on tenure/no tenure system, lecturers","154","53","101","0","0","0","5","0","5","4","2","2","7","2","5","0","0","0","112","41","71","0","0","0","18","7","11","8","1","7","-2"
"225511","University of Houston","2012","Tenured total","685","507","178","2","2","0","107","79","28","24","15","9","46","27","19","0","0","0","502","381","121","4","3","1","0","0","0","0","0","0","-2"
"225511","University of Houston","2012","Tenured, professors","384","318","66","0","0","0","63","54","9","6","5","1","16","11","5","0","0","0","297","246","51","2","2","0","0","0","0","0","0","0","-2"
"225511","University of Houston","2012","Tenured, associate professors","301","189","112","2","2","0","44","25","19","18","10","8","30","16","14","0","0","0","205","135","70","2","1","1","0","0","0","0","0","0","-2"
"225511","University of Houston","2012","On-Tenure track total","227","128","99","1","1","0","55","32","23","5","2","3","15","7","8","0","0","0","115","61","54","1","1","0","0","0","0","35","24","11","-2"
"225511","University of Houston","2012","On-tenure track, professors","1","1","0","0","0","0","0","0","0","0","0","0","0","0","0","0","0","0","0","0","0","0","0","0","0","0","0","1","1","0","-2"
"225511","University of Houston","2012","On-tenure track, associate professors","10","5","5","0","0","0","4","3","1","0","0","0","1","0","1","0","0","0","4","1","3","0","0","0","0","0","0","1","1","0","-2"
"225511","University of Houston","2012","On-tenure track, assistant professors","216","122","94","1","1","0","51","29","22","5","2","3","14","7","7","0","0","0","111","60","51","1","1","0","0","0","0","33","22","11","-2"
"225511","University of Houston","2012","Not on tenure track/No tenure system system total","206","97","109","0","0","0","11","6","5","14","5","9","19","5","14","0","0","0","151","73","78","4","3","1","0","0","0","7","5","2","-2"
"225511","University of Houston","2012","Not on tenure/no tenure system, associate professors","1","0","1","0","0","0","0","0","0","0","0","0","1","0","1","0","0","0","0","0","0","0","0","0","0","0","0","0","0","0","-2"
"225511","University of Houston","2012","Not on tenure/no tenure system, lecturers","53","23","30","0","0","0","3","1","2","1","1","0","9","3","6","0","0","0","39","18","21","1","0","1","0","0","0","0","0","0","-2"
"225511","University of Houston","2012","Not on tenure/no tenure system, no academic rank","152","74","78","0","0","0","8","5","3","13","4","9","9","2","7","0","0","0","112","55","57","3","3","0","0","0","0","7","5","2","-2"
"225627","University of the Incarnate Word","2012","Tenured total","113","52","61","0","0","0","7","5","2","4","0","4","19","10","9","0","0","0","80","36","44","0","0","0","1","0","1","2","1","1","-2"
"225627","University of the Incarnate Word","2012","Tenured, professors","48","20","28","0","0","0","4","3","1","1","0","1","4","1","3","0","0","0","38","15","23","0","0","0","0","0","0","1","1","0","-2"
"225627","University of the Incarnate Word","2012","Tenured, associate professors","62","32","30","0","0","0","3","2","1","3","0","3","15","9","6","0","0","0","39","21","18","0","0","0","1","0","1","1","0","1","-2"
"225627","University of the Incarnate Word","2012","Tenured, assistant professors","2","0","2","0","0","0","0","0","0","0","0","0","0","0","0","0","0","0","2","0","2","0","0","0","0","0","0","0","0","0","-2"
"225627","University of the Incarnate Word","2012","Tenured, instructors","1","0","1","0","0","0","0","0","0","0","0","0","0","0","0","0","0","0","1","0","1","0","0","0","0","0","0","0","0","0","-2"
"225627","University of the Incarnate Word","2012","On-Tenure track total","86","37","49","1","0","1","4","3","1","5","2","3","14","9","5","0","0","0","57","20","37","0","0","0","0","0","0","5","3","2","-2"
"225627","University of the Incarnate Word","2012","On-tenure track, associate professors","14","5","9","0","0","0","0","0","0","1","0","1","2","1","1","0","0","0","11","4","7","0","0","0","0","0","0","0","0","0","-2"
"225627","University of the Incarnate Word","2012","On-tenure track, assistant professors","71","31","40","1","0","1","4","3","1","4","2","2","12","8","4","0","0","0","46","16","30","0","0","0","0","0","0","4","2","2","-2"
"225627","University of the Incarnate Word","2012","On-tenure track, instructors","1","1","0","0","0","0","0","0","0","0","0","0","0","0","0","0","0","0","0","0","0","0","0","0","0","0","0","1","1","0","-2"
"225627","University of the Incarnate Word","2012","Not on tenure track/No tenure system system total","80","37","43","0","0","0","3","1","2","6","4","2","19","7","12","0","0","0","50","24","26","0","0","0","0","0","0","2","1","1","-2"
"225627","University of the Incarnate Word","2012","Not on tenure/no tenure system, professors","7","4","3","0","0","0","0","0","0","0","0","0","2","1","1","0","0","0","5","3","2","0","0","0","0","0","0","0","0","0","-2"
"225627","University of the Incarnate Word","2012","Not on tenure/no tenure system, associate professors","3","3","0","0","0","0","0","0","0","0","0","0","0","0","0","0","0","0","2","2","0","0","0","0","0","0","0","1","1","0","-2"
"225627","University of the Incarnate Word","2012","Not on tenure/no tenure system, assistant professors","21","10","11","0","0","0","0","0","0","3","2","1","7","3","4","0","0","0","10","5","5","0","0","0","0","0","0","1","0","1","-2"
"225627","University of the Incarnate Word","2012","Not on tenure/no tenure system, instructors","48","19","29","0","0","0","3","1","2","3","2","1","9","2","7","0","0","0","33","14","19","0","0","0","0","0","0","0","0","0","-2"
"225627","University of the Incarnate Word","2012","Not on tenure/no tenure system, lecturers","1","1","0","0","0","0","0","0","0","0","0","0","1","1","0","0","0","0","0","0","0","0","0","0","0","0","0","0","0","0","-2"
"227757","Rice University","2012","Tenured total","400","311","89","0","0","0","43","32","11","8","6","2","16","14","2","0","0","0","331","257","74","0","0","0","0","0","0","2","2","0","-2"
"227757","Rice University","2012","Tenured, professors","288","239","49","0","0","0","26","23","3","3","3","0","11","10","1","0","0","0","247","202","45","0","0","0","0","0","0","1","1","0","-2"
"227757","Rice University","2012","Tenured, associate professors","112","72","40","0","0","0","17","9","8","5","3","2","5","4","1","0","0","0","84","55","29","0","0","0","0","0","0","1","1","0","-2"
"227757","Rice University","2012","On-Tenure track total","110","70","40","0","0","0","13","8","5","3","3","0","8","5","3","0","0","0","79","51","28","0","0","0","0","0","0","7","3","4","-2"
"227757","Rice University","2012","On-tenure track, assistant professors","110","70","40","0","0","0","13","8","5","3","3","0","8","5","3","0","0","0","79","51","28","0","0","0","0","0","0","7","3","4","-2"
"227757","Rice University","2012","Not on tenure track/No tenure system system total","124","63","61","0","0","0","11","4","7","1","1","0","13","7","6","0","0","0","95","49","46","0","0","0","0","0","0","4","2","2","-2"
"227757","Rice University","2012","Not on tenure/no tenure system, instructors","17","12","5","0","0","0","5","3","2","0","0","0","2","2","0","0","0","0","9","6","3","0","0","0","0","0","0","1","1","0","-2"
"227757","Rice University","2012","Not on tenure/no tenure system, lecturers","93","41","52","0","0","0","6","1","5","0","0","0","11","5","6","0","0","0","74","35","39","0","0","0","0","0","0","2","0","2","-2"
"227757","Rice University","2012","Not on tenure/no tenure system, no academic rank","14","10","4","0","0","0","0","0","0","1","1","0","0","0","0","0","0","0","12","8","4","0","0","0","0","0","0","1","1","0","-2"
"228459","Texas State University","2012","Tenured total","498","310","188","3","1","2","40","30","10","17","9","8","54","33","21","2","1","1","364","223","141","3","1","2","14","11","3","1","1","0","-2"
"228459","Texas State University","2012","Tenured, professors","260","181","79","1","1","0","17","13","4","5","4","1","16","11","5","1","1","0","212","143","69","0","0","0","8","8","0","0","0","0","-2"
"228459","Texas State University","2012","Tenured, associate professors","228","123","105","2","0","2","23","17","6","11","5","6","36","21","15","1","0","1","145","75","70","3","1","2","6","3","3","1","1","0","-2"
"228459","Texas State University","2012","Tenured, assistant professors","9","5","4","0","0","0","0","0","0","1","0","1","2","1","1","0","0","0","6","4","2","0","0","0","0","0","0","0","0","0","-2"
"228459","Texas State University","2012","Tenured, instructors","1","1","0","0","0","0","0","0","0","0","0","0","0","0","0","0","0","0","1","1","0","0","0","0","0","0","0","0","0","0","-2"
"228459","Texas State University","2012","On-Tenure track total","211","104","107","1","1","0","29","19","10","11","8","3","25","8","17","1","1","0","130","61","69","0","0","0","13","5","8","1","1","0","-2"
"228459","Texas State University","2012","On-tenure track, associate professors","8","5","3","0","0","0","0","0","0","0","0","0","0","0","0","0","0","0","8","5","3","0","0","0","0","0","0","0","0","0","-2"
"228459","Texas State University","2012","On-tenure track, assistant professors","203","99","104","1","1","0","29","19","10","11","8","3","25","8","17","1","1","0","122","56","66","0","0","0","13","5","8","1","1","0","-2"
"228459","Texas State University","2012","Not on tenure track/No tenure system system total","425","170","255","3","2","1","20","7","13","13","6","7","30","13","17","2","0","2","341","133","208","1","1","0","14","7","7","1","1","0","-2"
"228459","Texas State University","2012","Not on tenure/no tenure system, professors","2","2","0","0","0","0","0","0","0","0","0","0","0","0","0","0","0","0","1","1","0","1","1","0","0","0","0","0","0","0","-2"
"228459","Texas State University","2012","Not on tenure/no tenure system, associate professors","8","0","8","0","0","0","0","0","0","0","0","0","0","0","0","0","0","0","8","0","8","0","0","0","0","0","0","0","0","0","-2"
"228459","Texas State University","2012","Not on tenure/no tenure system, assistant professors","16","3","13","0","0","0","1","0","1","1","0","1","1","1","0","0","0","0","13","2","11","0","0","0","0","0","0","0","0","0","-2"
"228459","Texas State University","2012","Not on tenure/no tenure system, instructors","1","0","1","0","0","0","0","0","0","0","0","0","0","0","0","0","0","0","1","0","1","0","0","0","0","0","0","0","0","0","-2"
"228459","Texas State University","2012","Not on tenure/no tenure system, lecturers","376","155","221","3","2","1","15","5","10","11","5","6","28","12","16","2","0","2","306","125","181","0","0","0","10","5","5","1","1","0","-2"
"228459","Texas State University","2012","Not on tenure/no tenure system, no academic rank","22","10","12","0","0","0","4","2","2","1","1","0","1","0","1","0","0","0","12","5","7","0","0","0","4","2","2","0","0","0","-2"
"228723","Texas A & M University-College Station","2012","Tenured total","1322","1033","289","3","2","1","180","155","25","42","27","15","77","54","23","0","0","0","1009","786","223","0","0","0","7","6","1","4","3","1","-2"
"228723","Texas A & M University-College Station","2012","Tenured, professors","793","674","119","1","0","1","93","84","9","20","15","5","34","26","8","0","0","0","640","545","95","0","0","0","4","3","1","1","1","0","-2"
"228723","Texas A & M University-College Station","2012","Tenured, associate professors","529","359","170","2","2","0","87","71","16","22","12","10","43","28","15","0","0","0","369","241","128","0","0","0","3","3","0","3","2","1","-2"
"228723","Texas A & M University-College Station","2012","On-Tenure track total","357","218","139","1","1","0","64","37","27","23","11","12","24","16","8","0","0","0","206","130","76","2","1","1","3","2","1","34","20","14","-2"
"228723","Texas A & M University-College Station","2012","On-tenure track, professors","5","5","0","0","0","0","1","1","0","0","0","0","0","0","0","0","0","0","4","4","0","0","0","0","0","0","0","0","0","0","-2"
"228723","Texas A & M University-College Station","2012","On-tenure track, associate professors","12","9","3","0","0","0","1","0","1","0","0","0","1","1","0","0","0","0","10","8","2","0","0","0","0","0","0","0","0","0","-2"
"228723","Texas A & M University-College Station","2012","On-tenure track, assistant professors","339","203","136","1","1","0","62","36","26","23","11","12","23","15","8","0","0","0","191","117","74","2","1","1","3","2","1","34","20","14","-2"
"228723","Texas A & M University-College Station","2012","On-tenure track, instructors","1","1","0","0","0","0","0","0","0","0","0","0","0","0","0","0","0","0","1","1","0","0","0","0","0","0","0","0","0","0","-2"
"228723","Texas A & M University-College Station","2012","Not on tenure track/No tenure system system total","566","267","299","3","1","2","25","11","14","9","4","5","24","19","5","0","0","0","460","202","258","1","0","1","7","4","3","37","26","11","-2"
"228723","Texas A & M University-College Station","2012","Not on tenure/no tenure system, professors","57","39","18","1","0","1","5","4","1","1","0","1","0","0","0","0","0","0","48","33","15","0","0","0","1","1","0","1","1","0","-2"
"228723","Texas A & M University-College Station","2012","Not on tenure/no tenure system, associate professors","48","24","24","0","0","0","0","0","0","1","0","1","3","3","0","0","0","0","42","19","23","0","0","0","0","0","0","2","2","0","-2"
"228723","Texas A & M University-College Station","2012","Not on tenure/no tenure system, assistant professors","86","56","30","0","0","0","6","3","3","2","0","2","5","4","1","0","0","0","50","29","21","0","0","0","2","2","0","21","18","3","-2"
"228723","Texas A & M University-College Station","2012","Not on tenure/no tenure system, instructors","124","53","71","1","0","1","1","0","1","2","2","0","2","2","0","0","0","0","113","49","64","0","0","0","1","0","1","4","0","4","-2"
"228723","Texas A & M University-College Station","2012","Not on tenure/no tenure system, lecturers","251","95","156","1","1","0","13","4","9","3","2","1","14","10","4","0","0","0","207","72","135","1","0","1","3","1","2","9","5","4","-2"
"228778","The University of Texas at Austin","2012","Tenured total","1511","1093","418","8","4","4","129","99","30","63","35","28","82","55","27","0","0","0","1209","889","320","10","3","7","0","0","0","10","8","2","-2"
"228778","The University of Texas at Austin","2012","Tenured, professors","983","767","216","5","3","2","76","65","11","24","17","7","41","29","12","0","0","0","829","648","181","4","2","2","0","0","0","4","3","1","-2"
"228778","The University of Texas at Austin","2012","Tenured, associate professors","528","326","202","3","1","2","53","34","19","39","18","21","41","26","15","0","0","0","380","241","139","6","1","5","0","0","0","6","5","1","-2"
"228778","The University of Texas at Austin","2012","On-Tenure track total","399","231","168","0","0","0","54","31","23","22","10","12","36","18","18","0","0","0","245","141","104","3","3","0","0","0","0","39","28","11","-2"
"228778","The University of Texas at Austin","2012","On-tenure track, assistant professors","398","230","168","0","0","0","54","31","23","22","10","12","36","18","18","0","0","0","244","140","104","3","3","0","0","0","0","39","28","11","-2"
"228778","The University of Texas at Austin","2012","On-tenure track, instructors","1","1","0","0","0","0","0","0","0","0","0","0","0","0","0","0","0","0","1","1","0","0","0","0","0","0","0","0","0","0","-2"
"228778","The University of Texas at Austin","2012","Not on tenure track/No tenure system system total","825","372","453","2","0","2","70","30","40","15","6","9","55","21","34","0","0","0","630","287","343","7","3","4","0","0","0","46","25","21","-2"
"228778","The University of Texas at Austin","2012","Not on tenure/no tenure system, lecturers","551","267","284","1","0","1","43","18","25","9","5","4","33","11","22","0","0","0","431","216","215","3","1","2","0","0","0","31","16","15","-2"
"228778","The University of Texas at Austin","2012","Not on tenure/no tenure system, no academic rank","274","105","169","1","0","1","27","12","15","6","1","5","22","10","12","0","0","0","199","71","128","4","2","2","0","0","0","15","9","6","-2"
"228796","The University of Texas at El Paso","2012","Tenured total","334","242","92","0","0","0","31","24","7","4","4","0","89","60","29","0","0","0","208","152","56","2","2","0","0","0","0","0","0","0","-2"
"228796","The University of Texas at El Paso","2012","Tenured, professors","151","115","36","0","0","0","12","10","2","2","2","0","36","24","12","0","0","0","99","77","22","2","2","0","0","0","0","0","0","0","-2"
"228796","The University of Texas at El Paso","2012","Tenured, associate professors","182","127","55","0","0","0","19","14","5","2","2","0","53","36","17","0","0","0","108","75","33","0","0","0","0","0","0","0","0","0","-2"
"228796","The University of Texas at El Paso","2012","Tenured, assistant professors","1","0","1","0","0","0","0","0","0","0","0","0","0","0","0","0","0","0","1","0","1","0","0","0","0","0","0","0","0","0","-2"
"228796","The University of Texas at El Paso","2012","On-Tenure track total","153","89","64","0","0","0","26","16","10","3","1","2","43","28","15","0","0","0","57","31","26","1","1","0","0","0","0","23","12","11","-2"
"228796","The University of Texas at El Paso","2012","On-tenure track, associate professors","13","9","4","0","0","0","3","2","1","0","0","0","6","5","1","0","0","0","4","2","2","0","0","0","0","0","0","0","0","0","-2"
"228796","The University of Texas at El Paso","2012","On-tenure track, assistant professors","140","80","60","0","0","0","23","14","9","3","1","2","37","23","14","0","0","0","53","29","24","1","1","0","0","0","0","23","12","11","-2"
"228796","The University of Texas at El Paso","2012","Not on tenure track/No tenure system system total","185","72","113","1","0","1","5","2","3","2","0","2","66","27","39","0","0","0","96","37","59","0","0","0","1","0","1","14","6","8","-2"
"228796","The University of Texas at El Paso","2012","Not on tenure/no tenure system, lecturers","185","72","113","1","0","1","5","2","3","2","0","2","66","27","39","0","0","0","96","37","59","0","0","0","1","0","1","14","6","8","-2"
"229063","Texas Southern University","2012","Tenured total","249","151","98","0","0","0","34","23","11","156","90","66","4","3","1","0","0","0","37","22","15","0","0","0","0","0","0","18","13","5","-2"
"229063","Texas Southern University","2012","Tenured, professors","127","93","34","0","0","0","11","10","1","83","58","25","3","3","0","0","0","0","19","14","5","0","0","0","0","0","0","11","8","3","-2"
"229063","Texas Southern University","2012","Tenured, associate professors","110","50","60","0","0","0","23","13","10","64","25","39","1","0","1","0","0","0","16","8","8","0","0","0","0","0","0","6","4","2","-2"
"229063","Texas Southern University","2012","Tenured, assistant professors","12","8","4","0","0","0","0","0","0","9","7","2","0","0","0","0","0","0","2","0","2","0","0","0","0","0","0","1","1","0","-2"
"229063","Texas Southern University","2012","On-Tenure track total","70","28","42","0","0","0","10","4","6","50","18","32","1","1","0","0","0","0","8","5","3","0","0","0","0","0","0","1","0","1","-2"
"229063","Texas Southern University","2012","On-tenure track, associate professors","11","5","6","0","0","0","1","0","1","7","4","3","0","0","0","0","0","0","2","1","1","0","0","0","0","0","0","1","0","1","-2"
"229063","Texas Southern University","2012","On-tenure track, assistant professors","59","23","36","0","0","0","9","4","5","43","14","29","1","1","0","0","0","0","6","4","2","0","0","0","0","0","0","0","0","0","-2"
"229063","Texas Southern University","2012","Not on tenure track/No tenure system system total","120","59","61","0","0","0","6","5","1","90","41","49","6","3","3","0","0","0","14","9","5","0","0","0","0","0","0","4","1","3","-2"
"229063","Texas Southern University","2012","Not on tenure/no tenure system, instructors","10","6","4","0","0","0","1","1","0","6","4","2","1","0","1","0","0","0","1","1","0","0","0","0","0","0","0","1","0","1","-2"
"229063","Texas Southern University","2012","Not on tenure/no tenure system, no academic rank","110","53","57","0","0","0","5","4","1","84","37","47","5","3","2","0","0","0","13","8","5","0","0","0","0","0","0","3","1","2","-2"
"229115","Texas Tech University","2012","Tenured total","642","457","185","3","2","1","33","24","9","11","5","6","25","17","8","0","0","0","473","338","135","0","0","0","0","0","0","97","71","26","-2"
"229115","Texas Tech University","2012","Tenured, professors","296","229","67","2","1","1","22","17","5","7","3","4","10","8","2","0","0","0","233","180","53","0","0","0","0","0","0","22","20","2","-2"
"229115","Texas Tech University","2012","Tenured, associate professors","343","226","117","1","1","0","11","7","4","3","2","1","15","9","6","0","0","0","238","156","82","0","0","0","0","0","0","75","51","24","-2"
"229115","Texas Tech University","2012","Tenured, assistant professors","3","2","1","0","0","0","0","0","0","1","0","1","0","0","0","0","0","0","2","2","0","0","0","0","0","0","0","0","0","0","-2"
"229115","Texas Tech University","2012","On-Tenure track total","266","161","105","0","0","0","12","10","2","5","3","2","21","11","10","0","0","0","171","104","67","1","0","1","0","0","0","56","33","23","-2"
"229115","Texas Tech University","2012","On-tenure track, professors","2","2","0","0","0","0","0","0","0","0","0","0","0","0","0","0","0","0","2","2","0","0","0","0","0","0","0","0","0","0","-2"
"229115","Texas Tech University","2012","On-tenure track, associate professors","34","22","12","0","0","0","1","1","0","1","1","0","1","1","0","0","0","0","25","16","9","0","0","0","0","0","0","6","3","3","-2"
"229115","Texas Tech University","2012","On-tenure track, assistant professors","230","137","93","0","0","0","11","9","2","4","2","2","20","10","10","0","0","0","144","86","58","1","0","1","0","0","0","50","30","20","-2"
"229115","Texas Tech University","2012","Not on tenure track/No tenure system system total","248","116","132","1","1","0","5","3","2","6","3","3","15","7","8","0","0","0","195","88","107","3","3","0","0","0","0","23","11","12","-2"
"229115","Texas Tech University","2012","Not on tenure/no tenure system, professors","4","3","1","0","0","0","0","0","0","0","0","0","0","0","0","0","0","0","4","3","1","0","0","0","0","0","0","0","0","0","-2"
"229115","Texas Tech University","2012","Not on tenure/no tenure system, associate professors","2","1","1","0","0","0","0","0","0","0","0","0","0","0","0","0","0","0","2","1","1","0","0","0","0","0","0","0","0","0","-2"
"229115","Texas Tech University","2012","Not on tenure/no tenure system, assistant professors","32","18","14","0","0","0","0","0","0","3","2","1","1","0","1","0","0","0","20","11","9","2","2","0","0","0","0","6","3","3","-2"
"229115","Texas Tech University","2012","Not on tenure/no tenure system, instructors","210","94","116","1","1","0","5","3","2","3","1","2","14","7","7","0","0","0","169","73","96","1","1","0","0","0","0","17","8","9","-2"
"230728","Utah State University","2012","Tenured total","450","329","121","1","1","0","12","11","1","2","2","0","13","7","6","0","0","0","390","285","105","2","1","1","10","9","1","20","13","7","-2"
"230728","Utah State University","2012","Tenured, professors","175","150","25","0","0","0","8","7","1","1","1","0","1","1","0","0","0","0","154","131","23","1","1","0","3","3","0","7","6","1","-2"
"230728","Utah State University","2012","Tenured, associate professors","275","179","96","1","1","0","4","4","0","1","1","0","12","6","6","0","0","0","236","154","82","1","0","1","7","6","1","13","7","6","-2"
"230728","Utah State University","2012","On-Tenure track total","196","115","81","0","0","0","17","13","4","0","0","0","8","4","4","0","0","0","126","72","54","0","0","0","27","14","13","18","12","6","-2"
"230728","Utah State University","2012","On-tenure track, professors","1","1","0","0","0","0","0","0","0","0","0","0","0","0","0","0","0","0","0","0","0","0","0","0","1","1","0","0","0","0","-2"
"230728","Utah State University","2012","On-tenure track, associate professors","9","7","2","0","0","0","1","1","0","0","0","0","0","0","0","0","0","0","4","3","1","0","0","0","3","2","1","1","1","0","-2"
"230728","Utah State University","2012","On-tenure track, assistant professors","181","103","78","0","0","0","16","12","4","0","0","0","8","4","4","0","0","0","117","65","52","0","0","0","23","11","12","17","11","6","-2"
"230728","Utah State University","2012","On-tenure track, instructors","5","4","1","0","0","0","0","0","0","0","0","0","0","0","0","0","0","0","5","4","1","0","0","0","0","0","0","0","0","0","-2"
"230728","Utah State University","2012","Not on tenure track/No tenure system system total","185","93","92","1","0","1","1","0","1","3","1","2","3","2","1","0","0","0","150","74","76","1","0","1","22","13","9","4","3","1","-2"
"230728","Utah State University","2012","Not on tenure/no tenure system, professors","1","1","0","0","0","0","0","0","0","0","0","0","0","0","0","0","0","0","1","1","0","0","0","0","0","0","0","0","0","0","-2"
"230728","Utah State University","2012","Not on tenure/no tenure system, associate professors","8","5","3","0","0","0","0","0","0","0","0","0","0","0","0","0","0","0","7","5","2","0","0","0","1","0","1","0","0","0","-2"
"230728","Utah State University","2012","Not on tenure/no tenure system, assistant professors","33","15","18","0","0","0","0","0","0","1","0","1","1","1","0","0","0","0","23","8","15","0","0","0","5","4","1","3","2","1","-2"
"230728","Utah State University","2012","Not on tenure/no tenure system, instructors","23","6","17","0","0","0","0","0","0","0","0","0","0","0","0","0","0","0","20","6","14","0","0","0","3","0","3","0","0","0","-2"
"230728","Utah State University","2012","Not on tenure/no tenure system, lecturers","120","66","54","1","0","1","1","0","1","2","1","1","2","1","1","0","0","0","99","54","45","1","0","1","13","9","4","1","1","0","-2"
"232186","George Mason University","2012","Tenured total","675","461","214","3","1","2","74","56","18","21","10","11","16","10","6","0","0","0","527","363","164","0","0","0","30","17","13","4","4","0","-2"
"232186","George Mason University","2012","Tenured, professors","345","263","82","1","1","0","27","23","4","9","4","5","4","4","0","0","0","0","285","218","67","0","0","0","17","11","6","2","2","0","-2"
"232186","George Mason University","2012","Tenured, associate professors","330","198","132","2","0","2","47","33","14","12","6","6","12","6","6","0","0","0","242","145","97","0","0","0","13","6","7","2","2","0","-2"
"232186","George Mason University","2012","On-Tenure track total","223","123","100","1","1","0","19","10","9","8","4","4","8","5","3","0","0","0","91","45","46","0","0","0","70","38","32","26","20","6","-2"
"232186","George Mason University","2012","On-tenure track, associate professors","12","9","3","0","0","0","1","1","0","0","0","0","1","1","0","0","0","0","7","4","3","0","0","0","3","3","0","0","0","0","-2"
"232186","George Mason University","2012","On-tenure track, assistant professors","211","114","97","1","1","0","18","9","9","8","4","4","7","4","3","0","0","0","84","41","43","0","0","0","67","35","32","26","20","6","-2"
"232186","George Mason University","2012","Not on tenure track/No tenure system system total","328","127","201","1","1","0","22","11","11","15","5","10","7","3","4","0","0","0","212","79","133","2","0","2","52","22","30","17","6","11","-2"
"232186","George Mason University","2012","Not on tenure/no tenure system, professors","20","12","8","0","0","0","1","1","0","0","0","0","0","0","0","0","0","0","16","9","7","0","0","0","3","2","1","0","0","0","-2"
"232186","George Mason University","2012","Not on tenure/no tenure system, associate professors","55","20","35","1","1","0","3","2","1","5","1","4","2","1","1","0","0","0","38","11","27","0","0","0","5","4","1","1","0","1","-2"
"232186","George Mason University","2012","Not on tenure/no tenure system, assistant professors","177","67","110","0","0","0","14","6","8","8","4","4","4","2","2","0","0","0","101","38","63","1","0","1","36","12","24","13","5","8","-2"
"232186","George Mason University","2012","Not on tenure/no tenure system, instructors","76","28","48","0","0","0","4","2","2","2","0","2","1","0","1","0","0","0","57","21","36","1","0","1","8","4","4","3","1","2","-2"
"232265","Hampton University","2012","Tenured total","77","48","29","0","0","0","12","10","2","44","23","21","2","1","1","0","0","0","19","14","5","0","0","0","0","0","0","0","0","0","-2"
"232265","Hampton University","2012","Tenured, professors","34","23","11","0","0","0","7","6","1","22","13","9","0","0","0","0","0","0","5","4","1","0","0","0","0","0","0","0","0","0","-2"
"232265","Hampton University","2012","Tenured, associate professors","31","18","13","0","0","0","3","2","1","18","8","10","1","1","0","0","0","0","9","7","2","0","0","0","0","0","0","0","0","0","-2"
"232265","Hampton University","2012","Tenured, assistant professors","12","7","5","0","0","0","2","2","0","4","2","2","1","0","1","0","0","0","5","3","2","0","0","0","0","0","0","0","0","0","-2"
"232265","Hampton University","2012","On-Tenure track total","31","16","15","0","0","0","3","1","2","21","11","10","0","0","0","0","0","0","7","4","3","0","0","0","0","0","0","0","0","0","-2"
"232265","Hampton University","2012","On-tenure track, professors","3","1","2","0","0","0","0","0","0","2","1","1","0","0","0","0","0","0","1","0","1","0","0","0","0","0","0","0","0","0","-2"
"232265","Hampton University","2012","On-tenure track, associate professors","12","7","5","0","0","0","1","0","1","11","7","4","0","0","0","0","0","0","0","0","0","0","0","0","0","0","0","0","0","0","-2"
"232265","Hampton University","2012","On-tenure track, assistant professors","15","7","8","0","0","0","2","1","1","8","3","5","0","0","0","0","0","0","5","3","2","0","0","0","0","0","0","0","0","0","-2"
"232265","Hampton University","2012","On-tenure track, lecturers","1","1","0","0","0","0","0","0","0","0","0","0","0","0","0","0","0","0","1","1","0","0","0","0","0","0","0","0","0","0","-2"
"232265","Hampton University","2012","Not on tenure track/No tenure system system total","164","74","90","1","0","1","13","4","9","117","54","63","2","1","1","1","1","0","30","14","16","0","0","0","0","0","0","0","0","0","-2"
"232265","Hampton University","2012","Not on tenure/no tenure system, professors","9","4","5","0","0","0","0","0","0","7","3","4","1","1","0","0","0","0","1","0","1","0","0","0","0","0","0","0","0","0","-2"
"232265","Hampton University","2012","Not on tenure/no tenure system, associate professors","25","10","15","0","0","0","4","2","2","14","6","8","0","0","0","0","0","0","7","2","5","0","0","0","0","0","0","0","0","0","-2"
"232265","Hampton University","2012","Not on tenure/no tenure system, assistant professors","89","40","49","1","0","1","5","1","4","63","28","35","1","0","1","1","1","0","18","10","8","0","0","0","0","0","0","0","0","0","-2"
"232265","Hampton University","2012","Not on tenure/no tenure system, instructors","8","1","7","0","0","0","4","1","3","4","0","4","0","0","0","0","0","0","0","0","0","0","0","0","0","0","0","0","0","0","-2"
"232265","Hampton University","2012","Not on tenure/no tenure system, lecturers","16","10","6","0","0","0","0","0","0","14","8","6","0","0","0","0","0","0","2","2","0","0","0","0","0","0","0","0","0","0","-2"
"232265","Hampton University","2012","Not on tenure/no tenure system, no academic rank","17","9","8","0","0","0","0","0","0","15","9","6","0","0","0","0","0","0","2","0","2","0","0","0","0","0","0","0","0","0","-2"
"232982","Old Dominion University","2012","Tenured total","398","282","116","2","1","1","40","32","8","22","13","9","10","8","2","0","0","0","247","168","79","0","0","0","55","42","13","22","18","4","-2"
"232982","Old Dominion University","2012","Tenured, professors","202","167","35","1","0","1","22","21","1","7","6","1","3","3","0","0","0","0","123","98","25","0","0","0","31","25","6","15","14","1","-2"
"232982","Old Dominion University","2012","Tenured, associate professors","196","115","81","1","1","0","18","11","7","15","7","8","7","5","2","0","0","0","124","70","54","0","0","0","24","17","7","7","4","3","-2"
"232982","Old Dominion University","2012","On-Tenure track total","173","103","70","1","1","0","30","18","12","10","4","6","8","5","3","0","0","0","98","61","37","1","1","0","14","6","8","11","7","4","-2"
"232982","Old Dominion University","2012","On-tenure track, professors","5","3","2","0","0","0","1","1","0","0","0","0","0","0","0","0","0","0","3","2","1","0","0","0","1","0","1","0","0","0","-2"
"232982","Old Dominion University","2012","On-tenure track, associate professors","13","9","4","0","0","0","2","2","0","2","0","2","1","1","0","0","0","0","5","4","1","0","0","0","3","2","1","0","0","0","-2"
"232982","Old Dominion University","2012","On-tenure track, assistant professors","154","90","64","1","1","0","27","15","12","8","4","4","6","3","3","0","0","0","90","55","35","1","1","0","10","4","6","11","7","4","-2"
"232982","Old Dominion University","2012","On-tenure track, lecturers","1","1","0","0","0","0","0","0","0","0","0","0","1","1","0","0","0","0","0","0","0","0","0","0","0","0","0","0","0","0","-2"
"232982","Old Dominion University","2012","Not on tenure track/No tenure system system total","190","58","132","1","1","0","7","5","2","14","1","13","4","3","1","0","0","0","135","40","95","2","0","2","24","7","17","3","1","2","-2"
"232982","Old Dominion University","2012","Not on tenure/no tenure system, professors","2","2","0","0","0","0","0","0","0","0","0","0","0","0","0","0","0","0","2","2","0","0","0","0","0","0","0","0","0","0","-2"
"232982","Old Dominion University","2012","Not on tenure/no tenure system, associate professors","2","0","2","0","0","0","0","0","0","0","0","0","0","0","0","0","0","0","2","0","2","0","0","0","0","0","0","0","0","0","-2"
"232982","Old Dominion University","2012","Not on tenure/no tenure system, assistant professors","9","4","5","0","0","0","0","0","0","0","0","0","0","0","0","0","0","0","6","3","3","1","0","1","2","1","1","0","0","0","-2"
"232982","Old Dominion University","2012","Not on tenure/no tenure system, instructors","30","10","20","0","0","0","1","1","0","3","1","2","0","0","0","0","0","0","21","6","15","0","0","0","3","2","1","2","0","2","-2"
"232982","Old Dominion University","2012","Not on tenure/no tenure system, lecturers","147","42","105","1","1","0","6","4","2","11","0","11","4","3","1","0","0","0","104","29","75","1","0","1","19","4","15","1","1","0","-2"
"233921","Virginia Polytechnic Institute and State University","2012","Tenured total","1035","781","254","5","2","3","110","90","20","33","22","11","31","28","3","1","0","1","844","633","211","4","2","2","0","0","0","7","4","3","-2"
"233921","Virginia Polytechnic Institute and State University","2012","Tenured, professors","560","463","97","2","0","2","64","60","4","15","10","5","10","9","1","1","0","1","465","382","83","3","2","1","0","0","0","0","0","0","-2"
"233921","Virginia Polytechnic Institute and State University","2012","Tenured, associate professors","475","318","157","3","2","1","46","30","16","18","12","6","21","19","2","0","0","0","379","251","128","1","0","1","0","0","0","7","4","3","-2"
"233921","Virginia Polytechnic Institute and State University","2012","On-Tenure track total","350","221","129","0","0","0","44","29","15","8","3","5","16","8","8","0","0","0","232","145","87","2","2","0","0","0","0","48","34","14","-2"
"233921","Virginia Polytechnic Institute and State University","2012","On-tenure track, professors","1","1","0","0","0","0","1","1","0","0","0","0","0","0","0","0","0","0","0","0","0","0","0","0","0","0","0","0","0","0","-2"
"233921","Virginia Polytechnic Institute and State University","2012","On-tenure track, associate professors","31","29","2","0","0","0","6","6","0","0","0","0","0","0","0","0","0","0","24","22","2","0","0","0","0","0","0","1","1","0","-2"
"233921","Virginia Polytechnic Institute and State University","2012","On-tenure track, assistant professors","318","191","127","0","0","0","37","22","15","8","3","5","16","8","8","0","0","0","208","123","85","2","2","0","0","0","0","47","33","14","-2"
"233921","Virginia Polytechnic Institute and State University","2012","Not on tenure track/No tenure system system total","325","143","182","1","1","0","9","2","7","9","6","3","13","1","12","1","0","1","272","120","152","0","0","0","0","0","0","20","13","7","-2"
"233921","Virginia Polytechnic Institute and State University","2012","Not on tenure/no tenure system, professors","8","7","1","0","0","0","0","0","0","0","0","0","0","0","0","0","0","0","7","6","1","0","0","0","0","0","0","1","1","0","-2"
"233921","Virginia Polytechnic Institute and State University","2012","Not on tenure/no tenure system, associate professors","14","7","7","0","0","0","0","0","0","0","0","0","0","0","0","0","0","0","14","7","7","0","0","0","0","0","0","0","0","0","-2"
"233921","Virginia Polytechnic Institute and State University","2012","Not on tenure/no tenure system, assistant professors","79","34","45","0","0","0","1","0","1","3","2","1","5","1","4","0","0","0","61","27","34","0","0","0","0","0","0","9","4","5","-2"
"233921","Virginia Polytechnic Institute and State University","2012","Not on tenure/no tenure system, instructors","219","92","127","1","1","0","8","2","6","6","4","2","8","0","8","1","0","1","185","77","108","0","0","0","0","0","0","10","8","2","-2"
"233921","Virginia Polytechnic Institute and State University","2012","Not on tenure/no tenure system, lecturers","5","3","2","0","0","0","0","0","0","0","0","0","0","0","0","0","0","0","5","3","2","0","0","0","0","0","0","0","0","0","-2"
"234076","University of Virginia-Main Campus","2012","Tenured total","1003","764","239","0","0","0","55","43","12","39","26","13","18","14","4","0","0","0","878","674","204","5","2","3","0","0","0","8","5","3","-2"
"234076","University of Virginia-Main Campus","2012","Tenured, professors","677","556","121","0","0","0","35","31","4","17","12","5","9","8","1","0","0","0","610","501","109","2","0","2","0","0","0","4","4","0","-2"
"234076","University of Virginia-Main Campus","2012","Tenured, associate professors","326","208","118","0","0","0","20","12","8","22","14","8","9","6","3","0","0","0","268","173","95","3","2","1","0","0","0","4","1","3","-2"
"234076","University of Virginia-Main Campus","2012","On-Tenure track total","262","154","108","0","0","0","36","22","14","12","5","7","9","5","4","0","0","0","179","107","72","1","0","1","0","0","0","25","15","10","-2"
"234076","University of Virginia-Main Campus","2012","On-tenure track, professors","1","1","0","0","0","0","0","0","0","0","0","0","0","0","0","0","0","0","1","1","0","0","0","0","0","0","0","0","0","0","-2"
"234076","University of Virginia-Main Campus","2012","On-tenure track, associate professors","42","24","18","0","0","0","5","3","2","0","0","0","0","0","0","0","0","0","34","19","15","0","0","0","0","0","0","3","2","1","-2"
"234076","University of Virginia-Main Campus","2012","On-tenure track, assistant professors","219","129","90","0","0","0","31","19","12","12","5","7","9","5","4","0","0","0","144","87","57","1","0","1","0","0","0","22","13","9","-2"
"234076","University of Virginia-Main Campus","2012","Not on tenure track/No tenure system system total","542","284","258","1","1","0","42","22","20","20","11","9","11","6","5","0","0","0","445","230","215","2","1","1","0","0","0","21","13","8","-2"
"234076","University of Virginia-Main Campus","2012","Not on tenure/no tenure system, professors","51","34","17","0","0","0","1","1","0","1","1","0","0","0","0","0","0","0","48","31","17","0","0","0","0","0","0","1","1","0","-2"
"234076","University of Virginia-Main Campus","2012","Not on tenure/no tenure system, associate professors","172","102","70","0","0","0","7","6","1","9","4","5","2","2","0","0","0","0","154","90","64","0","0","0","0","0","0","0","0","0","-2"
"234076","University of Virginia-Main Campus","2012","Not on tenure/no tenure system, assistant professors","175","76","99","1","1","0","21","11","10","5","3","2","3","2","1","0","0","0","139","55","84","1","0","1","0","0","0","5","4","1","-2"
"234076","University of Virginia-Main Campus","2012","Not on tenure/no tenure system, instructors","29","18","11","0","0","0","1","1","0","1","1","0","1","0","1","0","0","0","23","14","9","1","1","0","0","0","0","2","1","1","-2"
"234076","University of Virginia-Main Campus","2012","Not on tenure/no tenure system, lecturers","115","54","61","0","0","0","12","3","9","4","2","2","5","2","3","0","0","0","81","40","41","0","0","0","0","0","0","13","7","6","-2"
"237525","Marshall University","2012","Tenured total","369","241","128","2","0","2","25","19","6","11","10","1","8","5","3","0","0","0","316","205","111","0","0","0","0","0","0","7","2","5","-2"
"237525","Marshall University","2012","Tenured, professors","233","157","76","1","0","1","12","10","2","8","7","1","6","3","3","0","0","0","202","137","65","0","0","0","0","0","0","4","0","4","-2"
"237525","Marshall University","2012","Tenured, associate professors","129","83","46","1","0","1","13","9","4","3","3","0","2","2","0","0","0","0","107","67","40","0","0","0","0","0","0","3","2","1","-2"
"237525","Marshall University","2012","Tenured, assistant professors","7","1","6","0","0","0","0","0","0","0","0","0","0","0","0","0","0","0","7","1","6","0","0","0","0","0","0","0","0","0","-2"
"237525","Marshall University","2012","On-Tenure track total","202","115","87","0","0","0","29","20","9","5","3","2","3","1","2","0","0","0","155","89","66","0","0","0","4","0","4","6","2","4","-2"
"237525","Marshall University","2012","On-tenure track, professors","7","6","1","0","0","0","1","1","0","1","0","1","0","0","0","0","0","0","5","5","0","0","0","0","0","0","0","0","0","0","-2"
"237525","Marshall University","2012","On-tenure track, associate professors","49","27","22","0","0","0","12","9","3","0","0","0","2","1","1","0","0","0","33","17","16","0","0","0","0","0","0","2","0","2","-2"
"237525","Marshall University","2012","On-tenure track, assistant professors","145","81","64","0","0","0","16","10","6","4","3","1","1","0","1","0","0","0","116","66","50","0","0","0","4","0","4","4","2","2","-2"
"237525","Marshall University","2012","On-tenure track, instructors","1","1","0","0","0","0","0","0","0","0","0","0","0","0","0","0","0","0","1","1","0","0","0","0","0","0","0","0","0","0","-2"
"237525","Marshall University","2012","Not on tenure track/No tenure system system total","158","79","79","0","0","0","7","3","4","3","1","2","3","2","1","0","0","0","139","69","70","0","0","0","2","1","1","4","3","1","-2"
"237525","Marshall University","2012","Not on tenure/no tenure system, professors","2","1","1","0","0","0","0","0","0","0","0","0","0","0","0","0","0","0","2","1","1","0","0","0","0","0","0","0","0","0","-2"
"237525","Marshall University","2012","Not on tenure/no tenure system, associate professors","13","9","4","0","0","0","0","0","0","0","0","0","0","0","0","0","0","0","13","9","4","0","0","0","0","0","0","0","0","0","-2"
"237525","Marshall University","2012","Not on tenure/no tenure system, assistant professors","69","42","27","0","0","0","6","3","3","2","1","1","3","2","1","0","0","0","56","35","21","0","0","0","2","1","1","0","0","0","-2"
"237525","Marshall University","2012","Not on tenure/no tenure system, instructors","74","27","47","0","0","0","1","0","1","1","0","1","0","0","0","0","0","0","68","24","44","0","0","0","0","0","0","4","3","1","-2"
"240444","University of Wisconsin-Madison","2012","Tenured total","1498","1052","446","7","3","4","159","118","41","22","15","7","49","29","20","0","0","0","1226","864","362","9","4","5","24","17","7","2","2","0","-2"
"240444","University of Wisconsin-Madison","2012","Tenured, professors","1118","831","287","2","0","2","107","85","22","15","10","5","33","19","14","0","0","0","944","706","238","6","3","3","11","8","3","0","0","0","-2"
"240444","University of Wisconsin-Madison","2012","Tenured, associate professors","380","221","159","5","3","2","52","33","19","7","5","2","16","10","6","0","0","0","282","158","124","3","1","2","13","9","4","2","2","0","-2"
"240444","University of Wisconsin-Madison","2012","On-Tenure track total","457","267","190","0","0","0","52","32","20","19","8","11","19","8","11","0","0","0","279","158","121","4","1","3","36","24","12","48","36","12","-2"
"240444","University of Wisconsin-Madison","2012","On-tenure track, assistant professors","457","267","190","0","0","0","52","32","20","19","8","11","19","8","11","0","0","0","279","158","121","4","1","3","36","24","12","48","36","12","-2"
"240444","University of Wisconsin-Madison","2012","Not on tenure track/No tenure system system total","358","209","149","0","0","0","26","14","12","3","1","2","7","4","3","0","0","0","295","172","123","1","0","1","16","11","5","10","7","3","-2"
"240444","University of Wisconsin-Madison","2012","Not on tenure/no tenure system, professors","59","38","21","0","0","0","1","0","1","0","0","0","2","1","1","0","0","0","54","35","19","0","0","0","2","2","0","0","0","0","-2"
"240444","University of Wisconsin-Madison","2012","Not on tenure/no tenure system, associate professors","83","48","35","0","0","0","6","2","4","1","0","1","0","0","0","0","0","0","72","45","27","1","0","1","2","1","1","1","0","1","-2"
"240444","University of Wisconsin-Madison","2012","Not on tenure/no tenure system, assistant professors","124","74","50","0","0","0","11","6","5","1","0","1","2","1","1","0","0","0","97","59","38","0","0","0","7","4","3","6","4","2","-2"
"240444","University of Wisconsin-Madison","2012","Not on tenure/no tenure system, instructors","51","28","23","0","0","0","6","4","2","1","1","0","1","1","0","0","0","0","36","16","20","0","0","0","5","4","1","2","2","0","-2"
"240444","University of Wisconsin-Madison","2012","Not on tenure/no tenure system, lecturers","35","19","16","0","0","0","2","2","0","0","0","0","1","0","1","0","0","0","31","16","15","0","0","0","0","0","0","1","1","0","-2"
"240444","University of Wisconsin-Madison","2012","Not on tenure/no tenure system, no academic rank","6","2","4","0","0","0","0","0","0","0","0","0","1","1","0","0","0","0","5","1","4","0","0","0","0","0","0","0","0","0","-2"
"240453","University of Wisconsin-Milwaukee","2012","Tenured total","523","332","191","6","4","2","75","56","19","29","19","10","19","14","5","0","0","0","387","233","154","2","1","1","0","0","0","5","5","0","-2"
"240453","University of Wisconsin-Milwaukee","2012","Tenured, professors","219","158","61","2","1","1","29","26","3","12","9","3","7","6","1","0","0","0","166","114","52","2","1","1","0","0","0","1","1","0","-2"
"240453","University of Wisconsin-Milwaukee","2012","Tenured, associate professors","299","171","128","4","3","1","45","29","16","17","10","7","11","8","3","0","0","0","218","117","101","0","0","0","0","0","0","4","4","0","-2"
"240453","University of Wisconsin-Milwaukee","2012","Tenured, assistant professors","5","3","2","0","0","0","1","1","0","0","0","0","1","0","1","0","0","0","3","2","1","0","0","0","0","0","0","0","0","0","-2"
"240453","University of Wisconsin-Milwaukee","2012","On-Tenure track total","236","120","116","2","2","0","46","25","21","16","7","9","17","4","13","0","0","0","122","64","58","3","1","2","0","0","0","30","17","13","-2"
"240453","University of Wisconsin-Milwaukee","2012","On-tenure track, associate professors","37","18","19","1","1","0","7","5","2","2","0","2","3","1","2","0","0","0","24","11","13","0","0","0","0","0","0","0","0","0","-2"
"240453","University of Wisconsin-Milwaukee","2012","On-tenure track, assistant professors","199","102","97","1","1","0","39","20","19","14","7","7","14","3","11","0","0","0","98","53","45","3","1","2","0","0","0","30","17","13","-2"
"240453","University of Wisconsin-Milwaukee","2012","Not on tenure track/No tenure system system total","71","29","42","0","0","0","2","0","2","2","1","1","1","0","1","0","0","0","63","27","36","0","0","0","0","0","0","3","1","2","-2"
"240453","University of Wisconsin-Milwaukee","2012","Not on tenure/no tenure system, professors","3","1","2","0","0","0","0","0","0","0","0","0","0","0","0","0","0","0","2","1","1","0","0","0","0","0","0","1","0","1","-2"
"240453","University of Wisconsin-Milwaukee","2012","Not on tenure/no tenure system, associate professors","5","0","5","0","0","0","0","0","0","0","0","0","0","0","0","0","0","0","5","0","5","0","0","0","0","0","0","0","0","0","-2"
"240453","University of Wisconsin-Milwaukee","2012","Not on tenure/no tenure system, assistant professors","12","3","9","0","0","0","1","0","1","0","0","0","0","0","0","0","0","0","9","2","7","0","0","0","0","0","0","2","1","1","-2"
"240453","University of Wisconsin-Milwaukee","2012","Not on tenure/no tenure system, instructors","3","1","2","0","0","0","1","0","1","0","0","0","0","0","0","0","0","0","2","1","1","0","0","0","0","0","0","0","0","0","-2"
"240453","University of Wisconsin-Milwaukee","2012","Not on tenure/no tenure system, lecturers","47","23","24","0","0","0","0","0","0","2","1","1","1","0","1","0","0","0","44","22","22","0","0","0","0","0","0","0","0","0","-2"
"240453","University of Wisconsin-Milwaukee","2012","Not on tenure/no tenure system, no academic rank","1","1","0","0","0","0","0","0","0","0","0","0","0","0","0","0","0","0","1","1","0","0","0","0","0","0","0","0","0","0","-2"
"243665","University of the Virgin Islands","2012","Tenured total","49","31","18","0","0","0","2","2","0","18","11","7","1","0","1","0","0","0","27","18","9","0","0","0","1","0","1","0","0","0","-2"
"243665","University of the Virgin Islands","2012","Tenured, professors","22","14","8","0","0","0","1","1","0","10","5","5","0","0","0","0","0","0","11","8","3","0","0","0","0","0","0","0","0","0","-2"
"243665","University of the Virgin Islands","2012","Tenured, associate professors","20","15","5","0","0","0","1","1","0","7","5","2","0","0","0","0","0","0","12","9","3","0","0","0","0","0","0","0","0","0","-2"
"243665","University of the Virgin Islands","2012","Tenured, assistant professors","7","2","5","0","0","0","0","0","0","1","1","0","1","0","1","0","0","0","4","1","3","0","0","0","1","0","1","0","0","0","-2"
"243665","University of the Virgin Islands","2012","On-Tenure track total","23","12","11","0","0","0","3","3","0","10","5","5","1","0","1","0","0","0","8","4","4","0","0","0","1","0","1","0","0","0","-2"
"243665","University of the Virgin Islands","2012","On-tenure track, associate professors","13","8","5","0","0","0","2","2","0","6","4","2","0","0","0","0","0","0","4","2","2","0","0","0","1","0","1","0","0","0","-2"
"243665","University of the Virgin Islands","2012","On-tenure track, assistant professors","9","4","5","0","0","0","1","1","0","4","1","3","0","0","0","0","0","0","4","2","2","0","0","0","0","0","0","0","0","0","-2"
"243665","University of the Virgin Islands","2012","On-tenure track, instructors","1","0","1","0","0","0","0","0","0","0","0","0","1","0","1","0","0","0","0","0","0","0","0","0","0","0","0","0","0","0","-2"
"243665","University of the Virgin Islands","2012","Not on tenure track/No tenure system system total","36","15","21","0","0","0","0","0","0","17","6","11","0","0","0","0","0","0","18","9","9","0","0","0","1","0","1","0","0","0","-2"
"243665","University of the Virgin Islands","2012","Not on tenure/no tenure system, professors","2","2","0","0","0","0","0","0","0","0","0","0","0","0","0","0","0","0","2","2","0","0","0","0","0","0","0","0","0","0","-2"
"243665","University of the Virgin Islands","2012","Not on tenure/no tenure system, associate professors","5","1","4","0","0","0","0","0","0","3","0","3","0","0","0","0","0","0","1","1","0","0","0","0","1","0","1","0","0","0","-2"
"243665","University of the Virgin Islands","2012","Not on tenure/no tenure system, assistant professors","26","10","16","0","0","0","0","0","0","12","5","7","0","0","0","0","0","0","14","5","9","0","0","0","0","0","0","0","0","0","-2"
"243665","University of the Virgin Islands","2012","Not on tenure/no tenure system, instructors","2","1","1","0","0","0","0","0","0","1","0","1","0","0","0","0","0","0","1","1","0","0","0","0","0","0","0","0","0","0","-2"
"243665","University of the Virgin Islands","2012","Not on tenure/no tenure system, no academic rank","1","1","0","0","0","0","0","0","0","1","1","0","0","0","0","0","0","0","0","0","0","0","0","0","0","0","0","0","0","0","-2"
"243780","Purdue University-Main Campus","2012","Tenured total","1254","971","283","2","2","0","201","170","31","32","22","10","43","33","10","0","0","0","970","741","229","5","2","3","0","0","0","1","1","0","-2"
"243780","Purdue University-Main Campus","2012","Tenured, professors","719","599","120","1","1","0","126","113","13","11","11","0","15","12","3","0","0","0","565","462","103","1","0","1","0","0","0","0","0","0","-2"
"243780","Purdue University-Main Campus","2012","Tenured, associate professors","527","367","160","1","1","0","75","57","18","20","11","9","28","21","7","0","0","0","398","274","124","4","2","2","0","0","0","1","1","0","-2"
"243780","Purdue University-Main Campus","2012","Tenured, assistant professors","8","5","3","0","0","0","0","0","0","1","0","1","0","0","0","0","0","0","7","5","2","0","0","0","0","0","0","0","0","0","-2"
"243780","Purdue University-Main Campus","2012","On-Tenure track total","342","191","151","0","0","0","64","39","25","12","3","9","13","7","6","0","0","0","206","112","94","4","2","2","0","0","0","43","28","15","-2"
"243780","Purdue University-Main Campus","2012","On-tenure track, professors","1","1","0","0","0","0","0","0","0","0","0","0","0","0","0","0","0","0","0","0","0","0","0","0","0","0","0","1","1","0","-2"
"243780","Purdue University-Main Campus","2012","On-tenure track, associate professors","8","5","3","0","0","0","2","1","1","0","0","0","0","0","0","0","0","0","2","0","2","0","0","0","0","0","0","4","4","0","-2"
"243780","Purdue University-Main Campus","2012","On-tenure track, assistant professors","333","185","148","0","0","0","62","38","24","12","3","9","13","7","6","0","0","0","204","112","92","4","2","2","0","0","0","38","23","15","-2"
"243780","Purdue University-Main Campus","2012","Not on tenure track/No tenure system system total","67","46","21","0","0","0","9","6","3","1","1","0","3","2","1","0","0","0","31","19","12","0","0","0","0","0","0","23","18","5","-2"
"243780","Purdue University-Main Campus","2012","Not on tenure/no tenure system, professors","2","1","1","0","0","0","0","0","0","0","0","0","0","0","0","0","0","0","1","0","1","0","0","0","0","0","0","1","1","0","-2"
"243780","Purdue University-Main Campus","2012","Not on tenure/no tenure system, associate professors","1","1","0","0","0","0","0","0","0","0","0","0","0","0","0","0","0","0","0","0","0","0","0","0","0","0","0","1","1","0","-2"
"243780","Purdue University-Main Campus","2012","Not on tenure/no tenure system, assistant professors","56","41","15","0","0","0","9","6","3","1","1","0","3","2","1","0","0","0","25","17","8","0","0","0","0","0","0","18","15","3","-2"
"243780","Purdue University-Main Campus","2012","Not on tenure/no tenure system, instructors","8","3","5","0","0","0","0","0","0","0","0","0","0","0","0","0","0","0","5","2","3","0","0","0","0","0","0","3","1","2","-2"
"409698","California State University-Monterey Bay","2012","Tenured total","84","45","39","1","1","0","16","7","9","5","3","2","17","8","9","1","0","1","42","24","18","0","0","0","2","2","0","0","0","0","-2"
"409698","California State University-Monterey Bay","2012","Tenured, professors","49","32","17","1","1","0","11","6","5","2","1","1","10","7","3","1","0","1","24","17","7","0","0","0","0","0","0","0","0","0","-2"
"409698","California State University-Monterey Bay","2012","Tenured, associate professors","31","10","21","0","0","0","5","1","4","2","1","1","7","1","6","0","0","0","15","5","10","0","0","0","2","2","0","0","0","0","-2"
"409698","California State University-Monterey Bay","2012","Tenured, assistant professors","1","1","0","0","0","0","0","0","0","1","1","0","0","0","0","0","0","0","0","0","0","0","0","0","0","0","0","0","0","0","-2"
"409698","California State University-Monterey Bay","2012","Tenured, no academic rank","3","2","1","0","0","0","0","0","0","0","0","0","0","0","0","0","0","0","3","2","1","0","0","0","0","0","0","0","0","0","-2"
"409698","California State University-Monterey Bay","2012","On-Tenure track total","32","12","20","0","0","0","5","2","3","1","1","0","6","4","2","0","0","0","17","4","13","0","0","0","3","1","2","0","0","0","-2"
"409698","California State University-Monterey Bay","2012","On-tenure track, professors","1","1","0","0","0","0","0","0","0","0","0","0","1","1","0","0","0","0","0","0","0","0","0","0","0","0","0","0","0","0","-2"
"409698","California State University-Monterey Bay","2012","On-tenure track, assistant professors","31","11","20","0","0","0","5","2","3","1","1","0","5","3","2","0","0","0","17","4","13","0","0","0","3","1","2","0","0","0","-2"
"409698","California State University-Monterey Bay","2012","Not on tenure track/No tenure system system total","54","16","38","1","0","1","2","1","1","1","0","1","7","1","6","0","0","0","40","14","26","0","0","0","3","0","3","0","0","0","-2"
"409698","California State University-Monterey Bay","2012","Not on tenure/no tenure system, lecturers","54","16","38","1","0","1","2","1","1","1","0","1","7","1","6","0","0","0","40","14","26","0","0","0","3","0","3","0","0","0","-2"
"445188","University of California-Merced","2012","Tenured total","82","60","22","1","0","1","13","11","2","0","0","0","9","7","2","0","0","0","58","41","17","0","0","0","0","0","0","1","1","0","-2"
"445188","University of California-Merced","2012","Tenured, professors","35","28","7","0","0","0","2","2","0","0","0","0","4","4","0","0","0","0","29","22","7","0","0","0","0","0","0","0","0","0","-2"
"445188","University of California-Merced","2012","Tenured, associate professors","46","32","14","1","0","1","11","9","2","0","0","0","4","3","1","0","0","0","29","19","10","0","0","0","0","0","0","1","1","0","-2"
"445188","University of California-Merced","2012","Tenured, lecturers","1","0","1","0","0","0","0","0","0","0","0","0","1","0","1","0","0","0","0","0","0","0","0","0","0","0","0","0","0","0","-2"
"445188","University of California-Merced","2012","On-Tenure track total","77","44","33","1","0","1","17","10","7","3","2","1","8","6","2","0","0","0","39","18","21","0","0","0","0","0","0","9","8","1","-2"
"445188","University of California-Merced","2012","On-tenure track, assistant professors","71","41","30","1","0","1","15","9","6","3","2","1","8","6","2","0","0","0","35","16","19","0","0","0","0","0","0","9","8","1","-2"
"445188","University of California-Merced","2012","On-tenure track, lecturers","6","3","3","0","0","0","2","1","1","0","0","0","0","0","0","0","0","0","4","2","2","0","0","0","0","0","0","0","0","0","-2"
"445188","University of California-Merced","2012","Not on tenure track/No tenure system system total","105","49","56","1","1","0","11","3","8","1","1","0","13","7","6","0","0","0","70","31","39","2","2","0","3","2","1","4","2","2","-2"
"445188","University of California-Merced","2012","Not on tenure/no tenure system, assistant professors","7","6","1","0","0","0","1","1","0","0","0","0","2","2","0","0","0","0","2","1","1","0","0","0","0","0","0","2","2","0","-2"
"445188","University of California-Merced","2012","Not on tenure/no tenure system, lecturers","98","43","55","1","1","0","10","2","8","1","1","0","11","5","6","0","0","0","68","30","38","2","2","0","3","2","1","2","0","2","-2"
